bill_id,roll_call_id,date,chamber,description,yea,nay,nv,absent,total
1890232,1506597,2025-03-05,House,"HOUSE CIVIL JUSTICE SUBCOMMITTEE: Rec for pass if am by s/c ref. to Judiciary Committee",5,2,1,0,8
1890340,1499827,2025-02-25,Senate,"SENATE JUDICIARY COMMITTEE: Recommended for adoption by Senate Judiciary Committee, refer Senate Calendar Committee",7,2,0,0,9
1890340,1512541,2025-03-11,Senate,"SENATE FINANCE, WAYS AND MEANS COMMITTEE: Recommended for adoption by Senate Finance, Ways, and Means Committee, refer Senate Calendar Committee",9,1,1,0,11
1890340,1527731,2025-03-26,Senate,"FLOOR VOTE: Motion to Adopt Third and Final Reading",26,5,1,0,32
1890340,1553209,2025-04-21,House,"FLOOR VOTE: REGULAR CALENDAR MOTION TO CONCUR",89,6,0,0,95
1890340,1553210,2025-04-21,House,"FLOOR VOTE: REGULAR CALENDAR PREVIOUS QUESTION MOTION TO CONCUR",59,32,0,0,91
1890558,1521857,2025-03-19,House,"HOUSE CITIES & COUNTIES SUBCOMMITTEE: Rec. for pass by s/c ref. to State & Local Government Committee",7,0,0,0,7
1890558,1528210,2025-03-26,House,"HOUSE STATE & LOCAL GOVERNMENT COMMITTEE: Rec. for pass; ref to Finance, Ways, and Means Committee",20,0,1,0,21
1890558,1541907,2025-04-09,House,"HOUSE FINANCE, WAYS, AND MEANS SUBCOMMITTEE: Rec. for pass by s/c ref. to Finance, Ways, and Means Committee",12,0,0,0,12
1890558,1547116,2025-04-14,House,"HOUSE FINANCE, WAYS, AND MEANS COMMITTEE: Rec. for pass; ref to Calendar & Rules Committee",26,0,0,0,26
1890667,1499872,2025-02-26,House,"HOUSE PUBLIC SERVICE SUBCOMMITTEE: Rec. for pass by s/c ref. to State & Local Government Committee",5,0,0,0,5
1890667,1516452,2025-03-12,House,"HOUSE STATE & LOCAL GOVERNMENT COMMITTEE: Rec. for pass; ref to Finance, Ways, and Means Committee",23,0,0,0,23
1890885,1520926,2025-03-19,House,"HOUSE HIGHER EDUCATION SUBCOMMITTEE: Rec for pass if am by s/c ref. to Education Committee",5,0,0,0,5
1890885,1526332,2025-03-25,House,"HOUSE EDUCATION COMMITTEE: Rec. for pass. if am., ref. to Finance, Ways, and Means Committee",18,0,0,0,18
1891103,1500078,2025-02-26,House,"HOUSE HEALTH SUBCOMMITTEE: Rec. for pass by s/c ref. to Health Committee",9,0,0,0,9
1891103,1504401,2025-03-04,House,"HOUSE HEALTH COMMITTEE: Rec. for pass; ref to Calendar & Rules Committee",17,0,0,0,17
1891103,1509533,2025-03-10,House,"FLOOR VOTE: CONSENT CALENDAR PASSAGE ON THIRD CONSIDERATION",94,0,0,0,94
1891103,1549682,2025-04-16,Senate,"SENATE FINANCE, WAYS AND MEANS COMMITTEE: Recommended for concurrence by Senate Finance, Ways, and Means Committee, refer Senate Calendar Committee",11,0,0,0,11
1891103,1552982,2025-04-21,Senate,"FLOOR VOTE: Motion to Adopt",33,0,0,0,33
1891212,1521050,2025-03-19,House,"HOUSE FINANCE, WAYS, AND MEANS SUBCOMMITTEE: Def. to Summer Study in Finance, Ways, and Means Subcommittee",10,3,0,0,13
1891321,1525921,2025-03-25,House,"HOUSE K-12 SUBCOMMITTEE: Failed in s/c K-12 Subcommittee of Education Committee",3,5,0,0,8
1891539,1525931,2025-03-25,House,"HOUSE K-12 SUBCOMMITTEE: Rec. for pass by s/c ref. to Education Committee",8,0,0,0,8
1891539,1534813,2025-04-02,House,"HOUSE EDUCATION COMMITTEE: Rec. for pass; ref to Calendar & Rules Committee",17,0,1,0,18
1891539,1538493,2025-04-07,House,"FLOOR VOTE: CONSENT CALENDAR PASSAGE ON THIRD CONSIDERATION",96,0,0,0,96
1891648,1521817,2025-03-19,House,"HOUSE CIVIL JUSTICE SUBCOMMITTEE: Rec for pass if am by s/c ref. to Judiciary Committee",7,1,0,0,8
1891648,1541918,2025-04-09,House,"HOUSE JUDICIARY COMMITTEE: Rec. for pass. if am., ref. to Health Committee",14,6,0,0,20
1891770,1477070,2025-01-29,House,"FLOOR VOTE: REGULAR CALENDAR LAY ON THE TABLE MOTION TO ADOPT AMENDMENT # 1 BY MITCHELL PASSAGE ON THIRD CONSIDERATION",74,22,0,0,96
1891770,1477071,2025-01-29,House,"FLOOR VOTE: REGULAR CALENDAR MOTION TO CONSIDER AMENDMENT # 3 BY FRITTS PASSAGE ON THIRD CONSIDERATION",19,77,0,0,96
1891770,1477072,2025-01-29,House,"FLOOR VOTE: REGULAR CALENDAR PASSAGE ON THIRD CONSIDERATION",96,0,0,0,96
1891793,1519792,2025-03-18,House,"HOUSE DEPARTMENTS & AGENCIES SUBCOMMITTEE: Failed in s/c Departments & Agencies Subcommittee of State & Local Government Committee",0,3,1,0,4
1892082,1515223,2025-03-11,House,"HOUSE EDUCATION ADMINISTRATION SUBCOMMITTEE: Failed in s/c Education Administration Subcommittee of Education Committee",2,4,0,0,6
1892111,1471810,2025-01-15,House,"FLOOR VOTE: CONSENT CALENDAR PASSAGE ON THIRD CONSIDERATION",95,0,0,0,95
1892422,1477076,2025-01-29,House,"FLOOR VOTE: REGULAR CALENDAR PASSAGE ON THIRD CONSIDERATION",95,0,0,0,95
1892426,1504173,2025-03-04,House,"HOUSE TENNCARE SUBCOMMITTEE: Rec. for pass by s/c ref. to Insurance Committee",5,2,0,0,7
1892437,1477547,2025-01-30,House,"FLOOR VOTE: REGULAR CALENDAR LAY ON THE TABLE MOTION TO ADOPT AMENDMENT # 3 BY POWELL PASSAGE ON THIRD CONSIDERATION",73,21,0,0,94
1892437,1477548,2025-01-30,House,"FLOOR VOTE: REGULAR CALENDAR LAY ON THE TABLE MOTION TO ADOPT AMENDMENT # 4 BY CLEMMONS PASSAGE ON THIRD CONSIDERATION",65,24,8,0,97
1892437,1477549,2025-01-30,House,"FLOOR VOTE: REGULAR CALENDAR PASSAGE ON THIRD CONSIDERATION",81,13,2,0,96
1892449,1519910,2025-03-18,House,"POPULATION HEALTH SUBCOMMITTEE: Failed in s/c Population Health Subcommittee of Health Committee",2,7,1,0,10
1892458,1477069,2025-01-29,House,"FLOOR VOTE: REGULAR CALENDAR 2 PASSAGE ON THIRD CONSIDERATION",80,16,0,0,96
1892496,1532461,2025-04-01,Senate,"SENATE FINANCE, WAYS AND MEANS COMMITTEE: Recommended for adoption by Senate Finance, Ways, and Means Committee, refer Senate Calendar Committee",9,0,0,0,9
1892496,1551048,2025-04-16,Senate,"FLOOR VOTE: Motion to Adopt Third Consideration",27,0,5,0,32
1892538,1471869,2025-01-15,House,"FLOOR VOTE: CONSENT CALENDAR PASSAGE ON THIRD CONSIDERATION",95,0,0,0,95
1892816,1494543,2025-02-18,House,"HOUSE TRANSPORTATION SUBCOMMITTEE: Rec for pass if am by s/c ref. to Transportation Committee",8,0,0,0,8
1892816,1498850,2025-02-25,House,"HOUSE TRANSPORTATION COMMITTEE: Rec. for pass. if am., ref. to Government Operations Committee",16,1,0,0,17
1892816,1509083,2025-03-10,House,"HOUSE GOVERNMENT OPERATIONS COMMITTEE: Rec. for pass; ref to Calendar & Rules Committee",14,0,0,0,14
1893071,1497081,2025-02-11,House,"HOUSE TENNCARE SUBCOMMITTEE: Rec. for pass by s/c ref. to Insurance Committee",7,0,0,0,7
1893071,1506279,2025-03-05,House,"HOUSE INSURANCE COMMITTEE: Failed in Insurance Committee",4,14,0,0,18
1893328,1534312,2025-04-02,Senate,"SENATE STATE & LOCAL GOVERNMENT COMMITTEE:",8,0,0,0,8
1893336,1477081,2025-01-29,House,"FLOOR VOTE: REGULAR CALENDAR 2 PASSAGE ON THIRD CONSIDERATION",96,0,0,0,96
1893336,1526516,2025-03-25,Senate,"SENATE STATE & LOCAL GOVERNMENT COMMITTEE: Recommended for passage with amendment/s, refer to Senate Calendar Committee Ayes 6, Nays 3 PNV 0",6,3,0,0,9
1893336,1536236,2025-04-03,Senate,"FLOOR VOTE: as Amended Third Consideration",23,6,0,0,29
1893336,1550169,2025-04-16,House,"FLOOR VOTE: REGULAR CALENDAR AS AMENDED PASSAGE ON THIRD CONSIDERATION",90,3,2,0,95
1893336,1550170,2025-04-16,House,"FLOOR VOTE: REGULAR CALENDAR MOTION TO ADOPT AMENDMENT # 2 BY HOWELL PASSAGE ON THIRD CONSIDERATION",92,0,0,0,92
1893336,1550171,2025-04-16,House,"FLOOR VOTE: REGULAR CALENDAR MOTION TO CONSIDER AMENDMENT # 2 BY HOWELL PASSAGE ON THIRD CONSIDERATION",90,0,1,0,91
1893336,1552422,2025-04-17,Senate,"FLOOR VOTE: Motion to Concur House Amendment # 1",26,7,0,0,33
1893336,1552423,2025-04-17,Senate,"FLOOR VOTE: Motion to Concur House Amendment # 2",26,6,0,0,32
1894322,1497082,2025-02-03,House,"HOUSE PUBLIC SERVICE SUBCOMMITTEE: Rec. for pass by s/c ref. to Education Committee",6,0,0,0,6
1894322,1506423,2025-03-05,House,"HOUSE PUBLIC SERVICE SUBCOMMITTEE: Rec. for pass by s/c ref. to State & Local Government Committee",5,0,0,0,5
1894322,1516512,2025-03-12,House,"HOUSE STATE & LOCAL GOVERNMENT COMMITTEE: Rec. for pass; ref to Finance, Ways, and Means Committee",21,1,1,0,23
1894322,1520824,2025-03-19,House,"HOUSE FINANCE, WAYS, AND MEANS SUBCOMMITTEE: Rec. for pass by s/c ref. to Finance, Ways, and Means Committee",10,0,0,0,10
1894322,1526529,2025-03-25,House,"HOUSE FINANCE, WAYS, AND MEANS COMMITTEE: Rec. for pass; ref to Calendar & Rules Committee",23,0,0,0,23
1894322,1531029,2025-03-31,House,"FLOOR VOTE: CONSENT CALENDAR PASSAGE ON THIRD CONSIDERATION",93,0,2,0,95
1894322,1548182,2025-04-14,Senate,"FLOOR VOTE: Third Consideration",31,0,0,0,31
1894759,1492389,2025-02-18,House,"HOUSE ELECTIONS & CAMPAIGN FINANCE SUBCOMMITTEE: Rec. for pass by s/c ref. to State & Local Government Committee",5,0,0,0,5
1894759,1506059,2025-03-05,House,"HOUSE STATE & LOCAL GOVERNMENT COMMITTEE: Rec. for pass. if am., ref. to Calendar & Rules Committee",17,2,0,0,19
1894759,1509515,2025-03-10,House,"FLOOR VOTE: REGULAR CALENDAR AS AMENDED PASSAGE ON THIRD CONSIDERATION",71,22,0,0,93
1894759,1528803,2025-03-27,Senate,"FLOOR VOTE: Third Consideration",29,0,0,0,29
1894784,1499864,2025-02-26,House,"HOUSE PUBLIC SERVICE SUBCOMMITTEE: Rec for pass if am by s/c ref. to State & Local Government Committee",3,1,1,0,5
1894784,1506271,2025-03-05,House,"HOUSE STATE & LOCAL GOVERNMENT COMMITTEE: Rec. for pass. if am., ref. to Calendar & Rules Committee",14,7,0,0,21
1894784,1509630,2025-03-10,House,"FLOOR VOTE: REGULAR CALENDAR AS AMENDED PASSAGE ON THIRD CONSIDERATION",60,29,2,0,91
1894814,1528075,2025-03-26,House,"HOUSE AGRICULTURE AND NATURAL RESOURCES SUBCOMMITTEE: Rec. for pass by s/c ref. to Agriculture & Natural Resources Committee",7,0,2,0,9
1894814,1532193,2025-04-01,House,"HOUSE AGRICULTURE & NATURAL RESOURCES COMMITTEE: Rec. for pass; ref to Finance, Ways, and Means Committee",14,0,0,0,14
1894814,1551868,2025-04-17,House,"HOUSE FINANCE, WAYS, AND MEANS SUBCOMMITTEE: Rec for pass if am by s/c ref. to Finance, Ways, and Means Committee",11,0,0,0,11
1894814,1553410,2025-04-17,House,"HOUSE FINANCE, WAYS, AND MEANS COMMITTEE: Rec. for pass. if am., ref. to Calendar & Rules Committee",14,9,4,0,27
1894814,1553411,2025-04-17,House,"HOUSE FINANCE, WAYS, AND MEANS COMMITTEE: Rec. for pass; ref to Calendar & Rules Committee",27,0,0,0,27
1894814,1553412,2025-04-21,House,"HOUSE FINANCE, WAYS, AND MEANS COMMITTEE: Rec. for pass. if am., ref. to Calendar & Rules Committee",20,7,0,0,27
1894932,1519964,2025-03-18,House,"HOUSE EDUCATION ADMINISTRATION SUBCOMMITTEE: Rec for pass if am by s/c ref. to Education Committee",4,2,0,0,6
1894932,1535078,2025-04-02,House,"HOUSE EDUCATION COMMITTEE: Rec. for pass. if am., ref. to Calendar & Rules Committee",10,9,0,0,19
1895058,1513217,2025-03-11,House,"POPULATION HEALTH SUBCOMMITTEE: Failed in s/c Population Health Subcommittee of Health Committee",1,6,0,0,7
1895703,1522334,2025-03-19,Senate,"SENATE EDUCATION COMMITTEE: Recommended for passage with amendment/s, refer to Senate Calendar Committee Ayes 6, Nays 2 PNV 0",6,2,0,0,8
1895707,1500242,2025-02-26,Senate,"SENATE ENERGY, AGRICULTURE AND NATURAL RESOURCES COMMITTEE: Recommended for passage, refer to Senate Finance, Ways, and Means Committee",9,0,0,0,9
1895707,1539537,2025-04-08,Senate,"SENATE FINANCE, WAYS AND MEANS COMMITTEE: Recommended for passage with amendment, refer to Senate Calendar Committee",11,0,0,0,11
1895707,1548103,2025-04-14,Senate,"FLOOR VOTE: as Amended Third Consideration",32,0,0,0,32
1895707,1554358,2025-04-22,House,"FLOOR VOTE: REGULAR CALENDAR 2 AS AMENDED PASSAGE ON THIRD CONSIDERATION",73,8,10,0,91
1895707,1556710,2025-04-22,Senate,"FLOOR VOTE: Motion to Concur House Amendment # 2",29,1,0,0,30
1895722,1491808,2025-02-18,Senate,"SENATE STATE & LOCAL GOVERNMENT COMMITTEE: Recommended for passage, refer to Senate Finance, Ways, and Means Committee",9,0,0,0,9
1895756,1505161,2025-03-04,House,"HOUSE TRANSPORTATION SUBCOMMITTEE: Rec. for pass by s/c ref. to Transportation Committee",9,0,0,0,9
1895853,1471817,2025-01-15,House,"FLOOR VOTE: CONSENT CALENDAR PASSAGE ON THIRD CONSIDERATION",95,0,0,0,95
1895884,1500069,2025-02-26,House,"INSURANCE SUBCOMMITTEE: Rec for pass if am by s/c ref. to Insurance Committee",6,0,0,0,6
1895884,1516442,2025-03-12,House,"HOUSE INSURANCE COMMITTEE: Rec. for pass. if am., ref. to Finance, Ways, and Means Committee",16,0,1,0,17
1895982,1505877,2025-03-05,House,"HOUSE CRIMINAL JUSTICE SUBCOMMITTEE: Rec. for pass by s/c ref. to Judiciary Committee",8,0,0,0,8
1895982,1516456,2025-03-12,House,"HOUSE JUDICIARY COMMITTEE: Rec. for pass; ref to Finance, Ways, and Means Committee",11,5,0,0,16
1895982,1551779,2025-04-17,House,"HOUSE FINANCE, WAYS, AND MEANS SUBCOMMITTEE: Rec. for pass by s/c ref. to Finance, Ways, and Means Committee",11,0,0,0,11
1895982,1553245,2025-04-17,House,"HOUSE FINANCE, WAYS, AND MEANS COMMITTEE: Rec. for pass; ref to Calendar & Rules Committee",27,0,0,0,27
1895982,1553246,2025-04-17,House,"HOUSE FINANCE, WAYS, AND MEANS COMMITTEE: Rec. for pass; ref to Calendar & Rules Committee",24,0,1,0,25
1895996,1500097,2025-02-26,House,"HOUSE CRIMINAL JUSTICE SUBCOMMITTEE: Rec for pass if am by s/c ref. to Judiciary Committee",7,1,1,0,9
1895996,1506256,2025-03-05,House,"HOUSE JUDICIARY COMMITTEE: Rec. for pass. if am., ref. to Finance, Ways, and Means Committee",16,5,0,0,21
1895996,1551816,2025-04-17,House,"HOUSE FINANCE, WAYS, AND MEANS SUBCOMMITTEE: Rec. for pass by s/c ref. to Finance, Ways, and Means Committee",11,0,0,0,11
1895996,1553369,2025-04-17,House,"HOUSE FINANCE, WAYS, AND MEANS COMMITTEE: Rec. for pass. if am., ref. to Calendar & Rules Committee",24,3,0,0,27
1895996,1553370,2025-04-17,House,"HOUSE FINANCE, WAYS, AND MEANS COMMITTEE: Rec. for pass; ref to Calendar & Rules Committee",27,0,0,0,27
1896010,1497083,2025-02-03,House,"HOUSE HEALTH SUBCOMMITTEE: Rec. for pass by s/c ref. to Health Committee",9,0,0,0,9
1896228,1471864,2025-01-15,House,"FLOOR VOTE: CONSENT CALENDAR PASSAGE ON THIRD CONSIDERATION",95,0,0,0,95
1896254,1488496,2025-02-12,House,"HOUSE CITIES & COUNTIES SUBCOMMITTEE: Rec. for pass by s/c ref. to State & Local Government Committee",7,0,0,0,7
1896254,1495521,2025-02-19,House,"HOUSE STATE & LOCAL GOVERNMENT COMMITTEE: Rec. for pass; ref to Finance, Ways, and Means Committee",20,0,0,0,20
1896254,1534170,2025-04-02,House,"HOUSE FINANCE, WAYS, AND MEANS SUBCOMMITTEE: Rec. for pass by s/c ref. to Finance, Ways, and Means Committee",11,0,0,0,11
1896254,1539443,2025-04-08,House,"HOUSE FINANCE, WAYS, AND MEANS COMMITTEE: Rec. for pass; ref to Calendar & Rules Committee",25,0,0,0,25
1896254,1547988,2025-04-14,House,"FLOOR VOTE: CONSENT CALENDAR PASSAGE ON THIRD CONSIDERATION",94,0,1,0,95
1896281,1471866,2025-01-15,House,"FLOOR VOTE: CONSENT CALENDAR PASSAGE ON THIRD CONSIDERATION",95,0,0,0,95
1896308,1471865,2025-01-15,House,"FLOOR VOTE: CONSENT CALENDAR PASSAGE ON THIRD CONSIDERATION",95,0,0,0,95
1896969,1506356,2025-03-05,House,"HOUSE PUBLIC SERVICE SUBCOMMITTEE: Rec for pass if am by s/c ref. to State & Local Government Committee",5,0,0,0,5
1896969,1516530,2025-03-12,House,"HOUSE STATE & LOCAL GOVERNMENT COMMITTEE: Rec. for pass. if am., ref. to Finance, Ways, and Means Committee",23,0,0,0,23
1896969,1525322,2025-03-24,House,"FLOOR VOTE: REGULAR CALENDAR AS AMENDED PASSAGE ON THIRD CONSIDERATION",75,19,0,0,94
1896969,1539264,2025-04-07,Senate,"FLOOR VOTE: Third Consideration",30,1,0,0,31
1897006,1526407,2025-03-25,House,"HOUSE CRIMINAL JUSTICE SUBCOMMITTEE: Rec for pass if am by s/c ref. to Judiciary Committee",8,0,1,0,9
1897064,1505808,2025-03-05,House,"HOUSE CRIMINAL JUSTICE SUBCOMMITTEE: Rec. for pass by s/c ref. to Judiciary Committee",6,2,0,0,8
1897064,1515890,2025-03-12,House,"HOUSE JUDICIARY COMMITTEE: Rec. for pass; ref to Calendar & Rules Committee",9,8,0,0,17
1897155,1528531,2025-03-26,Senate,"SENATE EDUCATION COMMITTEE: Recommended for passage with amendment/s, refer to Senate Calendar Committee Ayes 6, Nays 3 PNV 0",6,3,0,0,9
1897155,1539303,2025-04-07,Senate,"FLOOR VOTE: as Amended Third Consideration",25,4,0,0,29
1897155,1551376,2025-04-17,House,"FLOOR VOTE: REGULAR CALENDAR MOTION TO CONSIDER AMENDMENT # 2 BY PEARSON AS AMENDED PASSAGE ON THIRD CONSIDERATION",28,65,0,0,93
1897164,1491993,2025-02-18,House,"HOUSE CHILDREN AND FAMILY AFFAIRS SUBCOMMITTEE: Rec. for pass by s/c ref. to Judiciary Committee",6,0,0,0,6
1897164,1500053,2025-02-26,House,"HOUSE JUDICIARY COMMITTEE: Rec. for pass. if am., ref. to Finance, Ways, and Means Committee",19,0,0,0,19
1897164,1551699,2025-04-17,House,"HOUSE FINANCE, WAYS, AND MEANS SUBCOMMITTEE: Rec. for pass by s/c ref. to Finance, Ways, and Means Committee",11,0,0,0,11
1897164,1553641,2025-04-17,House,"HOUSE FINANCE, WAYS, AND MEANS COMMITTEE: Rec. for pass; ref to Calendar & Rules Committee",27,0,0,0,27
1897175,1499276,2025-02-25,House,"HOUSE EDUCATION ADMINISTRATION SUBCOMMITTEE: Rec for pass if am by s/c ref. to Education Committee",6,0,0,0,6
1897175,1513765,2025-03-11,House,"HOUSE EDUCATION COMMITTEE: Rec. for pass. if am., ref. to Finance, Ways, and Means Committee",17,0,0,0,17
1897357,1519514,2025-03-17,Senate,"SENATE JUDICIARY COMMITTEE: Failed in Senate Judiciary Committee",4,5,0,0,9
1897375,1493120,2025-02-18,Senate,"SENATE JUDICIARY COMMITTEE: Recommended for passage, refer to Senate Calendar Committee",8,0,0,0,8
1897375,1498151,2025-02-24,Senate,"FLOOR VOTE: Third Consideration",29,2,1,0,32
1897375,1509489,2025-03-10,House,"FLOOR VOTE: REGULAR CALENDAR PASSAGE ON THIRD CONSIDERATION",73,21,0,0,94
1897412,1498206,2025-02-10,House,"HOUSE NAMING & DESIGNATING COMMITTEE: Rec. for pass; ref to State & Local Government Committee",6,3,0,0,9
1897412,1498207,2025-02-19,House,"HOUSE STATE & LOCAL GOVERNMENT COMMITTEE: Failed in State & Local Government Committee",9,11,0,0,20
1897543,1500022,2025-02-26,House,"HOUSE CRIMINAL JUSTICE SUBCOMMITTEE: Rec. for pass by s/c ref. to Judiciary Committee",9,0,0,0,9
1897543,1506357,2025-03-05,House,"HOUSE JUDICIARY COMMITTEE: Rec. for pass; ref to Finance, Ways, and Means Committee",21,0,1,0,22
1897543,1534160,2025-04-02,House,"HOUSE FINANCE, WAYS, AND MEANS SUBCOMMITTEE: Rec. for pass by s/c ref. to Finance, Ways, and Means Committee",8,0,0,0,8
1897543,1540047,2025-04-08,House,"HOUSE FINANCE, WAYS, AND MEANS COMMITTEE: Rec. for pass; ref to Calendar & Rules Committee",28,0,0,0,28
1897543,1547700,2025-04-14,House,"FLOOR VOTE: CONSENT CALENDAR PASSAGE ON THIRD CONSIDERATION",94,0,1,0,95
1897543,1552625,2025-04-21,Senate,"FLOOR VOTE: Motion to Adopt",33,0,0,0,33
1897558,1521834,2025-03-19,House,"HOUSE CITIES & COUNTIES SUBCOMMITTEE: Rec. for pass by s/c ref. to State & Local Government Committee",7,0,0,0,7
1897558,1540069,2025-04-08,House,"HOUSE STATE & LOCAL GOVERNMENT COMMITTEE: Rec. for pass; ref to Finance, Ways, and Means Committee",23,0,0,0,23
1897571,1471822,2025-01-15,House,"FLOOR VOTE: CONSENT CALENDAR PASSAGE ON THIRD CONSIDERATION",95,0,0,0,95
1897585,1471727,2025-01-15,House,"FLOOR VOTE: CONSENT CALENDAR PASSAGE ON THIRD CONSIDERATION",95,0,0,0,95
1897597,1520414,2025-03-18,House,"HOUSE EDUCATION ADMINISTRATION SUBCOMMITTEE: Rec. for pass by s/c ref. to Education Committee",5,1,0,0,6
1897609,1471823,2025-01-15,House,"FLOOR VOTE: CONSENT CALENDAR PASSAGE ON THIRD CONSIDERATION",95,0,0,0,95
1897625,1471824,2025-01-15,House,"FLOOR VOTE: CONSENT CALENDAR PASSAGE ON THIRD CONSIDERATION",95,0,0,0,95
1897740,1494790,2025-02-10,House,"HOUSE PRIVATE ACTS COMMITTEE: Rec. for pass; ref to Calendar & Rules Committee",8,0,0,0,8
1897740,1494791,2025-02-19,House,"HOUSE STATE & LOCAL GOVERNMENT COMMITTEE: Rec. for pass; ref to Calendar & Rules Committee",22,0,0,0,22
1897740,1503723,2025-03-03,House,"FLOOR VOTE: CONSENT CALENDAR PASSAGE ON THIRD CONSIDERATION",89,0,0,0,89
1897815,1515834,2025-03-12,House,"HOUSE CRIMINAL JUSTICE SUBCOMMITTEE: Rec. for pass by s/c ref. to Judiciary Committee",7,0,0,0,7
1897815,1540197,2025-04-08,House,"HOUSE JUDICIARY COMMITTEE: Rec. for pass; ref to Calendar & Rules Committee",14,6,0,0,20
1898413,1513458,2025-03-11,House,"HOUSE DEPARTMENTS & AGENCIES SUBCOMMITTEE: Rec for pass if am by s/c ref. to State & Local Government Committee",8,0,0,0,8
1898413,1528217,2025-03-26,House,"HOUSE STATE & LOCAL GOVERNMENT COMMITTEE: Rec. for pass. if am., ref. to Finance, Ways, and Means Committee",21,0,0,0,21
1900925,1500627,2025-02-26,House,"HOUSE FINANCE, WAYS, AND MEANS SUBCOMMITTEE: Rec. for pass by s/c ref. to Finance, Ways, and Means Committee",12,0,0,0,12
1900925,1505402,2025-03-04,House,"HOUSE FINANCE, WAYS, AND MEANS COMMITTEE: Rec. for pass; ref to Calendar & Rules Committee",19,3,1,0,23
1900925,1517166,2025-03-13,House,"FLOOR VOTE: REGULAR CALENDAR MOTION TO ADOPT",69,22,0,0,91
1900925,1539664,2025-04-08,Senate,"SENATE FINANCE, WAYS AND MEANS COMMITTEE: Recommended for concurrence by Senate Finance, Ways, and Means Committee, refer Senate Calendar Committee",8,1,0,0,9
1900925,1550885,2025-04-16,Senate,"FLOOR VOTE: Motion to Concur",26,6,0,0,32
1900951,1520854,2025-03-18,Senate,"SENATE JUDICIARY COMMITTEE: Recommended for adoption, refer to Senate Calendar Committee Ayes 7, Nays 0, PNV 2",7,0,2,0,9
1900951,1528656,2025-03-27,Senate,"FLOOR VOTE: Motion to Adopt",27,1,3,0,31
1900979,1487821,2025-02-12,House,"HOUSE CITIES & COUNTIES SUBCOMMITTEE: Rec. for pass by s/c ref. to State & Local Government Committee",7,0,0,0,7
1900979,1494526,2025-02-19,House,"HOUSE STATE & LOCAL GOVERNMENT COMMITTEE: Rec. for pass; ref to Calendar & Rules Committee",22,0,0,0,22
1900979,1494527,2025-02-19,House,"HOUSE STATE & LOCAL GOVERNMENT COMMITTEE: Rec. for pass; ref to Calendar & Rules Committee",22,0,0,0,22
1901012,1541278,2025-04-08,Senate,"SENATE JUDICIARY COMMITTEE: Recommended for passage with amendment, refer to Senate Calendar Committee",6,2,0,0,8
1901012,1548015,2025-04-14,Senate,"FLOOR VOTE: as Amended Third Consideration",30,2,0,0,32
1901012,1553286,2025-04-21,House,"FLOOR VOTE: REGULAR CALENDAR MOTION TO ADOPT AMENDMENT # 2 BY BEHN PASSAGE ON THIRD CONSIDERATION",24,70,0,0,94
1901012,1553287,2025-04-21,House,"FLOOR VOTE: REGULAR CALENDAR PASSAGE ON THIRD CONSIDERATION",70,20,4,0,94
1901012,1553288,2025-04-21,House,"FLOOR VOTE: REGULAR CALENDAR PREVIOUS QUESTION PASSAGE ON THIRD CONSIDERATION",70,20,0,0,90
1901020,1526784,2025-03-25,Senate,"SENATE JUDICIARY COMMITTEE: Recommended for passage, refer to Senate Calendar Committee",7,2,0,0,9
1901020,1536009,2025-04-03,Senate,"FLOOR VOTE: Third Consideration",26,3,0,0,29
1901020,1553563,2025-04-21,House,"FLOOR VOTE: REGULAR CALENDAR PASSAGE ON THIRD CONSIDERATION",88,2,4,0,94
1901026,1515827,2025-03-12,House,"HOUSE CRIMINAL JUSTICE SUBCOMMITTEE: Rec for pass if am by s/c ref. to Judiciary Committee",5,2,0,0,7
1901026,1534052,2025-04-02,House,"HOUSE JUDICIARY COMMITTEE: Rec. for pass. if am., ref. to Finance, Ways, and Means Committee",15,4,0,0,19
1901026,1551834,2025-04-17,House,"HOUSE FINANCE, WAYS, AND MEANS SUBCOMMITTEE: Rec. for pass by s/c ref. to Finance, Ways, and Means Committee",11,0,0,0,11
1901026,1553354,2025-04-17,House,"HOUSE FINANCE, WAYS, AND MEANS COMMITTEE: Rec. for pass; ref to Calendar & Rules Committee",27,0,0,0,27
1901026,1553355,2025-04-17,House,"HOUSE FINANCE, WAYS, AND MEANS COMMITTEE: Rec. for pass; ref to Calendar & Rules Committee",23,0,3,0,26
1901034,1519753,2025-03-18,Senate,"SENATE STATE & LOCAL GOVERNMENT COMMITTEE: Recommended for passage with amendment, refer to Senate Calendar Committee",9,0,0,0,9
1901034,1525839,2025-03-24,Senate,"FLOOR VOTE: as Amended Third Consideration",32,0,0,0,32
1901034,1550682,2025-04-16,House,"FLOOR VOTE: REGULAR CALENDAR AS AMENDED PASSAGE ON THIRD CONSIDERATION",90,1,3,0,94
1901034,1552410,2025-04-17,Senate,"FLOOR VOTE: Motion to Concur House Amendment # 1",32,0,0,0,32
1901034,1552411,2025-04-17,Senate,"FLOOR VOTE: Motion to Concur House Amendment # 2",32,0,0,0,32
1901042,1498945,2025-02-25,Senate,"SENATE STATE & LOCAL GOVERNMENT COMMITTEE: Recommended for passage, refer to Senate Calendar Committee",8,1,0,0,9
1901042,1514399,2025-03-06,Senate,"FLOOR VOTE: Third Consideration",27,3,2,0,32
1901042,1525024,2025-03-24,House,"FLOOR VOTE: REGULAR CALENDAR PASSAGE ON THIRD CONSIDERATION",77,16,0,0,93
1901052,1488388,2025-02-12,House,"HOUSE CITIES & COUNTIES SUBCOMMITTEE: Rec for pass if am by s/c ref. to State & Local Government Committee",7,0,0,0,7
1901052,1494577,2025-02-19,House,"HOUSE STATE & LOCAL GOVERNMENT COMMITTEE: Rec. for pass. if am., ref. to Calendar & Rules Committee",21,0,0,0,21
1901052,1498460,2025-02-24,House,"FLOOR VOTE: REGULAR CALENDAR AS AMENDED PASSAGE ON THIRD CONSIDERATION",94,0,1,0,95
1901052,1517186,2025-03-13,Senate,"FLOOR VOTE: as Amended Third Consideration",20,10,0,0,30
1901052,1522775,2025-03-20,House,"FLOOR VOTE: MESSAGE CALENDAR CONCUR IN SENATE AMENDMENT # 1",85,7,0,0,92
1902404,1504703,2025-03-04,Senate,"SENATE STATE & LOCAL GOVERNMENT COMMITTEE: Recommended for passage with amendment/s, refer to Senate Calendar Committee Ayes 6, Nays 2 PNV 1",6,2,1,0,9
1902939,1494506,2025-02-18,House,"HOUSE K-12 SUBCOMMITTEE: Rec. for pass by s/c ref. to Education Committee",7,0,0,0,7
1902939,1504402,2025-03-04,House,"HOUSE EDUCATION COMMITTEE: Rec. for pass; ref to Calendar & Rules Committee",15,1,0,0,16
1902939,1509510,2025-03-10,House,"FLOOR VOTE: CONSENT CALENDAR PASSAGE ON THIRD CONSIDERATION",94,0,0,0,94
1902939,1525825,2025-03-24,Senate,"FLOOR VOTE: Motion to Adopt",32,0,0,0,32
1903032,1493162,2025-02-19,House,"HOUSE HEALTH SUBCOMMITTEE: Rec for pass if am by s/c ref. to Health Committee",8,1,0,0,9
1903032,1499245,2025-02-25,House,"HOUSE HEALTH COMMITTEE: Rec. for pass. if am., ref. to Calendar & Rules Committee",20,1,1,0,22
1903032,1503366,2025-03-03,House,"HOUSE GOVERNMENT OPERATIONS COMMITTEE: Rec. for pass; ref to Calendar & Rules Committee",11,0,0,0,11
1903032,1509128,2025-03-10,House,"FLOOR VOTE: REGULAR CALENDAR AS AMENDED PASSAGE ON THIRD CONSIDERATION",92,2,0,0,94
1903032,1519387,2025-03-17,Senate,"FLOOR VOTE: Third Consideration",31,0,0,0,31
1903131,1495176,2025-02-11,House,"HOUSE TRANSPORTATION SUBCOMMITTEE: Rec for pass if am by s/c ref. to Transportation Committee",9,0,0,0,9
1903131,1495177,2025-02-18,House,"HOUSE TRANSPORTATION COMMITTEE: Rec. for pass. if am., ref. to Government Operations Committee",21,0,0,0,21
1903131,1503681,2025-03-03,House,"HOUSE GOVERNMENT OPERATIONS COMMITTEE: Rec. for pass; ref to Finance, Ways, and Means Committee",11,0,0,0,11
1903131,1552012,2025-04-17,House,"HOUSE FINANCE, WAYS, AND MEANS SUBCOMMITTEE: Rec. for pass by s/c ref. to Finance, Ways, and Means Committee",11,0,0,0,11
1903131,1553883,2025-04-17,House,"HOUSE FINANCE, WAYS, AND MEANS COMMITTEE: Rec. for pass; ref to Calendar & Rules Committee",27,0,0,0,27
1903609,1497084,2025-02-11,House,"HOUSE EDUCATION ADMINISTRATION SUBCOMMITTEE: Rec for pass if am by s/c ref. to Education Committee",5,1,0,0,6
1903609,1513288,2025-03-11,House,"HOUSE EDUCATION COMMITTEE: Rec. for pass. if am., ref. to Calendar & Rules Committee",13,3,0,0,16
1903609,1519039,2025-03-17,House,"FLOOR VOTE: REGULAR CALENDAR AS AMENDED PASSAGE ON THIRD CONSIDERATION",74,18,0,0,92
1903609,1519040,2025-03-17,House,"FLOOR VOTE: REGULAR CALENDAR PREVIOUS QUESTION AS AMENDED PASSAGE ON THIRD CONSIDERATION",73,20,0,0,93
1903609,1522776,2025-03-20,Senate,"FLOOR VOTE: Third Consideration",25,4,0,0,29
1903694,1492419,2025-02-18,Senate,"SENATE COMMERCE AND LABOR COMMITTEE: Recommended for passage, refer to Senate Calendar Committee",7,0,0,0,7
1903694,1498072,2025-02-24,Senate,"FLOOR VOTE: Motion to Adopt",33,0,0,0,33
1903694,1529046,2025-03-27,House,"FLOOR VOTE: REGULAR CALENDAR PASSAGE ON THIRD CONSIDERATION",97,0,0,0,97
1904301,1487768,2025-02-12,House,"HOUSE CITIES & COUNTIES SUBCOMMITTEE: Rec. for pass by s/c ref. to State & Local Government Committee",5,2,0,0,7
1904301,1494501,2025-02-19,House,"HOUSE STATE & LOCAL GOVERNMENT COMMITTEE: Rec. for pass. if am., ref. to Finance, Ways, and Means Committee",19,1,0,0,20
1904301,1506296,2025-03-05,House,"HOUSE FINANCE, WAYS, AND MEANS SUBCOMMITTEE: Rec. for pass by s/c ref. to Finance, Ways, and Means Committee",11,0,0,0,11
1904301,1515213,2025-03-11,House,"HOUSE FINANCE, WAYS, AND MEANS COMMITTEE: Rec. for pass; ref to Calendar & Rules Committee",18,0,0,0,18
1904301,1518958,2025-03-17,House,"FLOOR VOTE: REGULAR CALENDAR AS AMENDED PASSAGE ON THIRD CONSIDERATION",79,11,1,0,91
1904301,1518959,2025-03-17,House,"FLOOR VOTE: REGULAR CALENDAR MOTION AS AMENDED PASSAGE ON THIRD CONSIDERATION",17,76,0,0,93
1904301,1518960,2025-03-17,House,"FLOOR VOTE: REGULAR CALENDAR PREVIOUS QUESTION AS AMENDED PASSAGE ON THIRD CONSIDERATION",76,13,0,0,89
1904301,1539288,2025-04-07,Senate,"FLOOR VOTE: Third Consideration",31,0,0,0,31
1904304,1471782,2025-01-15,House,"FLOOR VOTE: CONSENT CALENDAR PASSAGE ON THIRD CONSIDERATION",95,0,0,0,95
1904364,1513754,2025-03-11,House,"HOUSE ELECTIONS & CAMPAIGN FINANCE SUBCOMMITTEE: Rec for pass if am by s/c ref. to State & Local Government Committee",6,1,0,0,7
1904364,1521832,2025-03-19,House,"HOUSE STATE & LOCAL GOVERNMENT COMMITTEE: Rec. for pass. if am., ref. to Transportation Committee",16,2,0,0,18
1904364,1525909,2025-03-25,House,"HOUSE TRANSPORTATION COMMITTEE: Rec. for pass; ref to Finance, Ways, and Means Committee",18,1,0,0,19
1904364,1551796,2025-04-17,House,"HOUSE FINANCE, WAYS, AND MEANS SUBCOMMITTEE: Rec. for pass by s/c ref. to Finance, Ways, and Means Committee",11,0,0,0,11
1904364,1552865,2025-04-21,Senate,"FLOOR VOTE: Third Consideration",32,0,1,0,33
1904364,1553247,2025-04-17,House,"HOUSE FINANCE, WAYS, AND MEANS COMMITTEE: Rec. for pass; ref to Calendar & Rules Committee",27,0,0,0,27
1904364,1553248,2025-04-21,House,"FLOOR VOTE: REGULAR CALENDAR AS AMENDED PASSAGE ON THIRD CONSIDERATION",77,18,0,0,95
1904364,1553249,2025-04-21,House,"FLOOR VOTE: REGULAR CALENDAR PREVIOUS QUESTION AS AMENDED PASSAGE ON THIRD CONSIDERATION",72,22,0,0,94
1904425,1494534,2025-02-19,Senate,"SENATE HEALTH AND WELFARE COMMITTEE: Recommended for passage with amendment/s, refer to Senate Finance, Ways, and Means Committee Ayes 7, Nays 0 PNV 2",7,0,2,0,9
1904425,1512607,2025-03-11,Senate,"SENATE FINANCE, WAYS AND MEANS COMMITTEE: Recommended for passage with amendment/s, refer to Senate Calendar Committee Ayes 8, Nays 3 PNV 0",8,3,0,0,11
1904425,1522721,2025-03-20,Senate,"FLOOR VOTE: as Amended Third Consideration",23,5,0,0,28
1904489,1519699,2025-03-18,House,"HOUSE K-12 SUBCOMMITTEE: Rec for pass if am by s/c ref. to Education Committee",7,1,0,0,8
1904489,1526487,2025-03-25,House,"HOUSE EDUCATION COMMITTEE: Rec. for pass. if am., ref. to Finance, Ways, and Means Committee",18,0,0,0,18
1904612,1493132,2025-02-18,Senate,"SENATE JUDICIARY COMMITTEE: Recommended for passage, refer to Senate Finance, Ways and Means Committee",9,0,0,0,9
1904731,1506241,2025-03-05,House,"HOUSE PUBLIC SERVICE SUBCOMMITTEE: Rec. for pass by s/c ref. to State & Local Government Committee",6,0,0,0,6
1904731,1516469,2025-03-12,House,"HOUSE STATE & LOCAL GOVERNMENT COMMITTEE: Rec. for pass; ref to Government Operations Committee",22,0,0,0,22
1904731,1524803,2025-03-24,House,"HOUSE GOVERNMENT OPERATIONS COMMITTEE: Rec. for pass; ref to Calendar & Rules Committee",14,0,0,0,14
1904731,1531003,2025-03-31,House,"FLOOR VOTE: CONSENT CALENDAR PASSAGE ON THIRD CONSIDERATION",93,0,2,0,95
1904731,1539274,2025-04-07,Senate,"FLOOR VOTE: Motion to Adopt",31,0,0,0,31
1905315,1515784,2025-03-12,House,"HOUSE CRIMINAL JUSTICE SUBCOMMITTEE: Def. to Summer Study in Criminal Justice Subcommittee",6,0,1,0,7
1905548,1556780,2025-01-16,Senate,"FLOOR VOTE: Motion to Adopt",32,0,0,0,32
1907233,1520945,2025-03-19,House,"HOUSE PUBLIC SERVICE SUBCOMMITTEE: Rec for pass if am by s/c ref. to State & Local Government Committee",5,0,1,0,6
1907233,1543140,2025-04-09,House,"HOUSE STATE & LOCAL GOVERNMENT COMMITTEE: Rec. for pass. if am., ref. to Calendar & Rules Committee",21,1,0,0,22
1907351,1497085,2025-02-12,House,"HOUSE CRIMINAL JUSTICE SUBCOMMITTEE: Rec. for pass by s/c ref. to Judiciary Committee",7,2,0,0,9
1907351,1497086,2025-02-19,House,"HOUSE JUDICIARY COMMITTEE: Rec. for pass; ref to Calendar & Rules Committee",16,4,0,0,20
1907351,1497866,2025-02-24,House,"FLOOR VOTE: REGULAR CALENDAR PASSAGE ON THIRD CONSIDERATION",87,7,0,0,94
1907351,1514749,2025-03-10,Senate,"FLOOR VOTE: as Amended Third Consideration",27,3,0,0,30
1907351,1518527,2025-03-17,House,"FLOOR VOTE: MESSAGE CALENDAR CONCUR IN SENATE AMENDMENT # 1",86,8,0,0,94
1907541,1500301,2025-02-26,House,"HOUSE CRIMINAL JUSTICE SUBCOMMITTEE: Rec for pass if am by s/c ref. to Judiciary Committee",9,0,0,0,9
1907541,1506079,2025-03-05,House,"HOUSE JUDICIARY COMMITTEE: Rec. for pass. if am., ref. to Calendar & Rules Committee",21,0,1,0,22
1907541,1523101,2025-03-20,House,"FLOOR VOTE: REGULAR CALENDAR AS AMENDED PASSAGE ON THIRD CONSIDERATION",94,0,0,0,94
1907541,1535818,2025-04-03,Senate,"FLOOR VOTE: Third Consideration",28,1,1,0,30
1907621,1521683,2025-03-19,House,"HOUSE CITIES & COUNTIES SUBCOMMITTEE: Rec for pass if am by s/c ref. to State & Local Government Committee",7,0,0,0,7
1907698,1487419,2025-02-12,House,"FLOOR VOTE: CONSENT CALENDAR PASSAGE ON THIRD CONSIDERATION",90,0,1,0,91
1907780,1494656,2025-02-12,House,"HOUSE CRIMINAL JUSTICE SUBCOMMITTEE: Rec. for pass by s/c ref. to Judiciary Committee",8,0,0,0,8
1907780,1494657,2025-02-19,House,"HOUSE JUDICIARY COMMITTEE: Rec. for pass; ref to Finance, Ways, and Means Committee",20,0,0,0,20
1907780,1551979,2025-04-17,House,"HOUSE FINANCE, WAYS, AND MEANS SUBCOMMITTEE: Rec. for pass by s/c ref. to Finance, Ways, and Means Committee",11,0,0,0,11
1907780,1553737,2025-04-17,House,"HOUSE FINANCE, WAYS, AND MEANS COMMITTEE: Rec. for pass; ref to Calendar & Rules Committee",27,0,0,0,27
1907858,1487323,2025-02-12,House,"FLOOR VOTE: CONSENT CALENDAR PASSAGE ON THIRD CONSIDERATION",90,0,1,0,91
1908239,1471826,2025-01-15,House,"FLOOR VOTE: CONSENT CALENDAR PASSAGE ON THIRD CONSIDERATION",95,0,0,0,95
1908399,1471832,2025-01-15,House,"FLOOR VOTE: CONSENT CALENDAR PASSAGE ON THIRD CONSIDERATION",95,0,0,0,95
1908559,1521700,2025-03-19,House,"HOUSE CITIES & COUNTIES SUBCOMMITTEE: Rec for pass if am by s/c ref. to State & Local Government Committee",7,0,0,0,7
1908559,1534675,2025-04-02,House,"HOUSE STATE & LOCAL GOVERNMENT COMMITTEE: Rec. for pass. if am., ref. to Finance, Ways, and Means Committee",20,0,0,0,20
1908559,1551880,2025-04-17,House,"HOUSE FINANCE, WAYS, AND MEANS SUBCOMMITTEE: Rec. for pass by s/c ref. to Finance, Ways, and Means Committee",11,0,0,0,11
1908559,1553316,2025-04-17,House,"HOUSE FINANCE, WAYS, AND MEANS COMMITTEE: Rec. for pass; ref to Calendar & Rules Committee",27,0,0,0,27
1908633,1504759,2025-03-04,House,"HOUSE EDUCATION ADMINISTRATION SUBCOMMITTEE: Rec for pass if am by s/c ref. to Education Committee",6,0,0,0,6
1908633,1526436,2025-03-25,House,"HOUSE EDUCATION COMMITTEE: Rec. for pass. if am., ref. to Calendar & Rules Committee",17,0,0,0,17
1908741,1490119,2025-02-12,Senate,"SENATE GOVERNMENT OPERATIONS COMMITTEE: Recommended for passage, refer to Senate Calendar Committee",9,0,0,0,9
1908753,1494507,2025-02-19,Senate,"SENATE GOVERNMENT OPERATIONS COMMITTEE: Recommended for passage, refer to Senate Calendar Committee",6,0,0,0,6
1908766,1504841,2025-03-04,House,"HOUSE EDUCATION ADMINISTRATION SUBCOMMITTEE: Rec for pass if am by s/c ref. to Education Committee",6,0,0,0,6
1908766,1532850,2025-04-01,House,"HOUSE EDUCATION COMMITTEE: Rec. for pass. if am., ref. to Calendar & Rules Committee",17,1,0,0,18
1908779,1489952,2025-02-12,Senate,"SENATE GOVERNMENT OPERATIONS COMMITTEE: Recommended for passage, refer to Senate Calendar Committee",9,0,0,0,9
1908793,1490051,2025-02-12,Senate,"SENATE GOVERNMENT OPERATIONS COMMITTEE: Recommended for passage, refer to Senate Calendar Committee",9,0,0,0,9
1908806,1495002,2025-02-19,Senate,"SENATE GOVERNMENT OPERATIONS COMMITTEE: Recommended for passage, refer to Senate Calendar Committee",6,0,0,0,6
1908819,1494983,2025-02-19,Senate,"SENATE GOVERNMENT OPERATIONS COMMITTEE: Recommended for passage, refer to Senate Calendar Committee",8,0,0,0,8
1908830,1494531,2025-02-19,Senate,"SENATE GOVERNMENT OPERATIONS COMMITTEE: Recommended for passage, refer to Senate Calendar Committee",6,0,0,0,6
1908846,1498777,2025-02-25,House,"HOUSE TRANSPORTATION SUBCOMMITTEE: Rec. for pass by s/c ref. to Transportation Committee",6,3,0,0,9
1908846,1513354,2025-03-11,House,"HOUSE TRANSPORTATION COMMITTEE: Rec. for pass; ref to Calendar & Rules Committee",11,7,2,0,20
1908860,1490520,2025-02-12,Senate,"SENATE GOVERNMENT OPERATIONS COMMITTEE: Recommended for passage, refer to Senate Calendar Committee",9,0,0,0,9
1908874,1490583,2025-02-12,Senate,"SENATE GOVERNMENT OPERATIONS COMMITTEE: Recommended for passage, refer to Senate Calendar Committee",9,0,0,0,9
1908888,1494508,2025-02-19,Senate,"SENATE GOVERNMENT OPERATIONS COMMITTEE: Recommended for passage, refer to Senate Calendar Committee",6,0,0,0,6
1908902,1494503,2025-02-19,Senate,"SENATE GOVERNMENT OPERATIONS COMMITTEE: Recommended for passage, refer to Senate Calendar Committee",8,0,0,0,8
1908915,1494516,2025-02-19,Senate,"SENATE GOVERNMENT OPERATIONS COMMITTEE: Recommended for passage, refer to Senate Calendar Committee",8,0,0,0,8
1908942,1494512,2025-02-19,Senate,"SENATE GOVERNMENT OPERATIONS COMMITTEE: Recommended for passage, refer to Senate Calendar Committee",8,0,0,0,8
1908959,1490561,2025-02-12,Senate,"SENATE GOVERNMENT OPERATIONS COMMITTEE: Recommended for passage, refer to Senate Calendar Committee",9,0,0,0,9
1908975,1494511,2025-02-19,Senate,"SENATE GOVERNMENT OPERATIONS COMMITTEE: Recommended for passage, refer to Senate Calendar Committee",6,0,0,0,6
1908987,1499829,2025-02-26,Senate,"SENATE GOVERNMENT OPERATIONS COMMITTEE: Recommended for passage, refer to Senate Calendar Committee",8,0,0,0,8
1908998,1527709,2025-03-26,House,"HOUSE K-12 SUBCOMMITTEE: Rec for pass if am by s/c ref. to Education Committee",5,0,0,0,5
1908998,1534893,2025-04-02,House,"HOUSE EDUCATION COMMITTEE: Rec. for pass. if am., ref. to Calendar & Rules Committee",18,0,1,0,19
1909013,1494888,2025-02-19,Senate,"SENATE GOVERNMENT OPERATIONS COMMITTEE: Recommended for passage, refer to Senate Calendar Committee",5,3,0,0,8
1909026,1490553,2025-02-12,Senate,"SENATE GOVERNMENT OPERATIONS COMMITTEE: Recommended for passage, refer to Senate Calendar Committee",9,0,0,0,9
1909042,1490576,2025-02-12,Senate,"SENATE GOVERNMENT OPERATIONS COMMITTEE: Recommended for passage, refer to Senate Calendar Committee",9,0,0,0,9
1909056,1505891,2025-03-05,Senate,"SENATE GOVERNMENT OPERATIONS COMMITTEE: Recommended for passage, refer to Senate Calendar Committee",8,0,0,0,8
1909056,1513712,2025-03-10,Senate,"FLOOR VOTE: Motion to Adopt",30,0,0,0,30
1909070,1490140,2025-02-12,Senate,"SENATE GOVERNMENT OPERATIONS COMMITTEE: Recommended for passage, refer to Senate Calendar Committee",9,0,0,0,9
1909081,1490381,2025-02-12,Senate,"SENATE GOVERNMENT OPERATIONS COMMITTEE: Recommended for passage, refer to Senate Calendar Committee",9,0,0,0,9
1909098,1494519,2025-02-19,Senate,"SENATE GOVERNMENT OPERATIONS COMMITTEE: Recommended for passage, refer to Senate Calendar Committee",6,0,0,0,6
1909111,1494974,2025-02-19,Senate,"SENATE GOVERNMENT OPERATIONS COMMITTEE: Recommended for passage, refer to Senate Calendar Committee",6,0,0,0,6
1909141,1489967,2025-02-12,Senate,"SENATE GOVERNMENT OPERATIONS COMMITTEE: Recommended for passage, refer to Senate Calendar Committee",9,0,0,0,9
1909169,1490161,2025-02-12,Senate,"SENATE GOVERNMENT OPERATIONS COMMITTEE: Recommended for passage, refer to Senate Calendar Committee",9,0,0,0,9
1909182,1494563,2025-02-19,Senate,"SENATE GOVERNMENT OPERATIONS COMMITTEE: Recommended for passage, refer to Senate Calendar Committee",6,0,0,0,6
1909196,1494979,2025-02-19,Senate,"SENATE GOVERNMENT OPERATIONS COMMITTEE: Recommended for passage, refer to Senate Calendar Committee",6,0,0,0,6
1909214,1489964,2025-02-12,Senate,"SENATE GOVERNMENT OPERATIONS COMMITTEE: Recommended for passage, refer to Senate Calendar Committee",9,0,0,0,9
1909228,1494502,2025-02-19,Senate,"SENATE GOVERNMENT OPERATIONS COMMITTEE: Recommended for passage, refer to Senate Calendar Committee",6,0,0,0,6
1909239,1499786,2025-02-26,Senate,"SENATE GOVERNMENT OPERATIONS COMMITTEE: Recommended for passage, refer to Senate Calendar Committee",8,0,0,0,8
1909254,1495001,2025-02-19,Senate,"SENATE GOVERNMENT OPERATIONS COMMITTEE: Recommended for passage, refer to Senate Calendar Committee",6,0,0,0,6
1909267,1495129,2025-02-19,Senate,"SENATE GOVERNMENT OPERATIONS COMMITTEE: Recommended for passage, refer to Senate Calendar Committee",6,0,0,0,6
1909283,1506030,2025-03-05,Senate,"SENATE GOVERNMENT OPERATIONS COMMITTEE: Recommended for passage, refer to Senate Calendar Committee",9,0,0,0,9
1909283,1515420,2025-03-10,Senate,"FLOOR VOTE: Motion to Adopt",30,0,0,0,30
1909299,1499795,2025-02-26,Senate,"SENATE GOVERNMENT OPERATIONS COMMITTEE: Recommended for passage, refer to Senate Calendar Committee",9,0,0,0,9
1909311,1490369,2025-02-12,Senate,"SENATE GOVERNMENT OPERATIONS COMMITTEE: Recommended for passage, refer to Senate Calendar Committee",9,0,0,0,9
1909324,1500282,2025-02-26,Senate,"SENATE GOVERNMENT OPERATIONS COMMITTEE: Recommended for passage, refer to Senate Calendar Committee",9,0,0,0,9
1909339,1489966,2025-02-12,Senate,"SENATE GOVERNMENT OPERATIONS COMMITTEE: Recommended for passage, refer to Senate Calendar Committee",9,0,0,0,9
1909351,1506299,2025-03-05,House,"HOUSE PUBLIC SERVICE SUBCOMMITTEE: Failed in s/c Public Service Subcommittee of State & Local Government Committee",1,4,0,0,5
1909367,1489995,2025-02-12,Senate,"SENATE GOVERNMENT OPERATIONS COMMITTEE: Recommended for passage, refer to Senate Calendar Committee",9,0,0,0,9
1909378,1489959,2025-02-12,Senate,"SENATE GOVERNMENT OPERATIONS COMMITTEE: Recommended for passage, refer to Senate Calendar Committee",9,0,0,0,9
1909391,1495472,2025-02-19,Senate,"SENATE GOVERNMENT OPERATIONS COMMITTEE: Recommended for passage, refer to Senate Calendar Committee",6,0,0,0,6
1909404,1505875,2025-03-04,Senate,"SENATE JUDICIARY COMMITTEE: Recommended for passage with amdt, refer to Senate Calendar Committee",9,0,0,0,9
1909404,1513347,2025-03-10,Senate,"FLOOR VOTE: as Amended Third Consideration",29,0,1,0,30
1909404,1550193,2025-04-16,House,"FLOOR VOTE: REGULAR CALENDAR PASSAGE ON THIRD CONSIDERATION",91,0,1,0,92
1909428,1499833,2025-02-26,Senate,"SENATE GOVERNMENT OPERATIONS COMMITTEE: Recommended for passage, refer to Senate Calendar Committee",8,0,0,0,8
1909439,1489984,2025-02-12,Senate,"SENATE GOVERNMENT OPERATIONS COMMITTEE: Recommended for passage, refer to Senate Calendar Committee",9,0,0,0,9
1909541,1494520,2025-02-19,Senate,"SENATE GOVERNMENT OPERATIONS COMMITTEE: Recommended for passage, refer to Senate Calendar Committee",6,0,0,0,6
1909555,1499790,2025-02-26,Senate,"SENATE GOVERNMENT OPERATIONS COMMITTEE: Recommended for passage, refer to Senate Calendar Committee",8,0,0,0,8
1909570,1471767,2025-01-15,House,"FLOOR VOTE: CONSENT CALENDAR PASSAGE ON THIRD CONSIDERATION",95,0,0,0,95
1909607,1471771,2025-01-15,House,"FLOOR VOTE: CONSENT CALENDAR PASSAGE ON THIRD CONSIDERATION",95,0,0,0,95
1909623,1471774,2025-01-15,House,"FLOOR VOTE: CONSENT CALENDAR PASSAGE ON THIRD CONSIDERATION",95,0,0,0,95
1909636,1499775,2025-02-26,Senate,"SENATE GOVERNMENT OPERATIONS COMMITTEE: Recommended for passage, refer to Senate Calendar Committee",6,1,1,0,8
1909649,1505885,2025-03-05,Senate,"SENATE GOVERNMENT OPERATIONS COMMITTEE: Recommended for passage, refer to Senate Calendar Committee",9,0,0,0,9
1909649,1513565,2025-03-10,Senate,"FLOOR VOTE: Motion to Adopt",30,0,0,0,30
1909662,1489963,2025-02-12,Senate,"SENATE GOVERNMENT OPERATIONS COMMITTEE: Recommended for passage, refer to Senate Calendar Committee",9,0,0,0,9
1909676,1471861,2025-01-15,House,"FLOOR VOTE: CONSENT CALENDAR PASSAGE ON THIRD CONSIDERATION",95,0,0,0,95
1909690,1526003,2025-03-25,House,"HOUSE DEPARTMENTS & AGENCIES SUBCOMMITTEE: Rec. for pass by s/c ref. to State & Local Government Committee",8,0,0,0,8
1909690,1541132,2025-04-08,House,"HOUSE STATE & LOCAL GOVERNMENT COMMITTEE: Rec. for pass; ref to Finance, Ways, and Means Committee",21,0,0,0,21
1909701,1471777,2025-01-15,House,"FLOOR VOTE: CONSENT CALENDAR PASSAGE ON THIRD CONSIDERATION",95,0,0,0,95
1909715,1494672,2025-02-19,Senate,"SENATE GOVERNMENT OPERATIONS COMMITTEE: Recommended for passage, refer to Senate Calendar Committee",6,0,0,0,6
1909730,1494864,2025-02-19,Senate,"SENATE GOVERNMENT OPERATIONS COMMITTEE: Recommended for passage, refer to Senate Calendar Committee",6,0,0,0,6
1909744,1505802,2025-03-05,Senate,"SENATE GOVERNMENT OPERATIONS COMMITTEE: Recommended for passage, refer to Senate Calendar Committee",9,0,0,0,9
1909756,1498865,2025-02-25,Senate,"SENATE STATE & LOCAL GOVERNMENT COMMITTEE: Recommended for passage, refer to Senate Calendar Committee",9,0,0,0,9
1909756,1507067,2025-03-06,House,"FLOOR VOTE: REGULAR CALENDAR PASSAGE ON THIRD CONSIDERATION",91,0,0,0,91
1909756,1515415,2025-02-27,Senate,"FLOOR VOTE: Motion to Reconsider Third Consideration",22,10,0,0,32
1909756,1515416,2025-02-27,Senate,"FLOOR VOTE: Third Consideration",32,0,0,0,32
1909756,1515417,2025-02-27,Senate,"FLOOR VOTE: Third Consideration",32,0,0,0,32
1909769,1525927,2025-03-25,House,"HOUSE K-12 SUBCOMMITTEE: Rec for pass if am by s/c ref. to Education Committee",4,3,0,0,7
1909785,1494509,2025-02-19,Senate,"SENATE GOVERNMENT OPERATIONS COMMITTEE: Recommended for passage, refer to Senate Calendar Committee",6,0,0,0,6
1909796,1494514,2025-02-19,Senate,"SENATE GOVERNMENT OPERATIONS COMMITTEE: Recommended for passage, refer to Senate Calendar Committee",6,0,0,0,6
1909837,1499834,2025-02-26,Senate,"SENATE GOVERNMENT OPERATIONS COMMITTEE: Recommended for passage, refer to Senate Calendar Committee",7,2,0,0,9
1909852,1494856,2025-02-19,Senate,"SENATE GOVERNMENT OPERATIONS COMMITTEE: Recommended for passage, refer to Senate Calendar Committee",6,0,0,0,6
1909864,1490581,2025-02-12,Senate,"SENATE GOVERNMENT OPERATIONS COMMITTEE: Recommended for passage, refer to Senate Calendar Committee",9,0,0,0,9
1909864,1549506,2025-04-15,House,"FLOOR VOTE: REGULAR CALENDAR AS AMENDED PASSAGE ON THIRD CONSIDERATION",93,1,0,0,94
1909864,1554704,2025-04-22,House,"FLOOR VOTE: MESSAGE CALENDAR CONFERENCE COMMITTEE REPORT",86,8,4,0,98
1909864,1556575,2025-04-22,Senate,"FLOOR VOTE: Motion to Adopt Conference Committee Report",31,0,0,0,31
1914827,1471760,2025-01-15,House,"FLOOR VOTE: CONSENT CALENDAR PASSAGE ON THIRD CONSIDERATION",95,0,0,0,95
1914880,1497087,2025-02-12,House,"HOUSE CRIMINAL JUSTICE SUBCOMMITTEE: Rec. for pass by s/c ref. to Judiciary Committee",9,0,0,0,9
1914880,1499983,2025-02-26,House,"HOUSE JUDICIARY COMMITTEE: Rec. for pass; ref to Calendar & Rules Committee",17,2,0,0,19
1914996,1487280,2025-02-11,Senate,"SENATE STATE & LOCAL GOVERNMENT COMMITTEE: Recommended for adoption by Senate State and Local Government Committee, refer Senate Calendar Committee",8,0,0,0,8
1914996,1494493,2025-02-13,Senate,"FLOOR VOTE: Motion to Adopt",31,0,0,0,31
1915052,1489227,2025-02-13,House,"FLOOR VOTE: REGULAR CALENDAR MOTION TO CONCUR",71,18,0,0,89
1915111,1471820,2025-01-15,House,"FLOOR VOTE: CONSENT CALENDAR PASSAGE ON THIRD CONSIDERATION",95,0,0,0,95
1915274,1528218,2025-03-26,House,"HOUSE AGRICULTURE AND NATURAL RESOURCES SUBCOMMITTEE: Rec for pass if am by s/c ref. to Agriculture & Natural Resources Committee",9,0,0,0,9
1915274,1532257,2025-04-01,House,"HOUSE AGRICULTURE & NATURAL RESOURCES COMMITTEE: Rec. for pass. if am., ref. to Finance, Ways, and Means Committee",15,0,0,0,15
1915274,1551877,2025-04-17,House,"HOUSE FINANCE, WAYS, AND MEANS SUBCOMMITTEE: Rec. for pass by s/c ref. to Finance, Ways, and Means Committee",11,0,0,0,11
1915274,1553453,2025-04-17,House,"HOUSE FINANCE, WAYS, AND MEANS COMMITTEE: Rec. for pass; ref to Calendar & Rules Committee",27,0,0,0,27
1915286,1494628,2025-02-19,House,"HOUSE AGRICULTURE AND NATURAL RESOURCES SUBCOMMITTEE: Rec. for pass by s/c ref. to Agriculture & Natural Resources Committee",8,0,0,0,8
1915286,1498749,2025-02-25,House,"HOUSE AGRICULTURE & NATURAL RESOURCES COMMITTEE: Rec. for pass; ref to Calendar & Rules Committee",16,0,0,0,16
1915286,1503404,2025-03-03,House,"FLOOR VOTE: CONSENT CALENDAR PASSAGE ON THIRD CONSIDERATION",89,0,0,0,89
1915286,1531795,2025-03-31,Senate,"FLOOR VOTE: Motion to Adopt",30,0,0,0,30
1915294,1494933,2025-02-12,House,"HOUSE PUBLIC SERVICE SUBCOMMITTEE: Rec. for pass by s/c ref. to State & Local Government Committee",6,0,0,0,6
1915294,1494934,2025-02-19,House,"HOUSE STATE & LOCAL GOVERNMENT COMMITTEE: Rec. for pass; ref to Calendar & Rules Committee",22,0,0,0,22
1915294,1498104,2025-02-24,House,"FLOOR VOTE: CONSENT CALENDAR PASSAGE ON THIRD CONSIDERATION",92,0,2,0,94
1915294,1513885,2025-03-10,Senate,"FLOOR VOTE: Motion to Adopt",30,0,0,0,30
1915308,1513804,2025-03-11,House,"HOUSE TRANSPORTATION SUBCOMMITTEE: Rec for pass if am by s/c ref. to Transportation Committee",9,0,0,0,9
1915308,1519916,2025-03-18,House,"HOUSE TRANSPORTATION COMMITTEE: Rec. for pass. if am., ref. to Finance, Ways, and Means Committee",16,0,1,0,17
1915308,1527606,2025-03-26,House,"HOUSE FINANCE, WAYS, AND MEANS SUBCOMMITTEE: Rec. for pass by s/c ref. to Finance, Ways, and Means Committee",12,0,0,0,12
1915316,1494625,2025-02-18,House,"POPULATION HEALTH SUBCOMMITTEE: Rec. for pass by s/c ref. to Health Committee",7,0,0,0,7
1915316,1499299,2025-02-25,House,"HOUSE HEALTH COMMITTEE: Rec. for pass; ref to Calendar & Rules Committee",20,0,0,0,20
1915316,1503339,2025-03-03,House,"FLOOR VOTE: CONSENT CALENDAR PASSAGE ON THIRD CONSIDERATION",89,0,0,0,89
1915335,1488336,2025-02-12,House,"FLOOR VOTE: CONSENT CALENDAR PASSAGE ON THIRD CONSIDERATION",90,0,1,0,91
1915357,1494545,2025-02-19,House,"HOUSE HEALTH SUBCOMMITTEE: Rec for pass if am by s/c ref. to Health Committee",9,0,0,0,9
1915357,1513360,2025-03-11,House,"HOUSE HEALTH COMMITTEE: Rec. for pass. if am., ref. to Government Operations Committee",15,0,0,0,15
1915357,1518400,2025-03-17,House,"HOUSE GOVERNMENT OPERATIONS COMMITTEE: Rec. for pass., ref. to Calendar & Rules Committee",13,0,0,0,13
1915357,1524960,2025-03-24,House,"FLOOR VOTE: REGULAR CALENDAR AS AMENDED PASSAGE ON THIRD CONSIDERATION",92,0,1,0,93
1915357,1525768,2025-03-24,Senate,"FLOOR VOTE: Third Consideration",32,0,0,0,32
1915378,1486990,2025-02-11,House,"HOUSE CHILDREN AND FAMILY AFFAIRS SUBCOMMITTEE: Rec. for pass by s/c ref. to Judiciary Committee",7,0,0,0,7
1915378,1494532,2025-02-19,House,"HOUSE JUDICIARY COMMITTEE: Rec. for pass; ref to Finance, Ways, and Means Committee",16,1,2,0,19
1915378,1499773,2025-02-26,House,"HOUSE FINANCE, WAYS, AND MEANS SUBCOMMITTEE: Rec. for pass by s/c ref. to Finance, Ways, and Means Committee",12,0,0,0,12
1915378,1505097,2025-03-04,House,"HOUSE FINANCE, WAYS, AND MEANS COMMITTEE: Rec. for pass; ref to Calendar & Rules Committee",21,0,0,0,21
1915378,1509273,2025-03-10,House,"FLOOR VOTE: CONSENT CALENDAR PASSAGE ON THIRD CONSIDERATION",94,0,0,0,94
1915378,1548063,2025-04-14,Senate,"FLOOR VOTE: Motion to Adopt",32,0,0,0,32
1915390,1494524,2025-02-19,House,"HOUSE AGRICULTURE AND NATURAL RESOURCES SUBCOMMITTEE: Rec. for pass by s/c ref. to Agriculture & Natural Resources Committee",9,0,0,0,9
1915390,1498733,2025-02-25,House,"HOUSE AGRICULTURE & NATURAL RESOURCES COMMITTEE: Rec. for pass; ref to Finance, Ways, and Means Committee",16,0,0,0,16
1915390,1506385,2025-03-05,House,"HOUSE FINANCE, WAYS, AND MEANS SUBCOMMITTEE: Rec. for pass by s/c ref. to Finance, Ways, and Means Committee",10,0,0,0,10
1915390,1514984,2025-03-11,House,"HOUSE FINANCE, WAYS, AND MEANS COMMITTEE: Rec. for pass; ref to Calendar & Rules Committee",23,0,0,0,23
1915390,1518624,2025-03-17,House,"FLOOR VOTE: CONSENT CALENDAR PASSAGE ON THIRD CONSIDERATION",92,0,1,0,93
1915390,1531910,2025-03-31,Senate,"FLOOR VOTE: Motion to Adopt",30,0,0,0,30
1915400,1497093,2025-02-12,House,"HOUSE HIGHER EDUCATION SUBCOMMITTEE: Rec for pass if am by s/c ref. to Education Committee",6,0,0,0,6
1915400,1497094,2025-02-18,House,"HOUSE EDUCATION COMMITTEE: Rec. for pass. if am., ref. to Finance, Ways, and Means Committee",18,0,0,0,18
1915400,1506347,2025-03-05,House,"HOUSE FINANCE, WAYS, AND MEANS SUBCOMMITTEE: Rec. for pass by s/c ref. to Finance, Ways, and Means Committee",10,0,0,0,10
1915400,1515183,2025-03-11,House,"HOUSE FINANCE, WAYS, AND MEANS COMMITTEE: Rec. for pass; ref to Calendar & Rules Committee",22,0,0,0,22
1915400,1518551,2025-03-17,House,"FLOOR VOTE: REGULAR CALENDAR AS AMENDED PASSAGE ON THIRD CONSIDERATION",94,0,0,0,94
1915400,1549529,2025-04-15,Senate,"FLOOR VOTE: Third Consideration",32,0,0,0,32
1915422,1493145,2025-02-18,Senate,"SENATE JUDICIARY COMMITTEE: Recommended for passage with amendment/s, refer to Senate Calendar Committee Ayes 7, Nays 2 PNV 0",7,2,0,0,9
1915422,1513912,2025-03-03,Senate,"FLOOR VOTE: Motion to Adopt as Amended",27,5,0,0,32
1915422,1553600,2025-04-21,House,"FLOOR VOTE: REGULAR CALENDAR MOTION TO CONCUR",93,0,0,0,93
1915432,1500653,2025-02-26,House,"HOUSE AGRICULTURE AND NATURAL RESOURCES SUBCOMMITTEE: Rec. for pass by s/c ref. to Agriculture & Natural Resources Committee",8,0,0,0,8
1915432,1504186,2025-03-04,House,"HOUSE AGRICULTURE & NATURAL RESOURCES COMMITTEE: Rec. for pass; ref to Finance, Ways, and Means Committee",15,0,0,0,15
1915432,1515888,2025-03-12,House,"HOUSE FINANCE, WAYS, AND MEANS SUBCOMMITTEE: Rec. for pass by s/c ref. to Finance, Ways, and Means Committee",7,0,0,0,7
1915432,1519902,2025-03-18,House,"HOUSE FINANCE, WAYS, AND MEANS COMMITTEE: Rec. for pass; ref to Calendar & Rules Committee",22,0,0,0,22
1915432,1525309,2025-03-24,House,"FLOOR VOTE: CONSENT CALENDAR PASSAGE ON THIRD CONSIDERATION",96,0,0,0,96
1915432,1548035,2025-04-14,Senate,"FLOOR VOTE: Motion to Adopt",32,0,0,0,32
1915443,1515868,2025-03-12,House,"HOUSE HEALTH SUBCOMMITTEE: Rec for pass if am by s/c ref. to Health Committee",5,3,1,0,9
1915443,1519805,2025-03-18,House,"HOUSE HEALTH COMMITTEE: Rec. for pass. if am., ref. to Finance, Ways, and Means Committee",14,7,1,0,22
1915452,1520435,2025-03-18,House,"HOUSE EDUCATION ADMINISTRATION SUBCOMMITTEE: Rec for pass if am by s/c ref. to Education Committee",6,0,0,0,6
1915452,1534814,2025-04-02,House,"HOUSE EDUCATION COMMITTEE: Rec. for pass. if am., ref. to Calendar & Rules Committee",14,4,0,0,18
1915452,1538417,2025-04-07,House,"FLOOR VOTE: REGULAR CALENDAR AS AMENDED PASSAGE ON THIRD CONSIDERATION",88,5,0,0,93
1915452,1553043,2025-04-21,Senate,"FLOOR VOTE: Third Consideration",33,0,0,0,33
1915462,1487320,2025-02-12,House,"FLOOR VOTE: CONSENT CALENDAR PASSAGE ON THIRD CONSIDERATION",90,0,1,0,91
1915473,1497088,2025-02-12,House,"HOUSE BUSINESS AND UTILITIES SUBCOMMITTEE: Rec. for pass by s/c ref. to Commerce Committee",10,0,0,0,10
1915473,1500059,2025-02-26,House,"HOUSE COMMERCE COMMITTEE: Rec. for pass; ref to Calendar & Rules Committee",22,0,0,0,22
1915473,1503352,2025-03-03,House,"FLOOR VOTE: CONSENT CALENDAR PASSAGE ON THIRD CONSIDERATION",89,0,0,0,89
1915473,1513682,2025-03-10,Senate,"FLOOR VOTE: Motion to Adopt",30,0,0,0,30
1915484,1506516,2025-03-05,House,"HOUSE PUBLIC SERVICE SUBCOMMITTEE: Rec. for pass by s/c ref. to State & Local Government Committee",5,0,1,0,6
1915484,1516551,2025-03-12,House,"HOUSE STATE & LOCAL GOVERNMENT COMMITTEE: Rec. for pass; ref to Finance, Ways, and Means Committee",18,4,0,0,22
1915484,1551790,2025-04-17,House,"HOUSE FINANCE, WAYS, AND MEANS SUBCOMMITTEE: Rec. for pass by s/c ref. to Finance, Ways, and Means Committee",11,0,0,0,11
1915484,1553240,2025-04-17,House,"HOUSE FINANCE, WAYS, AND MEANS COMMITTEE: Rec. for pass. if am., ref. to Calendar & Rules Committee",24,3,0,0,27
1915484,1553241,2025-04-17,House,"HOUSE FINANCE, WAYS, AND MEANS COMMITTEE: Rec. for pass; ref to Calendar & Rules Committee",27,0,0,0,27
1915484,1553242,2025-04-21,House,"FLOOR VOTE: REGULAR CALENDAR AS AMENDED PASSAGE ON THIRD CONSIDERATION",69,22,0,0,91
1915484,1553243,2025-04-21,House,"FLOOR VOTE: REGULAR CALENDAR PREVIOUS QUESTION AS AMENDED PASSAGE ON THIRD CONSIDERATION",70,21,0,0,91
1915484,1554657,2025-04-22,House,"FLOOR VOTE: MESSAGE CALENDAR 3 CONCUR IN SENATE AMENDMENT # 1",72,23,0,0,95
1915484,1556804,2025-04-22,Senate,"FLOOR VOTE: as Amended Third Consideration",27,6,0,0,33
1915495,1487830,2025-02-12,House,"HOUSE CITIES & COUNTIES SUBCOMMITTEE: Rec. for pass by s/c ref. to State & Local Government Committee",7,0,0,0,7
1915495,1494495,2025-02-19,House,"HOUSE STATE & LOCAL GOVERNMENT COMMITTEE: Rec. for pass; ref to Calendar & Rules Committee",21,0,0,0,21
1915505,1494676,2025-02-12,House,"HOUSE CRIMINAL JUSTICE SUBCOMMITTEE: Rec. for pass by s/c ref. to Judiciary Committee",6,1,1,0,8
1915505,1494677,2025-02-19,House,"HOUSE JUDICIARY COMMITTEE: Rec. for pass; ref to Finance, Ways, and Means Committee",16,5,0,0,21
1915505,1500100,2025-02-26,House,"HOUSE FINANCE, WAYS, AND MEANS SUBCOMMITTEE: Rec. for pass by s/c ref. to Finance, Ways, and Means Committee",9,2,0,0,11
1915505,1505178,2025-03-04,House,"HOUSE FINANCE, WAYS, AND MEANS COMMITTEE: Rec. for pass; ref to Calendar & Rules Committee",24,1,0,0,25
1915505,1509575,2025-03-10,House,"FLOOR VOTE: REGULAR CALENDAR PASSAGE ON THIRD CONSIDERATION",73,19,0,0,92
1915505,1517234,2025-03-13,Senate,"FLOOR VOTE: Third Consideration",25,6,0,0,31
1915517,1494496,2025-02-18,House,"POPULATION HEALTH SUBCOMMITTEE: Rec. for pass by s/c ref. to Health Committee",6,0,0,0,6
1915517,1498803,2025-02-25,House,"HOUSE HEALTH COMMITTEE: Rec. for pass; ref to Calendar & Rules Committee",22,0,0,0,22
1915527,1494730,2025-02-11,House,"HOUSE TRANSPORTATION SUBCOMMITTEE: Rec. for pass by s/c ref. to Transportation Committee",9,0,0,0,9
1915527,1494731,2025-02-18,House,"HOUSE TRANSPORTATION COMMITTEE: Rec. for pass; ref to Calendar & Rules Committee",18,1,0,0,19
1915527,1498453,2025-02-24,House,"FLOOR VOTE: CONSENT CALENDAR PASSAGE ON THIRD CONSIDERATION",92,0,2,0,94
1915527,1513937,2025-03-10,Senate,"FLOOR VOTE: Motion to Adopt",30,0,0,0,30
1915537,1494821,2025-02-19,House,"HOUSE BANKING AND CONSUMER AFFAIRS SUBCOMMITTEE: Rec. for pass by s/c ref. to Commerce Committee",5,0,0,0,5
1915537,1500274,2025-02-26,House,"HOUSE COMMERCE COMMITTEE: Rec. for pass; ref to Calendar & Rules Committee",20,0,0,0,20
1915537,1509215,2025-03-10,House,"HOUSE GOVERNMENT OPERATIONS COMMITTEE: Rec. for pass; ref to Calendar & Rules Committee",13,0,0,0,13
1915537,1525658,2025-03-24,House,"FLOOR VOTE: CONSENT CALENDAR PASSAGE ON THIRD CONSIDERATION",96,0,0,0,96
1915547,1500597,2025-02-26,House,"HOUSE CITIES & COUNTIES SUBCOMMITTEE: Rec. for pass by s/c ref. to State & Local Government Committee",7,0,0,0,7
1915547,1506148,2025-03-05,House,"HOUSE STATE & LOCAL GOVERNMENT COMMITTEE: Rec. for pass; ref to Finance, Ways, and Means Committee",23,0,0,0,23
1915583,1487289,2025-02-11,Senate,"SENATE JUDICIARY COMMITTEE: Recommended for passage, refer to Senate Calendar Committee",9,0,0,0,9
1915601,1516144,2025-03-12,House,"HOUSE FINANCE, WAYS, AND MEANS SUBCOMMITTEE: Rec. for pass by s/c ref. to Finance, Ways, and Means Committee",7,0,0,0,7
1915601,1526835,2025-03-25,House,"HOUSE FINANCE, WAYS, AND MEANS COMMITTEE: Rec. for pass. if am., ref. to Calendar & Rules Committee",24,0,0,0,24
1915601,1531692,2025-03-31,House,"FLOOR VOTE: REGULAR CALENDAR AS AMENDED PASSAGE ON THIRD CONSIDERATION",93,0,0,0,93
1915601,1548481,2025-04-14,Senate,"FLOOR VOTE: Motion to Adopt",32,0,0,0,32
1915611,1494614,2025-02-19,Senate,"SENATE ENERGY, AGRICULTURE AND NATURAL RESOURCES COMMITTEE: Recommended for passage, refer to Senate Calendar Committee",8,0,0,0,8
1915611,1497774,2025-02-24,Senate,"FLOOR VOTE: Motion to Adopt",33,0,0,0,33
1915611,1531570,2025-03-31,House,"FLOOR VOTE: REGULAR CALENDAR AS AMENDED PASSAGE ON THIRD CONSIDERATION",63,30,0,0,93
1915611,1531571,2025-03-31,House,"FLOOR VOTE: REGULAR CALENDAR LAY ON THE TABLE MOTION TO ADOPT AMENDMENT # 2 BY RENEAU PASSAGE ON THIRD CONSIDERATION",40,51,0,0,91
1915611,1531572,2025-03-31,House,"FLOOR VOTE: REGULAR CALENDAR MOTION TO ADOPT AMENDMENT # 2 BY RENEAU PASSAGE ON THIRD CONSIDERATION",44,46,0,0,90
1915611,1536121,2025-04-03,Senate,"FLOOR VOTE: Motion to Concur House Amendment # 1",26,3,1,0,30
1915630,1491827,2025-02-18,Senate,"SENATE STATE & LOCAL GOVERNMENT COMMITTEE: Recommended for passage, refer to Senate Calendar Committee",9,0,0,0,9
1915630,1498163,2025-02-24,Senate,"FLOOR VOTE: Motion to Adopt",33,0,0,0,33
1915630,1551419,2025-04-17,House,"FLOOR VOTE: REGULAR CALENDAR PASSAGE ON THIRD CONSIDERATION",76,15,4,0,95
1915652,1488054,2025-02-12,House,"FLOOR VOTE: CONSENT CALENDAR PASSAGE ON THIRD CONSIDERATION",90,0,1,0,91
1915664,1505817,2025-03-05,House,"HOUSE CRIMINAL JUSTICE SUBCOMMITTEE: Rec. for pass by s/c ref. to Judiciary Committee",8,0,0,0,8
1915664,1521637,2025-03-19,House,"HOUSE JUDICIARY COMMITTEE: Rec. for pass; ref to Calendar & Rules Committee",21,0,0,0,21
1915664,1525136,2025-03-24,House,"FLOOR VOTE: CONSENT CALENDAR PASSAGE ON THIRD CONSIDERATION",96,0,0,0,96
1915673,1500318,2025-02-26,House,"HOUSE FINANCE, WAYS, AND MEANS SUBCOMMITTEE: Rec. for pass by s/c ref. to Finance, Ways, and Means Committee",11,0,0,0,11
1915673,1505113,2025-03-04,House,"HOUSE FINANCE, WAYS, AND MEANS COMMITTEE: Rec. for pass; ref to Calendar & Rules Committee",23,0,0,0,23
1915673,1517483,2025-03-13,Senate,"FLOOR VOTE: Motion to Adopt",32,0,0,0,32
1915695,1491831,2025-02-18,Senate,"SENATE STATE & LOCAL GOVERNMENT COMMITTEE: Recommended for passage, refer to Senate Calendar Committee",8,0,1,0,9
1915695,1498165,2025-02-24,Senate,"FLOOR VOTE: Third Consideration",33,0,0,0,33
1915695,1503617,2025-03-03,House,"FLOOR VOTE: REGULAR CALENDAR PASSAGE ON THIRD CONSIDERATION",85,2,0,0,87
1915708,1497091,2025-02-12,House,"HOUSE HEALTH SUBCOMMITTEE: Rec. for pass by s/c ref. to Health Committee",9,0,0,0,9
1915708,1497092,2025-02-18,House,"HOUSE HEALTH COMMITTEE: Rec. for pass; ref to Calendar & Rules Committee",21,0,0,0,21
1915708,1497841,2025-02-24,House,"FLOOR VOTE: CONSENT CALENDAR PASSAGE ON THIRD CONSIDERATION",92,0,2,0,94
1915708,1513721,2025-03-10,Senate,"FLOOR VOTE: Motion to Adopt",30,0,0,0,30
1915728,1497095,2025-02-12,House,"HOUSE PUBLIC SERVICE SUBCOMMITTEE: Rec. for pass by s/c ref. to State & Local Government Committee",6,0,0,0,6
1915728,1497096,2025-02-19,House,"HOUSE STATE & LOCAL GOVERNMENT COMMITTEE: Rec. for pass; ref to Government Operations Committee",21,1,0,0,22
1915728,1497469,2025-02-24,House,"HOUSE GOVERNMENT OPERATIONS COMMITTEE: Rec. for pass; ref to Finance, Ways, and Means Committee",13,0,0,0,13
1915728,1506268,2025-03-05,House,"HOUSE FINANCE, WAYS, AND MEANS SUBCOMMITTEE: Rec. for pass by s/c ref. to Finance, Ways, and Means Committee",12,0,0,0,12
1915728,1515039,2025-03-11,House,"HOUSE FINANCE, WAYS, AND MEANS COMMITTEE: Rec. for pass; ref to Calendar & Rules Committee",25,0,0,0,25
1915735,1487363,2025-02-12,House,"FLOOR VOTE: CONSENT CALENDAR PASSAGE ON THIRD CONSIDERATION",90,0,1,0,91
1915750,1486536,2025-02-11,House,"HOUSE CHILDREN AND FAMILY AFFAIRS SUBCOMMITTEE: Rec. for pass by s/c ref. to Judiciary Committee",7,0,0,0,7
1915750,1494500,2025-02-19,House,"HOUSE JUDICIARY COMMITTEE: Rec. for pass; ref to Calendar & Rules Committee",20,0,0,0,20
1915750,1497708,2025-02-24,House,"FLOOR VOTE: CONSENT CALENDAR PASSAGE ON THIRD CONSIDERATION",92,0,2,0,94
1915750,1514661,2025-03-10,Senate,"FLOOR VOTE: Motion to Adopt",30,0,0,0,30
1915757,1515819,2025-03-12,House,"HOUSE CRIMINAL JUSTICE SUBCOMMITTEE: Rec. for pass by s/c ref. to Judiciary Committee",7,0,0,0,7
1915757,1540002,2025-04-08,House,"HOUSE JUDICIARY COMMITTEE: Rec. for pass; ref to Finance, Ways, and Means Committee",19,0,1,0,20
1915757,1551815,2025-04-17,House,"HOUSE FINANCE, WAYS, AND MEANS SUBCOMMITTEE: Rec. for pass by s/c ref. to Finance, Ways, and Means Committee",11,0,0,0,11
1915757,1553328,2025-04-17,House,"HOUSE FINANCE, WAYS, AND MEANS COMMITTEE: Rec. for pass; ref to Calendar & Rules Committee",27,0,0,0,27
1915757,1553329,2025-04-21,House,"FLOOR VOTE: REGULAR CALENDAR PASSAGE ON THIRD CONSIDERATION",91,0,1,0,92
1915757,1554755,2025-04-22,House,"FLOOR VOTE: MESSAGE CALENDAR 3 CONCUR IN SENATE AMENDMENT # 1",93,0,0,0,93
1915757,1556409,2025-04-22,Senate,"FLOOR VOTE: as Amended Third Consideration",33,0,0,0,33
1915773,1515831,2025-03-12,House,"HOUSE HEALTH SUBCOMMITTEE: Rec for pass if am by s/c ref. to Health Committee",9,0,0,0,9
1915773,1519781,2025-03-18,House,"HOUSE HEALTH COMMITTEE: Rec. for pass. if am., ref. to Calendar & Rules Committee",18,0,0,0,18
1915773,1534175,2025-04-02,House,"HOUSE FINANCE, WAYS, AND MEANS SUBCOMMITTEE: Rec. for pass by s/c ref. to Finance, Ways, and Means Committee",9,0,0,0,9
1915773,1547130,2025-04-14,House,"HOUSE FINANCE, WAYS, AND MEANS COMMITTEE: Rec. for pass. if am., ref. to Calendar & Rules Committee",25,0,0,0,25
1915801,1497089,2025-02-12,House,"HOUSE HEALTH SUBCOMMITTEE: Rec. for pass by s/c ref. to Health Committee",8,1,0,0,9
1915801,1497090,2025-02-18,House,"HOUSE HEALTH COMMITTEE: Rec. for pass; ref to Calendar & Rules Committee",21,0,0,0,21
1915801,1497847,2025-02-24,House,"FLOOR VOTE: CONSENT CALENDAR PASSAGE ON THIRD CONSIDERATION",92,0,2,0,94
1915801,1514637,2025-03-10,Senate,"FLOOR VOTE: Motion to Adopt",30,0,0,0,30
1915813,1491892,2025-02-18,Senate,"SENATE STATE & LOCAL GOVERNMENT COMMITTEE: Recommended for passage, refer to Senate Calendar Committee",9,0,0,0,9
1915813,1498181,2025-02-24,Senate,"FLOOR VOTE: Motion to Adopt",33,0,0,0,33
1915813,1501034,2025-02-27,House,"FLOOR VOTE: REGULAR CALENDAR PASSAGE ON THIRD CONSIDERATION",92,0,0,0,92
1915822,1504663,2025-03-04,Senate,"SENATE STATE & LOCAL GOVERNMENT COMMITTEE: Recommended for passage, refer to Senate Calendar Committee",9,0,0,0,9
1915822,1523002,2025-03-20,Senate,"FLOOR VOTE: Motion to Adopt",30,0,0,0,30
1915835,1521889,2025-03-19,House,"HOUSE AGRICULTURE AND NATURAL RESOURCES SUBCOMMITTEE: Rec. for pass by s/c ref. to Agriculture & Natural Resources Committee",7,0,1,0,8
1915835,1532212,2025-04-01,House,"HOUSE AGRICULTURE & NATURAL RESOURCES COMMITTEE: Rec. for pass; ref to Finance, Ways, and Means Committee",15,0,0,0,15
1915835,1542004,2025-04-09,House,"HOUSE FINANCE, WAYS, AND MEANS SUBCOMMITTEE: Rec. for pass by s/c ref. to Finance, Ways, and Means Committee",10,0,0,0,10
1915835,1547173,2025-04-14,House,"HOUSE FINANCE, WAYS, AND MEANS COMMITTEE: Rec. for pass; ref to Calendar & Rules Committee",25,0,1,0,26
1915841,1495188,2025-02-12,House,"HOUSE BANKING AND CONSUMER AFFAIRS SUBCOMMITTEE: Rec. for pass by s/c ref. to Commerce Committee",6,0,0,0,6
1915841,1499862,2025-02-26,House,"HOUSE COMMERCE COMMITTEE: Rec. for pass; ref to Calendar & Rules Committee",18,3,0,0,21
1915841,1504024,2025-03-03,House,"FLOOR VOTE: REGULAR CALENDAR PASSAGE ON THIRD CONSIDERATION",78,10,1,0,89
1915841,1517280,2025-03-13,Senate,"FLOOR VOTE: Third Consideration",26,5,1,0,32
1915854,1487359,2025-02-12,House,"INSURANCE SUBCOMMITTEE: Rec. for pass by s/c ref. to Insurance Committee",7,0,0,0,7
1915854,1500894,2025-02-26,House,"HOUSE INSURANCE COMMITTEE: Rec. for pass; ref to Calendar & Rules Committee",18,0,0,0,18
1915854,1509131,2025-03-10,House,"FLOOR VOTE: CONSENT CALENDAR PASSAGE ON THIRD CONSIDERATION",94,0,0,0,94
1915876,1487274,2025-02-11,Senate,"SENATE COMMERCE AND LABOR COMMITTEE: Recommended for passage, refer to Senate Calendar Committee",9,0,0,0,9
1915883,1494499,2025-02-19,Senate,"SENATE HEALTH AND WELFARE COMMITTEE: Recommended for passage, refer to Senate Calendar Committee",9,0,0,0,9
1915883,1498115,2025-02-24,Senate,"FLOOR VOTE: Motion to Adopt",33,0,0,0,33
1915883,1550080,2025-04-16,House,"FLOOR VOTE: REGULAR CALENDAR PASSAGE ON THIRD CONSIDERATION",95,0,0,0,95
1915902,1471738,2025-01-15,House,"FLOOR VOTE: CONSENT CALENDAR PASSAGE ON THIRD CONSIDERATION",95,0,0,0,95
1915998,1471740,2025-01-15,House,"FLOOR VOTE: CONSENT CALENDAR PASSAGE ON THIRD CONSIDERATION",95,0,0,0,95
1916099,1471751,2025-01-15,House,"FLOOR VOTE: CONSENT CALENDAR PASSAGE ON THIRD CONSIDERATION",95,0,0,0,95
1916201,1525953,2025-03-25,House,"HOUSE K-12 SUBCOMMITTEE: Rec for pass if am by s/c ref. to Education Committee",4,1,0,0,5
1916201,1534825,2025-04-02,House,"HOUSE EDUCATION COMMITTEE: Rec. for pass. if am., ref. to Finance, Ways, and Means Committee",19,0,0,0,19
1916505,1472315,2025-01-15,House,"FLOOR VOTE: CONSENT CALENDAR PASSAGE ON THIRD CONSIDERATION",95,0,0,0,95
1917051,1487771,2025-02-11,Senate,"SENATE JUDICIARY COMMITTEE: Recommended for adoption by Senate Judiciary Committee, refer Senate Calendar Committee",9,0,0,0,9
1917149,1500111,2025-02-26,House,"HOUSE CITIES & COUNTIES SUBCOMMITTEE: Rec. for pass by s/c ref. to State & Local Government Committee",7,0,0,0,7
1917149,1527777,2025-03-26,House,"HOUSE STATE & LOCAL GOVERNMENT COMMITTEE: Rec. for pass; ref to Calendar & Rules Committee",21,0,0,0,21
1917149,1531193,2025-03-31,House,"FLOOR VOTE: CONSENT CALENDAR PASSAGE ON THIRD CONSIDERATION",93,0,2,0,95
1917191,1522384,2025-03-19,Senate,"SENATE EDUCATION COMMITTEE: Recommended for passage with amendment/s, refer to Senate Calendar Committee Ayes 7, Nays 0 PNV 0",7,0,0,0,7
1917191,1525848,2025-03-24,Senate,"FLOOR VOTE: as Amended Third Consideration",33,0,0,0,33
1917191,1531548,2025-03-31,House,"FLOOR VOTE: REGULAR CALENDAR PASSAGE ON THIRD CONSIDERATION",95,0,0,0,95
1917231,1471991,2025-01-16,House,"FLOOR VOTE: REGULAR CALENDAR MOTION TO ADOPT",78,13,0,0,91
1917231,1471992,2025-01-16,House,"FLOOR VOTE: REGULAR CALENDAR PREVIOUS QUESTION MOTION TO ADOPT",75,18,0,0,93
1917266,1515914,2025-03-12,House,"HOUSE BANKING AND CONSUMER AFFAIRS SUBCOMMITTEE: Rec. for pass by s/c ref. to Commerce Committee",5,0,0,0,5
1917266,1520948,2025-03-19,House,"HOUSE COMMERCE COMMITTEE: Rec. for pass; ref to Calendar & Rules Committee",23,0,0,0,23
1917383,1513225,2025-03-11,House,"HOUSE DEPARTMENTS & AGENCIES SUBCOMMITTEE: Rec. for pass by s/c ref. to State & Local Government Committee",7,0,0,0,7
1917383,1542739,2025-04-09,House,"HOUSE STATE & LOCAL GOVERNMENT COMMITTEE: Rec. for pass; ref to Calendar & Rules Committee",20,0,1,0,21
1917418,1528423,2025-03-26,Senate,"SENATE ENERGY, AGRICULTURE AND NATURAL RESOURCES COMMITTEE: Recommended for passage with amendment/s, refer to Senate Calendar Committee Ayes 6, Nays 1 PNV 2",6,1,2,0,9
1917418,1549647,2025-04-15,Senate,"FLOOR VOTE: as Amended Third Consideration",28,2,1,0,31
1917418,1550716,2025-04-16,House,"FLOOR VOTE: REGULAR CALENDAR PASSAGE ON THIRD CONSIDERATION",65,24,4,0,93
1917458,1504594,2025-03-04,Senate,"SENATE STATE & LOCAL GOVERNMENT COMMITTEE: Recommended for passage with amendment/s, refer to Senate Finance, Ways, and Means Committee Ayes 9, Nays 0 PNV 0",9,0,0,0,9
1917458,1539740,2025-04-08,Senate,"SENATE FINANCE, WAYS AND MEANS COMMITTEE: Recommended for passage, refer to Senate Calendar Committee",8,1,0,0,9
1917498,1528041,2025-03-26,House,"HOUSE BANKING AND CONSUMER AFFAIRS SUBCOMMITTEE: Failed in s/c Banking and Consumer Affairs Subcommittee of Commerce Committee",2,2,0,0,4
1917602,1500195,2025-02-26,Senate,"SENATE ENERGY, AGRICULTURE AND NATURAL RESOURCES COMMITTEE: Recommended for passage, refer to Senate Calendar Committee",7,0,2,0,9
1917637,1471745,2025-01-15,House,"FLOOR VOTE: CONSENT CALENDAR PASSAGE ON THIRD CONSIDERATION",95,0,0,0,95
1917879,1471867,2025-01-15,House,"FLOOR VOTE: CONSENT CALENDAR PASSAGE ON THIRD CONSIDERATION",95,0,0,0,95
1917922,1504189,2025-03-04,House,"HOUSE TENNCARE SUBCOMMITTEE: Rec. for pass by s/c ref. to Insurance Committee",7,0,0,0,7
1917922,1516590,2025-03-12,House,"HOUSE INSURANCE COMMITTEE: Rec. for pass; ref to Finance, Ways, and Means Committee",17,0,0,0,17
1917975,1526444,2025-03-25,House,"HOUSE EDUCATION COMMITTEE: Rec. for pass; ref to Finance, Ways, and Means Committee",18,0,0,0,18
1918025,1515935,2025-03-12,Senate,"TRANSPORTATION AND SAFETY COMMITTEE: Recommended for passage with amendment/s, refer to Senate Calendar Committee Ayes 9, Nays 0 PNV 0",9,0,0,0,9
1918025,1531951,2025-03-31,Senate,"FLOOR VOTE: as Amended Third Consideration",29,0,0,0,29
1918163,1528477,2025-03-26,Senate,"SENATE EDUCATION COMMITTEE: Recommended for passage with amendment/s, refer to Senate Calendar Committee Ayes 9, Nays 0 PNV 0",9,0,0,0,9
1918163,1536074,2025-04-03,Senate,"FLOOR VOTE: as Amended Third Consideration",28,0,1,0,29
1918163,1550647,2025-04-16,House,"FLOOR VOTE: REGULAR CALENDAR PASSAGE ON THIRD CONSIDERATION",58,28,6,0,92
1918163,1550648,2025-04-16,House,"FLOOR VOTE: REGULAR CALENDAR PREVIOUS QUESTION PASSAGE ON THIRD CONSIDERATION",65,27,0,0,92
1918258,1490083,2025-02-12,Senate,"SENATE HEALTH AND WELFARE COMMITTEE: Recommended for passage, refer to Senate Finance, Ways, and Means Committee",9,0,0,0,9
1918305,1521458,2025-03-19,Senate,"SENATE HEALTH AND WELFARE COMMITTEE: Recommended for adoption by Senate Health and Welfare Committee, refer Senate Calendar Committee",9,0,0,0,9
1918305,1526419,2025-03-24,Senate,"FLOOR VOTE: Motion to Adopt",32,0,0,0,32
1918394,1534376,2025-04-02,Senate,"SENATE STATE & LOCAL GOVERNMENT COMMITTEE: Recommended for passage with amendment/s, refer to Senate Finance, Ways, and Means Committee Ayes 7, Nays 0 PNV 0",7,0,0,0,7
1918394,1548924,2025-04-15,Senate,"SENATE FINANCE, WAYS AND MEANS COMMITTEE: Recommended for passage, refer to Senate Calendar Committee",10,0,0,0,10
1918441,1534510,2025-04-02,Senate,"SENATE STATE & LOCAL GOVERNMENT COMMITTEE: Recommended for passage with amendment/s, refer to Senate Calendar Committee Ayes 8, Nays 1 PNV 0",8,1,0,0,9
1918441,1541491,2025-04-09,Senate,"FLOOR VOTE: as Amended Third Consideration",28,2,0,0,30
1918441,1553546,2025-04-21,House,"FLOOR VOTE: REGULAR CALENDAR PASSAGE ON THIRD CONSIDERATION",77,10,5,0,92
1918496,1505871,2025-03-05,Senate,"TRANSPORTATION AND SAFETY COMMITTEE: Recommended for passage with amendment/s, refer to Senate Finance, Ways, and Means Committee Ayes 8, Nays 0 PNV 1",8,0,1,0,9
1918496,1553048,2025-04-21,Senate,"SENATE FINANCE, WAYS AND MEANS COMMITTEE: Recommended for passage with amendment/s, refer to Senate Calendar Committee Ayes 11, Nays 0 PNV 0",11,0,0,0,11
1918578,1506208,2025-03-05,House,"HOUSE CITIES & COUNTIES SUBCOMMITTEE: Rec for pass if am by s/c ref. to State & Local Government Committee",4,3,0,0,7
1918578,1542674,2025-04-09,House,"HOUSE STATE & LOCAL GOVERNMENT COMMITTEE: Rec. for pass. if am., ref. to Finance, Ways, and Means Committee",18,3,0,0,21
1918578,1547014,2025-04-14,House,"HOUSE FINANCE, WAYS, AND MEANS SUBCOMMITTEE: Rec. for pass by s/c ref. to Finance, Ways, and Means Committee",12,0,0,0,12
1918578,1548902,2025-04-15,House,"HOUSE FINANCE, WAYS, AND MEANS COMMITTEE: Rec. for pass; ref to Calendar & Rules Committee",24,0,0,0,24
1918666,1522349,2025-03-19,Senate,"SENATE EDUCATION COMMITTEE: Recommended for passage, refer to Senate Calendar Committee",7,0,0,0,7
1918713,1520985,2025-03-19,Senate,"TRANSPORTATION AND SAFETY COMMITTEE: Recommended for passage with amendment/s, refer to Senate Calendar Committee Ayes 9, Nays 0 PNV 0",9,0,0,0,9
1918713,1526070,2025-03-24,Senate,"FLOOR VOTE: as Amended Third Consideration",33,0,0,0,33
1918713,1553452,2025-04-21,House,"FLOOR VOTE: REGULAR CALENDAR PASSAGE ON THIRD CONSIDERATION",93,0,0,0,93
1918802,1487794,2025-02-12,House,"HOUSE CITIES & COUNTIES SUBCOMMITTEE: Rec. for pass by s/c ref. to State & Local Government Committee",7,0,0,0,7
1918802,1494541,2025-02-19,House,"HOUSE STATE & LOCAL GOVERNMENT COMMITTEE: Rec. for pass; ref to Calendar & Rules Committee",21,0,0,0,21
1918802,1501044,2025-02-27,House,"FLOOR VOTE: REGULAR CALENDAR MOTION TO ADOPT",94,0,0,0,94
1918802,1534368,2025-04-02,Senate,"SENATE STATE & LOCAL GOVERNMENT COMMITTEE: Recommended for concurrence by Senate State and Local Government Committee, refer Senate Calendar Committee",9,0,0,0,9
1918802,1539428,2025-04-07,Senate,"FLOOR VOTE: Motion to Adopt",31,0,0,0,31
1918978,1516048,2025-03-11,Senate,"SENATE STATE & LOCAL GOVERNMENT COMMITTEE: Recommended for passage, refer to Senate Finance, Ways, and Means Committee",8,0,0,0,8
1919020,1500221,2025-02-26,House,"HOUSE HEALTH SUBCOMMITTEE: Rec for pass if am by s/c ref. to Health Committee",9,0,0,0,9
1919020,1504788,2025-03-04,House,"HOUSE HEALTH COMMITTEE: Rec. for pass. if am., ref. to Calendar & Rules Committee",18,0,1,0,19
1919343,1507446,2025-03-05,Senate,"SENATE EDUCATION COMMITTEE: Recommended for passage with amdt, refer to Senate Calendar Committee",8,1,0,0,9
1919343,1513193,2025-03-10,Senate,"FLOOR VOTE: as Amended Third Consideration",28,1,0,0,29
1919343,1513194,2025-03-10,Senate,"FLOOR VOTE: as Amended Third Consideration",28,1,0,0,29
1919343,1548552,2025-04-15,House,"FLOOR VOTE: REGULAR CALENDAR PASSAGE ON THIRD CONSIDERATION",95,0,0,0,95
1919397,1471969,2025-01-16,House,"FLOOR VOTE: CONSENT CALENDAR PASSAGE ON THIRD CONSIDERATION",93,0,0,0,93
1919415,1478997,2025-02-03,House,"FLOOR VOTE: CONSENT CALENDAR PASSAGE ON THIRD CONSIDERATION",91,0,0,0,91
1919435,1483232,2025-02-05,House,"FLOOR VOTE: REGULAR CALENDAR REFER TO COMMITTEE",52,30,4,0,86
1919435,1503551,2025-03-03,House,"HOUSE NAMING & DESIGNATING COMMITTEE: Rec. for pass; ref to State & Local Government Committee",9,0,1,0,10
1919435,1527732,2025-03-26,House,"HOUSE STATE & LOCAL GOVERNMENT COMMITTEE: Rec. for pass; ref to Calendar & Rules Committee",22,0,0,0,22
1919435,1531156,2025-03-31,House,"FLOOR VOTE: REGULAR CALENDAR AS AMENDED MOTION TO CONCUR",93,0,0,0,93
1919435,1535773,2025-04-03,Senate,"FLOOR VOTE: Motion to Concur House Amendment # 1",31,0,0,0,31
1919450,1526605,2025-03-25,Senate,"SENATE STATE & LOCAL GOVERNMENT COMMITTEE: Recommended for passage with amendment, refer to Senate Calendar Committee",7,1,1,0,9
1919467,1478950,2025-02-03,House,"FLOOR VOTE: CONSENT CALENDAR PASSAGE ON THIRD CONSIDERATION",91,0,0,0,91
1919500,1494571,2025-02-19,House,"HOUSE HEALTH SUBCOMMITTEE: Rec. for pass by s/c ref. to Health Committee",9,0,0,0,9
1919500,1499282,2025-02-25,House,"HOUSE HEALTH COMMITTEE: Rec. for pass; ref to Calendar & Rules Committee",21,0,0,0,21
1919500,1503573,2025-03-03,House,"FLOOR VOTE: CONSENT CALENDAR PASSAGE ON THIRD CONSIDERATION",89,0,0,0,89
1919500,1519354,2025-03-17,Senate,"FLOOR VOTE: Motion to Adopt",32,0,0,0,32
1919519,1478995,2025-02-03,House,"FLOOR VOTE: CONSENT CALENDAR PASSAGE ON THIRD CONSIDERATION",91,0,0,0,91
1919538,1472013,2025-01-16,House,"FLOOR VOTE: CONSENT CALENDAR PASSAGE ON THIRD CONSIDERATION",93,0,0,0,93
1919554,1526451,2025-03-25,Senate,"SENATE STATE & LOCAL GOVERNMENT COMMITTEE: Recommended for passage with amendment, refer to Senate Calendar Committee",9,0,0,0,9
1919554,1531963,2025-03-31,Senate,"FLOOR VOTE: as Amended Third Consideration",28,0,0,0,28
1919554,1553256,2025-04-21,House,"FLOOR VOTE: REGULAR CALENDAR PASSAGE ON THIRD CONSIDERATION",92,0,0,0,92
1919585,1528114,2025-03-26,Senate,"SENATE HEALTH AND WELFARE COMMITTEE: Recommended for passage, refer to Senate Calendar Committee",9,0,0,0,9
1919585,1531936,2025-03-31,Senate,"FLOOR VOTE: Motion to Adopt",30,0,0,0,30
1919604,1472050,2025-01-16,House,"FLOOR VOTE: CONSENT CALENDAR PASSAGE ON THIRD CONSIDERATION",93,0,0,0,93
1919620,1516849,2025-03-12,Senate,"SENATE EDUCATION COMMITTEE: Recommended for passage with amendment/s, refer to Senate Finance, Ways, and Means Committee Ayes 6, Nays 3 PNV 0",6,3,0,0,9
1919640,1528488,2025-03-26,Senate,"SENATE EDUCATION COMMITTEE: Recommended for passage with amendment/s, refer to Senate Calendar Committee Ayes 8, Nays 0 PNV 1",8,0,1,0,9
1919640,1536206,2025-04-03,Senate,"FLOOR VOTE: as Amended Third Consideration",29,0,0,0,29
1919640,1550052,2025-04-16,House,"FLOOR VOTE: REGULAR CALENDAR AS AMENDED PASSAGE ON THIRD CONSIDERATION",86,1,6,0,93
1919640,1552418,2025-04-17,Senate,"FLOOR VOTE: Motion to Concur House Amendment # 2",33,0,0,0,33
1919654,1541253,2025-04-08,Senate,"SENATE JUDICIARY COMMITTEE: Recommended for passage with amendment/s, refer to Senate Finance, Ways, and Means Committee Ayes 7, Nays 1 PNV 0",7,1,0,0,8
1919690,1532330,2025-04-01,Senate,"SENATE STATE & LOCAL GOVERNMENT COMMITTEE: Recommended for passage, refer to Senate Calendar Committee",7,0,0,0,7
1919690,1548928,2025-04-15,Senate,"SENATE FINANCE, WAYS AND MEANS COMMITTEE: Recommended for passage, refer to Senate Calendar Committee",9,0,0,0,9
1919690,1552986,2025-04-21,Senate,"FLOOR VOTE: Motion to Adopt",33,0,0,0,33
1919707,1471963,2025-01-16,House,"FLOOR VOTE: CONSENT CALENDAR PASSAGE ON THIRD CONSIDERATION",93,0,0,0,93
1919755,1513594,2025-03-11,House,"HOUSE DEPARTMENTS & AGENCIES SUBCOMMITTEE: Rec. for pass by s/c ref. to State & Local Government Committee",7,0,0,0,7
1919755,1542054,2025-04-09,House,"HOUSE STATE & LOCAL GOVERNMENT COMMITTEE: Rec. for pass; ref to Finance, Ways, and Means Committee",20,1,0,0,21
1919755,1551907,2025-04-17,House,"HOUSE FINANCE, WAYS, AND MEANS SUBCOMMITTEE: Rec. for pass by s/c ref. to Finance, Ways, and Means Committee",11,0,0,0,11
1919755,1553463,2025-04-17,House,"HOUSE FINANCE, WAYS, AND MEANS COMMITTEE: Rec. for pass; ref to Calendar & Rules Committee",27,0,0,0,27
1919755,1553464,2025-04-21,House,"FLOOR VOTE: REGULAR CALENDAR PASSAGE ON THIRD CONSIDERATION",77,15,3,0,95
1919755,1556531,2025-04-22,Senate,"FLOOR VOTE: Third Consideration",28,0,3,0,31
1919775,1479142,2025-02-03,House,"FLOOR VOTE: CONSENT CALENDAR PASSAGE ON THIRD CONSIDERATION",91,0,0,0,91
1919877,1472053,2025-01-16,House,"FLOOR VOTE: CONSENT CALENDAR PASSAGE ON THIRD CONSIDERATION",93,0,0,0,93
1919910,1487548,2025-02-12,House,"INSURANCE SUBCOMMITTEE: Rec. for pass by s/c ref. to Insurance Committee",6,0,0,0,6
1919910,1500292,2025-02-26,House,"HOUSE INSURANCE COMMITTEE: Rec. for pass; ref to Calendar & Rules Committee",18,0,0,0,18
1919910,1511971,2025-03-10,House,"FLOOR VOTE: CONSENT CALENDAR PASSAGE ON THIRD CONSIDERATION",94,0,0,0,94
1920013,1521763,2025-03-19,House,"HOUSE AGRICULTURE AND NATURAL RESOURCES SUBCOMMITTEE: Rec. for pass by s/c ref. to Agriculture & Natural Resources Committee",7,0,1,0,8
1920013,1532131,2025-04-01,House,"HOUSE AGRICULTURE & NATURAL RESOURCES COMMITTEE: Rec. for pass; ref to Government Operations Committee",15,0,0,0,15
1920013,1549784,2025-04-16,House,"HOUSE GOVERNMENT OPERATIONS COMMITTEE: Rec. for pass; ref to Calendar & Rules Committee",13,0,0,0,13
1920013,1553038,2025-04-21,Senate,"FLOOR VOTE: Third Consideration",32,0,0,0,32
1920013,1553357,2025-04-21,House,"FLOOR VOTE: CONSENT CALENDAR PASSAGE ON THIRD CONSIDERATION",86,0,1,0,87
1920034,1483681,2025-02-05,House,"FLOOR VOTE: REGULAR CALENDAR MOTION TO CONCUR",83,5,0,0,88
1920070,1471977,2025-01-16,House,"FLOOR VOTE: CONSENT CALENDAR PASSAGE ON THIRD CONSIDERATION",93,0,0,0,93
1920080,1516467,2025-03-12,House,"HOUSE CITIES & COUNTIES SUBCOMMITTEE: Failed in s/c Cities & Counties Subcommittee of State & Local Government Committee",2,5,0,0,7
1920117,1479035,2025-02-03,House,"FLOOR VOTE: CONSENT CALENDAR PASSAGE ON THIRD CONSIDERATION",91,0,0,0,91
1920133,1527208,2025-03-25,Senate,"SENATE COMMERCE AND LABOR COMMITTEE: Recommended for passage with amendment/s, refer to Senate Finance, Ways, and Means Committee Ayes 8, Nays 0 PNV 1",8,0,1,0,9
1920157,1519703,2025-03-18,Senate,"SENATE STATE & LOCAL GOVERNMENT COMMITTEE: Failed in Senate State and Local Government Committee",3,0,6,0,9
1920169,1527229,2025-03-25,Senate,"SENATE COMMERCE AND LABOR COMMITTEE: Recommended for passage, refer to Senate Finance, Ways, and Means Committee",8,1,0,0,9
1920181,1507064,2025-03-05,Senate,"SENATE EDUCATION COMMITTEE: Recommended for passage, refer to Senate Finance, Ways, and Means Committee",8,0,0,0,8
1920210,1533284,2025-04-01,Senate,"SENATE STATE & LOCAL GOVERNMENT COMMITTEE: Recommended for passage with amendment/s, refer to Senate Government Operations Committee Ayes 6, Nays 0 PNV 0",6,0,0,0,6
1920210,1542659,2025-04-09,Senate,"SENATE GOVERNMENT OPERATIONS COMMITTEE: Recommended for passage, refer to Senate Calendar Committee",9,0,0,0,9
1920210,1548095,2025-04-14,Senate,"FLOOR VOTE: as Amended Third Consideration",31,0,0,0,31
1920210,1549206,2025-04-15,House,"FLOOR VOTE: REGULAR CALENDAR PASSAGE ON THIRD CONSIDERATION",97,0,0,0,97
1920233,1505835,2025-03-05,House,"INSURANCE SUBCOMMITTEE: Rec for pass if am by s/c ref. to Insurance Committee",5,0,0,0,5
1920233,1516561,2025-03-12,House,"HOUSE INSURANCE COMMITTEE: Rec. for pass. if am., ref. to Calendar & Rules Committee",16,0,0,0,16
1920250,1522089,2025-03-19,House,"HOUSE AGRICULTURE AND NATURAL RESOURCES SUBCOMMITTEE: Rec for pass if am by s/c ref. to Agriculture & Natural Resources Committee",6,3,0,0,9
1920250,1526693,2025-03-25,House,"HOUSE AGRICULTURE & NATURAL RESOURCES COMMITTEE: Rec. for pass. if am., ref. to Health Committee",10,6,0,0,16
1920250,1533221,2025-04-01,House,"HOUSE HEALTH COMMITTEE: Rec. for pass; ref to Government Operations Committee",15,6,2,0,23
1920250,1538337,2025-04-07,House,"HOUSE GOVERNMENT OPERATIONS COMMITTEE: Rec. for pass; ref to Calendar & Rules Committee",13,2,0,0,15
1920276,1471980,2025-01-16,House,"FLOOR VOTE: CONSENT CALENDAR PASSAGE ON THIRD CONSIDERATION",93,0,0,0,93
1920289,1516852,2025-03-12,Senate,"SENATE EDUCATION COMMITTEE: Recommended for passage with amendment/s, refer to Senate Calendar Committee Ayes 9, Nays 0 PNV 0",9,0,0,0,9
1920289,1522700,2025-03-20,Senate,"FLOOR VOTE: as Amended Third Consideration",32,0,0,0,32
1920289,1538592,2025-04-07,House,"FLOOR VOTE: REGULAR CALENDAR PASSAGE ON THIRD CONSIDERATION",94,0,1,0,95
1920302,1504362,2025-03-04,House,"HOUSE TENNCARE SUBCOMMITTEE: Rec for pass if am by s/c ref. to Insurance Committee",7,0,0,0,7
1920302,1516534,2025-03-12,House,"HOUSE INSURANCE COMMITTEE: Rec. for pass. if am., ref. to Finance, Ways, and Means Committee",16,0,0,0,16
1920302,1534106,2025-04-02,House,"HOUSE FINANCE, WAYS, AND MEANS SUBCOMMITTEE: Rec. for pass by s/c ref. to Finance, Ways, and Means Committee",11,0,0,0,11
1920302,1540080,2025-04-08,House,"HOUSE FINANCE, WAYS, AND MEANS COMMITTEE: Rec. for pass; ref to Calendar & Rules Committee",28,0,0,0,28
1920316,1494867,2025-02-12,House,"HOUSE BUSINESS AND UTILITIES SUBCOMMITTEE: Rec. for pass by s/c ref. to Commerce Committee",10,0,0,0,10
1920316,1499973,2025-02-26,House,"HOUSE COMMERCE COMMITTEE: Rec. for pass; ref to Calendar & Rules Committee",21,0,0,0,21
1920316,1504092,2025-03-03,House,"FLOOR VOTE: CONSENT CALENDAR PASSAGE ON THIRD CONSIDERATION",89,0,0,0,89
1920344,1519677,2025-03-18,Senate,"SENATE STATE & LOCAL GOVERNMENT COMMITTEE: Recommended for passage with amendment/s, refer to Senate Finance, Ways, and Means Committee Ayes 9, Nays 0 PNV 0",9,0,0,0,9
1920344,1552969,2025-04-21,Senate,"SENATE FINANCE, WAYS AND MEANS COMMITTEE: Recommended for passage with amendment/s, refer to Senate Calendar Committee Ayes 10, Nays 0 PNV 0",10,0,0,0,10
1920356,1487736,2025-02-11,Senate,"SENATE COMMERCE AND LABOR COMMITTEE: Recommended for passage, refer to Senate Calendar Committee",9,0,0,0,9
1920366,1519619,2025-03-18,Senate,"SENATE STATE & LOCAL GOVERNMENT COMMITTEE: Recommended for passage with amendment/s, refer to Senate Calendar Committee Ayes 7, Nays 2 PNV 0",7,2,0,0,9
1920458,1526293,2025-03-25,House,"HOUSE DEPARTMENTS & AGENCIES SUBCOMMITTEE: Rec for pass if am by s/c ref. to State & Local Government Committee",7,1,0,0,8
1920470,1516019,2025-03-12,Senate,"SENATE ENERGY, AGRICULTURE AND NATURAL RESOURCES COMMITTEE: Recommended for passage, refer to Senate Calendar Committee",8,0,1,0,9
1920470,1519443,2025-03-17,Senate,"FLOOR VOTE: Third Consideration",29,0,0,0,29
1920482,1509250,2025-03-10,House,"FLOOR VOTE: MOTION TO SUSPEND THE RULES",22,65,0,0,87
1920579,1471993,2025-01-16,House,"FLOOR VOTE: CONSENT CALENDAR PASSAGE ON THIRD CONSIDERATION",93,0,0,0,93
1920592,1504718,2025-03-04,Senate,"SENATE COMMERCE AND LABOR COMMITTEE: Recommended for passage, refer to Senate Health and Welfare Committee",7,0,0,0,7
1920592,1528061,2025-03-26,Senate,"SENATE HEALTH AND WELFARE COMMITTEE: Recommended for passage, refer to Senate Finance, Ways, and Means Committee",9,0,0,0,9
1920607,1505688,2025-03-05,House,"HOUSE CRIMINAL JUSTICE SUBCOMMITTEE: Rec. for pass by s/c ref. to Judiciary Committee",9,0,0,0,9
1920634,1472035,2025-01-16,House,"FLOOR VOTE: CONSENT CALENDAR PASSAGE ON THIRD CONSIDERATION",93,0,0,0,93
1920645,1471922,2025-01-16,House,"FLOOR VOTE: CONSENT CALENDAR PASSAGE ON THIRD CONSIDERATION",93,0,0,0,93
1920657,1519770,2025-03-18,House,"HOUSE TENNCARE SUBCOMMITTEE: Rec. for pass by s/c ref. to Insurance Committee",4,0,0,0,4
1920657,1534266,2025-04-02,House,"HOUSE INSURANCE COMMITTEE: Rec. for pass; ref to Finance, Ways, and Means Committee",14,0,0,0,14
1920697,1490569,2025-02-12,Senate,"SENATE HEALTH AND WELFARE COMMITTEE: Recommended for passage, refer to Senate Calendar Committee",9,0,0,0,9
1920697,1517542,2025-03-13,House,"FLOOR VOTE: REGULAR CALENDAR PASSAGE ON THIRD CONSIDERATION",89,0,1,0,90
1920710,1534023,2025-04-01,Senate,"SENATE JUDICIARY COMMITTEE: Recommended for passage with amendment/s, refer to Senate Calendar Committee Ayes 7, Nays 0 PNV 1",7,0,1,0,8
1920747,1515886,2025-03-12,Senate,"SENATE GOVERNMENT OPERATIONS COMMITTEE: Recommended for passage, refer to Senate Calendar Committee",9,0,0,0,9
1920747,1519641,2025-03-17,Senate,"FLOOR VOTE: Motion to Adopt",32,0,0,0,32
1920747,1549168,2025-04-15,House,"FLOOR VOTE: REGULAR CALENDAR PASSAGE ON THIRD CONSIDERATION",88,3,1,0,92
1920758,1504745,2025-03-04,House,"HOUSE EDUCATION INSTRUCTION SUBCOMMITTEE: Rec for pass if am by s/c ref. to Education Committee",4,1,0,0,5
1920758,1534833,2025-04-02,House,"HOUSE EDUCATION COMMITTEE: Rec. for pass. if am., ref. to Calendar & Rules Committee",15,4,0,0,19
1921107,1487829,2025-02-12,House,"HOUSE CITIES & COUNTIES SUBCOMMITTEE: Rec. for pass by s/c ref. to State & Local Government Committee",7,0,0,0,7
1921107,1494523,2025-02-19,House,"HOUSE STATE & LOCAL GOVERNMENT COMMITTEE: Rec. for pass; ref to Calendar & Rules Committee",22,0,0,0,22
1921107,1503558,2025-03-03,House,"FLOOR VOTE: CONSENT CALENDAR PASSAGE ON THIRD CONSIDERATION",89,0,0,0,89
1921369,1471974,2025-01-16,House,"FLOOR VOTE: CONSENT CALENDAR PASSAGE ON THIRD CONSIDERATION",93,0,0,0,93
1921897,1499728,2025-02-25,Senate,"SENATE JUDICIARY COMMITTEE: Recommended for adoption by Senate Judiciary Committee, refer Senate Calendar Committee",6,3,0,0,9
1921897,1519403,2025-03-17,Senate,"FLOOR VOTE: Motion to Adopt",23,6,1,0,30
1921897,1554085,2025-04-21,House,"FLOOR VOTE: REGULAR CALENDAR MOTION TO CONCUR",84,10,1,0,95
1921897,1554086,2025-04-21,House,"FLOOR VOTE: REGULAR CALENDAR PREVIOUS QUESTION MOTION TO CONCUR",71,22,0,0,93
1922699,1520791,2025-03-19,Senate,"TRANSPORTATION AND SAFETY COMMITTEE: Recommended for passage with amendment/s, refer to Senate Finance, Ways, and Means Committee Ayes 9, Nays 0 PNV 0",9,0,0,0,9
1922699,1549750,2025-04-16,Senate,"SENATE FINANCE, WAYS AND MEANS COMMITTEE: Recommended for passage, refer to Senate Calendar Committee",11,0,0,0,11
1922893,1540662,2025-04-08,Senate,"SENATE FINANCE, WAYS AND MEANS COMMITTEE: Recommended for adoption by Senate Finance, Ways, and Means Committee, refer Senate Calendar Committee",10,1,0,0,11
1922893,1551058,2025-04-16,Senate,"FLOOR VOTE: Motion to Adopt Third Consideration",28,3,2,0,33
1923020,1494529,2025-02-11,House,"HOUSE K-12 SUBCOMMITTEE: Rec. for pass by s/c ref. to Education Committee",8,0,0,0,8
1923020,1494530,2025-02-18,House,"HOUSE EDUCATION COMMITTEE: Rec. for pass; ref to Calendar & Rules Committee",18,0,0,0,18
1923088,1500806,2025-02-26,House,"HOUSE HEALTH SUBCOMMITTEE: Rec. for pass by s/c ref. to Health Committee",9,0,0,0,9
1923088,1505147,2025-03-04,House,"HOUSE HEALTH COMMITTEE: Rec. for pass; ref to Calendar & Rules Committee",18,0,0,0,18
1923154,1521014,2025-03-19,Senate,"TRANSPORTATION AND SAFETY COMMITTEE: Recommended for passage with amendment/s, refer to Senate Calendar Committee Ayes 9, Nays 0 PNV 0",9,0,0,0,9
1923154,1525855,2025-03-24,Senate,"FLOOR VOTE: as Amended Third Consideration",32,0,0,0,32
1923154,1548271,2025-04-14,House,"FLOOR VOTE: REGULAR CALENDAR AS AMENDED PASSAGE ON THIRD CONSIDERATION",96,0,0,0,96
1923154,1548272,2025-04-14,House,"FLOOR VOTE: REGULAR CALENDAR MOTION TO ADOPT AMENDMENT # 3 BY RUSSELL PASSAGE ON THIRD CONSIDERATION",95,0,0,0,95
1923154,1551144,2025-04-16,Senate,"FLOOR VOTE: Motion to Concur House Amendment # 1",31,0,0,0,31
1923154,1551145,2025-04-16,Senate,"FLOOR VOTE: Motion to Concur House Amendment # 2",31,0,0,0,31
1923154,1551146,2025-04-16,Senate,"FLOOR VOTE: Motion to Concur House Amendment # 3",31,0,0,0,31
1923233,1497109,2025-02-12,House,"HOUSE CRIMINAL JUSTICE SUBCOMMITTEE: Rec. for pass by s/c ref. to Judiciary Committee",7,2,0,0,9
1923233,1500049,2025-02-26,House,"HOUSE JUDICIARY COMMITTEE: Rec. for pass; ref to Finance, Ways, and Means Committee",17,2,2,0,21
1923233,1541581,2025-04-09,House,"HOUSE FINANCE, WAYS, AND MEANS SUBCOMMITTEE: Rec. for pass by s/c ref. to Finance, Ways, and Means Committee",12,0,0,0,12
1923233,1546945,2025-04-14,House,"HOUSE FINANCE, WAYS, AND MEANS COMMITTEE: Rec. for pass; ref to Calendar & Rules Committee",26,0,0,0,26
1923233,1548794,2025-04-16,House,"HOUSE CALENDAR & RULES COMMITTEE: H. Placed on Regular Calendar for 4/16/2025 4/15/2025",0,1,0,0,1
1923263,1494630,2025-02-19,House,"HOUSE HEALTH SUBCOMMITTEE: Rec. for pass by s/c ref. to Health Committee",9,0,0,0,9
1923263,1499218,2025-02-25,House,"HOUSE HEALTH COMMITTEE: Rec. for pass; ref to Calendar & Rules Committee",15,0,0,0,15
1923293,1497097,2025-02-12,House,"HOUSE CRIMINAL JUSTICE SUBCOMMITTEE: Rec for pass if am by s/c ref. to Judiciary Committee",9,0,0,0,9
1923293,1497098,2025-02-19,House,"HOUSE JUDICIARY COMMITTEE: Rec. for pass; ref to Calendar & Rules Committee",19,0,0,0,19
1923293,1497790,2025-02-24,House,"FLOOR VOTE: REGULAR CALENDAR AS AMENDED PASSAGE ON THIRD CONSIDERATION",96,0,0,0,96
1923293,1514190,2025-03-10,Senate,"FLOOR VOTE: Third Consideration",29,0,0,0,29
1923327,1504412,2025-03-04,House,"HOUSE TENNCARE SUBCOMMITTEE: Rec. for pass by s/c ref. to Insurance Committee",6,0,0,0,6
1923327,1521670,2025-03-19,House,"HOUSE INSURANCE COMMITTEE: Rec. for pass. if am., ref. to Finance, Ways, and Means Committee",15,0,0,0,15
1923363,1475446,2025-01-27,House,"FLOOR VOTE: CONSENT CALENDAR PASSAGE ON THIRD CONSIDERATION",89,0,1,0,90
1923397,1504177,2025-03-04,House,"HOUSE TENNCARE SUBCOMMITTEE: Rec. for pass by s/c ref. to Insurance Committee",6,0,0,0,6
1923397,1516545,2025-03-12,House,"HOUSE INSURANCE COMMITTEE: Rec. for pass; ref to Finance, Ways, and Means Committee",16,0,0,0,16
1923429,1497107,2025-02-12,House,"HOUSE CRIMINAL JUSTICE SUBCOMMITTEE: Rec. for pass by s/c ref. to Judiciary Committee",9,0,0,0,9
1923429,1497108,2025-02-19,House,"HOUSE JUDICIARY COMMITTEE: Rec. for pass; ref to Finance, Ways, and Means Committee",17,2,0,0,19
1923429,1542009,2025-04-09,House,"HOUSE FINANCE, WAYS, AND MEANS SUBCOMMITTEE: Rec. for pass by s/c ref. to Finance, Ways, and Means Committee",11,0,0,0,11
1923429,1547148,2025-04-14,House,"HOUSE FINANCE, WAYS, AND MEANS COMMITTEE: Rec. for pass; ref to Calendar & Rules Committee",26,0,0,0,26
1923572,1521002,2025-03-19,House,"HOUSE HEALTH SUBCOMMITTEE: Rec for pass if am by s/c ref. to Health Committee",7,0,0,0,7
1923572,1526410,2025-03-25,House,"HOUSE HEALTH COMMITTEE: Rec. for pass. if am., ref. to Calendar & Rules Committee",23,0,0,0,23
1923607,1500837,2025-02-26,House,"HOUSE CRIMINAL JUSTICE SUBCOMMITTEE: Rec for pass if am by s/c ref. to Judiciary Committee",9,0,0,0,9
1923607,1506412,2025-03-05,House,"HOUSE JUDICIARY COMMITTEE: Rec. for pass. if am., ref. to Calendar & Rules Committee",17,0,0,0,17
1923607,1509664,2025-03-10,House,"FLOOR VOTE: REGULAR CALENDAR AS AMENDED PASSAGE ON THIRD CONSIDERATION",92,0,1,0,93
1923607,1519410,2025-03-17,Senate,"FLOOR VOTE: Third Consideration",30,1,1,0,32
1923640,1494612,2025-02-19,Senate,"SENATE ENERGY, AGRICULTURE AND NATURAL RESOURCES COMMITTEE: Recommended for passage, refer to Senate Finance, Ways, and Means Committee",5,4,0,0,9
1923640,1504220,2025-03-04,Senate,"SENATE FINANCE, WAYS AND MEANS COMMITTEE: Recommended for passage, refer to Senate Calendar Committee",10,0,0,0,10
1923640,1517033,2025-03-13,Senate,"FLOOR VOTE: Third Consideration",27,4,0,0,31
1923640,1550186,2025-04-16,House,"FLOOR VOTE: REGULAR CALENDAR AS AMENDED PASSAGE ON THIRD CONSIDERATION",84,8,3,0,95
1923640,1552976,2025-04-21,Senate,"FLOOR VOTE: Motion to Concur House Amendment # 1",25,4,0,0,29
1923710,1500235,2025-02-26,Senate,"SENATE HEALTH AND WELFARE COMMITTEE: Recommended for passage, refer to Senate Commerce and Labor Committee",7,0,0,0,7
1923710,1520821,2025-03-18,Senate,"SENATE COMMERCE AND LABOR COMMITTEE: Recommended for passage with amendment/s, refer to Senate Finance, Ways, and Means Committee Ayes 8, Nays 0 PNV 0",8,0,0,0,8
1923775,1515765,2025-03-12,House,"HOUSE CRIMINAL JUSTICE SUBCOMMITTEE: Rec. for pass by s/c ref. to Judiciary Committee",7,0,0,0,7
1923775,1534124,2025-04-02,House,"HOUSE JUDICIARY COMMITTEE: Rec. for pass; ref to Finance, Ways, and Means Committee",18,0,0,0,18
1923775,1551842,2025-04-17,House,"HOUSE FINANCE, WAYS, AND MEANS SUBCOMMITTEE: Rec. for pass by s/c ref. to Finance, Ways, and Means Committee",11,0,0,0,11
1923775,1553320,2025-04-17,House,"HOUSE FINANCE, WAYS, AND MEANS COMMITTEE: Rec. for pass; ref to Calendar & Rules Committee",27,0,0,0,27
1923816,1479125,2025-02-03,House,"FLOOR VOTE: CONSENT CALENDAR PASSAGE ON THIRD CONSIDERATION",91,0,0,0,91
1923851,1505848,2025-03-05,Senate,"SENATE ENERGY, AGRICULTURE AND NATURAL RESOURCES COMMITTEE: Recommended for passage, refer to Senate Calendar Committee",9,0,0,0,9
1923851,1513339,2025-03-10,Senate,"FLOOR VOTE: Motion to Adopt",30,0,0,0,30
1923921,1521120,2025-03-19,House,"HOUSE HIGHER EDUCATION SUBCOMMITTEE: Rec for pass if am by s/c ref. to Education Committee",5,0,0,0,5
1923921,1533104,2025-04-01,House,"HOUSE EDUCATION COMMITTEE: Rec. for pass. if am., ref. to Finance, Ways, and Means Committee",18,0,1,0,19
1923921,1541996,2025-04-09,House,"HOUSE FINANCE, WAYS, AND MEANS SUBCOMMITTEE: Rec. for pass by s/c ref. to Finance, Ways, and Means Committee",10,0,0,0,10
1923921,1547114,2025-04-14,House,"HOUSE FINANCE, WAYS, AND MEANS COMMITTEE: Rec. for pass; ref to Calendar & Rules Committee",27,0,0,0,27
1923988,1506175,2025-03-05,House,"HOUSE AGRICULTURE AND NATURAL RESOURCES SUBCOMMITTEE: Rec. for pass by s/c ref. to Agriculture & Natural Resources Committee",6,2,0,0,8
1923988,1526269,2025-03-25,House,"HOUSE AGRICULTURE & NATURAL RESOURCES COMMITTEE: Rec. for pass. if am., ref. to Calendar & Rules Committee",9,6,0,0,15
1924055,1475692,2025-01-27,House,"FLOOR VOTE: CONSENT CALENDAR PASSAGE ON THIRD CONSIDERATION",89,0,1,0,90
1924055,1490514,2025-02-13,Senate,"FLOOR VOTE: Motion to Adopt",31,0,0,0,31
1924094,1504725,2025-03-04,Senate,"SENATE COMMERCE AND LABOR COMMITTEE: Recommended for passage with amendment/s, refer to Senate Calendar Committee Ayes 8, Nays 0 PNV 0",8,0,0,0,8
1924094,1513226,2025-03-10,Senate,"FLOOR VOTE: as Amended Third Consideration",29,1,0,0,30
1924232,1519807,2025-03-18,House,"HOUSE TRANSPORTATION SUBCOMMITTEE: Rec for pass if am by s/c ref. to Transportation Committee",8,1,0,0,9
1924232,1525854,2025-03-25,House,"HOUSE TRANSPORTATION COMMITTEE: Rec. for pass. if am., ref. to Government Operations Committee",15,4,0,0,19
1924232,1538438,2025-04-07,House,"HOUSE GOVERNMENT OPERATIONS COMMITTEE: Rec. for pass; ref to Calendar & Rules Committee",8,5,0,0,13
1924268,1528069,2025-03-26,House,"HOUSE CRIMINAL JUSTICE SUBCOMMITTEE: Failed in s/c Criminal Justice Subcommittee of Judiciary Committee",3,5,0,0,8
1924298,1494551,2025-02-19,Senate,"SENATE EDUCATION COMMITTEE: Recommended for passage, refer to Senate Calendar Committee",9,0,0,0,9
1924298,1498351,2025-02-24,Senate,"FLOOR VOTE: Motion to Adopt",33,0,0,0,33
1924298,1501764,2025-02-27,House,"FLOOR VOTE: REGULAR CALENDAR PASSAGE ON THIRD CONSIDERATION",94,0,0,0,94
1924346,1485989,2025-02-10,House,"HOUSE NAMING & DESIGNATING COMMITTEE: Rec. for pass; ref to State & Local Government Committee",9,0,0,0,9
1924346,1495163,2025-02-19,House,"HOUSE STATE & LOCAL GOVERNMENT COMMITTEE: Rec. for pass; ref to Finance, Ways, and Means Committee",21,0,0,0,21
1924346,1551744,2025-04-17,House,"HOUSE FINANCE, WAYS, AND MEANS SUBCOMMITTEE: Rec. for pass by s/c ref. to Finance, Ways, and Means Committee",11,0,0,0,11
1924346,1553749,2025-04-17,House,"HOUSE FINANCE, WAYS, AND MEANS COMMITTEE: Rec. for pass; ref to Calendar & Rules Committee",27,0,0,0,27
1924514,1505865,2025-03-04,Senate,"SENATE JUDICIARY COMMITTEE: Recommended for passage with amendment/s, refer to Senate Calendar Committee Ayes 8, Nays 0 PNV 1",8,0,1,0,9
1924682,1493219,2025-02-18,Senate,"SENATE JUDICIARY COMMITTEE: Recommended for passage, refer to Senate Calendar Committee",6,2,0,0,8
1924682,1514454,2025-03-03,Senate,"FLOOR VOTE: as Amended Third Consideration",25,5,0,0,30
1924682,1554390,2025-04-22,House,"FLOOR VOTE: REGULAR CALENDAR AS AMENDED PASSAGE ON THIRD CONSIDERATION",73,22,0,0,95
1924682,1556747,2025-04-22,Senate,"FLOOR VOTE: Motion to Concur House Amendment # 2",27,5,0,0,32
1925021,1534484,2025-04-02,Senate,"SENATE STATE & LOCAL GOVERNMENT COMMITTEE: Recommended for passage with amendment/s, refer to Senate Calendar Committee Ayes 7, Nays 0 PNV 0",7,0,0,0,7
1925021,1539240,2025-04-07,Senate,"FLOOR VOTE: as Amended Third Consideration",32,0,0,0,32
1925021,1550093,2025-04-16,House,"FLOOR VOTE: REGULAR CALENDAR PASSAGE ON THIRD CONSIDERATION",95,0,0,0,95
1925110,1505878,2025-03-05,Senate,"TRANSPORTATION AND SAFETY COMMITTEE: Recommended for passage with amendment/s, refer to Senate Calendar Committee Ayes 7, Nays 1 PNV 0",7,1,0,0,8
1925110,1517072,2025-03-13,Senate,"FLOOR VOTE: as Amended Third Consideration",25,6,0,0,31
1925110,1549139,2025-04-15,House,"FLOOR VOTE: REGULAR CALENDAR MOTION TO CONSIDER AMENDMENT # 2 BY PEARSON PASSAGE ON THIRD CONSIDERATION",21,71,0,0,92
1925110,1549140,2025-04-15,House,"FLOOR VOTE: REGULAR CALENDAR MOTION TO CONSIDER AMENDMENT # 3 BY PEARSON PASSAGE ON THIRD CONSIDERATION",22,71,0,0,93
1925110,1549141,2025-04-15,House,"FLOOR VOTE: REGULAR CALENDAR MOTION TO CONSIDER AMENDMENT # 4 BY PEARSON PASSAGE ON THIRD CONSIDERATION",23,73,0,0,96
1925110,1549142,2025-04-15,House,"FLOOR VOTE: REGULAR CALENDAR MOTION TO CONSIDER AMENDMENT # 5 BY PEARSON PASSAGE ON THIRD CONSIDERATION",24,71,0,0,95
1925110,1549143,2025-04-15,House,"FLOOR VOTE: REGULAR CALENDAR PASSAGE ON THIRD CONSIDERATION",74,23,0,0,97
1925110,1549144,2025-04-15,House,"FLOOR VOTE: REGULAR CALENDAR PREVIOUS QUESTION PASSAGE ON THIRD CONSIDERATION",73,21,0,0,94
1925194,1520357,2025-03-18,House,"HOUSE TRANSPORTATION SUBCOMMITTEE: Rec. for pass by s/c ref. to Transportation Committee",8,0,0,0,8
1925194,1526236,2025-03-25,House,"HOUSE TRANSPORTATION COMMITTEE: Rec. for pass. if am., ref. to Finance, Ways, and Means Committee",18,0,0,0,18
1925194,1534432,2025-04-02,House,"HOUSE FINANCE, WAYS, AND MEANS SUBCOMMITTEE: Rec. for pass by s/c ref. to Finance, Ways, and Means Committee",10,0,0,0,10
1925194,1539463,2025-04-08,House,"HOUSE FINANCE, WAYS, AND MEANS COMMITTEE: Rec. for pass. if am., ref. to Calendar & Rules Committee",28,0,0,0,28
1925279,1519565,2025-03-17,Senate,"SENATE JUDICIARY COMMITTEE: Failed in Senate Judiciary Committee",4,4,0,0,8
1925365,1505899,2025-03-04,Senate,"SENATE JUDICIARY COMMITTEE: Recommended for passage, refer to Senate Calendar Committee",7,0,2,0,9
1925365,1517157,2025-03-13,Senate,"FLOOR VOTE: Third Consideration",23,5,2,0,30
1925449,1519784,2025-03-18,House,"HOUSE TRANSPORTATION SUBCOMMITTEE: Rec. for pass by s/c ref. to Transportation Committee",8,0,0,0,8
1925449,1525867,2025-03-25,House,"HOUSE TRANSPORTATION COMMITTEE: Rec. for pass. if am., ref. to Finance, Ways, and Means Committee",19,0,0,0,19
1925449,1534196,2025-04-02,House,"HOUSE FINANCE, WAYS, AND MEANS SUBCOMMITTEE: Rec for pass if am by s/c ref. to Finance, Ways, and Means Committee",10,0,0,0,10
1925449,1540023,2025-04-08,House,"HOUSE FINANCE, WAYS, AND MEANS COMMITTEE: Rec. for pass. if am., ref. to Calendar & Rules Committee",26,0,0,0,26
1925449,1547685,2025-04-14,House,"FLOOR VOTE: REGULAR CALENDAR AS AMENDED PASSAGE ON THIRD CONSIDERATION",93,0,0,0,93
1925449,1553034,2025-04-21,Senate,"FLOOR VOTE: as Amended Third Consideration",32,0,0,0,32
1925449,1554777,2025-04-22,House,"FLOOR VOTE: MESSAGE CALENDAR 2 CONCUR IN SENATE AMENDMENT # 2",94,0,0,0,94
1925534,1520833,2025-03-19,Senate,"SENATE GOVERNMENT OPERATIONS COMMITTEE: Recommended for passage, refer to Senate State and Local Government Committee",6,2,0,0,8
1925617,1494505,2025-02-19,Senate,"TRANSPORTATION AND SAFETY COMMITTEE: Recommended for passage, refer to Senate Calendar Committee",9,0,0,0,9
1925617,1498421,2025-02-24,Senate,"FLOOR VOTE: Motion to Adopt",33,0,0,0,33
1925703,1491888,2025-02-18,Senate,"SENATE STATE & LOCAL GOVERNMENT COMMITTEE: Recommended for passage, refer to Senate Calendar Committee",9,0,0,0,9
1925703,1498159,2025-02-24,Senate,"FLOOR VOTE: Motion to Adopt",33,0,0,0,33
1926926,1494513,2025-02-19,Senate,"TRANSPORTATION AND SAFETY COMMITTEE: Recommended for passage with amendment/s, refer to Senate Calendar Committee Ayes 9, Nays 0 PNV 0",9,0,0,0,9
1926926,1498087,2025-02-24,Senate,"FLOOR VOTE: as Amended Third Consideration",32,1,0,0,33
1926926,1530934,2025-03-31,House,"FLOOR VOTE: REGULAR CALENDAR PASSAGE ON THIRD CONSIDERATION",94,0,0,0,94
1926947,1516028,2025-03-12,Senate,"SENATE HEALTH AND WELFARE COMMITTEE: Recommended for passage with amendment/s, refer to Senate Calendar Committee Ayes 9, Nays 0 PNV 0",9,0,0,0,9
1926972,1497859,2025-02-24,House,"HOUSE NAMING & DESIGNATING COMMITTEE: Rec. for pass; ref to State & Local Government Committee",8,2,0,0,10
1926972,1516408,2025-03-12,House,"HOUSE STATE & LOCAL GOVERNMENT COMMITTEE: Rec. for pass; ref to Calendar & Rules Committee",19,4,0,0,23
1926972,1518887,2025-03-17,House,"FLOOR VOTE: REGULAR CALENDAR MOTION TO ADOPT",81,8,1,0,90
1926972,1552791,2025-04-21,Senate,"SENATE FINANCE, WAYS AND MEANS COMMITTEE: Recommended for concurrence by Senate Finance, Ways, and Means Committee, refer Senate Calendar Committee",9,0,1,0,10
1926972,1556808,2025-04-22,Senate,"FLOOR VOTE: Motion to Concur",28,3,0,0,31
1926995,1525144,2025-03-24,Senate,"SENATE JUDICIARY COMMITTEE: Recommended for passage with amendment/s, refer to Senate Calendar Committee Ayes 5, Nays 1 PNV 1",5,1,1,0,7
1926995,1536084,2025-04-03,Senate,"FLOOR VOTE: as Amended Third Consideration",24,4,1,0,29
1926995,1550606,2025-04-16,House,"FLOOR VOTE: REGULAR CALENDAR PASSAGE ON THIRD CONSIDERATION",70,23,0,0,93
1926995,1550607,2025-04-16,House,"FLOOR VOTE: REGULAR CALENDAR PREVIOUS QUESTION PASSAGE ON THIRD CONSIDERATION",68,24,0,0,92
1927018,1500042,2025-02-26,House,"HOUSE CIVIL JUSTICE SUBCOMMITTEE: Rec. for pass by s/c ref. to Judiciary Committee",8,0,0,0,8
1927018,1506447,2025-03-05,House,"HOUSE JUDICIARY COMMITTEE: Rec. for pass; ref to Calendar & Rules Committee",21,0,0,0,21
1927018,1509680,2025-03-10,House,"FLOOR VOTE: CONSENT CALENDAR PASSAGE ON THIRD CONSIDERATION",94,0,0,0,94
1927018,1519418,2025-03-17,Senate,"FLOOR VOTE: Motion to Adopt",32,0,0,0,32
1927062,1509119,2025-03-10,House,"HOUSE NAMING & DESIGNATING COMMITTEE: Ref. to Transportation Committee with a Negative Recommendation",4,6,0,0,10
1927062,1519954,2025-03-18,House,"HOUSE TRANSPORTATION COMMITTEE: Failed in Transportation Committee",5,12,1,0,18
1927110,1494525,2025-02-18,House,"HOUSE EDUCATION ADMINISTRATION SUBCOMMITTEE: Failed in s/c Education Administration Subcommittee of Education Committee",3,3,0,0,6
1927155,1527209,2025-03-25,Senate,"SENATE COMMERCE AND LABOR COMMITTEE: Failed in Senate Commerce and Labor Committee",4,3,2,0,9
1927174,1526691,2025-03-25,Senate,"SENATE JUDICIARY COMMITTEE: Recommended for passage with amendment/s, refer to Senate Finance, Ways, and Means Committee Ayes 9, Nays 0 PNV 0",9,0,0,0,9
1928335,1498129,2025-02-24,House,"HOUSE NAMING & DESIGNATING COMMITTEE: ref to State & Local Government Committee with Negative Recommendation",3,6,1,0,10
1930832,1498737,2025-02-25,House,"HOUSE K-12 SUBCOMMITTEE: Rec for pass if am by s/c ref. to Education Committee",6,2,0,0,8
1930884,1479113,2025-02-03,House,"FLOOR VOTE: CONSENT CALENDAR PASSAGE ON THIRD CONSIDERATION",91,0,0,0,91
1930884,1490363,2025-02-13,Senate,"FLOOR VOTE: Motion to Adopt",31,0,0,0,31
1930896,1524721,2025-03-24,Senate,"SENATE JUDICIARY COMMITTEE: Recommended for passage with amendment/s, refer to Senate Calendar Committee Ayes 6, Nays 1 PNV 0",6,1,0,0,7
1930927,1515851,2025-03-11,Senate,"SENATE JUDICIARY COMMITTEE: Recommended for passage with amendment, refer to Senate Calendar Committee",8,0,1,0,9
1930927,1519421,2025-03-17,Senate,"FLOOR VOTE: as Amended Third Consideration",29,0,2,0,31
1930927,1553231,2025-04-21,House,"FLOOR VOTE: REGULAR CALENDAR PASSAGE ON THIRD CONSIDERATION",90,0,0,0,90
1930940,1491873,2025-02-18,Senate,"SENATE STATE & LOCAL GOVERNMENT COMMITTEE: Recommended for passage, refer to Senate Finance, Ways, and Means Committee",8,1,0,0,9
1930940,1552998,2025-04-21,Senate,"SENATE FINANCE, WAYS AND MEANS COMMITTEE: Recommended for passage with amendment/s, refer to Senate Calendar Committee Ayes 8, Nays 2 PNV 0",9,2,0,0,11
1930940,1554706,2025-04-22,House,"FLOOR VOTE: MESSAGE CALENDAR MOTION TO ADOPT CONFERENCE COMMITTEE REPORT",78,13,0,0,91
1930940,1554707,2025-04-22,House,"FLOOR VOTE: REGULAR CALENDAR AS AMENDED PASSAGE ON THIRD CONSIDERATION",73,21,0,0,94
1930940,1556906,2025-04-22,Senate,"FLOOR VOTE: Motion to Adopt Conference Committee Report",23,6,1,0,30
1930940,1556907,2025-04-22,Senate,"FLOOR VOTE: as Amended Third Consideration",28,3,0,0,31
1930952,1494522,2025-02-18,House,"HOUSE K-12 SUBCOMMITTEE: Rec for pass if am by s/c ref. to Education Committee",7,0,0,0,7
1930985,1527614,2025-03-26,House,"HOUSE CIVIL JUSTICE SUBCOMMITTEE: Rec. for pass by s/c ref. to Judiciary Committee",5,1,0,0,6
1930985,1539957,2025-04-08,House,"HOUSE JUDICIARY COMMITTEE: Rec. for pass; ref to Finance, Ways, and Means Committee",14,7,0,0,21
1931011,1514030,2025-03-11,Senate,"SENATE COMMERCE AND LABOR COMMITTEE: Recommended for passage with amendment/s, refer to Senate Calendar Committee Ayes 9, Nays 0 PNV 0",9,0,0,0,9
1931011,1525847,2025-03-24,Senate,"FLOOR VOTE: as Amended Third Consideration",32,0,0,0,32
1931011,1553526,2025-04-21,House,"FLOOR VOTE: REGULAR CALENDAR PASSAGE ON THIRD CONSIDERATION",85,4,0,0,89
1931022,1515646,2025-03-11,Senate,"SENATE JUDICIARY COMMITTEE: Recommended for passage with amendment/s, refer to Senate Calendar Committee Ayes 8, Nays 1 PNV 0",8,1,0,0,9
1931052,1494670,2025-02-19,House,"HOUSE AGRICULTURE AND NATURAL RESOURCES SUBCOMMITTEE: Rec. for pass by s/c ref. to Agriculture & Natural Resources Committee",8,0,0,0,8
1931052,1498709,2025-02-25,House,"HOUSE AGRICULTURE & NATURAL RESOURCES COMMITTEE: Rec. for pass; ref to Finance, Ways, and Means Committee",16,0,0,0,16
1931079,1500399,2025-02-26,House,"HOUSE CITIES & COUNTIES SUBCOMMITTEE: Rec for pass if am by s/c ref. to State & Local Government Committee",5,0,0,0,5
1931079,1516728,2025-03-12,House,"HOUSE STATE & LOCAL GOVERNMENT COMMITTEE: Rec. for pass. if am., ref. to Government Operations Committee",20,3,0,0,23
1931079,1519000,2025-03-17,House,"HOUSE GOVERNMENT OPERATIONS COMMITTEE: Rec. for pass; ref to Calendar & Rules Committee",10,1,0,0,11
1931079,1529671,2025-03-27,House,"FLOOR VOTE: REGULAR CALENDAR AS AMENDED PASSAGE ON THIRD CONSIDERATION",91,5,0,0,96
1931079,1549485,2025-04-15,Senate,"FLOOR VOTE: Third Consideration",30,0,0,0,30
1931095,1515969,2025-03-11,Senate,"SENATE STATE & LOCAL GOVERNMENT COMMITTEE: Recommended for passage, refer to Senate Calendar Committee",9,0,0,0,9
1931095,1519305,2025-03-17,Senate,"FLOOR VOTE: Motion to Adopt",32,0,0,0,32
1931107,1516100,2025-03-11,Senate,"SENATE STATE & LOCAL GOVERNMENT COMMITTEE: Recommended for passage with amendment/s, refer to Senate Calendar Committee Ayes 9, Nays 0 PNV 0",9,0,0,0,9
1931107,1525810,2025-03-24,Senate,"FLOOR VOTE: as Amended Third Consideration",32,0,0,0,32
1931107,1553422,2025-04-21,House,"FLOOR VOTE: REGULAR CALENDAR PASSAGE ON THIRD CONSIDERATION",93,0,0,0,93
1931121,1479325,2025-02-03,House,"FLOOR VOTE: CONSENT CALENDAR PASSAGE ON THIRD CONSIDERATION",91,0,0,0,91
1931164,1485702,2025-02-10,House,"HOUSE GOVERNMENT OPERATIONS COMMITTEE: Rec. for pass; ref to Calendar & Rules Committee",10,0,0,0,10
1931164,1495357,2025-02-20,House,"FLOOR VOTE: CONSENT CALENDAR PASSAGE ON THIRD CONSIDERATION",89,0,1,0,90
1931164,1498434,2025-02-24,Senate,"FLOOR VOTE: Motion to Adopt",33,0,0,0,33
1931171,1485620,2025-02-10,House,"HOUSE GOVERNMENT OPERATIONS COMMITTEE: Rec. for pass; ref to Calendar & Rules Committee",10,0,0,0,10
1931171,1495403,2025-02-20,House,"FLOOR VOTE: CONSENT CALENDAR PASSAGE ON THIRD CONSIDERATION",89,0,1,0,90
1931186,1485710,2025-02-10,House,"HOUSE GOVERNMENT OPERATIONS COMMITTEE: Rec. for pass; ref to Calendar & Rules Committee",10,0,0,0,10
1931186,1494915,2025-02-20,House,"FLOOR VOTE: CONSENT CALENDAR PASSAGE ON THIRD CONSIDERATION",89,0,1,0,90
1931197,1519090,2025-03-17,House,"HOUSE GOVERNMENT OPERATIONS COMMITTEE: Rec. for pass. if am., ref. to Calendar & Rules Committee",6,3,0,0,9
1931202,1518709,2025-03-17,House,"HOUSE GOVERNMENT OPERATIONS COMMITTEE: Rec. for pass; ref to Calendar & Rules Committee",10,0,0,0,10
1931202,1547422,2025-04-14,House,"FLOOR VOTE: CONSENT CALENDAR PASSAGE ON THIRD CONSIDERATION",94,0,1,0,95
1931211,1485700,2025-02-10,House,"HOUSE GOVERNMENT OPERATIONS COMMITTEE: Rec. for pass; ref to Calendar & Rules Committee",10,0,0,0,10
1931211,1495273,2025-02-20,House,"FLOOR VOTE: CONSENT CALENDAR PASSAGE ON THIRD CONSIDERATION",89,0,1,0,90
1931220,1484718,2025-02-10,House,"HOUSE GOVERNMENT OPERATIONS COMMITTEE: Rec. for pass; ref to Calendar & Rules Committee",10,0,0,0,10
1931220,1494962,2025-02-20,House,"FLOOR VOTE: CONSENT CALENDAR PASSAGE ON THIRD CONSIDERATION",89,0,1,0,90
1931220,1514609,2025-03-03,Senate,"FLOOR VOTE: Motion to Adopt",32,0,0,0,32
1931225,1485693,2025-02-10,House,"HOUSE GOVERNMENT OPERATIONS COMMITTEE: Rec. for pass; ref to Calendar & Rules Committee",10,0,0,0,10
1931225,1494741,2025-02-20,House,"FLOOR VOTE: CONSENT CALENDAR PASSAGE ON THIRD CONSIDERATION",89,0,1,0,90
1931225,1498258,2025-02-24,Senate,"FLOOR VOTE: Motion to Adopt",33,0,0,0,33
1931236,1485703,2025-02-10,House,"HOUSE GOVERNMENT OPERATIONS COMMITTEE: Rec. for pass; ref to Calendar & Rules Committee",10,0,0,0,10
1931236,1495239,2025-02-20,House,"FLOOR VOTE: CONSENT CALENDAR PASSAGE ON THIRD CONSIDERATION",89,0,1,0,90
1931236,1514842,2025-03-03,Senate,"FLOOR VOTE: Motion to Adopt",32,0,0,0,32
1931243,1485699,2025-02-10,House,"HOUSE GOVERNMENT OPERATIONS COMMITTEE: Rec. for pass; ref to Calendar & Rules Committee",10,0,0,0,10
1931243,1495733,2025-02-20,House,"FLOOR VOTE: CONSENT CALENDAR PASSAGE ON THIRD CONSIDERATION",89,0,1,0,90
1931243,1498430,2025-02-24,Senate,"FLOOR VOTE: Motion to Adopt",33,0,0,0,33
1931256,1485716,2025-02-10,House,"HOUSE GOVERNMENT OPERATIONS COMMITTEE: Rec. for pass; ref to Calendar & Rules Committee",10,0,0,0,10
1931256,1495954,2025-02-20,House,"FLOOR VOTE: CONSENT CALENDAR PASSAGE ON THIRD CONSIDERATION",89,0,1,0,90
1931256,1498196,2025-02-24,Senate,"FLOOR VOTE: Motion to Adopt",33,0,0,0,33
1931269,1485709,2025-02-10,House,"HOUSE GOVERNMENT OPERATIONS COMMITTEE: Rec. for pass; ref to Calendar & Rules Committee",10,0,0,0,10
1931269,1495232,2025-02-20,House,"FLOOR VOTE: CONSENT CALENDAR PASSAGE ON THIRD CONSIDERATION",89,0,1,0,90
1931279,1485660,2025-02-10,House,"HOUSE GOVERNMENT OPERATIONS COMMITTEE: Rec. for pass; ref to Calendar & Rules Committee",10,0,0,0,10
1931279,1495777,2025-02-20,House,"FLOOR VOTE: CONSENT CALENDAR PASSAGE ON THIRD CONSIDERATION",89,0,1,0,90
1931279,1513359,2025-03-06,Senate,"FLOOR VOTE: Third Consideration",32,0,0,0,32
1931287,1485708,2025-02-10,House,"HOUSE GOVERNMENT OPERATIONS COMMITTEE: Rec. for pass; ref to Calendar & Rules Committee",10,0,0,0,10
1931287,1494868,2025-02-20,House,"FLOOR VOTE: CONSENT CALENDAR PASSAGE ON THIRD CONSIDERATION",89,0,1,0,90
1931287,1513780,2025-03-03,Senate,"FLOOR VOTE: Motion to Adopt",32,0,0,0,32
1931295,1485309,2025-02-10,House,"HOUSE GOVERNMENT OPERATIONS COMMITTEE: Rec. for pass; ref to Calendar & Rules Committee",10,0,0,0,10
1931295,1495346,2025-02-20,House,"FLOOR VOTE: CONSENT CALENDAR PASSAGE ON THIRD CONSIDERATION",89,0,1,0,90
1931295,1498200,2025-02-24,Senate,"FLOOR VOTE: Motion to Adopt",33,0,0,0,33
1931312,1485415,2025-02-10,House,"HOUSE GOVERNMENT OPERATIONS COMMITTEE: Rec. for pass; ref to Calendar & Rules Committee",10,0,0,0,10
1931312,1495860,2025-02-20,House,"FLOOR VOTE: CONSENT CALENDAR PASSAGE ON THIRD CONSIDERATION",89,0,1,0,90
1931318,1531021,2025-03-31,House,"HOUSE GOVERNMENT OPERATIONS COMMITTEE: Rec. for pass; ref to Calendar & Rules Committee",14,0,0,0,14
1931318,1547964,2025-04-14,House,"FLOOR VOTE: CONSENT CALENDAR PASSAGE ON THIRD CONSIDERATION",94,0,1,0,95
1931325,1485715,2025-02-10,House,"HOUSE GOVERNMENT OPERATIONS COMMITTEE: Rec. for pass; ref to Calendar & Rules Committee",10,0,0,0,10
1931325,1495697,2025-02-20,House,"FLOOR VOTE: CONSENT CALENDAR PASSAGE ON THIRD CONSIDERATION",89,0,1,0,90
1931325,1497855,2025-02-24,Senate,"FLOOR VOTE: Motion to Adopt",33,0,0,0,33
1931332,1485472,2025-02-10,House,"HOUSE GOVERNMENT OPERATIONS COMMITTEE: Rec. for pass; ref to Calendar & Rules Committee",10,0,0,0,10
1931332,1494865,2025-02-20,House,"FLOOR VOTE: CONSENT CALENDAR PASSAGE ON THIRD CONSIDERATION",89,0,1,0,90
1931344,1485211,2025-02-10,House,"HOUSE GOVERNMENT OPERATIONS COMMITTEE: Rec. for pass; ref to Calendar & Rules Committee",10,0,0,0,10
1931344,1494899,2025-02-20,House,"FLOOR VOTE: CONSENT CALENDAR PASSAGE ON THIRD CONSIDERATION",89,0,1,0,90
1931344,1498171,2025-02-24,Senate,"FLOOR VOTE: Motion to Adopt",33,0,0,0,33
1931352,1485689,2025-02-10,House,"HOUSE GOVERNMENT OPERATIONS COMMITTEE: Rec. for pass; ref to Calendar & Rules Committee",10,0,0,0,10
1931352,1495234,2025-02-20,House,"FLOOR VOTE: CONSENT CALENDAR PASSAGE ON THIRD CONSIDERATION",89,0,1,0,90
1931357,1485706,2025-02-10,House,"HOUSE GOVERNMENT OPERATIONS COMMITTEE: Rec. for pass; ref to Calendar & Rules Committee",10,0,0,0,10
1931357,1495668,2025-02-20,House,"FLOOR VOTE: CONSENT CALENDAR PASSAGE ON THIRD CONSIDERATION",89,0,1,0,90
1931357,1498324,2025-02-24,Senate,"FLOOR VOTE: Motion to Adopt",33,0,0,0,33
1931367,1485679,2025-02-10,House,"HOUSE GOVERNMENT OPERATIONS COMMITTEE: Rec. for pass; ref to Calendar & Rules Committee",10,0,0,0,10
1931367,1494745,2025-02-20,House,"FLOOR VOTE: CONSENT CALENDAR PASSAGE ON THIRD CONSIDERATION",89,0,1,0,90
1931367,1514364,2025-03-03,Senate,"FLOOR VOTE: Motion to Adopt",32,0,0,0,32
1931372,1524820,2025-03-24,House,"HOUSE GOVERNMENT OPERATIONS COMMITTEE: Rec. for pass; ref to Calendar & Rules Committee",12,0,0,0,12
1931372,1547446,2025-04-14,House,"FLOOR VOTE: CONSENT CALENDAR PASSAGE ON THIRD CONSIDERATION",94,0,1,0,95
1931386,1485691,2025-02-10,House,"HOUSE GOVERNMENT OPERATIONS COMMITTEE: Rec. for pass; ref to Calendar & Rules Committee",10,0,0,0,10
1931386,1494781,2025-02-20,House,"FLOOR VOTE: CONSENT CALENDAR PASSAGE ON THIRD CONSIDERATION",89,0,1,0,90
1931386,1498252,2025-02-24,Senate,"FLOOR VOTE: Motion to Adopt",33,0,0,0,33
1931394,1485685,2025-02-10,House,"HOUSE GOVERNMENT OPERATIONS COMMITTEE: Rec. for pass; ref to Calendar & Rules Committee",10,0,0,0,10
1931394,1494822,2025-02-20,House,"FLOOR VOTE: CONSENT CALENDAR PASSAGE ON THIRD CONSIDERATION",89,0,1,0,90
1931398,1485214,2025-02-10,House,"HOUSE GOVERNMENT OPERATIONS COMMITTEE: Rec. for pass; ref to Calendar & Rules Committee",10,0,0,0,10
1931398,1494858,2025-02-20,House,"FLOOR VOTE: CONSENT CALENDAR PASSAGE ON THIRD CONSIDERATION",89,0,1,0,90
1931411,1485624,2025-02-10,House,"HOUSE GOVERNMENT OPERATIONS COMMITTEE: Rec. for pass; ref to Calendar & Rules Committee",10,0,0,0,10
1931411,1494766,2025-02-20,House,"FLOOR VOTE: CONSENT CALENDAR PASSAGE ON THIRD CONSIDERATION",89,0,1,0,90
1931418,1485697,2025-02-10,House,"HOUSE GOVERNMENT OPERATIONS COMMITTEE: Rec. for pass; ref to Calendar & Rules Committee",10,0,0,0,10
1931418,1495675,2025-02-20,House,"FLOOR VOTE: CONSENT CALENDAR PASSAGE ON THIRD CONSIDERATION",89,0,1,0,90
1931418,1498192,2025-02-24,Senate,"FLOOR VOTE: Motion to Adopt",33,0,0,0,33
1931435,1509186,2025-03-10,House,"HOUSE GOVERNMENT OPERATIONS COMMITTEE: Rec. for pass; ref to Calendar & Rules Committee",9,0,0,0,9
1931435,1547952,2025-04-14,House,"FLOOR VOTE: CONSENT CALENDAR PASSAGE ON THIRD CONSIDERATION",94,0,1,0,95
1931443,1524642,2025-03-24,House,"HOUSE GOVERNMENT OPERATIONS COMMITTEE: Rec. for pass. if am., ref. to Calendar & Rules Committee",12,0,0,0,12
1931451,1485713,2025-02-10,House,"HOUSE GOVERNMENT OPERATIONS COMMITTEE: Rec. for pass; ref to Calendar & Rules Committee",10,0,0,0,10
1931451,1494740,2025-02-20,House,"FLOOR VOTE: CONSENT CALENDAR PASSAGE ON THIRD CONSIDERATION",89,0,1,0,90
1931451,1514096,2025-03-06,Senate,"FLOOR VOTE: Third Consideration",27,0,4,0,31
1931461,1485714,2025-02-10,House,"HOUSE GOVERNMENT OPERATIONS COMMITTEE: Rec. for pass; ref to Calendar & Rules Committee",10,0,0,0,10
1931461,1494654,2025-02-20,House,"FLOOR VOTE: CONSENT CALENDAR PASSAGE ON THIRD CONSIDERATION",89,0,1,0,90
1931468,1519075,2025-03-17,House,"HOUSE GOVERNMENT OPERATIONS COMMITTEE: Rec. for pass; ref to Calendar & Rules Committee",11,0,0,0,11
1931468,1547750,2025-04-14,House,"FLOOR VOTE: CONSENT CALENDAR PASSAGE ON THIRD CONSIDERATION",94,0,1,0,95
1931475,1485391,2025-02-10,House,"HOUSE GOVERNMENT OPERATIONS COMMITTEE: Rec. for pass; ref to Calendar & Rules Committee",10,0,0,0,10
1931475,1494830,2025-02-20,House,"FLOOR VOTE: CONSENT CALENDAR PASSAGE ON THIRD CONSIDERATION",89,0,1,0,90
1931475,1498438,2025-02-24,Senate,"FLOOR VOTE: Motion to Adopt",33,0,0,0,33
1931482,1485696,2025-02-10,House,"HOUSE GOVERNMENT OPERATIONS COMMITTEE: Rec. for pass; ref to Calendar & Rules Committee",10,0,0,0,10
1931482,1495507,2025-02-20,House,"FLOOR VOTE: CONSENT CALENDAR PASSAGE ON THIRD CONSIDERATION",89,0,1,0,90
1931494,1485694,2025-02-10,House,"HOUSE GOVERNMENT OPERATIONS COMMITTEE: Rec. for pass; ref to Calendar & Rules Committee",10,0,0,0,10
1931494,1495557,2025-02-20,House,"FLOOR VOTE: CONSENT CALENDAR PASSAGE ON THIRD CONSIDERATION",89,0,1,0,90
1931494,1514798,2025-03-03,Senate,"FLOOR VOTE: Motion to Adopt",32,0,0,0,32
1931501,1485584,2025-02-10,House,"HOUSE GOVERNMENT OPERATIONS COMMITTEE: Rec. for pass; ref to Calendar & Rules Committee",10,0,0,0,10
1931501,1495923,2025-02-20,House,"FLOOR VOTE: CONSENT CALENDAR PASSAGE ON THIRD CONSIDERATION",89,0,1,0,90
1931501,1498234,2025-02-24,Senate,"FLOOR VOTE: Motion to Adopt",33,0,0,0,33
1931509,1485688,2025-02-10,House,"HOUSE GOVERNMENT OPERATIONS COMMITTEE: Rec. for pass; ref to Calendar & Rules Committee",10,0,0,0,10
1931509,1495834,2025-02-20,House,"FLOOR VOTE: CONSENT CALENDAR PASSAGE ON THIRD CONSIDERATION",89,0,1,0,90
1931519,1509175,2025-03-10,House,"HOUSE GOVERNMENT OPERATIONS COMMITTEE: Rec. for pass; ref to Calendar & Rules Committee",12,0,0,0,12
1931519,1547971,2025-04-14,House,"FLOOR VOTE: CONSENT CALENDAR PASSAGE ON THIRD CONSIDERATION",94,0,1,0,95
1931531,1485627,2025-02-10,House,"HOUSE GOVERNMENT OPERATIONS COMMITTEE: Rec. for pass; ref to Calendar & Rules Committee",10,0,0,0,10
1931531,1495102,2025-02-20,House,"FLOOR VOTE: CONSENT CALENDAR PASSAGE ON THIRD CONSIDERATION",89,0,1,0,90
1931531,1515399,2025-03-10,Senate,"FLOOR VOTE: Motion to Adopt",30,0,0,0,30
1931533,1485695,2025-02-10,House,"HOUSE GOVERNMENT OPERATIONS COMMITTEE: Rec. for pass; ref to Calendar & Rules Committee",10,0,0,0,10
1931533,1494863,2025-02-20,House,"FLOOR VOTE: CONSENT CALENDAR PASSAGE ON THIRD CONSIDERATION",89,0,1,0,90
1931533,1498512,2025-02-24,Senate,"FLOOR VOTE: Motion to Adopt",33,0,0,0,33
1931543,1485712,2025-02-10,House,"HOUSE GOVERNMENT OPERATIONS COMMITTEE: Rec. for pass; ref to Calendar & Rules Committee",10,0,0,0,10
1931543,1494857,2025-02-20,House,"FLOOR VOTE: CONSENT CALENDAR PASSAGE ON THIRD CONSIDERATION",89,0,1,0,90
1931543,1497845,2025-02-24,Senate,"FLOOR VOTE: Motion to Adopt",33,0,0,0,33
1931550,1484844,2025-02-10,House,"HOUSE GOVERNMENT OPERATIONS COMMITTEE: Rec. for pass; ref to Calendar & Rules Committee",10,0,0,0,10
1931550,1495839,2025-02-20,House,"FLOOR VOTE: CONSENT CALENDAR PASSAGE ON THIRD CONSIDERATION",89,0,1,0,90
1931550,1523730,2025-03-20,Senate,"FLOOR VOTE: Motion to Adopt",30,0,0,0,30
1931560,1485641,2025-02-10,House,"HOUSE GOVERNMENT OPERATIONS COMMITTEE: Rec. for pass; ref to Calendar & Rules Committee",10,0,0,0,10
1931560,1495821,2025-02-20,House,"FLOOR VOTE: CONSENT CALENDAR PASSAGE ON THIRD CONSIDERATION",89,0,1,0,90
1931560,1498254,2025-02-24,Senate,"FLOOR VOTE: Motion to Adopt",33,0,0,0,33
1931569,1519077,2025-03-17,House,"HOUSE GOVERNMENT OPERATIONS COMMITTEE: Rec. for pass; ref to Calendar & Rules Committee",12,0,0,0,12
1931569,1547962,2025-04-14,House,"FLOOR VOTE: CONSENT CALENDAR PASSAGE ON THIRD CONSIDERATION",94,0,1,0,95
1931583,1485196,2025-02-10,House,"HOUSE GOVERNMENT OPERATIONS COMMITTEE: Rec. for pass; ref to Calendar & Rules Committee",10,0,0,0,10
1931583,1494845,2025-02-20,House,"FLOOR VOTE: CONSENT CALENDAR PASSAGE ON THIRD CONSIDERATION",89,0,1,0,90
1931591,1485368,2025-02-10,House,"HOUSE GOVERNMENT OPERATIONS COMMITTEE: Rec. for pass; ref to Calendar & Rules Committee",10,0,0,0,10
1931591,1494843,2025-02-20,House,"FLOOR VOTE: CONSENT CALENDAR PASSAGE ON THIRD CONSIDERATION",89,0,1,0,90
1931591,1498055,2025-02-24,Senate,"FLOOR VOTE: Motion to Adopt",33,0,0,0,33
1931605,1488460,2025-02-12,House,"HOUSE CITIES & COUNTIES SUBCOMMITTEE: Failed in s/c Cities & Counties Subcommittee of State & Local Government Committee",2,5,0,0,7
1931627,1485701,2025-02-10,House,"HOUSE GOVERNMENT OPERATIONS COMMITTEE: Rec. for pass; ref to Calendar & Rules Committee",10,0,0,0,10
1931627,1495417,2025-02-20,House,"FLOOR VOTE: CONSENT CALENDAR PASSAGE ON THIRD CONSIDERATION",89,0,1,0,90
1931627,1498357,2025-02-24,Senate,"FLOOR VOTE: Motion to Adopt",33,0,0,0,33
1931638,1485530,2025-02-10,House,"HOUSE GOVERNMENT OPERATIONS COMMITTEE: Rec. for pass; ref to Calendar & Rules Committee",10,0,0,0,10
1931638,1495090,2025-02-20,House,"FLOOR VOTE: CONSENT CALENDAR PASSAGE ON THIRD CONSIDERATION",89,0,1,0,90
1931638,1513440,2025-03-03,Senate,"FLOOR VOTE: Motion to Adopt",32,0,0,0,32
1931643,1485707,2025-02-10,House,"HOUSE GOVERNMENT OPERATIONS COMMITTEE: Rec. for pass; ref to Calendar & Rules Committee",10,0,0,0,10
1931643,1494755,2025-02-20,House,"FLOOR VOTE: CONSENT CALENDAR PASSAGE ON THIRD CONSIDERATION",89,0,1,0,90
1931643,1497965,2025-02-24,Senate,"FLOOR VOTE: Motion to Adopt",33,0,0,0,33
1931651,1485686,2025-02-10,House,"HOUSE GOVERNMENT OPERATIONS COMMITTEE: Rec. for pass; ref to Calendar & Rules Committee",10,0,0,0,10
1931651,1495419,2025-02-20,House,"FLOOR VOTE: CONSENT CALENDAR PASSAGE ON THIRD CONSIDERATION",89,0,1,0,90
1931651,1498446,2025-02-24,Senate,"FLOOR VOTE: Motion to Adopt",33,0,0,0,33
1931659,1485717,2025-02-10,House,"HOUSE GOVERNMENT OPERATIONS COMMITTEE: Rec. for pass; ref to Calendar & Rules Committee",10,0,0,0,10
1931659,1495841,2025-02-20,House,"FLOOR VOTE: CONSENT CALENDAR PASSAGE ON THIRD CONSIDERATION",89,0,1,0,90
1931659,1497932,2025-02-24,Senate,"FLOOR VOTE: Motion to Adopt",33,0,0,0,33
1931667,1485254,2025-02-10,House,"HOUSE GOVERNMENT OPERATIONS COMMITTEE: Rec. for pass; ref to Calendar & Rules Committee",10,0,0,0,10
1931667,1495076,2025-02-20,House,"FLOOR VOTE: CONSENT CALENDAR PASSAGE ON THIRD CONSIDERATION",89,0,1,0,90
1931667,1513273,2025-03-03,Senate,"FLOOR VOTE: Third Consideration",28,1,0,0,29
1931678,1538868,2025-04-07,House,"HOUSE GOVERNMENT OPERATIONS COMMITTEE: Rec. for pass; ref to Calendar & Rules Committee",10,6,0,0,16
1931684,1485444,2025-02-10,House,"HOUSE GOVERNMENT OPERATIONS COMMITTEE: Rec. for pass; ref to Calendar & Rules Committee",10,0,0,0,10
1931684,1494724,2025-02-20,House,"FLOOR VOTE: CONSENT CALENDAR PASSAGE ON THIRD CONSIDERATION",89,0,1,0,90
1931684,1523760,2025-03-20,Senate,"FLOOR VOTE: Motion to Adopt",30,0,0,0,30
1931691,1485523,2025-02-10,House,"HOUSE GOVERNMENT OPERATIONS COMMITTEE: Rec. for pass; ref to Calendar & Rules Committee",10,0,0,0,10
1931691,1494940,2025-02-20,House,"FLOOR VOTE: CONSENT CALENDAR PASSAGE ON THIRD CONSIDERATION",89,0,1,0,90
1931696,1485719,2025-02-10,House,"HOUSE GOVERNMENT OPERATIONS COMMITTEE: Rec. for pass; ref to Calendar & Rules Committee",10,0,0,0,10
1931696,1495768,2025-02-20,House,"FLOOR VOTE: CONSENT CALENDAR PASSAGE ON THIRD CONSIDERATION",89,0,1,0,90
1931696,1498017,2025-02-24,Senate,"FLOOR VOTE: Motion to Adopt",33,0,0,0,33
1932058,1504188,2025-03-04,House,"HOUSE TENNCARE SUBCOMMITTEE: Rec for pass if am by s/c ref. to Insurance Committee",7,0,0,0,7
1932748,1515822,2025-03-12,House,"INSURANCE SUBCOMMITTEE: Rec for pass if am by s/c ref. to Insurance Committee",5,0,0,0,5
1932748,1521911,2025-03-19,House,"HOUSE INSURANCE COMMITTEE: Rec. for pass. if am., ref. to Finance, Ways, and Means Committee",17,0,0,0,17
1932748,1551799,2025-04-17,House,"HOUSE FINANCE, WAYS, AND MEANS SUBCOMMITTEE: Rec. for pass by s/c ref. to Finance, Ways, and Means Committee",11,0,0,0,11
1932748,1553363,2025-04-17,House,"HOUSE FINANCE, WAYS, AND MEANS COMMITTEE: Rec. for pass; ref to Calendar & Rules Committee",27,0,0,0,27
1933092,1487752,2025-02-12,House,"HOUSE CITIES & COUNTIES SUBCOMMITTEE: Rec for pass if am by s/c ref. to State & Local Government Committee",7,0,0,0,7
1933092,1494599,2025-02-19,House,"HOUSE STATE & LOCAL GOVERNMENT COMMITTEE: Rec. for pass. if am., ref. to Calendar & Rules Committee",21,0,0,0,21
1933092,1497766,2025-02-24,House,"FLOOR VOTE: REGULAR CALENDAR AS AMENDED PASSAGE ON THIRD CONSIDERATION",96,0,0,0,96
1933092,1517254,2025-03-13,Senate,"FLOOR VOTE: as Amended Third Consideration",31,0,0,0,31
1933092,1523767,2025-03-20,House,"FLOOR VOTE: MESSAGE CALENDAR CONCUR IN SENATE AMENDMENT # 2",94,0,0,0,94
1933977,1491870,2025-02-18,Senate,"SENATE STATE & LOCAL GOVERNMENT COMMITTEE: Recommended for passage, refer to Senate Calendar Committee",8,0,0,0,8
1933977,1498172,2025-02-24,Senate,"FLOOR VOTE: Motion to Adopt",33,0,0,0,33
1934391,1505811,2025-03-04,Senate,"SENATE JUDICIARY COMMITTEE: Recommended for passage with amendment/s, refer to Senate Finance, Ways, and Means Committee Ayes 8, Nays 0 PNV 0",9,0,0,0,9
1934562,1494831,2025-02-12,House,"HOUSE BUSINESS AND UTILITIES SUBCOMMITTEE: Rec. for pass by s/c ref. to Commerce Committee",10,0,0,0,10
1934562,1516162,2025-03-12,House,"HOUSE COMMERCE COMMITTEE: Rec. for pass; ref to Calendar & Rules Committee",22,0,0,0,22
1934562,1519205,2025-03-17,House,"FLOOR VOTE: CONSENT CALENDAR PASSAGE ON THIRD CONSIDERATION",92,0,1,0,93
1934616,1521034,2025-03-19,House,"HOUSE PUBLIC SERVICE SUBCOMMITTEE: Rec. for pass by s/c ref. to State & Local Government Committee",6,0,0,0,6
1934616,1540139,2025-04-08,House,"HOUSE STATE & LOCAL GOVERNMENT COMMITTEE: Rec. for pass; ref to Finance, Ways, and Means Committee",19,0,0,0,19
1934616,1551883,2025-04-17,House,"HOUSE FINANCE, WAYS, AND MEANS SUBCOMMITTEE: Rec. for pass by s/c ref. to Finance, Ways, and Means Committee",11,0,0,0,11
1934616,1553349,2025-04-17,House,"HOUSE FINANCE, WAYS, AND MEANS COMMITTEE: Rec. for pass; ref to Calendar & Rules Committee",27,0,0,0,27
1934616,1553350,2025-04-21,House,"FLOOR VOTE: REGULAR CALENDAR PASSAGE ON THIRD CONSIDERATION",91,1,0,0,92
1934616,1556405,2025-04-22,Senate,"FLOOR VOTE: Motion to Adopt",33,0,0,0,33
1934643,1476479,2025-01-29,Senate,"SENATE FINANCE, WAYS AND MEANS COMMITTEE: Recommended for passage with amendment/s, refer to Senate Calendar Committee Ayes 9, Nays 1 PNV 1",9,1,1,0,11
1934643,1478444,2025-01-30,House,"FLOOR VOTE: REGULAR CALENDAR LAY ON THE TABLE MOTION TO ADOPT AMENDMENT # 3 BY POWELL PASSAGE ON THIRD CONSIDERATION",73,21,0,0,94
1934643,1478445,2025-01-30,House,"FLOOR VOTE: REGULAR CALENDAR LAY ON THE TABLE MOTION TO ADOPT AMENDMENT # 4 BY CLEMMONS PASSAGE ON THIRD CONSIDERATION",65,24,8,0,97
1934643,1478446,2025-01-30,House,"FLOOR VOTE: REGULAR CALENDAR PASSAGE ON THIRD CONSIDERATION",81,13,2,0,96
1934643,1491812,2025-01-30,Senate,"FLOOR VOTE: as Amended Third Consideration",27,6,0,0,33
1934670,1500345,2025-02-26,House,"HOUSE CITIES & COUNTIES SUBCOMMITTEE: Rec for pass if am by s/c ref. to State & Local Government Committee",5,2,0,0,7
1934670,1516721,2025-03-19,House,"HOUSE STATE & LOCAL GOVERNMENT COMMITTEE: Action def. in State & Local Government Committee to 3/19/2025 3/12/2025",20,0,1,0,21
1934670,1535346,2025-04-02,House,"HOUSE STATE & LOCAL GOVERNMENT COMMITTEE: Failed in State & Local Government Committee",8,10,3,0,21
1934698,1500609,2025-02-26,Senate,"SENATE ENERGY, AGRICULTURE AND NATURAL RESOURCES COMMITTEE: Recommended for passage, refer to Senate Finance, Ways, and Means Committee",9,0,0,0,9
1934724,1504689,2025-03-04,Senate,"SENATE STATE & LOCAL GOVERNMENT COMMITTEE: Recommended for passage with amendment/s, refer to Senate Calendar Committee Ayes 8, Nays 0 PNV 0",8,0,0,0,8
1934752,1514045,2025-03-11,House,"HOUSE TRANSPORTATION SUBCOMMITTEE: Rec. for pass by s/c ref. to Transportation Committee",8,1,0,0,9
1934752,1520387,2025-03-18,House,"HOUSE TRANSPORTATION COMMITTEE: Rec. for pass; ref to Calendar & Rules Committee",14,4,0,0,18
1934780,1504634,2025-03-04,Senate,"SENATE STATE & LOCAL GOVERNMENT COMMITTEE: Recommended for passage, refer to Senate Calendar Committee",9,0,0,0,9
1934780,1514771,2025-03-10,Senate,"FLOOR VOTE: Motion to Adopt",30,0,0,0,30
1934807,1475738,2025-01-28,Senate,"SENATE EDUCATION COMMITTEE: Recommended for passage with amendment/s, refer to Senate Finance, Ways, and Means Committee Ayes 8, Nays 1 PNV 0",8,1,0,0,9
1934807,1476392,2025-01-29,Senate,"SENATE FINANCE, WAYS AND MEANS COMMITTEE: Recommended for passage, refer to Senate Calendar Committee",8,3,0,0,11
1934837,1505837,2025-03-05,Senate,"TRANSPORTATION AND SAFETY COMMITTEE: Recommended for passage, refer to Senate Calendar Committee",8,0,0,0,8
1934837,1513195,2025-03-10,Senate,"FLOOR VOTE: Motion to Adopt",30,0,0,0,30
1934837,1529248,2025-03-27,House,"FLOOR VOTE: REGULAR CALENDAR PASSAGE ON THIRD CONSIDERATION",69,17,9,0,95
1934864,1501228,2025-02-26,Senate,"SENATE EDUCATION COMMITTEE: Recommended for passage, refer to Senate Calendar Committee",8,1,0,0,9
1934864,1514505,2025-03-06,Senate,"FLOOR VOTE: Third Consideration",31,0,0,0,31
1934864,1553581,2025-04-21,House,"FLOOR VOTE: REGULAR CALENDAR AS AMENDED PASSAGE ON THIRD CONSIDERATION",86,0,1,0,87
1934864,1556691,2025-04-22,Senate,"FLOOR VOTE: Motion to Concur House Amendment # 1",33,0,0,0,33
1935001,1475386,2025-01-28,Senate,"SENATE COMMERCE AND LABOR COMMITTEE: Recommended for passage, refer to Senate State and Local Government Committee",9,0,0,0,9
1935001,1476125,2025-01-29,Senate,"SENATE STATE & LOCAL GOVERNMENT COMMITTEE: Recommended for passage, refer to Senate Calendar Committee",9,0,0,0,9
1935001,1476359,2025-01-29,Senate,"FLOOR VOTE: Third Consideration",33,0,0,0,33
1935001,1478593,2025-01-29,House,"FLOOR VOTE: REGULAR CALENDAR PASSAGE ON THIRD CONSIDERATION",96,0,0,0,96
1935058,1520766,2025-03-18,Senate,"SENATE JUDICIARY COMMITTEE: Recommended for passage, refer to Senate Calendar Committee",6,2,0,0,8
1935058,1528602,2025-03-27,Senate,"FLOOR VOTE: Third Consideration",26,5,0,0,31
1935058,1548549,2025-04-15,House,"FLOOR VOTE: REGULAR CALENDAR PASSAGE ON THIRD CONSIDERATION",73,21,0,0,94
1935084,1532872,2025-04-01,House,"HOUSE CRIMINAL JUSTICE SUBCOMMITTEE: Rec for pass if am by s/c ref. to Judiciary Committee",8,0,1,0,9
1935084,1543132,2025-04-09,House,"HOUSE JUDICIARY COMMITTEE: Rec. for pass. if am., ref. to Calendar & Rules Committee",22,0,0,0,22
1935138,1500668,2025-02-26,House,"HOUSE CITIES & COUNTIES SUBCOMMITTEE: Rec for pass if am by s/c ref. to State & Local Government Committee",5,1,0,0,6
1935138,1535137,2025-04-02,House,"HOUSE STATE & LOCAL GOVERNMENT COMMITTEE: Rec. for pass. if am., ref. to Calendar & Rules Committee",22,0,0,0,22
1935164,1506333,2025-03-05,House,"HOUSE PUBLIC SERVICE SUBCOMMITTEE: Rec. for pass by s/c ref. to State & Local Government Committee",6,0,0,0,6
1935164,1516477,2025-03-12,House,"HOUSE STATE & LOCAL GOVERNMENT COMMITTEE: Rec. for pass; ref to Calendar & Rules Committee",23,0,0,0,23
1935164,1531189,2025-03-31,House,"FLOOR VOTE: CONSENT CALENDAR PASSAGE ON THIRD CONSIDERATION",93,0,2,0,95
1935191,1475330,2025-01-28,Senate,"SENATE GOVERNMENT OPERATIONS COMMITTEE: Recommended for passage with amendment/s, refer to Senate Transportation and Safety Committee Ayes 7, Nays 1 PNV 0",7,1,0,0,8
1935191,1475331,2025-01-28,Senate,"TRANSPORTATION AND SAFETY COMMITTEE: Recommended for passage with amendment/s, refer to Senate Judiciary Committee Ayes 8, Nays 1 PNV 0",8,1,0,0,9
1935191,1475609,2025-01-28,Senate,"SENATE JUDICIARY COMMITTEE: Recommended for passage, refer to Senate State and Local Government Committee",6,3,0,0,9
1935191,1476250,2025-01-29,Senate,"SENATE FINANCE, WAYS AND MEANS COMMITTEE: Recommended for passage with amendment/s, refer to Senate Calendar Committee Ayes 9, Nays 2 PNV 0",9,2,0,0,11
1935191,1476251,2025-01-29,Senate,"SENATE STATE & LOCAL GOVERNMENT COMMITTEE: Recommended for passage, refer to Senate Finance, Ways, and Means Committee",6,3,0,0,9
1935191,1476570,2025-01-29,Senate,"FLOOR VOTE: Motion to Adopt Amend# 5 by Senator Oliver",6,27,0,0,33
1935191,1476571,2025-01-29,Senate,"FLOOR VOTE: as Amended Third Consideration",26,7,0,0,33
1935191,1477610,2025-01-30,House,"FLOOR VOTE: REGULAR CALENDAR MOTION TO CONSIDER AMENDMENT # 10 BY PEARSON PASSAGE ON THIRD CONSIDERATION",21,70,0,0,91
1935191,1477611,2025-01-30,House,"FLOOR VOTE: REGULAR CALENDAR MOTION TO CONSIDER AMENDMENT # 3 BY JOHNSON PASSAGE ON THIRD CONSIDERATION",23,70,0,0,93
1935191,1477612,2025-01-30,House,"FLOOR VOTE: REGULAR CALENDAR MOTION TO CONSIDER AMENDMENT # 4 BY JOHNSON PASSAGE ON THIRD CONSIDERATION",24,72,0,0,96
1935191,1477613,2025-01-30,House,"FLOOR VOTE: REGULAR CALENDAR MOTION TO CONSIDER AMENDMENT # 6 BY JONES J PASSAGE ON THIRD CONSIDERATION",23,71,1,0,95
1935191,1477614,2025-01-30,House,"FLOOR VOTE: REGULAR CALENDAR MOTION TO CONSIDER AMENDMENT # 7 BY DIXIE PASSAGE ON THIRD CONSIDERATION",23,73,0,0,96
1935191,1477615,2025-01-30,House,"FLOOR VOTE: REGULAR CALENDAR MOTION TO CONSIDER AMENDMENT # 8 BY PEARSON PASSAGE ON THIRD CONSIDERATION",23,70,0,0,93
1935191,1477616,2025-01-30,House,"FLOOR VOTE: REGULAR CALENDAR MOTION TO CONSIDER AMENDMENT # 9 BY PEARSON PASSAGE ON THIRD CONSIDERATION",22,70,0,0,92
1935191,1477617,2025-01-30,House,"FLOOR VOTE: REGULAR CALENDAR PASSAGE ON THIRD CONSIDERATION",72,21,0,0,93
1935191,1477618,2025-01-30,House,"FLOOR VOTE: REGULAR CALENDAR PREVIOUS QUESTION PASSAGE ON THIRD CONSIDERATION",71,19,0,0,90
1935217,1476291,2025-01-29,Senate,"SENATE FINANCE, WAYS AND MEANS COMMITTEE: Recommended for passage, refer to Senate Calendar Committee",11,0,0,0,11
1935217,1476292,2025-01-29,Senate,"SENATE STATE & LOCAL GOVERNMENT COMMITTEE: Recommended for passage, refer to Senate Finance, Ways, and Means Committee",9,0,0,0,9
1935217,1476609,2025-01-29,Senate,"FLOOR VOTE: Third Consideration",32,1,0,0,33
1935217,1478585,2025-01-29,House,"FLOOR VOTE: REGULAR CALENDAR LAY ON THE TABLE MOTION TO ADOPT AMENDMENT # 1 BY MITCHELL PASSAGE ON THIRD CONSIDERATION",74,22,0,0,96
1935217,1478586,2025-01-29,House,"FLOOR VOTE: REGULAR CALENDAR MOTION TO CONSIDER AMENDMENT # 3 BY FRITTS PASSAGE ON THIRD CONSIDERATION",19,77,0,0,96
1935217,1478587,2025-01-29,House,"FLOOR VOTE: REGULAR CALENDAR PASSAGE ON THIRD CONSIDERATION",96,0,0,0,96
1935273,1500652,2025-02-26,House,"HOUSE CITIES & COUNTIES SUBCOMMITTEE: Rec for pass if am by s/c ref. to State & Local Government Committee",3,2,2,0,7
1935273,1540152,2025-04-08,House,"HOUSE STATE & LOCAL GOVERNMENT COMMITTEE: Failed in State & Local Government Committee",7,13,1,0,21
1935298,1497099,2025-02-11,House,"HOUSE TRANSPORTATION SUBCOMMITTEE: Rec for pass if am by s/c ref. to Transportation Committee",8,1,0,0,9
1935298,1497100,2025-02-18,House,"HOUSE TRANSPORTATION COMMITTEE: Rec. for pass. if am., ref. to Calendar & Rules Committee",19,1,0,0,20
1935298,1497849,2025-02-24,House,"FLOOR VOTE: REGULAR CALENDAR AS AMENDED PASSAGE ON THIRD CONSIDERATION",94,1,0,0,95
1935298,1513897,2025-03-03,Senate,"FLOOR VOTE: Third Consideration",31,0,0,0,31
1935320,1493143,2025-02-18,Senate,"SENATE JUDICIARY COMMITTEE: Recommended for passage, refer to Senate Calendar Committee",9,0,0,0,9
1935320,1498408,2025-02-24,Senate,"FLOOR VOTE: Motion to Adopt",33,0,0,0,33
1935320,1549540,2025-04-15,House,"FLOOR VOTE: REGULAR CALENDAR AS AMENDED PASSAGE ON THIRD CONSIDERATION",93,1,0,0,94
1935320,1552463,2025-04-17,Senate,"FLOOR VOTE: Motion to Concur House Amendment # 1",33,0,0,0,33
1935389,1497101,2025-02-11,House,"HOUSE DEPARTMENTS & AGENCIES SUBCOMMITTEE: Rec. for pass by s/c ref. to State & Local Government Committee",6,0,0,0,6
1935389,1497102,2025-02-19,House,"HOUSE STATE & LOCAL GOVERNMENT COMMITTEE: Rec. for pass. if am., ref. to Calendar & Rules Committee",22,0,0,0,22
1935389,1497823,2025-02-24,House,"FLOOR VOTE: REGULAR CALENDAR AS AMENDED PASSAGE ON THIRD CONSIDERATION",96,0,0,0,96
1935389,1514752,2025-03-10,Senate,"FLOOR VOTE: Third Consideration",29,0,0,0,29
1935502,1499911,2025-02-26,House,"HOUSE PUBLIC SERVICE SUBCOMMITTEE: Rec. for pass by s/c ref. to State & Local Government Committee",4,1,0,0,5
1935502,1542067,2025-04-09,House,"HOUSE STATE & LOCAL GOVERNMENT COMMITTEE: Rec. for pass; ref to Calendar & Rules Committee",16,5,0,0,21
1935557,1521541,2025-03-19,House,"HOUSE CITIES & COUNTIES SUBCOMMITTEE: Def. to Summer Study in Cities & Counties Subcommittee",4,1,2,0,7
1935613,1506155,2025-03-05,House,"HOUSE PUBLIC SERVICE SUBCOMMITTEE: Rec. for pass by s/c ref. to State & Local Government Committee",5,0,0,0,5
1935613,1521788,2025-03-19,House,"HOUSE STATE & LOCAL GOVERNMENT COMMITTEE: Rec. for pass; ref to Calendar & Rules Committee",15,4,0,0,19
1935669,1519537,2025-03-17,Senate,"SENATE JUDICIARY COMMITTEE: Failed in Senate Judiciary Committee",4,4,0,0,8
1935669,1533935,2025-04-01,Senate,"SENATE JUDICIARY COMMITTEE: Recommended for passage with amendment/s, refer to Senate Calendar Committee Ayes 5, Nays 4 PNV 0",5,4,0,0,9
1935726,1479177,2025-02-03,House,"FLOOR VOTE: CONSENT CALENDAR PASSAGE ON THIRD CONSIDERATION",91,0,0,0,91
1935951,1476564,2025-01-29,House,"HOUSE DISASTER RELIEF COMMITTEE OF EXTRAORDINARY SESSION: Rec. for pass; ref to Government Operations Committee of 1st Extraordinary Session",21,0,0,0,21
1935951,1476565,2025-01-29,House,"HOUSE FINANCE, WAYS, AND MEANS COMMITTEE OF EXTRAORDINARY SESSION: Rec. for pass; ref to Calendar & Rules Committee of 1st Extraordinary Session",26,0,0,0,26
1935951,1476566,2025-01-29,House,"HOUSE GOVERNMENT OPERATIONS COMMITTEE OF EXTRAORDINARY SESSION: Rec. for pass; ref to Finance, Ways, and Means Committee of 1st Extraordinary Session",20,1,0,0,21
1936008,1476547,2025-01-29,House,"HOUSE FINANCE, WAYS, AND MEANS COMMITTEE OF EXTRAORDINARY SESSION: Rec. for pass; ref to Calendar & Rules Committee of 1st Extraordinary Session",21,5,0,0,26
1936063,1521137,2025-03-19,House,"HOUSE CRIMINAL JUSTICE SUBCOMMITTEE: Rec for pass if am by s/c ref. to Judiciary Committee",7,2,0,0,9
1936063,1541924,2025-04-09,House,"HOUSE JUDICIARY COMMITTEE: Rec. for pass. if am., ref. to Finance, Ways, and Means Committee",16,6,0,0,22
1936063,1551865,2025-04-17,House,"HOUSE FINANCE, WAYS, AND MEANS SUBCOMMITTEE: Rec. for pass by s/c ref. to Finance, Ways, and Means Committee",11,0,0,0,11
1936063,1553407,2025-04-17,House,"HOUSE FINANCE, WAYS, AND MEANS COMMITTEE: Rec. for pass; ref to Calendar & Rules Committee",27,0,0,0,27
1936063,1553408,2025-04-17,House,"HOUSE FINANCE, WAYS, AND MEANS COMMITTEE: Rec. for pass; ref to Calendar & Rules Committee",18,8,1,0,27
1936176,1476548,2025-01-29,House,"HOUSE EDUCATION COMMITTEE OF EXTRAORDINARY SESSION: Rec. for pass. if am., ref. to Government Operations Committee of 1st Extraordinary Session",18,6,0,0,24
1936176,1476549,2025-01-29,House,"HOUSE FINANCE, WAYS, AND MEANS COMMITTEE OF EXTRAORDINARY SESSION: Rec. for pass; ref to Calendar & Rules Committee of 1st Extraordinary Session",21,6,0,0,27
1936176,1476550,2025-01-29,House,"HOUSE GOVERNMENT OPERATIONS COMMITTEE OF EXTRAORDINARY SESSION: Rec. for pass. if am., ref. to Finance, Ways, and Means Committee of 1st Extraordinary Session",17,4,0,0,21
1936176,1477563,2025-01-30,House,"FLOOR VOTE: REGULAR CALENDAR AMENDMENT # 1 BY PEARSON MOTION TO ADOPT AMENDMENT # 1 BY CEPICKY PASSAGE ON THIRD CONSIDERATION",22,75,0,0,97
1936176,1477564,2025-01-30,House,"FLOOR VOTE: REGULAR CALENDAR AMENDMENT # 2 BY PEARSON MOTION TO ADOPT AMENDMENT # 1 BY CEPICKY PASSAGE ON THIRD CONSIDERATION",21,74,0,0,95
1936176,1477565,2025-01-30,House,"FLOOR VOTE: REGULAR CALENDAR AMENDMENT # 3 BY PEARSON MOTION TO ADOPT AMENDMENT # 1 BY CEPICKY PASSAGE ON THIRD CONSIDERATION",20,74,0,0,94
1936176,1477566,2025-01-30,House,"FLOOR VOTE: REGULAR CALENDAR AS AMENDED PASSAGE ON THIRD CONSIDERATION",54,43,1,0,98
1936176,1477567,2025-01-30,House,"FLOOR VOTE: REGULAR CALENDAR LAY ON THE TABLE MOTION TO ADOPT AMENDMENT # 10 BY HAKEEM PASSAGE ON THIRD CONSIDERATION",71,25,0,0,96
1936176,1477568,2025-01-30,House,"FLOOR VOTE: REGULAR CALENDAR LAY ON THE TABLE MOTION TO ADOPT AMENDMENT # 11 BY CAMPER PASSAGE ON THIRD CONSIDERATION",69,25,0,0,94
1936176,1477569,2025-01-30,House,"FLOOR VOTE: REGULAR CALENDAR LAY ON THE TABLE MOTION TO ADOPT AMENDMENT # 12 BY CAMPER PASSAGE ON THIRD CONSIDERATION",72,23,0,0,95
1936176,1477570,2025-01-30,House,"FLOOR VOTE: REGULAR CALENDAR LAY ON THE TABLE MOTION TO ADOPT AMENDMENT # 13 BY CAMPER PASSAGE ON THIRD CONSIDERATION",72,23,0,0,95
1936176,1477571,2025-01-30,House,"FLOOR VOTE: REGULAR CALENDAR LAY ON THE TABLE MOTION TO ADOPT AMENDMENT # 14 BY SALINAS PASSAGE ON THIRD CONSIDERATION",74,24,0,0,98
1936176,1477572,2025-01-30,House,"FLOOR VOTE: REGULAR CALENDAR LAY ON THE TABLE MOTION TO ADOPT AMENDMENT # 15 BY SALINAS PASSAGE ON THIRD CONSIDERATION",75,23,0,0,98
1936176,1477573,2025-01-30,House,"FLOOR VOTE: REGULAR CALENDAR LAY ON THE TABLE MOTION TO ADOPT AMENDMENT # 16 BY JOHNSON PASSAGE ON THIRD CONSIDERATION",74,23,0,0,97
1936176,1477574,2025-01-30,House,"FLOOR VOTE: REGULAR CALENDAR LAY ON THE TABLE MOTION TO ADOPT AMENDMENT # 17 BY JOHNSON PASSAGE ON THIRD CONSIDERATION",73,23,0,0,96
1936176,1477575,2025-01-30,House,"FLOOR VOTE: REGULAR CALENDAR LAY ON THE TABLE MOTION TO ADOPT AMENDMENT # 18 BY JOHNSON PASSAGE ON THIRD CONSIDERATION",75,23,0,0,98
1936176,1477576,2025-01-30,House,"FLOOR VOTE: REGULAR CALENDAR LAY ON THE TABLE MOTION TO ADOPT AMENDMENT # 19 BY LOVE PASSAGE ON THIRD CONSIDERATION",75,23,0,0,98
1936176,1477577,2025-01-30,House,"FLOOR VOTE: REGULAR CALENDAR LAY ON THE TABLE MOTION TO ADOPT AMENDMENT # 20 BY HARDAWAY PASSAGE ON THIRD CONSIDERATION",75,23,0,0,98
1936176,1477578,2025-01-30,House,"FLOOR VOTE: REGULAR CALENDAR LAY ON THE TABLE MOTION TO ADOPT AMENDMENT # 21 BY HARDAWAY PASSAGE ON THIRD CONSIDERATION",74,23,0,0,97
1936176,1477579,2025-01-30,House,"FLOOR VOTE: REGULAR CALENDAR LAY ON THE TABLE MOTION TO ADOPT AMENDMENT # 22 BY HURT PASSAGE ON THIRD CONSIDERATION",33,63,2,0,98
1936176,1477580,2025-01-30,House,"FLOOR VOTE: REGULAR CALENDAR LAY ON THE TABLE MOTION TO ADOPT AMENDMENT # 3 BY HEMMER PASSAGE ON THIRD CONSIDERATION",74,22,0,0,96
1936176,1477581,2025-01-30,House,"FLOOR VOTE: REGULAR CALENDAR LAY ON THE TABLE MOTION TO ADOPT AMENDMENT # 5 BY POWELL PASSAGE ON THIRD CONSIDERATION",74,23,0,0,97
1936176,1477582,2025-01-30,House,"FLOOR VOTE: REGULAR CALENDAR LAY ON THE TABLE MOTION TO ADOPT AMENDMENT # 6 BY CLEMMONS PASSAGE ON THIRD CONSIDERATION",73,24,0,0,97
1936176,1477583,2025-01-30,House,"FLOOR VOTE: REGULAR CALENDAR LAY ON THE TABLE MOTION TO ADOPT AMENDMENT # 7 BY DIXIE PASSAGE ON THIRD CONSIDERATION",74,23,0,0,97
1936176,1477584,2025-01-30,House,"FLOOR VOTE: REGULAR CALENDAR LAY ON THE TABLE MOTION TO ADOPT AMENDMENT # 8 BY DIXIE PASSAGE ON THIRD CONSIDERATION",74,22,0,0,96
1936176,1477585,2025-01-30,House,"FLOOR VOTE: REGULAR CALENDAR MOTION TO ADOPT AMENDMENT # 2 BY MITCHELL PASSAGE ON THIRD CONSIDERATION",17,75,0,0,92
1936176,1477586,2025-01-30,House,"FLOOR VOTE: REGULAR CALENDAR MOTION TO ADOPT AMENDMENT # 22 BY HURT PASSAGE ON THIRD CONSIDERATION",37,53,5,0,95
1936176,1477587,2025-01-30,House,"FLOOR VOTE: REGULAR CALENDAR MOTION TO CONSIDER AMENDMENT # 24 BY PEARSON PASSAGE ON THIRD CONSIDERATION",21,74,0,0,95
1936176,1477588,2025-01-30,House,"FLOOR VOTE: REGULAR CALENDAR MOTION TO CONSIDER AMENDMENT # 25 BY PEARSON PASSAGE ON THIRD CONSIDERATION",22,76,0,0,98
1936176,1477589,2025-01-30,House,"FLOOR VOTE: REGULAR CALENDAR MOTION TO CONSIDER AMENDMENT # 26 BY PEARSON PASSAGE ON THIRD CONSIDERATION",23,74,0,0,97
1936176,1477590,2025-01-30,House,"FLOOR VOTE: REGULAR CALENDAR MOTION TO CONSIDER AMENDMENT # 27 BY JONES J PASSAGE ON THIRD CONSIDERATION",23,73,0,0,96
1936176,1477591,2025-01-30,House,"FLOOR VOTE: REGULAR CALENDAR MOTION TO CONSIDER AMENDMENT # 27 BY PEARSON PASSAGE ON THIRD CONSIDERATION",20,77,0,0,97
1936176,1492167,2025-01-30,Senate,"FLOOR VOTE: Lay on the Table Motion to Adopt Amend# 2 by Senator Lamar",25,6,0,0,31
1936176,1492168,2025-01-30,Senate,"FLOOR VOTE: Third Consideration",20,13,0,0,33
1936234,1500142,2025-02-26,House,"HOUSE CITIES & COUNTIES SUBCOMMITTEE: Rec. for pass by s/c ref. to State & Local Government Committee",7,0,0,0,7
1936234,1541995,2025-04-09,House,"HOUSE STATE & LOCAL GOVERNMENT COMMITTEE: Rec. for pass. if am., ref. to Calendar & Rules Committee",21,0,0,0,21
1936344,1476614,2025-01-29,House,"HOUSE FINANCE, WAYS, AND MEANS COMMITTEE OF EXTRAORDINARY SESSION: Rec. for pass; ref to Calendar & Rules Committee of 1st Extraordinary Session",26,0,0,0,26
1936399,1541338,2025-04-08,Senate,"SENATE JUDICIARY COMMITTEE: Recommended for passage with amendment/s, refer to Senate Calendar Committee Ayes 8, Nays 0 PNV 0",8,0,0,0,8
1936449,1476278,2025-01-29,House,"HOUSE IMMIGRATION COMMITTEE OF EXTRAORDINARY SESSION: Rec. for pass. if am., ref. to Finance, Ways, and Means Committee of 1st Extraordinary Session",15,5,0,0,20
1936449,1476596,2025-01-29,House,"HOUSE FINANCE, WAYS, AND MEANS COMMITTEE OF EXTRAORDINARY SESSION: Rec. for pass; ref to Calendar & Rules Committee of 1st Extraordinary Session",20,5,0,0,25
1936869,1506187,2025-03-05,House,"HOUSE AGRICULTURE AND NATURAL RESOURCES SUBCOMMITTEE: Rec. for pass by s/c ref. to Agriculture & Natural Resources Committee",8,0,0,0,8
1936869,1513576,2025-03-11,House,"HOUSE AGRICULTURE & NATURAL RESOURCES COMMITTEE: Rec. for pass; ref to Finance, Ways, and Means Committee",14,0,0,0,14
1936883,1515656,2025-03-11,Senate,"SENATE JUDICIARY COMMITTEE: Recommended for passage, refer to Senate Calendar Committee",9,0,0,0,9
1936883,1519431,2025-03-17,Senate,"FLOOR VOTE: Motion to Adopt",32,0,0,0,32
1936883,1553353,2025-04-21,House,"FLOOR VOTE: REGULAR CALENDAR PASSAGE ON THIRD CONSIDERATION",94,0,0,0,94
1936899,1494602,2025-02-10,House,"HOUSE NAMING & DESIGNATING COMMITTEE: Rec. for pass. if am., ref. to Health Committee",9,0,0,0,9
1936899,1494603,2025-02-18,House,"HOUSE HEALTH COMMITTEE: Rec. for pass; ref to Calendar & Rules Committee",21,0,0,0,21
1936899,1497521,2025-02-24,House,"FLOOR VOTE: REGULAR CALENDAR AS AMENDED PASSAGE ON THIRD CONSIDERATION",94,0,0,0,94
1936934,1479277,2025-02-03,House,"FLOOR VOTE: CONSENT CALENDAR PASSAGE ON THIRD CONSIDERATION",91,0,0,0,91
1936934,1489969,2025-02-13,Senate,"FLOOR VOTE: Motion to Adopt",31,0,0,0,31
1936950,1503582,2025-03-03,House,"HOUSE NAMING & DESIGNATING COMMITTEE: Rec. for pass; ref to Judiciary Committee",7,2,1,0,10
1936950,1540081,2025-04-08,House,"HOUSE JUDICIARY COMMITTEE: Rec. for pass; ref to Calendar & Rules Committee",16,4,0,0,20
1936965,1487368,2025-02-12,House,"INSURANCE SUBCOMMITTEE: Rec. for pass by s/c ref. to Insurance Committee",6,0,0,0,6
1936965,1500702,2025-02-26,House,"HOUSE INSURANCE COMMITTEE: Rec. for pass; ref to Government Operations Committee",18,0,0,0,18
1936965,1509211,2025-03-10,House,"HOUSE GOVERNMENT OPERATIONS COMMITTEE: Rec. for pass; ref to Finance, Ways, and Means Committee",14,0,0,0,14
1936965,1521830,2025-03-19,House,"HOUSE FINANCE, WAYS, AND MEANS SUBCOMMITTEE: Rec. for pass by s/c ref. to Finance, Ways, and Means Committee",12,0,0,0,12
1936965,1527097,2025-03-25,House,"HOUSE FINANCE, WAYS, AND MEANS COMMITTEE: Rec. for pass; ref to Calendar & Rules Committee",23,0,0,0,23
1936965,1531109,2025-03-31,House,"FLOOR VOTE: CONSENT CALENDAR PASSAGE ON THIRD CONSIDERATION",93,0,2,0,95
1936979,1522154,2025-03-19,Senate,"SENATE HEALTH AND WELFARE COMMITTEE: Recommended for passage with amendment/s, refer to Senate Calendar Committee Ayes 9, Nays 0 PNV 0",9,0,0,0,9
1937030,1539707,2025-04-08,Senate,"SENATE FINANCE, WAYS AND MEANS COMMITTEE: Recommended for passage, refer to Senate Calendar Committee",7,2,0,0,9
1937030,1548180,2025-04-14,Senate,"FLOOR VOTE: Third Consideration",25,6,0,0,31
1937030,1551164,2025-04-17,House,"FLOOR VOTE: REGULAR CALENDAR MOTION TO CONSIDER AMENDMENT # 1 BY SALINAS PASSAGE ON THIRD CONSIDERATION",25,71,0,0,96
1937030,1551165,2025-04-17,House,"FLOOR VOTE: REGULAR CALENDAR PASSAGE ON THIRD CONSIDERATION",72,25,0,0,97
1937030,1551166,2025-04-17,House,"FLOOR VOTE: REGULAR CALENDAR PREVIOUS QUESTION PASSAGE ON THIRD CONSIDERATION",73,24,0,0,97
1937081,1479103,2025-02-03,House,"FLOOR VOTE: CONSENT CALENDAR PASSAGE ON THIRD CONSIDERATION",91,0,0,0,91
1937081,1490406,2025-02-13,Senate,"FLOOR VOTE: Motion to Adopt",31,0,0,0,31
1937113,1494600,2025-02-10,House,"HOUSE NAMING & DESIGNATING COMMITTEE: Rec. for pass; ref to Education Committee",9,0,0,0,9
1937113,1494601,2025-02-18,House,"HOUSE EDUCATION COMMITTEE: Rec. for pass. if am., ref. to Calendar & Rules Committee",18,0,0,0,18
1937113,1498465,2025-02-24,House,"FLOOR VOTE: REGULAR CALENDAR AS AMENDED PASSAGE ON THIRD CONSIDERATION",95,0,0,0,95
1937143,1527595,2025-03-26,Senate,"SENATE ENERGY, AGRICULTURE AND NATURAL RESOURCES COMMITTEE: Recommended for passage, refer to Senate Calendar Committee",9,0,0,0,9
1937143,1531984,2025-03-31,Senate,"FLOOR VOTE: Motion to Adopt",30,0,0,0,30
1937143,1538780,2025-04-07,House,"FLOOR VOTE: REGULAR CALENDAR AS AMENDED PASSAGE ON THIRD CONSIDERATION",94,0,1,0,95
1937143,1543693,2025-04-10,Senate,"FLOOR VOTE: Motion to Concur House Amendment # 1",31,0,0,0,31
1937198,1488473,2025-02-12,House,"HOUSE CITIES & COUNTIES SUBCOMMITTEE: Rec. for pass by s/c ref. to State & Local Government Committee",7,0,0,0,7
1937198,1494606,2025-02-19,House,"HOUSE STATE & LOCAL GOVERNMENT COMMITTEE: Rec. for pass; ref to Calendar & Rules Committee",21,0,0,0,21
1937198,1497776,2025-02-24,House,"FLOOR VOTE: CONSENT CALENDAR PASSAGE ON THIRD CONSIDERATION",92,0,2,0,94
1937198,1548174,2025-04-14,Senate,"FLOOR VOTE: as Amended Third Consideration",31,1,0,0,32
1937198,1550049,2025-04-16,House,"FLOOR VOTE: MESSAGE CALENDAR CONCUR IN SENATE AMENDMENT # 1",88,0,2,0,90
1937338,1519503,2025-03-18,Senate,"SENATE STATE & LOCAL GOVERNMENT COMMITTEE: Recommended for passage with amendment/s, refer to Senate Calendar Committee Ayes 7, Nays 1 PNV 1",7,1,1,0,9
1937338,1528223,2025-03-26,Senate,"FLOOR VOTE: as Amended Third Consideration",27,4,1,0,32
1937446,1494536,2025-02-19,House,"HOUSE BANKING AND CONSUMER AFFAIRS SUBCOMMITTEE: Rec. for pass by s/c ref. to Commerce Committee",5,0,0,0,5
1937446,1500065,2025-02-26,House,"HOUSE COMMERCE COMMITTEE: Rec. for pass; ref to Calendar & Rules Committee",22,0,0,0,22
1937446,1503378,2025-03-03,House,"FLOOR VOTE: CONSENT CALENDAR PASSAGE ON THIRD CONSIDERATION",89,0,0,0,89
1937517,1521924,2025-03-19,House,"HOUSE CITIES & COUNTIES SUBCOMMITTEE: Rec for pass if am by s/c ref. to State & Local Government Committee",7,0,0,0,7
1937517,1527768,2025-03-26,House,"HOUSE STATE & LOCAL GOVERNMENT COMMITTEE: Rec. for pass. if am., ref. to Finance, Ways, and Means Committee",22,0,0,0,22
1937517,1534592,2025-04-02,House,"HOUSE FINANCE, WAYS, AND MEANS SUBCOMMITTEE: Rec. for pass by s/c ref. to Finance, Ways, and Means Committee",9,0,0,0,9
1937517,1540131,2025-04-08,House,"HOUSE FINANCE, WAYS, AND MEANS COMMITTEE: Rec. for pass; ref to Calendar & Rules Committee",26,0,0,0,26
1937551,1500099,2025-02-26,House,"HOUSE CRIMINAL JUSTICE SUBCOMMITTEE: Rec. for pass by s/c ref. to Judiciary Committee",7,0,1,0,8
1937551,1506258,2025-03-05,House,"HOUSE JUDICIARY COMMITTEE: Rec. for pass; ref to Calendar & Rules Committee",20,0,1,0,21
1937661,1520002,2025-03-18,Senate,"SENATE STATE & LOCAL GOVERNMENT COMMITTEE: Recommended for passage with amendment/s, refer to Senate Calendar Committee Ayes 7, Nays 1 PNV 1",7,1,1,0,9
1937661,1528817,2025-03-27,Senate,"FLOOR VOTE: as Amended Third Consideration",27,0,1,0,28
1937661,1538675,2025-04-07,House,"FLOOR VOTE: REGULAR CALENDAR PASSAGE ON THIRD CONSIDERATION",77,14,5,0,96
1937661,1538676,2025-04-07,House,"FLOOR VOTE: REGULAR CALENDAR PREVIOUS QUESTION PASSAGE ON THIRD CONSIDERATION",73,22,0,0,95
1937701,1521881,2025-03-19,House,"HOUSE BANKING AND CONSUMER AFFAIRS SUBCOMMITTEE: Rec for pass if am by s/c ref. to Commerce Committee",6,0,1,0,7
1937701,1527429,2025-03-26,House,"HOUSE COMMERCE COMMITTEE: Rec. for pass. if am., ref. to Calendar & Rules Committee",19,0,2,0,21
1937735,1515643,2025-03-11,Senate,"SENATE JUDICIARY COMMITTEE: Recommended for passage, refer to Senate Calendar Committee",9,0,0,0,9
1937735,1519434,2025-03-17,Senate,"FLOOR VOTE: Motion to Adopt",32,0,0,0,32
1937804,1515795,2025-03-12,House,"HOUSE PUBLIC SERVICE SUBCOMMITTEE: Rec. for pass by s/c ref. to State & Local Government Committee",5,0,0,0,5
1937804,1542008,2025-04-09,House,"HOUSE STATE & LOCAL GOVERNMENT COMMITTEE: Rec. for pass; ref to Finance, Ways, and Means Committee",20,0,0,0,20
1937844,1500079,2025-02-26,House,"HOUSE PUBLIC SERVICE SUBCOMMITTEE: Rec. for pass by s/c ref. to State & Local Government Committee",5,0,0,0,5
1937844,1539964,2025-04-08,House,"HOUSE STATE & LOCAL GOVERNMENT COMMITTEE: Rec. for pass; ref to Calendar & Rules Committee",19,0,2,0,21
1937844,1547638,2025-04-14,House,"FLOOR VOTE: CONSENT CALENDAR PASSAGE ON THIRD CONSIDERATION",94,0,1,0,95
1937947,1479349,2025-02-03,House,"FLOOR VOTE: CONSENT CALENDAR PASSAGE ON THIRD CONSIDERATION",91,0,0,0,91
1937947,1489989,2025-02-13,Senate,"FLOOR VOTE: Motion to Adopt",31,0,0,0,31
1938023,1526114,2025-03-25,Senate,"SENATE STATE & LOCAL GOVERNMENT COMMITTEE: Recommended for passage, refer to Senate Calendar Committee",9,0,0,0,9
1938023,1532149,2025-03-31,Senate,"FLOOR VOTE: Motion to Adopt",30,0,0,0,30
1938023,1554092,2025-04-21,House,"FLOOR VOTE: REGULAR CALENDAR PASSAGE ON THIRD CONSIDERATION",93,0,0,0,93
1938167,1520356,2025-03-18,House,"HOUSE K-12 SUBCOMMITTEE: Rec for pass if am by s/c ref. to Education Committee",8,0,0,0,8
1938167,1534635,2025-04-02,House,"HOUSE EDUCATION COMMITTEE: Rec. for pass. if am., ref. to Finance, Ways, and Means Committee",17,0,1,0,18
1938440,1494637,2025-02-13,Senate,"FLOOR VOTE: Motion to Adopt",31,0,0,0,31
1938440,1498229,2025-02-24,House,"FLOOR VOTE: CONSENT CALENDAR PASSAGE ON THIRD CONSIDERATION",92,0,2,0,94
1938507,1494609,2025-02-18,House,"HOUSE EDUCATION ADMINISTRATION SUBCOMMITTEE: Rec. for pass by s/c ref. to Education Committee",6,0,0,0,6
1938507,1519803,2025-03-18,House,"HOUSE EDUCATION COMMITTEE: Rec. for pass. if am., ref. to Calendar & Rules Committee",17,1,0,0,18
1938576,1498304,2025-02-24,House,"HOUSE NAMING & DESIGNATING COMMITTEE: Rec. for pass; ref to State & Local Government Committee",8,2,0,0,10
1938576,1506593,2025-03-05,House,"HOUSE STATE & LOCAL GOVERNMENT COMMITTEE: Rec. for pass. if am., ref. to Finance, Ways, and Means Committee",17,2,1,0,20
1938780,1519705,2025-03-18,House,"HOUSE CHILDREN AND FAMILY AFFAIRS SUBCOMMITTEE: Rec for pass if am by s/c ref. to Judiciary Committee",7,0,0,0,7
1938780,1534195,2025-04-02,House,"HOUSE JUDICIARY COMMITTEE: Rec. for pass. if am., ref. to Calendar & Rules Committee",20,0,0,0,20
1938848,1504683,2025-03-04,House,"HOUSE DEPARTMENTS & AGENCIES SUBCOMMITTEE: Rec for pass if am by s/c ref. to State & Local Government Committee",8,0,0,0,8
1938848,1534798,2025-04-02,House,"HOUSE STATE & LOCAL GOVERNMENT COMMITTEE: Rec. for pass. if am., ref. to Calendar & Rules Committee",20,1,1,0,22
1938916,1489971,2025-02-13,Senate,"FLOOR VOTE: Motion to Adopt",31,0,0,0,31
1938916,1498228,2025-02-24,House,"FLOOR VOTE: CONSENT CALENDAR PASSAGE ON THIRD CONSIDERATION",92,0,2,0,94
1939626,1515652,2025-03-11,Senate,"SENATE JUDICIARY COMMITTEE: Recommended for passage, refer to Senate Calendar Committee",7,2,0,0,9
1939626,1528587,2025-03-27,Senate,"FLOOR VOTE: Third Consideration",27,5,0,0,32
1939626,1529062,2025-03-27,House,"FLOOR VOTE: REGULAR CALENDAR PASSAGE ON THIRD CONSIDERATION",76,14,5,0,95
1939684,1499525,2025-02-25,Senate,"SENATE COMMERCE AND LABOR COMMITTEE: Recommended for passage, Refer to Senate Calendar Committee",7,0,0,0,7
1939684,1514180,2025-03-03,Senate,"FLOOR VOTE: Motion to Adopt",32,0,0,0,32
1939700,1515984,2025-03-12,Senate,"SENATE ENERGY, AGRICULTURE AND NATURAL RESOURCES COMMITTEE: Recommended for passage, refer to Senate Calendar Committee",9,0,0,0,9
1939719,1515653,2025-03-11,Senate,"SENATE JUDICIARY COMMITTEE: Recommended for passage, refer to Senate Calendar Committee",9,0,0,0,9
1939742,1513936,2025-03-11,Senate,"SENATE COMMERCE AND LABOR COMMITTEE: Recommended for passage, refer to Senate Calendar Committee",9,0,0,0,9
1939742,1519439,2025-03-17,Senate,"FLOOR VOTE: Motion to Adopt",32,0,0,0,32
1939742,1553362,2025-04-21,House,"FLOOR VOTE: REGULAR CALENDAR PASSAGE ON THIRD CONSIDERATION",94,0,0,0,94
1939759,1520820,2025-03-18,Senate,"SENATE COMMERCE AND LABOR COMMITTEE: Recommended for passage, refer to Senate Finance, Ways, and Means Committee",8,0,0,0,8
1939759,1552743,2025-04-21,Senate,"SENATE FINANCE, WAYS AND MEANS COMMITTEE: Recommended for passage, refer to Senate Calendar Committee",10,0,0,0,10
1939778,1533945,2025-04-01,Senate,"SENATE JUDICIARY COMMITTEE: Recommended for passage with amendment/s, refer to Senate Calendar Committee Ayes 8, Nays 0 PNV 1",8,0,1,0,9
1939778,1539246,2025-04-07,Senate,"FLOOR VOTE: as Amended Third Consideration",32,0,0,0,32
1939778,1544538,2025-04-10,House,"FLOOR VOTE: REGULAR CALENDAR MOTION TO CONSIDER AMENDMENT # 2 BY PEARSON PASSAGE ON THIRD CONSIDERATION",24,69,0,0,93
1939778,1544539,2025-04-10,House,"FLOOR VOTE: REGULAR CALENDAR PASSAGE ON THIRD CONSIDERATION",90,4,0,0,94
1939778,1544540,2025-04-10,House,"FLOOR VOTE: REGULAR CALENDAR PREVIOUS QUESTION PASSAGE ON THIRD CONSIDERATION",75,18,0,0,93
1939798,1519993,2025-03-18,Senate,"SENATE STATE & LOCAL GOVERNMENT COMMITTEE: Recommended for passage, refer to Senate Finance, Ways, and Means Committee",8,0,1,0,9
1939798,1543093,2025-04-09,Senate,"SENATE FINANCE, WAYS AND MEANS COMMITTEE: Recommended for passage, refer to Senate Calendar Committee",10,0,1,0,11
1939835,1500226,2025-02-26,Senate,"SENATE HEALTH AND WELFARE COMMITTEE: Recommended for passage with amendment/s, refer to Senate Calendar Committee Ayes 8, Nays 1 PNV 0",8,1,0,0,9
1939835,1507088,2025-03-06,House,"FLOOR VOTE: REGULAR CALENDAR PASSAGE ON THIRD CONSIDERATION",84,5,3,0,92
1939835,1513846,2025-03-06,Senate,"FLOOR VOTE: as Amended Third Consideration",28,1,1,0,30
1939872,1516061,2025-03-11,Senate,"SENATE STATE & LOCAL GOVERNMENT COMMITTEE: Recommended for passage, refer to Senate Calendar Committee",7,0,0,0,7
1939872,1519326,2025-03-17,Senate,"FLOOR VOTE: Motion to Adopt",32,0,0,0,32
1939906,1494916,2025-02-18,House,"HOUSE DEPARTMENTS & AGENCIES SUBCOMMITTEE: Rec. for pass by s/c ref. to State & Local Government Committee",7,0,0,0,7
1939906,1516259,2025-03-12,House,"HOUSE STATE & LOCAL GOVERNMENT COMMITTEE: Rec. for pass; ref to Government Operations Committee",22,1,0,0,23
1939906,1518748,2025-03-17,House,"HOUSE GOVERNMENT OPERATIONS COMMITTEE: Rec. for pass; ref to Finance, Ways, and Means Committee",13,0,0,0,13
1940620,1526275,2025-03-25,House,"HOUSE CRIMINAL JUSTICE SUBCOMMITTEE: Def. to Summer Study in Criminal Justice Subcommittee",9,0,0,0,9
1941329,1500891,2025-02-26,Senate,"SENATE HEALTH AND WELFARE COMMITTEE: Recommended for adoption by Senate Health and Welfare Committee, refer Senate Calendar Committee",9,0,0,0,9
1941329,1514283,2025-03-03,Senate,"FLOOR VOTE: Motion to Adopt",32,0,0,0,32
1941540,1476489,2025-01-29,House,"HOUSE GOVERNMENT OPERATIONS COMMITTEE OF EXTRAORDINARY SESSION: Rec. for pass; ref to Calendar & Rules Committee of 1st Extraordinary Session",22,0,0,0,22
1941540,1476490,2025-01-29,House,"HOUSE TRANSPORTATION COMMITTEE OF EXTRAORDINARY SESSION: Rec. for pass; ref to Government Operations Committee of 1st Extraordinary Session",20,0,0,0,20
1941744,1476491,2025-01-29,House,"HOUSE DISASTER RELIEF COMMITTEE OF EXTRAORDINARY SESSION: Rec. for pass. if am., ref. to Finance, Ways, and Means Committee of 1st Extraordinary Session",22,0,0,0,22
1941744,1476492,2025-01-29,House,"HOUSE FINANCE, WAYS, AND MEANS COMMITTEE OF EXTRAORDINARY SESSION: Rec. for pass; ref to Calendar & Rules Committee of 1st Extraordinary Session",26,0,0,0,26
1941890,1521781,2025-03-19,House,"HOUSE CITIES & COUNTIES SUBCOMMITTEE: Failed in s/c Cities & Counties Subcommittee of State & Local Government Committee",1,5,0,0,6
1941911,1516842,2025-03-12,Senate,"SENATE EDUCATION COMMITTEE: Recommended for passage, refer to Senate Calendar Committee",8,0,0,0,8
1941911,1548869,2025-04-15,House,"FLOOR VOTE: REGULAR CALENDAR PASSAGE ON THIRD CONSIDERATION",82,8,2,0,92
1941911,1549482,2025-04-15,Senate,"FLOOR VOTE: as Amended Third Consideration",31,0,1,0,32
1941932,1504040,2025-03-03,House,"HOUSE NAMING & DESIGNATING COMMITTEE: Rec. for pass; ref to Health Committee",10,0,0,0,10
1941932,1513939,2025-03-11,House,"HOUSE HEALTH COMMITTEE: Rec. for pass; ref to Calendar & Rules Committee",17,0,0,0,17
1941932,1525641,2025-03-24,House,"FLOOR VOTE: CONSENT CALENDAR PASSAGE ON THIRD CONSIDERATION",96,0,0,0,96
1941983,1493237,2025-02-18,Senate,"SENATE JUDICIARY COMMITTEE: Recommended for passage with amendment/s, refer to Senate Calendar Committee Ayes 8, Nays 1 PNV 0",8,1,0,0,9
1941983,1531952,2025-03-31,Senate,"FLOOR VOTE: as Amended Third Consideration",27,2,0,0,29
1941983,1535669,2025-04-03,House,"FLOOR VOTE: REGULAR CALENDAR PASSAGE ON THIRD CONSIDERATION",82,2,0,0,84
1942002,1500211,2025-02-26,Senate,"TRANSPORTATION AND SAFETY COMMITTEE: Recommended for passage with amendment/s, refer to Senate Calendar Committee Ayes 9, Nays 0 PNV 0",9,0,0,0,9
1942031,1499818,2025-02-25,Senate,"SENATE JUDICIARY COMMITTEE: Recommended for passage with amendment, refer to Senate Calendar Committee",9,0,0,0,9
1942031,1514428,2025-03-03,Senate,"FLOOR VOTE: as Amended Third Consideration",32,0,0,0,32
1942031,1531212,2025-03-31,House,"FLOOR VOTE: REGULAR CALENDAR PASSAGE ON THIRD CONSIDERATION",94,0,0,0,94
1942076,1489958,2025-02-13,Senate,"FLOOR VOTE: Motion to Adopt",31,0,0,0,31
1942076,1498256,2025-02-24,House,"FLOOR VOTE: CONSENT CALENDAR PASSAGE ON THIRD CONSIDERATION",92,0,2,0,94
1942119,1500810,2025-02-26,Senate,"SENATE ENERGY, AGRICULTURE AND NATURAL RESOURCES COMMITTEE: Recommended for passage, refer to Senate Calendar Committee",9,0,0,0,9
1942119,1514837,2025-03-03,Senate,"FLOOR VOTE: Motion to Adopt",32,0,0,0,32
1942142,1516151,2025-03-12,House,"HOUSE CRIMINAL JUSTICE SUBCOMMITTEE: Rec for pass if am by s/c ref. to Judiciary Committee",7,0,0,0,7
1942142,1543151,2025-04-09,House,"HOUSE JUDICIARY COMMITTEE: Rec. for pass. if am., ref. to Calendar & Rules Committee",20,0,0,0,20
1942248,1494518,2025-02-18,House,"HOUSE TENNCARE SUBCOMMITTEE: Rec. for pass by s/c ref. to Insurance Committee",6,0,0,0,6
1942248,1500622,2025-02-26,House,"HOUSE INSURANCE COMMITTEE: Rec. for pass; ref to Finance, Ways, and Means Committee",18,0,0,0,18
1942272,1533930,2025-04-01,Senate,"SENATE JUDICIARY COMMITTEE: Recommended for passage with amendment/s, refer to Senate Finance, Ways, and Means Committee Ayes 7, Nays 1 PNV 1",7,1,1,0,9
1942272,1548947,2025-04-15,Senate,"SENATE FINANCE, WAYS AND MEANS COMMITTEE: Recommended for passage, refer to Senate Calendar Committee",6,3,0,0,9
1942310,1494680,2025-02-18,House,"HOUSE TRANSPORTATION SUBCOMMITTEE: Rec. for pass by s/c ref. to Transportation Committee",6,2,0,0,8
1942310,1499053,2025-02-25,House,"HOUSE TRANSPORTATION COMMITTEE: Rec. for pass; ref to Finance, Ways, and Means Committee",14,2,1,0,17
1942339,1501218,2025-02-26,Senate,"SENATE EDUCATION COMMITTEE: Recommended for passage with amendment/s, refer to Senate Calendar Committee Ayes 9, Nays 0 PNV 0",9,0,0,0,9
1942339,1514314,2025-03-06,Senate,"FLOOR VOTE: as Amended Third Consideration",30,0,0,0,30
1942339,1528992,2025-03-27,House,"FLOOR VOTE: REGULAR CALENDAR PASSAGE ON THIRD CONSIDERATION",88,3,4,0,95
1942342,1516006,2025-03-11,Senate,"SENATE STATE & LOCAL GOVERNMENT COMMITTEE: Recommended for passage, refer to Senate Calendar Committee",8,0,0,0,8
1942342,1519728,2025-03-17,Senate,"FLOOR VOTE: Motion to Adopt",32,0,0,0,32
1942346,1492478,2025-02-18,Senate,"SENATE STATE & LOCAL GOVERNMENT COMMITTEE: Recommended for passage, refer to Senate Calendar Committee",9,0,0,0,9
1942346,1498429,2025-02-24,Senate,"FLOOR VOTE: as Amended Third Consideration",29,3,1,0,33
1942346,1519106,2025-03-17,House,"FLOOR VOTE: REGULAR CALENDAR PASSAGE ON THIRD CONSIDERATION",70,14,7,0,91
1942357,1521041,2025-03-19,House,"HOUSE HEALTH SUBCOMMITTEE: Rec for pass if am by s/c ref. to Health Committee",6,2,1,0,9
1942365,1496167,2025-01-30,Senate,"FLOOR VOTE: Motion to Adopt",32,0,0,0,32
1942370,1494862,2025-02-18,House,"HOUSE DEPARTMENTS & AGENCIES SUBCOMMITTEE: Rec. for pass by s/c ref. to State & Local Government Committee",5,0,0,0,5
1942370,1540628,2025-04-08,House,"HOUSE STATE & LOCAL GOVERNMENT COMMITTEE: Rec. for pass; ref to Calendar & Rules Committee",19,0,2,0,21
1942370,1547961,2025-04-14,House,"FLOOR VOTE: CONSENT CALENDAR PASSAGE ON THIRD CONSIDERATION",94,0,1,0,95
1942374,1494770,2025-02-19,House,"HOUSE HEALTH SUBCOMMITTEE: Rec. for pass by s/c ref. to Health Committee",9,0,0,0,9
1942374,1499568,2025-02-25,House,"HOUSE HEALTH COMMITTEE: Rec. for pass; ref to Finance, Ways, and Means Committee",21,0,0,0,21
1942374,1551959,2025-04-17,House,"HOUSE FINANCE, WAYS, AND MEANS SUBCOMMITTEE: Rec. for pass by s/c ref. to Finance, Ways, and Means Committee",11,0,0,0,11
1942374,1553575,2025-04-17,House,"HOUSE FINANCE, WAYS, AND MEANS COMMITTEE: Rec. for pass; ref to Calendar & Rules Committee",27,0,0,0,27
1942380,1532140,2025-04-01,House,"HOUSE CRIMINAL JUSTICE SUBCOMMITTEE: Rec for pass if am by s/c ref. to Judiciary Committee",9,0,0,0,9
1942380,1540742,2025-04-08,House,"HOUSE JUDICIARY COMMITTEE: Rec. for pass. if am., ref. to Finance, Ways, and Means Committee",22,0,0,0,22
1942380,1551930,2025-04-17,House,"HOUSE FINANCE, WAYS, AND MEANS SUBCOMMITTEE: Rec. for pass by s/c ref. to Finance, Ways, and Means Committee",11,0,0,0,11
1942380,1553164,2025-04-21,Senate,"FLOOR VOTE: Third Consideration",25,5,3,0,33
1942380,1553798,2025-04-17,House,"HOUSE FINANCE, WAYS, AND MEANS COMMITTEE: Rec. for pass; ref to Calendar & Rules Committee",27,0,0,0,27
1942380,1553799,2025-04-21,House,"FLOOR VOTE: REGULAR CALENDAR AS AMENDED PASSAGE ON THIRD CONSIDERATION",89,3,1,0,93
1942389,1479342,2025-02-03,House,"FLOOR VOTE: CONSENT CALENDAR PASSAGE ON THIRD CONSIDERATION",91,0,0,0,91
1942389,1490567,2025-02-13,Senate,"FLOOR VOTE: Motion to Adopt",31,0,0,0,31
1942396,1519397,2025-03-18,House,"HOUSE TENNCARE SUBCOMMITTEE: Rec. for pass by s/c ref. to Insurance Committee",5,0,0,0,5
1942396,1534545,2025-04-02,House,"HOUSE INSURANCE COMMITTEE: Rec. for pass; ref to Government Operations Committee",14,0,0,0,14
1942396,1538346,2025-04-07,House,"HOUSE GOVERNMENT OPERATIONS COMMITTEE: Rec. for pass; ref to Finance, Ways, and Means Committee",11,1,0,0,12
1942404,1491978,2025-02-18,Senate,"SENATE STATE & LOCAL GOVERNMENT COMMITTEE: Recommended for passage, refer to Senate Calendar Committee",8,0,1,0,9
1942404,1513718,2025-03-03,Senate,"FLOOR VOTE: Third Consideration",31,0,0,0,31
1942404,1523140,2025-03-20,House,"FLOOR VOTE: REGULAR CALENDAR PASSAGE ON THIRD CONSIDERATION",92,0,2,0,94
1942423,1499828,2025-02-25,Senate,"SENATE JUDICIARY COMMITTEE: Recommended for passage with amendment/s, refer to Senate Calendar Committee Ayes 9, Nays 0 PNV 0",9,0,0,0,9
1942423,1509242,2025-03-10,House,"FLOOR VOTE: REGULAR CALENDAR PASSAGE ON THIRD CONSIDERATION",92,0,0,0,92
1942423,1514338,2025-03-03,Senate,"FLOOR VOTE: as Amended Third Consideration",32,0,0,0,32
1942428,1490481,2025-02-13,Senate,"FLOOR VOTE: Motion to Adopt",31,0,0,0,31
1942428,1497926,2025-02-24,House,"FLOOR VOTE: CONSENT CALENDAR PASSAGE ON THIRD CONSIDERATION",92,0,2,0,94
1942436,1475940,2025-01-27,House,"FLOOR VOTE: UNFINISHED BUSINESS MOTION TO ADOPT",78,12,0,0,90
1942449,1514578,2025-03-11,House,"HOUSE DEPARTMENTS & AGENCIES SUBCOMMITTEE: Rec for pass if am by s/c ref. to State & Local Government Committee",7,0,0,0,7
1942449,1543131,2025-04-09,House,"HOUSE STATE & LOCAL GOVERNMENT COMMITTEE: Rec. for pass. if am., ref. to Finance, Ways, and Means Committee",16,1,1,0,18
1942449,1547203,2025-04-14,House,"HOUSE FINANCE, WAYS, AND MEANS SUBCOMMITTEE: Rec. for pass by s/c ref. to Finance, Ways, and Means Committee",8,2,1,0,11
1942449,1549346,2025-04-15,House,"HOUSE FINANCE, WAYS, AND MEANS COMMITTEE: Rec. for pass; ref to Calendar & Rules Committee",17,3,5,0,25
1942460,1505852,2025-03-05,Senate,"SENATE GOVERNMENT OPERATIONS COMMITTEE: Recommended for passage with amendment/s, refer to Senate Health and Welfare Committee Ayes 9, Nays 0 PNV 0",9,0,0,0,9
1942460,1522152,2025-03-19,Senate,"SENATE HEALTH AND WELFARE COMMITTEE: Recommended for passage, refer to Senate Calendar Committee",9,0,0,0,9
1942479,1475727,2025-01-27,House,"FLOOR VOTE: UNFINISHED BUSINESS MOTION TO ADOPT",72,18,0,0,90
1942485,1498742,2025-02-25,House,"HOUSE DEPARTMENTS & AGENCIES SUBCOMMITTEE: Rec. for pass by s/c ref. to State & Local Government Committee",8,0,0,0,8
1942485,1528187,2025-03-26,House,"HOUSE STATE & LOCAL GOVERNMENT COMMITTEE: Rec. for pass; ref to Calendar & Rules Committee",22,1,0,0,23
1942485,1530955,2025-03-31,House,"FLOOR VOTE: CONSENT CALENDAR PASSAGE ON THIRD CONSIDERATION",93,0,2,0,95
1942497,1500951,2025-02-26,House,"HOUSE BUSINESS AND UTILITIES SUBCOMMITTEE: Rec for pass if am by s/c ref. to Commerce Committee",11,0,0,0,11
1942497,1506719,2025-03-05,House,"HOUSE COMMERCE COMMITTEE: Rec. for pass. if am., ref. to Calendar & Rules Committee",20,0,0,0,20
1942507,1532909,2025-04-01,House,"HOUSE CRIMINAL JUSTICE SUBCOMMITTEE: Rec. for pass by s/c ref. to Judiciary Committee",8,0,0,0,8
1942507,1540744,2025-04-08,House,"HOUSE JUDICIARY COMMITTEE: Rec. for pass; ref to Finance, Ways, and Means Committee",19,1,0,0,20
1942507,1551949,2025-04-17,House,"HOUSE FINANCE, WAYS, AND MEANS SUBCOMMITTEE: Rec. for pass by s/c ref. to Finance, Ways, and Means Committee",11,0,0,0,11
1942507,1553825,2025-04-17,House,"HOUSE FINANCE, WAYS, AND MEANS COMMITTEE: Rec. for pass; ref to Calendar & Rules Committee",27,0,0,0,27
1942507,1553826,2025-04-17,House,"HOUSE FINANCE, WAYS, AND MEANS COMMITTEE: Rec. for pass; ref to Calendar & Rules Committee",26,0,0,0,26
1942511,1527623,2025-03-26,Senate,"SENATE HEALTH AND WELFARE COMMITTEE: Recommended for passage, refer to Senate Finance, Ways, and Means Committee",9,0,0,0,9
1942527,1504681,2025-03-04,Senate,"SENATE STATE & LOCAL GOVERNMENT COMMITTEE: Recommended for passage with amendment, refer to Senate Calendar Committee",9,0,0,0,9
1942533,1506399,2025-03-05,Senate,"SENATE ENERGY, AGRICULTURE AND NATURAL RESOURCES COMMITTEE: Recommended for passage, refer to Senate Calendar Committee",9,0,0,0,9
1942544,1475949,2025-01-28,Senate,"SENATE GOVERNMENT OPERATIONS COMMITTEE: Recommended for passage, refer to Senate Transportation and Safety Committee",8,0,0,0,8
1942544,1475950,2025-01-28,Senate,"TRANSPORTATION AND SAFETY COMMITTEE: Recommended for passage with amendment/s, refer to Senate State and Local Government Committee Ayes 8, Nays 1 PNV 0",8,1,0,0,9
1942544,1476296,2025-01-29,Senate,"SENATE STATE & LOCAL GOVERNMENT COMMITTEE: Recommended for passage, refer to Senate Calendar Committee",9,0,0,0,9
1942544,1476822,2025-01-29,Senate,"FLOOR VOTE: Third Consideration",31,2,0,0,33
1942544,1478603,2025-01-29,House,"FLOOR VOTE: REGULAR CALENDAR 2 PASSAGE ON THIRD CONSIDERATION",80,16,0,0,96
1942552,1497103,2025-02-11,House,"HOUSE EDUCATION ADMINISTRATION SUBCOMMITTEE: Rec for pass if am by s/c ref. to Education Committee",6,0,0,0,6
1942552,1497104,2025-02-18,House,"HOUSE EDUCATION COMMITTEE: Rec. for pass. if am., ref. to Calendar & Rules Committee",17,1,0,0,18
1942552,1497864,2025-02-24,House,"FLOOR VOTE: REGULAR CALENDAR AS AMENDED PASSAGE ON THIRD CONSIDERATION",95,0,0,0,95
1942552,1514602,2025-03-10,Senate,"FLOOR VOTE: Third Consideration",27,0,1,0,28
1942561,1528182,2025-03-26,Senate,"SENATE HEALTH AND WELFARE COMMITTEE: Recommended for passage with amendment/s, refer to Senate Calendar Committee Ayes 9, Nays 0 PNV 0",9,0,0,0,9
1942561,1531955,2025-03-31,Senate,"FLOOR VOTE: as Amended Third Consideration",30,0,0,0,30
1942561,1538843,2025-04-07,House,"FLOOR VOTE: REGULAR CALENDAR PASSAGE ON THIRD CONSIDERATION",92,1,2,0,95
1942566,1479348,2025-02-03,House,"FLOOR VOTE: CONSENT CALENDAR PASSAGE ON THIRD CONSIDERATION",91,0,0,0,91
1942566,1490424,2025-02-13,Senate,"FLOOR VOTE: Motion to Adopt",31,0,0,0,31
1942571,1516035,2025-03-11,Senate,"SENATE JUDICIARY COMMITTEE: Recommended for passage, refer to Senate Finance, Ways, and Means Committee",9,0,0,0,9
1942575,1504757,2025-03-04,House,"HOUSE EDUCATION INSTRUCTION SUBCOMMITTEE: Rec for pass if am by s/c ref. to Education Committee",3,0,1,0,4
1942575,1519764,2025-03-18,House,"HOUSE EDUCATION COMMITTEE: Rec. for pass. if am., ref. to Calendar & Rules Committee",16,1,0,0,17
1942601,1499266,2025-02-25,Senate,"SENATE COMMERCE AND LABOR COMMITTEE: Recommended for passage with amendment/s, refer to Senate Health and Welfare Committee Ayes 8, Nays 0 PNV 0",8,0,0,0,8
1942601,1506092,2025-03-05,Senate,"SENATE HEALTH AND WELFARE COMMITTEE: Recommended for passage with amendment/s, refer to Senate Calendar Committee Ayes 9, Nays 0 PNV 0",9,0,0,0,9
1942601,1514581,2025-03-10,Senate,"FLOOR VOTE: as Amended Third Consideration",27,0,3,0,30
1942609,1476123,2025-01-29,Senate,"SENATE STATE & LOCAL GOVERNMENT COMMITTEE: Recommended for passage with amendment/s, refer to Senate Finance, Ways, and Means Committee Ayes 9, Nays 0 PNV 0",9,0,0,0,9
1942609,1476326,2025-01-29,Senate,"SENATE FINANCE, WAYS AND MEANS COMMITTEE: Recommended for passage with amendment/s, refer to Senate Calendar Committee Ayes 11, Nays 0 PNV 0",11,0,0,0,11
1942609,1476685,2025-01-29,Senate,"FLOOR VOTE: as Amended Third Consideration",33,0,0,0,33
1942609,1478589,2025-01-29,House,"FLOOR VOTE: REGULAR CALENDAR 2 PASSAGE ON THIRD CONSIDERATION",96,0,0,0,96
1942613,1519412,2025-03-18,House,"HOUSE TENNCARE SUBCOMMITTEE: Rec. for pass by s/c ref. to Insurance Committee",7,0,0,0,7
1942618,1516058,2025-03-11,Senate,"SENATE STATE & LOCAL GOVERNMENT COMMITTEE: Recommended for passage with amendment/s, refer to Senate Calendar Committee Ayes 8, Nays 0 PNV 1",8,0,1,0,9
1942618,1519298,2025-03-17,Senate,"FLOOR VOTE: as Amended Third Consideration",30,0,0,0,30
1942624,1519599,2025-03-18,Senate,"SENATE STATE & LOCAL GOVERNMENT COMMITTEE: Recommended for passage with amendment, refer to Senate Finance, Ways, and Means Committee",9,0,0,0,9
1942624,1532619,2025-04-01,Senate,"SENATE FINANCE, WAYS AND MEANS COMMITTEE: Recommended for passage, refer to Senate Calendar Committee",8,1,0,0,9
1942624,1551074,2025-04-16,Senate,"FLOOR VOTE: as Amended Third Consideration",33,0,0,0,33
1942624,1554245,2025-04-22,House,"FLOOR VOTE: REGULAR CALENDAR PASSAGE ON THIRD CONSIDERATION",89,1,0,0,90
1942633,1506655,2025-03-05,House,"HOUSE BUSINESS AND UTILITIES SUBCOMMITTEE: Rec for pass if am by s/c ref. to Commerce Committee",10,0,0,0,10
1942633,1521517,2025-03-19,House,"HOUSE COMMERCE COMMITTEE: Rec. for pass. if am., ref. to Calendar & Rules Committee",22,0,0,0,22
1942641,1504605,2025-03-04,Senate,"SENATE STATE & LOCAL GOVERNMENT COMMITTEE: Recommended for adoption by Senate State and Local Government Committee, refer Senate Finance, Ways, and Means Committee",7,1,1,0,9
1942641,1532629,2025-04-01,Senate,"SENATE FINANCE, WAYS AND MEANS COMMITTEE: Recommended for adoption by Senate Finance, Ways, and Means Committee, refer Senate Calendar Committee",6,4,0,0,10
1942641,1551032,2025-04-16,Senate,"FLOOR VOTE: Motion to Adopt Third Consideration",27,6,0,0,33
1942645,1515785,2025-03-12,House,"HOUSE HIGHER EDUCATION SUBCOMMITTEE: Rec for pass if am by s/c ref. to Education Committee",4,0,0,0,4
1942645,1532128,2025-04-01,House,"HOUSE EDUCATION COMMITTEE: Rec. for pass. if am., ref. to Calendar & Rules Committee",15,4,0,0,19
1942652,1489965,2025-02-13,Senate,"FLOOR VOTE: Motion to Adopt",31,0,0,0,31
1942652,1497844,2025-02-24,House,"FLOOR VOTE: CONSENT CALENDAR PASSAGE ON THIRD CONSIDERATION",92,0,2,0,94
1942661,1494742,2025-02-12,House,"HOUSE HEALTH SUBCOMMITTEE: Rec. for pass by s/c ref. to Health Committee",9,0,0,0,9
1942661,1494743,2025-02-18,House,"HOUSE HEALTH COMMITTEE: Rec. for pass; ref to Calendar & Rules Committee",22,0,0,0,22
1942661,1497503,2025-02-24,House,"FLOOR VOTE: CONSENT CALENDAR PASSAGE ON THIRD CONSIDERATION",92,0,2,0,94
1942661,1514797,2025-03-03,Senate,"FLOOR VOTE: Motion to Adopt",32,0,0,0,32
1942667,1478952,2025-02-03,House,"FLOOR VOTE: CONSENT CALENDAR PASSAGE ON THIRD CONSIDERATION",91,0,0,0,91
1942696,1501170,2025-02-26,Senate,"SENATE EDUCATION COMMITTEE: Recommended for adoption by Senate Education Committee, refer Senate Calendar Committee",9,0,0,0,9
1942696,1514081,2025-03-06,Senate,"FLOOR VOTE: Motion to Adopt",32,0,0,0,32
1942696,1538499,2025-04-07,House,"HOUSE NAMING & DESIGNATING COMMITTEE: Rec. for pass; ref to Education Committee",9,0,0,0,9
1942696,1542275,2025-04-09,House,"HOUSE EDUCATION COMMITTEE: Rec. for pass; ref to Calendar & Rules Committee",16,0,0,0,16
1942696,1547435,2025-04-14,House,"FLOOR VOTE: CONSENT CALENDAR PASSAGE ON THIRD CONSIDERATION",94,0,1,0,95
1942700,1479086,2025-02-03,House,"FLOOR VOTE: CONSENT CALENDAR PASSAGE ON THIRD CONSIDERATION",91,0,0,0,91
1942700,1490388,2025-02-13,Senate,"FLOOR VOTE: Motion to Adopt",31,0,0,0,31
1942706,1475440,2025-01-27,House,"FLOOR VOTE: UNFINISHED BUSINESS MOTION TO ADOPT",83,7,0,0,90
1942715,1507270,2025-03-05,Senate,"SENATE EDUCATION COMMITTEE: Recommended for adoption by Senate Education Committee, refer Senate Calendar Committee",9,0,0,0,9
1942715,1517577,2025-03-13,Senate,"FLOOR VOTE: Motion to Adopt",32,0,0,0,32
1942715,1522452,2025-03-20,House,"FLOOR VOTE: CONSENT CALENDAR PASSAGE ON THIRD CONSIDERATION",94,0,0,0,94
1942734,1514074,2025-03-11,House,"HOUSE DEPARTMENTS & AGENCIES SUBCOMMITTEE: Rec for pass if am by s/c ref. to State & Local Government Committee",7,0,0,0,7
1942734,1543154,2025-04-09,House,"HOUSE STATE & LOCAL GOVERNMENT COMMITTEE: Rec. for pass. if am., ref. to Finance, Ways, and Means Committee",22,0,0,0,22
1942734,1551939,2025-04-17,House,"HOUSE FINANCE, WAYS, AND MEANS SUBCOMMITTEE: Rec. for pass by s/c ref. to Finance, Ways, and Means Committee",11,0,0,0,11
1942734,1553557,2025-04-17,House,"HOUSE FINANCE, WAYS, AND MEANS COMMITTEE: Rec. for pass; ref to Calendar & Rules Committee",27,0,0,0,27
1942742,1500595,2025-02-26,House,"HOUSE CITIES & COUNTIES SUBCOMMITTEE: Rec for pass if am by s/c ref. to State & Local Government Committee",7,0,0,0,7
1942742,1516417,2025-03-12,House,"HOUSE STATE & LOCAL GOVERNMENT COMMITTEE: Rec. for pass. if am., ref. to Calendar & Rules Committee",21,0,1,0,22
1942742,1518556,2025-03-17,House,"FLOOR VOTE: REGULAR CALENDAR AS AMENDED PASSAGE ON THIRD CONSIDERATION",94,0,0,0,94
1942742,1522824,2025-03-20,Senate,"FLOOR VOTE: Third Consideration",28,2,2,0,32
1942764,1515853,2025-03-11,Senate,"SENATE STATE & LOCAL GOVERNMENT COMMITTEE: Recommended for passage with amendment/s, refer to Senate Finance, Ways, and Means Committee Ayes 9, Nays 0 PNV 0",9,0,0,0,9
1942764,1540595,2025-04-08,Senate,"SENATE FINANCE, WAYS AND MEANS COMMITTEE: Recommended for passage with amendment/s, refer to Senate Calendar Committee Ayes 9, Nays 1 PNV 1",9,1,1,0,11
1942764,1548090,2025-04-14,Senate,"FLOOR VOTE: as Amended Third Consideration",27,3,0,0,30
1942764,1550535,2025-04-16,House,"FLOOR VOTE: REGULAR CALENDAR PASSAGE ON THIRD CONSIDERATION",69,14,5,0,88
1942768,1513609,2025-03-11,House,"HOUSE EDUCATION INSTRUCTION SUBCOMMITTEE: Rec for pass if am by s/c ref. to Education Committee",5,0,1,0,6
1942768,1534747,2025-04-02,House,"HOUSE EDUCATION COMMITTEE: Rec. for pass. if am., ref. to Calendar & Rules Committee",18,0,1,0,19
1942775,1496570,2025-01-30,Senate,"FLOOR VOTE: Motion to Adopt",32,0,0,0,32
1942782,1496589,2025-01-30,Senate,"FLOOR VOTE: Motion to Adopt",32,0,0,0,32
1942790,1490382,2025-02-13,Senate,"FLOOR VOTE: Motion to Adopt",31,0,0,0,31
1942790,1498174,2025-02-24,House,"FLOOR VOTE: CONSENT CALENDAR PASSAGE ON THIRD CONSIDERATION",92,0,2,0,94
1942800,1490148,2025-02-13,Senate,"FLOOR VOTE: Motion to Adopt",31,0,0,0,31
1942800,1497612,2025-02-24,House,"FLOOR VOTE: CONSENT CALENDAR PASSAGE ON THIRD CONSIDERATION",92,0,2,0,94
1942812,1475765,2025-01-28,House,"FLOOR VOTE: CONSENT CALENDAR PASSAGE ON THIRD CONSIDERATION",92,0,0,0,92
1942822,1504216,2025-03-04,House,"HOUSE K-12 SUBCOMMITTEE: Rec for pass if am by s/c ref. to Education Committee",7,0,0,0,7
1942822,1534827,2025-04-02,House,"HOUSE EDUCATION COMMITTEE: Rec. for pass. if am., ref. to Calendar & Rules Committee",17,0,1,0,18
1942837,1533896,2025-04-01,Senate,"SENATE JUDICIARY COMMITTEE: Recommended for passage with amendment/s, refer to Senate Finance, Ways, and Means Committee Ayes 7, Nays 0 PNV 1",7,0,1,0,8
1942837,1549732,2025-04-16,Senate,"SENATE FINANCE, WAYS AND MEANS COMMITTEE: Recommended for passage, refer to Senate Calendar Committee",11,0,0,0,11
1942841,1498982,2025-02-25,House,"HOUSE EDUCATION ADMINISTRATION SUBCOMMITTEE: Rec. for pass by s/c ref. to Education Committee",6,0,0,0,6
1942841,1505450,2025-03-04,House,"HOUSE EDUCATION COMMITTEE: Rec. for pass; ref to Calendar & Rules Committee",16,0,0,0,16
1942841,1511475,2025-03-10,House,"FLOOR VOTE: CONSENT CALENDAR PASSAGE ON THIRD CONSIDERATION",94,0,0,0,94
1942846,1479361,2025-02-03,House,"FLOOR VOTE: CONSENT CALENDAR PASSAGE ON THIRD CONSIDERATION",91,0,0,0,91
1942850,1534408,2025-04-02,Senate,"SENATE STATE & LOCAL GOVERNMENT COMMITTEE: Recommended for passage with amendment, refer to Senate Finance, Ways, and Means Committee",9,0,0,0,9
1942852,1490248,2025-02-13,Senate,"FLOOR VOTE: Motion to Adopt",31,0,0,0,31
1942852,1490249,2025-02-13,Senate,"FLOOR VOTE: Motion to Adopt",31,0,0,0,31
1942852,1498239,2025-02-24,House,"FLOOR VOTE: CONSENT CALENDAR PASSAGE ON THIRD CONSIDERATION",92,0,2,0,94
1942932,1478936,2025-02-03,House,"FLOOR VOTE: CONSENT CALENDAR PASSAGE ON THIRD CONSIDERATION",91,0,0,0,91
1942932,1490177,2025-02-13,Senate,"FLOOR VOTE: Motion to Adopt",31,0,0,0,31
1942999,1494539,2025-02-19,House,"HOUSE HEALTH SUBCOMMITTEE: Rec for pass if am by s/c ref. to Health Committee",9,0,0,0,9
1942999,1504774,2025-03-04,House,"HOUSE HEALTH COMMITTEE: Rec. for pass. if am., ref. to Calendar & Rules Committee",17,0,0,0,17
1942999,1509677,2025-03-10,House,"FLOOR VOTE: REGULAR CALENDAR AS AMENDED PASSAGE ON THIRD CONSIDERATION",89,0,3,0,92
1942999,1519399,2025-03-17,Senate,"FLOOR VOTE: Third Consideration",27,0,3,0,30
1943063,1532152,2025-04-01,Senate,"SENATE STATE & LOCAL GOVERNMENT COMMITTEE: Recommended for passage with amendment/s, refer to Senate Calendar Committee Ayes 7, Nays 1 PNV 0",7,1,0,0,8
1943063,1543982,2025-04-10,Senate,"FLOOR VOTE: as Amended Third Consideration",24,8,0,0,32
1943155,1534362,2025-04-02,Senate,"SENATE STATE & LOCAL GOVERNMENT COMMITTEE: Recommended for passage, refer to Senate Finance, Ways, and Means Committee",7,2,0,0,9
1943518,1522327,2025-03-19,Senate,"SENATE EDUCATION COMMITTEE: Recommended for passage with amendment/s, refer to Senate Calendar Committee Ayes 7, Nays 0 PNV 0",7,0,0,0,7
1943518,1525844,2025-03-24,Senate,"FLOOR VOTE: as Amended Third Consideration",33,0,0,0,33
1943518,1548781,2025-04-15,House,"FLOOR VOTE: REGULAR CALENDAR PASSAGE ON THIRD CONSIDERATION",95,0,0,0,95
1943530,1516717,2025-03-12,Senate,"SENATE HEALTH AND WELFARE COMMITTEE: Recommended for passage, refer to Senate Calendar Committee",9,0,0,0,9
1943530,1519574,2025-03-17,Senate,"FLOOR VOTE: Motion to Adopt",32,0,0,0,32
1943530,1549350,2025-04-15,House,"FLOOR VOTE: REGULAR CALENDAR AS AMENDED PASSAGE ON THIRD CONSIDERATION",94,0,0,0,94
1943530,1552554,2025-04-17,Senate,"FLOOR VOTE: Motion to Concur House Amendment # 1",33,0,0,0,33
1943537,1507063,2025-03-05,Senate,"SENATE EDUCATION COMMITTEE: Recommended for passage, refer to Senate Calendar Committee",7,1,1,0,9
1943537,1517069,2025-03-13,Senate,"FLOOR VOTE: Third Consideration",30,0,0,0,30
1943550,1494489,2025-02-18,House,"POPULATION HEALTH SUBCOMMITTEE: Rec. for pass by s/c ref. to Health Committee",6,0,0,0,6
1943550,1499301,2025-02-25,House,"HOUSE HEALTH COMMITTEE: Rec. for pass; ref to Calendar & Rules Committee",20,0,0,0,20
1943550,1503638,2025-03-03,House,"FLOOR VOTE: CONSENT CALENDAR PASSAGE ON THIRD CONSIDERATION",89,0,0,0,89
1943550,1521626,2025-03-19,Senate,"SENATE HEALTH AND WELFARE COMMITTEE: Recommended for concurrence by Senate Health and Welfare Committee, refer Senate Calendar Committee",8,0,0,0,8
1943550,1525824,2025-03-24,Senate,"FLOOR VOTE: Motion to Adopt",32,0,0,0,32
1943582,1532646,2025-04-01,Senate,"SENATE STATE & LOCAL GOVERNMENT COMMITTEE: Recommended for passage with amendment/s, refer to Senate Calendar Committee Ayes 6, Nays 2 PNV 0",6,2,0,0,8
1943582,1541419,2025-04-09,Senate,"FLOOR VOTE: as Amended Third Consideration",26,4,0,0,30
1943596,1520840,2025-03-19,House,"INSURANCE SUBCOMMITTEE: Rec for pass if am by s/c ref. to Insurance Committee",5,0,0,0,5
1943602,1490025,2025-02-13,Senate,"FLOOR VOTE: Motion to Adopt",31,0,0,0,31
1943609,1521126,2025-03-19,House,"HOUSE HIGHER EDUCATION SUBCOMMITTEE: Rec for pass if am by s/c ref. to Education Committee",5,0,0,0,5
1943609,1526588,2025-03-25,House,"HOUSE EDUCATION COMMITTEE: Rec. for pass. if am., ref. to Calendar & Rules Committee",14,3,1,0,18
1943617,1527670,2025-03-26,House,"HOUSE K-12 SUBCOMMITTEE: Failed in s/c K-12 Subcommittee of Education Committee",1,2,1,0,4
1943624,1526433,2025-03-25,Senate,"SENATE STATE & LOCAL GOVERNMENT COMMITTEE: Recommended for passage with amendment/s, refer to Senate Calendar Committee Ayes 9, Nays 0 PNV 0",9,0,0,0,9
1943624,1531959,2025-03-31,Senate,"FLOOR VOTE: as Amended Third Consideration",29,0,0,0,29
1943624,1550373,2025-04-16,House,"FLOOR VOTE: REGULAR CALENDAR PASSAGE ON THIRD CONSIDERATION",93,0,0,0,93
1943631,1521942,2025-03-19,House,"HOUSE CITIES & COUNTIES SUBCOMMITTEE: Rec for pass if am by s/c ref. to State & Local Government Committee",6,1,0,0,7
1943631,1543137,2025-04-09,House,"HOUSE STATE & LOCAL GOVERNMENT COMMITTEE: Rec. for pass. if am., ref. to Calendar & Rules Committee",18,1,1,0,20
1943639,1494636,2025-02-18,House,"HOUSE EDUCATION ADMINISTRATION SUBCOMMITTEE: Rec. for pass by s/c ref. to Education Committee",6,0,0,0,6
1943639,1498738,2025-02-25,House,"HOUSE EDUCATION COMMITTEE: Rec. for pass; ref to Finance, Ways, and Means Committee",14,3,0,0,17
1943692,1483624,2025-02-05,House,"FLOOR VOTE: CONSENT CALENDAR PASSAGE ON THIRD CONSIDERATION",90,0,0,0,90
1943692,1490457,2025-02-13,Senate,"FLOOR VOTE: Motion to Adopt",31,0,0,0,31
1943705,1522317,2025-03-19,Senate,"SENATE EDUCATION COMMITTEE: Recommended for passage, refer to Senate Finance, Ways, and Means Committee",8,0,0,0,8
1943713,1500061,2025-02-26,House,"HOUSE CRIMINAL JUSTICE SUBCOMMITTEE: Rec for pass if am by s/c ref. to Judiciary Committee",8,0,0,0,8
1943713,1506470,2025-03-05,House,"HOUSE JUDICIARY COMMITTEE: Rec. for pass. if am., ref. to Finance, Ways, and Means Committee",20,0,0,0,20
1943727,1527607,2025-03-26,House,"HOUSE K-12 SUBCOMMITTEE: Rec for pass if am by s/c ref. to Education Committee",5,0,0,0,5
1943727,1534788,2025-04-02,House,"HOUSE EDUCATION COMMITTEE: Rec. for pass. if am., ref. to Finance, Ways, and Means Committee",19,0,0,0,19
1943740,1499177,2025-02-25,Senate,"SENATE STATE & LOCAL GOVERNMENT COMMITTEE: Recommended for passage with amendment/s, refer to Senate Calendar Committee Ayes 9, Nays 0 PNV 0",9,0,0,0,9
1943740,1515472,2025-03-03,Senate,"FLOOR VOTE: as Amended Third Consideration",30,1,0,0,31
1943740,1531133,2025-03-31,House,"FLOOR VOTE: REGULAR CALENDAR AS AMENDED PASSAGE ON THIRD CONSIDERATION",89,3,1,0,93
1943740,1538343,2025-04-07,House,"FLOOR VOTE: MESSAGE CALENDAR PASSAGE ON THIRD CONSIDERATION",92,1,2,0,95
1943746,1490418,2025-02-13,Senate,"FLOOR VOTE: Motion to Adopt",31,0,0,0,31
1943746,1498359,2025-02-24,House,"FLOOR VOTE: CONSENT CALENDAR PASSAGE ON THIRD CONSIDERATION",92,0,2,0,94
1943754,1485721,2025-02-10,House,"HOUSE GOVERNMENT OPERATIONS COMMITTEE: Rec. for pass; ref to Calendar & Rules Committee",10,0,0,0,10
1943754,1495382,2025-02-20,House,"FLOOR VOTE: CONSENT CALENDAR PASSAGE ON THIRD CONSIDERATION",89,0,1,0,90
1943754,1497909,2025-02-24,Senate,"FLOOR VOTE: Motion to Adopt",33,0,0,0,33
1943805,1494556,2025-02-19,House,"HOUSE CITIES & COUNTIES SUBCOMMITTEE: Failed in s/c Cities & Counties Subcommittee of State & Local Government Committee",2,5,0,0,7
1943811,1534338,2025-04-02,Senate,"SENATE STATE & LOCAL GOVERNMENT COMMITTEE: Recommended for passage with amendment/s, refer to Senate Calendar Committee Ayes 9, Nays 0 PNV 0",9,0,0,0,9
1943811,1539442,2025-04-07,Senate,"FLOOR VOTE: as Amended Third Consideration",30,1,0,0,31
1943811,1548572,2025-04-15,House,"FLOOR VOTE: REGULAR CALENDAR PASSAGE ON THIRD CONSIDERATION",94,0,0,0,94
1943817,1505199,2025-03-04,House,"HOUSE EDUCATION ADMINISTRATION SUBCOMMITTEE: Rec. for pass by s/c ref. to Education Committee",6,0,0,0,6
1943817,1526543,2025-03-25,House,"HOUSE EDUCATION COMMITTEE: Rec. for pass. if am., ref. to Finance, Ways, and Means Committee",18,0,0,0,18
1943817,1551871,2025-04-17,House,"HOUSE FINANCE, WAYS, AND MEANS SUBCOMMITTEE: Rec. for pass by s/c ref. to Finance, Ways, and Means Committee",11,0,0,0,11
1943817,1553481,2025-04-17,House,"HOUSE FINANCE, WAYS, AND MEANS COMMITTEE: Rec. for pass; ref to Calendar & Rules Committee",27,0,0,0,27
1943847,1526442,2025-03-25,House,"HOUSE ELECTIONS & CAMPAIGN FINANCE SUBCOMMITTEE: Rec for pass if am by s/c ref. to State & Local Government Committee",6,1,0,0,7
1943847,1542846,2025-04-09,House,"HOUSE STATE & LOCAL GOVERNMENT COMMITTEE: Rec. for pass. if am., ref. to Calendar & Rules Committee",16,5,0,0,21
1943849,1527238,2025-03-25,Senate,"SENATE COMMERCE AND LABOR COMMITTEE: Recommended for passage with amendment/s, refer to Senate Calendar Committee Ayes 9, Nays 0 PNV 0",9,0,0,0,9
1943855,1506340,2025-03-05,House,"HOUSE BANKING AND CONSUMER AFFAIRS SUBCOMMITTEE: Failed in s/c Banking and Consumer Affairs Subcommittee of Commerce Committee",1,4,0,0,5
1943860,1527099,2025-03-25,House,"HOUSE ELECTIONS & CAMPAIGN FINANCE SUBCOMMITTEE: Rec for pass if am by s/c ref. to State & Local Government Committee",7,0,0,0,7
1943860,1543163,2025-04-09,House,"HOUSE STATE & LOCAL GOVERNMENT COMMITTEE: Rec. for pass. if am., ref. to Government Operations Committee",20,0,1,0,21
1943860,1549509,2025-04-16,House,"HOUSE GOVERNMENT OPERATIONS COMMITTEE: Rec. for pass; ref to Calendar & Rules Committee",14,0,0,0,14
1943865,1521920,2025-03-19,House,"HOUSE CITIES & COUNTIES SUBCOMMITTEE: Returned to the Clerk's Desk.",5,0,0,0,5
1943868,1500175,2025-02-26,Senate,"TRANSPORTATION AND SAFETY COMMITTEE: Recommended for passage, refer to Senate Calendar Committee",9,0,0,0,9
1943868,1514068,2025-03-03,Senate,"FLOOR VOTE: Motion to Adopt",32,0,0,0,32
1943874,1533998,2025-04-01,Senate,"SENATE JUDICIARY COMMITTEE: Recommended for passage with amendment/s, refer to Senate Finance, Ways, and Means Committee Ayes 7, Nays 1 PNV 1",7,1,1,0,9
1943874,1549261,2025-04-15,Senate,"SENATE FINANCE, WAYS AND MEANS COMMITTEE: Recommended for passage, refer to Senate Calendar Committee",10,0,0,0,10
1943890,1521860,2025-03-19,House,"HOUSE CITIES & COUNTIES SUBCOMMITTEE: Rec. for pass by s/c ref. to State & Local Government Committee",7,0,0,0,7
1943890,1542182,2025-04-09,House,"HOUSE STATE & LOCAL GOVERNMENT COMMITTEE: Rec. for pass; ref to Finance, Ways, and Means Committee",21,0,0,0,21
1943909,1505214,2025-03-04,Senate,"SENATE STATE & LOCAL GOVERNMENT COMMITTEE: Recommended for passage, refer to Senate Calendar Committee",9,0,0,0,9
1943909,1513918,2025-03-10,Senate,"FLOOR VOTE: Motion to Adopt",30,0,0,0,30
1943919,1504481,2025-03-04,House,"HOUSE TRANSPORTATION SUBCOMMITTEE: Rec. for pass by s/c ref. to Transportation Committee",9,0,0,0,9
1943919,1513103,2025-03-11,House,"HOUSE TRANSPORTATION COMMITTEE: Rec. for pass; ref to Calendar & Rules Committee",20,0,0,0,20
1943919,1518715,2025-03-17,House,"FLOOR VOTE: CONSENT CALENDAR PASSAGE ON THIRD CONSIDERATION",92,0,1,0,93
1943919,1526367,2025-03-24,Senate,"FLOOR VOTE: Motion to Adopt",32,0,0,0,32
1943923,1532346,2025-04-01,Senate,"SENATE STATE & LOCAL GOVERNMENT COMMITTEE: Recommended for passage, refer to Senate Finance, Ways, and Means Committee",7,0,0,0,7
1943948,1515971,2025-03-11,Senate,"SENATE JUDICIARY COMMITTEE: Recommended for passage, refer to Senate Calendar Committee",9,0,0,0,9
1943948,1519707,2025-03-17,Senate,"FLOOR VOTE: Motion to Adopt",32,0,0,0,32
1943950,1526338,2025-03-25,Senate,"SENATE STATE & LOCAL GOVERNMENT COMMITTEE: Recommended for passage, refer to Senate Calendar Committee",9,0,0,0,9
1943950,1531918,2025-03-31,Senate,"FLOOR VOTE: Motion to Adopt",30,0,0,0,30
1943950,1553326,2025-04-21,House,"FLOOR VOTE: REGULAR CALENDAR PASSAGE ON THIRD CONSIDERATION",89,0,0,0,89
1943958,1541275,2025-04-08,Senate,"SENATE JUDICIARY COMMITTEE: Recommended for passage with amendment/s, refer to Senate Calendar Committee Ayes 6, Nays 2 PNV 0",6,2,0,0,8
1943958,1548175,2025-04-14,Senate,"FLOOR VOTE: as Amended Third Consideration",28,2,0,0,30
1943958,1548727,2025-04-15,House,"FLOOR VOTE: REGULAR CALENDAR PASSAGE ON THIRD CONSIDERATION",86,8,1,0,95
1943960,1520982,2025-03-19,House,"HOUSE CRIMINAL JUSTICE SUBCOMMITTEE: Rec for pass if am by s/c ref. to Judiciary Committee",7,0,1,0,8
1943960,1540079,2025-04-08,House,"HOUSE JUDICIARY COMMITTEE: Rec. for pass. if am., ref. to Finance, Ways, and Means Committee",18,0,0,0,18
1943975,1483224,2025-02-05,House,"FLOOR VOTE: CONSENT CALENDAR PASSAGE ON THIRD CONSIDERATION",90,0,0,0,90
1943975,1490427,2025-02-13,Senate,"FLOOR VOTE: Motion to Adopt",31,0,0,0,31
1943976,1541264,2025-04-08,Senate,"SENATE JUDICIARY COMMITTEE: Recommended for passage with amendment/s, refer to Senate Calendar Committee Ayes 5, Nays 2 PNV 0",5,2,0,0,7
1943976,1550882,2025-04-16,Senate,"FLOOR VOTE: Motion to Table Amend# 4 by Senator Akbari Third Consideration",26,6,0,0,32
1943976,1550883,2025-04-16,Senate,"FLOOR VOTE: as Amended Third Consideration",25,6,0,0,31
1943976,1554336,2025-04-22,House,"FLOOR VOTE: REGULAR CALENDAR MOTION TO CONSIDER AMENDMENT # 2 BY BEHN PASSAGE ON THIRD CONSIDERATION",25,72,0,0,97
1943976,1554337,2025-04-22,House,"FLOOR VOTE: REGULAR CALENDAR MOTION TO CONSIDER AMENDMENT # 3 BY BEHN PASSAGE ON THIRD CONSIDERATION",27,68,0,0,95
1943976,1554338,2025-04-22,House,"FLOOR VOTE: REGULAR CALENDAR PASSAGE ON THIRD CONSIDERATION",73,22,0,0,95
1943976,1554339,2025-04-22,House,"FLOOR VOTE: REGULAR CALENDAR PREVIOUS QUESTION PASSAGE ON THIRD CONSIDERATION",71,23,0,0,94
1943984,1514002,2025-03-11,Senate,"SENATE COMMERCE AND LABOR COMMITTEE: Recommended for passage, refer to Senate Finance, Ways, and Means Committee",8,0,0,0,8
1943984,1532645,2025-04-01,Senate,"SENATE FINANCE, WAYS AND MEANS COMMITTEE: Recommended for passage with amendment/s, refer to Senate Calendar Committee Ayes 9, Nays 0 PNV 0",9,0,0,0,9
1943992,1499831,2025-02-26,House,"HOUSE PUBLIC SERVICE SUBCOMMITTEE: Rec. for pass by s/c ref. to State & Local Government Committee",5,0,0,0,5
1943992,1541150,2025-04-08,House,"HOUSE STATE & LOCAL GOVERNMENT COMMITTEE: Rec. for pass; ref to Calendar & Rules Committee",19,0,2,0,21
1943992,1550124,2025-04-16,House,"FLOOR VOTE: CONSENT CALENDAR PASSAGE ON THIRD CONSIDERATION",96,0,0,0,96
1944000,1515847,2025-03-12,House,"HOUSE PUBLIC SERVICE SUBCOMMITTEE: Rec. for pass by s/c ref. to State & Local Government Committee",5,0,0,0,5
1944000,1528184,2025-03-26,House,"HOUSE STATE & LOCAL GOVERNMENT COMMITTEE: Rec. for pass; ref to Finance, Ways, and Means Committee",20,1,1,0,22
1944008,1526464,2025-03-25,House,"HOUSE CRIMINAL JUSTICE SUBCOMMITTEE: Rec for pass if am by s/c ref. to Judiciary Committee",7,2,0,0,9
1944008,1540077,2025-04-08,House,"HOUSE JUDICIARY COMMITTEE: Rec. for pass. if am., ref. to Calendar & Rules Committee",15,6,0,0,21
1944012,1483396,2025-02-05,House,"FLOOR VOTE: CONSENT CALENDAR PASSAGE ON THIRD CONSIDERATION",90,0,0,0,90
1944012,1490299,2025-02-13,Senate,"FLOOR VOTE: Motion to Adopt",31,0,0,0,31
1944021,1490407,2025-02-13,Senate,"FLOOR VOTE: Motion to Adopt",31,0,0,0,31
1944021,1497604,2025-02-24,House,"FLOOR VOTE: CONSENT CALENDAR PASSAGE ON THIRD CONSIDERATION",92,0,2,0,94
1944029,1489956,2025-02-13,Senate,"FLOOR VOTE: Motion to Adopt",31,0,0,0,31
1944029,1498173,2025-02-24,House,"FLOOR VOTE: CONSENT CALENDAR PASSAGE ON THIRD CONSIDERATION",92,0,2,0,94
1944045,1515661,2025-03-11,Senate,"SENATE JUDICIARY COMMITTEE: Recommended for passage with amendment/s, refer to Senate Calendar Committee Ayes 9, Nays 0 PNV 0",9,0,0,0,9
1944047,1490555,2025-02-13,Senate,"FLOOR VOTE: Motion to Adopt",31,0,0,0,31
1944047,1497914,2025-02-24,House,"FLOOR VOTE: CONSENT CALENDAR PASSAGE ON THIRD CONSIDERATION",92,0,2,0,94
1944059,1520811,2025-03-18,Senate,"SENATE COMMERCE AND LABOR COMMITTEE: Failed in Senate Commerce and Labor Committee",3,5,0,0,8
1944070,1528475,2025-03-26,Senate,"SENATE EDUCATION COMMITTEE: Recommended for passage with amendment/s, refer to Senate Calendar Committee Ayes 8, Nays 1 PNV 0",8,1,0,0,9
1944070,1539438,2025-04-07,Senate,"FLOOR VOTE: Lay on the Table Motion to Adopt Amend# 2 by Senator Yarbro Third Consideration",26,6,0,0,32
1944070,1539439,2025-04-07,Senate,"FLOOR VOTE: Previous Question as Amended Third Consideration",25,6,0,0,31
1944070,1539440,2025-04-07,Senate,"FLOOR VOTE: as Amended Third Consideration",25,6,0,0,31
1944070,1544282,2025-04-10,House,"FLOOR VOTE: REGULAR CALENDAR MOTION TO ADOPT AMENDMENT # 2 BY JOHNSON PASSAGE ON THIRD CONSIDERATION",23,72,0,0,95
1944070,1544283,2025-04-10,House,"FLOOR VOTE: REGULAR CALENDAR MOTION TO CONSIDER AMENDMENT # 3 BY PEARSON PASSAGE ON THIRD CONSIDERATION",21,73,0,0,94
1944070,1544284,2025-04-10,House,"FLOOR VOTE: REGULAR CALENDAR PASSAGE ON THIRD CONSIDERATION",73,22,0,0,95
1944070,1544285,2025-04-10,House,"FLOOR VOTE: REGULAR CALENDAR PREVIOUS QUESTION PASSAGE ON THIRD CONSIDERATION",73,22,0,0,95
1944086,1505791,2025-03-05,House,"HOUSE CRIMINAL JUSTICE SUBCOMMITTEE: Rec. for pass by s/c ref. to Judiciary Committee",7,1,1,0,9
1944086,1516487,2025-03-12,House,"HOUSE JUDICIARY COMMITTEE: Rec. for pass. if am., ref. to Finance, Ways, and Means Committee",18,3,0,0,21
1944088,1534342,2025-04-02,Senate,"SENATE STATE & LOCAL GOVERNMENT COMMITTEE: Recommended for passage, refer to Senate Calendar Committee",9,0,0,0,9
1944097,1518365,2025-03-17,House,"HOUSE GOVERNMENT OPERATIONS COMMITTEE: ref. to Finance, Ways, and Means with Negative Recommendation",4,8,0,0,12
1944107,1491869,2025-02-18,Senate,"SENATE STATE & LOCAL GOVERNMENT COMMITTEE: Recommended for passage with amendment/s, refer to Senate Calendar Committee Ayes 9, Nays 0 PNV 0",9,0,0,0,9
1944107,1498142,2025-02-24,Senate,"FLOOR VOTE: as Amended Third Consideration",33,0,0,0,33
1944107,1529088,2025-03-27,House,"FLOOR VOTE: REGULAR CALENDAR PASSAGE ON THIRD CONSIDERATION",93,2,1,0,96
1944115,1519857,2025-03-18,House,"HOUSE DEPARTMENTS & AGENCIES SUBCOMMITTEE: Rec for pass if am by s/c ref. to State & Local Government Committee",7,0,0,0,7
1944115,1534948,2025-04-02,House,"HOUSE STATE & LOCAL GOVERNMENT COMMITTEE: Rec. for pass. if am., ref. to Finance, Ways, and Means Committee",23,0,0,0,23
1944117,1516150,2025-03-12,House,"HOUSE PUBLIC SERVICE SUBCOMMITTEE: Rec. for pass by s/c ref. to State & Local Government Committee",4,1,0,0,5
1944117,1528388,2025-03-26,House,"HOUSE STATE & LOCAL GOVERNMENT COMMITTEE: Rec. for pass; ref to Finance, Ways, and Means Committee",22,0,0,0,22
1944125,1514052,2025-03-11,Senate,"SENATE COMMERCE AND LABOR COMMITTEE: Recommended for passage with amendment/s, refer to Senate Calendar Committee Ayes 5, Nays 2 PNV 1",5,2,1,0,8
1944125,1522818,2025-03-20,Senate,"FLOOR VOTE: as Amended Third Consideration",29,1,0,0,30
1944125,1529099,2025-03-27,House,"FLOOR VOTE: REGULAR CALENDAR PASSAGE ON THIRD CONSIDERATION",96,0,0,0,96
1944129,1521082,2025-03-18,Senate,"SENATE JUDICIARY COMMITTEE: Recommended for passage with amendment/s, refer to Senate Calendar Committee Ayes 8, Nays 0 PNV 0",8,0,0,0,8
1944129,1526045,2025-03-24,Senate,"FLOOR VOTE: as Amended Third Consideration",33,0,0,0,33
1944129,1548125,2025-04-14,House,"FLOOR VOTE: REGULAR CALENDAR PASSAGE ON THIRD CONSIDERATION",94,0,0,0,94
1944162,1535786,2025-04-02,Senate,"SENATE JUDICIARY COMMITTEE: Recommended for passage, refer to Senate Calendar Committee",9,0,0,0,9
1944162,1539467,2025-04-07,Senate,"FLOOR VOTE: Motion to Adopt",31,0,0,0,31
1944162,1553516,2025-04-21,House,"FLOOR VOTE: REGULAR CALENDAR PASSAGE ON THIRD CONSIDERATION",92,0,2,0,94
1944170,1497105,2025-02-11,House,"HOUSE DEPARTMENTS & AGENCIES SUBCOMMITTEE: Rec. for pass by s/c ref. to State & Local Government Committee",7,0,0,0,7
1944170,1497106,2025-02-19,House,"HOUSE STATE & LOCAL GOVERNMENT COMMITTEE: Rec. for pass; ref to Calendar & Rules Committee",22,0,0,0,22
1944170,1501102,2025-02-27,House,"FLOOR VOTE: REGULAR CALENDAR PASSAGE ON THIRD CONSIDERATION",85,8,0,0,93
1944170,1513345,2025-03-10,Senate,"FLOOR VOTE: as Amended Third Consideration",28,0,0,0,28
1944170,1524936,2025-03-24,House,"FLOOR VOTE: MESSAGE CALENDAR CONCUR IN SENATE AMENDMENT # 1",79,11,2,0,92
1944176,1519411,2025-03-17,Senate,"SENATE JUDICIARY COMMITTEE: Recommended for passage with amendment/s, refer to Senate Finance, Ways, and Means Committee Ayes 7, Nays 0 PNV 2",7,0,2,0,9
1944176,1552988,2025-04-21,Senate,"SENATE FINANCE, WAYS AND MEANS COMMITTEE: Recommended for passage with amendment/s, refer to Senate Calendar Committee Ayes 9, Nays 1 PNV 1",9,1,1,0,11
1944183,1527452,2025-03-26,Senate,"TRANSPORTATION AND SAFETY COMMITTEE: Recommended for passage with amendment/s, refer to Senate Finance, Ways, and Means Committee Ayes 8, Nays 0 PNV 0",8,0,0,0,8
1944191,1500499,2025-02-26,House,"HOUSE BUSINESS AND UTILITIES SUBCOMMITTEE: Rec. for pass by s/c ref. to Commerce Committee",11,0,0,0,11
1944191,1506980,2025-03-05,House,"HOUSE COMMERCE COMMITTEE: Rec. for pass; ref to Calendar & Rules Committee",15,0,0,0,15
1944191,1511300,2025-03-10,House,"FLOOR VOTE: CONSENT CALENDAR PASSAGE ON THIRD CONSIDERATION",94,0,0,0,94
1944207,1483488,2025-02-05,House,"FLOOR VOTE: CONSENT CALENDAR PASSAGE ON THIRD CONSIDERATION",90,0,0,0,90
1944207,1500390,2025-02-26,Senate,"SENATE HEALTH AND WELFARE COMMITTEE: Recommended for concurrence by Senate Health and Welfare Committee, refer Senate Calendar Committee",9,0,0,0,9
1944207,1514693,2025-03-03,Senate,"FLOOR VOTE: Motion to Adopt",32,0,0,0,32
1944219,1534378,2025-04-02,Senate,"SENATE STATE & LOCAL GOVERNMENT COMMITTEE: Recommended for passage with amendment/s, refer to Senate Finance, Ways, and Means Committee Ayes 6, Nays 2 PNV 1",6,2,1,0,9
1944219,1552687,2025-04-21,Senate,"SENATE FINANCE, WAYS AND MEANS COMMITTEE: Recommended for passage, refer to Senate Calendar Committee",9,2,0,0,11
1944221,1516737,2025-03-12,House,"HOUSE CITIES & COUNTIES SUBCOMMITTEE: Rec. for pass by s/c ref. to State & Local Government Committee",6,0,0,0,6
1944221,1521919,2025-03-19,House,"HOUSE STATE & LOCAL GOVERNMENT COMMITTEE: Rec. for pass; ref to Finance, Ways, and Means Committee",20,0,2,0,22
1944221,1528211,2025-03-26,House,"HOUSE FINANCE, WAYS, AND MEANS SUBCOMMITTEE: Rec. for pass by s/c ref. to Finance, Ways, and Means Committee",8,0,0,0,8
1944221,1532944,2025-04-01,House,"HOUSE FINANCE, WAYS, AND MEANS COMMITTEE: Rec. for pass; ref to Calendar & Rules Committee",25,0,0,0,25
1944230,1520422,2025-03-18,House,"HOUSE EDUCATION ADMINISTRATION SUBCOMMITTEE: Failed in s/c Education Administration Subcommittee of Education Committee",1,5,0,0,6
1944233,1520849,2025-03-18,Senate,"SENATE JUDICIARY COMMITTEE: Recommended for passage, refer to Senate Finance, Ways, and Means Committee",7,2,0,0,9
1944248,1515996,2025-03-11,Senate,"SENATE STATE & LOCAL GOVERNMENT COMMITTEE: Recommended for passage with amendment, refer to Senate Calendar Committee",8,0,0,0,8
1944248,1519302,2025-03-17,Senate,"FLOOR VOTE: as Amended Third Consideration",30,0,0,0,30
1944248,1550349,2025-04-16,House,"FLOOR VOTE: REGULAR CALENDAR PASSAGE ON THIRD CONSIDERATION",77,13,2,0,92
1944284,1534621,2025-04-01,Senate,"SENATE JUDICIARY COMMITTEE: Recommended for passage with amendment/s, refer to Senate Calendar Committee Ayes 6, Nays 2 PNV 0",6,2,0,0,8
1944284,1542605,2025-04-09,Senate,"FLOOR VOTE: as Amended Third Consideration",25,5,0,0,30
1944306,1505889,2025-03-05,Senate,"TRANSPORTATION AND SAFETY COMMITTEE: Recommended for passage with amendment/s, refer to Senate Calendar Committee Ayes 8, Nays 0 PNV 0",8,0,0,0,8
1944312,1528502,2025-03-26,Senate,"SENATE EDUCATION COMMITTEE: Recommended for passage with amendment/s, refer to Senate Calendar Committee Ayes 9, Nays 0 PNV 0",9,0,0,0,9
1944312,1531999,2025-03-31,Senate,"FLOOR VOTE: Motion to Adopt",30,0,0,0,30
1944329,1520974,2025-03-19,Senate,"TRANSPORTATION AND SAFETY COMMITTEE: Recommended for passage, refer to Senate Finance, Ways, and Means Committee",6,3,0,0,9
1944345,1509092,2025-03-10,House,"HOUSE NAMING & DESIGNATING COMMITTEE: Rec. for pass; ref to State & Local Government Committee",7,3,0,0,10
1944345,1534206,2025-04-02,House,"HOUSE STATE & LOCAL GOVERNMENT COMMITTEE: Failed in State & Local Government Committee",8,9,1,0,18
1944356,1492952,2025-02-13,Senate,"FLOOR VOTE: Motion to Adopt",31,0,0,0,31
1944360,1483647,2025-02-05,House,"FLOOR VOTE: CONSENT CALENDAR PASSAGE ON THIRD CONSIDERATION",90,0,0,0,90
1944360,1490346,2025-02-13,Senate,"FLOOR VOTE: Motion to Adopt",31,0,0,0,31
1944366,1521065,2025-03-19,House,"HOUSE HEALTH SUBCOMMITTEE: Rec for pass if am by s/c ref. to Health Committee",8,0,0,0,8
1944366,1533225,2025-04-01,House,"HOUSE HEALTH COMMITTEE: Rec. for pass. if am., ref. to Calendar & Rules Committee",22,0,0,0,22
1944375,1516855,2025-03-12,Senate,"SENATE EDUCATION COMMITTEE: Recommended for passage with amendment/s, refer to Senate Calendar Committee Ayes 8, Nays 0 PNV 0",8,0,0,0,8
1944375,1519321,2025-03-17,Senate,"FLOOR VOTE: as Amended Third Consideration",32,0,0,0,32
1944375,1550330,2025-04-16,House,"FLOOR VOTE: REGULAR CALENDAR AS AMENDED PASSAGE ON THIRD CONSIDERATION",82,9,1,0,92
1944375,1553017,2025-04-21,Senate,"FLOOR VOTE: Motion to Concur House Amendment # 1",33,0,0,0,33
1944388,1515125,2025-03-11,Senate,"SENATE COMMERCE AND LABOR COMMITTEE: Recommended for passage, refer to Senate Calendar Committee",8,0,1,0,9
1944388,1519383,2025-03-17,Senate,"FLOOR VOTE: Third Consideration",32,0,0,0,32
1944388,1536306,2025-04-03,House,"FLOOR VOTE: REGULAR CALENDAR PASSAGE ON THIRD CONSIDERATION",88,0,1,0,89
1944395,1527592,2025-03-26,Senate,"SENATE ENERGY, AGRICULTURE AND NATURAL RESOURCES COMMITTEE: Recommended for passage with amendment, refer to Senate Finance, Ways, and Means Committee",8,0,0,0,8
1944395,1539644,2025-04-08,Senate,"SENATE FINANCE, WAYS AND MEANS COMMITTEE: Recommended for passage, refer to Senate Calendar Committee",9,0,0,0,9
1944395,1548156,2025-04-14,Senate,"FLOOR VOTE: as Amended Third Consideration",30,0,0,0,30
1944395,1553211,2025-04-21,House,"FLOOR VOTE: REGULAR CALENDAR AS AMENDED PASSAGE ON THIRD CONSIDERATION",94,0,0,0,94
1944395,1553212,2025-04-21,House,"FLOOR VOTE: REGULAR CALENDAR MOTION TO ADOPT AMENDMENT # 2 BY TODD PASSAGE ON THIRD CONSIDERATION",94,0,0,0,94
1944395,1556765,2025-04-22,Senate,"FLOOR VOTE: Motion to Concur House Amendment # 2",33,0,0,0,33
1944398,1528524,2025-03-26,Senate,"SENATE EDUCATION COMMITTEE: Recommended for passage with amendment/s, refer to Senate Calendar Committee Ayes 9, Nays 0 PNV 0",9,0,0,0,9
1944398,1552403,2025-04-17,Senate,"FLOOR VOTE: as Amended Third Consideration",29,0,0,0,29
1944398,1554316,2025-04-22,House,"FLOOR VOTE: REGULAR CALENDAR PASSAGE ON THIRD CONSIDERATION",79,17,1,0,97
1944398,1554317,2025-04-22,House,"FLOOR VOTE: REGULAR CALENDAR PREVIOUS QUESTION PASSAGE ON THIRD CONSIDERATION",72,24,0,0,96
1944410,1516089,2025-03-12,House,"HOUSE PUBLIC SERVICE SUBCOMMITTEE: Rec. for pass by s/c ref. to State & Local Government Committee",6,0,0,0,6
1944412,1504457,2025-03-04,House,"HOUSE TRANSPORTATION SUBCOMMITTEE: Rec. for pass by s/c ref. to Transportation Committee",9,0,0,0,9
1944412,1515312,2025-03-11,House,"HOUSE TRANSPORTATION COMMITTEE: Rec. for pass; ref to Calendar & Rules Committee",18,0,0,0,18
1944412,1518703,2025-03-17,House,"FLOOR VOTE: REGULAR CALENDAR PASSAGE ON THIRD CONSIDERATION",94,0,0,0,94
1944412,1526355,2025-03-24,Senate,"FLOOR VOTE: Motion to Adopt",32,0,0,0,32
1944420,1483675,2025-02-05,House,"FLOOR VOTE: CONSENT CALENDAR PASSAGE ON THIRD CONSIDERATION",90,0,0,0,90
1944420,1490008,2025-02-13,Senate,"FLOOR VOTE: Motion to Adopt",31,0,0,0,31
1944427,1494517,2025-02-19,Senate,"SENATE GOVERNMENT OPERATIONS COMMITTEE: Recommended for passage, refer to Senate Calendar Committee",8,0,0,0,8
1944437,1540781,2025-04-08,Senate,"SENATE FINANCE, WAYS AND MEANS COMMITTEE: Recommended for passage with amendment/s, refer to Senate Calendar Committee Ayes 10, Nays 0 PNV 0",10,0,0,0,10
1944444,1521775,2025-03-19,House,"HOUSE BUSINESS AND UTILITIES SUBCOMMITTEE: Rec for pass if am by s/c ref. to Commerce Committee",7,3,0,0,10
1944448,1495182,2025-02-19,House,"HOUSE BUSINESS AND UTILITIES SUBCOMMITTEE: Rec. for pass by s/c ref. to Commerce Committee",10,0,0,0,10
1944448,1515908,2025-03-12,House,"HOUSE COMMERCE COMMITTEE: Rec. for pass; ref to Calendar & Rules Committee",22,0,0,0,22
1944450,1500129,2025-02-26,House,"HOUSE BUSINESS AND UTILITIES SUBCOMMITTEE: Rec for pass if am by s/c ref. to Commerce Committee",10,0,0,0,10
1944450,1506344,2025-03-05,House,"HOUSE COMMERCE COMMITTEE: Rec. for pass. if am., ref. to Finance, Ways, and Means Committee",15,0,0,0,15
1944450,1515893,2025-03-12,House,"HOUSE FINANCE, WAYS, AND MEANS SUBCOMMITTEE: Rec. for pass by s/c ref. to Finance, Ways, and Means Committee",7,0,0,0,7
1944450,1520388,2025-03-18,House,"HOUSE FINANCE, WAYS, AND MEANS COMMITTEE: Rec. for pass; ref to Calendar & Rules Committee",22,0,0,0,22
1944460,1493377,2025-02-18,Senate,"SENATE JUDICIARY COMMITTEE: Recommended for passage, refer to Senate Calendar Committee",9,0,0,0,9
1944460,1498317,2025-02-24,Senate,"FLOOR VOTE: Motion to Adopt",33,0,0,0,33
1944460,1517475,2025-03-13,House,"FLOOR VOTE: REGULAR CALENDAR PASSAGE ON THIRD CONSIDERATION",86,0,3,0,89
1944490,1490566,2025-02-13,Senate,"FLOOR VOTE: Motion to Adopt",31,0,0,0,31
1944490,1498391,2025-02-24,House,"FLOOR VOTE: CONSENT CALENDAR PASSAGE ON THIRD CONSIDERATION",92,0,2,0,94
1944498,1528471,2025-03-26,Senate,"SENATE EDUCATION COMMITTEE: Failed in Senate Education Committee",4,5,0,0,9
1944509,1541274,2025-04-08,Senate,"SENATE JUDICIARY COMMITTEE: Failed in Senate Judiciary Committee",4,4,0,0,8
1944514,1514177,2025-03-11,House,"HOUSE EDUCATION ADMINISTRATION SUBCOMMITTEE: Rec. for pass by s/c ref. to Education Committee",6,0,0,0,6
1944514,1526019,2025-03-25,House,"HOUSE EDUCATION COMMITTEE: Rec. for pass. if am., ref. to Calendar & Rules Committee",18,0,0,0,18
1944534,1494542,2025-02-19,House,"HOUSE CITIES & COUNTIES SUBCOMMITTEE: Rec. for pass by s/c ref. to State & Local Government Committee",5,0,0,0,5
1944534,1500043,2025-02-26,House,"HOUSE STATE & LOCAL GOVERNMENT COMMITTEE: Rec. for pass; ref to Finance, Ways, and Means Committee",19,2,0,0,21
1944534,1506316,2025-03-05,House,"HOUSE FINANCE, WAYS, AND MEANS SUBCOMMITTEE: Rec. for pass by s/c ref. to Finance, Ways, and Means Committee",8,0,0,0,8
1944534,1515014,2025-03-11,House,"HOUSE FINANCE, WAYS, AND MEANS COMMITTEE: Rec. for pass; ref to Calendar & Rules Committee",22,0,1,0,23
1944539,1519405,2025-03-18,House,"HOUSE TENNCARE SUBCOMMITTEE: Rec for pass if am by s/c ref. to Insurance Committee",7,0,0,0,7
1944539,1534326,2025-04-02,House,"HOUSE INSURANCE COMMITTEE: Rec. for pass. if am., ref. to Calendar & Rules Committee",12,0,0,0,12
1944539,1547749,2025-04-14,House,"FLOOR VOTE: REGULAR CALENDAR AS AMENDED PASSAGE ON THIRD CONSIDERATION",95,0,0,0,95
1944539,1552643,2025-04-21,Senate,"FLOOR VOTE: as Amended Third Consideration",33,0,0,0,33
1944539,1554093,2025-04-22,House,"FLOOR VOTE: MESSAGE CALENDAR 2 CONCUR IN SENATE AMENDMENT # 2",97,0,0,0,97
1944568,1515833,2025-03-12,House,"INSURANCE SUBCOMMITTEE: Rec for pass if am by s/c ref. to Insurance Committee",6,0,0,0,6
1944568,1521394,2025-03-19,House,"HOUSE INSURANCE COMMITTEE: Rec. for pass. if am., ref. to Government Operations Committee",16,1,0,0,17
1944607,1494576,2025-02-18,House,"HOUSE EDUCATION ADMINISTRATION SUBCOMMITTEE: Rec. for pass by s/c ref. to Education Committee",6,0,0,0,6
1944607,1514181,2025-03-11,House,"HOUSE EDUCATION COMMITTEE: Rec. for pass; ref to Calendar & Rules Committee",16,0,0,0,16
1944607,1538584,2025-04-07,House,"FLOOR VOTE: CONSENT CALENDAR PASSAGE ON THIRD CONSIDERATION",96,0,0,0,96
1944607,1556639,2025-04-22,Senate,"FLOOR VOTE: Third Consideration",32,0,0,0,32
1944648,1506631,2025-03-05,House,"HOUSE CITIES & COUNTIES SUBCOMMITTEE: Rec. for pass by s/c ref. to State & Local Government Committee",7,0,0,0,7
1944648,1516460,2025-03-12,House,"HOUSE STATE & LOCAL GOVERNMENT COMMITTEE: Rec. for pass; ref to Finance, Ways, and Means Committee",22,0,0,0,22
1944648,1551547,2025-04-17,House,"HOUSE FINANCE, WAYS, AND MEANS SUBCOMMITTEE: Rec. for pass by s/c ref. to Finance, Ways, and Means Committee",11,0,0,0,11
1944648,1553512,2025-04-17,House,"HOUSE FINANCE, WAYS, AND MEANS COMMITTEE: Rec. for pass; ref to Calendar & Rules Committee",27,0,0,0,27
1944687,1500557,2025-02-26,House,"HOUSE PUBLIC SERVICE SUBCOMMITTEE: Rec. for pass by s/c ref. to State & Local Government Committee",5,0,0,0,5
1944687,1506746,2025-03-05,House,"HOUSE STATE & LOCAL GOVERNMENT COMMITTEE: Rec. for pass; ref to Finance, Ways, and Means Committee",23,0,0,0,23
1944687,1551903,2025-04-17,House,"HOUSE FINANCE, WAYS, AND MEANS SUBCOMMITTEE: Rec. for pass by s/c ref. to Finance, Ways, and Means Committee",11,0,0,0,11
1944687,1553834,2025-04-17,House,"HOUSE FINANCE, WAYS, AND MEANS COMMITTEE: Rec. for pass. if am., ref. to Calendar & Rules Committee",26,0,0,0,26
1944687,1553835,2025-04-17,House,"HOUSE FINANCE, WAYS, AND MEANS COMMITTEE: Rec. for pass; ref to Calendar & Rules Committee",27,0,0,0,27
1944687,1553836,2025-04-21,House,"FLOOR VOTE: REGULAR CALENDAR AS AMENDED PASSAGE ON THIRD CONSIDERATION",94,0,0,0,94
1944687,1557357,2025-04-22,Senate,"FLOOR VOTE: Third Consideration",33,0,0,0,33
1944854,1526512,2025-03-25,House,"HOUSE CRIMINAL JUSTICE SUBCOMMITTEE: Rec for pass if am by s/c ref. to Judiciary Committee",7,1,1,0,9
1944935,1483204,2025-02-05,House,"FLOOR VOTE: CONSENT CALENDAR PASSAGE ON THIRD CONSIDERATION",90,0,0,0,90
1944977,1521895,2025-03-19,House,"HOUSE CITIES & COUNTIES SUBCOMMITTEE: Rec. for pass by s/c ref. to State & Local Government Committee",7,0,0,0,7
1944977,1527849,2025-03-26,House,"HOUSE STATE & LOCAL GOVERNMENT COMMITTEE: Rec. for pass; ref to Calendar & Rules Committee",21,0,0,0,21
1944977,1530971,2025-03-31,House,"FLOOR VOTE: CONSENT CALENDAR PASSAGE ON THIRD CONSIDERATION",93,0,2,0,95
1945058,1499528,2025-02-25,Senate,"SENATE COMMERCE AND LABOR COMMITTEE: Recommended for passage, refer to Senate Calendar Committee",7,1,0,0,8
1945466,1520411,2025-03-18,House,"HOUSE EDUCATION ADMINISTRATION SUBCOMMITTEE: Rec for pass if am by s/c ref. to Education Committee",6,0,0,0,6
1945466,1534895,2025-04-02,House,"HOUSE EDUCATION COMMITTEE: Rec. for pass. if am., ref. to Government Operations Committee",18,0,0,0,18
1945466,1538480,2025-04-07,House,"HOUSE GOVERNMENT OPERATIONS COMMITTEE: Rec. for pass; ref to Finance, Ways, and Means Committee",14,0,0,0,14
1945490,1535344,2025-04-02,House,"HOUSE CIVIL JUSTICE SUBCOMMITTEE: Rec for pass if am by s/c ref. to Judiciary Committee",6,0,0,0,6
1945490,1539430,2025-04-08,House,"HOUSE JUDICIARY COMMITTEE: Rec. for pass. if am., ref. to Calendar & Rules Committee",21,0,0,0,21
1945490,1549382,2025-04-15,House,"FLOOR VOTE: REGULAR CALENDAR AS AMENDED PASSAGE ON THIRD CONSIDERATION",96,0,0,0,96
1945490,1552563,2025-04-17,Senate,"FLOOR VOTE: Third Consideration",31,0,0,0,31
1945501,1499497,2025-02-25,Senate,"SENATE COMMERCE AND LABOR COMMITTEE: Recommended for passage, refer to Senate Calendar Committee",8,0,0,0,8
1945501,1519409,2025-03-17,Senate,"FLOOR VOTE: Motion to Adopt",32,0,0,0,32
1945512,1500055,2025-02-26,House,"INSURANCE SUBCOMMITTEE: Rec for pass if am by s/c ref. to Insurance Committee",6,0,0,0,6
1945512,1506372,2025-03-05,House,"HOUSE INSURANCE COMMITTEE: Rec. for pass. if am., ref. to Calendar & Rules Committee",18,0,0,0,18
1945537,1519592,2025-03-17,Senate,"SENATE JUDICIARY COMMITTEE: Recommended for passage, refer to Senate Calendar Committee",6,2,1,0,9
1945537,1529470,2025-03-27,Senate,"FLOOR VOTE: Third Consideration",22,4,1,0,27
1945537,1550090,2025-04-16,House,"FLOOR VOTE: REGULAR CALENDAR PASSAGE ON THIRD CONSIDERATION",75,16,0,0,91
1945550,1515949,2025-03-12,Senate,"SENATE HEALTH AND WELFARE COMMITTEE: Recommended for passage with amendment/s, refer to Senate Calendar Committee Ayes 9, Nays 0 PNV 0",9,0,0,0,9
1945550,1519428,2025-03-17,Senate,"FLOOR VOTE: as Amended Third Consideration",29,0,0,0,29
1945550,1544236,2025-04-10,House,"FLOOR VOTE: REGULAR CALENDAR AS AMENDED PASSAGE ON THIRD CONSIDERATION",54,37,8,0,99
1945550,1544237,2025-04-10,House,"FLOOR VOTE: REGULAR CALENDAR LAY ON THE TABLE MOTION TO ADOPT AMENDMENT # 2 BY BULSO PASSAGE ON THIRD CONSIDERATION",65,31,2,0,98
1945550,1544238,2025-04-10,House,"FLOOR VOTE: REGULAR CALENDAR MOTION TO ADOPT AMENDMENT # 4 BY LAMBERTH PASSAGE ON THIRD CONSIDERATION",82,16,0,0,98
1945550,1544239,2025-04-10,House,"FLOOR VOTE: REGULAR CALENDAR PREVIOUS QUESTION AS AMENDED PASSAGE ON THIRD CONSIDERATION",72,26,0,0,98
1945550,1544240,2025-04-10,House,"FLOOR VOTE: REGULAR CALENDAR PREVIOUS QUESTION AS AMENDED PASSAGE ON THIRD CONSIDERATION",51,47,0,0,98
1945550,1548043,2025-04-14,Senate,"FLOOR VOTE: Motion to Concur House Amendment # 4",27,3,0,0,30
1945586,1505681,2025-03-04,Senate,"SENATE JUDICIARY COMMITTEE: Recommended for passage, refer to Senate Finance, Ways, and Means Committee",9,0,0,0,9
1945586,1552800,2025-04-21,Senate,"SENATE FINANCE, WAYS AND MEANS COMMITTEE: Recommended for passage with amendment/s, refer to Senate Calendar Committee Ayes 11, Nays 0 PNV 0",11,0,0,0,11
1945597,1506842,2025-03-05,House,"HOUSE CIVIL JUSTICE SUBCOMMITTEE: Rec for pass if am by s/c ref. to Judiciary Committee",7,0,0,0,7
1945597,1543118,2025-04-09,House,"HOUSE JUDICIARY COMMITTEE: Rec. for pass. if am., ref. to Finance, Ways, and Means Committee",21,0,0,0,21
1945597,1547070,2025-04-14,House,"HOUSE FINANCE, WAYS, AND MEANS SUBCOMMITTEE: Rec. for pass by s/c ref. to Finance, Ways, and Means Committee",11,0,0,0,11
1945597,1549112,2025-04-15,House,"HOUSE FINANCE, WAYS, AND MEANS COMMITTEE: Rec. for pass; ref to Calendar & Rules Committee",26,0,0,0,26
1945638,1492828,2025-02-18,House,"HOUSE CHILDREN AND FAMILY AFFAIRS SUBCOMMITTEE: Rec. for pass by s/c ref. to Judiciary Committee",7,0,0,0,7
1945638,1500772,2025-02-26,House,"HOUSE JUDICIARY COMMITTEE: Rec. for pass; ref to Government Operations Committee",15,0,1,0,16
1945638,1503876,2025-03-03,House,"HOUSE GOVERNMENT OPERATIONS COMMITTEE: Rec. for pass; ref to Calendar & Rules Committee",9,0,1,0,10
1945638,1517536,2025-03-13,House,"FLOOR VOTE: REGULAR CALENDAR PASSAGE ON THIRD CONSIDERATION",88,0,2,0,90
1945638,1532079,2025-03-31,Senate,"FLOOR VOTE: as Amended Third Consideration",30,0,0,0,30
1945638,1539111,2025-04-07,House,"FLOOR VOTE: MESSAGE CALENDAR CONCUR IN SENATE AMENDMENT # 1",95,0,0,0,95
1945649,1494633,2025-02-19,House,"HOUSE HEALTH SUBCOMMITTEE: Rec. for pass by s/c ref. to Health Committee",9,0,0,0,9
1945649,1499287,2025-02-25,House,"HOUSE HEALTH COMMITTEE: Rec. for pass; ref to Finance, Ways, and Means Committee",21,0,0,0,21
1945649,1534559,2025-04-02,House,"HOUSE FINANCE, WAYS, AND MEANS SUBCOMMITTEE: Rec. for pass by s/c ref. to Finance, Ways, and Means Committee",11,0,0,0,11
1945649,1540108,2025-04-08,House,"HOUSE FINANCE, WAYS, AND MEANS COMMITTEE: Rec. for pass; ref to Calendar & Rules Committee",28,0,0,0,28
1945649,1547677,2025-04-14,House,"FLOOR VOTE: CONSENT CALENDAR PASSAGE ON THIRD CONSIDERATION",94,0,1,0,95
1945658,1521373,2025-03-19,House,"HOUSE HEALTH SUBCOMMITTEE: Rec for pass if am by s/c ref. to Health Committee",7,0,0,0,7
1945658,1526318,2025-03-25,House,"HOUSE HEALTH COMMITTEE: Rec. for pass. if am., ref. to Calendar & Rules Committee",23,0,0,0,23
1945658,1531051,2025-03-31,House,"FLOOR VOTE: REGULAR CALENDAR AS AMENDED PASSAGE ON THIRD CONSIDERATION",95,0,0,0,95
1945658,1549530,2025-04-15,Senate,"FLOOR VOTE: Third Consideration",31,0,0,0,31
1945673,1534511,2025-04-02,House,"HOUSE CIVIL JUSTICE SUBCOMMITTEE: Rec for pass if am by s/c ref. to Judiciary Committee",6,0,0,0,6
1945673,1543159,2025-04-09,House,"HOUSE JUDICIARY COMMITTEE: Rec. for pass. if am., ref. to Finance, Ways, and Means Committee",21,0,0,0,21
1945673,1547154,2025-04-14,House,"HOUSE FINANCE, WAYS, AND MEANS SUBCOMMITTEE: Rec. for pass by s/c ref. to Finance, Ways, and Means Committee",12,0,0,0,12
1945673,1549368,2025-04-15,House,"HOUSE FINANCE, WAYS, AND MEANS COMMITTEE: Rec. for pass; ref to Calendar & Rules Committee",26,0,0,0,26
1945673,1550813,2025-04-16,House,"FLOOR VOTE: REGULAR CALENDAR AS AMENDED PASSAGE ON THIRD CONSIDERATION",82,8,1,0,91
1945673,1550814,2025-04-16,House,"FLOOR VOTE: REGULAR CALENDAR PREVIOUS QUESTION AS AMENDED PASSAGE ON THIRD CONSIDERATION",69,20,0,0,89
1945673,1553003,2025-04-21,Senate,"FLOOR VOTE: Third Consideration",31,2,0,0,33
1945685,1515647,2025-03-12,Senate,"SENATE GOVERNMENT OPERATIONS COMMITTEE: Recommended for passage with amendment/s, refer to Senate Judiciary Committee Ayes 9, Nays 0 PNV 0",9,0,0,0,9
1945685,1527023,2025-03-25,Senate,"SENATE JUDICIARY COMMITTEE: Recommended for passage, refer to Senate Calendar Committee",9,0,0,0,9
1945708,1516548,2025-03-12,House,"HOUSE HEALTH SUBCOMMITTEE: Rec for pass if am by s/c ref. to Health Committee",9,0,0,0,9
1945708,1520327,2025-03-18,House,"HOUSE HEALTH COMMITTEE: Rec. for pass. if am., ref. to Calendar & Rules Committee",19,0,0,0,19
1945708,1525666,2025-03-24,House,"FLOOR VOTE: REGULAR CALENDAR AS AMENDED PASSAGE ON THIRD CONSIDERATION",92,0,0,0,92
1945708,1526205,2025-03-24,Senate,"FLOOR VOTE: Third Consideration",33,0,0,0,33
1945722,1499801,2025-02-25,Senate,"SENATE JUDICIARY COMMITTEE: Recommended for passage, refer to Senate Calendar Committee",9,0,0,0,9
1945722,1514235,2025-03-03,Senate,"FLOOR VOTE: Motion to Adopt",32,0,0,0,32
1945722,1535837,2025-04-03,House,"FLOOR VOTE: REGULAR CALENDAR PASSAGE ON THIRD CONSIDERATION",88,1,1,0,90
1945722,1535838,2025-04-03,House,"FLOOR VOTE: REGULAR CALENDAR PREVIOUS QUESTION PASSAGE ON THIRD CONSIDERATION",69,18,0,0,87
1945731,1498881,2025-02-25,Senate,"SENATE COMMERCE AND LABOR COMMITTEE: Recommended for passage, refer to Senate Calendar Committee",8,0,0,0,8
1945731,1519437,2025-03-17,Senate,"FLOOR VOTE: Motion to Adopt",32,0,0,0,32
1945744,1515654,2025-03-11,Senate,"SENATE JUDICIARY COMMITTEE: Recommended for passage, refer to Senate Calendar Committee",7,2,0,0,9
1945744,1522651,2025-03-20,Senate,"FLOOR VOTE: Third Consideration",28,0,0,0,28
1945744,1553399,2025-04-21,House,"FLOOR VOTE: REGULAR CALENDAR PASSAGE ON THIRD CONSIDERATION",93,0,0,0,93
1945770,1532700,2025-04-01,House,"HOUSE CRIMINAL JUSTICE SUBCOMMITTEE: Rec for pass if am by s/c ref. to Judiciary Committee",9,0,0,0,9
1945770,1543152,2025-04-09,House,"HOUSE JUDICIARY COMMITTEE: Rec. for pass. if am., ref. to Finance, Ways, and Means Committee",21,0,0,0,21
1945770,1550782,2023-03-06,Senate,"FLOOR VOTE: Motion to Adopt",33,0,0,0,33
1945770,1552540,2025-04-17,House,"HOUSE FINANCE, WAYS, AND MEANS SUBCOMMITTEE: Rec. for pass by s/c ref. to Finance, Ways, and Means Committee",11,0,0,0,11
1945770,1553229,2025-04-17,House,"HOUSE FINANCE, WAYS, AND MEANS COMMITTEE: Rec. for pass; ref to Calendar & Rules Committee",27,0,0,0,27
1945770,1553230,2025-04-21,House,"FLOOR VOTE: REGULAR CALENDAR AS AMENDED PASSAGE ON THIRD CONSIDERATION",94,0,0,0,94
1945770,1556829,2025-04-22,Senate,"FLOOR VOTE: Third Consideration",33,0,0,0,33
1945784,1521010,2025-03-19,House,"HOUSE HEALTH SUBCOMMITTEE: Rec for pass if am by s/c ref. to Health Committee",6,0,0,0,6
1945784,1526400,2025-03-25,House,"HOUSE HEALTH COMMITTEE: Rec. for pass. if am., ref. to Calendar & Rules Committee",22,0,0,0,22
1945805,1483206,2025-02-05,House,"FLOOR VOTE: CONSENT CALENDAR PASSAGE ON THIRD CONSIDERATION",90,0,0,0,90
1945805,1527669,2025-03-26,Senate,"SENATE ENERGY, AGRICULTURE AND NATURAL RESOURCES COMMITTEE: Recommended for concurrence by Senate Energy, Ag., and Nat. Resources Committee, refer Senate Calendar Committee",8,0,0,0,8
1945805,1531922,2025-03-31,Senate,"FLOOR VOTE: Motion to Adopt",30,0,0,0,30
1945831,1492860,2025-02-18,Senate,"SENATE STATE & LOCAL GOVERNMENT COMMITTEE: Recommended for passage, refer to Senate Finance, Ways, and Means Committee",9,0,0,0,9
1945831,1540564,2025-04-08,Senate,"SENATE FINANCE, WAYS AND MEANS COMMITTEE: Recommended for passage, refer to Senate Calendar Committee",11,0,0,0,11
1945831,1548069,2025-04-14,Senate,"FLOOR VOTE: Motion to Adopt",32,0,0,0,32
1945845,1494616,2025-02-19,House,"HOUSE HIGHER EDUCATION SUBCOMMITTEE: Rec for pass if am by s/c ref. to Education Committee",5,0,0,0,5
1945845,1526394,2025-03-25,House,"HOUSE EDUCATION COMMITTEE: Rec. for pass. if am., ref. to Finance, Ways, and Means Committee",18,0,0,0,18
1945845,1551527,2025-04-17,House,"HOUSE FINANCE, WAYS, AND MEANS SUBCOMMITTEE: Rec. for pass by s/c ref. to Finance, Ways, and Means Committee",11,0,0,0,11
1945845,1553440,2025-04-17,House,"HOUSE FINANCE, WAYS, AND MEANS COMMITTEE: Rec. for pass; ref to Calendar & Rules Committee",27,0,0,0,27
1945845,1553441,2025-04-21,House,"FLOOR VOTE: REGULAR CALENDAR AS AMENDED PASSAGE ON THIRD CONSIDERATION",94,0,0,0,94
1945845,1556544,2025-04-22,Senate,"FLOOR VOTE: Third Consideration",33,0,0,0,33
1945868,1495167,2025-02-19,House,"HOUSE BUSINESS AND UTILITIES SUBCOMMITTEE: Rec. for pass by s/c ref. to Commerce Committee",10,0,0,0,10
1945868,1499840,2025-02-26,House,"HOUSE COMMERCE COMMITTEE: Rec. for pass; ref to Calendar & Rules Committee",21,0,0,0,21
1945868,1503833,2025-03-03,House,"FLOOR VOTE: CONSENT CALENDAR PASSAGE ON THIRD CONSIDERATION",89,0,0,0,89
1945868,1513401,2025-03-06,Senate,"FLOOR VOTE: Third Consideration",30,0,0,0,30
1945905,1515069,2025-03-11,House,"HOUSE EDUCATION ADMINISTRATION SUBCOMMITTEE: Rec. for pass by s/c ref. to Education Committee",6,0,0,0,6
1945905,1526483,2025-03-25,House,"HOUSE EDUCATION COMMITTEE: Rec. for pass; ref to Calendar & Rules Committee",17,0,0,0,17
1945905,1531472,2025-03-31,House,"FLOOR VOTE: CONSENT CALENDAR PASSAGE ON THIRD CONSIDERATION",93,0,2,0,95
1945931,1494664,2025-02-18,House,"HOUSE TENNCARE SUBCOMMITTEE: Rec for pass if am by s/c ref. to Insurance Committee",6,0,0,0,6
1945931,1500618,2025-02-26,House,"HOUSE INSURANCE COMMITTEE: Rec. for pass. if am., ref. to Calendar & Rules Committee",17,0,0,0,17
1945931,1509547,2025-03-10,House,"FLOOR VOTE: REGULAR CALENDAR AS AMENDED PASSAGE ON THIRD CONSIDERATION",93,0,0,0,93
1945931,1523015,2025-03-20,Senate,"FLOOR VOTE: Third Consideration",27,2,0,0,29
1945943,1504798,2025-03-04,House,"HOUSE CHILDREN AND FAMILY AFFAIRS SUBCOMMITTEE: Rec for pass if am by s/c ref. to Judiciary Committee",7,0,0,0,7
1945943,1543008,2025-04-09,House,"HOUSE JUDICIARY COMMITTEE: Rec. for pass. if am., ref. to Calendar & Rules Committee",19,2,0,0,21
1945966,1505692,2025-03-04,Senate,"SENATE JUDICIARY COMMITTEE: Recommended for passage, refer to Senate Calendar Committee",8,0,0,0,8
1945966,1514575,2025-03-10,Senate,"FLOOR VOTE: Motion to Adopt",30,0,0,0,30
1945966,1553488,2025-04-21,House,"FLOOR VOTE: REGULAR CALENDAR PASSAGE ON THIRD CONSIDERATION",80,6,2,0,88
1945978,1541476,2025-04-08,Senate,"SENATE JUDICIARY COMMITTEE: Recommended for passage with amendment/s, refer to Senate Finance, Ways, and Means Committee Ayes 8, Nays 0 PNV 0",8,0,0,0,8
1945978,1552997,2025-04-21,Senate,"SENATE FINANCE, WAYS AND MEANS COMMITTEE: Recommended for passage, refer to Senate Calendar Committee",10,0,0,0,10
1946012,1499220,2025-02-25,House,"HOUSE EDUCATION ADMINISTRATION SUBCOMMITTEE: Rec. for pass by s/c ref. to Education Committee",6,0,0,0,6
1946012,1513412,2025-03-11,House,"HOUSE EDUCATION COMMITTEE: Rec. for pass. if am., ref. to Finance, Ways, and Means Committee",14,0,3,0,17
1946015,1521893,2025-03-19,House,"HOUSE CRIMINAL JUSTICE SUBCOMMITTEE: Rec. for pass by s/c ref. to Judiciary Committee",8,0,0,0,8
1946015,1534468,2025-04-02,House,"HOUSE JUDICIARY COMMITTEE: Rec. for pass; ref to Finance, Ways, and Means Committee",18,0,0,0,18
1946015,1551832,2025-04-17,House,"HOUSE FINANCE, WAYS, AND MEANS SUBCOMMITTEE: Rec. for pass by s/c ref. to Finance, Ways, and Means Committee",11,0,0,0,11
1946015,1553324,2025-04-17,House,"HOUSE FINANCE, WAYS, AND MEANS COMMITTEE: Rec. for pass; ref to Calendar & Rules Committee",27,0,0,0,27
1946015,1553325,2025-04-21,House,"FLOOR VOTE: CONSENT CALENDAR PASSAGE ON THIRD CONSIDERATION",86,0,1,0,87
1946015,1556578,2025-04-22,Senate,"FLOOR VOTE: Motion to Adopt",33,0,0,0,33
1946022,1535315,2025-04-02,Senate,"SENATE STATE & LOCAL GOVERNMENT COMMITTEE: Recommended for passage with amendment/s, refer to Senate Calendar Committee Ayes 9, Nays 0 PNV 0",9,0,0,0,9
1946053,1483333,2025-02-05,House,"FLOOR VOTE: CONSENT CALENDAR PASSAGE ON THIRD CONSIDERATION",90,0,0,0,90
1946053,1489953,2025-02-13,Senate,"FLOOR VOTE: Motion to Adopt",31,0,0,0,31
1946056,1532782,2025-04-01,House,"HOUSE CRIMINAL JUSTICE SUBCOMMITTEE: Rec. for pass by s/c ref. to Judiciary Committee",7,1,1,0,9
1946056,1542367,2025-04-09,House,"HOUSE JUDICIARY COMMITTEE: Rec. for pass. if am., ref. to Calendar & Rules Committee",17,2,1,0,20
1946065,1514164,2025-03-11,House,"HOUSE TRANSPORTATION SUBCOMMITTEE: Rec for pass if am by s/c ref. to Transportation Committee",7,0,0,0,7
1946070,1520734,2025-03-18,Senate,"SENATE JUDICIARY COMMITTEE: Recommended for passage, refer to Senate Finance, Ways, and Means Committee",9,0,0,0,9
1946070,1540542,2025-04-08,Senate,"SENATE FINANCE, WAYS AND MEANS COMMITTEE: Recommended for passage, refer to Senate Calendar Committee",11,0,0,0,11
1946070,1548136,2025-04-14,Senate,"FLOOR VOTE: Motion to Adopt",32,0,0,0,32
1946070,1549263,2025-04-15,House,"FLOOR VOTE: REGULAR CALENDAR PASSAGE ON THIRD CONSIDERATION",95,0,0,0,95
1946073,1534310,2025-04-02,Senate,"SENATE STATE & LOCAL GOVERNMENT COMMITTEE: Recommended for passage with amendment/s, refer to Senate Finance, Ways, and Means Committee Ayes 9, Nays 0 PNV 0",9,0,0,0,9
1946082,1494925,2025-02-19,House,"HOUSE AGRICULTURE AND NATURAL RESOURCES SUBCOMMITTEE: Rec. for pass by s/c ref. to Agriculture & Natural Resources Committee",8,0,0,0,8
1946082,1499173,2025-02-25,House,"HOUSE AGRICULTURE & NATURAL RESOURCES COMMITTEE: Rec. for pass; ref to Finance, Ways, and Means Committee",16,0,0,0,16
1946082,1521896,2025-03-19,House,"HOUSE FINANCE, WAYS, AND MEANS SUBCOMMITTEE: Rec for pass if am by s/c ref. to Finance, Ways, and Means Committee",12,0,0,0,12
1946082,1527049,2025-03-25,House,"HOUSE FINANCE, WAYS, AND MEANS COMMITTEE: Rec. for pass; ref to Calendar & Rules Committee",23,0,0,0,23
1946091,1528159,2025-03-26,House,"HOUSE AGRICULTURE AND NATURAL RESOURCES SUBCOMMITTEE: Rec for pass if am by s/c ref. to Agriculture & Natural Resources Committee",7,2,0,0,9
1946091,1531964,2025-04-01,House,"HOUSE AGRICULTURE & NATURAL RESOURCES COMMITTEE: Rec. for pass. if am., ref. to Finance, Ways, and Means Committee",13,3,0,0,16
1946091,1551819,2025-04-17,House,"HOUSE FINANCE, WAYS, AND MEANS SUBCOMMITTEE: Rec. for pass by s/c ref. to Finance, Ways, and Means Committee",11,0,0,0,11
1946091,1553254,2025-04-17,House,"HOUSE FINANCE, WAYS, AND MEANS COMMITTEE: Rec. for pass; ref to Calendar & Rules Committee",27,0,0,0,27
1946091,1553255,2025-04-17,House,"HOUSE FINANCE, WAYS, AND MEANS COMMITTEE: Rec. for pass; ref to Calendar & Rules Committee",24,1,2,0,27
1946105,1520770,2025-03-18,Senate,"SENATE JUDICIARY COMMITTEE: Recommended for passage with amendment/s, refer to Senate Calendar Committee Ayes 7, Nays 2 PNV 0",7,2,0,0,9
1946105,1528653,2025-03-27,Senate,"FLOOR VOTE: as Amended Third Consideration",24,4,0,0,28
1946105,1548732,2025-04-15,House,"FLOOR VOTE: REGULAR CALENDAR AS AMENDED PASSAGE ON THIRD CONSIDERATION",72,22,0,0,94
1946105,1548733,2025-04-15,House,"FLOOR VOTE: REGULAR CALENDAR LAY ON THE TABLE MOTION TO ADOPT AMENDMENT # 2 BY BEHN PASSAGE ON THIRD CONSIDERATION",72,21,0,0,93
1946105,1548734,2025-04-15,House,"FLOOR VOTE: REGULAR CALENDAR LAY ON THE TABLE MOTION TO ADOPT AMENDMENT # 3 BY BEHN PASSAGE ON THIRD CONSIDERATION",73,19,0,0,92
1946105,1548735,2025-04-15,House,"FLOOR VOTE: REGULAR CALENDAR LAY ON THE TABLE MOTION TO ADOPT AMENDMENT # 4 BY BEHN PASSAGE ON THIRD CONSIDERATION",73,20,0,0,93
1946105,1548736,2025-04-15,House,"FLOOR VOTE: REGULAR CALENDAR PREVIOUS QUESTION AS AMENDED PASSAGE ON THIRD CONSIDERATION",71,20,0,0,91
1946147,1505233,2025-03-04,Senate,"SENATE COMMERCE AND LABOR COMMITTEE: Recommended for passage with amendment/s, refer to Senate Calendar Committee Ayes 7, Nays 0 PNV 0",7,0,0,0,7
1946147,1515252,2025-03-10,Senate,"FLOOR VOTE: as Amended Third Consideration",27,0,0,0,27
1946147,1529226,2025-03-27,House,"FLOOR VOTE: REGULAR CALENDAR AS AMENDED PASSAGE ON THIRD CONSIDERATION",90,1,3,0,94
1946147,1536512,2025-04-03,Senate,"FLOOR VOTE: Motion to Concur House Amendment # 1",30,0,0,0,30
1946152,1513727,2025-03-11,House,"POPULATION HEALTH SUBCOMMITTEE: Rec. for pass by s/c ref. to Health Committee",8,0,0,0,8
1946152,1526524,2025-03-25,House,"HOUSE HEALTH COMMITTEE: Rec. for pass. if am., ref. to Calendar & Rules Committee",22,0,0,0,22
1946170,1483423,2025-02-05,House,"FLOOR VOTE: CONSENT CALENDAR PASSAGE ON THIRD CONSIDERATION",90,0,0,0,90
1946170,1490463,2025-02-13,Senate,"FLOOR VOTE: Motion to Adopt",31,0,0,0,31
1946183,1483727,2025-02-05,House,"FLOOR VOTE: CONSENT CALENDAR PASSAGE ON THIRD CONSIDERATION",90,0,0,0,90
1946183,1490485,2025-02-13,Senate,"FLOOR VOTE: Motion to Adopt",31,0,0,0,31
1946186,1521026,2025-03-19,Senate,"SENATE HEALTH AND WELFARE COMMITTEE: Recommended for passage, refer to Senate Calendar Committee",8,0,0,0,8
1946186,1525955,2025-03-24,Senate,"FLOOR VOTE: Motion to Adopt",32,0,0,0,32
1946193,1516840,2025-03-12,Senate,"SENATE EDUCATION COMMITTEE: Recommended for passage with amendment/s, refer to Senate Calendar Committee Ayes 8, Nays 1 PNV 0",8,1,0,0,9
1946203,1516843,2025-03-12,Senate,"SENATE EDUCATION COMMITTEE: Recommended for passage, refer to Senate Finance, Ways, and Means Committee",8,0,0,0,8
1946213,1528111,2025-03-26,Senate,"SENATE HEALTH AND WELFARE COMMITTEE: Recommended for passage with amendment/s, refer to Senate Calendar Committee Ayes 9, Nays 0 PNV 0",9,0,0,0,9
1946213,1531933,2025-03-31,Senate,"FLOOR VOTE: as Amended Third Consideration",26,0,2,0,28
1946213,1553577,2025-04-21,House,"FLOOR VOTE: REGULAR CALENDAR PASSAGE ON THIRD CONSIDERATION",94,0,1,0,95
1946223,1506512,2025-03-05,House,"HOUSE PUBLIC SERVICE SUBCOMMITTEE: Rec for pass if am by s/c ref. to State & Local Government Committee",6,0,0,0,6
1946223,1516473,2025-03-12,House,"HOUSE STATE & LOCAL GOVERNMENT COMMITTEE: Rec. for pass. if am., ref. to Calendar & Rules Committee",23,0,0,0,23
1946251,1521887,2025-03-19,House,"HOUSE BUSINESS AND UTILITIES SUBCOMMITTEE: Rec for pass if am by s/c ref. to Commerce Committee",7,2,0,0,9
1946251,1527248,2025-03-26,House,"HOUSE COMMERCE COMMITTEE: Rec. for pass. if am., ref. to Finance, Ways, and Means Committee",18,3,0,0,21
1946251,1551872,2025-04-17,House,"HOUSE FINANCE, WAYS, AND MEANS SUBCOMMITTEE: Rec. for pass by s/c ref. to Finance, Ways, and Means Committee",11,0,0,0,11
1946251,1553053,2025-04-21,Senate,"FLOOR VOTE: Third Consideration",24,6,0,0,30
1946251,1553381,2025-04-17,House,"HOUSE FINANCE, WAYS, AND MEANS COMMITTEE: Rec. for pass; ref to Calendar & Rules Committee",27,0,0,0,27
1946251,1553382,2025-04-21,House,"FLOOR VOTE: REGULAR CALENDAR AS AMENDED PASSAGE ON THIRD CONSIDERATION",77,13,0,0,90
1946257,1522340,2025-03-19,Senate,"SENATE EDUCATION COMMITTEE: Recommended for passage, refer to Senate Finance, Ways, and Means Committee",8,0,0,0,8
1946261,1520763,2025-03-18,Senate,"SENATE JUDICIARY COMMITTEE: Recommended for passage with amendment/s, refer to Senate Finance, Ways, and Means Committee Ayes 9, Nays 0 PNV 0",9,0,0,0,9
1946270,1500486,2025-02-26,Senate,"SENATE HEALTH AND WELFARE COMMITTEE: Recommended for adoption by Senate Health and Welfare Committee, refer Senate Calendar Committee",9,0,0,0,9
1946270,1509237,2025-03-10,House,"FLOOR VOTE: CONSENT CALENDAR PASSAGE ON THIRD CONSIDERATION",94,0,0,0,94
1946270,1514255,2025-03-03,Senate,"FLOOR VOTE: Motion to Adopt",32,0,0,0,32
1946277,1483762,2025-02-05,House,"FLOOR VOTE: CONSENT CALENDAR PASSAGE ON THIRD CONSIDERATION",90,0,0,0,90
1946277,1490001,2025-02-13,Senate,"FLOOR VOTE: Motion to Adopt",31,0,0,0,31
1946284,1541261,2025-04-08,Senate,"SENATE JUDICIARY COMMITTEE: Failed in Senate Judiciary Committee",1,6,0,0,7
1946294,1520855,2025-03-19,Senate,"TRANSPORTATION AND SAFETY COMMITTEE: Failed in Senate Transportation and Safety Committee",3,6,0,0,9
1946310,1541454,2025-04-08,Senate,"SENATE JUDICIARY COMMITTEE: Recommended for passage with amendment/s, refer to Senate Calendar Committee Ayes 8, Nays 0 PNV 0",8,0,0,0,8
1946310,1548155,2025-04-14,Senate,"FLOOR VOTE: as Amended Third Consideration",32,0,0,0,32
1946310,1549275,2025-04-15,House,"FLOOR VOTE: REGULAR CALENDAR PASSAGE ON THIRD CONSIDERATION",71,23,0,0,94
1946310,1549276,2025-04-15,House,"FLOOR VOTE: REGULAR CALENDAR PREVIOUS QUESTION PASSAGE ON THIRD CONSIDERATION",70,24,0,0,94
1946315,1532721,2025-04-01,House,"HOUSE CRIMINAL JUSTICE SUBCOMMITTEE: Rec. for pass by s/c ref. to Judiciary Committee",7,0,2,0,9
1946315,1540751,2025-04-08,House,"HOUSE JUDICIARY COMMITTEE: Rec. for pass; ref to Calendar & Rules Committee",15,6,0,0,21
1946327,1520954,2025-03-19,House,"HOUSE CRIMINAL JUSTICE SUBCOMMITTEE: Rec. for pass by s/c ref. to Judiciary Committee",8,0,0,0,8
1946327,1534100,2025-04-02,House,"HOUSE JUDICIARY COMMITTEE: Rec. for pass; ref to Calendar & Rules Committee",19,0,0,0,19
1946342,1500027,2025-02-26,House,"HOUSE CRIMINAL JUSTICE SUBCOMMITTEE: Rec for pass if am by s/c ref. to Judiciary Committee",9,0,0,0,9
1946342,1506552,2025-03-05,House,"HOUSE JUDICIARY COMMITTEE: Rec. for pass. if am., ref. to Finance, Ways, and Means Committee",22,0,0,0,22
1946349,1526786,2025-03-25,Senate,"SENATE JUDICIARY COMMITTEE: Failed in Senate Judiciary Committee",3,5,1,0,9
1946359,1483220,2025-02-05,House,"FLOOR VOTE: CONSENT CALENDAR PASSAGE ON THIRD CONSIDERATION",90,0,0,0,90
1946359,1490027,2025-02-13,Senate,"FLOOR VOTE: Motion to Adopt",31,0,0,0,31
1946370,1516838,2025-03-12,Senate,"SENATE EDUCATION COMMITTEE: Recommended for passage, refer to Senate Calendar Committee",5,4,0,0,9
1946381,1504593,2025-03-04,House,"HOUSE EDUCATION INSTRUCTION SUBCOMMITTEE: Rec. for pass by s/c ref. to Education Committee",3,1,0,0,4
1946391,1499270,2025-02-25,House,"HOUSE EDUCATION ADMINISTRATION SUBCOMMITTEE: Rec. for pass by s/c ref. to Education Committee",6,0,0,0,6
1946391,1526580,2025-03-25,House,"HOUSE EDUCATION COMMITTEE: Rec. for pass; ref to Calendar & Rules Committee",18,0,0,0,18
1946391,1531068,2025-03-31,House,"FLOOR VOTE: CONSENT CALENDAR PASSAGE ON THIRD CONSIDERATION",93,0,2,0,95
1946397,1522329,2025-03-19,Senate,"SENATE EDUCATION COMMITTEE: Recommended for passage with amendment/s, refer to Senate Calendar Committee Ayes 7, Nays 1 PNV 0",7,1,0,0,8
1946397,1528667,2025-03-27,Senate,"FLOOR VOTE: as Amended Third Consideration",25,5,0,0,30
1946397,1538442,2025-04-07,House,"FLOOR VOTE: REGULAR CALENDAR MOTION TO CONSIDER AMENDMENT # 2 BY BEHN PASSAGE ON THIRD CONSIDERATION",22,72,0,0,94
1946397,1538443,2025-04-07,House,"FLOOR VOTE: REGULAR CALENDAR PASSAGE ON THIRD CONSIDERATION",73,20,2,0,95
1946397,1538444,2025-04-07,House,"FLOOR VOTE: REGULAR CALENDAR PREVIOUS QUESTION PASSAGE ON THIRD CONSIDERATION",73,20,0,0,93
1946412,1520980,2025-03-19,Senate,"TRANSPORTATION AND SAFETY COMMITTEE: Recommended for passage, refer to Senate Calendar Committee",9,0,0,0,9
1946423,1499802,2025-02-25,Senate,"SENATE JUDICIARY COMMITTEE: Recommended for passage, refer to Senate Calendar Committee",8,1,0,0,9
1946423,1514022,2025-03-06,Senate,"FLOOR VOTE: Third Consideration",30,0,0,0,30
1946423,1522678,2025-03-20,House,"FLOOR VOTE: REGULAR CALENDAR PASSAGE ON THIRD CONSIDERATION",81,11,0,0,92
1946452,1505326,2025-03-04,Senate,"SENATE STATE & LOCAL GOVERNMENT COMMITTEE:",9,0,0,0,9
1946462,1498090,2025-02-24,House,"HOUSE NAMING & DESIGNATING COMMITTEE: Rec. for pass; ref to Health Committee",10,0,0,0,10
1946462,1504975,2025-03-04,House,"HOUSE HEALTH COMMITTEE: Rec. for pass; ref to Calendar & Rules Committee",16,0,0,0,16
1946462,1511940,2025-03-10,House,"FLOOR VOTE: CONSENT CALENDAR PASSAGE ON THIRD CONSIDERATION",94,0,0,0,94
1946462,1521428,2025-03-19,Senate,"SENATE HEALTH AND WELFARE COMMITTEE: Recommended for concurrence by Senate Health and Welfare Committee, refer Senate Calendar Committee",8,0,0,0,8
1946462,1526354,2025-03-24,Senate,"FLOOR VOTE: Motion to Adopt",32,0,0,0,32
1946467,1520358,2025-03-18,House,"HOUSE TRANSPORTATION SUBCOMMITTEE: Rec for pass if am by s/c ref. to Transportation Committee",9,0,0,0,9
1946467,1525936,2025-03-25,House,"HOUSE TRANSPORTATION COMMITTEE: Rec. for pass. if am., ref. to Calendar & Rules Committee",19,0,0,0,19
1946469,1505507,2025-03-04,House,"HOUSE EDUCATION ADMINISTRATION SUBCOMMITTEE: Rec. for pass by s/c ref. to Education Committee",6,0,0,0,6
1946469,1520523,2025-03-18,House,"HOUSE EDUCATION COMMITTEE: Rec. for pass; ref to Judiciary Committee",18,0,0,0,18
1946469,1534084,2025-04-02,House,"HOUSE JUDICIARY COMMITTEE: Rec. for pass; ref to Calendar & Rules Committee",18,0,0,0,18
1946469,1550801,2025-04-16,House,"FLOOR VOTE: CONSENT CALENDAR PASSAGE ON THIRD CONSIDERATION",96,0,0,0,96
1946564,1500191,2025-02-26,House,"HOUSE BUSINESS AND UTILITIES SUBCOMMITTEE: Rec. for pass by s/c ref. to Commerce Committee",11,0,0,0,11
1946564,1506404,2025-03-05,House,"HOUSE COMMERCE COMMITTEE: Rec. for pass; ref to Calendar & Rules Committee",20,0,0,0,20
1946564,1520836,2025-03-19,House,"HOUSE FINANCE, WAYS, AND MEANS SUBCOMMITTEE: Rec. for pass by s/c ref. to Finance, Ways, and Means Committee",12,0,0,0,12
1946564,1526856,2025-03-25,House,"HOUSE FINANCE, WAYS, AND MEANS COMMITTEE: Rec. for pass; ref to Calendar & Rules Committee",24,0,0,0,24
1946564,1530889,2025-03-31,House,"FLOOR VOTE: CONSENT CALENDAR PASSAGE ON THIRD CONSIDERATION",93,0,2,0,95
1946600,1519909,2025-03-18,House,"HOUSE TRANSPORTATION SUBCOMMITTEE: Failed in s/c Transportation Subcommittee of Transportation Committee",3,5,1,0,9
1946635,1485315,2025-02-05,House,"FLOOR VOTE: CONSENT CALENDAR PASSAGE ON THIRD CONSIDERATION",90,0,0,0,90
1946671,1519907,2025-03-18,House,"HOUSE TRANSPORTATION SUBCOMMITTEE: Def. to Summer Study in Transportation Subcommittee",9,0,0,0,9
1946708,1528084,2025-03-26,House,"HOUSE AGRICULTURE AND NATURAL RESOURCES SUBCOMMITTEE: Rec for pass if am by s/c ref. to Agriculture & Natural Resources Committee",9,0,0,0,9
1946708,1532082,2025-04-01,House,"HOUSE AGRICULTURE & NATURAL RESOURCES COMMITTEE: Rec. for pass. if am., ref. to Finance, Ways, and Means Committee",14,1,1,0,16
1946708,1551890,2025-04-17,House,"HOUSE FINANCE, WAYS, AND MEANS SUBCOMMITTEE: Rec. for pass by s/c ref. to Finance, Ways, and Means Committee",11,0,0,0,11
1946708,1553430,2025-04-17,House,"HOUSE FINANCE, WAYS, AND MEANS COMMITTEE: Rec. for pass; ref to Calendar & Rules Committee",27,0,0,0,27
1946783,1499305,2025-02-25,House,"HOUSE EDUCATION ADMINISTRATION SUBCOMMITTEE: Rec. for pass by s/c ref. to Education Committee",6,0,0,0,6
1946783,1526539,2025-03-25,House,"HOUSE EDUCATION COMMITTEE: Rec. for pass; ref to Finance, Ways, and Means Committee",17,0,1,0,18
1946817,1505764,2025-03-05,House,"HOUSE CRIMINAL JUSTICE SUBCOMMITTEE: Rec. for pass by s/c ref. to Judiciary Committee",9,0,0,0,9
1946817,1516685,2025-03-12,House,"HOUSE JUDICIARY COMMITTEE: Rec. for pass; ref to Finance, Ways, and Means Committee",20,0,0,0,20
1946817,1534581,2025-04-02,House,"HOUSE FINANCE, WAYS, AND MEANS SUBCOMMITTEE: Rec. for pass by s/c ref. to Finance, Ways, and Means Committee",11,0,0,0,11
1946817,1547324,2025-04-14,House,"HOUSE FINANCE, WAYS, AND MEANS COMMITTEE: Rec. for pass; ref to Calendar & Rules Committee",28,0,0,0,28
1946853,1500058,2025-02-26,House,"HOUSE CRIMINAL JUSTICE SUBCOMMITTEE: Rec. for pass by s/c ref. to Judiciary Committee",7,2,0,0,9
1946853,1506360,2025-03-05,House,"HOUSE JUDICIARY COMMITTEE: Rec. for pass; ref to Finance, Ways, and Means Committee",17,5,0,0,22
1946888,1494498,2025-02-19,House,"HOUSE CITIES & COUNTIES SUBCOMMITTEE: Rec. for pass by s/c ref. to State & Local Government Committee",5,1,0,0,6
1946888,1500017,2025-02-26,House,"HOUSE STATE & LOCAL GOVERNMENT COMMITTEE: Rec. for pass; ref to Calendar & Rules Committee",18,1,0,0,19
1946888,1503423,2025-03-03,House,"FLOOR VOTE: CONSENT CALENDAR PASSAGE ON THIRD CONSIDERATION",89,0,0,0,89
1946888,1514019,2025-03-10,Senate,"FLOOR VOTE: Motion to Adopt",30,0,0,0,30
1946925,1505777,2025-03-05,House,"HOUSE CRIMINAL JUSTICE SUBCOMMITTEE: Rec. for pass by s/c ref. to Judiciary Committee",8,0,0,0,8
1946925,1521665,2025-03-19,House,"HOUSE JUDICIARY COMMITTEE: Rec. for pass; ref to Finance, Ways, and Means Committee",16,5,0,0,21
1946964,1520951,2025-03-19,House,"HOUSE PUBLIC SERVICE SUBCOMMITTEE: Rec. for pass by s/c ref. to State & Local Government Committee",6,0,0,0,6
1946964,1527869,2025-03-26,House,"HOUSE STATE & LOCAL GOVERNMENT COMMITTEE: Rec. for pass; ref to Calendar & Rules Committee",22,0,0,0,22
1946964,1531037,2025-03-31,House,"FLOOR VOTE: CONSENT CALENDAR PASSAGE ON THIRD CONSIDERATION",93,0,2,0,95
1946964,1548089,2025-04-14,Senate,"FLOOR VOTE: as Amended Third Consideration",32,0,0,0,32
1946964,1550567,2025-04-16,House,"FLOOR VOTE: MESSAGE CALENDAR CONCUR IN SENATE AMENDMENT # 1",89,0,0,0,89
1946997,1513300,2025-03-11,House,"HOUSE DEPARTMENTS & AGENCIES SUBCOMMITTEE: Rec. for pass by s/c ref. to State & Local Government Committee",8,0,0,0,8
1947034,1515824,2025-03-12,House,"HOUSE PUBLIC SERVICE SUBCOMMITTEE: Rec for pass if am by s/c ref. to State & Local Government Committee",5,1,0,0,6
1947034,1528140,2025-03-26,House,"HOUSE STATE & LOCAL GOVERNMENT COMMITTEE: Rec. for pass. if am., ref. to Calendar & Rules Committee",19,2,1,0,22
1947105,1520004,2025-03-18,Senate,"SENATE STATE & LOCAL GOVERNMENT COMMITTEE: Recommended for passage with amendment/s, refer to Senate Calendar Committee Ayes 8, Nays 0 PNV 1",8,0,1,0,9
1947105,1528835,2025-03-27,Senate,"FLOOR VOTE: as Amended Third Consideration",28,2,0,0,30
1947140,1483662,2025-02-05,House,"FLOOR VOTE: CONSENT CALENDAR PASSAGE ON THIRD CONSIDERATION",90,0,0,0,90
1947140,1490126,2025-02-13,Senate,"FLOOR VOTE: Motion to Adopt",31,0,0,0,31
1947177,1515730,2025-03-11,Senate,"SENATE JUDICIARY COMMITTEE: Recommended for passage, refer to Senate Finance, Ways, and Means Committee",9,0,0,0,9
1947177,1552971,2025-04-21,Senate,"SENATE FINANCE, WAYS AND MEANS COMMITTEE: Recommended for passage, refer to Senate Calendar Committee",11,0,0,0,11
1947214,1534766,2025-04-02,House,"HOUSE CIVIL JUSTICE SUBCOMMITTEE: Failed in s/c Civil Justice Subcommittee of Judiciary Committee",3,4,0,0,7
1947288,1514935,2025-03-11,House,"HOUSE EDUCATION ADMINISTRATION SUBCOMMITTEE: Failed in s/c Education Administration Subcommittee of Education Committee",1,5,0,0,6
1947322,1521004,2025-03-19,House,"HOUSE PUBLIC SERVICE SUBCOMMITTEE: Rec. for pass by s/c ref. to State & Local Government Committee",5,1,0,0,6
1947322,1534218,2025-04-02,House,"HOUSE STATE & LOCAL GOVERNMENT COMMITTEE: Rec. for pass; ref to Calendar & Rules Committee",12,5,5,0,22
1947322,1544134,2025-04-10,House,"FLOOR VOTE: REGULAR CALENDAR MOTION TO ADOPT AMENDMENT # 1 BY FRITTS PASSAGE ON THIRD CONSIDERATION",69,21,1,0,91
1947322,1544135,2025-04-10,House,"FLOOR VOTE: REGULAR CALENDAR REFER TO COMMITTEE AS AMENDED PASSAGE ON THIRD CONSIDERATION",61,31,0,0,92
1947425,1520015,2025-03-18,Senate,"SENATE STATE & LOCAL GOVERNMENT COMMITTEE: Recommended for passage, refer to Senate Calendar Committee",7,1,1,0,9
1947425,1528235,2025-03-26,Senate,"FLOOR VOTE: Third Consideration",26,6,0,0,32
1947425,1551037,2025-04-16,House,"FLOOR VOTE: REGULAR CALENDAR PASSAGE ON THIRD CONSIDERATION",70,22,0,0,92
1947460,1527120,2025-03-25,House,"HOUSE ELECTIONS & CAMPAIGN FINANCE SUBCOMMITTEE: Rec for pass if am by s/c ref. to State & Local Government Committee",6,1,0,0,7
1947460,1535372,2025-04-02,House,"HOUSE STATE & LOCAL GOVERNMENT COMMITTEE: Rec. for pass. if am., ref. to Government Operations Committee",16,7,0,0,23
1947460,1538959,2025-04-07,House,"HOUSE GOVERNMENT OPERATIONS COMMITTEE: Rec. for pass; ref to Calendar & Rules Committee",6,4,1,0,11
1947470,1527931,2025-03-26,House,"HOUSE CRIMINAL JUSTICE SUBCOMMITTEE: Rec for pass if am by s/c ref. to Judiciary Committee",8,1,0,0,9
1947470,1543109,2025-04-09,House,"HOUSE JUDICIARY COMMITTEE: Rec. for pass. if am., ref. to Government Operations Committee",14,3,1,0,18
1947470,1549671,2025-04-16,House,"HOUSE GOVERNMENT OPERATIONS COMMITTEE: Rec. for pass; ref to Finance, Ways, and Means Committee",10,1,0,0,11
1947470,1551978,2025-04-17,House,"HOUSE FINANCE, WAYS, AND MEANS SUBCOMMITTEE: Rec for pass if am by s/c ref. to Finance, Ways, and Means Committee",11,0,0,0,11
1947470,1553197,2025-04-21,Senate,"FLOOR VOTE: Third Consideration",22,8,0,0,30
1947470,1553986,2025-04-17,House,"HOUSE FINANCE, WAYS, AND MEANS COMMITTEE: Rec. for pass; ref to Calendar & Rules Committee",27,0,0,0,27
1947470,1553987,2025-04-21,House,"FLOOR VOTE: REGULAR CALENDAR AS AMENDED PASSAGE ON THIRD CONSIDERATION",83,5,1,0,89
1947481,1483671,2025-02-05,House,"FLOOR VOTE: CONSENT CALENDAR PASSAGE ON THIRD CONSIDERATION",90,0,0,0,90
1947481,1489948,2025-02-13,Senate,"FLOOR VOTE: Motion to Adopt",31,0,0,0,31
1947501,1483589,2025-02-05,House,"FLOOR VOTE: CONSENT CALENDAR PASSAGE ON THIRD CONSIDERATION",90,0,0,0,90
1947501,1490442,2025-02-13,Senate,"FLOOR VOTE: Motion to Adopt",31,0,0,0,31
1947532,1506343,2025-03-05,House,"HOUSE PUBLIC SERVICE SUBCOMMITTEE: Failed in s/c Public Service Subcommittee of State & Local Government Committee",2,3,0,0,5
1947543,1505847,2025-03-05,House,"HOUSE CRIMINAL JUSTICE SUBCOMMITTEE: Rec. for pass by s/c ref. to Judiciary Committee",7,0,2,0,9
1947543,1527535,2025-03-26,House,"HOUSE JUDICIARY COMMITTEE: Rec. for pass. if am., ref. to Finance, Ways, and Means Committee",20,0,0,0,20
1947543,1551784,2025-04-17,House,"HOUSE FINANCE, WAYS, AND MEANS SUBCOMMITTEE: Rec. for pass by s/c ref. to Finance, Ways, and Means Committee",11,0,0,0,11
1947543,1553266,2025-04-17,House,"HOUSE FINANCE, WAYS, AND MEANS COMMITTEE: Rec. for pass; ref to Calendar & Rules Committee",27,0,0,0,27
1947543,1553267,2025-04-21,House,"FLOOR VOTE: REGULAR CALENDAR AS AMENDED PASSAGE ON THIRD CONSIDERATION",84,4,1,0,89
1947543,1556913,2025-04-22,Senate,"FLOOR VOTE: Third Consideration",33,0,0,0,33
1947553,1527744,2025-03-26,House,"HOUSE CRIMINAL JUSTICE SUBCOMMITTEE: Failed in s/c Criminal Justice Subcommittee of Judiciary Committee",2,6,0,0,8
1947563,1498463,2025-02-24,House,"HOUSE NAMING & DESIGNATING COMMITTEE: Rec. for pass; ref to State & Local Government Committee",10,0,0,0,10
1947563,1540585,2025-04-08,House,"HOUSE STATE & LOCAL GOVERNMENT COMMITTEE: Rec. for pass; ref to Calendar & Rules Committee",19,0,2,0,21
1947563,1547950,2025-04-14,House,"FLOOR VOTE: CONSENT CALENDAR PASSAGE ON THIRD CONSIDERATION",94,0,1,0,95
1947574,1483700,2025-02-05,House,"FLOOR VOTE: CONSENT CALENDAR PASSAGE ON THIRD CONSIDERATION",90,0,0,0,90
1947574,1490103,2025-02-13,Senate,"FLOOR VOTE: Motion to Adopt",31,0,0,0,31
1947584,1505709,2025-03-05,House,"HOUSE CRIMINAL JUSTICE SUBCOMMITTEE: Rec for pass if am by s/c ref. to Judiciary Committee",9,0,0,0,9
1947584,1527810,2025-03-26,House,"HOUSE JUDICIARY COMMITTEE: Rec. for pass. if am., ref. to Calendar & Rules Committee",20,0,0,0,20
1947594,1500290,2025-02-26,House,"HOUSE CRIMINAL JUSTICE SUBCOMMITTEE: Rec. for pass by s/c ref. to Judiciary Committee",9,0,0,0,9
1947594,1516676,2025-03-12,House,"HOUSE JUDICIARY COMMITTEE: Rec. for pass; ref to Calendar & Rules Committee",21,0,0,0,21
1947594,1518586,2025-03-17,House,"FLOOR VOTE: CONSENT CALENDAR PASSAGE ON THIRD CONSIDERATION",92,0,1,0,93
1947625,1494923,2025-02-18,House,"POPULATION HEALTH SUBCOMMITTEE: Rec. for pass by s/c ref. to Health Committee",8,0,0,0,8
1947625,1499426,2025-02-25,House,"HOUSE HEALTH COMMITTEE: Rec. for pass; ref to Calendar & Rules Committee",15,0,0,0,15
1947625,1503541,2025-03-03,House,"FLOOR VOTE: CONSENT CALENDAR PASSAGE ON THIRD CONSIDERATION",89,0,0,0,89
1947625,1515276,2025-03-10,Senate,"FLOOR VOTE: Motion to Adopt",30,0,0,0,30
1947636,1519945,2025-03-18,House,"HOUSE DEPARTMENTS & AGENCIES SUBCOMMITTEE: Rec for pass if am by s/c ref. to State & Local Government Committee",8,0,0,0,8
1947636,1527743,2025-03-26,House,"HOUSE STATE & LOCAL GOVERNMENT COMMITTEE: Rec. for pass. if am., ref. to Finance, Ways, and Means Committee",23,0,0,0,23
1947636,1551776,2025-04-17,House,"HOUSE FINANCE, WAYS, AND MEANS SUBCOMMITTEE: Rec. for pass by s/c ref. to Finance, Ways, and Means Committee",11,0,0,0,11
1947636,1553270,2025-04-17,House,"HOUSE FINANCE, WAYS, AND MEANS COMMITTEE: Rec. for pass. if am., ref. to Calendar & Rules Committee",28,0,0,0,28
1947636,1553271,2025-04-17,House,"HOUSE FINANCE, WAYS, AND MEANS COMMITTEE: Rec. for pass; ref to Calendar & Rules Committee",27,0,0,0,27
1947636,1553272,2025-04-21,House,"FLOOR VOTE: REGULAR CALENDAR AS AMENDED PASSAGE ON THIRD CONSIDERATION",93,0,0,0,93
1947636,1556891,2025-04-22,Senate,"FLOOR VOTE: Third Consideration",33,0,0,0,33
1947656,1505788,2025-03-05,House,"HOUSE CRIMINAL JUSTICE SUBCOMMITTEE: Rec. for pass by s/c ref. to Judiciary Committee",9,0,0,0,9
1947656,1527839,2025-03-26,House,"HOUSE JUDICIARY COMMITTEE: Rec. for pass; ref to Finance, Ways, and Means Committee",19,0,1,0,20
1947667,1532266,2025-04-01,House,"HOUSE CRIMINAL JUSTICE SUBCOMMITTEE: Rec for pass if am by s/c ref. to Judiciary Committee",9,0,0,0,9
1947667,1541951,2025-04-09,House,"HOUSE JUDICIARY COMMITTEE: Rec. for pass. if am., ref. to Calendar & Rules Committee",20,0,0,0,20
1947677,1521499,2025-03-19,House,"HOUSE CIVIL JUSTICE SUBCOMMITTEE: Rec for pass if am by s/c ref. to Judiciary Committee",6,1,0,0,7
1947677,1542062,2025-04-09,House,"HOUSE JUDICIARY COMMITTEE: Rec. for pass. if am., ref. to Calendar & Rules Committee",16,6,0,0,22
1947687,1505792,2025-03-05,House,"HOUSE CRIMINAL JUSTICE SUBCOMMITTEE: Rec. for pass by s/c ref. to Judiciary Committee",8,0,1,0,9
1947687,1527532,2025-03-26,House,"HOUSE JUDICIARY COMMITTEE: Rec. for pass; ref to Calendar & Rules Committee",19,0,1,0,20
1947719,1499994,2025-02-26,House,"HOUSE HEALTH SUBCOMMITTEE: Rec. for pass by s/c ref. to Health Committee",9,0,0,0,9
1947719,1504633,2025-03-04,House,"HOUSE HEALTH COMMITTEE: Rec. for pass; ref to Calendar & Rules Committee",15,0,1,0,16
1947719,1511522,2025-03-10,House,"FLOOR VOTE: CONSENT CALENDAR PASSAGE ON THIRD CONSIDERATION",94,0,0,0,94
1947731,1522333,2025-03-19,Senate,"SENATE EDUCATION COMMITTEE: Recommended for passage with amendment/s, refer to Senate Calendar Committee Ayes 8, Nays 0 PNV 0",8,0,0,0,8
1947731,1525814,2025-03-24,Senate,"FLOOR VOTE: as Amended Third Consideration",32,0,0,0,32
1947731,1550527,2025-04-16,House,"FLOOR VOTE: REGULAR CALENDAR AS AMENDED PASSAGE ON THIRD CONSIDERATION",78,9,8,0,95
1947731,1552672,2025-04-21,Senate,"FLOOR VOTE: Motion to Concur House Amendment # 1",33,0,0,0,33
1947738,1531632,2025-03-31,Senate,"SENATE JUDICIARY COMMITTEE: Recommended for passage with amendment/s, refer to Senate Calendar Committee Ayes 6, Nays 2 PNV 0",6,2,0,0,8
1947738,1542733,2025-04-09,Senate,"FLOOR VOTE: as Amended Third Consideration",25,5,0,0,30
1947738,1549201,2025-04-15,House,"FLOOR VOTE: REGULAR CALENDAR PASSAGE ON THIRD CONSIDERATION",76,18,0,0,94
1947752,1532627,2025-04-01,Senate,"SENATE STATE & LOCAL GOVERNMENT COMMITTEE: Recommended for passage with amendment/s, refer to Senate Calendar Committee Ayes 7, Nays 0 PNV 0",7,0,0,0,7
1947752,1539241,2025-04-07,Senate,"FLOOR VOTE: as Amended Third Consideration",32,0,0,0,32
1947752,1550160,2025-04-16,House,"FLOOR VOTE: REGULAR CALENDAR PASSAGE ON THIRD CONSIDERATION",93,0,0,0,93
1947776,1505860,2025-03-04,Senate,"SENATE JUDICIARY COMMITTEE: Recommended for passage with amendment/s, refer to Senate Calendar Committee Ayes 9, Nays 0 PNV 0",9,0,0,0,9
1947784,1490461,2025-02-13,Senate,"FLOOR VOTE: Motion to Adopt",31,0,0,0,31
1947784,1498353,2025-02-24,House,"FLOOR VOTE: CONSENT CALENDAR PASSAGE ON THIRD CONSIDERATION",92,0,2,0,94
1947798,1505814,2025-03-05,House,"HOUSE CRIMINAL JUSTICE SUBCOMMITTEE: Rec. for pass by s/c ref. to Judiciary Committee",9,0,0,0,9
1947798,1540090,2025-04-08,House,"HOUSE JUDICIARY COMMITTEE: Rec. for pass; ref to Calendar & Rules Committee",20,0,2,0,22
1947806,1500678,2025-02-26,Senate,"SENATE ENERGY, AGRICULTURE AND NATURAL RESOURCES COMMITTEE: Recommended for passage, refer to Senate Calendar Committee",9,0,0,0,9
1947806,1515437,2025-03-03,Senate,"FLOOR VOTE: Motion to Adopt",32,0,0,0,32
1947823,1528414,2025-03-26,Senate,"SENATE ENERGY, AGRICULTURE AND NATURAL RESOURCES COMMITTEE: Recommended for passage, refer to Senate Finance, Ways, and Means Committee",9,0,0,0,9
1947830,1500932,2025-02-26,Senate,"SENATE HEALTH AND WELFARE COMMITTEE: Recommended for passage, refer to Senate Calendar Committee",9,0,0,0,9
1947830,1515471,2025-03-03,Senate,"FLOOR VOTE: Motion to Adopt",32,0,0,0,32
1947845,1504695,2025-03-04,Senate,"SENATE STATE & LOCAL GOVERNMENT COMMITTEE: Recommended for passage, refer to Senate Calendar Committee",9,0,0,0,9
1947845,1513251,2025-03-10,Senate,"FLOOR VOTE: Motion to Adopt",30,0,0,0,30
1947853,1498983,2025-02-25,Senate,"SENATE COMMERCE AND LABOR COMMITTEE: Recommended for passage, refer to Senate Calendar Committee",8,0,0,0,8
1947853,1514592,2025-03-03,Senate,"FLOOR VOTE: Motion to Adopt",32,0,0,0,32
1947857,1527318,2025-03-25,Senate,"SENATE COMMERCE AND LABOR COMMITTEE: Recommended for passage with amendment/s, refer to Senate Calendar Committee Ayes 9, Nays 0 PNV 0",9,0,0,0,9
1947873,1515931,2025-03-11,Senate,"SENATE JUDICIARY COMMITTEE: Recommended for passage, refer to Senate Calendar Committee",8,1,0,0,9
1947873,1519679,2025-03-17,Senate,"FLOOR VOTE: Third Consideration",25,5,0,0,30
1947873,1552031,2025-04-17,House,"FLOOR VOTE: REGULAR CALENDAR PASSAGE ON THIRD CONSIDERATION",73,23,1,0,97
1947910,1527710,2025-03-26,Senate,"SENATE HEALTH AND WELFARE COMMITTEE: Recommended for passage, refer to Senate Finance, Ways, and Means Committee",9,0,0,0,9
1947910,1539666,2025-04-08,Senate,"SENATE FINANCE, WAYS AND MEANS COMMITTEE: Recommended for passage, refer to Senate Calendar Committee",10,0,0,0,10
1947910,1548171,2025-04-14,Senate,"FLOOR VOTE: Motion to Adopt",32,0,0,0,32
1947917,1520818,2025-03-18,Senate,"SENATE COMMERCE AND LABOR COMMITTEE: Recommended for passage, refer to Senate Calendar Committee",7,0,0,0,7
1947917,1525801,2025-03-24,Senate,"FLOOR VOTE: Motion to Adopt",32,0,0,0,32
1947973,1534430,2025-04-02,Senate,"SENATE STATE & LOCAL GOVERNMENT COMMITTEE: Recommended for passage, refer to Senate Calendar Committee",8,1,0,0,9
1947993,1504828,2025-03-04,Senate,"SENATE STATE & LOCAL GOVERNMENT COMMITTEE:",9,0,0,0,9
1948054,1535303,2025-04-02,Senate,"SENATE STATE & LOCAL GOVERNMENT COMMITTEE: Recommended for passage with amendment/s, refer to Senate Finance, Ways, and Means Committee Ayes 9, Nays 0 PNV 0",9,0,0,0,9
1948054,1552967,2025-04-21,Senate,"SENATE FINANCE, WAYS AND MEANS COMMITTEE: Recommended for passage, refer to Senate Calendar Committee",11,0,0,0,11
1948062,1516867,2025-03-12,Senate,"SENATE EDUCATION COMMITTEE: Recommended for passage, refer to Senate Calendar Committee",9,0,0,0,9
1948068,1515963,2025-03-11,Senate,"SENATE STATE & LOCAL GOVERNMENT COMMITTEE: Recommended for passage, refer to Senate Calendar Committee",7,0,0,0,7
1948068,1519644,2025-03-17,Senate,"FLOOR VOTE: Motion to Adopt",32,0,0,0,32
1948068,1544969,2025-04-10,House,"FLOOR VOTE: REGULAR CALENDAR PASSAGE ON THIRD CONSIDERATION",96,0,0,0,96
1948075,1515642,2025-03-11,Senate,"SENATE JUDICIARY COMMITTEE: Recommended for passage with amendment/s, refer to Senate Calendar Committee Ayes 8, Nays 1 PNV 0",8,1,0,0,9
1948079,1514024,2025-03-11,Senate,"SENATE COMMERCE AND LABOR COMMITTEE: Recommended for passage with amendment/s, refer to Senate Calendar Committee Ayes 6, Nays 3 PNV 0",6,3,0,0,9
1948088,1526771,2025-03-25,Senate,"SENATE JUDICIARY COMMITTEE: Recommended for passage with amendment/s, refer to Senate Calendar Committee Ayes 9, Nays 0 PNV 0",9,0,0,0,9
1948088,1531874,2025-03-31,Senate,"FLOOR VOTE: as Amended Third Consideration",30,0,0,0,30
1948088,1548483,2025-04-15,House,"FLOOR VOTE: REGULAR CALENDAR PASSAGE ON THIRD CONSIDERATION",95,0,0,0,95
1948096,1528203,2025-03-26,Senate,"SENATE ENERGY, AGRICULTURE AND NATURAL RESOURCES COMMITTEE: Recommended for passage with amendment/s, refer to Senate Calendar Committee Ayes 9, Nays 0, PNV 0",9,0,0,0,9
1948126,1505424,2025-03-04,Senate,"SENATE COMMERCE AND LABOR COMMITTEE: Recommended for passage with amendment/s, refer to Senate Calendar Committee Ayes 7, Nays 0 PNV 0",7,0,0,0,7
1948132,1521423,2025-03-19,Senate,"SENATE HEALTH AND WELFARE COMMITTEE: Recommended for passage with amendment/s, refer to Senate Calendar Committee Ayes 9, Nays 0 PNV 0",9,0,0,0,9
1948132,1525811,2025-03-24,Senate,"FLOOR VOTE: as Amended Third Consideration",33,0,0,0,33
1948132,1536053,2025-04-03,House,"FLOOR VOTE: REGULAR CALENDAR PASSAGE ON THIRD CONSIDERATION",90,0,0,0,90
1948142,1506696,2025-03-05,Senate,"SENATE ENERGY, AGRICULTURE AND NATURAL RESOURCES COMMITTEE: Recommended for passage, refer to Senate Calendar Committee",9,0,0,0,9
1948142,1523165,2025-03-20,Senate,"FLOOR VOTE: Third Consideration",29,3,0,0,32
1948142,1531642,2025-03-31,House,"FLOOR VOTE: REGULAR CALENDAR AS AMENDED PASSAGE ON THIRD CONSIDERATION",93,1,0,0,94
1948142,1535849,2025-04-03,Senate,"FLOOR VOTE: Motion to Concur House Amendment # 1",30,0,0,0,30
1948162,1505776,2025-03-04,Senate,"SENATE JUDICIARY COMMITTEE: Recommended for passage, refer to Senate Calendar Committee",9,0,0,0,9
1948162,1513110,2025-03-10,Senate,"FLOOR VOTE: Motion to Adopt",30,0,0,0,30
1948174,1492411,2025-02-18,Senate,"SENATE COMMERCE AND LABOR COMMITTEE: Recommended for passage, refer to Senate Calendar Committee",7,0,0,0,7
1948174,1498128,2025-02-24,Senate,"FLOOR VOTE: Motion to Adopt",33,0,0,0,33
1948183,1524684,2025-03-24,Senate,"SENATE JUDICIARY COMMITTEE: Recommended for passage with amendment/s, refer to Senate Calendar Committee Ayes 8, Nays 0 PNV 1",8,0,1,0,9
1948183,1536928,2025-04-03,Senate,"FLOOR VOTE: as Amended Third Consideration",27,0,0,0,27
1948183,1550856,2025-04-16,House,"FLOOR VOTE: REGULAR CALENDAR PASSAGE ON THIRD CONSIDERATION",94,0,0,0,94
1948190,1521468,2025-03-19,House,"HOUSE AGRICULTURE AND NATURAL RESOURCES SUBCOMMITTEE: Rec for pass if am by s/c ref. to Agriculture & Natural Resources Committee",8,0,0,0,8
1948190,1526761,2025-03-25,House,"HOUSE AGRICULTURE & NATURAL RESOURCES COMMITTEE: Rec. for pass. if am., ref. to Government Operations Committee",16,0,0,0,16
1948190,1530800,2025-03-31,House,"HOUSE GOVERNMENT OPERATIONS COMMITTEE: Rec. for pass; ref to Calendar & Rules Committee",15,0,0,0,15
1948196,1504763,2025-03-04,Senate,"SENATE COMMERCE AND LABOR COMMITTEE: Recommended for passage, refer to Senate Calendar Committee",7,0,0,0,7
1948196,1513236,2025-03-10,Senate,"FLOOR VOTE: Motion to Adopt",30,0,0,0,30
1948205,1499535,2025-02-25,Senate,"SENATE COMMERCE AND LABOR COMMITTEE: Recommended for passage, refer to Senate Calendar Committee",7,0,0,0,7
1948205,1514745,2025-03-06,Senate,"FLOOR VOTE: Third Consideration",27,3,0,0,30
1948205,1517324,2025-03-13,House,"FLOOR VOTE: REGULAR CALENDAR PASSAGE ON THIRD CONSIDERATION",84,4,0,0,88
1948212,1528427,2025-03-26,Senate,"SENATE ENERGY, AGRICULTURE AND NATURAL RESOURCES COMMITTEE: Recommended for passage, refer to Senate Calendar Committee",9,0,0,0,9
1948219,1499879,2025-02-25,Senate,"SENATE JUDICIARY COMMITTEE: Recommended for passage with amendment, refer to Senate Calendar Committee",7,2,0,0,9
1948219,1513332,2025-03-06,Senate,"FLOOR VOTE: as Amended Third Consideration",26,3,1,0,30
1948219,1548904,2025-04-15,House,"FLOOR VOTE: REGULAR CALENDAR AS AMENDED PASSAGE ON THIRD CONSIDERATION",75,17,2,0,94
1948228,1516037,2025-03-12,Senate,"SENATE ENERGY, AGRICULTURE AND NATURAL RESOURCES COMMITTEE: Recommended for passage, refer to Senate Calendar Committee",7,2,0,0,9
1948228,1524980,2025-03-24,Senate,"SENATE JUDICIARY COMMITTEE: Recommended for passage with amendment/s, refer to Senate Calendar Committee Ayes 6, Nays 2 PNV 1",6,2,1,0,9
1948228,1536327,2025-04-03,Senate,"FLOOR VOTE: Previous Question as Amended Third Consideration",25,4,0,0,29
1948228,1536328,2025-04-03,Senate,"FLOOR VOTE: as Amended Third Consideration",21,7,2,0,30
1948245,1524682,2025-03-24,Senate,"SENATE JUDICIARY COMMITTEE: Recommended for passage, refer to Senate Calendar Committee",7,2,0,0,9
1948245,1536240,2025-04-03,Senate,"FLOOR VOTE: Third Consideration",25,5,0,0,30
1948245,1543719,2025-04-10,House,"FLOOR VOTE: REGULAR CALENDAR MOTION TO CONSIDER AMENDMENT # 1 BY PEARSON PASSAGE ON THIRD CONSIDERATION",22,72,0,0,94
1948245,1543720,2025-04-10,House,"FLOOR VOTE: REGULAR CALENDAR PASSAGE ON THIRD CONSIDERATION",73,22,0,0,95
1948245,1543721,2025-04-10,House,"FLOOR VOTE: REGULAR CALENDAR PREVIOUS QUESTION PASSAGE ON THIRD CONSIDERATION",73,21,0,0,94
1948381,1530771,2025-03-25,Senate,"SENATE COMMERCE AND LABOR COMMITTEE: Failed in Senate Commerce and Labor Committee",1,8,0,0,9
1948455,1506506,2025-03-05,Senate,"SENATE HEALTH AND WELFARE COMMITTEE: Recommended for passage, refer to Senate Calendar Committee",9,0,0,0,9
1948569,1516013,2025-03-12,Senate,"SENATE HEALTH AND WELFARE COMMITTEE: Recommended for passage with amendment/s, refer to Senate Finance, Ways & Means Committee Ayes 9, Nays 0 PNV 0",9,0,0,0,9
1948569,1539601,2025-04-08,Senate,"SENATE FINANCE, WAYS AND MEANS COMMITTEE: Recommended for passage, refer to Senate Calendar Committee",9,0,0,0,9
1948569,1547417,2025-04-14,House,"FLOOR VOTE: REGULAR CALENDAR PASSAGE ON THIRD CONSIDERATION",96,0,0,0,96
1948569,1548121,2025-04-14,Senate,"FLOOR VOTE: as Amended Third Consideration",32,0,0,0,32
1948606,1506218,2025-03-05,Senate,"SENATE HEALTH AND WELFARE COMMITTEE: Recommended for passage with amendment/s, refer to Senate Calendar Committee Ayes 9, Nays 0 PNV 0",9,0,0,0,9
1948606,1517301,2025-03-13,Senate,"FLOOR VOTE: as Amended Third Consideration",31,0,0,0,31
1948606,1525170,2025-03-24,House,"FLOOR VOTE: REGULAR CALENDAR PASSAGE ON THIRD CONSIDERATION",94,0,0,0,94
1948680,1505841,2025-03-04,Senate,"SENATE JUDICIARY COMMITTEE: Recommended for passage, refer to Senate Calendar Committee",9,0,0,0,9
1948680,1513397,2025-03-10,Senate,"FLOOR VOTE: Motion to Adopt",30,0,0,0,30
1948680,1553364,2025-04-21,House,"FLOOR VOTE: REGULAR CALENDAR PASSAGE ON THIRD CONSIDERATION",91,0,2,0,93
1948796,1516866,2025-03-12,Senate,"SENATE EDUCATION COMMITTEE: Recommended for passage with amendment/s, refer to Senate Calendar Committee Ayes 9, Nays 0 PNV 0",9,0,0,0,9
1948836,1499813,2025-02-25,Senate,"SENATE JUDICIARY COMMITTEE: Recommended for passage with amendment, refer to Senate Calendar Committee",5,4,0,0,9
1948991,1520838,2025-03-18,Senate,"SENATE COMMERCE AND LABOR COMMITTEE: Failed in Senate Commerce and Labor Committee",1,7,0,0,8
1949032,1492955,2025-02-13,Senate,"FLOOR VOTE: Motion to Adopt",31,0,0,0,31
1949163,1515435,2025-03-11,House,"HOUSE TRANSPORTATION SUBCOMMITTEE: Rec. for pass by s/c ref. to Transportation Committee",9,0,0,0,9
1949163,1520372,2025-03-18,House,"HOUSE TRANSPORTATION COMMITTEE: Rec. for pass; ref to Calendar & Rules Committee",18,0,0,0,18
1949163,1524973,2025-03-24,House,"FLOOR VOTE: CONSENT CALENDAR PASSAGE ON THIRD CONSIDERATION",96,0,0,0,96
1949176,1551821,2025-04-17,House,"HOUSE FINANCE, WAYS, AND MEANS SUBCOMMITTEE: Rec. for pass by s/c ref. to Finance, Ways, and Means Committee",11,0,0,0,11
1949176,1553289,2025-04-17,House,"HOUSE FINANCE, WAYS, AND MEANS COMMITTEE: Rec. for pass; ref to Calendar & Rules Committee",27,0,0,0,27
1949176,1553290,2025-04-21,House,"FLOOR VOTE: REGULAR CALENDAR PASSAGE ON THIRD CONSIDERATION",93,0,0,0,93
1949176,1556402,2025-04-22,Senate,"FLOOR VOTE: Third Consideration",28,2,1,0,31
1949186,1513737,2025-03-11,House,"HOUSE TRANSPORTATION SUBCOMMITTEE: Rec. for pass by s/c ref. to Transportation Committee",9,0,0,0,9
1949186,1519887,2025-03-18,House,"HOUSE TRANSPORTATION COMMITTEE: Rec. for pass; ref to Finance, Ways, and Means Committee",19,0,0,0,19
1949186,1527505,2025-03-26,House,"HOUSE FINANCE, WAYS, AND MEANS SUBCOMMITTEE: Rec. for pass by s/c ref. to Finance, Ways, and Means Committee",12,0,0,0,12
1949186,1533095,2025-04-01,House,"HOUSE FINANCE, WAYS, AND MEANS COMMITTEE: Rec. for pass; ref to Calendar & Rules Committee",28,0,0,0,28
1949198,1504273,2025-03-04,House,"POPULATION HEALTH SUBCOMMITTEE: Failed in s/c Population Health Subcommittee of Health Committee",1,8,0,0,9
1949223,1505160,2025-03-04,House,"HOUSE DEPARTMENTS & AGENCIES SUBCOMMITTEE: Rec. for pass by s/c ref. to State & Local Government Committee",8,0,0,0,8
1949223,1521909,2025-03-19,House,"HOUSE STATE & LOCAL GOVERNMENT COMMITTEE: Rec. for pass; ref to Finance, Ways, and Means Committee",19,0,0,0,19
1949223,1551933,2025-04-17,House,"HOUSE FINANCE, WAYS, AND MEANS SUBCOMMITTEE: Rec. for pass by s/c ref. to Finance, Ways, and Means Committee",11,0,0,0,11
1949223,1553480,2025-04-17,House,"HOUSE FINANCE, WAYS, AND MEANS COMMITTEE: Rec. for pass; ref to Calendar & Rules Committee",27,0,0,0,27
1949325,1514007,2025-03-11,House,"HOUSE ELECTIONS & CAMPAIGN FINANCE SUBCOMMITTEE: Rec. for pass by s/c ref. to State & Local Government Committee",7,0,0,0,7
1949325,1543147,2025-04-09,House,"HOUSE STATE & LOCAL GOVERNMENT COMMITTEE: Rec. for pass; ref to Finance, Ways, and Means Committee",20,0,0,0,20
1949325,1547097,2025-04-14,House,"HOUSE FINANCE, WAYS, AND MEANS SUBCOMMITTEE: Rec. for pass by s/c ref. to Finance, Ways, and Means Committee",12,0,0,0,12
1949325,1548991,2025-04-15,House,"HOUSE FINANCE, WAYS, AND MEANS COMMITTEE: Rec. for pass; ref to Calendar & Rules Committee",23,0,0,0,23
1949325,1550225,2025-04-16,House,"FLOOR VOTE: CONSENT CALENDAR PASSAGE ON THIRD CONSIDERATION",96,0,0,0,96
1949335,1500070,2025-02-26,House,"HOUSE CRIMINAL JUSTICE SUBCOMMITTEE: Rec for pass if am by s/c ref. to Judiciary Committee",8,0,0,0,8
1949335,1506147,2025-03-05,House,"HOUSE JUDICIARY COMMITTEE: Rec. for pass. if am., ref. to Calendar & Rules Committee",22,0,0,0,22
1949350,1521707,2025-03-19,House,"HOUSE CITIES & COUNTIES SUBCOMMITTEE: Rec for pass if am by s/c ref. to State & Local Government Committee",5,2,0,0,7
1949350,1540102,2025-04-08,House,"HOUSE STATE & LOCAL GOVERNMENT COMMITTEE: Rec. for pass. if am., ref. to Education Committee",17,5,0,0,22
1949350,1542041,2025-04-09,House,"FLOOR VOTE: MOTION TO SUSPEND THE RULES",69,19,0,0,88
1949350,1542042,2025-04-09,House,"HOUSE EDUCATION COMMITTEE: Rec. for pass. if am., ref. to Calendar & Rules Committee",10,4,3,0,17
1949350,1551312,2025-04-17,House,"FLOOR VOTE: REGULAR CALENDAR AS AMENDED PASSAGE ON THIRD CONSIDERATION",73,24,0,0,97
1949350,1551313,2025-04-17,House,"FLOOR VOTE: REGULAR CALENDAR MOTION TO ADOPT AMENDMENT # 3 BY JONES J PASSAGE ON THIRD CONSIDERATION",23,72,0,0,95
1949350,1551314,2025-04-17,House,"FLOOR VOTE: REGULAR CALENDAR MOTION TO ADOPT AMENDMENT # 4 BY JOHNSON PASSAGE ON THIRD CONSIDERATION",24,71,0,0,95
1949350,1551315,2025-04-17,House,"FLOOR VOTE: REGULAR CALENDAR PREVIOUS QUESTION MOTION TO ADOPT AMENDMENT # 3 BY JONES J PASSAGE ON THIRD CONSIDERATION",70,22,0,0,92
1949350,1551316,2025-04-17,House,"FLOOR VOTE: REGULAR CALENDAR PREVIOUS QUESTION MOTION TO ADOPT AMENDMENT # 4 BY JOHNSON PASSAGE ON THIRD CONSIDERATION",68,24,0,0,92
1949350,1556894,2025-04-22,Senate,"FLOOR VOTE: Lay on the Table Amend# 2 by Senator Yarbro Third Consideration",26,6,0,0,32
1949350,1556895,2025-04-22,Senate,"FLOOR VOTE: Third Consideration",27,6,0,0,33
1949360,1483737,2025-02-05,House,"FLOOR VOTE: CONSENT CALENDAR PASSAGE ON THIRD CONSIDERATION",90,0,0,0,90
1949360,1500846,2025-02-26,Senate,"SENATE ENERGY, AGRICULTURE AND NATURAL RESOURCES COMMITTEE: Recommended for concurrence by Senate Energy, Ag., and Nat. Resources Committee, refer Senate Calendar Committee",9,0,0,0,9
1949360,1515388,2025-03-03,Senate,"FLOOR VOTE: Motion to Adopt",32,0,0,0,32
1949377,1527727,2025-03-26,House,"HOUSE CRIMINAL JUSTICE SUBCOMMITTEE: Rec for pass if am by s/c ref. to Judiciary Committee",6,3,0,0,9
1949377,1534095,2025-04-02,House,"HOUSE JUDICIARY COMMITTEE: Rec. for pass. if am., ref. to Calendar & Rules Committee",11,8,0,0,19
1949377,1535764,2025-04-07,House,"HOUSE CALENDAR & RULES COMMITTEE: H. Placed on Regular Calendar for 4/7/2025 4/3/2025",11,9,0,0,20
1949377,1538345,2025-04-07,House,"FLOOR VOTE: REGULAR CALENDAR AS AMENDED PASSAGE ON THIRD CONSIDERATION",85,7,0,0,92
1949377,1543970,2025-04-10,Senate,"FLOOR VOTE: Third Consideration",24,6,0,0,30
1949395,1487783,2025-02-12,House,"HOUSE CITIES & COUNTIES SUBCOMMITTEE: Rec. for pass by s/c ref. to State & Local Government Committee",7,0,0,0,7
1949395,1494537,2025-02-19,House,"HOUSE STATE & LOCAL GOVERNMENT COMMITTEE: Rec. for pass; ref to Calendar & Rules Committee",22,0,0,0,22
1949395,1501024,2025-02-27,House,"FLOOR VOTE: REGULAR CALENDAR PASSAGE ON THIRD CONSIDERATION",61,26,4,0,91
1949422,1504183,2025-03-04,House,"HOUSE K-12 SUBCOMMITTEE: Rec. for pass by s/c ref. to Education Committee",7,0,0,0,7
1949422,1513653,2025-03-11,House,"HOUSE EDUCATION COMMITTEE: Rec. for pass; ref to Calendar & Rules Committee",17,0,0,0,17
1949422,1525316,2025-03-24,House,"FLOOR VOTE: CONSENT CALENDAR PASSAGE ON THIRD CONSIDERATION",96,0,0,0,96
1949422,1525938,2025-03-24,Senate,"FLOOR VOTE: as Amended Third Consideration",32,0,0,0,32
1949422,1531044,2025-03-31,House,"FLOOR VOTE: MESSAGE CALENDAR CONCUR IN SENATE AMENDMENT # 1",95,0,0,0,95
1949461,1528135,2025-03-26,House,"HOUSE AGRICULTURE AND NATURAL RESOURCES SUBCOMMITTEE: Rec for pass if am by s/c ref. to Agriculture & Natural Resources Committee",8,0,1,0,9
1949461,1532151,2025-04-01,House,"HOUSE AGRICULTURE & NATURAL RESOURCES COMMITTEE: Rec. for pass. if am., ref. to Calendar & Rules Committee",14,1,1,0,16
1949461,1544003,2025-04-10,House,"FLOOR VOTE: REGULAR CALENDAR AS AMENDED PASSAGE ON THIRD CONSIDERATION",74,20,0,0,94
1949461,1548029,2025-04-14,Senate,"FLOOR VOTE: Third Consideration",26,6,0,0,32
1949470,1514156,2025-03-11,House,"HOUSE DEPARTMENTS & AGENCIES SUBCOMMITTEE: Failed in s/c Departments & Agencies Subcommittee of State & Local Government Committee",1,6,0,0,7
1949509,1515115,2025-03-11,House,"HOUSE ELECTIONS & CAMPAIGN FINANCE SUBCOMMITTEE: Rec. for pass by s/c ref. to State & Local Government Committee",6,0,1,0,7
1949522,1520081,2025-03-18,House,"HOUSE TRANSPORTATION SUBCOMMITTEE: Def. to Summer Study in Transportation Subcommittee",9,0,0,0,9
1949547,1519698,2025-03-18,House,"HOUSE TRANSPORTATION SUBCOMMITTEE: Def. to Summer Study in Transportation Subcommittee",8,1,0,0,9
1949557,1526358,2025-03-25,House,"HOUSE CRIMINAL JUSTICE SUBCOMMITTEE: Rec. for pass by s/c ref. to Judiciary Committee",8,0,1,0,9
1949569,1506294,2025-03-05,House,"HOUSE PUBLIC SERVICE SUBCOMMITTEE: Failed in s/c Public Service Subcommittee of State & Local Government Committee",2,4,0,0,6
1949585,1513698,2025-03-11,House,"HOUSE DEPARTMENTS & AGENCIES SUBCOMMITTEE: Rec for pass if am by s/c ref. to State & Local Government Committee",8,0,0,0,8
1949585,1521820,2025-03-19,House,"HOUSE STATE & LOCAL GOVERNMENT COMMITTEE: Rec. for pass. if am., ref. to Calendar & Rules Committee",17,0,2,0,19
1949585,1528923,2025-03-27,House,"FLOOR VOTE: REGULAR CALENDAR AS AMENDED PASSAGE ON THIRD CONSIDERATION",94,0,0,0,94
1949585,1531797,2025-03-31,Senate,"FLOOR VOTE: Third Consideration",30,0,0,0,30
1949919,1528491,2025-03-26,Senate,"SENATE EDUCATION COMMITTEE: Recommended for passage with amendment/s, refer to Senate Calendar Committee Ayes 7, Nays 1 PNV 1",7,1,1,0,9
1949919,1541621,2025-04-09,Senate,"FLOOR VOTE: as Amended Third Consideration",28,0,0,0,28
1949919,1550416,2025-04-16,House,"FLOOR VOTE: REGULAR CALENDAR AS AMENDED PASSAGE ON THIRD CONSIDERATION",89,2,1,0,92
1949919,1552673,2025-04-21,Senate,"FLOOR VOTE: Motion to Concur House Amendment # 2",33,0,0,0,33
1949927,1526280,2025-03-25,Senate,"SENATE STATE & LOCAL GOVERNMENT COMMITTEE: Recommended for passage with amendment/s, refer to Senate Calendar Committee Ayes 9, Nays 0 PNV 0",9,0,0,0,9
1949927,1531866,2025-03-31,Senate,"FLOOR VOTE: as Amended Third Consideration",30,0,0,0,30
1949927,1550593,2025-04-16,House,"FLOOR VOTE: REGULAR CALENDAR PASSAGE ON THIRD CONSIDERATION",92,1,0,0,93
1949935,1506310,2025-03-05,Senate,"SENATE HEALTH AND WELFARE COMMITTEE: Recommended for passage with amendment/s, refer to Senate Calendar Committee Ayes 8, Nays 0 PNV 1",8,0,1,0,9
1949942,1535326,2025-04-02,Senate,"SENATE STATE & LOCAL GOVERNMENT COMMITTEE: Recommended for passage with amendment/s, refer to Senate Calendar Committee Ayes 9, Nays 0 PNV 0",9,0,0,0,9
1949942,1542677,2025-04-09,Senate,"FLOOR VOTE: as Amended Third Consideration",25,2,0,0,27
1949942,1553224,2025-04-21,House,"FLOOR VOTE: REGULAR CALENDAR PASSAGE ON THIRD CONSIDERATION",90,0,2,0,92
1949947,1541272,2025-04-08,Senate,"SENATE JUDICIARY COMMITTEE: Recommended for passage with amendment/s, refer to Senate Calendar Committee Ayes 8, Nays 0 PNV 0",8,0,0,0,8
1949947,1547503,2025-04-14,House,"FLOOR VOTE: REGULAR CALENDAR PASSAGE ON THIRD CONSIDERATION",95,1,0,0,96
1949947,1548190,2025-04-14,Senate,"FLOOR VOTE: as Amended Third Consideration",32,0,0,0,32
1949963,1532178,2025-04-01,Senate,"SENATE STATE & LOCAL GOVERNMENT COMMITTEE: Recommended for passage with amendment/s, refer to Senate Finance, Ways, and Means Committee Ayes 7, Nays 0 PNV 0",7,0,0,0,7
1949963,1544494,2025-04-10,Senate,"FLOOR VOTE: as Amended Third Consideration",30,0,2,0,32
1949963,1550384,2025-04-16,House,"FLOOR VOTE: REGULAR CALENDAR PASSAGE ON THIRD CONSIDERATION",82,2,7,0,91
1949969,1516850,2025-03-12,Senate,"SENATE EDUCATION COMMITTEE: Recommended for passage with amendment/s, refer to Senate Finance, Ways, and Means Committee Ayes 9, Nays 0 PNV 0",9,0,0,0,9
1949980,1501225,2025-02-26,Senate,"SENATE EDUCATION COMMITTEE: Recommended for passage, refer to Senate Finance, Ways, and Means Committee",9,0,0,0,9
1950000,1526403,2025-03-25,Senate,"SENATE STATE & LOCAL GOVERNMENT COMMITTEE: Recommended for passage with amendment/s, refer to Senate Calendar Committee Ayes 8, Nays 0 PNV 0",8,0,0,0,8
1950007,1490492,2025-02-13,Senate,"FLOOR VOTE: Motion to Adopt",31,0,0,0,31
1950007,1497996,2025-02-24,House,"FLOOR VOTE: CONSENT CALENDAR PASSAGE ON THIRD CONSIDERATION",92,0,2,0,94
1950021,1521028,2025-03-19,Senate,"TRANSPORTATION AND SAFETY COMMITTEE: Recommended for passage, refer to Senate Calendar Committee",8,0,0,0,8
1950042,1522095,2025-03-19,Senate,"SENATE HEALTH AND WELFARE COMMITTEE: Recommended for passage with amendment/s, refer to Senate Calendar Committee Ayes 9, Nays 0 PNV 0",9,0,0,0,9
1950055,1528510,2025-03-26,Senate,"SENATE EDUCATION COMMITTEE: Recommended for passage with amendment/s, refer to Senate Finance, Ways, and Means Committee Ayes 9, Nays 0 PNV 0",9,0,0,0,9
1950055,1539670,2025-04-08,Senate,"SENATE FINANCE, WAYS AND MEANS COMMITTEE: Recommended for passage, refer to Senate Calendar Committee",9,1,0,0,10
1950055,1548184,2025-04-14,Senate,"FLOOR VOTE: as Amended Third Consideration",23,5,2,0,30
1950087,1526076,2025-03-25,Senate,"SENATE STATE & LOCAL GOVERNMENT COMMITTEE: Recommended for passage, refer to Senate Calendar Committee",8,0,0,0,8
1950103,1533500,2025-04-01,Senate,"SENATE STATE & LOCAL GOVERNMENT COMMITTEE: Recommended for passage with amendment/s, refer to Senate Calendar Committee Ayes 6, Nays 2 PNV 0",6,2,0,0,8
1950143,1516188,2025-03-12,House,"HOUSE CITIES & COUNTIES SUBCOMMITTEE: Rec for pass if am by s/c ref. to State & Local Government Committee",7,0,0,0,7
1950143,1543150,2025-04-09,House,"HOUSE STATE & LOCAL GOVERNMENT COMMITTEE: Rec. for pass. if am., ref. to Finance, Ways, and Means Committee",22,0,0,0,22
1950143,1547192,2025-04-14,House,"HOUSE FINANCE, WAYS, AND MEANS SUBCOMMITTEE: Rec. for pass by s/c ref. to Finance, Ways, and Means Committee",12,0,0,0,12
1950143,1549362,2025-04-15,House,"HOUSE FINANCE, WAYS, AND MEANS COMMITTEE: Rec. for pass; ref to Calendar & Rules Committee",26,0,0,0,26
1950227,1534402,2025-04-02,Senate,"SENATE STATE & LOCAL GOVERNMENT COMMITTEE: Recommended for passage with amendment, refer to Senate Calendar Committee",7,2,0,0,9
1950227,1541445,2025-04-09,Senate,"FLOOR VOTE: as Amended Third Consideration",22,4,0,0,26
1950227,1550047,2025-04-16,House,"FLOOR VOTE: REGULAR CALENDAR PASSAGE ON THIRD CONSIDERATION",72,22,0,0,94
1950259,1521450,2025-03-19,Senate,"SENATE HEALTH AND WELFARE COMMITTEE: Recommended for passage with amendment/s, refer to Senate Finance, Ways, and Means Committee Ayes 9, Nays 0 PNV 0",9,0,0,0,9
1950259,1552731,2025-04-21,Senate,"SENATE FINANCE, WAYS AND MEANS COMMITTEE: Recommended for passage with amendment/s, refer to Senate Calendar Committee Ayes 10, Nays 0 PNV 0",10,0,0,0,10
1950321,1528161,2025-03-26,Senate,"SENATE HEALTH AND WELFARE COMMITTEE: Recommended for passage, refer to Senate Finance, Ways, and Means Committee",9,0,0,0,9
1950370,1535337,2025-04-02,Senate,"SENATE STATE & LOCAL GOVERNMENT COMMITTEE: Recommended for passage, refer to Senate Finance, Ways, and Means Committee",9,0,0,0,9
1950393,1500056,2025-02-26,House,"HOUSE HEALTH SUBCOMMITTEE:",2,7,0,0,9
1950462,1519919,2025-03-18,House,"HOUSE CHILDREN AND FAMILY AFFAIRS SUBCOMMITTEE: Rec for pass if am by s/c ref. to Judiciary Committee",6,0,0,0,6
1950462,1540122,2025-04-08,House,"HOUSE JUDICIARY COMMITTEE: Rec. for pass. if am., ref. to Government Operations Committee",17,0,2,0,19
1950462,1549780,2025-04-16,House,"HOUSE GOVERNMENT OPERATIONS COMMITTEE: Rec. for pass; ref to Calendar & Rules Committee",13,0,0,0,13
1950485,1534401,2025-04-02,Senate,"SENATE STATE & LOCAL GOVERNMENT COMMITTEE: Recommended for passage with amendment/s, refer to Senate Finance, Ways, and Means Committee Ayes 9, Nays 0 PNV 0",9,0,0,0,9
1950485,1552699,2025-04-21,Senate,"SENATE FINANCE, WAYS AND MEANS COMMITTEE: Recommended for passage with amendment/s, refer to Senate Calendar Committee Ayes 10, Nays 0 PNV 0",10,0,0,0,10
1950507,1500167,2025-02-26,Senate,"SENATE HEALTH AND WELFARE COMMITTEE: Recommended for passage, refer to Senate Finance, Ways, and Means Committee",9,0,0,0,9
1950531,1515864,2025-03-12,House,"HOUSE FINANCE, WAYS, AND MEANS SUBCOMMITTEE: Rec for pass if am by s/c ref. to Finance, Ways, and Means Committee",13,0,0,0,13
1950531,1520315,2025-03-18,House,"HOUSE FINANCE, WAYS, AND MEANS COMMITTEE: Rec. for pass. if am., ref. to Calendar & Rules Committee",23,0,0,0,23
1950531,1525262,2025-03-24,House,"FLOOR VOTE: REGULAR CALENDAR AS AMENDED PASSAGE ON THIRD CONSIDERATION",94,0,0,0,94
1950531,1548022,2025-04-14,Senate,"FLOOR VOTE: Third Consideration",32,0,0,0,32
1950577,1532729,2025-04-01,House,"HOUSE CRIMINAL JUSTICE SUBCOMMITTEE: Rec for pass if am by s/c ref. to Judiciary Committee",6,1,1,0,8
1950650,1521747,2025-03-19,House,"HOUSE CITIES & COUNTIES SUBCOMMITTEE: Rec for pass if am by s/c ref. to State & Local Government Committee",7,0,0,0,7
1950650,1542688,2025-04-09,House,"HOUSE STATE & LOCAL GOVERNMENT COMMITTEE: Rec. for pass. if am., ref. to Finance, Ways, and Means Committee",20,0,0,0,20
1950650,1547076,2025-04-14,House,"HOUSE FINANCE, WAYS, AND MEANS SUBCOMMITTEE: Rec for pass if am by s/c ref. to Finance, Ways, and Means Committee",12,0,0,0,12
1950650,1548968,2025-04-15,House,"HOUSE FINANCE, WAYS, AND MEANS COMMITTEE: Rec. for pass. if am., ref. to Calendar & Rules Committee",25,0,0,0,25
1950673,1499889,2025-02-26,House,"HOUSE PUBLIC SERVICE SUBCOMMITTEE:",1,4,0,0,5
1950697,1519965,2025-03-18,Senate,"SENATE STATE & LOCAL GOVERNMENT COMMITTEE: Recommended for passage with amendment/s, refer to Senate Calendar Committee Ayes 9, Nays 0 PNV 0",9,0,0,0,9
1950697,1528219,2025-03-26,Senate,"FLOOR VOTE: as Amended Third Consideration",32,0,0,0,32
1950697,1553884,2025-04-21,House,"FLOOR VOTE: REGULAR CALENDAR PASSAGE ON THIRD CONSIDERATION",93,0,0,0,93
1950769,1521456,2025-03-19,Senate,"SENATE HEALTH AND WELFARE COMMITTEE: Recommended for passage with amendment/s, refer to Senate Calendar Committee Ayes 9, Nays 0 PNV 0",9,0,0,0,9
1950769,1528005,2025-03-26,Senate,"FLOOR VOTE: as Amended Third Consideration",32,0,0,0,32
1950769,1553583,2025-04-21,House,"FLOOR VOTE: REGULAR CALENDAR AS AMENDED PASSAGE ON THIRD CONSIDERATION",92,0,0,0,92
1950769,1556686,2025-04-22,Senate,"FLOOR VOTE: Motion to Concur House Amendment # 1",33,0,0,0,33
1950814,1530813,2025-03-31,Senate,"SENATE JUDICIARY COMMITTEE: Recommended for passage, refer to Senate Calendar Committee",6,2,0,0,8
1950814,1542654,2025-04-09,Senate,"FLOOR VOTE: Third Consideration",23,5,0,0,28
1950814,1550680,2025-04-16,House,"FLOOR VOTE: REGULAR CALENDAR PASSAGE ON THIRD CONSIDERATION",75,13,0,0,88
1950859,1494486,2025-02-19,Senate,"SENATE EDUCATION COMMITTEE: Recommended for passage, refer to Senate Calendar Committee",8,0,0,0,8
1950859,1497911,2025-02-24,Senate,"FLOOR VOTE: Motion to Adopt",33,0,0,0,33
1950870,1521559,2025-03-19,Senate,"SENATE ENERGY, AGRICULTURE AND NATURAL RESOURCES COMMITTEE: Recommended for passage with amendment/s, refer to Senate Finance, Ways & Means Committee Ayes 7, Nays 2 PNV 0",7,2,0,0,9
1950870,1541548,2025-04-09,Senate,"SENATE FINANCE, WAYS AND MEANS COMMITTEE: Recommended for passage with amendment/s, refer to Senate Calendar Committee Ayes 8, Nays 3 PNV 0",8,3,0,0,11
1950870,1548158,2025-04-14,Senate,"FLOOR VOTE: Motion to Table Amend# 3 by Senator Campbell Third Consideration",26,6,0,0,32
1950870,1548159,2025-04-14,Senate,"FLOOR VOTE: Motion to Table Amend# 4 by Senator Campbell Third Consideration",26,6,0,0,32
1950870,1548160,2025-04-14,Senate,"FLOOR VOTE: as Amended Third Consideration",25,6,0,0,31
1950870,1553646,2025-04-21,House,"FLOOR VOTE: REGULAR CALENDAR PASSAGE ON THIRD CONSIDERATION",71,21,1,0,93
1950879,1494550,2025-02-19,Senate,"SENATE EDUCATION COMMITTEE: Recommended for passage, refer to Senate Calendar Committee",8,0,0,0,8
1950879,1498168,2025-02-24,Senate,"FLOOR VOTE: Motion to Adopt",33,0,0,0,33
1950879,1550166,2025-04-16,House,"FLOOR VOTE: REGULAR CALENDAR PASSAGE ON THIRD CONSIDERATION",67,20,0,0,87
1950902,1516864,2025-03-12,Senate,"SENATE EDUCATION COMMITTEE: Recommended for passage with amendment/s, refer to Senate Calendar Committee Ayes 9, Nays 0 PNV 0",9,0,0,0,9
1950902,1519307,2025-03-17,Senate,"FLOOR VOTE: as Amended Third Consideration",31,1,0,0,32
1950902,1535882,2025-04-03,House,"FLOOR VOTE: REGULAR CALENDAR AS AMENDED PASSAGE ON THIRD CONSIDERATION",77,10,3,0,90
1950902,1544129,2025-04-10,Senate,"FLOOR VOTE: Motion to Concur House Amendment # 1",31,0,0,0,31
1950926,1520916,2025-03-19,Senate,"TRANSPORTATION AND SAFETY COMMITTEE: Recommended for passage with amendment/s, refer to Senate Calendar Committee Ayes 9, Nays 0 PNV 0",9,0,0,0,9
1950957,1505797,2025-03-04,Senate,"SENATE JUDICIARY COMMITTEE: Recommended for passage with amendment/s, refer to Senate Finance, Ways, and Means Committee Ayes 8, Nays 0 PNV 1",8,0,1,0,9
1950969,1507343,2025-03-05,Senate,"SENATE EDUCATION COMMITTEE: Recommended for passage with amendment/s, refer to Senate Calendar Committee Ayes 8, Nays 0 PNV 0",8,0,0,0,8
1950991,1498854,2025-02-25,Senate,"SENATE STATE & LOCAL GOVERNMENT COMMITTEE: Recommended for passage, refer to Senate Finance, Ways, and Means Committee",9,0,0,0,9
1951003,1494497,2025-02-19,Senate,"SENATE EDUCATION COMMITTEE: Recommended for passage, refer to Senate Finance, Ways, and Means Committee",8,0,0,0,8
1951011,1499804,2025-02-25,Senate,"SENATE JUDICIARY COMMITTEE: Recommended for passage with amendment/s, refer to Senate Finance, Ways, and Means Committee Ayes 7, Nays 2 PNV 0",7,2,0,0,9
1951025,1505638,2025-03-04,Senate,"SENATE JUDICIARY COMMITTEE: Recommended for passage, refer to Senate Finance, Ways, and Means Committee",7,0,2,0,9
1951025,1553013,2025-04-21,Senate,"SENATE FINANCE, WAYS AND MEANS COMMITTEE: Recommended for passage, refer to Senate Calendar Committee",10,0,0,0,10
1951035,1522357,2025-03-19,Senate,"SENATE EDUCATION COMMITTEE: Recommended for passage, refer to Senate Finance, Ways, and Means Committee",7,0,0,0,7
1951046,1552975,2025-04-21,Senate,"SENATE FINANCE, WAYS AND MEANS COMMITTEE: Recommended for passage, refer to Senate Calendar Committee",10,1,0,0,11
1951056,1494549,2025-02-19,Senate,"SENATE HEALTH AND WELFARE COMMITTEE: Recommended for passage, refer to Senate Calendar Committee",9,0,0,0,9
1951056,1497906,2025-02-24,Senate,"FLOOR VOTE: Motion to Adopt",33,0,0,0,33
1951056,1509668,2025-03-10,House,"FLOOR VOTE: REGULAR CALENDAR AS AMENDED PASSAGE ON THIRD CONSIDERATION",93,0,0,0,93
1951056,1523202,2025-03-20,Senate,"FLOOR VOTE: Motion to Concur House Amendment # 1",32,0,0,0,32
1951081,1494546,2025-02-19,Senate,"SENATE EDUCATION COMMITTEE: Recommended for passage, refer to Senate Finance, Ways, and Means Committee",8,0,0,0,8
1951112,1527211,2025-03-25,Senate,"SENATE COMMERCE AND LABOR COMMITTEE: Recommended for passage with amendment/s, refer to Senate Finance, Ways, and Means Committee Ayes 5, Nays 4 PNV 0",6,3,0,0,9
1951135,1527631,2025-03-26,Senate,"SENATE ENERGY, AGRICULTURE AND NATURAL RESOURCES COMMITTEE: Recommended for passage with amendment/s, refer to Senate Finance, Ways, and Means Committee Ayes 7, Nays 2 PNV 0",7,2,0,0,9
1951145,1541269,2025-04-08,Senate,"SENATE JUDICIARY COMMITTEE: Recommended for passage, refer to Senate Calendar Committee",6,2,0,0,8
1951145,1548004,2025-04-14,Senate,"FLOOR VOTE: Third Consideration",26,6,0,0,32
1951145,1550148,2025-04-16,House,"FLOOR VOTE: REGULAR CALENDAR PASSAGE ON THIRD CONSIDERATION",83,2,4,0,89
1951168,1493201,2025-02-18,Senate,"SENATE JUDICIARY COMMITTEE: Recommended for passage, refer to Senate Calendar Committee",7,2,0,0,9
1951168,1497748,2025-02-24,Senate,"FLOOR VOTE: Third Consideration",27,0,6,0,33
1951168,1550462,2025-04-16,House,"FLOOR VOTE: REGULAR CALENDAR AS AMENDED PASSAGE ON THIRD CONSIDERATION",88,0,0,0,88
1951168,1552470,2025-04-17,Senate,"FLOOR VOTE: Motion to Concur House Amendment # 1",32,0,1,0,33
1951189,1507415,2025-03-05,Senate,"SENATE EDUCATION COMMITTEE: Recommended for passage, refer to Senate Calendar Committee",8,0,0,0,8
1951189,1517376,2025-03-13,Senate,"FLOOR VOTE: Motion to Adopt",32,0,0,0,32
1951189,1528865,2025-03-27,House,"FLOOR VOTE: REGULAR CALENDAR LAY ON THE TABLE MOTION TO ADOPT AMENDMENT # 1 BY JOHNSON PASSAGE ON THIRD CONSIDERATION",74,22,0,0,96
1951189,1528866,2025-03-27,House,"FLOOR VOTE: REGULAR CALENDAR PASSAGE ON THIRD CONSIDERATION",73,22,1,0,96
1951201,1527224,2025-03-25,Senate,"SENATE COMMERCE AND LABOR COMMITTEE: Recommended for passage, refer to Senate Calendar Committee",8,1,0,0,9
1951201,1541742,2025-04-09,Senate,"FLOOR VOTE: Third Consideration",24,5,0,0,29
1951211,1494559,2025-02-19,Senate,"SENATE HEALTH AND WELFARE COMMITTEE: Recommended for passage, refer to Senate Calendar Committee",8,1,0,0,9
1951211,1497751,2025-02-24,Senate,"FLOOR VOTE: Third Consideration",26,6,0,0,32
1951211,1517367,2025-03-13,House,"FLOOR VOTE: REGULAR CALENDAR PASSAGE ON THIRD CONSIDERATION",70,19,0,0,89
1951211,1517368,2025-03-13,House,"FLOOR VOTE: REGULAR CALENDAR PREVIOUS QUESTION PASSAGE ON THIRD CONSIDERATION",68,21,0,0,89
1951222,1494648,2025-02-19,Senate,"SENATE EDUCATION COMMITTEE: Recommended for passage with amendment/s, refer to Senate Finance, Ways, and Means Committee Ayes 7, Nays 1 PNV 0",7,1,0,0,8
1951222,1552612,2025-04-21,Senate,"SENATE FINANCE, WAYS AND MEANS COMMITTEE: Recommended for passage with amendment/s, refer to Senate Calendar Committee Ayes 10, Nays 0 PNV 0",10,0,0,0,10
1951419,1499295,2025-02-25,House,"HOUSE ELECTIONS & CAMPAIGN FINANCE SUBCOMMITTEE: Rec. for pass by s/c ref. to State & Local Government Committee",7,0,0,0,7
1951419,1534205,2025-04-02,House,"HOUSE STATE & LOCAL GOVERNMENT COMMITTEE: Rec. for pass; ref to Finance, Ways, and Means Committee",22,1,0,0,23
1951419,1551864,2025-04-17,House,"HOUSE FINANCE, WAYS, AND MEANS SUBCOMMITTEE: Rec for pass if am by s/c ref. to Finance, Ways, and Means Committee",11,0,0,0,11
1951419,1553336,2025-04-17,House,"HOUSE FINANCE, WAYS, AND MEANS COMMITTEE: Rec. for pass. if am., ref. to Calendar & Rules Committee",27,0,1,0,28
1951419,1553337,2025-04-17,House,"HOUSE FINANCE, WAYS, AND MEANS COMMITTEE: Rec. for pass; ref to Calendar & Rules Committee",27,0,0,0,27
1951460,1483421,2025-02-05,House,"FLOOR VOTE: CONSENT CALENDAR PASSAGE ON THIRD CONSIDERATION",90,0,0,0,90
1951460,1490133,2025-02-13,Senate,"FLOOR VOTE: Motion to Adopt",31,0,0,0,31
1951490,1506264,2025-03-05,House,"HOUSE HIGHER EDUCATION SUBCOMMITTEE: Rec. for pass by s/c ref. to Education Committee",4,1,0,0,5
1951490,1532972,2025-04-01,House,"HOUSE EDUCATION COMMITTEE: Failed in Education Committee",8,8,1,0,17
1951507,1505859,2025-03-05,House,"INSURANCE SUBCOMMITTEE: Rec for pass if am by s/c ref. to Insurance Committee",5,0,0,0,5
1951507,1516517,2025-03-12,House,"HOUSE INSURANCE COMMITTEE: Rec. for pass. if am., ref. to Calendar & Rules Committee",17,0,0,0,17
1951580,1516725,2025-03-12,House,"HOUSE AGRICULTURE AND NATURAL RESOURCES SUBCOMMITTEE: Rec. for pass by s/c ref. to Agriculture & Natural Resources Committee",9,0,0,0,9
1951580,1526847,2025-03-25,House,"HOUSE AGRICULTURE & NATURAL RESOURCES COMMITTEE: Rec. for pass; ref to Calendar & Rules Committee",16,0,0,0,16
1951580,1538387,2025-04-07,House,"FLOOR VOTE: CONSENT CALENDAR PASSAGE ON THIRD CONSIDERATION",96,0,0,0,96
1951614,1504686,2025-03-04,House,"HOUSE CHILDREN AND FAMILY AFFAIRS SUBCOMMITTEE: Rec. for pass by s/c ref. to Judiciary Committee",6,0,1,0,7
1951614,1516432,2025-03-12,House,"HOUSE JUDICIARY COMMITTEE: Rec. for pass; ref to Finance, Ways, and Means Committee",20,0,0,0,20
1951614,1551608,2025-04-17,House,"HOUSE FINANCE, WAYS, AND MEANS SUBCOMMITTEE: Rec. for pass by s/c ref. to Finance, Ways, and Means Committee",11,0,0,0,11
1951614,1553548,2025-04-17,House,"HOUSE FINANCE, WAYS, AND MEANS COMMITTEE: Rec. for pass. if am., ref. to Calendar & Rules Committee",27,0,0,0,27
1951614,1553549,2025-04-17,House,"HOUSE FINANCE, WAYS, AND MEANS COMMITTEE: Rec. for pass; ref to Calendar & Rules Committee",27,0,0,0,27
1951614,1553550,2025-04-21,House,"FLOOR VOTE: REGULAR CALENDAR AS AMENDED PASSAGE ON THIRD CONSIDERATION",93,0,1,0,94
1951614,1556657,2025-04-22,Senate,"FLOOR VOTE: Third Consideration",32,0,0,0,32
1951641,1494544,2025-02-19,House,"HOUSE HEALTH SUBCOMMITTEE: Rec for pass if am by s/c ref. to Health Committee",9,0,0,0,9
1951641,1499281,2025-02-25,House,"HOUSE HEALTH COMMITTEE: Rec. for pass. if am., ref. to Government Operations Committee",15,3,1,0,19
1951641,1503167,2025-03-03,House,"HOUSE GOVERNMENT OPERATIONS COMMITTEE: Rec. for pass; ref to Calendar & Rules Committee",11,0,0,0,11
1951641,1509530,2025-03-10,House,"FLOOR VOTE: REGULAR CALENDAR AS AMENDED PASSAGE ON THIRD CONSIDERATION",89,2,1,0,92
1951641,1514696,2025-03-10,Senate,"FLOOR VOTE: Third Consideration",28,0,1,0,29
1951720,1498844,2025-02-25,House,"HOUSE TRANSPORTATION SUBCOMMITTEE: Rec. for pass by s/c ref. to Transportation Committee",8,0,0,0,8
1951734,1527679,2025-03-26,House,"HOUSE HEALTH SUBCOMMITTEE: Rec for pass if am by s/c ref. to Health Committee",6,2,1,0,9
1951734,1532466,2025-04-01,House,"HOUSE HEALTH COMMITTEE: Rec. for pass. if am., ref. to Government Operations Committee",12,8,2,0,22
1951734,1549759,2025-04-16,House,"HOUSE GOVERNMENT OPERATIONS COMMITTEE: Rec. for pass; ref to Calendar & Rules Committee",11,4,0,0,15
1951798,1528335,2025-03-26,House,"HOUSE CRIMINAL JUSTICE SUBCOMMITTEE: Rec for pass if am by s/c ref. to Judiciary Committee",9,0,0,0,9
1951813,1528490,2025-03-26,Senate,"SENATE EDUCATION COMMITTEE: Recommended for passage with amendment/s, refer to Senate Finance, Ways, and Means Committee Ayes 9, Nays 0 PNV 0",9,0,0,0,9
1951829,1506314,2025-03-05,Senate,"SENATE HEALTH AND WELFARE COMMITTEE: Recommended for passage with amendment/s, refer to Senate Finance, Ways, and Means Committee Ayes 9, Nays 0 PNV 0",9,0,0,0,9
1951847,1519826,2025-03-18,House,"HOUSE K-12 SUBCOMMITTEE: Rec for pass if am by s/c ref. to Education Committee",6,2,0,0,8
1951847,1535013,2025-04-02,House,"HOUSE EDUCATION COMMITTEE: Rec. for pass. if am., ref. to Finance, Ways, and Means Committee",15,4,0,0,19
1951847,1551869,2025-04-17,House,"HOUSE FINANCE, WAYS, AND MEANS SUBCOMMITTEE: Rec for pass if am by s/c ref. to Finance, Ways, and Means Committee",8,1,0,0,9
1951847,1551870,2025-04-17,House,"HOUSE FINANCE, WAYS, AND MEANS SUBCOMMITTEE: Rec. for pass by s/c ref. to Finance, Ways, and Means Committee",11,0,0,0,11
1951847,1553322,2025-04-17,House,"HOUSE FINANCE, WAYS, AND MEANS COMMITTEE: Rec. for pass. if am., ref. to Calendar & Rules Committee",16,5,0,0,21
1951856,1499042,2025-02-25,Senate,"SENATE COMMERCE AND LABOR COMMITTEE: Recommended for passage, refer to Senate Calendar Committee",8,0,0,0,8
1951856,1513884,2025-03-06,Senate,"FLOOR VOTE: Third Consideration",22,4,1,0,27
1951856,1519163,2025-03-17,House,"FLOOR VOTE: REGULAR CALENDAR PASSAGE ON THIRD CONSIDERATION",61,26,8,0,95
1951873,1505834,2025-03-04,Senate,"SENATE JUDICIARY COMMITTEE: Recommended for passage, refer to Senate Calendar Committee",8,0,0,0,8
1951873,1513210,2025-03-10,Senate,"FLOOR VOTE: Motion to Adopt",30,0,0,0,30
1951873,1518837,2025-03-17,House,"FLOOR VOTE: REGULAR CALENDAR AS AMENDED PASSAGE ON THIRD CONSIDERATION",92,0,1,0,93
1951873,1523198,2025-03-20,Senate,"FLOOR VOTE: Motion to Concur House Amendment # 1",31,0,0,0,31
1951946,1519572,2025-03-18,House,"HOUSE K-12 SUBCOMMITTEE: Rec for pass if am by s/c ref. to Education Committee",8,0,0,0,8
1951946,1534698,2025-04-02,House,"HOUSE EDUCATION COMMITTEE: Rec. for pass. if am., ref. to Government Operations Committee",15,3,0,0,18
1951946,1538415,2025-04-07,House,"HOUSE GOVERNMENT OPERATIONS COMMITTEE: Rec. for pass; ref to Finance, Ways, and Means Committee",13,0,1,0,14
1951946,1551860,2025-04-17,House,"HOUSE FINANCE, WAYS, AND MEANS SUBCOMMITTEE: Rec. for pass by s/c ref. to Finance, Ways, and Means Committee",11,0,0,0,11
1951946,1553277,2025-04-17,House,"HOUSE FINANCE, WAYS, AND MEANS COMMITTEE: Rec. for pass. if am., ref. to Calendar & Rules Committee",25,0,0,0,25
1951946,1553278,2025-04-17,House,"HOUSE FINANCE, WAYS, AND MEANS COMMITTEE: Rec. for pass; ref to Calendar & Rules Committee",27,0,0,0,27
1951982,1535935,2025-04-02,Senate,"SENATE JUDICIARY COMMITTEE: Recommended for passage, refer to Senate Finance, Ways, and Means Committee",9,0,0,0,9
1951982,1548999,2025-04-15,Senate,"SENATE FINANCE, WAYS AND MEANS COMMITTEE: Recommended for passage, refer to Senate Calendar Committee",10,0,0,0,10
1951996,1499286,2025-02-25,House,"HOUSE EDUCATION ADMINISTRATION SUBCOMMITTEE: Rec. for pass by s/c ref. to Education Committee",6,0,0,0,6
1951996,1526425,2025-03-25,House,"HOUSE EDUCATION COMMITTEE: Rec. for pass; ref to Calendar & Rules Committee",18,0,0,0,18
1951996,1531125,2025-03-31,House,"FLOOR VOTE: CONSENT CALENDAR PASSAGE ON THIRD CONSIDERATION",93,0,2,0,95
1952013,1504558,2025-03-04,House,"HOUSE EDUCATION ADMINISTRATION SUBCOMMITTEE: Rec for pass if am by s/c ref. to Education Committee",6,0,0,0,6
1952013,1519741,2025-03-18,House,"HOUSE EDUCATION COMMITTEE: Rec. for pass. if am., ref. to Finance, Ways, and Means Committee",18,0,0,0,18
1952013,1527642,2025-03-26,House,"HOUSE FINANCE, WAYS, AND MEANS SUBCOMMITTEE: Rec. for pass by s/c ref. to Finance, Ways, and Means Committee",12,0,0,0,12
1952013,1533046,2025-04-01,House,"HOUSE FINANCE, WAYS, AND MEANS COMMITTEE: Rec. for pass; ref to Calendar & Rules Committee",28,0,0,0,28
1952013,1538853,2025-04-07,House,"FLOOR VOTE: REGULAR CALENDAR AS AMENDED PASSAGE ON THIRD CONSIDERATION",94,0,0,0,94
1952013,1541478,2025-04-09,Senate,"FLOOR VOTE: Third Consideration",31,0,0,0,31
1952045,1498973,2025-02-25,Senate,"SENATE COMMERCE AND LABOR COMMITTEE: Recommended for passage, refer to Senate Calendar Committee",8,0,0,0,8
1952045,1513084,2025-03-03,Senate,"FLOOR VOTE: Motion to Adopt",32,0,0,0,32
1952054,1527576,2025-03-26,House,"HOUSE CRIMINAL JUSTICE SUBCOMMITTEE: Rec for pass if am by s/c ref. to Judiciary Committee",8,0,0,0,8
1952054,1534158,2025-04-02,House,"HOUSE JUDICIARY COMMITTEE: Rec. for pass. if am., ref. to Calendar & Rules Committee",18,0,0,0,18
1952054,1538393,2025-04-07,House,"FLOOR VOTE: REGULAR CALENDAR AS AMENDED PASSAGE ON THIRD CONSIDERATION",94,0,0,0,94
1952054,1553007,2025-04-21,Senate,"FLOOR VOTE: Re-Refer to Committee Third Consideration",23,9,0,0,32
1952059,1520903,2025-03-19,House,"HOUSE PUBLIC SERVICE SUBCOMMITTEE: Rec for pass if am by s/c ref. to State & Local Government Committee",6,0,0,0,6
1952059,1539981,2025-04-08,House,"HOUSE STATE & LOCAL GOVERNMENT COMMITTEE: Rec. for pass. if am., ref. to Government Operations Committee",22,0,0,0,22
1952059,1549828,2025-04-16,House,"HOUSE GOVERNMENT OPERATIONS COMMITTEE: Rec. for pass; ref to Finance, Ways, and Means Committee",13,0,0,0,13
1952069,1513890,2025-03-11,Senate,"SENATE COMMERCE AND LABOR COMMITTEE: Recommended for passage, refer to Senate Calendar Committee",8,0,0,0,8
1952069,1519299,2025-03-17,Senate,"FLOOR VOTE: Motion to Adopt",32,0,0,0,32
1952094,1495165,2025-02-19,House,"HOUSE BUSINESS AND UTILITIES SUBCOMMITTEE: Rec. for pass by s/c ref. to Commerce Committee",10,1,0,0,11
1952094,1506508,2025-03-05,House,"HOUSE COMMERCE COMMITTEE: Rec. for pass. if am., ref. to Government Operations Committee",21,0,0,0,21
1952094,1509226,2025-03-10,House,"HOUSE GOVERNMENT OPERATIONS COMMITTEE: Rec. for pass; ref to Finance, Ways, and Means Committee",11,1,0,0,12
1952094,1520861,2025-03-19,House,"HOUSE FINANCE, WAYS, AND MEANS SUBCOMMITTEE: Rec for pass if am by s/c ref. to Finance, Ways, and Means Committee",12,0,0,0,12
1952094,1526821,2025-03-25,House,"HOUSE FINANCE, WAYS, AND MEANS COMMITTEE: Rec. for pass. if am., ref. to Calendar & Rules Committee",23,0,0,0,23
1952094,1531067,2025-03-31,House,"FLOOR VOTE: REGULAR CALENDAR AS AMENDED PASSAGE ON THIRD CONSIDERATION",83,9,1,0,93
1952094,1550892,2025-04-16,Senate,"FLOOR VOTE: Third Consideration",28,4,0,0,32
1952117,1532281,2025-04-01,House,"HOUSE CRIMINAL JUSTICE SUBCOMMITTEE: Rec for pass if am by s/c ref. to Judiciary Committee",7,0,1,0,8
1952117,1540752,2025-04-08,House,"HOUSE JUDICIARY COMMITTEE: Rec. for pass. if am., ref. to Calendar & Rules Committee",19,2,1,0,22
1952142,1490160,2025-02-13,Senate,"FLOOR VOTE: Motion to Adopt",31,0,0,0,31
1952142,1497684,2025-02-24,House,"FLOOR VOTE: CONSENT CALENDAR PASSAGE ON THIRD CONSIDERATION",92,0,2,0,94
1952149,1519973,2025-03-18,House,"HOUSE EDUCATION ADMINISTRATION SUBCOMMITTEE: Rec for pass if am by s/c ref. to Education Committee",6,0,0,0,6
1952149,1534927,2025-04-02,House,"HOUSE EDUCATION COMMITTEE: Rec. for pass. if am., ref. to Calendar & Rules Committee",18,0,1,0,19
1952156,1516844,2025-03-12,Senate,"SENATE EDUCATION COMMITTEE: Recommended for passage with amendment/s, refer to Senate Finance, Ways, and Means Committee Ayes 9, Nays 0 PNV 0",9,0,0,0,9
1952165,1528126,2025-03-26,House,"HOUSE AGRICULTURE AND NATURAL RESOURCES SUBCOMMITTEE: Rec for pass if am by s/c ref. to Agriculture & Natural Resources Committee",8,0,0,0,8
1952165,1532142,2025-04-01,House,"HOUSE AGRICULTURE & NATURAL RESOURCES COMMITTEE: Rec. for pass. if am., ref. to Finance, Ways, and Means Committee",15,0,0,0,15
1952165,1551898,2025-04-17,House,"HOUSE FINANCE, WAYS, AND MEANS SUBCOMMITTEE: Rec. for pass by s/c ref. to Finance, Ways, and Means Committee",11,0,0,0,11
1952165,1553444,2025-04-17,House,"HOUSE FINANCE, WAYS, AND MEANS COMMITTEE: Rec. for pass; ref to Calendar & Rules Committee",27,0,0,0,27
1952191,1498974,2025-02-25,Senate,"SENATE COMMERCE AND LABOR COMMITTEE: Recommended for adoption by Senate Commerce and Labor Committee, refer Senate Calendar Committee",7,0,0,0,7
1952191,1514302,2025-03-03,Senate,"FLOOR VOTE: Motion to Adopt",32,0,0,0,32
1952210,1516309,2025-03-12,House,"HOUSE CITIES & COUNTIES SUBCOMMITTEE: Rec. for pass by s/c ref. to State & Local Government Committee",7,0,0,0,7
1952210,1541116,2025-04-08,House,"HOUSE STATE & LOCAL GOVERNMENT COMMITTEE: Rec. for pass; ref to Calendar & Rules Committee",19,0,2,0,21
1952226,1521719,2025-03-19,House,"HOUSE AGRICULTURE AND NATURAL RESOURCES SUBCOMMITTEE: Rec for pass if am by s/c ref. to Agriculture & Natural Resources Committee",8,0,0,0,8
1952226,1525861,2025-03-25,House,"HOUSE AGRICULTURE & NATURAL RESOURCES COMMITTEE: Rec. for pass. if am., ref. to Calendar & Rules Committee",16,0,0,0,16
1952226,1530950,2025-03-31,House,"FLOOR VOTE: REGULAR CALENDAR AS AMENDED PASSAGE ON THIRD CONSIDERATION",94,0,0,0,94
1952226,1539269,2025-04-07,Senate,"FLOOR VOTE: Third Consideration",32,0,0,0,32
1952235,1516012,2025-03-12,Senate,"TRANSPORTATION AND SAFETY COMMITTEE: Recommended for passage with amendment/s, refer to Senate Calendar Committee Ayes 9, Nays 0 PNV 0",9,0,0,0,9
1952235,1519306,2025-03-17,Senate,"FLOOR VOTE: as Amended Third Consideration",32,0,0,0,32
1952235,1553442,2025-04-21,House,"FLOOR VOTE: REGULAR CALENDAR PASSAGE ON THIRD CONSIDERATION",91,1,0,0,92
1952269,1532170,2025-04-01,House,"HOUSE CRIMINAL JUSTICE SUBCOMMITTEE: Def. to Summer Study in Criminal Justice Subcommittee",7,2,0,0,9
1952286,1494540,2025-02-19,House,"HOUSE AGRICULTURE AND NATURAL RESOURCES SUBCOMMITTEE: Rec. for pass by s/c ref. to Agriculture & Natural Resources Committee",7,0,0,0,7
1952286,1499034,2025-02-25,House,"HOUSE AGRICULTURE & NATURAL RESOURCES COMMITTEE: Rec. for pass; ref to Calendar & Rules Committee",13,0,2,0,15
1952286,1503810,2025-03-03,House,"FLOOR VOTE: CONSENT CALENDAR PASSAGE ON THIRD CONSIDERATION",89,0,0,0,89
1952328,1506551,2025-03-05,House,"HOUSE HEALTH SUBCOMMITTEE: Rec for pass if am by s/c ref. to Health Committee",8,0,0,0,8
1952328,1515307,2025-03-11,House,"HOUSE HEALTH COMMITTEE: Rec. for pass. if am., ref. to Calendar & Rules Committee",17,0,0,0,17
1952328,1518695,2025-03-17,House,"FLOOR VOTE: REGULAR CALENDAR AS AMENDED PASSAGE ON THIRD CONSIDERATION",93,0,0,0,93
1952328,1526295,2025-03-24,Senate,"FLOOR VOTE: Third Consideration",33,0,0,0,33
1952340,1525935,2025-03-25,House,"HOUSE K-12 SUBCOMMITTEE: Rec for pass if am by s/c ref. to Education Committee",6,1,0,0,7
1952349,1506592,2025-03-05,House,"HOUSE CIVIL JUSTICE SUBCOMMITTEE: Rec for pass if am by s/c ref. to Judiciary Committee",8,0,0,0,8
1952349,1521742,2025-03-19,House,"HOUSE JUDICIARY COMMITTEE: Rec. for pass. if am., ref. to Calendar & Rules Committee",21,0,0,0,21
1952354,1504248,2025-03-04,House,"HOUSE TENNCARE SUBCOMMITTEE: Rec. for pass by s/c ref. to Insurance Committee",7,0,0,0,7
1952354,1516501,2025-03-12,House,"HOUSE INSURANCE COMMITTEE: Rec. for pass. if am., ref. to Government Operations Committee",17,0,0,0,17
1952354,1524668,2025-03-24,House,"HOUSE GOVERNMENT OPERATIONS COMMITTEE: Rec. for pass; ref to Calendar & Rules Committee",14,0,0,0,14
1952363,1519615,2025-03-18,House,"HOUSE TRANSPORTATION SUBCOMMITTEE: Rec. for pass by s/c ref. to Transportation Committee",7,1,1,0,9
1952363,1525840,2025-03-25,House,"HOUSE TRANSPORTATION COMMITTEE: Rec. for pass; ref to Calendar & Rules Committee",16,3,0,0,19
1952363,1535748,2025-04-03,House,"FLOOR VOTE: REGULAR CALENDAR PASSAGE ON THIRD CONSIDERATION",68,21,0,0,89
1952363,1535749,2025-04-03,House,"FLOOR VOTE: REGULAR CALENDAR PREVIOUS QUESTION PASSAGE ON THIRD CONSIDERATION",68,21,0,0,89
1952363,1539300,2025-04-07,Senate,"FLOOR VOTE: Third Consideration",26,6,0,0,32
1952368,1506125,2025-03-05,House,"HOUSE BUSINESS AND UTILITIES SUBCOMMITTEE: Rec for pass if am by s/c ref. to Commerce Committee",8,1,0,0,9
1952368,1521521,2025-03-19,House,"HOUSE COMMERCE COMMITTEE: Rec. for pass. if am., ref. to Calendar & Rules Committee",22,1,0,0,23
1952372,1516863,2025-03-12,Senate,"SENATE EDUCATION COMMITTEE: Recommended for passage with amendment/s, refer to Senate Finance, Ways, and Means Committee Ayes 7, Nays 1 PNV 1",7,1,1,0,9
1952382,1520933,2025-03-19,House,"HOUSE CRIMINAL JUSTICE SUBCOMMITTEE: Rec for pass if am by s/c ref. to Judiciary Committee",6,2,0,0,8
1952382,1541923,2025-04-09,House,"HOUSE JUDICIARY COMMITTEE: Rec. for pass. if am., ref. to Finance, Ways, and Means Committee",14,5,0,0,19
1952393,1521892,2025-03-19,House,"HOUSE PUBLIC SERVICE SUBCOMMITTEE: Rec. for pass by s/c ref. to State & Local Government Committee",4,0,1,0,5
1952393,1528385,2025-03-26,House,"HOUSE STATE & LOCAL GOVERNMENT COMMITTEE: Rec. for pass; ref to Finance, Ways, and Means Committee",20,0,1,0,21
1952397,1519928,2025-03-18,House,"HOUSE DEPARTMENTS & AGENCIES SUBCOMMITTEE: Rec for pass if am by s/c ref. to State & Local Government Committee",6,1,1,0,8
1952410,1483339,2025-02-05,House,"FLOOR VOTE: CONSENT CALENDAR PASSAGE ON THIRD CONSIDERATION",90,0,0,0,90
1952410,1490392,2025-02-13,Senate,"FLOOR VOTE: Motion to Adopt",31,0,0,0,31
1952415,1506145,2025-03-05,House,"HOUSE PUBLIC SERVICE SUBCOMMITTEE: Rec for pass if am by s/c ref. to State & Local Government Committee",4,1,0,0,5
1952415,1516542,2025-03-12,House,"HOUSE STATE & LOCAL GOVERNMENT COMMITTEE: Rec. for pass. if am., ref. to Calendar & Rules Committee",16,6,0,0,22
1952415,1518929,2025-03-17,House,"FLOOR VOTE: REGULAR CALENDAR AS AMENDED MOTION TO ADOPT",78,14,0,0,92
1952415,1548969,2025-04-15,Senate,"SENATE FINANCE, WAYS AND MEANS COMMITTEE: Recommended for concurrence by Senate Finance, Ways, and Means Committee, refer Senate Calendar Committee",7,2,0,0,9
1952415,1553031,2025-04-21,Senate,"FLOOR VOTE: Motion to Concur",27,6,0,0,33
1952423,1513782,2025-03-11,House,"POPULATION HEALTH SUBCOMMITTEE: Rec for pass if am by s/c ref. to Health Committee",6,2,1,0,9
1952423,1520021,2025-03-18,House,"HOUSE HEALTH COMMITTEE: Rec. for pass. if am., ref. to Finance, Ways, and Means Committee",18,5,0,0,23
1952428,1528520,2025-03-26,Senate,"SENATE EDUCATION COMMITTEE: Recommended for passage with amendment/s, refer to Senate Finance, Ways, and Means Committee Ayes 8, Nays 1 PNV 0",8,1,0,0,9
1952428,1549741,2025-04-16,Senate,"SENATE FINANCE, WAYS AND MEANS COMMITTEE: Recommended for passage with amendment/s, refer to Senate Calendar Committee Ayes 9, Nays 2 PNV 0",9,2,0,0,11
1952428,1553980,2025-04-22,House,"FLOOR VOTE: REGULAR CALENDAR AS AMENDED PASSAGE ON THIRD CONSIDERATION",63,30,2,0,95
1952428,1553981,2025-04-22,House,"FLOOR VOTE: REGULAR CALENDAR MOTION TO CONSIDER AMENDMENT # 3 BY PARKINSON AS AMENDED PASSAGE ON THIRD CONSIDERATION",25,63,0,0,88
1952428,1553982,2025-04-22,House,"FLOOR VOTE: REGULAR CALENDAR MOTION TO CONSIDER AMENDMENT # 5 BY PARKINSON AS AMENDED PASSAGE ON THIRD CONSIDERATION",24,66,0,0,90
1952428,1553983,2025-04-22,House,"FLOOR VOTE: REGULAR CALENDAR MOTION TO CONSIDER AMENDMENT # 6 BY PARKINSON AS AMENDED PASSAGE ON THIRD CONSIDERATION",24,69,0,0,93
1952428,1553984,2025-04-22,House,"FLOOR VOTE: REGULAR CALENDAR MOTION TO CONSIDER AMENDMENT # 8 BY PARKINSON AS AMENDED PASSAGE ON THIRD CONSIDERATION",21,71,0,0,92
1952428,1556427,2025-04-22,Senate,"FLOOR VOTE: as Amended Third Consideration",27,6,0,0,33
1952436,1521878,2025-03-19,House,"HOUSE BANKING AND CONSUMER AFFAIRS SUBCOMMITTEE: Rec for pass if am by s/c ref. to Commerce Committee",7,0,0,0,7
1952436,1527405,2025-03-26,House,"HOUSE COMMERCE COMMITTEE: Rec. for pass. if am., ref. to Calendar & Rules Committee",22,0,0,0,22
1952436,1531690,2025-03-31,House,"FLOOR VOTE: REGULAR CALENDAR AS AMENDED PASSAGE ON THIRD CONSIDERATION",93,0,1,0,94
1952436,1543864,2025-04-10,Senate,"FLOOR VOTE: Third Consideration",31,1,0,0,32
1952443,1494521,2025-02-19,House,"HOUSE HEALTH SUBCOMMITTEE: Rec. for pass by s/c ref. to Health Committee",9,0,0,0,9
1952443,1504896,2025-03-04,House,"HOUSE HEALTH COMMITTEE: Rec. for pass; ref to Calendar & Rules Committee",17,0,0,0,17
1952456,1515928,2025-03-12,House,"HOUSE CRIMINAL JUSTICE SUBCOMMITTEE: Rec for pass if am by s/c ref. to Judiciary Committee",7,0,0,0,7
1952456,1539488,2025-04-08,House,"HOUSE JUDICIARY COMMITTEE: Rec. for pass. if am., ref. to Finance, Ways, and Means Committee",18,0,0,0,18
1952470,1500782,2025-02-26,House,"HOUSE BUSINESS AND UTILITIES SUBCOMMITTEE: Rec for pass if am by s/c ref. to Commerce Committee",10,1,0,0,11
1952470,1516017,2025-03-12,House,"HOUSE COMMERCE COMMITTEE: Rec. for pass. if am., ref. to Calendar & Rules Committee",20,0,2,0,22
1952479,1494668,2025-02-18,House,"HOUSE EDUCATION ADMINISTRATION SUBCOMMITTEE: Rec. for pass by s/c ref. to Education Committee",6,0,0,0,6
1952479,1534786,2025-04-02,House,"HOUSE EDUCATION COMMITTEE: Rec. for pass; ref to Calendar & Rules Committee",18,1,0,0,19
1952497,1516514,2025-03-12,House,"HOUSE CITIES & COUNTIES SUBCOMMITTEE: Rec. for pass by s/c ref. to State & Local Government Committee",5,0,0,0,5
1952497,1542943,2025-04-09,House,"HOUSE STATE & LOCAL GOVERNMENT COMMITTEE: Rec. for pass. if am., ref. to Calendar & Rules Committee",21,0,0,0,21
1952505,1513728,2025-03-11,House,"HOUSE TRANSPORTATION SUBCOMMITTEE: Rec for pass if am by s/c ref. to Transportation Committee",9,0,0,0,9
1952505,1519937,2025-03-18,House,"HOUSE TRANSPORTATION COMMITTEE: Rec. for pass. if am., ref. to Finance, Ways, and Means Committee",18,0,0,0,18
1952505,1551858,2025-04-17,House,"HOUSE FINANCE, WAYS, AND MEANS SUBCOMMITTEE: Rec. for pass by s/c ref. to Finance, Ways, and Means Committee",11,0,0,0,11
1952505,1553314,2025-04-17,House,"HOUSE FINANCE, WAYS, AND MEANS COMMITTEE: Rec. for pass; ref to Calendar & Rules Committee",27,0,0,0,27
1952511,1496314,2025-02-19,House,"HOUSE CITIES & COUNTIES SUBCOMMITTEE: Rec for pass if am by s/c ref. to State & Local Government Committee",7,0,0,0,7
1952511,1500084,2025-02-26,House,"HOUSE STATE & LOCAL GOVERNMENT COMMITTEE: Rec. for pass. if am., ref. to Finance, Ways, and Means Committee",18,1,0,0,19
1952511,1506346,2025-03-05,House,"HOUSE FINANCE, WAYS, AND MEANS SUBCOMMITTEE: Rec. for pass by s/c ref. to Finance, Ways, and Means Committee",13,0,0,0,13
1952511,1515008,2025-03-11,House,"HOUSE FINANCE, WAYS, AND MEANS COMMITTEE: Rec. for pass; ref to Calendar & Rules Committee",21,0,0,0,21
1952511,1518607,2025-03-17,House,"FLOOR VOTE: REGULAR CALENDAR AS AMENDED PASSAGE ON THIRD CONSIDERATION",85,8,1,0,94
1952511,1543505,2025-04-10,Senate,"FLOOR VOTE: Third Consideration",28,1,0,0,29
1952515,1500116,2025-02-26,House,"HOUSE CIVIL JUSTICE SUBCOMMITTEE: Rec. for pass by s/c ref. to Judiciary Committee",7,0,0,0,7
1952515,1516490,2025-03-12,House,"HOUSE JUDICIARY COMMITTEE: Rec. for pass; ref to Calendar & Rules Committee",20,0,0,0,20
1952515,1518979,2025-03-17,House,"FLOOR VOTE: CONSENT CALENDAR PASSAGE ON THIRD CONSIDERATION",92,0,1,0,93
1952515,1548558,2025-04-15,Senate,"SENATE FINANCE, WAYS AND MEANS COMMITTEE: Recommended for concurrence by Senate Finance, Ways, and Means Committee, refer Senate Calendar Committee",9,0,1,0,10
1952515,1552725,2025-04-21,Senate,"FLOOR VOTE: Motion to Concur",28,4,0,0,32
1952524,1515862,2025-03-12,House,"HOUSE PUBLIC SERVICE SUBCOMMITTEE: Failed in s/c Public Service Subcommittee of State & Local Government Committee",1,5,0,0,6
1952530,1527471,2025-03-26,House,"HOUSE CRIMINAL JUSTICE SUBCOMMITTEE: Failed in s/c Criminal Justice Subcommittee of Judiciary Committee",2,5,0,0,7
1952542,1532172,2025-04-01,House,"HOUSE CITIES & COUNTIES SUBCOMMITTEE: Rec for pass if am by s/c ref. to State & Local Government Committee",6,0,0,0,6
1952542,1540043,2025-04-08,House,"HOUSE STATE & LOCAL GOVERNMENT COMMITTEE: Rec. for pass. if am., ref. to Finance, Ways, and Means Committee",23,0,0,0,23
1952542,1551801,2025-04-17,House,"HOUSE FINANCE, WAYS, AND MEANS SUBCOMMITTEE: Rec. for pass by s/c ref. to Finance, Ways, and Means Committee",11,0,0,0,11
1952542,1553300,2025-04-17,House,"HOUSE FINANCE, WAYS, AND MEANS COMMITTEE: Rec. for pass; ref to Calendar & Rules Committee",27,0,0,0,27
1952542,1553301,2025-04-21,House,"FLOOR VOTE: REGULAR CALENDAR AS AMENDED PASSAGE ON THIRD CONSIDERATION",91,0,0,0,91
1952542,1556950,2025-04-22,Senate,"FLOOR VOTE: Third Consideration",33,0,0,0,33
1952560,1522328,2025-03-19,Senate,"SENATE EDUCATION COMMITTEE: Recommended for passage with amendment/s, refer to Senate Calendar Committee Ayes 8, Nays 0 PNV 0",8,0,0,0,8
1952560,1527944,2025-03-26,Senate,"FLOOR VOTE: as Amended Third Consideration",28,3,1,0,32
1952560,1548577,2025-04-15,House,"FLOOR VOTE: REGULAR CALENDAR AS AMENDED PASSAGE ON THIRD CONSIDERATION",93,0,0,0,93
1952560,1552404,2025-04-17,Senate,"FLOOR VOTE: Motion to Concur House Amendment # 1",30,0,3,0,33
1952575,1521803,2025-03-19,House,"HOUSE CITIES & COUNTIES SUBCOMMITTEE: Rec. for pass by s/c ref. to State & Local Government Committee",5,2,0,0,7
1952581,1515992,2025-03-11,Senate,"SENATE JUDICIARY COMMITTEE: Recommended for passage with amendment/s, refer to Senate Calendar Committee Ayes 8, Nays 0 PNV 1",8,0,1,0,9
1952581,1519643,2025-03-17,Senate,"FLOOR VOTE: as Amended Third Consideration",26,5,0,0,31
1952581,1544741,2025-04-10,House,"FLOOR VOTE: REGULAR CALENDAR AS AMENDED PASSAGE ON THIRD CONSIDERATION",78,15,1,0,94
1952581,1544742,2025-04-10,House,"FLOOR VOTE: REGULAR CALENDAR MOTION TO CONSIDER AMENDMENT # 3 BY PEARSON PASSAGE ON THIRD CONSIDERATION",19,74,0,0,93
1952581,1548080,2025-04-14,Senate,"FLOOR VOTE: Motion to Concur House Amendment # 2",25,6,0,0,31
1952593,1551587,2025-04-17,House,"HOUSE FINANCE, WAYS, AND MEANS SUBCOMMITTEE: Rec. for pass by s/c ref. to Finance, Ways, and Means Committee",11,0,0,0,11
1952593,1553513,2025-04-17,House,"HOUSE FINANCE, WAYS, AND MEANS COMMITTEE: Rec. for pass. if am., ref. to Calendar & Rules Committee",28,0,0,0,28
1952593,1553514,2025-04-17,House,"HOUSE FINANCE, WAYS, AND MEANS COMMITTEE: Rec. for pass; ref to Calendar & Rules Committee",27,0,0,0,27
1952593,1553515,2025-04-21,House,"FLOOR VOTE: REGULAR CALENDAR AS AMENDED PASSAGE ON THIRD CONSIDERATION",92,0,0,0,92
1952593,1556593,2025-04-22,Senate,"FLOOR VOTE: Third Consideration",33,0,0,0,33
1952599,1498785,2025-02-25,House,"HOUSE ELECTIONS & CAMPAIGN FINANCE SUBCOMMITTEE: Rec. for pass by s/c ref. to State & Local Government Committee",7,0,0,0,7
1952607,1504822,2025-03-04,Senate,"SENATE COMMERCE AND LABOR COMMITTEE: Recommended for passage with amendment/s, refer to Senate Calendar Committee Ayes 7, Nays 0 PNV 0",7,0,0,0,7
1952607,1513315,2025-03-10,Senate,"FLOOR VOTE: as Amended Third Consideration",28,1,0,0,29
1952607,1518860,2025-03-17,House,"FLOOR VOTE: REGULAR CALENDAR AS AMENDED PASSAGE ON THIRD CONSIDERATION",92,0,3,0,95
1952607,1522600,2025-03-20,Senate,"FLOOR VOTE: Motion to Concur House Amendment # 2",32,0,0,0,32
1952616,1506324,2025-03-05,House,"HOUSE HEALTH SUBCOMMITTEE: Rec. for pass by s/c ref. to Health Committee",8,0,0,0,8
1952616,1519844,2025-03-18,House,"HOUSE HEALTH COMMITTEE: Rec. for pass; ref to Government Operations Committee",20,0,0,0,20
1952616,1524801,2025-03-24,House,"HOUSE GOVERNMENT OPERATIONS COMMITTEE: Rec. for pass; ref to Finance, Ways, and Means Committee",14,0,0,0,14
1952616,1551902,2025-04-17,House,"HOUSE FINANCE, WAYS, AND MEANS SUBCOMMITTEE: Rec for pass if am by s/c ref. to Finance, Ways, and Means Committee",11,0,0,0,11
1952616,1553389,2025-04-17,House,"HOUSE FINANCE, WAYS, AND MEANS COMMITTEE: Rec. for pass. if am., ref. to Calendar & Rules Committee",27,0,0,0,27
1952616,1553390,2025-04-17,House,"HOUSE FINANCE, WAYS, AND MEANS COMMITTEE: Rec. for pass; ref to Calendar & Rules Committee",27,0,0,0,27
1952616,1553391,2025-04-21,House,"FLOOR VOTE: REGULAR CALENDAR AS AMENDED PASSAGE ON THIRD CONSIDERATION",94,0,0,0,94
1952616,1556468,2025-04-22,Senate,"FLOOR VOTE: Third Consideration",31,0,0,0,31
1952634,1521809,2025-03-19,House,"HOUSE CRIMINAL JUSTICE SUBCOMMITTEE: Rec for pass if am by s/c ref. to Judiciary Committee",9,0,0,0,9
1952634,1534414,2025-04-02,House,"HOUSE JUDICIARY COMMITTEE: Rec. for pass. if am., ref. to Finance, Ways, and Means Committee",17,0,0,0,17
1952648,1483581,2025-02-05,House,"FLOOR VOTE: CONSENT CALENDAR PASSAGE ON THIRD CONSIDERATION",90,0,0,0,90
1952648,1490362,2025-02-13,Senate,"FLOOR VOTE: Motion to Adopt",31,0,0,0,31
1952658,1485542,2025-02-05,House,"FLOOR VOTE: CONSENT CALENDAR PASSAGE ON THIRD CONSIDERATION",90,0,0,0,90
1952677,1519849,2025-03-18,House,"HOUSE TENNCARE SUBCOMMITTEE: Rec. for pass by s/c ref. to Insurance Committee",7,0,0,0,7
1952694,1534215,2025-04-02,House,"HOUSE CIVIL JUSTICE SUBCOMMITTEE: Rec. for pass by s/c ref. to Judiciary Committee",6,0,0,0,6
1952694,1540001,2025-04-08,House,"HOUSE JUDICIARY COMMITTEE: Rec. for pass; ref to Finance, Ways, and Means Committee",19,0,0,0,19
1952694,1551805,2025-04-17,House,"HOUSE FINANCE, WAYS, AND MEANS SUBCOMMITTEE: Rec. for pass by s/c ref. to Finance, Ways, and Means Committee",11,0,0,0,11
1952694,1553296,2025-04-17,House,"HOUSE FINANCE, WAYS, AND MEANS COMMITTEE: Rec. for pass; ref to Calendar & Rules Committee",27,0,0,0,27
1952708,1514139,2025-03-11,House,"HOUSE TRANSPORTATION SUBCOMMITTEE: Rec for pass if am by s/c ref. to Transportation Committee",9,0,0,0,9
1952708,1520295,2025-03-18,House,"HOUSE TRANSPORTATION COMMITTEE: Rec. for pass. if am., ref. to Calendar & Rules Committee",18,0,0,0,18
1952708,1528877,2025-03-27,House,"FLOOR VOTE: REGULAR CALENDAR AS AMENDED PASSAGE ON THIRD CONSIDERATION",96,0,0,0,96
1952708,1531800,2025-03-31,Senate,"FLOOR VOTE: Third Consideration",28,1,0,0,29
1952712,1483495,2025-02-05,House,"FLOOR VOTE: CONSENT CALENDAR PASSAGE ON THIRD CONSIDERATION",90,0,0,0,90
1952712,1490072,2025-02-13,Senate,"FLOOR VOTE: Motion to Adopt",31,0,0,0,31
1952752,1519811,2025-03-18,House,"HOUSE TENNCARE SUBCOMMITTEE: Rec. for pass by s/c ref. to Insurance Committee",4,0,0,0,4
1952752,1525977,2025-03-25,House,"HOUSE INSURANCE COMMITTEE: Rec. for pass; ref to Finance, Ways, and Means Committee",14,0,0,0,14
1952752,1534176,2025-04-02,House,"HOUSE FINANCE, WAYS, AND MEANS SUBCOMMITTEE: Rec. for pass by s/c ref. to Finance, Ways, and Means Committee",9,0,0,0,9
1952752,1540114,2025-04-08,House,"HOUSE FINANCE, WAYS, AND MEANS COMMITTEE: Rec. for pass; ref to Calendar & Rules Committee",25,0,0,0,25
1952752,1547747,2025-04-14,House,"FLOOR VOTE: CONSENT CALENDAR PASSAGE ON THIRD CONSIDERATION",94,0,1,0,95
1952785,1483439,2025-02-05,House,"FLOOR VOTE: CONSENT CALENDAR PASSAGE ON THIRD CONSIDERATION",90,0,0,0,90
1952785,1490164,2025-02-13,Senate,"FLOOR VOTE: Motion to Adopt",31,0,0,0,31
1952795,1505734,2025-03-05,House,"HOUSE CRIMINAL JUSTICE SUBCOMMITTEE: Rec for pass if am by s/c ref. to Judiciary Committee",7,0,1,0,8
1952795,1516372,2025-03-12,House,"HOUSE JUDICIARY COMMITTEE: Rec. for pass. if am., ref. to Calendar & Rules Committee",16,2,2,0,20
1952795,1518502,2025-03-17,House,"FLOOR VOTE: REGULAR CALENDAR AS AMENDED PASSAGE ON THIRD CONSIDERATION",89,3,2,0,94
1952795,1551049,2025-04-16,Senate,"FLOOR VOTE: as Amended Third Consideration",30,0,1,0,31
1952795,1553518,2025-04-21,House,"FLOOR VOTE: MESSAGE CALENDAR CONCUR IN SENATE AMENDMENT # 1",86,1,6,0,93
1952808,1516532,2025-03-12,House,"HOUSE STATE & LOCAL GOVERNMENT COMMITTEE: Rec. for pass. if am., ref. to Calendar & Rules Committee",20,3,0,0,23
1952808,1518973,2025-03-17,House,"FLOOR VOTE: REGULAR CALENDAR AS AMENDED PASSAGE ON THIRD CONSIDERATION",87,5,1,0,93
1952808,1543475,2025-04-10,Senate,"FLOOR VOTE: Third Consideration",32,0,0,0,32
1952812,1506262,2025-03-05,House,"HOUSE CIVIL JUSTICE SUBCOMMITTEE: Rec for pass if am by s/c ref. to Judiciary Committee",7,0,0,0,7
1952812,1515905,2025-03-12,House,"HOUSE JUDICIARY COMMITTEE: Rec. for pass. if am., ref. to Calendar & Rules Committee",21,0,0,0,21
1952812,1518536,2025-03-17,House,"FLOOR VOTE: REGULAR CALENDAR AS AMENDED PASSAGE ON THIRD CONSIDERATION",93,0,0,0,93
1952812,1528657,2025-03-27,Senate,"FLOOR VOTE: Third Consideration",31,0,0,0,31
1952840,1528122,2025-03-26,House,"HOUSE AGRICULTURE AND NATURAL RESOURCES SUBCOMMITTEE: Rec for pass if am by s/c ref. to Agriculture & Natural Resources Committee",7,1,1,0,9
1952840,1532224,2025-04-01,House,"HOUSE AGRICULTURE & NATURAL RESOURCES COMMITTEE: Rec. for pass. if am., ref. to Finance, Ways, and Means Committee",11,2,0,0,13
1953304,1513861,2025-03-11,Senate,"SENATE COMMERCE AND LABOR COMMITTEE: Recommended for passage, refer to Senate Calendar Committee",9,0,0,0,9
1953304,1519332,2025-03-17,Senate,"FLOOR VOTE: Motion to Adopt",32,0,0,0,32
1953307,1515849,2025-03-12,House,"HOUSE PUBLIC SERVICE SUBCOMMITTEE: Rec for pass if am by s/c ref. to State & Local Government Committee",6,0,0,0,6
1953307,1543116,2025-04-09,House,"HOUSE STATE & LOCAL GOVERNMENT COMMITTEE: Rec. for pass. if am., ref. to Finance, Ways, and Means Committee",21,1,1,0,23
1953307,1551965,2025-04-17,House,"HOUSE FINANCE, WAYS, AND MEANS SUBCOMMITTEE: Rec. for pass by s/c ref. to Finance, Ways, and Means Committee",11,0,0,0,11
1953307,1553565,2025-04-17,House,"HOUSE FINANCE, WAYS, AND MEANS COMMITTEE: Rec. for pass; ref to Calendar & Rules Committee",27,0,0,0,27
1953307,1553566,2025-04-21,House,"FLOOR VOTE: REGULAR CALENDAR AS AMENDED PASSAGE ON THIRD CONSIDERATION",84,2,5,0,91
1953307,1553567,2025-04-21,House,"FLOOR VOTE: REGULAR CALENDAR MOTION TO ADOPT AMENDMENT # 2 BY POWERS AS AMENDED PASSAGE ON THIRD CONSIDERATION",90,0,1,0,91
1953307,1553568,2025-04-21,House,"FLOOR VOTE: REGULAR CALENDAR MOTION TO CONSIDER AMENDMENT # 2 BY POWERS AS AMENDED PASSAGE ON THIRD CONSIDERATION",90,0,0,0,90
1953307,1553569,2025-04-22,Senate,"SENATE FINANCE, WAYS AND MEANS COMMITTEE: Recommended for passage, refer to Senate Calendar Committee",7,3,1,0,11
1953307,1556877,2025-04-22,Senate,"FLOOR VOTE: Third Consideration",23,8,1,0,32
1953317,1505512,2025-03-04,Senate,"SENATE COMMERCE AND LABOR COMMITTEE: Recommended for passage, refer to Senate Calendar Committee",7,0,0,0,7
1953317,1515381,2025-03-10,Senate,"FLOOR VOTE: Motion to Adopt",30,0,0,0,30
1953317,1550156,2025-04-16,House,"FLOOR VOTE: REGULAR CALENDAR PASSAGE ON THIRD CONSIDERATION",79,9,2,0,90
1953322,1500232,2025-02-26,Senate,"SENATE HEALTH AND WELFARE COMMITTEE: Recommended for passage with amendment/s, refer to Senate Finance, Ways, and Means Committee Ayes 9, Nays 0 PNV 0",9,0,0,0,9
1953322,1512618,2025-03-11,Senate,"SENATE FINANCE, WAYS AND MEANS COMMITTEE: Recommended for passage, refer to Senate Calendar Committee",10,0,0,0,10
1953322,1519303,2025-03-17,Senate,"FLOOR VOTE: as Amended Third Consideration",32,0,0,0,32
1953322,1550554,2025-04-16,House,"FLOOR VOTE: REGULAR CALENDAR PASSAGE ON THIRD CONSIDERATION",97,0,0,0,97
1953334,1500228,2025-02-26,Senate,"SENATE HEALTH AND WELFARE COMMITTEE: Recommended for passage, refer to Senate Finance, Ways, and Means Committee",9,0,0,0,9
1953350,1528239,2025-03-26,House,"HOUSE CRIMINAL JUSTICE SUBCOMMITTEE: Def. to Summer Study in Criminal Justice Subcommittee",7,0,0,0,7
1953375,1525910,2025-03-25,House,"HOUSE DEPARTMENTS & AGENCIES SUBCOMMITTEE: Rec. for pass by s/c ref. to State & Local Government Committee",8,0,0,0,8
1953375,1539911,2025-04-08,House,"HOUSE STATE & LOCAL GOVERNMENT COMMITTEE: Rec. for pass; ref to Calendar & Rules Committee",19,0,2,0,21
1953375,1547619,2025-04-14,House,"FLOOR VOTE: CONSENT CALENDAR PASSAGE ON THIRD CONSIDERATION",94,0,1,0,95
1953382,1500193,2025-02-26,Senate,"SENATE HEALTH AND WELFARE COMMITTEE: Recommended for passage, refer to Senate Calendar Committee",9,0,0,0,9
1953390,1522377,2025-03-19,Senate,"SENATE EDUCATION COMMITTEE: Recommended for passage, refer to Senate Calendar Committee",8,0,0,0,8
1953390,1525841,2025-03-24,Senate,"FLOOR VOTE: Motion to Adopt",32,0,0,0,32
1953403,1506378,2025-03-05,House,"HOUSE BANKING AND CONSUMER AFFAIRS SUBCOMMITTEE: Rec. for pass by s/c ref. to Commerce Committee",4,0,0,0,4
1953403,1515806,2025-03-12,House,"HOUSE COMMERCE COMMITTEE: Rec. for pass; ref to Calendar & Rules Committee",10,4,0,0,14
1953409,1532204,2025-04-01,House,"HOUSE CRIMINAL JUSTICE SUBCOMMITTEE: Rec. for pass by s/c ref. to Judiciary Committee",8,0,0,0,8
1953409,1541830,2025-04-09,House,"HOUSE JUDICIARY COMMITTEE: Rec. for pass; ref to Calendar & Rules Committee",21,0,0,0,21
1953409,1547632,2025-04-14,House,"FLOOR VOTE: CONSENT CALENDAR PASSAGE ON THIRD CONSIDERATION",94,0,1,0,95
1953433,1521880,2025-03-19,House,"HOUSE CITIES & COUNTIES SUBCOMMITTEE: Rec for pass if am by s/c ref. to State & Local Government Committee",5,2,0,0,7
1953433,1542939,2025-04-09,House,"HOUSE STATE & LOCAL GOVERNMENT COMMITTEE: Rec. for pass. if am., ref. to Finance, Ways, and Means Committee",15,7,0,0,22
1953433,1547123,2025-04-14,House,"HOUSE FINANCE, WAYS, AND MEANS SUBCOMMITTEE: Rec. for pass by s/c ref. to Finance, Ways, and Means Committee",12,0,0,0,12
1953433,1549014,2025-04-15,House,"HOUSE FINANCE, WAYS, AND MEANS COMMITTEE: Rec. for pass; ref to Calendar & Rules Committee",25,0,0,0,25
1953433,1550339,2025-04-16,House,"FLOOR VOTE: REGULAR CALENDAR AS AMENDED PASSAGE ON THIRD CONSIDERATION",80,8,4,0,92
1953433,1556416,2025-04-22,Senate,"FLOOR VOTE: Third Consideration",32,0,0,0,32
1953436,1514010,2025-03-11,House,"HOUSE CHILDREN AND FAMILY AFFAIRS SUBCOMMITTEE: Rec for pass if am by s/c ref. to Judiciary Committee",5,0,0,0,5
1953436,1534523,2025-04-02,House,"HOUSE JUDICIARY COMMITTEE: Rec. for pass. if am., ref. to Calendar & Rules Committee",16,0,1,0,17
1953440,1520807,2025-03-18,Senate,"SENATE COMMERCE AND LABOR COMMITTEE: Recommended for passage with amendment/s, refer to Senate Judiciary Committee Ayes 5, Nays 3 PNV 0",5,3,0,0,8
1953440,1536103,2025-04-02,Senate,"SENATE JUDICIARY COMMITTEE: Recommended for passage with amendment/s, refer to Senate Calendar Committee Ayes 5, Nays 4 PNV 0",5,4,0,0,9
1953452,1535268,2025-04-02,Senate,"SENATE STATE & LOCAL GOVERNMENT COMMITTEE: Recommended for passage with amendment/s, refer to Senate Finance, Ways, and Means Committee Ayes 9, Nays 0 PNV 0",9,0,0,0,9
1953452,1552980,2025-04-21,Senate,"SENATE FINANCE, WAYS AND MEANS COMMITTEE: Recommended for passage, refer to Senate Calendar Committee",10,0,0,0,10
1953464,1519798,2025-03-18,House,"HOUSE TENNCARE SUBCOMMITTEE: Rec. for pass by s/c ref. to Insurance Committee",4,0,0,0,4
1953464,1526477,2025-03-25,House,"HOUSE INSURANCE COMMITTEE: Rec. for pass; ref to Government Operations Committee",17,0,0,0,17
1953464,1531368,2025-03-31,House,"HOUSE GOVERNMENT OPERATIONS COMMITTEE: Rec. for pass; ref to Finance, Ways, and Means Committee",15,0,0,0,15
1953464,1551836,2025-04-17,House,"HOUSE FINANCE, WAYS, AND MEANS SUBCOMMITTEE: Rec. for pass by s/c ref. to Finance, Ways, and Means Committee",11,0,0,0,11
1953464,1553343,2025-04-17,House,"HOUSE FINANCE, WAYS, AND MEANS COMMITTEE: Rec. for pass; ref to Calendar & Rules Committee",27,0,0,0,27
1953464,1553344,2025-04-21,House,"FLOOR VOTE: CONSENT CALENDAR PASSAGE ON THIRD CONSIDERATION",86,0,1,0,87
1953464,1556972,2025-04-22,Senate,"FLOOR VOTE: Motion to Adopt",33,0,0,0,33
1953471,1521666,2025-03-19,House,"HOUSE CITIES & COUNTIES SUBCOMMITTEE: Rec. for pass by s/c ref. to State & Local Government Committee",4,3,0,0,7
1953480,1506656,2025-03-05,Senate,"TRANSPORTATION AND SAFETY COMMITTEE: Recommended for passage with amendment/s, refer to Senate Finance, Ways, and Means Committee Ayes 8, Nays 0 PNV 0",8,0,0,0,8
1953480,1540719,2025-04-08,Senate,"SENATE FINANCE, WAYS AND MEANS COMMITTEE: Recommended for passage, refer to Senate Calendar Committee",7,3,0,0,10
1953488,1526556,2025-03-25,Senate,"SENATE STATE & LOCAL GOVERNMENT COMMITTEE: Recommended for passage, refer to Senate Calendar Committee",9,0,0,0,9
1953488,1531956,2025-03-31,Senate,"FLOOR VOTE: Motion to Adopt",30,0,0,0,30
1953488,1550213,2025-04-16,House,"FLOOR VOTE: REGULAR CALENDAR AS AMENDED PASSAGE ON THIRD CONSIDERATION",92,1,1,0,94
1953488,1550214,2025-04-16,House,"FLOOR VOTE: REGULAR CALENDAR MOTION TO ADOPT AMENDMENT # 2 BY WRIGHT PASSAGE ON THIRD CONSIDERATION",94,0,0,0,94
1953488,1552972,2025-04-21,Senate,"FLOOR VOTE: Motion to Concur House Amendment # 2",33,0,0,0,33
1953494,1505856,2025-03-04,Senate,"SENATE JUDICIARY COMMITTEE: Recommended for passage with amendment/s, refer to Senate Calendar Committee Ayes 9, Nays 0 PNV 0",9,0,0,0,9
1953494,1513276,2025-03-10,Senate,"FLOOR VOTE: as Amended Third Consideration",29,0,0,0,29
1953494,1553582,2025-04-21,House,"FLOOR VOTE: REGULAR CALENDAR PASSAGE ON THIRD CONSIDERATION",90,3,1,0,94
1953498,1516484,2025-03-12,House,"HOUSE CITIES & COUNTIES SUBCOMMITTEE: Rec. for pass by s/c ref. to State & Local Government Committee",7,0,0,0,7
1953504,1516143,2025-03-12,House,"HOUSE CRIMINAL JUSTICE SUBCOMMITTEE: Rec for pass if am by s/c ref. to Judiciary Committee",6,0,0,0,6
1953504,1521633,2025-03-19,House,"HOUSE JUDICIARY COMMITTEE: Rec. for pass. if am., ref. to Finance, Ways, and Means Committee",21,0,0,0,21
1953504,1551747,2025-04-17,House,"HOUSE FINANCE, WAYS, AND MEANS SUBCOMMITTEE: Rec. for pass by s/c ref. to Finance, Ways, and Means Committee",11,0,0,0,11
1953504,1553253,2025-04-17,House,"HOUSE FINANCE, WAYS, AND MEANS COMMITTEE: Rec. for pass; ref to Calendar & Rules Committee",27,0,0,0,27
1953515,1524519,2025-03-18,Senate,"SENATE COMMERCE AND LABOR COMMITTEE: Failed in Senate Commerce and Labor Committee",4,4,0,0,8
1953531,1528528,2025-03-26,Senate,"SENATE EDUCATION COMMITTEE: Recommended for passage, refer to Senate Calendar Committee",9,0,0,0,9
1953531,1531816,2025-03-31,Senate,"FLOOR VOTE: Motion to Adopt",30,0,0,0,30
1953545,1515658,2025-03-11,Senate,"SENATE JUDICIARY COMMITTEE: Recommended for passage, refer to Senate Finance, Ways, and Means Committee",8,1,0,0,9
1953553,1521926,2025-03-19,House,"HOUSE BANKING AND CONSUMER AFFAIRS SUBCOMMITTEE: Rec. for pass by s/c ref. to Commerce Committee",7,0,0,0,7
1953553,1528134,2025-03-26,House,"HOUSE COMMERCE COMMITTEE: Rec. for pass; ref to Calendar & Rules Committee",19,3,0,0,22
1953576,1520769,2025-03-18,Senate,"SENATE COMMERCE AND LABOR COMMITTEE: Recommended for passage with amendment/s, refer to Senate State and Local Government Committee Ayes 8, Nays 0 PNV 0",8,0,0,0,8
1953576,1526563,2025-03-25,Senate,"SENATE STATE & LOCAL GOVERNMENT COMMITTEE: Recommended for passage, refer to Senate Finance, Ways, and Means Committee",9,0,0,0,9
1953580,1505704,2025-03-05,Senate,"TRANSPORTATION AND SAFETY COMMITTEE: Recommended for passage with amendment/s, refer to Senate Finance, Ways, and Means Committee Ayes 8, Nays 0 PNV 0",8,0,0,0,8
1953580,1540078,2025-04-08,Senate,"SENATE FINANCE, WAYS AND MEANS COMMITTEE: Recommended for passage, refer to Senate Calendar Committee",10,0,0,0,10
1953580,1547372,2025-04-14,House,"FLOOR VOTE: REGULAR CALENDAR PASSAGE ON THIRD CONSIDERATION",85,5,0,0,90
1953580,1548252,2025-04-14,Senate,"FLOOR VOTE: as Amended Third Consideration",30,1,0,0,31
1953588,1532879,2025-04-01,Senate,"SENATE STATE & LOCAL GOVERNMENT COMMITTEE: Failed in Senate State and Local Government Committee",2,6,0,0,8
1953597,1513353,2025-03-11,House,"HOUSE K-12 SUBCOMMITTEE: Rec. for pass by s/c ref. to Education Committee",5,3,0,0,8
1953597,1527985,2025-03-26,House,"HOUSE EDUCATION COMMITTEE: Rec. for pass; ref to Government Operations Committee",11,7,0,0,18
1953597,1538409,2025-04-07,House,"HOUSE GOVERNMENT OPERATIONS COMMITTEE: Rec. for pass; ref to Finance, Ways, and Means Committee",8,7,0,0,15
1953614,1515392,2025-03-11,Senate,"SENATE COMMERCE AND LABOR COMMITTEE: Recommended for passage, refer to Senate Calendar Committee",7,0,1,0,8
1953633,1505485,2025-03-04,Senate,"SENATE COMMERCE AND LABOR COMMITTEE: Recommended for passage, refer to Senate Calendar Committee",7,0,0,0,7
1953633,1513962,2025-03-10,Senate,"FLOOR VOTE: Motion to Adopt",30,0,0,0,30
1953633,1536603,2025-04-03,House,"FLOOR VOTE: REGULAR CALENDAR PASSAGE ON THIRD CONSIDERATION",48,27,14,0,89
1953633,1545040,2025-04-14,House,"HOUSE CALENDAR & RULES COMMITTEE: H. Placed on Regular Calendar for 4/14/2025 4/10/2025",17,3,0,0,20
1953645,1505798,2025-03-04,Senate,"SENATE JUDICIARY COMMITTEE: Recommended for passage with amendment/s, refer to Senate Calendar Committee Ayes 9, Nays 0 PNV 0",9,0,0,0,9
1953645,1513114,2025-03-10,Senate,"FLOOR VOTE: as Amended Third Consideration",29,0,0,0,29
1953645,1529240,2025-03-27,House,"FLOOR VOTE: REGULAR CALENDAR PASSAGE ON THIRD CONSIDERATION",94,0,1,0,95
1953659,1514491,2025-03-11,House,"HOUSE TRANSPORTATION SUBCOMMITTEE: Rec. for pass by s/c ref. to Transportation Committee",9,0,0,0,9
1953659,1520426,2025-03-18,House,"HOUSE TRANSPORTATION COMMITTEE: Rec. for pass; ref to Calendar & Rules Committee",17,0,1,0,18
1953659,1524975,2025-03-24,House,"FLOOR VOTE: CONSENT CALENDAR PASSAGE ON THIRD CONSIDERATION",96,0,0,0,96
1953663,1522307,2025-03-19,Senate,"SENATE EDUCATION COMMITTEE: Recommended for passage, refer to Senate Finance, Ways, and Means Committee",6,1,0,0,7
1953668,1520995,2025-03-19,Senate,"TRANSPORTATION AND SAFETY COMMITTEE: Recommended for passage, refer to Senate Calendar Committee",9,0,0,0,9
1953668,1526234,2025-03-24,Senate,"FLOOR VOTE: Motion to Adopt",32,0,0,0,32
1953673,1506511,2025-03-05,House,"HOUSE CIVIL JUSTICE SUBCOMMITTEE: Rec. for pass by s/c ref. to Judiciary Committee",8,0,0,0,8
1953673,1528348,2025-03-26,House,"HOUSE JUDICIARY COMMITTEE: Rec. for pass; ref to Calendar & Rules Committee",21,0,0,0,21
1953673,1531048,2025-03-31,House,"FLOOR VOTE: CONSENT CALENDAR PASSAGE ON THIRD CONSIDERATION",93,0,2,0,95
1953681,1499278,2025-02-25,Senate,"SENATE STATE & LOCAL GOVERNMENT COMMITTEE: Recommended for passage, refer to Senate Finance, Ways, and Means Committee",9,0,0,0,9
1953681,1539768,2025-04-08,Senate,"SENATE FINANCE, WAYS AND MEANS COMMITTEE: Recommended for passage, refer to Senate Calendar Committee",9,0,0,0,9
1953681,1548141,2025-04-14,Senate,"FLOOR VOTE: Motion to Adopt",32,0,0,0,32
1953689,1528108,2025-03-26,Senate,"SENATE HEALTH AND WELFARE COMMITTEE: Recommended for passage with amendment/s, refer to Senate Calendar Committee Ayes 8, Nays 1 PNV 0",8,1,0,0,9
1953694,1516450,2025-03-12,House,"HOUSE CITIES & COUNTIES SUBCOMMITTEE: Rec. for pass by s/c ref. to State & Local Government Committee",7,0,0,0,7
1953705,1519366,2025-03-18,House,"HOUSE K-12 SUBCOMMITTEE: Rec. for pass by s/c ref. to Education Committee",8,0,0,0,8
1953705,1526486,2025-03-25,House,"HOUSE EDUCATION COMMITTEE: Rec. for pass; ref to Finance, Ways, and Means Committee",14,2,2,0,18
1953705,1534209,2025-04-02,House,"HOUSE FINANCE, WAYS, AND MEANS SUBCOMMITTEE: Rec. for pass by s/c ref. to Finance, Ways, and Means Committee",8,0,0,0,8
1953705,1539991,2025-04-08,House,"HOUSE FINANCE, WAYS, AND MEANS COMMITTEE: Rec. for pass; ref to Calendar & Rules Committee",27,0,0,0,27
1953705,1547659,2025-04-14,House,"FLOOR VOTE: CONSENT CALENDAR PASSAGE ON THIRD CONSIDERATION",94,0,1,0,95
1953716,1520767,2025-03-18,Senate,"SENATE JUDICIARY COMMITTEE: Recommended for passage, refer to Senate Calendar Committee",9,0,0,0,9
1953716,1525799,2025-03-24,Senate,"FLOOR VOTE: Motion to Adopt",32,0,0,0,32
1953725,1527031,2025-03-25,House,"HOUSE CRIMINAL JUSTICE SUBCOMMITTEE: Rec for pass if am by s/c ref. to Judiciary Committee",7,0,1,0,8
1953725,1542676,2025-04-09,House,"HOUSE JUDICIARY COMMITTEE: Rec. for pass. if am., ref. to Calendar & Rules Committee",14,1,1,0,16
1953752,1494639,2025-02-19,House,"HOUSE HEALTH SUBCOMMITTEE: Rec. for pass by s/c ref. to Health Committee",9,0,0,0,9
1953752,1498896,2025-02-25,House,"HOUSE HEALTH COMMITTEE: Rec. for pass. if am., ref. to Education Committee",21,0,0,0,21
1953752,1504907,2025-03-04,House,"HOUSE EDUCATION COMMITTEE: Rec. for pass; ref to Government Operations Committee",16,0,0,0,16
1953752,1509099,2025-03-10,House,"HOUSE GOVERNMENT OPERATIONS COMMITTEE: Rec. for pass; ref to Finance, Ways, and Means Committee",13,0,0,0,13
1953752,1521032,2025-03-19,House,"HOUSE FINANCE, WAYS, AND MEANS SUBCOMMITTEE: Rec. for pass by s/c ref. to Finance, Ways, and Means Committee",12,0,0,0,12
1953752,1526831,2025-03-25,House,"HOUSE FINANCE, WAYS, AND MEANS COMMITTEE: Rec. for pass; ref to Calendar & Rules Committee",22,0,0,0,22
1953752,1531036,2025-03-31,House,"FLOOR VOTE: REGULAR CALENDAR AS AMENDED PASSAGE ON THIRD CONSIDERATION",93,0,1,0,94
1953752,1541539,2025-04-09,Senate,"FLOOR VOTE: as Amended Third Consideration",28,0,0,0,28
1953752,1547482,2025-04-14,House,"FLOOR VOTE: MESSAGE CALENDAR CONCUR IN SENATE AMENDMENTS",92,0,0,0,92
1953755,1526273,2025-03-25,Senate,"SENATE JUDICIARY COMMITTEE: Recommended for passage with amendment/s, refer to Senate Finance, Ways, and Means Committee Ayes 9, Nays 0 PNV 0",9,0,0,0,9
1953760,1521905,2025-03-19,Senate,"SENATE ENERGY, AGRICULTURE AND NATURAL RESOURCES COMMITTEE: Recommended for passage, refer to Senate Finance, Ways, and Means Committee",9,0,0,0,9
1953766,1498935,2025-02-25,Senate,"SENATE COMMERCE AND LABOR COMMITTEE: Recommended for passage with amendment/s, refer to Senate Finance, Ways, and Means Committee Ayes 7, Nays 1 PNV 0",7,1,0,0,8
1953766,1525928,2025-03-25,Senate,"SENATE FINANCE, WAYS AND MEANS COMMITTEE: Recommended for passage with amendment/s, refer to Senate Calendar Committee Ayes 9, Nays 2 PNV 0",9,2,0,0,11
1953766,1531899,2025-03-31,Senate,"FLOOR VOTE: as Amended Third Consideration",24,4,1,0,29
1953766,1550617,2025-04-16,House,"FLOOR VOTE: REGULAR CALENDAR AS AMENDED PASSAGE ON THIRD CONSIDERATION",87,4,4,0,95
1953766,1550618,2025-04-16,House,"FLOOR VOTE: REGULAR CALENDAR MOTION TO ADOPT AMENDMENT # 4 BY HICKS G PASSAGE ON THIRD CONSIDERATION",89,0,2,0,91
1953766,1552391,2025-04-17,Senate,"FLOOR VOTE: Motion to Concur House Amendment # 4",28,3,1,0,32
1953774,1506289,2025-03-05,Senate,"SENATE ENERGY, AGRICULTURE AND NATURAL RESOURCES COMMITTEE: Recommended for passage, refer to Senate Calendar Committee",9,0,0,0,9
1953785,1551570,2025-04-17,House,"HOUSE FINANCE, WAYS, AND MEANS SUBCOMMITTEE: Rec. for pass by s/c ref. to Finance, Ways, and Means Committee",11,0,0,0,11
1953785,1552734,2025-04-21,Senate,"FLOOR VOTE: Third Consideration",32,0,0,0,32
1953785,1553542,2025-04-17,House,"HOUSE FINANCE, WAYS, AND MEANS COMMITTEE: Rec. for pass; ref to Calendar & Rules Committee",27,0,0,0,27
1953785,1553543,2025-04-21,House,"FLOOR VOTE: REGULAR CALENDAR PASSAGE ON THIRD CONSIDERATION",92,2,0,0,94
1953792,1521937,2025-03-19,Senate,"SENATE ENERGY, AGRICULTURE AND NATURAL RESOURCES COMMITTEE: Recommended for passage with amendment/s, refer to Senate Calendar Committee Ayes 9, Nays 0 PNV 0",9,0,0,0,9
1953792,1528893,2025-03-27,Senate,"FLOOR VOTE: as Amended Third Consideration",31,0,0,0,31
1953792,1538344,2025-04-07,House,"FLOOR VOTE: REGULAR CALENDAR PASSAGE ON THIRD CONSIDERATION",94,1,0,0,95
1953815,1516470,2025-03-12,House,"HOUSE CITIES & COUNTIES SUBCOMMITTEE: Rec. for pass by s/c ref. to State & Local Government Committee",6,0,0,0,6
1953815,1540279,2025-04-08,House,"HOUSE STATE & LOCAL GOVERNMENT COMMITTEE: Rec. for pass; ref to Calendar & Rules Committee",19,0,2,0,21
1953815,1547845,2025-04-14,House,"FLOOR VOTE: CONSENT CALENDAR PASSAGE ON THIRD CONSIDERATION",94,0,1,0,95
1953848,1506005,2025-03-05,House,"HOUSE CRIMINAL JUSTICE SUBCOMMITTEE: Rec. for pass by s/c ref. to Judiciary Committee",7,0,2,0,9
1953848,1528086,2025-03-26,House,"HOUSE JUDICIARY COMMITTEE: Rec. for pass; ref to Finance, Ways, and Means Committee",16,5,0,0,21
1953848,1551797,2025-04-17,House,"HOUSE FINANCE, WAYS, AND MEANS SUBCOMMITTEE: Rec. for pass by s/c ref. to Finance, Ways, and Means Committee",11,0,0,0,11
1953848,1553294,2025-04-17,House,"HOUSE FINANCE, WAYS, AND MEANS COMMITTEE: Rec. for pass; ref to Calendar & Rules Committee",27,0,0,0,27
1953848,1553295,2025-04-17,House,"HOUSE FINANCE, WAYS, AND MEANS COMMITTEE: Rec. for pass; ref to Calendar & Rules Committee",27,0,0,0,27
1953867,1534443,2025-04-02,Senate,"SENATE STATE & LOCAL GOVERNMENT COMMITTEE: Recommended for passage with amendment/s, refer to Senate Calendar Committee Ayes 9, Nays 0 PNV 0",9,0,0,0,9
1953880,1514985,2025-03-11,House,"HOUSE EDUCATION ADMINISTRATION SUBCOMMITTEE: Rec. for pass by s/c ref. to Education Committee",6,0,0,0,6
1953880,1534809,2025-04-02,House,"HOUSE EDUCATION COMMITTEE: Rec. for pass. if am., ref. to Calendar & Rules Committee",18,0,0,0,18
1953884,1552933,2025-04-21,Senate,"SENATE FINANCE, WAYS AND MEANS COMMITTEE: Recommended for passage with amendment/s, refer to Senate Calendar Committee Ayes 11, Nays 0 PNV 0",11,0,0,0,11
1953893,1506290,2025-03-05,House,"HOUSE BUSINESS AND UTILITIES SUBCOMMITTEE: Rec. for pass by s/c ref. to Commerce Committee",10,0,0,0,10
1953893,1516246,2025-03-12,House,"HOUSE COMMERCE COMMITTEE: Rec. for pass; ref to Calendar & Rules Committee",22,0,0,0,22
1953893,1518719,2025-03-17,House,"FLOOR VOTE: CONSENT CALENDAR PASSAGE ON THIRD CONSIDERATION",92,0,1,0,93
1953905,1483483,2025-02-06,House,"FLOOR VOTE: CONSENT CALENDAR PASSAGE ON THIRD CONSIDERATION",89,0,0,0,89
1953905,1490494,2025-02-13,Senate,"FLOOR VOTE: Motion to Adopt",31,0,0,0,31
1953910,1504527,2025-03-04,House,"HOUSE TRANSPORTATION SUBCOMMITTEE: Failed in s/c Transportation Subcommittee of Transportation Committee",0,9,0,0,9
1953918,1527832,2025-03-26,House,"HOUSE AGRICULTURE AND NATURAL RESOURCES SUBCOMMITTEE: Failed in s/c Agriculture and Natural Resources Subcommittee of Agriculture & Natural Resources Committee",3,6,0,0,9
1953923,1528059,2025-03-26,Senate,"SENATE ENERGY, AGRICULTURE AND NATURAL RESOURCES COMMITTEE: Recommended for passage with amendment/s, refer to Senate Calendar Committee Ayes 9, Nays 0 PNV 0",9,0,0,0,9
1953923,1552785,2025-04-21,Senate,"SENATE FINANCE, WAYS AND MEANS COMMITTEE: Recommended for passage, refer to Senate Calendar Committee",10,0,0,0,10
1953927,1533943,2025-04-01,Senate,"SENATE JUDICIARY COMMITTEE: Recommended for passage with amendment/s, refer to Senate Calendar Committee Ayes 5, Nays 2 PNV 0",5,2,0,0,7
1953927,1541502,2025-04-09,Senate,"FLOOR VOTE: as Amended Third Consideration",26,5,0,0,31
1953927,1548654,2025-04-15,House,"FLOOR VOTE: REGULAR CALENDAR PASSAGE ON THIRD CONSIDERATION",75,20,0,0,95
1953927,1548655,2025-04-15,House,"FLOOR VOTE: REGULAR CALENDAR PREVIOUS QUESTION PASSAGE ON THIRD CONSIDERATION",73,19,0,0,92
1953934,1499447,2025-02-25,Senate,"SENATE STATE & LOCAL GOVERNMENT COMMITTEE: Recommended for passage, refer to Senate Finance, Ways, and Means Committee",9,0,0,0,9
1953934,1514623,2025-03-11,Senate,"SENATE FINANCE, WAYS AND MEANS COMMITTEE: Recommended for passage, refer to Senate Calendar Committee",11,0,0,0,11
1953934,1519674,2025-03-17,Senate,"FLOOR VOTE: Third Consideration",31,0,0,0,31
1953934,1524981,2025-03-24,House,"FLOOR VOTE: REGULAR CALENDAR PASSAGE ON THIRD CONSIDERATION",58,22,9,0,89
1953939,1500066,2025-02-26,House,"HOUSE CRIMINAL JUSTICE SUBCOMMITTEE: Rec for pass if am by s/c ref. to Judiciary Committee",9,0,0,0,9
1953939,1516472,2025-03-12,House,"HOUSE JUDICIARY COMMITTEE: Rec. for pass. if am., ref. to Calendar & Rules Committee",20,0,0,0,20
1953945,1528378,2025-03-26,House,"HOUSE AGRICULTURE AND NATURAL RESOURCES SUBCOMMITTEE: Rec for pass if am by s/c ref. to Agriculture & Natural Resources Committee",9,0,0,0,9
1953945,1532100,2025-04-01,House,"HOUSE AGRICULTURE & NATURAL RESOURCES COMMITTEE: Rec. for pass; ref to Government Operations Committee",15,0,0,0,15
1953945,1549987,2025-04-16,House,"HOUSE GOVERNMENT OPERATIONS COMMITTEE: Rec. for pass; ref to Finance, Ways, and Means Committee",11,0,0,0,11
1953945,1552000,2025-04-17,House,"HOUSE FINANCE, WAYS, AND MEANS SUBCOMMITTEE: Rec. for pass by s/c ref. to Finance, Ways, and Means Committee",11,0,0,0,11
1953945,1553722,2025-04-17,House,"HOUSE FINANCE, WAYS, AND MEANS COMMITTEE: Rec. for pass; ref to Calendar & Rules Committee",27,0,0,0,27
1953992,1494553,2025-02-19,Senate,"SENATE EDUCATION COMMITTEE: Recommended for passage with amendment/s, refer to Senate Calendar Committee Ayes 9, Nays 0 PNV 0",9,0,0,0,9
1954003,1483595,2025-02-06,House,"FLOOR VOTE: CONSENT CALENDAR PASSAGE ON THIRD CONSIDERATION",89,0,0,0,89
1954003,1490084,2025-02-13,Senate,"FLOOR VOTE: Motion to Adopt",31,0,0,0,31
1954015,1528486,2025-03-26,Senate,"SENATE EDUCATION COMMITTEE: Recommended for passage with amendment/s, refer to Senate Calendar Committee Ayes 9, Nays 0 PNV 0",9,0,0,0,9
1954035,1483645,2025-02-06,House,"FLOOR VOTE: CONSENT CALENDAR PASSAGE ON THIRD CONSIDERATION",89,0,0,0,89
1954035,1490425,2025-02-13,Senate,"FLOOR VOTE: Motion to Adopt",31,0,0,0,31
1954043,1499559,2025-02-25,Senate,"SENATE STATE & LOCAL GOVERNMENT COMMITTEE: Recommended for passage, refer to Senate Calendar Committee",9,0,0,0,9
1954043,1514863,2025-02-27,Senate,"FLOOR VOTE: Motion to Adopt",32,0,0,0,32
1954055,1521408,2025-03-19,House,"HOUSE CITIES & COUNTIES SUBCOMMITTEE: Rec for pass if am by s/c ref. to State & Local Government Committee",7,0,0,0,7
1954055,1527918,2025-03-26,House,"HOUSE STATE & LOCAL GOVERNMENT COMMITTEE: Rec. for pass. if am., ref. to Calendar & Rules Committee",20,0,0,0,20
1954055,1531365,2025-03-31,House,"FLOOR VOTE: REGULAR CALENDAR AS AMENDED PASSAGE ON THIRD CONSIDERATION",90,0,0,0,90
1954055,1549510,2025-04-15,Senate,"FLOOR VOTE: Third Consideration",32,0,0,0,32
1954069,1527620,2025-03-26,House,"HOUSE CIVIL JUSTICE SUBCOMMITTEE: Rec for pass if am by s/c ref. to Judiciary Committee",6,0,0,0,6
1954069,1534145,2025-04-02,House,"HOUSE JUDICIARY COMMITTEE: Rec. for pass. if am., ref. to Calendar & Rules Committee",19,0,0,0,19
1954069,1538404,2025-04-07,House,"FLOOR VOTE: REGULAR CALENDAR AS AMENDED PASSAGE ON THIRD CONSIDERATION",92,0,0,0,92
1954069,1544037,2025-04-10,Senate,"FLOOR VOTE: as Amended Third Consideration",30,1,0,0,31
1954069,1549061,2025-04-15,House,"FLOOR VOTE: MESSAGE CALENDAR CONCUR IN SENATE AMENDMENTS",83,5,2,0,90
1954076,1522046,2025-03-19,Senate,"SENATE HEALTH AND WELFARE COMMITTEE: Recommended for passage with amendment/s, refer to Senate Calendar Committee Ayes 9, Nays 0 PNV 0",9,0,0,0,9
1954088,1505873,2025-03-05,House,"HOUSE CRIMINAL JUSTICE SUBCOMMITTEE: Rec. for pass by s/c ref. to Judiciary Committee",9,0,0,0,9
1954088,1516481,2025-03-12,House,"HOUSE JUDICIARY COMMITTEE: Rec. for pass; ref to Calendar & Rules Committee",20,0,0,0,20
1954088,1525017,2025-03-24,House,"FLOOR VOTE: CONSENT CALENDAR PASSAGE ON THIRD CONSIDERATION",96,0,0,0,96
1954104,1483186,2025-02-06,House,"FLOOR VOTE: CONSENT CALENDAR PASSAGE ON THIRD CONSIDERATION",89,0,0,0,89
1954104,1490234,2025-02-13,Senate,"FLOOR VOTE: Motion to Adopt",31,0,0,0,31
1954109,1516868,2025-03-12,Senate,"SENATE EDUCATION COMMITTEE: Recommended for passage, refer to Senate Finance, Ways, and Means Committee",7,0,1,0,8
1954115,1534194,2025-04-02,Senate,"SENATE STATE & LOCAL GOVERNMENT COMMITTEE: Recommended for passage with amendment, refer to Senate Calendar Committee",8,1,0,0,9
1954115,1541950,2025-04-09,Senate,"FLOOR VOTE: as Amended Third Consideration",27,3,1,0,31
1954115,1547660,2025-04-14,House,"FLOOR VOTE: REGULAR CALENDAR PASSAGE ON THIRD CONSIDERATION",60,25,2,0,87
1954123,1506327,2025-03-05,House,"HOUSE PUBLIC SERVICE SUBCOMMITTEE: Rec. for pass by s/c ref. to State & Local Government Committee",6,0,0,0,6
1954123,1516202,2025-03-12,House,"HOUSE STATE & LOCAL GOVERNMENT COMMITTEE: Rec. for pass; ref to Finance, Ways, and Means Committee",23,0,0,0,23
1954123,1552015,2025-04-17,House,"HOUSE FINANCE, WAYS, AND MEANS SUBCOMMITTEE: Rec. for pass by s/c ref. to Finance, Ways, and Means Committee",11,0,0,0,11
1954123,1553769,2025-04-17,House,"HOUSE FINANCE, WAYS, AND MEANS COMMITTEE: Rec. for pass; ref to Calendar & Rules Committee",27,0,0,0,27
1954130,1521039,2025-03-19,House,"INSURANCE SUBCOMMITTEE: Rec for pass if am by s/c ref. to Insurance Committee",6,0,0,0,6
1954130,1526439,2025-03-25,House,"HOUSE INSURANCE COMMITTEE: Rec. for pass. if am., ref. to Calendar & Rules Committee",18,0,0,0,18
1954130,1531080,2025-03-31,House,"FLOOR VOTE: REGULAR CALENDAR AS AMENDED PASSAGE ON THIRD CONSIDERATION",94,0,0,0,94
1954130,1550907,2025-04-16,Senate,"FLOOR VOTE: as Amended Third Consideration",33,0,0,0,33
1954130,1553345,2025-04-21,House,"FLOOR VOTE: MESSAGE CALENDAR CONCUR IN SENATE AMENDMENT # 1",92,0,1,0,93
1954152,1521904,2025-03-19,House,"HOUSE PUBLIC SERVICE SUBCOMMITTEE: Rec for pass if am by s/c ref. to State & Local Government Committee",6,0,0,0,6
1954152,1542555,2025-04-09,House,"HOUSE STATE & LOCAL GOVERNMENT COMMITTEE: Rec. for pass; ref to Calendar & Rules Committee",19,0,0,0,19
1954187,1494584,2025-02-18,House,"HOUSE EDUCATION ADMINISTRATION SUBCOMMITTEE: Rec. for pass by s/c ref. to Education Committee",6,0,0,0,6
1954187,1513940,2025-03-11,House,"HOUSE EDUCATION COMMITTEE: Rec. for pass. if am., ref. to Calendar & Rules Committee",16,0,2,0,18
1954187,1528954,2025-03-27,House,"FLOOR VOTE: REGULAR CALENDAR AS AMENDED PASSAGE ON THIRD CONSIDERATION",92,1,2,0,95
1954187,1528955,2025-03-27,Senate,"FLOOR VOTE: Third Consideration",31,0,0,0,31
1954208,1512493,2025-03-11,House,"HOUSE TENNCARE SUBCOMMITTEE: Rec. for pass by s/c ref. to Insurance Committee",7,0,0,0,7
1954208,1526482,2025-03-25,House,"HOUSE INSURANCE COMMITTEE: Rec. for pass. if am., ref. to Government Operations Committee",18,0,0,0,18
1954208,1549733,2025-04-16,House,"HOUSE GOVERNMENT OPERATIONS COMMITTEE: Rec. for pass; ref to Finance, Ways, and Means Committee",15,0,0,0,15
1954214,1494604,2025-02-19,House,"HOUSE CITIES & COUNTIES SUBCOMMITTEE: Rec. for pass by s/c ref. to State & Local Government Committee",7,0,0,0,7
1954214,1500243,2025-02-26,House,"HOUSE STATE & LOCAL GOVERNMENT COMMITTEE: Rec. for pass; ref to Finance, Ways, and Means Committee",17,3,1,0,21
1954214,1516285,2025-03-12,House,"HOUSE FINANCE, WAYS, AND MEANS SUBCOMMITTEE: Rec. for pass by s/c ref. to Finance, Ways, and Means Committee",9,0,0,0,9
1954214,1520242,2025-03-18,House,"HOUSE FINANCE, WAYS, AND MEANS COMMITTEE: Rec. for pass; ref to Calendar & Rules Committee",17,0,3,0,20
1954221,1535186,2025-04-02,Senate,"SENATE STATE & LOCAL GOVERNMENT COMMITTEE: Recommended for passage, refer to Senate Finance, Ways, and Means Committee",9,0,0,0,9
1954227,1499367,2025-02-25,House,"HOUSE TRANSPORTATION SUBCOMMITTEE: Rec for pass if am by s/c ref. to Transportation Committee",9,0,0,0,9
1954233,1515939,2025-03-11,Senate,"SENATE STATE & LOCAL GOVERNMENT COMMITTEE: Recommended for passage with amendment, refer to Senate Energy, Ag., and Nat. Resources Committee",8,0,0,0,8
1954233,1528396,2025-03-26,Senate,"SENATE ENERGY, AGRICULTURE AND NATURAL RESOURCES COMMITTEE: Recommended for passage, refer to Senate Finance, Ways, and Means Committee",7,2,0,0,9
1954233,1549316,2025-04-15,Senate,"SENATE FINANCE, WAYS AND MEANS COMMITTEE: Recommended for passage with amendment/s, refer to Senate Calendar Committee Ayes 10, Nays 0 PNV 0",10,0,0,0,10
1954233,1553069,2025-04-21,Senate,"FLOOR VOTE: as Amended Third Consideration",28,3,1,0,32
1954233,1554143,2025-04-21,House,"FLOOR VOTE: REGULAR CALENDAR PASSAGE ON THIRD CONSIDERATION",81,3,5,0,89
1954255,1483741,2025-02-06,House,"FLOOR VOTE: CONSENT CALENDAR PASSAGE ON THIRD CONSIDERATION",89,0,0,0,89
1954255,1489988,2025-02-13,Senate,"FLOOR VOTE: Motion to Adopt",31,0,0,0,31
1954263,1515964,2025-03-11,Senate,"SENATE STATE & LOCAL GOVERNMENT COMMITTEE: Recommended for passage, refer to Senate Finance, Ways, and Means Committee",7,1,0,0,8
1954277,1498897,2025-02-25,Senate,"SENATE STATE & LOCAL GOVERNMENT COMMITTEE: Recommended for passage, refer to Senate Calendar Committee",9,0,0,0,9
1954277,1513337,2025-02-27,Senate,"FLOOR VOTE: Third Consideration",31,0,0,0,31
1954283,1490564,2025-02-13,Senate,"FLOOR VOTE: Motion to Adopt",31,0,0,0,31
1954283,1498045,2025-02-24,House,"FLOOR VOTE: CONSENT CALENDAR PASSAGE ON THIRD CONSIDERATION",92,0,2,0,94
1954292,1483228,2025-02-06,House,"FLOOR VOTE: CONSENT CALENDAR PASSAGE ON THIRD CONSIDERATION",89,0,0,0,89
1954292,1490334,2025-02-13,Senate,"FLOOR VOTE: Motion to Adopt",31,0,0,0,31
1954299,1507237,2025-03-05,Senate,"SENATE EDUCATION COMMITTEE: Recommended for passage with amendment/s, refer to Senate Finance, Ways, and Means Committee Ayes 9, Nays 0 PNV 0",9,0,0,0,9
1954299,1532327,2025-04-01,Senate,"SENATE FINANCE, WAYS AND MEANS COMMITTEE: Recommended for passage, refer to Senate Calendar Committee",10,0,0,0,10
1954319,1483642,2025-02-06,House,"FLOOR VOTE: CONSENT CALENDAR PASSAGE ON THIRD CONSIDERATION",89,0,0,0,89
1954319,1490228,2025-02-13,Senate,"FLOOR VOTE: Motion to Adopt",31,0,0,0,31
1954336,1494644,2025-02-18,House,"HOUSE DEPARTMENTS & AGENCIES SUBCOMMITTEE: Rec. for pass by s/c ref. to State & Local Government Committee",5,0,0,0,5
1954336,1500179,2025-02-26,House,"HOUSE STATE & LOCAL GOVERNMENT COMMITTEE: Rec. for pass. if am., ref. to Finance, Ways, and Means Committee",19,0,2,0,21
1954336,1506249,2025-03-05,House,"HOUSE FINANCE, WAYS, AND MEANS SUBCOMMITTEE: Rec. for pass by s/c ref. to Finance, Ways, and Means Committee",7,1,1,0,9
1954336,1515180,2025-03-11,House,"HOUSE FINANCE, WAYS, AND MEANS COMMITTEE: Rec. for pass. if am., ref. to Calendar & Rules Committee",14,2,4,0,20
1954342,1522331,2025-03-19,Senate,"SENATE EDUCATION COMMITTEE: Failed in Senate Education Committee",4,4,0,0,8
1954349,1516418,2025-03-12,House,"HOUSE CITIES & COUNTIES SUBCOMMITTEE: Rec for pass if am by s/c ref. to State & Local Government Committee",7,0,0,0,7
1954349,1521813,2025-03-19,House,"HOUSE STATE & LOCAL GOVERNMENT COMMITTEE: Rec. for pass. if am., ref. to Calendar & Rules Committee",18,0,1,0,19
1954349,1525281,2025-03-24,House,"FLOOR VOTE: REGULAR CALENDAR AS AMENDED PASSAGE ON THIRD CONSIDERATION",81,10,0,0,91
1954349,1525907,2025-03-24,Senate,"FLOOR VOTE: Third Consideration",32,0,0,0,32
1954357,1513616,2025-03-11,House,"HOUSE EDUCATION INSTRUCTION SUBCOMMITTEE: Rec. for pass by s/c ref. to Education Committee",5,0,1,0,6
1954357,1519877,2025-03-18,House,"HOUSE EDUCATION COMMITTEE: Rec. for pass. if am., ref. to Calendar & Rules Committee",16,0,1,0,17
1954357,1528873,2025-03-27,House,"FLOOR VOTE: REGULAR CALENDAR AS AMENDED PASSAGE ON THIRD CONSIDERATION",88,4,3,0,95
1954357,1536242,2025-04-03,Senate,"FLOOR VOTE: Third Consideration",26,0,0,0,26
1954377,1495142,2025-02-19,House,"HOUSE BANKING AND CONSUMER AFFAIRS SUBCOMMITTEE: Rec for pass if am by s/c ref. to Commerce Committee",5,0,0,0,5
1954377,1500162,2025-02-26,House,"HOUSE COMMERCE COMMITTEE: Rec. for pass. if am., ref. to Calendar & Rules Committee",20,0,0,0,20
1954377,1503984,2025-03-03,House,"FLOOR VOTE: REGULAR CALENDAR AS AMENDED PASSAGE ON THIRD CONSIDERATION",89,1,0,0,90
1954377,1513887,2025-03-10,Senate,"FLOOR VOTE: Third Consideration",29,0,0,0,29
1954398,1527696,2025-03-26,House,"HOUSE CRIMINAL JUSTICE SUBCOMMITTEE: Rec. for pass by s/c ref. to Judiciary Committee",7,2,0,0,9
1954411,1516858,2025-03-12,Senate,"SENATE EDUCATION COMMITTEE: Recommended for passage with amendment/s, refer to Senate Calendar Committee Ayes 7, Nays 1 PNV 0",7,1,0,0,8
1954411,1522793,2025-03-20,Senate,"FLOOR VOTE: as Amended Third Consideration",26,5,0,0,31
1954411,1550686,2025-04-16,House,"FLOOR VOTE: REGULAR CALENDAR PASSAGE ON THIRD CONSIDERATION",75,14,2,0,91
1954418,1534394,2025-04-02,Senate,"SENATE STATE & LOCAL GOVERNMENT COMMITTEE: Failed in Senate State and Local Government Committee",4,2,2,0,8
1954418,1541511,2025-04-09,Senate,"SENATE STATE & LOCAL GOVERNMENT COMMITTEE: Recommended for passage with amendment/s, refer to Senate Calendar Committee Ayes 5, Nays 1 PNV 0",5,1,0,0,6
1954424,1519605,2025-03-18,House,"HOUSE DEPARTMENTS & AGENCIES SUBCOMMITTEE: Rec for pass if am by s/c ref. to State & Local Government Committee",8,0,0,0,8
1954424,1540092,2025-04-08,House,"HOUSE STATE & LOCAL GOVERNMENT COMMITTEE: Rec. for pass. if am., ref. to Calendar & Rules Committee",18,5,0,0,23
1954462,1483691,2025-02-06,House,"FLOOR VOTE: CONSENT CALENDAR PASSAGE ON THIRD CONSIDERATION",89,0,0,0,89
1954462,1490475,2025-02-13,Senate,"FLOOR VOTE: Motion to Adopt",31,0,0,0,31
1954481,1500581,2025-02-26,House,"HOUSE PUBLIC SERVICE SUBCOMMITTEE: Rec. for pass by s/c ref. to State & Local Government Committee",4,1,0,0,5
1954481,1506582,2025-03-05,House,"HOUSE STATE & LOCAL GOVERNMENT COMMITTEE: Rec. for pass; ref to Calendar & Rules Committee",17,1,2,0,20
1954481,1525199,2025-03-24,House,"FLOOR VOTE: REGULAR CALENDAR PASSAGE ON THIRD CONSIDERATION",86,6,1,0,93
1954481,1542524,2025-04-09,Senate,"FLOOR VOTE: Third Consideration",25,1,1,0,27
1954492,1529042,2025-03-27,House,"FLOOR VOTE: MOTION TO SUSPEND THE RULES",71,22,0,0,93
1954492,1534267,2025-04-02,House,"HOUSE CIVIL JUSTICE SUBCOMMITTEE: Rec for pass if am by s/c ref. to Judiciary Committee",5,1,0,0,6
1954492,1541955,2025-04-09,House,"HOUSE JUDICIARY COMMITTEE: Rec. for pass. if am., ref. to Calendar & Rules Committee",15,6,0,0,21
1954516,1527478,2025-03-26,House,"HOUSE HEALTH SUBCOMMITTEE: Rec. for pass by s/c ref. to Health Committee",5,1,3,0,9
1954529,1507281,2025-03-05,Senate,"SENATE EDUCATION COMMITTEE: Recommended for passage with amendment/s, refer to Senate Finance, Ways, and Means Committee Ayes 5, Nays 4 PNV 0",5,4,0,0,9
1954529,1532069,2025-04-01,Senate,"SENATE FINANCE, WAYS AND MEANS COMMITTEE: Recommended for passage with amendment/s, refer to Senate Calendar Committee Ayes 7, Nays 4 PNV 0",7,4,0,0,11
1954529,1543619,2025-04-10,Senate,"FLOOR VOTE: as Amended Third Consideration",19,13,0,0,32
1954541,1513938,2025-03-11,Senate,"SENATE COMMERCE AND LABOR COMMITTEE: Recommended for passage with amendment/s, refer to Senate Calendar Committee Ayes 8, Nays 0 PNV 0",8,0,0,0,8
1954541,1519328,2025-03-17,Senate,"FLOOR VOTE: as Amended Third Consideration",32,0,0,0,32
1954541,1531476,2025-03-31,House,"FLOOR VOTE: REGULAR CALENDAR PASSAGE ON THIRD CONSIDERATION",94,0,0,0,94
1954557,1483746,2025-02-06,House,"FLOOR VOTE: CONSENT CALENDAR PASSAGE ON THIRD CONSIDERATION",89,0,0,0,89
1954557,1490237,2025-02-13,Senate,"FLOOR VOTE: Motion to Adopt",31,0,0,0,31
1954571,1521931,2025-03-19,House,"HOUSE CITIES & COUNTIES SUBCOMMITTEE: Rec for pass if am by s/c ref. to State & Local Government Committee",7,0,0,0,7
1954571,1543124,2025-04-09,House,"HOUSE STATE & LOCAL GOVERNMENT COMMITTEE: Rec. for pass. if am., ref. to Finance, Ways, and Means Committee",20,0,1,0,21
1954571,1551878,2025-04-17,House,"HOUSE FINANCE, WAYS, AND MEANS SUBCOMMITTEE: Rec. for pass by s/c ref. to Finance, Ways, and Means Committee",11,0,0,0,11
1954571,1553471,2025-04-17,House,"HOUSE FINANCE, WAYS, AND MEANS COMMITTEE: Rec. for pass; ref to Calendar & Rules Committee",27,0,0,0,27
1954580,1532693,2025-04-01,Senate,"SENATE STATE & LOCAL GOVERNMENT COMMITTEE: Recommended for passage, refer to Senate Calendar Committee",5,1,1,0,7
1954580,1543605,2025-04-10,Senate,"FLOOR VOTE: Third Consideration",31,0,0,0,31
1954586,1527428,2025-03-26,House,"HOUSE HEALTH SUBCOMMITTEE: Rec for pass if am by s/c ref. to Health Committee",9,0,0,0,9
1954586,1533111,2025-04-01,House,"HOUSE HEALTH COMMITTEE: Rec. for pass. if am., ref. to Government Operations Committee",23,0,0,0,23
1954586,1549795,2025-04-16,House,"HOUSE GOVERNMENT OPERATIONS COMMITTEE: Rec. for pass; ref to Calendar & Rules Committee",15,0,0,0,15
1954592,1504690,2025-03-04,House,"HOUSE TRANSPORTATION SUBCOMMITTEE: Rec for pass if am by s/c ref. to Transportation Committee",9,0,0,0,9
1954592,1513460,2025-03-11,House,"HOUSE TRANSPORTATION COMMITTEE: Rec. for pass. if am., ref. to Finance, Ways, and Means Committee",18,0,0,0,18
1954592,1534223,2025-04-02,House,"HOUSE FINANCE, WAYS, AND MEANS SUBCOMMITTEE: Rec. for pass by s/c ref. to Finance, Ways, and Means Committee",8,0,0,0,8
1954592,1539955,2025-04-08,House,"HOUSE FINANCE, WAYS, AND MEANS COMMITTEE: Rec. for pass; ref to Calendar & Rules Committee",28,0,0,0,28
1954600,1515842,2025-03-12,House,"HOUSE HEALTH SUBCOMMITTEE: Rec for pass if am by s/c ref. to Health Committee",9,0,0,0,9
1954600,1526627,2025-03-25,House,"HOUSE HEALTH COMMITTEE: Rec. for pass. if am., ref. to Calendar & Rules Committee",22,0,1,0,23
1954606,1521771,2025-03-19,House,"HOUSE HEALTH SUBCOMMITTEE: Rec for pass if am by s/c ref. to Health Committee",7,0,1,0,8
1954606,1533789,2025-04-01,House,"HOUSE HEALTH COMMITTEE: Rec. for pass. if am., ref. to Insurance Committee",22,0,0,0,22
1954606,1539623,2025-04-08,House,"HOUSE INSURANCE COMMITTEE: Rec. for pass; ref to Calendar & Rules Committee",14,0,0,0,14
1954614,1516404,2025-03-12,House,"HOUSE AGRICULTURE AND NATURAL RESOURCES SUBCOMMITTEE: Rec. for pass by s/c ref. to Agriculture & Natural Resources Committee",6,2,1,0,9
1954614,1519385,2025-03-18,House,"HOUSE AGRICULTURE & NATURAL RESOURCES COMMITTEE: Rec. for pass; ref to Judiciary Committee",12,4,0,0,16
1954628,1509212,2025-03-10,House,"FLOOR VOTE: MOTION TO SUSPEND THE RULES",67,22,0,0,89
1954628,1516064,2025-03-12,House,"HOUSE AGRICULTURE AND NATURAL RESOURCES SUBCOMMITTEE: Rec for pass if am by s/c ref. to Agriculture & Natural Resources Committee",8,0,0,0,8
1954628,1532276,2025-04-01,House,"HOUSE AGRICULTURE & NATURAL RESOURCES COMMITTEE: Rec. for pass. if am., ref. to Government Operations Committee",13,0,1,0,14
1954628,1549757,2025-04-16,House,"HOUSE GOVERNMENT OPERATIONS COMMITTEE: Rec. for pass; ref to Calendar & Rules Committee",11,0,0,0,11
1954636,1519407,2025-03-18,House,"HOUSE TENNCARE SUBCOMMITTEE: Rec for pass if am by s/c ref. to Insurance Committee",4,0,0,0,4
1954636,1525933,2025-03-25,House,"HOUSE INSURANCE COMMITTEE: Rec. for pass. if am., ref. to Finance, Ways, and Means Committee",13,0,0,0,13
1954636,1534180,2025-04-02,House,"HOUSE FINANCE, WAYS, AND MEANS SUBCOMMITTEE: Rec. for pass by s/c ref. to Finance, Ways, and Means Committee",8,0,0,0,8
1954636,1540121,2025-04-08,House,"HOUSE FINANCE, WAYS, AND MEANS COMMITTEE: Rec. for pass; ref to Calendar & Rules Committee",24,0,0,0,24
1954648,1506581,2025-03-19,House,"HOUSE PUBLIC SERVICE SUBCOMMITTEE: Action Def. in s/c Public Service Subcommittee to 3/19/2025 3/5/2025",5,1,0,0,6
1954648,1521284,2025-03-19,House,"HOUSE PUBLIC SERVICE SUBCOMMITTEE: Failed in s/c Public Service Subcommittee of State & Local Government Committee",3,3,0,0,6
1954655,1495158,2025-02-19,House,"HOUSE BUSINESS AND UTILITIES SUBCOMMITTEE: Rec. for pass by s/c ref. to Commerce Committee",8,0,1,0,9
1954655,1499873,2025-02-26,House,"HOUSE COMMERCE COMMITTEE: Rec. for pass; ref to Calendar & Rules Committee",21,0,1,0,22
1954655,1503852,2025-03-03,House,"FLOOR VOTE: CONSENT CALENDAR PASSAGE ON THIRD CONSIDERATION",89,0,0,0,89
1954655,1519353,2025-03-17,Senate,"FLOOR VOTE: Motion to Adopt",32,0,0,0,32
1954687,1514263,2025-03-11,House,"HOUSE TRANSPORTATION SUBCOMMITTEE: Rec for pass if am by s/c ref. to Transportation Committee",9,0,0,0,9
1954687,1520122,2025-03-18,House,"HOUSE TRANSPORTATION COMMITTEE: Rec. for pass. if am., ref. to Calendar & Rules Committee",17,0,0,0,17
1954687,1525689,2025-03-24,House,"FLOOR VOTE: REGULAR CALENDAR AS AMENDED PASSAGE ON THIRD CONSIDERATION",91,2,2,0,95
1954687,1528788,2025-03-27,Senate,"FLOOR VOTE: Third Consideration",27,1,1,0,29
1954714,1505795,2025-03-04,Senate,"SENATE JUDICIARY COMMITTEE: Recommended for passage with amdt, refer to Senate Calendar Committee",9,0,0,0,9
1954714,1513156,2025-03-10,Senate,"FLOOR VOTE: as Amended Third Consideration",29,0,0,0,29
1954714,1538315,2025-04-07,House,"FLOOR VOTE: REGULAR CALENDAR PASSAGE ON THIRD CONSIDERATION",96,0,0,0,96
1954729,1483752,2025-02-06,House,"FLOOR VOTE: CONSENT CALENDAR PASSAGE ON THIRD CONSIDERATION",89,0,0,0,89
1954729,1490158,2025-02-13,Senate,"FLOOR VOTE: Motion to Adopt",31,0,0,0,31
1954742,1500856,2025-02-26,House,"HOUSE BUSINESS AND UTILITIES SUBCOMMITTEE: Rec for pass if am by s/c ref. to Commerce Committee",9,1,0,0,10
1954742,1506332,2025-03-05,House,"HOUSE COMMERCE COMMITTEE: Rec. for pass. if am., ref. to Calendar & Rules Committee",19,3,0,0,22
1954756,1526636,2025-03-25,House,"HOUSE ELECTIONS & CAMPAIGN FINANCE SUBCOMMITTEE: Rec for pass if am by s/c ref. to State & Local Government Committee",5,2,0,0,7
1954756,1540198,2025-04-08,House,"HOUSE STATE & LOCAL GOVERNMENT COMMITTEE: Rec. for pass. if am., ref. to Calendar & Rules Committee",21,2,0,0,23
1954772,1516410,2025-03-12,House,"HOUSE BUSINESS AND UTILITIES SUBCOMMITTEE: Rec for pass if am by s/c ref. to Commerce Committee",8,0,0,0,8
1954772,1520952,2025-03-19,House,"HOUSE COMMERCE COMMITTEE: Rec. for pass. if am., ref. to Calendar & Rules Committee",21,0,0,0,21
1954772,1525329,2025-03-24,House,"FLOOR VOTE: REGULAR CALENDAR AS AMENDED PASSAGE ON THIRD CONSIDERATION",94,1,0,0,95
1954772,1528908,2025-03-27,Senate,"FLOOR VOTE: Third Consideration",30,0,0,0,30
1954778,1515655,2025-03-11,Senate,"SENATE JUDICIARY COMMITTEE: Recommended for passage with amendment/s, refer to Senate Calendar Committee Ayes 9, Nays 0 PNV 0",9,0,0,0,9
1954792,1516363,2025-03-12,House,"HOUSE HEALTH SUBCOMMITTEE: Rec. for pass by s/c ref. to Health Committee",9,0,0,0,9
1954792,1520392,2025-03-18,House,"HOUSE HEALTH COMMITTEE: Rec. for pass; ref to Calendar & Rules Committee",17,0,0,0,17
1954792,1525192,2025-03-24,House,"FLOOR VOTE: CONSENT CALENDAR PASSAGE ON THIRD CONSIDERATION",96,0,0,0,96
1954792,1529189,2025-03-27,Senate,"FLOOR VOTE: Motion to Adopt",27,0,0,0,27
1954812,1520778,2025-03-18,Senate,"SENATE JUDICIARY COMMITTEE: Recommended for passage with amendment/s, refer to Senate Finance, Ways, and Means Committee Ayes 9, Nays 0 PNV 0",9,0,0,0,9
1954826,1483420,2025-02-06,House,"FLOOR VOTE: CONSENT CALENDAR PASSAGE ON THIRD CONSIDERATION",89,0,0,0,89
1954826,1490367,2025-02-13,Senate,"FLOOR VOTE: Motion to Adopt",31,0,0,0,31
1954853,1483404,2025-02-06,House,"FLOOR VOTE: CONSENT CALENDAR PASSAGE ON THIRD CONSIDERATION",89,0,0,0,89
1954853,1490080,2025-02-13,Senate,"FLOOR VOTE: Motion to Adopt",31,0,0,0,31
1954884,1521076,2025-03-19,House,"INSURANCE SUBCOMMITTEE: Rec. for pass by s/c ref. to Insurance Committee",6,0,0,0,6
1954884,1526467,2025-03-25,House,"HOUSE INSURANCE COMMITTEE: Rec. for pass; ref to Calendar & Rules Committee",17,0,0,0,17
1954891,1483485,2025-02-06,House,"FLOOR VOTE: CONSENT CALENDAR PASSAGE ON THIRD CONSIDERATION",89,0,0,0,89
1954891,1490059,2025-02-13,Senate,"FLOOR VOTE: Motion to Adopt",31,0,0,0,31
1954896,1520033,2025-03-18,House,"HOUSE TRANSPORTATION SUBCOMMITTEE: Rec for pass if am by s/c ref. to Transportation Committee",9,0,0,0,9
1954896,1525970,2025-03-25,House,"HOUSE TRANSPORTATION COMMITTEE: Rec. for pass. if am., ref. to Finance, Ways, and Means Committee",20,0,0,0,20
1954896,1547295,2025-04-14,House,"HOUSE FINANCE, WAYS, AND MEANS SUBCOMMITTEE: Rec. for pass by s/c ref. to Finance, Ways, and Means Committee",12,0,0,0,12
1954896,1549292,2025-04-15,House,"HOUSE FINANCE, WAYS, AND MEANS COMMITTEE: Rec. for pass; ref to Calendar & Rules Committee",24,0,1,0,25
1954896,1550237,2025-04-16,House,"FLOOR VOTE: REGULAR CALENDAR AS AMENDED PASSAGE ON THIRD CONSIDERATION",90,0,0,0,90
1954896,1552428,2025-04-17,Senate,"FLOOR VOTE: Third Consideration",27,5,0,0,32
1954910,1483632,2025-02-06,House,"FLOOR VOTE: CONSENT CALENDAR PASSAGE ON THIRD CONSIDERATION",89,0,0,0,89
1954910,1490233,2025-02-13,Senate,"FLOOR VOTE: Motion to Adopt",31,0,0,0,31
1954923,1483456,2025-02-06,House,"FLOOR VOTE: CONSENT CALENDAR PASSAGE ON THIRD CONSIDERATION",89,0,0,0,89
1954923,1490137,2025-02-13,Senate,"FLOOR VOTE: Motion to Adopt",31,0,0,0,31
1954931,1483743,2025-02-06,House,"FLOOR VOTE: CONSENT CALENDAR PASSAGE ON THIRD CONSIDERATION",89,0,0,0,89
1954931,1490254,2025-02-13,Senate,"FLOOR VOTE: Motion to Adopt",31,0,0,0,31
1954958,1483432,2025-02-06,House,"FLOOR VOTE: CONSENT CALENDAR PASSAGE ON THIRD CONSIDERATION",89,0,0,0,89
1954958,1490437,2025-02-13,Senate,"FLOOR VOTE: Motion to Adopt",31,0,0,0,31
1954964,1521074,2025-03-19,House,"HOUSE PUBLIC SERVICE SUBCOMMITTEE: Rec for pass if am by s/c ref. to State & Local Government Committee",5,0,0,0,5
1954964,1542648,2025-04-09,House,"HOUSE STATE & LOCAL GOVERNMENT COMMITTEE: Failed in State & Local Government Committee",7,9,3,0,19
1955007,1505775,2025-03-05,House,"HOUSE CRIMINAL JUSTICE SUBCOMMITTEE: Rec for pass if am by s/c ref. to Judiciary Committee",8,0,1,0,9
1955007,1539997,2025-04-08,House,"HOUSE JUDICIARY COMMITTEE: Rec. for pass. if am., ref. to Calendar & Rules Committee",20,1,0,0,21
1955017,1532913,2025-04-01,House,"HOUSE CRIMINAL JUSTICE SUBCOMMITTEE: Failed in s/c Criminal Justice Subcommittee of Judiciary Committee",2,7,0,0,9
1955045,1521866,2025-03-19,House,"HOUSE PUBLIC SERVICE SUBCOMMITTEE: Failed in s/c Public Service Subcommittee of State & Local Government Committee",1,5,0,0,6
1955047,1521882,2025-03-19,House,"HOUSE CIVIL JUSTICE SUBCOMMITTEE: Rec for pass if am by s/c ref. to Judiciary Committee",7,0,0,0,7
1955047,1534457,2025-04-02,House,"HOUSE JUDICIARY COMMITTEE: Rec. for pass. if am., ref. to Calendar & Rules Committee",18,0,0,0,18
1955057,1490518,2025-02-13,Senate,"FLOOR VOTE: Motion to Adopt",31,0,0,0,31
1955057,1498473,2025-02-24,House,"FLOOR VOTE: CONSENT CALENDAR PASSAGE ON THIRD CONSIDERATION",92,0,2,0,94
1955087,1526391,2025-03-25,House,"HOUSE DEPARTMENTS & AGENCIES SUBCOMMITTEE: Rec for pass if am by s/c ref. to State & Local Government Committee",6,2,0,0,8
1955087,1540011,2025-04-08,House,"HOUSE STATE & LOCAL GOVERNMENT COMMITTEE: Rec. for pass. if am., ref. to Finance, Ways, and Means Committee",17,5,0,0,22
1955087,1547159,2025-04-14,House,"HOUSE FINANCE, WAYS, AND MEANS SUBCOMMITTEE: Rec. for pass by s/c ref. to Finance, Ways, and Means Committee",9,3,0,0,12
1955087,1549046,2025-04-15,House,"HOUSE FINANCE, WAYS, AND MEANS COMMITTEE: Rec. for pass; ref to Calendar & Rules Committee",20,7,0,0,27
1955093,1520376,2025-03-18,House,"HOUSE EDUCATION ADMINISTRATION SUBCOMMITTEE: Rec for pass if am by s/c ref. to Education Committee",6,0,0,0,6
1955101,1516004,2025-03-12,House,"HOUSE HIGHER EDUCATION SUBCOMMITTEE: Rec for pass if am by s/c ref. to Education Committee",4,0,0,0,4
1955101,1533569,2025-04-01,House,"HOUSE EDUCATION COMMITTEE: Rec. for pass. if am., ref. to Government Operations Committee",15,1,3,0,19
1955101,1549626,2025-04-16,House,"HOUSE GOVERNMENT OPERATIONS COMMITTEE: Rec. for pass; ref to Finance, Ways, and Means Committee",11,2,0,0,13
1955101,1551730,2025-04-17,House,"HOUSE FINANCE, WAYS, AND MEANS SUBCOMMITTEE: Rec. for pass by s/c ref. to Finance, Ways, and Means Committee",12,0,0,0,12
1955101,1553493,2025-04-17,House,"HOUSE FINANCE, WAYS, AND MEANS COMMITTEE: Rec. for pass; ref to Calendar & Rules Committee",27,0,0,0,27
1955118,1494547,2025-02-18,House,"HOUSE EDUCATION ADMINISTRATION SUBCOMMITTEE: Rec for pass if am by s/c ref. to Education Committee",6,0,0,0,6
1955118,1498745,2025-02-25,House,"HOUSE EDUCATION COMMITTEE: Rec. for pass; ref to Calendar & Rules Committee",16,1,0,0,17
1955118,1503644,2025-03-03,House,"FLOOR VOTE: REGULAR CALENDAR AS AMENDED PASSAGE ON THIRD CONSIDERATION",80,9,1,0,90
1955118,1513112,2025-03-06,Senate,"FLOOR VOTE: as Amended Third Consideration",30,0,1,0,31
1955118,1517373,2025-03-13,House,"FLOOR VOTE: MESSAGE CALENDAR CONCUR IN SENATE AMENDMENT # 1",90,0,0,0,90
1955165,1494490,2025-02-19,House,"HOUSE AGRICULTURE AND NATURAL RESOURCES SUBCOMMITTEE: Rec. for pass by s/c ref. to Agriculture & Natural Resources Committee",9,0,0,0,9
1955165,1498652,2025-02-25,House,"HOUSE AGRICULTURE & NATURAL RESOURCES COMMITTEE: Rec. for pass; ref to Calendar & Rules Committee",15,0,1,0,16
1955165,1507396,2025-03-06,House,"FLOOR VOTE: REGULAR CALENDAR PASSAGE ON THIRD CONSIDERATION",86,0,5,0,91
1955165,1507397,2025-03-06,House,"FLOOR VOTE: REGULAR CALENDAR PREVIOUS QUESTION PASSAGE ON THIRD CONSIDERATION",71,19,0,0,90
1955165,1531796,2025-03-31,Senate,"FLOOR VOTE: Motion to Adopt",30,0,0,0,30
1955181,1527682,2025-03-26,House,"HOUSE CRIMINAL JUSTICE SUBCOMMITTEE: Rec. for pass by s/c ref. to Judiciary Committee",6,2,0,0,8
1955188,1521504,2025-03-19,House,"HOUSE AGRICULTURE AND NATURAL RESOURCES SUBCOMMITTEE: Rec for pass if am by s/c ref. to Agriculture & Natural Resources Committee",7,0,1,0,8
1955188,1532098,2025-04-01,House,"HOUSE AGRICULTURE & NATURAL RESOURCES COMMITTEE: Rec. for pass. if am., ref. to Government Operations Committee",14,0,1,0,15
1955188,1538405,2025-04-07,House,"HOUSE GOVERNMENT OPERATIONS COMMITTEE: Rec. for pass. if am., ref. to Finance, Ways, and Means Committee",11,1,0,0,12
1955188,1551807,2025-04-17,House,"HOUSE FINANCE, WAYS, AND MEANS SUBCOMMITTEE: Rec. for pass by s/c ref. to Finance, Ways, and Means Committee",11,0,0,0,11
1955188,1553303,2025-04-17,House,"HOUSE FINANCE, WAYS, AND MEANS COMMITTEE: Rec. for pass; ref to Calendar & Rules Committee",27,0,0,0,27
1955188,1553304,2025-04-17,House,"HOUSE FINANCE, WAYS, AND MEANS COMMITTEE: Rec. for pass; ref to Calendar & Rules Committee",19,8,0,0,27
1955188,1553305,2025-04-21,House,"FLOOR VOTE: REGULAR CALENDAR AS AMENDED PASSAGE ON THIRD CONSIDERATION",81,11,0,0,92
1955188,1556963,2025-04-22,Senate,"FLOOR VOTE: Third Consideration",33,0,0,0,33
1955192,1521840,2025-03-19,House,"HOUSE PUBLIC SERVICE SUBCOMMITTEE: Failed in s/c Public Service Subcommittee of State & Local Government Committee",1,4,0,0,5
1955203,1494535,2025-02-19,House,"HOUSE BANKING AND CONSUMER AFFAIRS SUBCOMMITTEE: Rec. for pass by s/c ref. to Commerce Committee",5,0,0,0,5
1955203,1499856,2025-02-26,House,"HOUSE COMMERCE COMMITTEE: Rec. for pass; ref to Calendar & Rules Committee",21,0,0,0,21
1955203,1503607,2025-03-03,House,"FLOOR VOTE: CONSENT CALENDAR PASSAGE ON THIRD CONSIDERATION",89,0,0,0,89
1955203,1529066,2025-03-27,House,"FLOOR VOTE: MOTION TO RECALL FROM SENATE",23,70,0,0,93
1955203,1539419,2025-04-07,Senate,"FLOOR VOTE: Third Consideration",24,5,1,0,30
1955255,1519560,2025-03-18,House,"POPULATION HEALTH SUBCOMMITTEE: Failed in s/c Population Health Subcommittee of Health Committee",4,6,0,0,10
1955260,1521843,2025-03-19,House,"HOUSE BANKING AND CONSUMER AFFAIRS SUBCOMMITTEE: Rec. for pass by s/c ref. to Commerce Committee",7,0,0,0,7
1955260,1527399,2025-03-26,House,"HOUSE COMMERCE COMMITTEE: Rec. for pass. if am., ref. to Calendar & Rules Committee",21,0,0,0,21
1955260,1531526,2025-03-31,House,"FLOOR VOTE: REGULAR CALENDAR AS AMENDED PASSAGE ON THIRD CONSIDERATION",94,0,0,0,94
1955260,1531901,2025-03-31,Senate,"FLOOR VOTE: Third Consideration",30,0,0,0,30
1955267,1515096,2025-03-11,House,"HOUSE ELECTIONS & CAMPAIGN FINANCE SUBCOMMITTEE: Rec for pass if am by s/c ref. to State & Local Government Committee",5,2,0,0,7
1955267,1521389,2025-03-19,House,"HOUSE STATE & LOCAL GOVERNMENT COMMITTEE: Rec. for pass. if am., ref. to Finance, Ways, and Means Committee",13,7,1,0,21
1955271,1515195,2025-03-11,House,"HOUSE ELECTIONS & CAMPAIGN FINANCE SUBCOMMITTEE: Rec. for pass by s/c ref. to State & Local Government Committee",6,1,0,0,7
1955271,1540178,2025-04-08,House,"HOUSE STATE & LOCAL GOVERNMENT COMMITTEE: Rec. for pass; ref to Calendar & Rules Committee",20,0,1,0,21
1955271,1550420,2025-04-16,House,"FLOOR VOTE: REGULAR CALENDAR PASSAGE ON THIRD CONSIDERATION",75,15,0,0,90
1955271,1552639,2025-04-21,Senate,"FLOOR VOTE: Third Consideration",28,1,2,0,31
1955277,1521522,2025-03-19,House,"HOUSE CITIES & COUNTIES SUBCOMMITTEE: Rec. for pass by s/c ref. to State & Local Government Committee",7,0,0,0,7
1955277,1534290,2025-04-02,House,"HOUSE STATE & LOCAL GOVERNMENT COMMITTEE: Rec. for pass; ref to Finance, Ways, and Means Committee",21,1,1,0,23
1955277,1551857,2025-04-17,House,"HOUSE FINANCE, WAYS, AND MEANS SUBCOMMITTEE: Rec. for pass by s/c ref. to Finance, Ways, and Means Committee",11,0,0,0,11
1955277,1553372,2025-04-17,House,"HOUSE FINANCE, WAYS, AND MEANS COMMITTEE: Rec. for pass; ref to Calendar & Rules Committee",27,0,0,0,27
1955277,1553373,2025-04-17,House,"HOUSE FINANCE, WAYS, AND MEANS COMMITTEE: Rec. for pass; ref to Calendar & Rules Committee",27,0,0,0,27
1955286,1494896,2025-02-19,House,"HOUSE AGRICULTURE AND NATURAL RESOURCES SUBCOMMITTEE: Rec. for pass by s/c ref. to Agriculture & Natural Resources Committee",8,0,0,0,8
1955286,1498591,2025-02-25,House,"HOUSE AGRICULTURE & NATURAL RESOURCES COMMITTEE: Rec. for pass; ref to Government Operations Committee",16,0,0,0,16
1955286,1503232,2025-03-03,House,"HOUSE GOVERNMENT OPERATIONS COMMITTEE: Rec. for pass; ref to Calendar & Rules Committee",10,0,0,0,10
1955286,1509655,2025-03-10,House,"FLOOR VOTE: CONSENT CALENDAR PASSAGE ON THIRD CONSIDERATION",94,0,0,0,94
1955286,1532018,2025-03-31,Senate,"FLOOR VOTE: Motion to Adopt",30,0,0,0,30
1955290,1505953,2025-03-05,House,"HOUSE CRIMINAL JUSTICE SUBCOMMITTEE: Rec. for pass by s/c ref. to Judiciary Committee",7,2,0,0,9
1955290,1527497,2025-03-26,House,"HOUSE JUDICIARY COMMITTEE: Rec. for pass; ref to Calendar & Rules Committee",16,6,0,0,22
1955297,1520429,2025-03-18,House,"HOUSE EDUCATION ADMINISTRATION SUBCOMMITTEE: Rec. for pass by s/c ref. to Education Committee",5,1,0,0,6
1955300,1522039,2025-03-19,House,"HOUSE AGRICULTURE AND NATURAL RESOURCES SUBCOMMITTEE: Rec for pass if am by s/c ref. to Agriculture & Natural Resources Committee",8,0,0,0,8
1955300,1532794,2025-04-01,House,"HOUSE AGRICULTURE & NATURAL RESOURCES COMMITTEE: Rec. for pass. if am., ref. to Finance, Ways, and Means Committee",9,6,0,0,15
1955300,1551971,2025-04-17,House,"HOUSE FINANCE, WAYS, AND MEANS SUBCOMMITTEE: Rec for pass if am by s/c ref. to Finance, Ways, and Means Committee",12,0,0,0,12
1955300,1554249,2025-04-17,House,"HOUSE FINANCE, WAYS, AND MEANS COMMITTEE: Rec. for pass. if am., ref. to Calendar & Rules Committee",25,0,0,0,25
1955300,1554250,2025-04-22,House,"FLOOR VOTE: REGULAR CALENDAR AS AMENDED PASSAGE ON THIRD CONSIDERATION",72,15,3,0,90
1955317,1521797,2025-03-19,House,"HOUSE AGRICULTURE AND NATURAL RESOURCES SUBCOMMITTEE: Rec. for pass by s/c ref. to Agriculture & Natural Resources Committee",8,0,1,0,9
1955317,1532173,2025-04-01,House,"HOUSE AGRICULTURE & NATURAL RESOURCES COMMITTEE: Rec. for pass; ref to Finance, Ways, and Means Committee",12,1,1,0,14
1955319,1515114,2025-03-11,House,"HOUSE ELECTIONS & CAMPAIGN FINANCE SUBCOMMITTEE: Failed in s/c Elections & Campaign Finance Subcommittee of State & Local Government Committee",1,4,2,0,7
1955338,1534724,2025-04-02,House,"HOUSE CIVIL JUSTICE SUBCOMMITTEE: Rec for pass if am by s/c ref. to Judiciary Committee",5,1,0,0,6
1955338,1542022,2025-04-09,House,"HOUSE JUDICIARY COMMITTEE: Rec. for pass. if am., ref. to Calendar & Rules Committee",17,5,0,0,22
1955366,1528391,2025-03-26,House,"HOUSE BANKING AND CONSUMER AFFAIRS SUBCOMMITTEE: Rec for pass if am by s/c ref. to Commerce Committee",5,0,0,0,5
1955371,1521371,2025-03-19,House,"HOUSE BANKING AND CONSUMER AFFAIRS SUBCOMMITTEE: Rec. for pass by s/c ref. to Commerce Committee",6,0,0,0,6
1955371,1527254,2025-03-26,House,"HOUSE COMMERCE COMMITTEE: Rec. for pass. if am., ref. to Calendar & Rules Committee",21,0,0,0,21
1955379,1532364,2025-04-01,Senate,"SENATE STATE & LOCAL GOVERNMENT COMMITTEE: Recommended for passage with amendment/s, refer to Senate Calendar Committee Ayes 8, Nays 0 PNV 0",8,0,0,0,8
1955379,1543661,2025-04-10,Senate,"FLOOR VOTE: as Amended Third Consideration",31,0,0,0,31
1955379,1550366,2025-04-16,House,"FLOOR VOTE: REGULAR CALENDAR PASSAGE ON THIRD CONSIDERATION",92,0,1,0,93
1955381,1521927,2025-03-19,House,"HOUSE CITIES & COUNTIES SUBCOMMITTEE: Rec for pass if am by s/c ref. to State & Local Government Committee",6,0,0,0,6
1955381,1543170,2025-04-09,House,"HOUSE STATE & LOCAL GOVERNMENT COMMITTEE: Rec. for pass. if am., ref. to Calendar & Rules Committee",20,0,1,0,21
1955386,1519614,2025-03-18,House,"HOUSE DEPARTMENTS & AGENCIES SUBCOMMITTEE: Rec for pass if am by s/c ref. to State & Local Government Committee",6,2,0,0,8
1955386,1528415,2025-03-26,House,"HOUSE STATE & LOCAL GOVERNMENT COMMITTEE: Rec. for pass. if am., ref. to Government Operations Committee",17,5,0,0,22
1955386,1530810,2025-03-31,House,"HOUSE GOVERNMENT OPERATIONS COMMITTEE: Rec. for pass. if am., ref. to Finance, Ways, and Means Committee",7,5,0,0,12
1955386,1541876,2025-04-09,House,"HOUSE FINANCE, WAYS, AND MEANS SUBCOMMITTEE: Rec. for pass by s/c ref. to Finance, Ways, and Means Committee",8,2,0,0,10
1955386,1546880,2025-04-14,House,"HOUSE FINANCE, WAYS, AND MEANS COMMITTEE: Rec. for pass; ref to Calendar & Rules Committee",21,6,0,0,27
1955386,1550597,2025-04-16,House,"FLOOR VOTE: REGULAR CALENDAR AS AMENDED PASSAGE ON THIRD CONSIDERATION",73,23,0,0,96
1955386,1550598,2025-04-16,House,"FLOOR VOTE: REGULAR CALENDAR MOTION TO ADOPT AMENDMENT # 3 BY CAMPER PASSAGE ON THIRD CONSIDERATION",24,68,0,0,92
1955386,1550599,2025-04-16,House,"FLOOR VOTE: REGULAR CALENDAR PREVIOUS QUESTION AS AMENDED PASSAGE ON THIRD CONSIDERATION",73,23,0,0,96
1955386,1552714,2025-04-21,Senate,"FLOOR VOTE: Third Consideration",27,6,0,0,33
1955397,1527754,2025-03-26,House,"HOUSE K-12 SUBCOMMITTEE: Rec for pass if am by s/c ref. to Education Committee",6,0,0,0,6
1955397,1534820,2025-04-02,House,"HOUSE EDUCATION COMMITTEE: Rec. for pass. if am., ref. to Finance, Ways, and Means Committee",14,3,1,0,18
1955397,1551825,2025-04-17,House,"HOUSE FINANCE, WAYS, AND MEANS SUBCOMMITTEE: Rec. for pass by s/c ref. to Finance, Ways, and Means Committee",11,0,0,0,11
1955397,1553269,2025-04-17,House,"HOUSE FINANCE, WAYS, AND MEANS COMMITTEE: Rec. for pass; ref to Calendar & Rules Committee",27,0,0,0,27
1955449,1521861,2025-03-19,House,"HOUSE CRIMINAL JUSTICE SUBCOMMITTEE: Rec for pass if am by s/c ref. to Judiciary Committee",8,0,0,0,8
1955449,1539459,2025-04-08,House,"HOUSE JUDICIARY COMMITTEE: Rec. for pass. if am., ref. to Calendar & Rules Committee",16,0,2,0,18
1955453,1513868,2025-03-11,House,"HOUSE DEPARTMENTS & AGENCIES SUBCOMMITTEE: Failed in s/c Departments & Agencies Subcommittee of State & Local Government Committee",2,5,0,0,7
1955461,1521761,2025-03-19,House,"HOUSE AGRICULTURE AND NATURAL RESOURCES SUBCOMMITTEE: Rec for pass if am by s/c ref. to Agriculture & Natural Resources Committee",8,0,1,0,9
1955461,1525902,2025-03-25,House,"HOUSE AGRICULTURE & NATURAL RESOURCES COMMITTEE: Rec. for pass. if am., ref. to Government Operations Committee",13,3,0,0,16
1955461,1549763,2025-04-16,House,"HOUSE GOVERNMENT OPERATIONS COMMITTEE: Rec. for pass; ref to Finance, Ways, and Means Committee",13,0,0,0,13
1955461,1553273,2025-04-22,House,"HOUSE FINANCE, WAYS, AND MEANS COMMITTEE: Rec. for pass; ref to Calendar & Rules Committee",25,0,0,0,25
1955461,1553274,2025-04-22,House,"HOUSE FINANCE, WAYS, AND MEANS SUBCOMMITTEE: Rec. for pass by s/c ref. to Finance, Ways, and Means Committee",13,0,0,0,13
1955465,1515895,2025-03-12,House,"INSURANCE SUBCOMMITTEE: Rec. for pass by s/c ref. to Insurance Committee",6,0,0,0,6
1955465,1521776,2025-03-19,House,"HOUSE INSURANCE COMMITTEE: Rec. for pass; ref to Calendar & Rules Committee",15,0,0,0,15
1955477,1521766,2025-03-19,House,"HOUSE AGRICULTURE AND NATURAL RESOURCES SUBCOMMITTEE: Rec for pass if am by s/c ref. to Agriculture & Natural Resources Committee",8,0,0,0,8
1955477,1525972,2025-03-25,House,"HOUSE AGRICULTURE & NATURAL RESOURCES COMMITTEE: Rec. for pass. if am., ref. to Calendar & Rules Committee",16,0,0,0,16
1955480,1519875,2025-03-18,House,"HOUSE ELECTIONS & CAMPAIGN FINANCE SUBCOMMITTEE: Rec. for pass by s/c ref. to State & Local Government Committee",5,1,0,0,6
1955480,1528095,2025-03-26,House,"HOUSE STATE & LOCAL GOVERNMENT COMMITTEE: Rec. for pass; ref to Calendar & Rules Committee",19,3,1,0,23
1955504,1516270,2025-03-12,House,"HOUSE PUBLIC SERVICE SUBCOMMITTEE: Rec. for pass by s/c ref. to State & Local Government Committee",5,0,0,0,5
1955504,1522140,2025-03-19,House,"HOUSE STATE & LOCAL GOVERNMENT COMMITTEE: Rec. for pass; ref to Calendar & Rules Committee",19,0,0,0,19
1955504,1525187,2025-03-24,House,"FLOOR VOTE: CONSENT CALENDAR PASSAGE ON THIRD CONSIDERATION",96,0,0,0,96
1955504,1531946,2025-03-31,Senate,"FLOOR VOTE: Motion to Adopt",30,0,0,0,30
1955531,1515798,2025-03-12,House,"HOUSE PUBLIC SERVICE SUBCOMMITTEE: Rec for pass if am by s/c ref. to State & Local Government Committee",6,0,0,0,6
1955531,1542708,2025-04-09,House,"HOUSE STATE & LOCAL GOVERNMENT COMMITTEE: Rec. for pass. if am., ref. to Finance, Ways, and Means Committee",17,6,0,0,23
1955531,1551766,2025-04-17,House,"HOUSE FINANCE, WAYS, AND MEANS SUBCOMMITTEE: Rec for pass if am by s/c ref. to Finance, Ways, and Means Committee",11,0,0,0,11
1955531,1553216,2025-04-17,House,"HOUSE FINANCE, WAYS, AND MEANS COMMITTEE: Rec. for pass. if am., ref. to Calendar & Rules Committee",26,0,0,0,26
1955531,1553217,2025-04-17,House,"HOUSE FINANCE, WAYS, AND MEANS COMMITTEE: Rec. for pass; ref to Calendar & Rules Committee",27,0,0,0,27
1955538,1519999,2025-03-18,House,"HOUSE TRANSPORTATION SUBCOMMITTEE: Def. to Summer Study in Transportation Subcommittee",8,0,1,0,9
1955554,1521019,2025-03-19,House,"HOUSE PUBLIC SERVICE SUBCOMMITTEE: Rec for pass if am by s/c ref. to State & Local Government Committee",5,0,0,0,5
1955554,1540245,2025-04-08,House,"HOUSE STATE & LOCAL GOVERNMENT COMMITTEE: Rec. for pass. if am., ref. to Calendar & Rules Committee",22,0,0,0,22
1955558,1528205,2025-03-26,House,"HOUSE AGRICULTURE AND NATURAL RESOURCES SUBCOMMITTEE: Rec for pass if am by s/c ref. to Agriculture & Natural Resources Committee",8,1,0,0,9
1955558,1532050,2025-04-01,House,"HOUSE AGRICULTURE & NATURAL RESOURCES COMMITTEE: Rec. for pass. if am., ref. to Calendar & Rules Committee",13,2,0,0,15
1955563,1515915,2025-03-12,House,"HOUSE PUBLIC SERVICE SUBCOMMITTEE: Rec. for pass by s/c ref. to State & Local Government Committee",5,0,0,0,5
1955563,1521743,2025-03-19,House,"HOUSE STATE & LOCAL GOVERNMENT COMMITTEE: Rec. for pass; ref to Calendar & Rules Committee",21,0,0,0,21
1955563,1525590,2025-03-24,House,"FLOOR VOTE: CONSENT CALENDAR PASSAGE ON THIRD CONSIDERATION",96,0,0,0,96
1955566,1516154,2025-03-12,House,"HOUSE PUBLIC SERVICE SUBCOMMITTEE: Rec for pass if am by s/c ref. to State & Local Government Committee",4,0,1,0,5
1956109,1521489,2025-03-19,Senate,"SENATE ENERGY, AGRICULTURE AND NATURAL RESOURCES COMMITTEE: Recommended for passage with amendment/s, refer to Senate Finance, Ways, and Means Committee Ayes 6, Nays 3 PNV 0",6,3,0,0,9
1956109,1549065,2025-04-15,Senate,"SENATE FINANCE, WAYS AND MEANS COMMITTEE: Recommended for passage, refer to Senate Calendar Committee",8,1,1,0,10
1956109,1553000,2025-04-21,Senate,"FLOOR VOTE: as Amended Third Consideration",27,5,1,0,33
1956109,1554729,2025-04-22,House,"FLOOR VOTE: REGULAR CALENDAR 2 PASSAGE ON THIRD CONSIDERATION",76,18,2,0,96
1956111,1507438,2025-03-05,Senate,"SENATE EDUCATION COMMITTEE: Recommended for passage with amendment/s, refer to Senate Calendar Committee Ayes 9, Nays 0 PNV 0",9,0,0,0,9
1956111,1517013,2025-03-13,Senate,"FLOOR VOTE: as Amended Third Consideration",31,0,0,0,31
1956111,1548974,2025-04-15,House,"FLOOR VOTE: REGULAR CALENDAR PASSAGE ON THIRD CONSIDERATION",87,2,6,0,95
1956119,1521475,2025-03-19,House,"HOUSE HEALTH SUBCOMMITTEE: Rec for pass if am by s/c ref. to Health Committee",6,1,2,0,9
1956119,1532902,2025-04-01,House,"HOUSE HEALTH COMMITTEE: Rec. for pass. if am., ref. to Government Operations Committee",21,1,1,0,23
1956119,1538398,2025-04-07,House,"HOUSE GOVERNMENT OPERATIONS COMMITTEE: Rec. for pass; ref to Finance, Ways, and Means Committee",11,1,0,0,12
1956119,1547064,2025-04-14,House,"HOUSE FINANCE, WAYS, AND MEANS SUBCOMMITTEE: Rec. for pass by s/c ref. to Finance, Ways, and Means Committee",11,0,0,0,11
1956119,1548917,2025-04-15,House,"HOUSE FINANCE, WAYS, AND MEANS COMMITTEE: Rec. for pass; ref to Calendar & Rules Committee",23,3,0,0,26
1956119,1550207,2025-04-16,House,"FLOOR VOTE: REGULAR CALENDAR AS AMENDED PASSAGE ON THIRD CONSIDERATION",72,5,11,0,88
1956119,1552793,2025-04-21,Senate,"FLOOR VOTE: as Amended Third Consideration",31,1,1,0,33
1956119,1554485,2025-04-22,House,"FLOOR VOTE: MESSAGE CALENDAR MOTION TO ADOPT CONFERENCE COMMITTEE REPORT",79,10,6,0,95
1956119,1556779,2025-04-22,Senate,"FLOOR VOTE: Motion to Adopt Conference Committee Report",31,0,0,0,31
1956122,1519704,2025-03-18,Senate,"SENATE STATE & LOCAL GOVERNMENT COMMITTEE: Recommended for passage with amendment/s, refer to Senate Commerce and Labor Committee Ayes 7, Nays 2 PNV 0",7,2,0,0,9
1956122,1527320,2025-03-25,Senate,"SENATE COMMERCE AND LABOR COMMITTEE: Recommended for passage, refer to Senate Calendar Committee",8,1,0,0,9
1956127,1527721,2025-03-26,Senate,"SENATE ENERGY, AGRICULTURE AND NATURAL RESOURCES COMMITTEE: Recommended for passage, refer to Senate Calendar Committee",8,0,0,0,8
1956137,1521921,2025-03-19,Senate,"SENATE ENERGY, AGRICULTURE AND NATURAL RESOURCES COMMITTEE: Recommended for passage, refer to Senate Calendar Committee",8,0,0,0,8
1956137,1526232,2025-03-24,Senate,"FLOOR VOTE: Motion to Adopt",32,0,0,0,32
1956137,1553766,2025-04-21,House,"FLOOR VOTE: REGULAR CALENDAR PASSAGE ON THIRD CONSIDERATION",94,0,0,0,94
1956141,1483703,2025-02-06,House,"FLOOR VOTE: CONSENT CALENDAR PASSAGE ON THIRD CONSIDERATION",89,0,0,0,89
1956141,1490112,2025-02-13,Senate,"FLOOR VOTE: Motion to Adopt",31,0,0,0,31
1956150,1505121,2025-03-04,Senate,"SENATE STATE & LOCAL GOVERNMENT COMMITTEE: Recommended for passage with amendment/s, refer to Senate Finance, Ways, and Means Committee Ayes 9, Nays 0 PNV 0",9,0,0,0,9
1956150,1533363,2025-04-01,Senate,"SENATE FINANCE, WAYS AND MEANS COMMITTEE: Recommended for passage, refer to Senate Calendar Committee",9,0,1,0,10
1956152,1494533,2025-02-19,House,"HOUSE HEALTH SUBCOMMITTEE: Rec. for pass by s/c ref. to Health Committee",9,0,0,0,9
1956152,1499422,2025-02-25,House,"HOUSE HEALTH COMMITTEE: Rec. for pass; ref to Calendar & Rules Committee",22,0,0,0,22
1956152,1501026,2025-02-27,House,"FLOOR VOTE: MOTION TO ADOPT",93,0,0,0,93
1956152,1521431,2025-03-19,Senate,"SENATE HEALTH AND WELFARE COMMITTEE: Recommended for concurrence by Senate Health and Welfare Committee, refer Senate Calendar Committee",8,0,0,0,8
1956152,1526164,2025-03-24,Senate,"FLOOR VOTE: Motion to Adopt",32,0,0,0,32
1956159,1533929,2025-04-01,Senate,"SENATE JUDICIARY COMMITTEE: Recommended for passage with amendment/s, refer to Senate Calendar Committee Ayes 8, Nays 0 PNV 0",8,0,0,0,8
1956164,1516271,2025-03-12,Senate,"SENATE HEALTH AND WELFARE COMMITTEE: Recommended for passage with amendment/s, refer to Senate Calendar Committee Ayes 9, Nays 0 PNV 0",9,0,0,0,9
1956164,1519335,2025-03-17,Senate,"FLOOR VOTE: as Amended Third Consideration",27,0,1,0,28
1956164,1547656,2025-04-14,House,"FLOOR VOTE: REGULAR CALENDAR PASSAGE ON THIRD CONSIDERATION",96,0,0,0,96
1956172,1490506,2025-02-13,Senate,"FLOOR VOTE: Motion to Adopt",31,0,0,0,31
1956181,1534360,2025-04-02,Senate,"SENATE STATE & LOCAL GOVERNMENT COMMITTEE:",8,0,0,0,8
1956188,1505680,2025-03-05,House,"HOUSE CRIMINAL JUSTICE SUBCOMMITTEE: Rec. for pass by s/c ref. to Judiciary Committee",8,0,0,0,8
1956188,1516479,2025-03-12,House,"HOUSE JUDICIARY COMMITTEE: Rec. for pass; ref to Commerce Committee",16,0,1,0,17
1956188,1527574,2025-03-26,House,"HOUSE COMMERCE COMMITTEE: Rec. for pass. if am., ref. to Finance, Ways, and Means Committee",20,0,1,0,21
1956211,1525529,2025-03-24,Senate,"SENATE JUDICIARY COMMITTEE: Recommended for passage with amendment/s, refer to Senate Government Operations Committee Ayes 7, Nays 2 PNV 0",7,2,0,0,9
1956211,1542664,2025-04-09,Senate,"SENATE GOVERNMENT OPERATIONS COMMITTEE: Recommended for passage with amendment/s, refer to Senate Finance, Ways, and Means Committee Ayes 7, Nays 2 PNV 0",7,2,0,0,9
1956211,1549312,2025-04-15,Senate,"SENATE FINANCE, WAYS AND MEANS COMMITTEE: Recommended for passage, refer to Senate Calendar Committee",8,2,0,0,10
1956236,1527450,2025-03-25,Senate,"SENATE COMMERCE AND LABOR COMMITTEE: Recommended for passage with amendment/s, refer to Senate Calendar Committee Ayes 9, Nays 0 PNV 0",9,0,0,0,9
1956236,1531913,2025-03-31,Senate,"FLOOR VOTE: as Amended Third Consideration",30,0,0,0,30
1956236,1554101,2025-04-21,House,"FLOOR VOTE: REGULAR CALENDAR PASSAGE ON THIRD CONSIDERATION",93,0,0,0,93
1956238,1516430,2025-03-12,House,"HOUSE BUSINESS AND UTILITIES SUBCOMMITTEE: Rec for pass if am by s/c ref. to Commerce Committee",6,3,0,0,9
1956238,1521089,2025-03-19,House,"HOUSE COMMERCE COMMITTEE: Rec. for pass. if am., ref. to Government Operations Committee",19,2,0,0,21
1956238,1524720,2025-03-24,House,"HOUSE GOVERNMENT OPERATIONS COMMITTEE: Rec. for pass; ref to Finance, Ways, and Means Committee",9,4,0,0,13
1956238,1553621,2025-04-21,House,"HOUSE FINANCE, WAYS, AND MEANS COMMITTEE: Rec. for pass. if am., ref. to Calendar & Rules Committee",27,0,0,0,27
1956238,1553622,2025-04-21,House,"HOUSE FINANCE, WAYS, AND MEANS SUBCOMMITTEE: Rec for pass if am by s/c ref. to Finance, Ways, and Means Committee",12,0,0,0,12
1956249,1506140,2025-03-05,House,"HOUSE BUSINESS AND UTILITIES SUBCOMMITTEE: Rec for pass if am by s/c ref. to Commerce Committee",10,0,0,0,10
1956249,1515896,2025-03-12,House,"HOUSE COMMERCE COMMITTEE: Rec. for pass. if am., ref. to Finance, Ways, and Means Committee",21,0,0,0,21
1956249,1527741,2025-03-26,House,"HOUSE FINANCE, WAYS, AND MEANS SUBCOMMITTEE: Rec. for pass by s/c ref. to Finance, Ways, and Means Committee",11,0,0,0,11
1956249,1533206,2025-04-01,House,"HOUSE FINANCE, WAYS, AND MEANS COMMITTEE: Rec. for pass; ref to Calendar & Rules Committee",28,0,0,0,28
1956249,1543928,2025-04-10,House,"FLOOR VOTE: REGULAR CALENDAR AS AMENDED PASSAGE ON THIRD CONSIDERATION",97,0,0,0,97
1956267,1520973,2025-03-19,Senate,"TRANSPORTATION AND SAFETY COMMITTEE: Recommended for passage, refer to Senate Finance, Ways, and Means Committee",9,0,0,0,9
1956267,1539679,2025-04-08,Senate,"SENATE FINANCE, WAYS AND MEANS COMMITTEE: Recommended for passage, refer to Senate Calendar Committee",10,0,0,0,10
1956267,1548005,2025-04-14,Senate,"FLOOR VOTE: Motion to Adopt",32,0,0,0,32
1956267,1548796,2025-04-15,House,"FLOOR VOTE: REGULAR CALENDAR PASSAGE ON THIRD CONSIDERATION",75,17,1,0,93
1956272,1504621,2025-03-04,Senate,"SENATE COMMERCE AND LABOR COMMITTEE: Recommended for passage with amendment/s, refer to Senate Calendar Committee Ayes 7, Nays 0 PNV 0",7,0,0,0,7
1956272,1517361,2025-03-13,Senate,"FLOOR VOTE: as Amended Third Consideration",31,0,0,0,31
1956272,1553234,2025-04-21,House,"FLOOR VOTE: REGULAR CALENDAR PASSAGE ON THIRD CONSIDERATION",92,0,0,0,92
1956286,1504612,2025-03-04,House,"HOUSE TRANSPORTATION SUBCOMMITTEE: Rec. for pass by s/c ref. to Transportation Committee",9,0,0,0,9
1956286,1513493,2025-03-11,House,"HOUSE TRANSPORTATION COMMITTEE: Rec. for pass; ref to Calendar & Rules Committee",16,0,0,0,16
1956286,1524908,2025-03-24,House,"FLOOR VOTE: CONSENT CALENDAR PASSAGE ON THIRD CONSIDERATION",96,0,0,0,96
1956308,1499820,2025-02-26,Senate,"SENATE GOVERNMENT OPERATIONS COMMITTEE: Recommended for passage, refer to Senate Energy, Ag., and Nat. Resources Committee",7,2,0,0,9
1956308,1527735,2025-03-26,Senate,"SENATE ENERGY, AGRICULTURE AND NATURAL RESOURCES COMMITTEE: Recommended for passage with amendment/s, refer to Senate Calendar Committee Ayes 7, Nays 2 PNV 0",7,2,0,0,9
1956308,1536234,2025-04-03,Senate,"FLOOR VOTE: as Amended Third Consideration",24,5,0,0,29
1956308,1538827,2025-04-07,House,"FLOOR VOTE: REGULAR CALENDAR PASSAGE ON THIRD CONSIDERATION",74,22,0,0,96
1956308,1538828,2025-04-07,House,"FLOOR VOTE: REGULAR CALENDAR PREVIOUS QUESTION PASSAGE ON THIRD CONSIDERATION",62,27,2,0,91
1956314,1509110,2025-03-10,House,"HOUSE GOVERNMENT OPERATIONS COMMITTEE: Rec. for pass. if am., ref. to Finance, Ways, and Means Committee",12,1,0,0,13
1956314,1527390,2025-03-26,House,"HOUSE FINANCE, WAYS, AND MEANS SUBCOMMITTEE: Rec for pass if am by s/c ref. to Finance, Ways, and Means Committee",13,0,0,0,13
1956314,1547196,2025-04-14,House,"HOUSE FINANCE, WAYS, AND MEANS COMMITTEE: Rec. for pass. if am., ref. to Calendar & Rules Committee",25,1,1,0,27
1956331,1483343,2025-02-06,House,"FLOOR VOTE: CONSENT CALENDAR PASSAGE ON THIRD CONSIDERATION",89,0,0,0,89
1956331,1489968,2025-02-13,Senate,"FLOOR VOTE: Motion to Adopt",31,0,0,0,31
1956345,1521569,2025-03-19,Senate,"SENATE HEALTH AND WELFARE COMMITTEE: Recommended for passage with amendment/s, refer to Senate Calendar Committee Ayes 9, Nays 0 PNV 0",9,0,0,0,9
1956345,1528721,2025-03-27,Senate,"FLOOR VOTE: as Amended Third Consideration",32,0,0,0,32
1956345,1553351,2025-04-21,House,"FLOOR VOTE: REGULAR CALENDAR PASSAGE ON THIRD CONSIDERATION",94,0,0,0,94
1956351,1505003,2025-03-04,Senate,"SENATE COMMERCE AND LABOR COMMITTEE: Recommended for passage with amendment/s, refer to Senate Calendar Committee Ayes 6, Nays 0 PNV 1",6,0,1,0,7
1956351,1517106,2025-03-13,Senate,"FLOOR VOTE: as Amended Third Consideration",30,0,0,0,30
1956351,1525695,2025-03-24,House,"FLOOR VOTE: REGULAR CALENDAR PASSAGE ON THIRD CONSIDERATION",88,1,6,0,95
1956355,1500731,2025-02-26,House,"HOUSE HEALTH SUBCOMMITTEE: Rec for pass if am by s/c ref. to Health Committee",8,0,1,0,9
1956355,1505236,2025-03-04,House,"HOUSE HEALTH COMMITTEE: Rec. for pass. if am., ref. to Calendar & Rules Committee",17,0,0,0,17
1956355,1512016,2025-03-10,House,"FLOOR VOTE: REGULAR CALENDAR AS AMENDED PASSAGE ON THIRD CONSIDERATION",93,0,0,0,93
1956355,1528701,2025-03-27,Senate,"FLOOR VOTE: as Amended Third Consideration",32,0,0,0,32
1956355,1536015,2025-04-03,House,"FLOOR VOTE: MESSAGE CALENDAR CONCUR IN SENATE AMENDMENT # 2",85,0,3,0,88
1956367,1528098,2025-03-26,Senate,"SENATE ENERGY, AGRICULTURE AND NATURAL RESOURCES COMMITTEE: Recommended for passage with amendment, refer to Senate Calendar Committee",9,0,0,0,9
1956371,1527472,2025-03-26,House,"HOUSE HEALTH SUBCOMMITTEE: Rec for pass if am by s/c ref. to Health Committee",9,0,0,0,9
1956371,1533091,2025-04-01,House,"HOUSE HEALTH COMMITTEE: Rec. for pass. if am., ref. to Calendar & Rules Committee",21,0,0,0,21
1956384,1527703,2025-03-26,Senate,"SENATE ENERGY, AGRICULTURE AND NATURAL RESOURCES COMMITTEE: Recommended for passage with amendment/s, refer to Senate Calendar Committee Ayes 9, Nays 0 PNV 0",9,0,0,0,9
1956384,1531965,2025-03-31,Senate,"FLOOR VOTE: as Amended Third Consideration",28,0,0,0,28
1956384,1538842,2025-04-07,House,"FLOOR VOTE: REGULAR CALENDAR PASSAGE ON THIRD CONSIDERATION",84,7,2,0,93
1956426,1527636,2025-03-26,Senate,"SENATE ENERGY, AGRICULTURE AND NATURAL RESOURCES COMMITTEE: Recommended for passage, refer to Senate Calendar Committee",6,2,0,0,8
1956432,1504552,2025-03-04,House,"HOUSE EDUCATION ADMINISTRATION SUBCOMMITTEE: Rec. for pass by s/c ref. to Education Committee",6,0,0,0,6
1956432,1526485,2025-03-25,House,"HOUSE EDUCATION COMMITTEE: Rec. for pass; ref to Government Operations Committee",18,0,0,0,18
1956432,1531214,2025-03-31,House,"HOUSE GOVERNMENT OPERATIONS COMMITTEE: Rec. for pass; ref to Finance, Ways, and Means Committee",12,0,0,0,12
1956432,1551813,2025-04-17,House,"HOUSE FINANCE, WAYS, AND MEANS SUBCOMMITTEE: Rec. for pass by s/c ref. to Finance, Ways, and Means Committee",11,0,0,0,11
1956432,1553342,2025-04-17,House,"HOUSE FINANCE, WAYS, AND MEANS COMMITTEE: Rec. for pass; ref to Calendar & Rules Committee",27,0,0,0,27
1956447,1524906,2025-03-24,Senate,"SENATE JUDICIARY COMMITTEE: Recommended for passage, refer to Senate Calendar Committee",8,0,0,0,8
1956447,1528959,2025-03-27,Senate,"FLOOR VOTE: Motion to Adopt",27,0,0,0,27
1956447,1553310,2025-04-21,House,"FLOOR VOTE: REGULAR CALENDAR PASSAGE ON THIRD CONSIDERATION",91,1,1,0,93
1956468,1521688,2025-03-19,House,"HOUSE CRIMINAL JUSTICE SUBCOMMITTEE: Rec. for pass by s/c ref. to Judiciary Committee",9,0,0,0,9
1956468,1534557,2025-04-02,House,"HOUSE JUDICIARY COMMITTEE: Rec. for pass; ref to Calendar & Rules Committee",19,0,0,0,19
1956468,1539164,2025-04-07,House,"FLOOR VOTE: CONSENT CALENDAR PASSAGE ON THIRD CONSIDERATION",96,0,0,0,96
1956468,1543361,2025-04-10,Senate,"FLOOR VOTE: Third Consideration",30,0,1,0,31
1956473,1507087,2025-03-05,Senate,"SENATE EDUCATION COMMITTEE: Recommended for passage, refer to Senate Finance, Ways, and Means Committee",9,0,0,0,9
1956473,1549007,2025-04-15,Senate,"SENATE FINANCE, WAYS AND MEANS COMMITTEE: Recommended for passage, refer to Senate Calendar Committee",10,0,0,0,10
1956482,1495003,2025-02-18,House,"HOUSE TRANSPORTATION SUBCOMMITTEE: Rec. for pass by s/c ref. to Transportation Committee",8,0,0,0,8
1956482,1498636,2025-02-25,House,"HOUSE TRANSPORTATION COMMITTEE: Rec. for pass. if am., ref. to Finance, Ways, and Means Committee",20,0,0,0,20
1956482,1551720,2025-04-17,House,"HOUSE FINANCE, WAYS, AND MEANS SUBCOMMITTEE: Rec for pass if am by s/c ref. to Finance, Ways, and Means Committee",11,0,0,0,11
1956482,1553213,2025-04-17,House,"HOUSE FINANCE, WAYS, AND MEANS COMMITTEE: Rec. for pass. if am., ref. to Calendar & Rules Committee",26,0,0,0,26
1956482,1553214,2025-04-17,House,"HOUSE FINANCE, WAYS, AND MEANS COMMITTEE: Rec. for pass; ref to Calendar & Rules Committee",27,0,0,0,27
1956482,1553215,2025-04-21,House,"FLOOR VOTE: REGULAR CALENDAR AS AMENDED PASSAGE ON THIRD CONSIDERATION",89,0,0,0,89
1956482,1556755,2025-04-22,Senate,"FLOOR VOTE: Third Consideration",33,0,0,0,33
1956491,1505674,2025-03-04,Senate,"SENATE JUDICIARY COMMITTEE: Recommended for passage with amendment/s, refer to Senate Calendar Committee Ayes 8, Nays 1 PNV 0",8,1,0,0,9
1956491,1517485,2025-03-13,Senate,"FLOOR VOTE: as Amended Third Consideration",25,6,0,0,31
1956491,1548006,2025-04-14,House,"FLOOR VOTE: REGULAR CALENDAR PASSAGE ON THIRD CONSIDERATION",80,16,0,0,96
1956495,1514115,2025-03-11,Senate,"SENATE COMMERCE AND LABOR COMMITTEE: Recommended for passage, refer to Senate Finance, Ways, and Means Committee",7,1,1,0,9
1956499,1521812,2025-03-19,House,"HOUSE BUSINESS AND UTILITIES SUBCOMMITTEE: Rec. for pass by s/c ref. to Commerce Committee",8,0,0,0,8
1956499,1527470,2025-03-26,House,"HOUSE COMMERCE COMMITTEE: Rec. for pass; ref to Calendar & Rules Committee",23,0,0,0,23
1956499,1530914,2025-03-31,House,"FLOOR VOTE: CONSENT CALENDAR PASSAGE ON THIRD CONSIDERATION",93,0,2,0,95
1956509,1492263,2025-02-18,Senate,"SENATE COMMERCE AND LABOR COMMITTEE: Recommended for passage, refer to Senate Calendar Committee",7,0,0,0,7
1956509,1498489,2025-02-24,Senate,"FLOOR VOTE: Motion to Adopt",33,0,0,0,33
1956518,1534295,2025-04-02,Senate,"SENATE STATE & LOCAL GOVERNMENT COMMITTEE: Recommended for passage with amendment/s, refer to Senate Calendar Committee Ayes 9, Nays 0 PNV 0",9,0,0,0,9
1956523,1522332,2025-03-19,Senate,"SENATE EDUCATION COMMITTEE: Recommended for passage, refer to Senate Finance, Ways, and Means Committee",8,0,0,0,8
1956523,1536014,2025-04-03,Senate,"FLOOR VOTE: Motion to Adopt",30,0,0,0,30
1956523,1553504,2025-04-21,House,"FLOOR VOTE: REGULAR CALENDAR PASSAGE ON THIRD CONSIDERATION",92,0,0,0,92
1956542,1521888,2025-03-19,House,"HOUSE PUBLIC SERVICE SUBCOMMITTEE: Rec for pass if am by s/c ref. to State & Local Government Committee",6,0,0,0,6
1956542,1543125,2025-04-09,House,"HOUSE STATE & LOCAL GOVERNMENT COMMITTEE: Rec. for pass. if am., ref. to Finance, Ways, and Means Committee",21,0,0,0,21
1956542,1547179,2025-04-14,House,"HOUSE FINANCE, WAYS, AND MEANS SUBCOMMITTEE: Rec. for pass by s/c ref. to Finance, Ways, and Means Committee",12,0,0,0,12
1956542,1548499,2025-04-15,House,"HOUSE FINANCE, WAYS, AND MEANS COMMITTEE: Rec. for pass; ref to Calendar & Rules Committee",25,0,0,0,25
1956558,1515937,2025-03-12,House,"HOUSE CITIES & COUNTIES SUBCOMMITTEE: Rec for pass if am by s/c ref. to State & Local Government Committee",7,0,0,0,7
1956567,1501207,2025-02-26,Senate,"SENATE EDUCATION COMMITTEE: Recommended for passage, refer to Senate Calendar Committee",9,0,0,0,9
1956573,1528403,2025-03-26,Senate,"SENATE HEALTH AND WELFARE COMMITTEE: Recommended for passage with amendment/s, refer to Senate Calendar Committee Ayes 9, Nays 0 PNV 0",9,0,0,0,9
1956573,1533861,2025-03-31,Senate,"FLOOR VOTE: as Amended Third Consideration",30,0,0,0,30
1956573,1544722,2025-04-10,House,"FLOOR VOTE: REGULAR CALENDAR PASSAGE ON THIRD CONSIDERATION",91,3,0,0,94
1956602,1499815,2025-02-25,Senate,"SENATE JUDICIARY COMMITTEE: Recommended for passage, refer to Senate Finance, Ways, and Means Committee",8,1,0,0,9
1956604,1505679,2025-03-04,Senate,"SENATE JUDICIARY COMMITTEE: Recommended for passage, refer to Senate Calendar Committee",5,4,0,0,9
1956604,1517107,2025-03-13,Senate,"FLOOR VOTE: Third Consideration",18,12,1,0,31
1956615,1516480,2025-03-12,Senate,"TRANSPORTATION AND SAFETY COMMITTEE: Recommended for passage, refer to Senate Calendar Committee",9,0,0,0,9
1956615,1519729,2025-03-17,Senate,"FLOOR VOTE: Motion to Adopt",32,0,0,0,32
1956624,1526763,2025-03-25,Senate,"SENATE JUDICIARY COMMITTEE: Recommended for passage with amendment/s, refer to Senate Calendar Committee Ayes 9, Nays 0 PNV 0",9,0,0,0,9
1956624,1539441,2025-04-07,Senate,"FLOOR VOTE: as Amended Third Consideration",25,3,4,0,32
1956624,1550532,2025-04-16,House,"FLOOR VOTE: REGULAR CALENDAR PASSAGE ON THIRD CONSIDERATION",71,18,4,0,93
1956634,1521785,2025-03-19,House,"HOUSE CRIMINAL JUSTICE SUBCOMMITTEE: Rec. for pass by s/c ref. to Judiciary Committee",7,2,0,0,9
1956634,1542536,2025-04-09,House,"HOUSE JUDICIARY COMMITTEE: Rec. for pass; ref to Calendar & Rules Committee",16,3,0,0,19
1956636,1500377,2025-02-25,Senate,"SENATE JUDICIARY COMMITTEE: Recommended for passage, refer to Senate Calendar Committee",8,0,1,0,9
1956636,1515545,2025-03-03,Senate,"FLOOR VOTE: Third Consideration",29,1,1,0,31
1956636,1525731,2025-03-24,House,"FLOOR VOTE: REGULAR CALENDAR AS AMENDED PASSAGE ON THIRD CONSIDERATION",88,4,2,0,94
1956636,1531844,2025-03-31,Senate,"FLOOR VOTE: Motion to Concur House Amendment # 1",22,5,0,0,27
1956652,1506450,2025-03-05,Senate,"SENATE HEALTH AND WELFARE COMMITTEE: Recommended for passage with amendment/s, refer to Senate Calendar Committee Ayes 6, Nays 1 PNV 2",6,1,2,0,9
1956671,1551929,2025-04-17,House,"HOUSE FINANCE, WAYS, AND MEANS SUBCOMMITTEE: Rec. for pass by s/c ref. to Finance, Ways, and Means Committee",11,0,0,0,11
1956671,1553498,2025-04-17,House,"HOUSE FINANCE, WAYS, AND MEANS COMMITTEE: Rec. for pass; ref to Calendar & Rules Committee",27,0,0,0,27
1956675,1490104,2025-02-13,Senate,"FLOOR VOTE: Motion to Adopt",31,0,0,0,31
1956675,1497551,2025-02-24,House,"FLOOR VOTE: CONSENT CALENDAR PASSAGE ON THIRD CONSIDERATION",92,0,2,0,94
1956679,1527644,2025-03-26,Senate,"SENATE ENERGY, AGRICULTURE AND NATURAL RESOURCES COMMITTEE: Failed in Senate Energy, Ag., and Nat. Resources Committee",4,5,0,0,9
1956686,1494528,2025-02-19,House,"HOUSE CITIES & COUNTIES SUBCOMMITTEE: Rec. for pass by s/c ref. to State & Local Government Committee",5,0,0,0,5
1956686,1500083,2025-02-26,House,"HOUSE STATE & LOCAL GOVERNMENT COMMITTEE: Rec. for pass; ref to Calendar & Rules Committee",21,0,0,0,21
1956686,1503589,2025-03-03,House,"FLOOR VOTE: CONSENT CALENDAR PASSAGE ON THIRD CONSIDERATION",89,0,0,0,89
1956686,1519336,2025-03-17,Senate,"FLOOR VOTE: Motion to Adopt",32,0,0,0,32
1956693,1490521,2025-02-13,Senate,"FLOOR VOTE: Motion to Adopt",31,0,0,0,31
1956693,1497851,2025-02-24,House,"FLOOR VOTE: CONSENT CALENDAR PASSAGE ON THIRD CONSIDERATION",92,0,2,0,94
1956713,1490482,2025-02-13,Senate,"FLOOR VOTE: Motion to Adopt",31,0,0,0,31
1956713,1497778,2025-02-24,House,"FLOOR VOTE: CONSENT CALENDAR PASSAGE ON THIRD CONSIDERATION",92,0,2,0,94
1956728,1490053,2025-02-13,Senate,"FLOOR VOTE: Motion to Adopt",31,0,0,0,31
1956728,1497735,2025-02-24,House,"FLOOR VOTE: CONSENT CALENDAR PASSAGE ON THIRD CONSIDERATION",92,0,2,0,94
1956731,1501219,2025-02-26,Senate,"SENATE EDUCATION COMMITTEE: Recommended for passage with amendment/s, refer to Senate Calendar Committee Ayes 9, Nays 0 PNV 0",9,0,0,0,9
1956731,1513687,2025-03-06,Senate,"FLOOR VOTE: as Amended Third Consideration",29,0,0,0,29
1956731,1550370,2025-04-16,House,"FLOOR VOTE: REGULAR CALENDAR AS AMENDED PASSAGE ON THIRD CONSIDERATION",74,20,0,0,94
1956731,1552455,2025-04-17,Senate,"FLOOR VOTE: Motion to Concur House Amendment # 1",31,1,0,0,32
1956742,1483657,2025-02-06,House,"FLOOR VOTE: CONSENT CALENDAR PASSAGE ON THIRD CONSIDERATION",89,0,0,0,89
1956742,1490371,2025-02-13,Senate,"FLOOR VOTE: Motion to Adopt",31,0,0,0,31
1956746,1490478,2025-02-13,Senate,"FLOOR VOTE: Motion to Adopt",31,0,0,0,31
1956746,1498332,2025-02-24,House,"FLOOR VOTE: CONSENT CALENDAR PASSAGE ON THIRD CONSIDERATION",92,0,2,0,94
1956753,1490411,2025-02-13,Senate,"FLOOR VOTE: Motion to Adopt",31,0,0,0,31
1956753,1498328,2025-02-24,House,"FLOOR VOTE: CONSENT CALENDAR PASSAGE ON THIRD CONSIDERATION",92,0,2,0,94
1956756,1528199,2025-03-26,Senate,"SENATE ENERGY, AGRICULTURE AND NATURAL RESOURCES COMMITTEE: Recommended for passage with amendment/s, refer to Senate Finance, Ways, and Means Committee Ayes 8, Nays 0 PNV 1",8,0,1,0,9
1956759,1526646,2025-03-25,Senate,"SENATE JUDICIARY COMMITTEE: Recommended for passage with amendment/s, refer to Senate Finance, Ways, and Means Committee Ayes 9, Nays 0 PNV 0",9,0,0,0,9
1956759,1552958,2025-04-21,Senate,"SENATE FINANCE, WAYS AND MEANS COMMITTEE: Recommended for passage, refer to Senate Calendar Committee",10,1,0,0,11
1956761,1534041,2025-04-01,Senate,"SENATE JUDICIARY COMMITTEE: Recommended for passage with amendment/s, refer to Senate Finance, Ways, and Means Committee Ayes 9, Nays 0 PNV 0",9,0,0,0,9
1956761,1549313,2025-04-15,Senate,"SENATE FINANCE, WAYS AND MEANS COMMITTEE: Recommended for passage, refer to Senate Calendar Committee",9,0,1,0,10
1956776,1531624,2025-03-31,Senate,"SENATE JUDICIARY COMMITTEE: Recommended for passage with amendment/s, refer to Senate Calendar Committee Ayes 8, Nays 0 PNV 0",8,0,0,0,8
1956776,1544472,2025-04-10,Senate,"FLOOR VOTE: as Amended Third Consideration",31,0,0,0,31
1956776,1553470,2025-04-21,House,"FLOOR VOTE: REGULAR CALENDAR PASSAGE ON THIRD CONSIDERATION",90,0,0,0,90
1956784,1520919,2025-03-19,House,"HOUSE HIGHER EDUCATION SUBCOMMITTEE: Rec for pass if am by s/c ref. to Education Committee",5,0,0,0,5
1956784,1534917,2025-04-02,House,"HOUSE EDUCATION COMMITTEE: Rec. for pass. if am., ref. to Calendar & Rules Committee",19,0,0,0,19
1956789,1520856,2025-03-19,Senate,"TRANSPORTATION AND SAFETY COMMITTEE: Failed in Senate Transportation and Safety Committee",4,5,0,0,9
1956799,1526620,2025-03-25,Senate,"SENATE JUDICIARY COMMITTEE: Recommended for passage with amendment/s, refer to Senate Calendar Committee Ayes 9, Nays 0 PNV 0",9,0,0,0,9
1956799,1539417,2025-04-07,Senate,"FLOOR VOTE: as Amended Third Consideration",32,0,0,0,32
1956799,1547960,2025-04-14,House,"FLOOR VOTE: REGULAR CALENDAR PASSAGE ON THIRD CONSIDERATION",96,0,0,0,96
1956801,1522320,2025-03-19,Senate,"SENATE EDUCATION COMMITTEE: Recommended for passage, refer to Senate Calendar Committee",7,0,0,0,7
1956801,1525798,2025-03-24,Senate,"FLOOR VOTE: Motion to Adopt",32,0,0,0,32
1956801,1531422,2025-03-31,House,"FLOOR VOTE: REGULAR CALENDAR AS AMENDED PASSAGE ON THIRD CONSIDERATION",94,0,0,0,94
1956801,1535994,2025-04-03,Senate,"FLOOR VOTE: Motion to Concur House Amendment # 1",31,0,0,0,31
1956804,1494930,2025-02-19,House,"HOUSE JUDICIARY COMMITTEE: Rec. for pass; ref to Calendar & Rules Committee",18,0,0,0,18
1956804,1498024,2025-02-24,House,"FLOOR VOTE: CONSENT CALENDAR PASSAGE ON THIRD CONSIDERATION",92,0,2,0,94
1956808,1490149,2025-02-13,Senate,"FLOOR VOTE: Motion to Adopt",31,0,0,0,31
1956808,1497566,2025-02-24,House,"FLOOR VOTE: CONSENT CALENDAR PASSAGE ON THIRD CONSIDERATION",92,0,2,0,94
1956811,1520746,2025-03-18,Senate,"SENATE JUDICIARY COMMITTEE: Recommended for passage, refer to Senate Calendar Committee",7,2,0,0,9
1956811,1529483,2025-03-27,Senate,"FLOOR VOTE: Third Consideration",29,2,0,0,31
1956811,1549590,2025-04-15,House,"FLOOR VOTE: REGULAR CALENDAR AS AMENDED PASSAGE ON THIRD CONSIDERATION",89,0,4,0,93
1956811,1552477,2025-04-17,Senate,"FLOOR VOTE: Motion to Concur House Amendment # 1",33,0,0,0,33
1956823,1527660,2025-03-26,House,"HOUSE HEALTH SUBCOMMITTEE: Def. to Summer Study in Health Subcommittee",9,0,0,0,9
1956825,1518300,2025-03-11,Senate,"SENATE JUDICIARY COMMITTEE: Failed in Senate Judiciary Committee",4,5,0,0,9
1956830,1505739,2025-03-05,House,"HOUSE CRIMINAL JUSTICE SUBCOMMITTEE: Rec. for pass by s/c ref. to Judiciary Committee",6,2,0,0,8
1956830,1528350,2025-03-26,House,"HOUSE JUDICIARY COMMITTEE: Rec. for pass. if am., ref. to Calendar & Rules Committee",20,2,0,0,22
1956830,1538856,2025-04-07,House,"FLOOR VOTE: REGULAR CALENDAR AS AMENDED PASSAGE ON THIRD CONSIDERATION",85,10,0,0,95
1956830,1542086,2025-04-09,Senate,"FLOOR VOTE: Third Consideration",26,0,3,0,29
1956835,1501241,2025-02-26,Senate,"SENATE EDUCATION COMMITTEE: Recommended for passage, refer to Senate Calendar Committee",9,0,0,0,9
1956860,1500176,2025-02-26,Senate,"TRANSPORTATION AND SAFETY COMMITTEE: Recommended for passage with amendment/s, refer to Senate Calendar Committee Ayes 9, Nays 0 PNV 0",9,0,0,0,9
1956860,1514046,2025-03-03,Senate,"FLOOR VOTE: as Amended Third Consideration",31,0,0,0,31
1956860,1519192,2025-03-17,House,"FLOOR VOTE: REGULAR CALENDAR PASSAGE ON THIRD CONSIDERATION",94,0,0,0,94
1956866,1522802,2025-03-19,Senate,"SENATE EDUCATION COMMITTEE: Recommended for passage with amendment/s, refer to Senate Calendar Committee Ayes 8, Nays 0 PNV 0",8,0,0,0,8
1956866,1532541,2025-03-31,Senate,"FLOOR VOTE: as Amended Third Consideration",23,5,0,0,28
1956866,1553657,2025-04-21,House,"FLOOR VOTE: REGULAR CALENDAR PASSAGE ON THIRD CONSIDERATION",75,17,0,0,92
1956880,1505738,2025-03-05,House,"INSURANCE SUBCOMMITTEE: Rec. for pass by s/c ref. to Insurance Committee",5,0,0,0,5
1956880,1516781,2025-03-12,House,"HOUSE INSURANCE COMMITTEE: Rec. for pass; ref to Calendar & Rules Committee",17,0,0,0,17
1956880,1525638,2025-03-24,House,"FLOOR VOTE: CONSENT CALENDAR PASSAGE ON THIRD CONSIDERATION",96,0,0,0,96
1956884,1528474,2025-03-26,Senate,"SENATE EDUCATION COMMITTEE: Recommended for passage with amendment/s, refer to Senate Calendar Committee Ayes 9, Nays 0 PNV 0",9,0,0,0,9
1956884,1539259,2025-04-07,Senate,"FLOOR VOTE: as Amended Third Consideration",32,0,0,0,32
1956884,1550145,2025-04-16,House,"FLOOR VOTE: REGULAR CALENDAR PASSAGE ON THIRD CONSIDERATION",94,0,1,0,95
1956895,1498665,2025-02-25,House,"HOUSE K-12 SUBCOMMITTEE: Rec. for pass by s/c ref. to Education Committee",8,0,0,0,8
1956895,1534735,2025-04-02,House,"HOUSE EDUCATION COMMITTEE: Rec. for pass. if am., ref. to Calendar & Rules Committee",19,0,0,0,19
1956897,1527054,2025-03-25,Senate,"SENATE JUDICIARY COMMITTEE: Recommended for passage with amendment/s, refer to Senate Finance, Ways, and Means Committee Ayes 9, Nays 0 PNV 0",9,0,0,0,9
1956918,1528504,2025-03-26,Senate,"SENATE EDUCATION COMMITTEE: Recommended for passage with amendment/s, refer to Senate Finance, Ways, and Means Committee Ayes 9, Nays 0 PNV 0",9,0,0,0,9
1956925,1516839,2025-03-12,Senate,"SENATE EDUCATION COMMITTEE: Recommended for passage with amendment/s, refer to Senate Calendar Committee Ayes 7, Nays 2 PNV 0",7,2,0,0,9
1956933,1483654,2025-02-06,House,"FLOOR VOTE: CONSENT CALENDAR PASSAGE ON THIRD CONSIDERATION",89,0,0,0,89
1956933,1490532,2025-02-13,Senate,"FLOOR VOTE: Motion to Adopt",31,0,0,0,31
1956936,1534236,2025-04-02,Senate,"SENATE STATE & LOCAL GOVERNMENT COMMITTEE: Failed in Senate State and Local Government Committee",0,7,2,0,9
1956938,1494562,2025-02-19,House,"HOUSE CIVIL JUSTICE SUBCOMMITTEE: Rec. for pass by s/c ref. to Judiciary Committee",7,1,0,0,8
1956938,1500050,2025-02-26,House,"HOUSE JUDICIARY COMMITTEE: Rec. for pass; ref to Calendar & Rules Committee",14,5,0,0,19
1956978,1516148,2025-03-12,House,"HOUSE CITIES & COUNTIES SUBCOMMITTEE: Rec. for pass by s/c ref. to State & Local Government Committee",6,0,0,0,6
1956978,1521929,2025-03-19,House,"HOUSE STATE & LOCAL GOVERNMENT COMMITTEE: Rec. for pass; ref to Finance, Ways, and Means Committee",21,0,0,0,21
1956984,1513481,2025-03-11,House,"POPULATION HEALTH SUBCOMMITTEE: Rec for pass if am by s/c ref. to Health Committee",7,0,0,0,7
1956984,1533145,2025-04-01,House,"HOUSE HEALTH COMMITTEE: Rec. for pass. if am., ref. to Calendar & Rules Committee",15,6,1,0,22
1956993,1504219,2025-03-04,House,"HOUSE K-12 SUBCOMMITTEE: Rec for pass if am by s/c ref. to Education Committee",7,0,0,0,7
1956993,1534949,2025-04-02,House,"HOUSE EDUCATION COMMITTEE: Rec. for pass. if am., ref. to Calendar & Rules Committee",18,0,0,0,18
1956998,1490122,2025-02-13,Senate,"FLOOR VOTE: Motion to Adopt",31,0,0,0,31
1956998,1497792,2025-02-24,House,"FLOOR VOTE: CONSENT CALENDAR PASSAGE ON THIRD CONSIDERATION",92,0,2,0,94
1957004,1490439,2025-02-13,Senate,"FLOOR VOTE: Motion to Adopt",31,0,0,0,31
1957004,1497809,2025-02-24,House,"FLOOR VOTE: CONSENT CALENDAR PASSAGE ON THIRD CONSIDERATION",92,0,2,0,94
1957014,1505250,2025-03-04,Senate,"SENATE COMMERCE AND LABOR COMMITTEE:",8,0,0,0,8
1957014,1519613,2025-03-18,Senate,"SENATE STATE & LOCAL GOVERNMENT COMMITTEE: Recommended for passage, refer to Senate Calendar Committee",9,0,0,0,9
1957014,1526181,2025-03-24,Senate,"FLOOR VOTE: as Amended Third Consideration",33,0,0,0,33
1957014,1529548,2025-03-27,House,"FLOOR VOTE: REGULAR CALENDAR PASSAGE ON THIRD CONSIDERATION",94,0,0,0,94
1957020,1500821,2025-02-26,Senate,"SENATE ENERGY, AGRICULTURE AND NATURAL RESOURCES COMMITTEE: Recommended for passage, refer to Senate Calendar Committee",9,0,0,0,9
1957020,1540768,2025-04-08,Senate,"SENATE FINANCE, WAYS AND MEANS COMMITTEE: Recommended for passage, refer to Senate Calendar Committee",9,0,0,0,9
1957020,1548117,2025-04-14,Senate,"FLOOR VOTE: Motion to Adopt",32,0,0,0,32
1957020,1553479,2025-04-21,House,"FLOOR VOTE: REGULAR CALENDAR PASSAGE ON THIRD CONSIDERATION",92,0,0,0,92
1957027,1494572,2025-02-19,House,"HOUSE HIGHER EDUCATION SUBCOMMITTEE: Rec. for pass by s/c ref. to Education Committee",5,0,0,0,5
1957046,1527603,2025-03-26,Senate,"SENATE ENERGY, AGRICULTURE AND NATURAL RESOURCES COMMITTEE: Recommended for passage with amendment/s, refer to Senate Calendar Committee Ayes 9, Nays 0 PNV 0",9,0,0,0,9
1957061,1490100,2025-02-13,Senate,"FLOOR VOTE: Motion to Adopt",31,0,0,0,31
1957061,1498298,2025-02-24,House,"FLOOR VOTE: CONSENT CALENDAR PASSAGE ON THIRD CONSIDERATION",92,0,2,0,94
1957064,1516051,2025-03-11,Senate,"SENATE STATE & LOCAL GOVERNMENT COMMITTEE: Recommended for passage with amendment/s, refer to Senate Calendar Committee Ayes 7, Nays 2 PNV 0",7,2,0,0,9
1957064,1525803,2025-03-24,Senate,"FLOOR VOTE: as Amended Third Consideration",27,6,0,0,33
1957064,1550583,2025-04-16,House,"FLOOR VOTE: REGULAR CALENDAR PASSAGE ON THIRD CONSIDERATION",70,24,0,0,94
1957064,1550584,2025-04-16,House,"FLOOR VOTE: REGULAR CALENDAR PREVIOUS QUESTION PASSAGE ON THIRD CONSIDERATION",71,23,0,0,94
1957070,1505804,2025-03-04,Senate,"SENATE JUDICIARY COMMITTEE: Recommended for passage, refer to Senate Calendar Committee",7,2,0,0,9
1957070,1522645,2025-03-20,Senate,"FLOOR VOTE: Third Consideration",27,0,2,0,29
1957070,1544169,2025-04-10,House,"FLOOR VOTE: REGULAR CALENDAR PASSAGE ON THIRD CONSIDERATION",80,10,2,0,92
1957072,1526218,2025-03-25,Senate,"SENATE JUDICIARY COMMITTEE: Recommended for passage with amendment/s, refer to Senate Calendar Committee Ayes 9, Nays 0 PNV 0",9,0,0,0,9
1957072,1536052,2025-04-03,Senate,"FLOOR VOTE: as Amended Third Consideration",31,0,0,0,31
1957072,1550592,2025-04-16,House,"FLOOR VOTE: REGULAR CALENDAR PASSAGE ON THIRD CONSIDERATION",92,0,0,0,92
1957081,1490102,2025-02-13,Senate,"FLOOR VOTE: Motion to Adopt",31,0,0,0,31
1957081,1498237,2025-02-24,House,"FLOOR VOTE: CONSENT CALENDAR PASSAGE ON THIRD CONSIDERATION",92,0,2,0,94
1957088,1500598,2025-02-26,Senate,"SENATE HEALTH AND WELFARE COMMITTEE: Recommended for passage with amendment/s, refer to Senate Calendar Committee Ayes 7, Nays 1 PNV 0",7,1,0,0,8
1957088,1514363,2025-03-06,Senate,"FLOOR VOTE: as Amended Third Consideration",27,3,0,0,30
1957088,1538800,2025-04-07,House,"FLOOR VOTE: REGULAR CALENDAR AS AMENDED PASSAGE ON THIRD CONSIDERATION",71,24,0,0,95
1957088,1538801,2025-04-07,House,"FLOOR VOTE: REGULAR CALENDAR PREVIOUS QUESTION AS AMENDED PASSAGE ON THIRD CONSIDERATION",71,22,0,0,93
1957088,1548185,2025-04-14,Senate,"FLOOR VOTE: Motion to Concur House Amendment # 1",25,6,0,0,31
1957108,1521865,2025-03-19,House,"HOUSE BANKING AND CONSUMER AFFAIRS SUBCOMMITTEE: Failed in s/c Banking and Consumer Affairs Subcommittee of Commerce Committee",2,4,0,0,6
1957112,1514734,2025-03-11,Senate,"SENATE COMMERCE AND LABOR COMMITTEE: Recommended for passage, refer to Senate Calendar Committee",9,0,0,0,9
1957121,1515421,2025-03-11,Senate,"SENATE COMMERCE AND LABOR COMMITTEE: Recommended for passage, refer to Senate Calendar Committee",8,0,0,0,8
1957121,1519570,2025-03-17,Senate,"FLOOR VOTE: Motion to Adopt",32,0,0,0,32
1957138,1506341,2025-03-05,Senate,"SENATE HEALTH AND WELFARE COMMITTEE: Recommended for passage, refer to Senate Calendar Committee",8,1,0,0,9
1957138,1517045,2025-03-13,Senate,"FLOOR VOTE: as Amended Third Consideration",25,6,0,0,31
1957142,1521129,2025-03-18,Senate,"SENATE JUDICIARY COMMITTEE: Recommended for passage with amendment/s, refer to Senate Calendar Committee Ayes 9, Nays 0 PNV 0",9,0,0,0,9
1957142,1529464,2025-03-27,Senate,"FLOOR VOTE: as Amended Third Consideration",30,0,1,0,31
1957142,1538980,2025-04-07,House,"FLOOR VOTE: REGULAR CALENDAR PASSAGE ON THIRD CONSIDERATION",96,0,0,0,96
1957144,1490106,2025-02-13,Senate,"FLOOR VOTE: Motion to Adopt",31,0,0,0,31
1957144,1497545,2025-02-24,House,"FLOOR VOTE: CONSENT CALENDAR PASSAGE ON THIRD CONSIDERATION",92,0,2,0,94
1957151,1490435,2025-02-13,Senate,"FLOOR VOTE: Motion to Adopt",31,0,0,0,31
1957151,1498447,2025-02-24,House,"FLOOR VOTE: CONSENT CALENDAR PASSAGE ON THIRD CONSIDERATION",92,0,2,0,94
1957156,1516412,2025-03-12,House,"HOUSE HEALTH SUBCOMMITTEE: Rec for pass if am by s/c ref. to Health Committee",7,2,0,0,9
1957156,1526335,2025-03-25,House,"HOUSE HEALTH COMMITTEE: Rec. for pass. if am., ref. to Calendar & Rules Committee",16,5,1,0,22
1957161,1527691,2025-03-26,Senate,"SENATE ENERGY, AGRICULTURE AND NATURAL RESOURCES COMMITTEE: Recommended for passage, refer to Senate Finance, Ways, and Means Committee",8,1,0,0,9
1957161,1542013,2025-04-09,Senate,"SENATE FINANCE, WAYS AND MEANS COMMITTEE: Recommended for passage, refer to Senate Calendar Committee",11,0,0,0,11
1957171,1520285,2025-03-18,House,"HOUSE EDUCATION ADMINISTRATION SUBCOMMITTEE: Rec for pass if am by s/c ref. to Education Committee",6,0,0,0,6
1957171,1526364,2025-03-25,House,"HOUSE EDUCATION COMMITTEE: Rec. for pass. if am., ref. to Calendar & Rules Committee",18,0,0,0,18
1957171,1530932,2025-03-31,House,"FLOOR VOTE: REGULAR CALENDAR AS AMENDED PASSAGE ON THIRD CONSIDERATION",95,0,0,0,95
1957175,1483653,2025-02-06,House,"FLOOR VOTE: CONSENT CALENDAR PASSAGE ON THIRD CONSIDERATION",89,0,0,0,89
1957175,1490572,2025-02-13,Senate,"FLOOR VOTE: Motion to Adopt",31,0,0,0,31
1957179,1535275,2025-04-02,Senate,"SENATE STATE & LOCAL GOVERNMENT COMMITTEE: Recommended for passage with amendment/s, refer to Senate Calendar Committee Ayes 8, Nays 1 PNV 0",8,1,0,0,9
1957179,1544485,2025-04-10,Senate,"FLOOR VOTE: as Amended Third Consideration",31,0,0,0,31
1957179,1550223,2025-04-16,House,"FLOOR VOTE: REGULAR CALENDAR PASSAGE ON THIRD CONSIDERATION",89,0,0,0,89
1957202,1522338,2025-03-19,Senate,"SENATE EDUCATION COMMITTEE: Recommended for passage with amendment/s, refer to Senate Calendar Committee Ayes 7, Nays 0 PNV 0",7,0,0,0,7
1957202,1528720,2025-03-27,Senate,"FLOOR VOTE: as Amended Third Consideration",27,5,0,0,32
1957202,1554724,2025-04-22,House,"FLOOR VOTE: REGULAR CALENDAR AS AMENDED PASSAGE ON THIRD CONSIDERATION",74,23,0,0,97
1957202,1554725,2025-04-22,House,"FLOOR VOTE: REGULAR CALENDAR PREVIOUS QUESTION AS AMENDED PASSAGE ON THIRD CONSIDERATION",73,23,0,0,96
1957202,1556924,2025-04-22,Senate,"FLOOR VOTE: Motion to Concur House Amendment # 1",25,4,0,0,29
1957208,1520965,2025-03-19,Senate,"TRANSPORTATION AND SAFETY COMMITTEE: Recommended for passage with amendment/s, refer to Senate Calendar Committee Ayes 9, Nays 0 PNV 0",9,0,0,0,9
1957208,1529484,2025-03-27,Senate,"FLOOR VOTE: as Amended Third Consideration",32,0,0,0,32
1957208,1538604,2025-04-07,House,"FLOOR VOTE: REGULAR CALENDAR PASSAGE ON THIRD CONSIDERATION",93,0,2,0,95
1957209,1515979,2025-03-12,Senate,"SENATE ENERGY, AGRICULTURE AND NATURAL RESOURCES COMMITTEE: Recommended for passage with amendment/s, refer to Senate Finance, Ways, and Means Committee Ayes 9, Nays 0 PNV 0",9,0,0,0,9
1957237,1483487,2025-02-06,House,"FLOOR VOTE: CONSENT CALENDAR PASSAGE ON THIRD CONSIDERATION",89,0,0,0,89
1957237,1489962,2025-02-13,Senate,"FLOOR VOTE: Motion to Adopt",31,0,0,0,31
1957239,1490208,2025-02-13,Senate,"FLOOR VOTE: Motion to Adopt",31,0,0,0,31
1957239,1498081,2025-02-24,House,"FLOOR VOTE: CONSENT CALENDAR PASSAGE ON THIRD CONSIDERATION",92,0,2,0,94
1957244,1498798,2025-02-25,House,"HOUSE TRANSPORTATION SUBCOMMITTEE: Rec for pass if am by s/c ref. to Transportation Committee",7,2,0,0,9
1957244,1513361,2025-03-11,House,"HOUSE TRANSPORTATION COMMITTEE: Rec. for pass. if am., ref. to Finance, Ways, and Means Committee",14,2,2,0,18
1957247,1552808,2025-04-21,Senate,"SENATE FINANCE, WAYS AND MEANS COMMITTEE: Recommended for passage with amendment/s, refer to Senate Calendar Committee Ayes 11, Nays 0 PNV 0",11,0,0,0,11
1957247,1554401,2025-04-22,House,"FLOOR VOTE: REGULAR CALENDAR PASSAGE ON THIRD CONSIDERATION",95,2,0,0,97
1957247,1557185,2025-04-22,Senate,"FLOOR VOTE: as Amended Third Consideration",32,0,0,0,32
1957260,1521935,2025-03-19,Senate,"SENATE HEALTH AND WELFARE COMMITTEE: Recommended for passage with amendment/s, refer to Senate Calendar Committee Ayes 9, Nays 0 PNV 0",9,0,0,0,9
1957260,1529480,2025-03-27,Senate,"FLOOR VOTE: as Amended Third Consideration",32,0,0,0,32
1957260,1553697,2025-04-21,House,"FLOOR VOTE: REGULAR CALENDAR PASSAGE ON THIRD CONSIDERATION",81,5,7,0,93
1957265,1500091,2025-02-26,House,"HOUSE CIVIL JUSTICE SUBCOMMITTEE: Rec. for pass by s/c ref. to Judiciary Committee",8,0,0,0,8
1957265,1520972,2025-03-19,House,"HOUSE JUDICIARY COMMITTEE: Rec. for pass. if am., ref. to Calendar & Rules Committee",20,0,2,0,22
1957270,1528503,2025-03-26,Senate,"SENATE EDUCATION COMMITTEE: Recommended for passage with amendment/s, refer to Senate Calendar Committee Ayes 8, Nays 1 PNV 0",8,1,0,0,9
1957270,1539354,2025-04-07,Senate,"FLOOR VOTE: as Amended Third Consideration",30,1,0,0,31
1957270,1547787,2025-04-14,House,"FLOOR VOTE: REGULAR CALENDAR PASSAGE ON THIRD CONSIDERATION",82,13,0,0,95
1957273,1532755,2025-04-01,House,"HOUSE CRIMINAL JUSTICE SUBCOMMITTEE: Rec for pass if am by s/c ref. to Judiciary Committee",9,0,0,0,9
1957273,1539436,2025-04-08,House,"HOUSE JUDICIARY COMMITTEE: Rec. for pass. if am., ref. to Finance, Ways, and Means Committee",19,0,0,0,19
1957275,1525957,2025-03-25,House,"HOUSE K-12 SUBCOMMITTEE: Failed in s/c K-12 Subcommittee of Education Committee",3,3,0,0,6
1957283,1490325,2025-02-13,Senate,"FLOOR VOTE: Motion to Adopt",31,0,0,0,31
1957283,1498441,2025-02-24,House,"FLOOR VOTE: CONSENT CALENDAR PASSAGE ON THIRD CONSIDERATION",92,0,2,0,94
1957296,1520936,2025-03-18,Senate,"SENATE COMMERCE AND LABOR COMMITTEE: Recommended for passage, refer to Senate Calendar Committee",8,0,0,0,8
1957296,1525871,2025-03-24,Senate,"FLOOR VOTE: Motion to Adopt",32,0,0,0,32
1957313,1535252,2025-04-02,Senate,"SENATE STATE & LOCAL GOVERNMENT COMMITTEE: Recommended for passage, refer to Senate Finance, Ways, and Means Committee",9,0,0,0,9
1957321,1528487,2025-03-26,Senate,"SENATE EDUCATION COMMITTEE: Recommended for passage with amendment/s, refer to Senate Calendar Committee Ayes 8, Nays 1 PNV 0",8,1,0,0,9
1957321,1536123,2025-04-03,Senate,"FLOOR VOTE: as Amended Third Consideration",25,5,0,0,30
1957321,1550663,2025-04-16,House,"FLOOR VOTE: REGULAR CALENDAR AS AMENDED PASSAGE ON THIRD CONSIDERATION",77,18,0,0,95
1957321,1550664,2025-04-16,House,"FLOOR VOTE: REGULAR CALENDAR MOTION TO CONSIDER AMENDMENT # 2 BY PEARSON AS AMENDED PASSAGE ON THIRD CONSIDERATION",20,70,0,0,90
1957321,1550665,2025-04-16,House,"FLOOR VOTE: REGULAR CALENDAR MOTION TO CONSIDER AMENDMENT # 3 BY PEARSON AS AMENDED PASSAGE ON THIRD CONSIDERATION",22,69,0,0,91
1957321,1550666,2025-04-16,House,"FLOOR VOTE: REGULAR CALENDAR MOTION TO CONSIDER AMENDMENT # 4 BY PEARSON AS AMENDED PASSAGE ON THIRD CONSIDERATION",21,72,0,0,93
1957321,1550667,2025-04-16,House,"FLOOR VOTE: REGULAR CALENDAR MOTION TO CONSIDER AMENDMENT # 5 BY JONES J AS AMENDED PASSAGE ON THIRD CONSIDERATION",20,73,0,0,93
1957321,1552728,2025-04-21,Senate,"FLOOR VOTE: Motion to Concur House Amendment # 1",27,6,0,0,33
1957330,1513792,2025-03-11,House,"HOUSE EDUCATION ADMINISTRATION SUBCOMMITTEE: Rec for pass if am by s/c ref. to Education Committee",6,0,0,0,6
1957343,1520835,2025-03-18,Senate,"SENATE JUDICIARY COMMITTEE: Recommended for passage with amendment/s, refer to Senate Calendar Committee Ayes 7, Nays 1 PNV 0",7,1,0,0,8
1957369,1504194,2025-03-04,House,"HOUSE TENNCARE SUBCOMMITTEE: Rec for pass if am by s/c ref. to Insurance Committee",6,0,0,0,6
1957369,1516437,2025-03-12,House,"HOUSE INSURANCE COMMITTEE: Rec. for pass. if am., ref. to Calendar & Rules Committee",16,0,0,0,16
1957375,1490528,2025-02-13,Senate,"FLOOR VOTE: Motion to Adopt",31,0,0,0,31
1957375,1497870,2025-02-24,House,"FLOOR VOTE: CONSENT CALENDAR PASSAGE ON THIRD CONSIDERATION",92,0,2,0,94
1957382,1534555,2025-04-02,Senate,"SENATE STATE & LOCAL GOVERNMENT COMMITTEE: Recommended for passage with amendment/s, refer to Senate Calendar Committee Ayes 5, Nays 4 PNV 0",5,4,0,0,9
1957398,1515641,2025-03-11,Senate,"SENATE JUDICIARY COMMITTEE: Recommended for passage, refer to Senate Calendar Committee",9,0,0,0,9
1957408,1536675,2025-04-02,Senate,"SENATE JUDICIARY COMMITTEE: Recommended for passage with amendment/s, refer to Senate Calendar Committee Ayes 8, Nays 0 PNV 0",8,0,0,0,8
1957413,1521138,2025-03-19,House,"HOUSE CRIMINAL JUSTICE SUBCOMMITTEE: Rec for pass if am by s/c ref. to Judiciary Committee",8,0,0,0,8
1957413,1534174,2025-04-02,House,"HOUSE JUDICIARY COMMITTEE: Rec. for pass. if am., ref. to Calendar & Rules Committee",20,0,0,0,20
1957424,1525940,2025-03-25,House,"HOUSE K-12 SUBCOMMITTEE: Rec for pass if am by s/c ref. to Education Committee",7,0,0,0,7
1957424,1534594,2025-04-02,House,"HOUSE EDUCATION COMMITTEE: Rec. for pass. if am., ref. to Calendar & Rules Committee",18,1,0,0,19
1957430,1505124,2025-03-04,Senate,"SENATE STATE & LOCAL GOVERNMENT COMMITTEE: Recommended for passage with amendment/s, refer to Senate Calendar Committee Ayes 8, Nays 1 PNV 0",8,1,0,0,9
1957455,1535257,2025-04-02,Senate,"SENATE STATE & LOCAL GOVERNMENT COMMITTEE: Recommended for passage, refer to Senate Calendar Committee",9,0,0,0,9
1957455,1539275,2025-04-07,Senate,"FLOOR VOTE: Motion to Adopt",31,0,0,0,31
1957470,1501224,2025-02-26,Senate,"SENATE EDUCATION COMMITTEE: Recommended for passage with amendment/s, refer to Senate Calendar Committee Ayes 9, Nays 0 PNV 0",9,0,0,0,9
1957470,1514812,2025-03-06,Senate,"FLOOR VOTE: as Amended Third Consideration",29,0,0,0,29
1957470,1554346,2025-04-22,House,"FLOOR VOTE: REGULAR CALENDAR AS AMENDED PASSAGE ON THIRD CONSIDERATION",70,22,1,0,93
1957470,1556673,2025-04-22,Senate,"FLOOR VOTE: Motion to Concur House Amendment # 2",25,0,0,0,25
1957475,1526130,2025-03-25,Senate,"SENATE STATE & LOCAL GOVERNMENT COMMITTEE: Recommended for passage with amendment/s, refer to Senate Finance, Ways, and Means Committee Ayes 8, Nays 0 PNV 0",8,0,0,0,8
1957475,1540916,2025-04-08,Senate,"SENATE FINANCE, WAYS AND MEANS COMMITTEE: Recommended for passage, refer to Senate Calendar Committee",10,0,0,0,10
1957475,1548218,2025-04-14,Senate,"FLOOR VOTE: as Amended Third Consideration",29,0,0,0,29
1957475,1550724,2025-04-16,House,"FLOOR VOTE: REGULAR CALENDAR PASSAGE ON THIRD CONSIDERATION",91,0,0,0,91
1957505,1514028,2025-03-11,House,"HOUSE DEPARTMENTS & AGENCIES SUBCOMMITTEE: Rec for pass if am by s/c ref. to State & Local Government Committee",8,0,0,0,8
1957505,1528377,2025-03-26,House,"HOUSE STATE & LOCAL GOVERNMENT COMMITTEE: Rec. for pass. if am., ref. to Finance, Ways, and Means Committee",22,0,0,0,22
1957505,1551950,2025-04-17,House,"HOUSE FINANCE, WAYS, AND MEANS SUBCOMMITTEE: Rec. for pass by s/c ref. to Finance, Ways, and Means Committee",11,0,0,0,11
1957505,1553446,2025-04-17,House,"HOUSE FINANCE, WAYS, AND MEANS COMMITTEE: Rec. for pass. if am., ref. to Calendar & Rules Committee",26,0,0,0,26
1957505,1553447,2025-04-17,House,"HOUSE FINANCE, WAYS, AND MEANS COMMITTEE: Rec. for pass; ref to Calendar & Rules Committee",27,0,0,0,27
1957511,1483427,2025-02-06,House,"FLOOR VOTE: CONSENT CALENDAR PASSAGE ON THIRD CONSIDERATION",89,0,0,0,89
1957511,1490433,2025-02-13,Senate,"FLOOR VOTE: Motion to Adopt",31,0,0,0,31
1957518,1505659,2025-03-04,Senate,"SENATE JUDICIARY COMMITTEE: Recommended for passage, refer to Senate Calendar Committee",9,0,0,0,9
1957518,1515314,2025-03-10,Senate,"FLOOR VOTE: Motion to Adopt",30,0,0,0,30
1957533,1504043,2025-03-03,House,"HOUSE NAMING & DESIGNATING COMMITTEE: Rec. for pass; ref to State & Local Government Committee",9,0,1,0,10
1957533,1528397,2025-03-26,House,"HOUSE STATE & LOCAL GOVERNMENT COMMITTEE: Rec. for pass; ref to Calendar & Rules Committee",19,1,0,0,20
1957533,1530942,2025-03-31,House,"FLOOR VOTE: CONSENT CALENDAR PASSAGE ON THIRD CONSIDERATION",93,0,2,0,95
1957536,1527525,2025-03-26,House,"HOUSE CIVIL JUSTICE SUBCOMMITTEE: Rec for pass if am by s/c ref. to Judiciary Committee",5,1,0,0,6
1957536,1534230,2025-04-02,House,"HOUSE JUDICIARY COMMITTEE: Rec. for pass. if am., ref. to State & Local Government Committee",15,4,0,0,19
1957536,1540221,2025-04-08,House,"HOUSE STATE & LOCAL GOVERNMENT COMMITTEE: Rec. for pass; ref to Calendar & Rules Committee",17,6,0,0,23
1957536,1550463,2025-04-16,House,"FLOOR VOTE: REGULAR CALENDAR AS AMENDED PASSAGE ON THIRD CONSIDERATION",73,24,0,0,97
1957536,1550464,2025-04-16,House,"FLOOR VOTE: REGULAR CALENDAR PREVIOUS QUESTION AS AMENDED PASSAGE ON THIRD CONSIDERATION",71,24,0,0,95
1957536,1552620,2025-04-21,Senate,"FLOOR VOTE: as Amended Third Consideration",27,6,0,0,33
1957536,1553964,2025-04-22,House,"FLOOR VOTE: MESSAGE CALENDAR MOTION TO ADOPT CONFERENCE COMMITTEE REPORT",74,21,0,0,95
1957536,1556474,2025-04-22,Senate,"FLOOR VOTE: Motion to Adopt Appoint Conference Committee",26,6,0,0,32
1957541,1499976,2025-02-26,House,"HOUSE PUBLIC SERVICE SUBCOMMITTEE: Rec for pass if am by s/c ref. to State & Local Government Committee",5,0,0,0,5
1957541,1506052,2025-03-05,House,"HOUSE STATE & LOCAL GOVERNMENT COMMITTEE: Rec. for pass. if am., ref. to Calendar & Rules Committee",22,0,0,0,22
1957541,1509278,2025-03-10,House,"FLOOR VOTE: REGULAR CALENDAR AS AMENDED PASSAGE ON THIRD CONSIDERATION",94,0,0,0,94
1957541,1519329,2025-03-17,Senate,"FLOOR VOTE: Third Consideration",31,0,0,0,31
1957567,1525574,2025-03-24,Senate,"SENATE JUDICIARY COMMITTEE: Recommended for passage, refer to Senate Calendar Committee",9,0,0,0,9
1957567,1528785,2025-03-27,Senate,"FLOOR VOTE: Motion to Adopt",27,0,0,0,27
1957572,1521773,2025-03-19,House,"HOUSE CITIES & COUNTIES SUBCOMMITTEE: Rec for pass if am by s/c ref. to State & Local Government Committee",7,0,0,0,7
1957572,1540104,2025-04-08,House,"HOUSE STATE & LOCAL GOVERNMENT COMMITTEE: Rec. for pass. if am., ref. to Finance, Ways, and Means Committee",22,0,0,0,22
1957572,1547127,2025-04-14,House,"HOUSE FINANCE, WAYS, AND MEANS SUBCOMMITTEE: Rec. for pass by s/c ref. to Finance, Ways, and Means Committee",12,0,0,0,12
1957572,1549005,2025-04-15,House,"HOUSE FINANCE, WAYS, AND MEANS COMMITTEE: Rec. for pass; ref to Calendar & Rules Committee",26,0,0,0,26
1957572,1550274,2025-04-16,House,"FLOOR VOTE: REGULAR CALENDAR AS AMENDED PASSAGE ON THIRD CONSIDERATION",90,1,0,0,91
1957572,1552433,2025-04-17,Senate,"FLOOR VOTE: Third Consideration",30,2,0,0,32
1957580,1520362,2025-03-18,House,"HOUSE EDUCATION ADMINISTRATION SUBCOMMITTEE: Rec. for pass by s/c ref. to Education Committee",6,0,0,0,6
1957580,1526025,2025-03-25,House,"HOUSE EDUCATION COMMITTEE: Rec. for pass; ref to Calendar & Rules Committee",17,0,0,0,17
1957580,1536267,2025-04-03,House,"FLOOR VOTE: REGULAR CALENDAR MOTION TO ADOPT",85,0,0,0,85
1957586,1495147,2025-02-19,House,"HOUSE BUSINESS AND UTILITIES SUBCOMMITTEE: Rec for pass if am by s/c ref. to Commerce Committee",8,2,0,0,10
1957586,1499774,2025-02-26,House,"HOUSE COMMERCE COMMITTEE: Rec. for pass. if am., ref. to Calendar & Rules Committee",17,4,0,0,21
1957586,1503447,2025-03-03,House,"FLOOR VOTE: REGULAR CALENDAR AS AMENDED PASSAGE ON THIRD CONSIDERATION",72,17,0,0,89
1957586,1525779,2025-03-24,Senate,"FLOOR VOTE: Third Consideration",27,6,0,0,33
1957595,1534680,2025-04-02,Senate,"SENATE STATE & LOCAL GOVERNMENT COMMITTEE: Recommended for passage, refer to Senate Calendar Committee",7,1,0,0,8
1957598,1515669,2025-03-12,House,"HOUSE CRIMINAL JUSTICE SUBCOMMITTEE: Rec for pass if am by s/c ref. to Judiciary Committee",7,0,0,0,7
1957598,1521702,2025-03-19,House,"HOUSE JUDICIARY COMMITTEE: Rec. for pass. if am., ref. to Finance, Ways, and Means Committee",22,0,0,0,22
1957598,1551783,2025-04-17,House,"HOUSE FINANCE, WAYS, AND MEANS SUBCOMMITTEE: Rec. for pass by s/c ref. to Finance, Ways, and Means Committee",11,0,0,0,11
1957598,1553232,2025-04-17,House,"HOUSE FINANCE, WAYS, AND MEANS COMMITTEE: Rec. for pass; ref to Calendar & Rules Committee",27,0,0,0,27
1957598,1553233,2025-04-21,House,"FLOOR VOTE: REGULAR CALENDAR AS AMENDED PASSAGE ON THIRD CONSIDERATION",67,12,8,0,87
1957598,1556833,2025-04-22,Senate,"FLOOR VOTE: Third Consideration",23,8,0,0,31
1957602,1516114,2025-03-12,House,"HOUSE CRIMINAL JUSTICE SUBCOMMITTEE: Rec for pass if am by s/c ref. to Judiciary Committee",6,0,1,0,7
1957602,1521912,2025-03-19,House,"HOUSE JUDICIARY COMMITTEE: Rec. for pass. if am., ref. to Finance, Ways, and Means Committee",21,0,1,0,22
1957602,1552008,2025-04-17,House,"HOUSE FINANCE, WAYS, AND MEANS SUBCOMMITTEE: Rec for pass if am by s/c ref. to Finance, Ways, and Means Committee",11,0,0,0,11
1957602,1553539,2025-04-17,House,"HOUSE FINANCE, WAYS, AND MEANS COMMITTEE: Rec. for pass. if am., ref. to Calendar & Rules Committee",28,0,0,0,28
1957602,1553540,2025-04-17,House,"HOUSE FINANCE, WAYS, AND MEANS COMMITTEE: Rec. for pass; ref to Calendar & Rules Committee",27,0,0,0,27
1957602,1553541,2025-04-21,House,"FLOOR VOTE: REGULAR CALENDAR AS AMENDED PASSAGE ON THIRD CONSIDERATION",93,0,1,0,94
1957602,1556505,2025-04-22,Senate,"FLOOR VOTE: Third Consideration",30,2,0,0,32
1957606,1519390,2025-03-18,House,"HOUSE K-12 SUBCOMMITTEE: Rec. for pass by s/c ref. to Education Committee",8,0,0,0,8
1957606,1534877,2025-04-02,House,"HOUSE EDUCATION COMMITTEE: Rec. for pass; ref to Calendar & Rules Committee",17,0,1,0,18
1957623,1500074,2025-02-26,House,"HOUSE CRIMINAL JUSTICE SUBCOMMITTEE: Rec. for pass by s/c ref. to Judiciary Committee",9,0,0,0,9
1957623,1506391,2025-03-05,House,"HOUSE JUDICIARY COMMITTEE: Rec. for pass. if am., ref. to Finance, Ways, and Means Committee",16,0,0,0,16
1957623,1551795,2025-04-17,House,"HOUSE FINANCE, WAYS, AND MEANS SUBCOMMITTEE: Rec. for pass by s/c ref. to Finance, Ways, and Means Committee",11,0,0,0,11
1957623,1553260,2025-04-17,House,"HOUSE FINANCE, WAYS, AND MEANS COMMITTEE: Rec. for pass; ref to Calendar & Rules Committee",27,0,0,0,27
1957650,1522316,2025-03-19,Senate,"SENATE EDUCATION COMMITTEE: Recommended for passage with amendment/s, refer to Senate Calendar Committee Ayes 8, Nays 0 PNV 0",8,0,0,0,8
1957658,1519950,2025-03-18,Senate,"SENATE STATE & LOCAL GOVERNMENT COMMITTEE: Recommended for passage, refer to Senate Calendar Committee",9,0,0,0,9
1957669,1536655,2025-04-02,Senate,"SENATE JUDICIARY COMMITTEE: Recommended for passage, refer to Senate Calendar Committee",8,0,1,0,9
1957694,1533924,2025-04-01,Senate,"SENATE JUDICIARY COMMITTEE: Recommended for passage, refer to Senate Calendar Committee",6,2,0,0,8
1957721,1500150,2025-02-26,House,"HOUSE BUSINESS AND UTILITIES SUBCOMMITTEE: Rec. for pass by s/c ref. to Commerce Committee",11,0,0,0,11
1957721,1506577,2025-03-05,House,"HOUSE COMMERCE COMMITTEE: Rec. for pass; ref to Calendar & Rules Committee",17,0,0,0,17
1957721,1517084,2025-03-13,House,"FLOOR VOTE: REGULAR CALENDAR PASSAGE ON THIRD CONSIDERATION",76,13,1,0,90
1957721,1535864,2025-04-03,Senate,"FLOOR VOTE: Third Consideration",25,5,0,0,30
1957725,1515645,2025-03-11,Senate,"SENATE JUDICIARY COMMITTEE: Recommended for passage, refer to Senate Calendar Committee",9,0,0,0,9
1957725,1519457,2025-03-17,Senate,"FLOOR VOTE: Motion to Adopt",32,0,0,0,32
1957738,1528406,2025-03-26,House,"HOUSE AGRICULTURE AND NATURAL RESOURCES SUBCOMMITTEE: Rec for pass if am by s/c ref. to Agriculture & Natural Resources Committee",6,2,0,0,8
1957738,1532242,2025-04-01,House,"HOUSE AGRICULTURE & NATURAL RESOURCES COMMITTEE: Rec. for pass. if am., ref. to Finance, Ways, and Means Committee",8,6,1,0,15
1957740,1500054,2025-02-26,House,"HOUSE FINANCE, WAYS, AND MEANS SUBCOMMITTEE: Rec. for pass by s/c ref. to Finance, Ways, and Means Committee",11,0,0,0,11
1957740,1504646,2025-03-04,House,"HOUSE FINANCE, WAYS, AND MEANS COMMITTEE: Rec. for pass; ref to Calendar & Rules Committee",23,0,1,0,24
1957740,1517377,2025-03-13,House,"FLOOR VOTE: REGULAR CALENDAR PASSAGE ON THIRD CONSIDERATION",87,2,1,0,90
1957740,1517378,2025-03-13,House,"FLOOR VOTE: REGULAR CALENDAR PREVIOUS QUESTION PASSAGE ON THIRD CONSIDERATION",69,21,0,0,90
1957740,1536326,2025-04-03,Senate,"FLOOR VOTE: as Amended Third Consideration",30,0,0,0,30
1957740,1553366,2025-04-21,House,"FLOOR VOTE: MESSAGE CALENDAR CONCUR IN SENATE AMENDMENT # 1",70,24,1,0,95
1957749,1515736,2025-03-12,Senate,"TRANSPORTATION AND SAFETY COMMITTEE: Recommended for passage with amendment/s, refer to Senate Calendar Committee Ayes 8, Nays 1 PNV 0",8,1,0,0,9
1957763,1534056,2025-04-01,Senate,"SENATE JUDICIARY COMMITTEE: Recommended for passage with amendment/s, refer to Senate Calendar Committee Ayes 8, Nays 1 PNV 0",8,1,0,0,9
1957763,1547886,2025-04-14,House,"FLOOR VOTE: REGULAR CALENDAR PASSAGE ON THIRD CONSIDERATION",92,0,1,0,93
1957763,1548025,2025-04-14,Senate,"FLOOR VOTE: as Amended Third Consideration",30,0,0,0,30
1957768,1527675,2025-03-26,House,"HOUSE HIGHER EDUCATION SUBCOMMITTEE: Rec for pass if am by s/c ref. to Education Committee",5,0,0,0,5
1957768,1532164,2025-04-01,House,"HOUSE EDUCATION COMMITTEE: Rec. for pass. if am., ref. to Finance, Ways, and Means Committee",17,0,1,0,18
1957773,1527265,2025-03-25,Senate,"SENATE COMMERCE AND LABOR COMMITTEE: Recommended for passage with amendment/s, refer to Senate Calendar Committee Ayes 9, Nays 0 PNV 0",9,0,0,0,9
1957776,1528058,2025-03-26,House,"HOUSE K-12 SUBCOMMITTEE: Failed in s/c K-12 Subcommittee of Education Committee",2,4,0,0,6
1957790,1505093,2025-03-04,Senate,"SENATE STATE & LOCAL GOVERNMENT COMMITTEE: Recommended for passage, refer to Senate Calendar Committee",9,0,0,0,9
1957790,1514674,2025-03-10,Senate,"FLOOR VOTE: Motion to Adopt",30,0,0,0,30
1957790,1551079,2025-04-17,House,"FLOOR VOTE: REGULAR CALENDAR PASSAGE ON THIRD CONSIDERATION",82,11,3,0,96
1957791,1522410,2025-03-19,Senate,"SENATE EDUCATION COMMITTEE: Recommended for passage, refer to Senate Finance, Ways, and Means Committee",8,0,0,0,8
1957791,1549691,2025-04-16,Senate,"SENATE FINANCE, WAYS AND MEANS COMMITTEE: Recommended for passage, refer to Senate Calendar Committee",9,2,0,0,11
1957800,1525918,2025-03-25,House,"HOUSE K-12 SUBCOMMITTEE: Failed in s/c K-12 Subcommittee of Education Committee",2,6,0,0,8
1957805,1528381,2025-03-26,House,"HOUSE AGRICULTURE AND NATURAL RESOURCES SUBCOMMITTEE: Rec. for pass by s/c ref. to Agriculture & Natural Resources Committee",9,0,0,0,9
1957805,1532774,2025-04-01,House,"HOUSE AGRICULTURE & NATURAL RESOURCES COMMITTEE: Rec. for pass. if am., ref. to Calendar & Rules Committee",15,0,0,0,15
1957808,1527218,2025-03-26,Senate,"TRANSPORTATION AND SAFETY COMMITTEE: Recommended for passage, refer to Senate Calendar Committee",7,2,0,0,9
1957814,1535310,2025-04-02,House,"HOUSE CIVIL JUSTICE SUBCOMMITTEE: Rec for pass if am by s/c ref. to Judiciary Committee",7,0,0,0,7
1957814,1542543,2025-04-09,House,"HOUSE JUDICIARY COMMITTEE: Rec. for pass. if am., ref. to Calendar & Rules Committee",17,1,2,0,20
1957814,1550850,2025-04-16,House,"FLOOR VOTE: REGULAR CALENDAR AS AMENDED PASSAGE ON THIRD CONSIDERATION",91,5,0,0,96
1957814,1550851,2025-04-16,House,"FLOOR VOTE: REGULAR CALENDAR MOTION TO ADOPT AMENDMENT # 2 BY FARMER AS AMENDED PASSAGE ON THIRD CONSIDERATION",91,1,0,0,92
1957814,1550852,2025-04-16,House,"FLOOR VOTE: REGULAR CALENDAR MOTION TO CONSIDER AMENDMENT # 2 BY FARMER AS AMENDED PASSAGE ON THIRD CONSIDERATION",89,1,2,0,92
1957814,1550853,2025-04-16,House,"FLOOR VOTE: REGULAR CALENDAR PREVIOUS QUESTION AS AMENDED PASSAGE ON THIRD CONSIDERATION",86,3,0,0,89
1957814,1552560,2025-04-17,Senate,"FLOOR VOTE: Third Consideration",30,0,0,0,30
1957823,1515947,2025-03-11,Senate,"SENATE STATE & LOCAL GOVERNMENT COMMITTEE: Recommended for passage w/amendment, refer to Senate Finance, Ways & Means Committee",6,3,0,0,9
1957829,1532637,2025-04-01,Senate,"SENATE STATE & LOCAL GOVERNMENT COMMITTEE: Recommended for passage with amendment/s, refer to Senate Calendar Committee Ayes 5, Nays 3 PNV 0",5,3,0,0,8
1957829,1533941,2025-04-01,Senate,"SENATE STATE & LOCAL GOVERNMENT COMMITTEE: Recommended for passage with amendment/s, refer to Senate Calendar Committee Ayes 6, Nays 2 PNV 0",6,2,0,0,8
1957834,1483416,2025-02-06,House,"FLOOR VOTE: CONSENT CALENDAR PASSAGE ON THIRD CONSIDERATION",89,0,0,0,89
1957834,1532374,2025-04-01,Senate,"SENATE STATE & LOCAL GOVERNMENT COMMITTEE: Recommended for concurrence by Senate State and Local Government Committee, refer Senate Calendar Committee",8,0,0,0,8
1957834,1539936,2025-04-07,Senate,"FLOOR VOTE: Motion to Adopt",31,0,0,0,31
1957836,1522318,2025-03-19,Senate,"SENATE EDUCATION COMMITTEE: Failed in Senate Education Committee",3,5,0,0,8
1957853,1506598,2025-03-05,House,"HOUSE BUSINESS AND UTILITIES SUBCOMMITTEE: Rec. for pass by s/c ref. to Commerce Committee",10,0,0,0,10
1957853,1521858,2025-03-19,House,"HOUSE COMMERCE COMMITTEE: Rec. for pass; ref to Calendar & Rules Committee",23,0,0,0,23
1957853,1525629,2025-03-24,House,"FLOOR VOTE: CONSENT CALENDAR PASSAGE ON THIRD CONSIDERATION",96,0,0,0,96
1957858,1505433,2025-03-04,Senate,"SENATE COMMERCE AND LABOR COMMITTEE: Recommended for passage with amendment/s, refer to Senate Calendar Committee Ayes 7, Nays 0 PNV 0",7,0,0,0,7
1957858,1517521,2025-03-13,Senate,"FLOOR VOTE: as Amended Third Consideration",32,0,0,0,32
1957858,1525600,2025-03-24,House,"FLOOR VOTE: REGULAR CALENDAR PASSAGE ON THIRD CONSIDERATION",90,0,0,0,90
1957865,1504294,2025-03-04,House,"HOUSE TRANSPORTATION SUBCOMMITTEE: Rec. for pass by s/c ref. to Transportation Committee",9,0,0,0,9
1957865,1513800,2025-03-11,House,"HOUSE TRANSPORTATION COMMITTEE: Rec. for pass; ref to Calendar & Rules Committee",19,0,0,0,19
1957865,1518640,2025-03-17,House,"FLOOR VOTE: CONSENT CALENDAR PASSAGE ON THIRD CONSIDERATION",92,0,1,0,93
1957870,1527439,2025-03-26,House,"HOUSE HIGHER EDUCATION SUBCOMMITTEE: Rec for pass if am by s/c ref. to Education Committee",5,0,0,0,5
1957870,1535203,2025-04-02,House,"HOUSE EDUCATION COMMITTEE: Rec. for pass. if am., ref. to Finance, Ways, and Means Committee",17,0,0,0,17
1957875,1520884,2025-03-18,Senate,"SENATE COMMERCE AND LABOR COMMITTEE: Recommended for passage, refer to Senate Calendar Committee",8,0,0,0,8
1957875,1526184,2025-03-24,Senate,"FLOOR VOTE: Motion to Adopt",32,0,0,0,32
1957886,1528399,2025-03-26,House,"HOUSE AGRICULTURE AND NATURAL RESOURCES SUBCOMMITTEE: Rec for pass if am by s/c ref. to Agriculture & Natural Resources Committee",8,0,1,0,9
1957886,1532150,2025-04-01,House,"HOUSE AGRICULTURE & NATURAL RESOURCES COMMITTEE: Rec. for pass. if am., ref. to Calendar & Rules Committee",13,1,1,0,15
1957912,1514280,2025-03-11,House,"HOUSE TRANSPORTATION SUBCOMMITTEE: Rec for pass if am by s/c ref. to Transportation Committee",9,0,0,0,9
1957912,1520378,2025-03-18,House,"HOUSE TRANSPORTATION COMMITTEE: Rec. for pass. if am., ref. to Finance, Ways, and Means Committee",18,0,0,0,18
1957912,1527511,2025-03-26,House,"HOUSE FINANCE, WAYS, AND MEANS SUBCOMMITTEE: Rec. for pass by s/c ref. to Finance, Ways, and Means Committee",8,0,0,0,8
1957912,1533798,2025-04-01,House,"HOUSE FINANCE, WAYS, AND MEANS COMMITTEE: Rec. for pass; ref to Calendar & Rules Committee",27,0,0,0,27
1957920,1520344,2025-03-18,House,"HOUSE EDUCATION ADMINISTRATION SUBCOMMITTEE: Rec. for pass by s/c ref. to Education Committee",6,0,0,0,6
1957920,1527086,2025-03-25,House,"HOUSE EDUCATION COMMITTEE: Rec. for pass; ref to Calendar & Rules Committee",17,0,0,0,17
1957920,1531108,2025-03-31,House,"FLOOR VOTE: CONSENT CALENDAR PASSAGE ON THIRD CONSIDERATION",93,0,2,0,95
1957932,1526663,2025-03-25,Senate,"SENATE JUDICIARY COMMITTEE: Recommended for passage with amendment, Refer to Senate Finance, Ways & Means Committee, Ayes 9, Nayes 0, PNV 0",9,0,0,0,9
1957932,1539762,2025-04-08,Senate,"SENATE FINANCE, WAYS AND MEANS COMMITTEE: Recommended for passage, refer to Senate Calendar Committee",9,1,0,0,10
1957934,1534336,2025-04-02,Senate,"SENATE STATE & LOCAL GOVERNMENT COMMITTEE: Recommended for passage with amendment/s, refer to Senate Calendar Committee Ayes 7, Nays 2 PNV 0",7,2,0,0,9
1957934,1554035,2025-04-22,House,"FLOOR VOTE: REGULAR CALENDAR LAY ON THE TABLE MOTION TO ADOPT AMENDMENT # 2 BY MILLER PASSAGE ON THIRD CONSIDERATION",71,25,0,0,96
1957934,1554036,2025-04-22,House,"FLOOR VOTE: REGULAR CALENDAR LAY ON THE TABLE MOTION TO ADOPT AMENDMENT # 3 BY SALINAS PASSAGE ON THIRD CONSIDERATION",73,22,0,0,95
1957934,1554037,2025-04-22,House,"FLOOR VOTE: REGULAR CALENDAR MOTION TO CONSIDER AMENDMENT # 4 BY PEARSON PASSAGE ON THIRD CONSIDERATION",24,72,0,0,96
1957934,1554038,2025-04-22,House,"FLOOR VOTE: REGULAR CALENDAR MOTION TO CONSIDER AMENDMENT # 5 BY POWELL PASSAGE ON THIRD CONSIDERATION",23,73,0,0,96
1957934,1554039,2025-04-22,House,"FLOOR VOTE: REGULAR CALENDAR MOTION TO CONSIDER AMENDMENT # 6 BY JONES J PASSAGE ON THIRD CONSIDERATION",23,73,0,0,96
1957934,1554040,2025-04-22,House,"FLOOR VOTE: REGULAR CALENDAR PASSAGE ON THIRD CONSIDERATION",72,25,0,0,97
1957934,1554041,2025-04-22,House,"FLOOR VOTE: REGULAR CALENDAR REREFER TO COMMITTEE PASSAGE ON THIRD CONSIDERATION",24,71,0,0,95
1957934,1556492,2025-04-22,Senate,"FLOOR VOTE: as Amended Third Consideration",27,6,0,0,33
1957938,1519845,2025-03-18,House,"HOUSE CHILDREN AND FAMILY AFFAIRS SUBCOMMITTEE: Rec for pass if am by s/c ref. to Judiciary Committee",5,1,0,0,6
1957938,1541894,2025-04-09,House,"HOUSE JUDICIARY COMMITTEE: Failed in Judiciary Committee",3,16,2,0,21
1957947,1506285,2025-03-05,House,"HOUSE PUBLIC SERVICE SUBCOMMITTEE: Rec. for pass by s/c ref. to State & Local Government Committee",4,1,0,0,5
1957947,1542701,2025-04-09,House,"HOUSE STATE & LOCAL GOVERNMENT COMMITTEE: Rec. for pass. if am., ref. to Calendar & Rules Committee",16,5,0,0,21
1957951,1519398,2025-03-18,House,"HOUSE K-12 SUBCOMMITTEE: Rec for pass if am by s/c ref. to Education Committee",8,0,0,0,8
1957962,1541434,2025-04-09,House,"HOUSE FINANCE, WAYS, AND MEANS SUBCOMMITTEE: Rec for pass if am by s/c ref. to Finance, Ways, and Means Committee",12,0,0,0,12
1957962,1546931,2025-04-14,House,"HOUSE FINANCE, WAYS, AND MEANS COMMITTEE: Rec. for pass. if am., ref. to Calendar & Rules Committee",27,0,0,0,27
1957970,1500400,2025-02-26,House,"HOUSE HEALTH SUBCOMMITTEE: Rec for pass if am by s/c ref. to Health Committee",9,0,0,0,9
1957970,1504419,2025-03-04,House,"HOUSE HEALTH COMMITTEE: Rec. for pass. if am., ref. to Insurance Committee",19,0,0,0,19
1957970,1516446,2025-03-12,House,"HOUSE INSURANCE COMMITTEE: Rec. for pass; ref to Calendar & Rules Committee",15,0,0,0,15
1957987,1515105,2025-03-11,House,"HOUSE EDUCATION ADMINISTRATION SUBCOMMITTEE: Rec. for pass by s/c ref. to Education Committee",6,0,0,0,6
1957987,1526422,2025-03-25,House,"HOUSE EDUCATION COMMITTEE: Rec. for pass. if am., ref. to Calendar & Rules Committee",18,0,0,0,18
1957997,1506352,2025-03-05,House,"HOUSE HEALTH SUBCOMMITTEE: Rec for pass if am by s/c ref. to Health Committee",8,0,0,0,8
1957997,1513816,2025-03-11,House,"HOUSE HEALTH COMMITTEE: Rec. for pass. if am., ref. to Government Operations Committee",13,0,0,0,13
1957997,1518730,2025-03-17,House,"HOUSE GOVERNMENT OPERATIONS COMMITTEE: Rec. for pass; ref to Finance, Ways, and Means Committee",12,0,0,0,12
1958005,1534188,2025-04-02,House,"HOUSE CIVIL JUSTICE SUBCOMMITTEE: Rec for pass if am by s/c ref. to Judiciary Committee",5,1,1,0,7
1958005,1542218,2025-04-09,House,"HOUSE JUDICIARY COMMITTEE: Rec. for pass. if am., ref. to Calendar & Rules Committee",20,1,0,0,21
1958005,1549158,2025-04-15,House,"FLOOR VOTE: REGULAR CALENDAR AS AMENDED PASSAGE ON THIRD CONSIDERATION",83,10,2,0,95
1958005,1552469,2025-04-17,Senate,"FLOOR VOTE: Third Consideration",28,2,1,0,31
1958010,1527583,2025-03-26,Senate,"SENATE ENERGY, AGRICULTURE AND NATURAL RESOURCES COMMITTEE: Failed in Senate Energy, Ag., and Nat. Resources Committee",3,6,0,0,9
1958014,1515194,2025-03-11,House,"HOUSE EDUCATION ADMINISTRATION SUBCOMMITTEE: Rec. for pass by s/c ref. to Education Committee",6,0,0,0,6
1958014,1534876,2025-04-02,House,"HOUSE EDUCATION COMMITTEE: Rec. for pass. if am., ref. to Finance, Ways, and Means Committee",18,0,0,0,18
1958032,1538134,2025-04-02,Senate,"SENATE STATE & LOCAL GOVERNMENT COMMITTEE: Failed in Senate State and Local Government Committee",4,5,0,0,9
1958037,1527050,2025-03-25,Senate,"SENATE JUDICIARY COMMITTEE: Recommended for passage with amendment, refer to Senate Calendar Committee",6,1,1,0,8
1958037,1539298,2025-04-07,Senate,"FLOOR VOTE: as Amended Third Consideration",27,5,0,0,32
1958037,1550786,2025-04-16,House,"FLOOR VOTE: REGULAR CALENDAR PASSAGE ON THIRD CONSIDERATION",86,0,3,0,89
1958042,1506389,2025-03-05,House,"HOUSE AGRICULTURE AND NATURAL RESOURCES SUBCOMMITTEE: Rec. for pass by s/c ref. to Agriculture & Natural Resources Committee",8,1,0,0,9
1958042,1513307,2025-03-11,House,"HOUSE AGRICULTURE & NATURAL RESOURCES COMMITTEE: Rec. for pass; ref to Calendar & Rules Committee",11,3,0,0,14
1958042,1524950,2025-03-24,House,"FLOOR VOTE: REGULAR CALENDAR PASSAGE ON THIRD CONSIDERATION",69,21,0,0,90
1958052,1535023,2025-04-02,Senate,"SENATE STATE & LOCAL GOVERNMENT COMMITTEE: Recommended for passage with amendment/s, refer to Senate Finance, Ways, and Means Committee Ayes 8, Nays 0 PNV 0",8,0,0,0,8
1958074,1525872,2025-03-25,House,"HOUSE K-12 SUBCOMMITTEE: Rec for pass if am by s/c ref. to Education Committee",7,0,0,0,7
1958074,1533213,2025-04-01,House,"HOUSE EDUCATION COMMITTEE: Rec. for pass. if am., ref. to Finance, Ways, and Means Committee",17,0,0,0,17
1958074,1547199,2025-04-14,House,"HOUSE FINANCE, WAYS, AND MEANS SUBCOMMITTEE: Rec for pass if am by s/c ref. to Finance, Ways, and Means Committee",12,0,0,0,12
1958074,1549129,2025-04-15,House,"HOUSE FINANCE, WAYS, AND MEANS COMMITTEE: Rec. for pass. if am., ref. to Calendar & Rules Committee",26,0,0,0,26
1958084,1534370,2025-04-02,Senate,"SENATE STATE & LOCAL GOVERNMENT COMMITTEE: Recommended for passage with amendment/s, refer to Senate Calendar Committee Ayes 7, Nays 2 PNV 0",7,2,0,0,9
1958093,1522315,2025-03-19,Senate,"SENATE EDUCATION COMMITTEE: Recommended for passage, refer to Senate Calendar Committee",8,0,0,0,8
1958093,1525818,2025-03-24,Senate,"FLOOR VOTE: Motion to Adopt",32,0,0,0,32
1958093,1544612,2025-04-10,House,"FLOOR VOTE: REGULAR CALENDAR PASSAGE ON THIRD CONSIDERATION",94,0,0,0,94
1958103,1495189,2025-02-19,House,"HOUSE BUSINESS AND UTILITIES SUBCOMMITTEE: Rec. for pass by s/c ref. to Commerce Committee",10,0,0,0,10
1958103,1500601,2025-02-26,House,"HOUSE COMMERCE COMMITTEE: Rec. for pass; ref to Calendar & Rules Committee",21,0,0,0,21
1958103,1525190,2025-03-24,House,"FLOOR VOTE: CONSENT CALENDAR PASSAGE ON THIRD CONSIDERATION",96,0,0,0,96
1958114,1551749,2025-04-17,House,"HOUSE FINANCE, WAYS, AND MEANS SUBCOMMITTEE: Rec. for pass by s/c ref. to Finance, Ways, and Means Committee",11,0,0,0,11
1958114,1553634,2025-04-17,House,"HOUSE FINANCE, WAYS, AND MEANS COMMITTEE: Rec. for pass; ref to Calendar & Rules Committee",27,0,0,0,27
1958114,1553635,2025-04-21,House,"HOUSE FINANCE, WAYS, AND MEANS COMMITTEE: Rec. for pass. if am., ref. to Calendar & Rules Committee",27,0,0,0,27
1958114,1554376,2025-04-22,House,"FLOOR VOTE: REGULAR CALENDAR 2 AS AMENDED PASSAGE ON THIRD CONSIDERATION",69,23,1,0,93
1958114,1554377,2025-04-22,House,"FLOOR VOTE: REGULAR CALENDAR 2 MOTION TO ADOPT AMENDMENT # 3 BY HULSEY AS AMENDED PASSAGE ON THIRD CONSIDERATION",78,18,2,0,98
1958114,1554378,2025-04-22,House,"FLOOR VOTE: REGULAR CALENDAR 2 MOTION TO CONSIDER AMENDMENT # 3 BY HULSEY AS AMENDED PASSAGE ON THIRD CONSIDERATION",83,9,3,0,95
1958114,1556727,2025-04-22,Senate,"FLOOR VOTE: Third Consideration",26,5,0,0,31
1958127,1541402,2025-04-08,Senate,"SENATE JUDICIARY COMMITTEE: Recommended for passage with amendment/s, refer to Senate Finance, Ways, and Means Committee Ayes 7, Nays 1 PNV 0",7,1,0,0,8
1958127,1552985,2025-04-21,Senate,"SENATE FINANCE, WAYS AND MEANS COMMITTEE: Recommended for passage, refer to Senate Calendar Committee",11,0,0,0,11
1958136,1499776,2025-02-26,House,"HOUSE CRIMINAL JUSTICE SUBCOMMITTEE: Rec for pass if am by s/c ref. to Judiciary Committee",7,2,0,0,9
1958136,1516407,2025-03-12,House,"HOUSE JUDICIARY COMMITTEE: Rec. for pass. if am., ref. to Finance, Ways, and Means Committee",13,7,1,0,21
1958140,1499331,2025-02-25,Senate,"SENATE STATE & LOCAL GOVERNMENT COMMITTEE: Recommended for adoption by Senate State and Local Government Committee, refer Senate Calendar Committee",9,0,0,0,9
1958140,1513582,2025-02-27,Senate,"FLOOR VOTE: Motion to Adopt",32,0,0,0,32
1958146,1495172,2025-02-19,House,"HOUSE BUSINESS AND UTILITIES SUBCOMMITTEE: Rec for pass if am by s/c ref. to Commerce Committee",10,0,0,0,10
1958146,1500104,2025-02-26,House,"HOUSE COMMERCE COMMITTEE: Rec. for pass. if am., ref. to Calendar & Rules Committee",21,0,0,0,21
1958146,1503406,2025-03-03,House,"FLOOR VOTE: REGULAR CALENDAR AS AMENDED PASSAGE ON THIRD CONSIDERATION",71,17,0,0,88
1958146,1514275,2025-03-10,Senate,"FLOOR VOTE: Third Consideration",26,3,0,0,29
1958162,1499399,2025-02-25,Senate,"SENATE COMMERCE AND LABOR COMMITTEE: Recommended for passage with amendment/s, refer to Senate Calendar Committee Ayes 8, Nays 0 PNV 0",8,0,0,0,8
1958162,1515374,2025-03-03,Senate,"FLOOR VOTE: as Amended Third Consideration",28,3,0,0,31
1958162,1529808,2025-03-27,House,"FLOOR VOTE: REGULAR CALENDAR PASSAGE ON THIRD CONSIDERATION",85,10,0,0,95
1958163,1541378,2025-04-08,Senate,"SENATE JUDICIARY COMMITTEE: Recommended for passage with amendment/s, refer to Senate Finance, Ways, and Means Committee Ayes 7, Nays 1 PNV 0",7,1,0,0,8
1958163,1552812,2025-04-21,Senate,"SENATE FINANCE, WAYS AND MEANS COMMITTEE: Recommended for passage, refer to Senate Calendar Committee",10,1,0,0,11
1958182,1536145,2025-04-02,Senate,"SENATE JUDICIARY COMMITTEE: Recommended for passage, refer to Senate Finance, Ways, and Means Committee",9,0,0,0,9
1958182,1552766,2025-04-21,Senate,"SENATE FINANCE, WAYS AND MEANS COMMITTEE: Recommended for passage, refer to Senate Calendar Committee",11,0,0,0,11
1958182,1554352,2025-04-22,House,"FLOOR VOTE: REGULAR CALENDAR PASSAGE ON THIRD CONSIDERATION",79,19,0,0,98
1958182,1556678,2025-04-22,Senate,"FLOOR VOTE: Motion to Adopt",33,0,0,0,33
1958192,1534389,2025-04-02,Senate,"SENATE STATE & LOCAL GOVERNMENT COMMITTEE: Recommended for passage, refer to Senate Finance, Ways, and Means Committee",8,0,0,0,8
1958192,1552744,2025-04-21,Senate,"SENATE FINANCE, WAYS AND MEANS COMMITTEE: Recommended for passage, refer to Senate Calendar Committee",10,0,1,0,11
1958225,1513917,2025-03-11,Senate,"SENATE COMMERCE AND LABOR COMMITTEE: Recommended for passage with amendment/s, refer to Senate Calendar Committee Ayes 8, Nays 1 PNV 0",8,1,0,0,9
1958230,1513878,2025-03-11,House,"HOUSE DEPARTMENTS & AGENCIES SUBCOMMITTEE: Rec for pass if am by s/c ref. to State & Local Government Committee",7,0,0,0,7
1958230,1528402,2025-03-26,House,"HOUSE STATE & LOCAL GOVERNMENT COMMITTEE: Rec. for pass. if am., ref. to Calendar & Rules Committee",17,2,0,0,19
1958230,1531092,2025-03-31,House,"FLOOR VOTE: REGULAR CALENDAR AS AMENDED PASSAGE ON THIRD CONSIDERATION",95,0,0,0,95
1958230,1549591,2025-04-15,Senate,"FLOOR VOTE: Third Consideration",32,0,0,0,32
1958244,1527403,2025-03-26,House,"HOUSE HEALTH SUBCOMMITTEE: Rec for pass if am by s/c ref. to Health Committee",8,0,0,0,8
1958244,1532920,2025-04-01,House,"HOUSE HEALTH COMMITTEE: Rec. for pass. if am., ref. to Calendar & Rules Committee",21,2,0,0,23
1958246,1528129,2025-03-26,Senate,"SENATE HEALTH AND WELFARE COMMITTEE: Recommended for passage, refer to Senate Finance, Ways, and Means Committee",9,0,0,0,9
1958252,1483569,2025-02-06,House,"FLOOR VOTE: CONSENT CALENDAR PASSAGE ON THIRD CONSIDERATION",89,0,0,0,89
1958252,1490543,2025-02-13,Senate,"FLOOR VOTE: Motion to Adopt",31,0,0,0,31
1958269,1527127,2025-03-25,House,"HOUSE ELECTIONS & CAMPAIGN FINANCE SUBCOMMITTEE: Rec for pass if am by s/c ref. to State & Local Government Committee",7,0,0,0,7
1958269,1535325,2025-04-02,House,"HOUSE STATE & LOCAL GOVERNMENT COMMITTEE: Rec. for pass. if am., ref. to Calendar & Rules Committee",20,3,0,0,23
1958269,1539168,2025-04-07,House,"FLOOR VOTE: REGULAR CALENDAR AS AMENDED PASSAGE ON THIRD CONSIDERATION",80,11,2,0,93
1958269,1549715,2025-04-15,Senate,"FLOOR VOTE: Third Consideration",28,3,0,0,31
1958287,1519829,2025-03-18,House,"HOUSE DEPARTMENTS & AGENCIES SUBCOMMITTEE: Rec for pass if am by s/c ref. to State & Local Government Committee",8,0,0,0,8
1958287,1528221,2025-03-26,House,"HOUSE STATE & LOCAL GOVERNMENT COMMITTEE: Rec. for pass. if am., ref. to Calendar & Rules Committee",22,0,0,0,22
1958294,1506479,2025-03-05,House,"HOUSE AGRICULTURE AND NATURAL RESOURCES SUBCOMMITTEE: Rec. for pass by s/c ref. to Agriculture & Natural Resources Committee",7,0,0,0,7
1958294,1513719,2025-03-11,House,"HOUSE AGRICULTURE & NATURAL RESOURCES COMMITTEE: Rec. for pass; ref to Finance, Ways, and Means Committee",14,0,0,0,14
1958294,1520930,2025-03-19,House,"HOUSE FINANCE, WAYS, AND MEANS SUBCOMMITTEE: Rec. for pass by s/c ref. to Finance, Ways, and Means Committee",13,0,0,0,13
1958294,1526465,2025-03-25,House,"HOUSE FINANCE, WAYS, AND MEANS COMMITTEE: Rec. for pass; ref to Calendar & Rules Committee",22,0,0,0,22
1958294,1535750,2025-04-03,House,"FLOOR VOTE: REGULAR CALENDAR PASSAGE ON THIRD CONSIDERATION",59,23,2,0,84
1958294,1548195,2025-04-14,Senate,"FLOOR VOTE: Third Consideration",29,1,0,0,30
1958301,1498882,2025-02-25,Senate,"SENATE COMMERCE AND LABOR COMMITTEE: Recommended for passage with amendment/s, refer to Senate Calendar Committee Ayes 8, Nays 0 PNV 0",8,0,0,0,8
1958301,1512658,2025-03-11,Senate,"SENATE FINANCE, WAYS AND MEANS COMMITTEE: Recommended for passage with amendment/s, refer to Senate Calendar Committee Ayes 11, Nays 0 PNV 0",11,0,0,0,11
1958301,1525786,2025-03-24,Senate,"FLOOR VOTE: as Amended Third Consideration",31,0,0,0,31
1958301,1554122,2025-04-22,House,"FLOOR VOTE: REGULAR CALENDAR 2 AS AMENDED PASSAGE ON THIRD CONSIDERATION",88,7,2,0,97
1958301,1556549,2025-04-22,Senate,"FLOOR VOTE: Motion to Concur House Amendment # 3",29,1,0,0,30
1958301,1556550,2025-04-22,Senate,"FLOOR VOTE: Motion to Concur House Amendment # 4",30,1,0,0,31
1958301,1556551,2025-04-22,Senate,"FLOOR VOTE: Motion to Concur House Amendment # 5",31,1,0,0,32
1958645,1514702,2025-03-11,Senate,"SENATE COMMERCE AND LABOR COMMITTEE: Recommended for passage, refer to Senate Calendar Committee",9,0,0,0,9
1958651,1531314,2025-03-31,Senate,"SENATE JUDICIARY COMMITTEE: Recommended for passage, refer to Senate Finance, Ways, and Means Committee",5,2,0,0,7
1958666,1485834,2025-02-10,House,"FLOOR VOTE: CONSENT CALENDAR PASSAGE ON THIRD CONSIDERATION",88,0,0,0,88
1958666,1490070,2025-02-13,Senate,"FLOOR VOTE: Motion to Adopt",31,0,0,0,31
1958698,1514018,2025-03-11,Senate,"SENATE COMMERCE AND LABOR COMMITTEE: Recommended for passage with amendment/s, refer to Senate Calendar Committee Ayes 9, Nays 0 PNV 0",9,0,0,0,9
1958708,1515787,2025-03-12,House,"HOUSE CRIMINAL JUSTICE SUBCOMMITTEE: Rec for pass if am by s/c ref. to Judiciary Committee",5,1,1,0,7
1958708,1521000,2025-03-19,House,"HOUSE JUDICIARY COMMITTEE: Rec. for pass. if am., ref. to Finance, Ways, and Means Committee",17,5,0,0,22
1958708,1551829,2025-04-17,House,"HOUSE FINANCE, WAYS, AND MEANS SUBCOMMITTEE: Rec. for pass by s/c ref. to Finance, Ways, and Means Committee",11,0,0,0,11
1958708,1553298,2025-04-17,House,"HOUSE FINANCE, WAYS, AND MEANS COMMITTEE: Rec. for pass. if am., ref. to Calendar & Rules Committee",28,0,0,0,28
1958708,1553299,2025-04-17,House,"HOUSE FINANCE, WAYS, AND MEANS COMMITTEE: Rec. for pass; ref to Calendar & Rules Committee",27,0,0,0,27
1958708,1554732,2025-04-22,House,"FLOOR VOTE: REGULAR CALENDAR AS AMENDED PASSAGE ON THIRD CONSIDERATION",90,5,0,0,95
1958708,1556935,2025-04-22,Senate,"FLOOR VOTE: Third Consideration",31,0,0,0,31
1958711,1521007,2025-03-18,Senate,"SENATE JUDICIARY COMMITTEE: Recommended for passage with amendment/s, refer to Senate Calendar Committee Ayes 9, Nays 0 PNV 0",9,0,0,0,9
1958711,1531975,2025-03-31,Senate,"FLOOR VOTE: as Amended Third Consideration",29,1,0,0,30
1958711,1548548,2025-04-15,House,"FLOOR VOTE: REGULAR CALENDAR AS AMENDED PASSAGE ON THIRD CONSIDERATION",91,0,4,0,95
1958711,1552389,2025-04-17,Senate,"FLOOR VOTE: Motion to Concur House Amendment # 1",30,1,0,0,31
1958714,1519540,2025-03-18,House,"HOUSE TENNCARE SUBCOMMITTEE: Rec. for pass by s/c ref. to Insurance Committee",6,0,0,0,6
1958714,1534184,2025-04-02,House,"HOUSE INSURANCE COMMITTEE: Rec. for pass; ref to Finance, Ways, and Means Committee",14,0,0,0,14
1958716,1500085,2025-02-26,House,"HOUSE HEALTH SUBCOMMITTEE: Rec for pass if am by s/c ref. to Health Committee",6,2,1,0,9
1958716,1513735,2025-03-11,House,"HOUSE HEALTH COMMITTEE: Rec. for pass. if am., ref. to Calendar & Rules Committee",11,5,2,0,18
1958716,1518520,2025-03-17,House,"FLOOR VOTE: REGULAR CALENDAR AS AMENDED PASSAGE ON THIRD CONSIDERATION",77,17,0,0,94
1958716,1519337,2025-03-17,Senate,"FLOOR VOTE: Third Consideration",26,6,0,0,32
1958721,1528509,2025-03-26,Senate,"SENATE EDUCATION COMMITTEE: Recommended for passage with amendment/s, refer to Senate Calendar Committee Ayes 9, Nays 0 PNV 0",9,0,0,0,9
1958721,1549596,2025-04-15,Senate,"FLOOR VOTE: as Amended Third Consideration",32,0,0,0,32
1958729,1522393,2025-03-19,Senate,"SENATE EDUCATION COMMITTEE: Recommended for passage, refer to Senate Finance, Ways, and Means Committee",8,0,0,0,8
1958735,1513793,2025-03-11,House,"HOUSE EDUCATION ADMINISTRATION SUBCOMMITTEE: Rec for pass if am by s/c ref. to Education Committee",6,0,0,0,6
1958735,1534912,2025-04-02,House,"HOUSE EDUCATION COMMITTEE: Rec. for pass. if am., ref. to Government Operations Committee",18,0,0,0,18
1958735,1538462,2025-04-07,House,"HOUSE GOVERNMENT OPERATIONS COMMITTEE: Rec. for pass; ref to Calendar & Rules Committee",10,3,0,0,13
1958744,1519898,2025-03-18,House,"HOUSE EDUCATION ADMINISTRATION SUBCOMMITTEE: Rec. for pass by s/c ref. to Education Committee",6,0,0,0,6
1958744,1534826,2025-04-02,House,"HOUSE EDUCATION COMMITTEE: Rec. for pass; ref to Finance, Ways, and Means Committee",19,0,0,0,19
1958750,1526874,2025-03-25,House,"HOUSE DEPARTMENTS & AGENCIES SUBCOMMITTEE: Rec for pass if am by s/c ref. to State & Local Government Committee",8,0,0,0,8
1958750,1541119,2025-04-08,House,"HOUSE STATE & LOCAL GOVERNMENT COMMITTEE: Rec. for pass. if am., ref. to Finance, Ways, and Means Committee",18,4,1,0,23
1958754,1500673,2025-02-26,Senate,"SENATE HEALTH AND WELFARE COMMITTEE: Recommended for passage, refer to Senate Calendar Committee",7,0,0,0,7
1958770,1490484,2025-02-13,Senate,"FLOOR VOTE: Motion to Adopt",31,0,0,0,31
1958770,1497833,2025-02-24,House,"FLOOR VOTE: CONSENT CALENDAR PASSAGE ON THIRD CONSIDERATION",92,0,2,0,94
1958778,1505513,2025-03-04,Senate,"SENATE COMMERCE AND LABOR COMMITTEE: Recommended for passage, refer to Senate Calendar Committee",7,0,0,0,7
1958778,1513541,2025-03-10,Senate,"FLOOR VOTE: Motion to Adopt",30,0,0,0,30
1958785,1513405,2025-03-11,House,"HOUSE CHILDREN AND FAMILY AFFAIRS SUBCOMMITTEE: Failed in s/c Children and Family Affairs Subcommittee of Judiciary Committee",3,3,0,0,6
1958789,1528201,2025-03-26,Senate,"SENATE HEALTH AND WELFARE COMMITTEE: Recommended for passage with amendment/s, refer to Senate Calendar Committee Ayes 8, Nays 1 PNV 0",8,1,0,0,9
1958789,1539453,2025-04-07,Senate,"FLOOR VOTE: as Amended Third Consideration",27,5,0,0,32
1958789,1544841,2025-04-10,House,"FLOOR VOTE: REGULAR CALENDAR PASSAGE ON THIRD CONSIDERATION",76,20,1,0,97
1958796,1534383,2025-04-02,Senate,"SENATE STATE & LOCAL GOVERNMENT COMMITTEE: Recommended for passage with amendment/s, refer to Senate Calendar Committee Ayes 9, Nays 0 PNV 0",9,0,0,0,9
1958799,1535681,2025-04-02,Senate,"SENATE JUDICIARY COMMITTEE: Recommended for passage with amendment/s, refer to Senate Government Operations Committee Ayes 6, Nays 3 PNV 0",6,3,0,0,9
1958799,1541582,2025-04-09,Senate,"SENATE GOVERNMENT OPERATIONS COMMITTEE: Recommended for passage with amendment/s, refer to Senate Finance, Ways, and Means Committee Ayes 5, Nays 4 PNV 0",5,4,0,0,9
1958799,1549166,2025-04-15,Senate,"SENATE FINANCE, WAYS AND MEANS COMMITTEE: Recommended for passage, refer to Senate Calendar Committee",10,0,0,0,10
1958809,1486565,2025-02-10,House,"FLOOR VOTE: CONSENT CALENDAR PASSAGE ON THIRD CONSIDERATION",88,0,0,0,88
1958809,1490251,2025-02-13,Senate,"FLOOR VOTE: Motion to Adopt",31,0,0,0,31
1958812,1533922,2025-04-01,Senate,"SENATE JUDICIARY COMMITTEE: Recommended for passage with amendment/s, refer to Senate Calendar Committee Ayes 6, Nays 2 PNV 0",6,2,0,0,8
1958812,1549543,2025-04-15,Senate,"FLOOR VOTE: as Amended Third Consideration",26,0,3,0,29
1958812,1550528,2025-04-16,House,"FLOOR VOTE: REGULAR CALENDAR AS AMENDED PASSAGE ON THIRD CONSIDERATION",81,4,4,0,89
1958812,1550529,2025-04-16,House,"FLOOR VOTE: REGULAR CALENDAR PREVIOUS QUESTION AS AMENDED PASSAGE ON THIRD CONSIDERATION",67,21,1,0,89
1958812,1552621,2025-04-21,Senate,"FLOOR VOTE: Motion to Concur House Amendment # 2",33,0,0,0,33
1958819,1490466,2025-02-13,Senate,"FLOOR VOTE: Motion to Adopt",31,0,0,0,31
1958821,1536599,2025-04-02,Senate,"SENATE JUDICIARY COMMITTEE: Recommended for passage with amendment/s, refer to Senate Calendar Committee Ayes 9, Nays 0 PNV 0",9,0,0,0,9
1958821,1549603,2025-04-15,Senate,"FLOOR VOTE: as Amended Third Consideration",32,0,0,0,32
1958821,1550652,2025-04-16,House,"FLOOR VOTE: REGULAR CALENDAR PASSAGE ON THIRD CONSIDERATION",86,7,1,0,94
1958827,1526576,2025-03-25,Senate,"SENATE STATE & LOCAL GOVERNMENT COMMITTEE: Recommended for passage with amendment/s, refer to Senate Finance, Ways, and Means Committee Ayes 7, Nays 0 PNV 1",7,0,1,0,8
1958827,1532662,2025-04-01,Senate,"SENATE STATE & LOCAL GOVERNMENT COMMITTEE: Recommended for passage with amendment/s, refer to Senate Finance, Ways, and Means Committee Ayes 6, Nays 0 PNV 2",6,0,2,0,8
1958827,1548938,2025-04-15,Senate,"SENATE FINANCE, WAYS AND MEANS COMMITTEE: Recommended for passage, refer to Senate Calendar Committee",8,2,0,0,10
1958836,1526606,2025-03-25,Senate,"SENATE STATE & LOCAL GOVERNMENT COMMITTEE: Recommended for passage with amendment, refer to Senate Calendar Committee",9,0,0,0,9
1958836,1539252,2025-04-07,Senate,"FLOOR VOTE: as Amended Third Consideration",31,0,0,0,31
1958836,1553739,2025-04-21,House,"FLOOR VOTE: REGULAR CALENDAR AS AMENDED PASSAGE ON THIRD CONSIDERATION",93,0,0,0,93
1958836,1557461,2025-04-22,Senate,"FLOOR VOTE: Motion to Concur House Amendment # 3",33,0,0,0,33
1958837,1534059,2025-04-01,Senate,"SENATE JUDICIARY COMMITTEE: Recommended for passage, refer to Senate Calendar Committee",8,1,0,0,9
1958837,1549217,2025-04-15,House,"FLOOR VOTE: REGULAR CALENDAR PASSAGE ON THIRD CONSIDERATION",95,0,0,0,95
1958837,1549570,2025-04-15,Senate,"FLOOR VOTE: as Amended Third Consideration",32,0,0,0,32
1958844,1528417,2025-03-26,Senate,"SENATE HEALTH AND WELFARE COMMITTEE: Recommended for passage with amendment/s, refer to Senate Calendar Committee Ayes 8, Nays 1 PNV 0",8,1,0,0,9
1958851,1520955,2025-03-19,Senate,"TRANSPORTATION AND SAFETY COMMITTEE: Recommended for passage with amendment/s, refer to Senate Calendar Committee Ayes 8, Nays 0 PNV 1",8,0,1,0,9
1958864,1532106,2025-04-01,Senate,"SENATE STATE & LOCAL GOVERNMENT COMMITTEE: Recommended for passage with amendment/s, refer to Senate Calendar Committee Ayes 7, Nays 0 PNV 0",7,0,0,0,7
1958866,1519436,2025-03-17,Senate,"SENATE JUDICIARY COMMITTEE: Recommended for passage with amendment, refer to Senate Calendar Committee",8,0,1,0,9
1958868,1534061,2025-04-01,Senate,"SENATE JUDICIARY COMMITTEE: Recommended for passage with amendment/s, refer to Senate Calendar Committee Ayes 7, Nays 0 PNV 0",7,0,0,0,7
1958868,1549640,2025-04-15,Senate,"FLOOR VOTE: as Amended Third Consideration",31,0,0,0,31
1958868,1550703,2025-04-16,House,"FLOOR VOTE: REGULAR CALENDAR PASSAGE ON THIRD CONSIDERATION",92,0,0,0,92
1958884,1500105,2025-02-26,House,"HOUSE PUBLIC SERVICE SUBCOMMITTEE: Rec. for pass by s/c ref. to State & Local Government Committee",5,0,0,0,5
1958884,1540096,2025-04-08,House,"HOUSE STATE & LOCAL GOVERNMENT COMMITTEE: Rec. for pass; ref to Calendar & Rules Committee",19,0,2,0,21
1958884,1550392,2025-04-16,House,"FLOOR VOTE: CONSENT CALENDAR PASSAGE ON THIRD CONSIDERATION",96,0,0,0,96
1958895,1541267,2025-04-08,Senate,"SENATE JUDICIARY COMMITTEE: Recommended for passage with amendment/s, refer to Senate Calendar Committee Ayes 8, Nays 0 PNV 0",8,0,0,0,8
1958901,1515990,2025-03-12,Senate,"SENATE HEALTH AND WELFARE COMMITTEE: Recommended for passage with amendment/s, refer to Senate Calendar Committee Ayes 9, Nays 0 PNV 0",9,0,0,0,9
1958901,1525774,2025-03-24,Senate,"FLOOR VOTE: as Amended Third Consideration",31,0,0,0,31
1958901,1531389,2025-03-31,House,"FLOOR VOTE: REGULAR CALENDAR PASSAGE ON THIRD CONSIDERATION",94,0,0,0,94
1958906,1516139,2025-03-12,Senate,"SENATE ENERGY, AGRICULTURE AND NATURAL RESOURCES COMMITTEE: Recommended for passage with amendment/s, refer to Senate Calendar Committee Ayes 9, Nays 0 PNV 0",9,0,0,0,9
1958906,1519327,2025-03-17,Senate,"FLOOR VOTE: as Amended Third Consideration",31,0,0,0,31
1958906,1536078,2025-04-03,House,"FLOOR VOTE: REGULAR CALENDAR PASSAGE ON THIRD CONSIDERATION",91,0,0,0,91
1958909,1532105,2025-04-01,Senate,"SENATE STATE & LOCAL GOVERNMENT COMMITTEE: Recommended for passage with amendment/s, refer to Senate Calendar Committee Ayes 7, Nays 1 PNV 0",7,1,0,0,8
1958916,1486218,2025-02-10,House,"FLOOR VOTE: CONSENT CALENDAR PASSAGE ON THIRD CONSIDERATION",88,0,0,0,88
1958916,1490573,2025-02-13,Senate,"FLOOR VOTE: Motion to Adopt",31,0,0,0,31
1958925,1521477,2025-03-19,Senate,"SENATE ENERGY, AGRICULTURE AND NATURAL RESOURCES COMMITTEE: Failed in Senate Energy, Ag., and Nat. Resources Committee",3,6,0,0,9
1958940,1492953,2025-02-13,Senate,"FLOOR VOTE: Motion to Adopt",31,0,0,0,31
1958952,1519339,2025-03-17,Senate,"SENATE JUDICIARY COMMITTEE: Recommended for passage with amendment/s, refer to Senate Calendar Committee Ayes 7, Nays 2 PNV 0",7,2,0,0,9
1958958,1525947,2025-03-25,House,"HOUSE K-12 SUBCOMMITTEE: Rec for pass if am by s/c ref. to Education Committee",8,0,0,0,8
1958958,1534805,2025-04-02,House,"HOUSE EDUCATION COMMITTEE: Rec. for pass. if am., ref. to Calendar & Rules Committee",19,0,0,0,19
1958958,1550280,2025-04-16,House,"FLOOR VOTE: REGULAR CALENDAR AS AMENDED PASSAGE ON THIRD CONSIDERATION",74,22,0,0,96
1958958,1553016,2025-04-21,Senate,"FLOOR VOTE: Third Consideration",28,4,0,0,32
1958959,1521570,2025-03-19,Senate,"SENATE ENERGY, AGRICULTURE AND NATURAL RESOURCES COMMITTEE: Recommended for passage, refer to Senate Calendar Committee",7,2,0,0,9
1958959,1528710,2025-03-27,Senate,"FLOOR VOTE: Third Consideration",26,5,0,0,31
1958968,1485947,2025-02-10,House,"FLOOR VOTE: CONSENT CALENDAR PASSAGE ON THIRD CONSIDERATION",88,0,0,0,88
1958968,1490503,2025-02-13,Senate,"FLOOR VOTE: Motion to Adopt",31,0,0,0,31
1958975,1485928,2025-02-10,House,"FLOOR VOTE: CONSENT CALENDAR PASSAGE ON THIRD CONSIDERATION",88,0,0,0,88
1958975,1490359,2025-02-13,Senate,"FLOOR VOTE: Motion to Adopt",31,0,0,0,31
1958985,1526129,2025-03-25,Senate,"SENATE STATE & LOCAL GOVERNMENT COMMITTEE: Recommended for passage, refer to Senate Calendar Committee",9,0,0,0,9
1958985,1532126,2025-03-31,Senate,"FLOOR VOTE: Motion to Adopt",30,0,0,0,30
1958991,1485938,2025-02-10,House,"FLOOR VOTE: CONSENT CALENDAR PASSAGE ON THIRD CONSIDERATION",88,0,0,0,88
1958991,1490571,2025-02-13,Senate,"FLOOR VOTE: Motion to Adopt",31,0,0,0,31
1958994,1527553,2025-03-26,Senate,"SENATE ENERGY, AGRICULTURE AND NATURAL RESOURCES COMMITTEE: Recommended for passage with amendment/s, refer to Senate Finance, Ways, and Means Committee Ayes 7, Nays 2 PNV 0",7,2,0,0,9
1958994,1541630,2025-04-09,Senate,"SENATE FINANCE, WAYS AND MEANS COMMITTEE: Recommended for passage with amendment/s, refer to Senate Calendar Committee Ayes 9, Nays 2 PNV 0",9,2,0,0,11
1958994,1549481,2025-04-15,Senate,"FLOOR VOTE: as Amended Third Consideration",26,6,0,0,32
1958994,1553250,2025-04-21,House,"FLOOR VOTE: REGULAR CALENDAR PASSAGE ON THIRD CONSIDERATION",71,22,0,0,93
1958995,1500423,2025-02-26,House,"HOUSE BUSINESS AND UTILITIES SUBCOMMITTEE: Rec. for pass by s/c ref. to Commerce Committee",8,2,0,0,10
1958995,1506725,2025-03-05,House,"HOUSE COMMERCE COMMITTEE: Rec. for pass; ref to Calendar & Rules Committee",16,0,0,0,16
1958995,1511229,2025-03-10,House,"FLOOR VOTE: CONSENT CALENDAR PASSAGE ON THIRD CONSIDERATION",94,0,0,0,94
1959004,1489961,2025-02-13,Senate,"FLOOR VOTE: Motion to Adopt",31,0,0,0,31
1959009,1500109,2025-02-26,House,"HOUSE CRIMINAL JUSTICE SUBCOMMITTEE: Rec. for pass by s/c ref. to Judiciary Committee",9,0,0,0,9
1959009,1516314,2025-03-12,House,"HOUSE JUDICIARY COMMITTEE: Rec. for pass. if am., ref. to Finance, Ways, and Means Committee",17,1,2,0,20
1959013,1534273,2025-04-02,Senate,"SENATE STATE & LOCAL GOVERNMENT COMMITTEE: Recommended for passage with amendment/s, refer to Senate Calendar Committee Ayes 7, Nays 2 PNV 0",7,2,0,0,9
1959013,1549505,2025-04-15,Senate,"FLOOR VOTE: as Amended Third Consideration",26,5,1,0,32
1959013,1550368,2025-04-16,House,"FLOOR VOTE: REGULAR CALENDAR PASSAGE ON THIRD CONSIDERATION",74,23,0,0,97
1959017,1485824,2025-02-10,House,"FLOOR VOTE: CONSENT CALENDAR PASSAGE ON THIRD CONSIDERATION",88,0,0,0,88
1959017,1490397,2025-02-13,Senate,"FLOOR VOTE: Motion to Adopt",31,0,0,0,31
1959034,1520834,2025-03-18,Senate,"SENATE COMMERCE AND LABOR COMMITTEE: Recommended for passage with amendment/s, refer to Senate Calendar Committee Ayes 8, Nays 0 PNV 0",8,0,0,0,8
1959037,1535759,2025-04-02,Senate,"SENATE JUDICIARY COMMITTEE: Recommended for passage with amendment/s, refer to Senate Finance, Ways, and Means Committee Ayes 9, Nays 0 PNV 0",9,0,0,0,9
1959037,1552968,2025-04-21,Senate,"SENATE FINANCE, WAYS AND MEANS COMMITTEE: Recommended for passage with amendment/s, refer to Senate Calendar Committee Ayes 11, Nays 0 PNV 0",11,0,0,0,11
1959037,1554448,2025-04-22,House,"FLOOR VOTE: REGULAR CALENDAR PASSAGE ON THIRD CONSIDERATION",85,10,0,0,95
1959037,1556442,2025-04-22,Senate,"FLOOR VOTE: as Amended Third Consideration",33,0,0,0,33
1959041,1528511,2025-03-26,Senate,"SENATE EDUCATION COMMITTEE: Recommended for passage with amendment/s, refer to Senate Calendar Committee Ayes 9, Nays 0 PNV 0",9,0,0,0,9
1959059,1515636,2025-03-11,Senate,"SENATE JUDICIARY COMMITTEE: Recommended for passage with amendment/s, refer to Senate Finance, Ways, and Means Committee Ayes 6, Nays 3 PNV 0",6,3,0,0,9
1959066,1526326,2025-03-25,Senate,"SENATE STATE & LOCAL GOVERNMENT COMMITTEE: Failed in Senate State and Local Government Committee",3,5,0,0,8
1959073,1519598,2025-03-18,Senate,"SENATE STATE & LOCAL GOVERNMENT COMMITTEE: Recommended for passage with amendment/s, refer to Senate Calendar Committee Ayes 9, Nays 0 PNV 0",9,0,0,0,9
1959073,1528629,2025-03-27,Senate,"FLOOR VOTE: as Amended Third Consideration",31,1,0,0,32
1959073,1531480,2025-03-31,House,"FLOOR VOTE: REGULAR CALENDAR PASSAGE ON THIRD CONSIDERATION",83,6,6,0,95
1959076,1492868,2025-02-18,House,"HOUSE CHILDREN AND FAMILY AFFAIRS SUBCOMMITTEE: Rec. for pass by s/c ref. to Judiciary Committee",6,0,0,0,6
1959076,1500787,2025-02-26,House,"HOUSE JUDICIARY COMMITTEE: Rec. for pass; ref to Calendar & Rules Committee",17,0,2,0,19
1959076,1503521,2025-03-03,House,"FLOOR VOTE: CONSENT CALENDAR PASSAGE ON THIRD CONSIDERATION",89,0,0,0,89
1959076,1519494,2025-03-17,Senate,"FLOOR VOTE: Motion to Adopt",32,0,0,0,32
1959081,1541270,2025-04-08,Senate,"SENATE JUDICIARY COMMITTEE: Failed in Senate Judiciary Committee",4,4,0,0,8
1959111,1533942,2025-04-01,Senate,"SENATE JUDICIARY COMMITTEE: Recommended for passage with amendment/s, refer to Senate Calendar Committee Ayes 8, Nays 0 PNV 0",8,0,0,0,8
1959111,1549593,2025-04-15,Senate,"FLOOR VOTE: as Amended Third Consideration",31,0,0,0,31
1959111,1550106,2025-04-16,House,"FLOOR VOTE: REGULAR CALENDAR PASSAGE ON THIRD CONSIDERATION",94,0,1,0,95
1959124,1534058,2025-04-01,Senate,"SENATE JUDICIARY COMMITTEE: Recommended for passage with amendment/s, refer to Senate Calendar Committee Ayes 8, Nays 1 PNV 0",8,1,0,0,9
1959133,1500621,2025-02-26,House,"HOUSE CITIES & COUNTIES SUBCOMMITTEE: Rec. for pass by s/c ref. to State & Local Government Committee",7,0,0,0,7
1959133,1521663,2025-03-19,House,"HOUSE STATE & LOCAL GOVERNMENT COMMITTEE: Rec. for pass; ref to Calendar & Rules Committee",21,0,0,0,21
1959138,1486051,2025-02-10,House,"FLOOR VOTE: CONSENT CALENDAR PASSAGE ON THIRD CONSIDERATION",88,0,0,0,88
1959138,1490357,2025-02-13,Senate,"FLOOR VOTE: Motion to Adopt",31,0,0,0,31
1959146,1515965,2025-03-12,House,"HOUSE CRIMINAL JUSTICE SUBCOMMITTEE: Rec for pass if am by s/c ref. to Judiciary Committee",7,0,0,0,7
1959147,1504741,2025-03-04,House,"POPULATION HEALTH SUBCOMMITTEE: Def. to Summer Study in Population Health Subcommittee",9,0,0,0,9
1959164,1485883,2025-02-10,House,"FLOOR VOTE: CONSENT CALENDAR PASSAGE ON THIRD CONSIDERATION",88,0,0,0,88
1959164,1490522,2025-02-13,Senate,"FLOOR VOTE: Motion to Adopt",31,0,0,0,31
1959165,1486345,2025-02-10,House,"FLOOR VOTE: CONSENT CALENDAR PASSAGE ON THIRD CONSIDERATION",88,0,0,0,88
1959165,1490376,2025-02-13,Senate,"FLOOR VOTE: Motion to Adopt",31,0,0,0,31
1959167,1504196,2025-03-04,House,"HOUSE K-12 SUBCOMMITTEE: Rec for pass if am by s/c ref. to Education Committee",7,0,0,0,7
1959167,1534907,2025-04-02,House,"HOUSE EDUCATION COMMITTEE: Rec. for pass; ref to Finance, Ways, and Means Committee",15,4,0,0,19
1959167,1551867,2025-04-17,House,"HOUSE FINANCE, WAYS, AND MEANS SUBCOMMITTEE: Rec. for pass by s/c ref. to Finance, Ways, and Means Committee",11,0,0,0,11
1959167,1553396,2025-04-17,House,"HOUSE FINANCE, WAYS, AND MEANS COMMITTEE: Rec. for pass; ref to Calendar & Rules Committee",27,0,0,0,27
1959167,1553397,2025-04-17,House,"HOUSE FINANCE, WAYS, AND MEANS COMMITTEE: Rec. for pass; ref to Calendar & Rules Committee",26,0,0,0,26
1959173,1521108,2025-03-18,Senate,"SENATE JUDICIARY COMMITTEE: Recommended for passage with amendment/s, refer to Senate Calendar Committee Ayes 9, Nays 0 PNV 0",9,0,0,0,9
1959173,1529478,2025-03-27,Senate,"FLOOR VOTE: as Amended Third Consideration",31,0,0,0,31
1959173,1551046,2025-04-16,House,"FLOOR VOTE: REGULAR CALENDAR PASSAGE ON THIRD CONSIDERATION",93,0,0,0,93
1959178,1520944,2025-03-18,Senate,"SENATE COMMERCE AND LABOR COMMITTEE: Recommended for passage, refer to Senate Finance, Ways, and Means Committee",8,0,0,0,8
1959180,1499370,2025-02-25,Senate,"SENATE STATE & LOCAL GOVERNMENT COMMITTEE: Recommended for adoption by Senate State and Local Government Committee, refer Senate Calendar Committee",9,0,0,0,9
1959180,1514975,2025-02-27,Senate,"FLOOR VOTE: Motion to Adopt",32,0,0,0,32
1959210,1486637,2025-02-10,House,"FLOOR VOTE: CONSENT CALENDAR PASSAGE ON THIRD CONSIDERATION",88,0,0,0,88
1959210,1490185,2025-02-13,Senate,"FLOOR VOTE: Motion to Adopt",31,0,0,0,31
1959212,1485919,2025-02-10,House,"FLOOR VOTE: CONSENT CALENDAR PASSAGE ON THIRD CONSIDERATION",88,0,0,0,88
1959212,1490563,2025-02-13,Senate,"FLOOR VOTE: Motion to Adopt",31,0,0,0,31
1959244,1515802,2025-03-12,House,"INSURANCE SUBCOMMITTEE: Rec for pass if am by s/c ref. to Insurance Committee",6,0,0,0,6
1959244,1521718,2025-03-19,House,"HOUSE INSURANCE COMMITTEE: Rec. for pass. if am., ref. to Calendar & Rules Committee",15,0,0,0,15
1959244,1531553,2025-03-31,House,"FLOOR VOTE: REGULAR CALENDAR AS AMENDED PASSAGE ON THIRD CONSIDERATION",92,1,0,0,93
1959244,1531893,2025-03-31,Senate,"FLOOR VOTE: Third Consideration",30,0,0,0,30
1959247,1505810,2025-03-04,Senate,"SENATE JUDICIARY COMMITTEE: Recommended for passage, refer to Senate Calendar Committee",9,0,0,0,9
1959249,1527206,2025-03-25,Senate,"SENATE COMMERCE AND LABOR COMMITTEE: Recommended for passage with amendment/s, refer to Senate Calendar Committee Ayes 9, Nays 0 PNV 0",9,0,0,0,9
1959251,1521792,2025-03-19,House,"HOUSE HEALTH SUBCOMMITTEE: Rec for pass if am by s/c ref. to Health Committee",7,0,0,0,7
1959251,1532894,2025-04-01,House,"HOUSE HEALTH COMMITTEE: Rec. for pass. if am., ref. to Calendar & Rules Committee",15,5,0,0,20
1959251,1549433,2025-04-15,House,"FLOOR VOTE: REGULAR CALENDAR AS AMENDED PASSAGE ON THIRD CONSIDERATION",78,14,0,0,92
1959256,1504905,2025-03-04,Senate,"SENATE COMMERCE AND LABOR COMMITTEE: Recommended for passage, refer to Senate Calendar Committee",7,0,0,0,7
1959256,1513568,2025-03-10,Senate,"FLOOR VOTE: Motion to Adopt",30,0,0,0,30
1959259,1490465,2025-02-13,Senate,"FLOOR VOTE: Motion to Adopt",31,0,0,0,31
1959259,1497669,2025-02-24,House,"FLOOR VOTE: CONSENT CALENDAR PASSAGE ON THIRD CONSIDERATION",92,0,2,0,94
1959265,1521205,2025-03-19,House,"HOUSE HEALTH SUBCOMMITTEE: Rec for pass if am by s/c ref. to Health Committee",7,0,0,0,7
1959265,1532681,2025-04-01,House,"HOUSE HEALTH COMMITTEE: Rec. for pass. if am., ref. to Calendar & Rules Committee",21,0,0,0,21
1959268,1532487,2025-04-01,Senate,"SENATE STATE & LOCAL GOVERNMENT COMMITTEE: Failed in Senate State and Local Government Committee",4,2,0,0,6
1959271,1506150,2025-03-05,House,"HOUSE HIGHER EDUCATION SUBCOMMITTEE: Rec for pass if am by s/c ref. to Education Committee",5,0,0,0,5
1959271,1519685,2025-03-18,House,"HOUSE EDUCATION COMMITTEE: Rec. for pass. if am., ref. to Calendar & Rules Committee",18,0,0,0,18
1959275,1505818,2025-03-04,Senate,"SENATE JUDICIARY COMMITTEE: Recommended for passage, refer to Senate Finance, Ways, and Means Committee",8,0,0,0,8
1959275,1539834,2025-04-08,Senate,"SENATE FINANCE, WAYS AND MEANS COMMITTEE: Recommended for passage, refer to Senate Calendar Committee",9,0,0,0,9
1959285,1541412,2025-04-08,Senate,"SENATE JUDICIARY COMMITTEE: Recommended for passage with amendment/s, refer to Senate Calendar Committee Ayes 8, Nays 0 PNV 0",8,0,0,0,8
1959288,1528489,2025-03-26,Senate,"SENATE EDUCATION COMMITTEE: Recommended for passage with amendment/s, refer to Senate Calendar Committee Ayes 9, Nays 0 PNV 0",9,0,0,0,9
1959291,1505740,2025-03-04,Senate,"SENATE JUDICIARY COMMITTEE: Recommended for passage, refer to Senate Calendar Committee",7,1,1,0,9
1959304,1519780,2025-03-18,House,"HOUSE DEPARTMENTS & AGENCIES SUBCOMMITTEE: Rec for pass if am by s/c ref. to State & Local Government Committee",8,0,0,0,8
1959304,1534210,2025-04-02,House,"HOUSE STATE & LOCAL GOVERNMENT COMMITTEE: Rec. for pass. if am., ref. to Government Operations Committee",20,0,0,0,20
1959304,1549785,2025-04-16,House,"HOUSE GOVERNMENT OPERATIONS COMMITTEE: Rec. for pass; ref to Finance, Ways, and Means Committee",11,0,0,0,11
1959304,1551863,2025-04-17,House,"HOUSE FINANCE, WAYS, AND MEANS SUBCOMMITTEE: Rec for pass if am by s/c ref. to Finance, Ways, and Means Committee",11,0,0,0,11
1959304,1553333,2025-04-17,House,"HOUSE FINANCE, WAYS, AND MEANS COMMITTEE: Rec. for pass. if am., ref. to Calendar & Rules Committee",28,0,0,0,28
1959304,1553334,2025-04-17,House,"HOUSE FINANCE, WAYS, AND MEANS COMMITTEE: Rec. for pass; ref to Calendar & Rules Committee",27,0,0,0,27
1959304,1553335,2025-04-21,House,"FLOOR VOTE: REGULAR CALENDAR AS AMENDED PASSAGE ON THIRD CONSIDERATION",93,0,0,0,93
1959304,1556946,2025-04-22,Senate,"FLOOR VOTE: Third Consideration",32,0,0,0,32
1959307,1540761,2025-04-08,Senate,"SENATE FINANCE, WAYS AND MEANS COMMITTEE: Recommended for passage, refer to Senate Calendar Committee",9,0,0,0,9
1959328,1516475,2025-03-12,Senate,"TRANSPORTATION AND SAFETY COMMITTEE: Recommended for passage, refer to Senate Calendar Committee",9,0,0,0,9
1959331,1485821,2025-02-10,House,"FLOOR VOTE: CONSENT CALENDAR PASSAGE ON THIRD CONSIDERATION",88,0,0,0,88
1959334,1534053,2025-04-01,Senate,"SENATE JUDICIARY COMMITTEE: Recommended for passage with amendment/s, refer to Senate Calendar Committee Ayes 7, Nays 2 PNV 0",7,2,0,0,9
1959334,1550656,2025-04-16,House,"FLOOR VOTE: REGULAR CALENDAR PASSAGE ON THIRD CONSIDERATION",69,17,5,0,91
1959334,1551066,2025-04-16,Senate,"FLOOR VOTE: as Amended Third Consideration",27,6,0,0,33
1959353,1532875,2025-04-01,House,"HOUSE CRIMINAL JUSTICE SUBCOMMITTEE: Failed in s/c Criminal Justice Subcommittee of Judiciary Committee",2,7,0,0,9
1959364,1505145,2025-03-04,Senate,"SENATE STATE & LOCAL GOVERNMENT COMMITTEE: Recommended for passage with amendment/s, refer to Senate Finance, Ways, and Means Committee Ayes 8, Nays 0 PNV 0",8,0,0,0,8
1959375,1506777,2025-03-05,Senate,"SENATE HEALTH AND WELFARE COMMITTEE: Recommended for passage, refer to Senate Calendar Committee",8,0,0,0,8
1959388,1541280,2025-04-08,Senate,"SENATE JUDICIARY COMMITTEE: Recommended for passage with amendment/s, refer to Senate Calendar Committee Ayes 6, Nays 2 PNV 0",6,2,0,0,8
1959388,1548823,2025-04-15,House,"FLOOR VOTE: REGULAR CALENDAR PASSAGE ON THIRD CONSIDERATION",72,20,0,0,92
1959388,1548824,2025-04-15,House,"FLOOR VOTE: REGULAR CALENDAR PREVIOUS QUESTION PASSAGE ON THIRD CONSIDERATION",66,22,0,0,88
1959388,1549624,2025-04-15,Senate,"FLOOR VOTE: as Amended Third Consideration",26,6,0,0,32
1959400,1504596,2025-03-04,House,"HOUSE EDUCATION ADMINISTRATION SUBCOMMITTEE: Rec. for pass by s/c ref. to Education Committee",6,0,0,0,6
1959400,1519906,2025-03-18,House,"HOUSE EDUCATION COMMITTEE: Rec. for pass. if am., ref. to Calendar & Rules Committee",18,0,0,0,18
1959400,1525314,2025-03-24,House,"FLOOR VOTE: REGULAR CALENDAR AS AMENDED PASSAGE ON THIRD CONSIDERATION",87,2,7,0,96
1959400,1539270,2025-04-07,Senate,"FLOOR VOTE: Third Consideration",32,0,0,0,32
1959402,1533912,2025-04-01,Senate,"SENATE JUDICIARY COMMITTEE: Recommended for passage with amendment/s, refer to Senate Calendar Committee Ayes 7, Nays 0 PNV 1",7,0,1,0,8
1959415,1541254,2025-04-08,Senate,"SENATE JUDICIARY COMMITTEE: Recommended for passage with amendment/s, refer to Senate Calendar Committee Ayes 7, Nays 1 PNV 0",7,1,0,0,8
1959421,1528526,2025-03-26,Senate,"SENATE EDUCATION COMMITTEE: Recommended for passage with amendment/s, refer to Senate Finance, Ways, and Means Committee Ayes 9, Nays 0 PNV 0",9,0,0,0,9
1959421,1539714,2025-04-08,Senate,"SENATE FINANCE, WAYS AND MEANS COMMITTEE: Recommended for passage with amendment/s, refer to Senate Calendar Committee Ayes 10, Nays 0 PNV 0",10,0,0,0,10
1959421,1549584,2025-04-15,Senate,"FLOOR VOTE: as Amended Third Consideration",32,0,0,0,32
1959421,1553221,2025-04-21,House,"FLOOR VOTE: REGULAR CALENDAR PASSAGE ON THIRD CONSIDERATION",75,15,2,0,92
1959421,1553222,2025-04-21,House,"FLOOR VOTE: REGULAR CALENDAR PREVIOUS QUESTION PASSAGE ON THIRD CONSIDERATION",69,21,0,0,90
1959425,1505219,2025-03-04,Senate,"SENATE STATE & LOCAL GOVERNMENT COMMITTEE: Recommended for passage, refer to Senate Calendar Committee",9,0,0,0,9
1959425,1515473,2025-03-10,Senate,"FLOOR VOTE: Motion to Adopt",30,0,0,0,30
1959425,1545251,2025-04-10,House,"FLOOR VOTE: REGULAR CALENDAR AS AMENDED PASSAGE ON THIRD CONSIDERATION",93,3,0,0,96
1959425,1548078,2025-04-14,Senate,"FLOOR VOTE: Motion to Concur House Amendment # 1",31,0,0,0,31
1959427,1498966,2025-02-25,Senate,"SENATE STATE & LOCAL GOVERNMENT COMMITTEE: Recommended for passage with amendment/s, refer to Senate Finance, Ways, and Means Committee Ayes 6, Nays 2 PNV 1",6,2,1,0,9
1959427,1532046,2025-04-01,Senate,"SENATE FINANCE, WAYS AND MEANS COMMITTEE: Recommended for passage with amendment/s, refer to Senate Calendar Committee Ayes 8, Nays 1 PNV 2",8,1,2,0,11
1959431,1504706,2025-03-04,House,"HOUSE EDUCATION COMMITTEE: Rec. for pass; ref to Calendar & Rules Committee",17,0,0,0,17
1959431,1509647,2025-03-10,House,"FLOOR VOTE: CONSENT CALENDAR PASSAGE ON THIRD CONSIDERATION",94,0,0,0,94
1959449,1506426,2025-03-05,Senate,"SENATE HEALTH AND WELFARE COMMITTEE: Recommended for passage, refer to Senate Calendar Committee",9,0,0,0,9
1959452,1500613,2025-02-26,Senate,"SENATE HEALTH AND WELFARE COMMITTEE: Recommended for passage, refer to Senate Calendar Committee",8,0,1,0,9
1959452,1507877,2025-03-06,House,"FLOOR VOTE: REGULAR CALENDAR PASSAGE ON THIRD CONSIDERATION",79,11,1,0,91
1959452,1515184,2025-03-03,Senate,"FLOOR VOTE: Third Consideration",30,0,0,0,30
1959455,1532735,2025-04-01,Senate,"SENATE STATE & LOCAL GOVERNMENT COMMITTEE: Recommended for passage, refer to Senate Finance, Ways, and Means Committee",6,0,0,0,6
1959455,1539713,2025-04-08,Senate,"SENATE FINANCE, WAYS AND MEANS COMMITTEE: Recommended for passage, refer to Senate Calendar Committee",9,1,0,0,10
1959460,1501101,2025-02-26,Senate,"TRANSPORTATION AND SAFETY COMMITTEE: Recommended for passage, voice vote, referred to Senate Calendar Committee",9,0,0,0,9
1959460,1505874,2025-03-05,Senate,"TRANSPORTATION AND SAFETY COMMITTEE: Recommended for passage, refer to Senate Calendar Committee",8,0,0,0,8
1959460,1513561,2025-03-10,Senate,"FLOOR VOTE: Motion to Adopt",30,0,0,0,30
1959460,1522990,2025-03-20,House,"FLOOR VOTE: REGULAR CALENDAR PASSAGE ON THIRD CONSIDERATION",93,0,0,0,93
1959463,1528288,2025-03-26,Senate,"SENATE ENERGY, AGRICULTURE AND NATURAL RESOURCES COMMITTEE: Recommended for passage, refer to Senate Finance, Ways & Means Committee",9,0,0,0,9
1959463,1549268,2025-04-15,Senate,"SENATE FINANCE, WAYS AND MEANS COMMITTEE: Recommended for passage, refer to Senate Calendar Committee",9,0,0,0,9
1959463,1553093,2025-04-21,Senate,"FLOOR VOTE: Motion to Adopt",33,0,0,0,33
1959475,1494515,2025-02-19,House,"HOUSE HIGHER EDUCATION SUBCOMMITTEE: Rec. for pass by s/c ref. to Education Committee",5,0,0,0,5
1959475,1498667,2025-02-25,House,"HOUSE EDUCATION COMMITTEE: Rec. for pass; ref to Calendar & Rules Committee",13,4,0,0,17
1959475,1503327,2025-03-03,House,"FLOOR VOTE: REGULAR CALENDAR MOTION TO ADOPT",72,12,3,0,87
1959475,1522429,2025-03-19,Senate,"SENATE EDUCATION COMMITTEE: Recommended for concurrence by Senate Education Committee, refer Senate Calendar Committee",7,0,0,0,7
1959475,1527491,2025-03-26,Senate,"FLOOR VOTE: Motion to Concur",26,5,1,0,32
1959486,1519852,2025-03-18,House,"HOUSE ELECTIONS & CAMPAIGN FINANCE SUBCOMMITTEE: Rec. for pass by s/c ref. to State & Local Government Committee",6,1,0,0,7
1959486,1534294,2025-04-02,House,"HOUSE STATE & LOCAL GOVERNMENT COMMITTEE: Rec. for pass. if am., ref. to Calendar & Rules Committee",18,2,0,0,20
1959489,1501015,2025-02-26,Senate,"TRANSPORTATION AND SAFETY COMMITTEE: Recommended for passage, voice vote, referred to Senate Calendar Committee",9,0,0,0,9
1959489,1505867,2025-03-05,Senate,"TRANSPORTATION AND SAFETY COMMITTEE: Recommended for passage, refer to Senate Calendar Committee",8,0,0,0,8
1959493,1525939,2025-03-25,House,"HOUSE K-12 SUBCOMMITTEE: Failed in s/c K-12 Subcommittee of Education Committee",2,6,0,0,8
1959495,1506714,2025-03-05,Senate,"SENATE HEALTH AND WELFARE COMMITTEE: Recommended for passage, refer to Senate Calendar Committee",9,0,0,0,9
1959495,1513799,2025-03-10,Senate,"FLOOR VOTE: Motion to Adopt",30,0,0,0,30
1959499,1500684,2025-02-26,Senate,"SENATE HEALTH AND WELFARE COMMITTEE: Recommended for passage, refer to Senate Calendar Committee",8,1,0,0,9
1959499,1513055,2025-03-06,Senate,"FLOOR VOTE: Third Consideration",28,1,0,0,29
1959501,1514251,2025-03-11,House,"HOUSE EDUCATION COMMITTEE: Rec. for pass; ref to Calendar & Rules Committee",17,0,0,0,17
1959501,1519260,2025-03-17,House,"FLOOR VOTE: CONSENT CALENDAR PASSAGE ON THIRD CONSIDERATION",92,0,1,0,93
1959504,1519771,2025-03-18,House,"POPULATION HEALTH SUBCOMMITTEE: Failed in s/c Population Health Subcommittee of Health Committee",2,6,0,0,8
1959512,1532606,2025-04-01,Senate,"SENATE STATE & LOCAL GOVERNMENT COMMITTEE: Failed in Senate State and Local Government Committee",4,3,0,0,7
1959525,1494652,2025-02-18,House,"HOUSE K-12 SUBCOMMITTEE: Rec. for pass by s/c ref. to Education Committee",7,0,0,0,7
1959525,1534918,2025-04-02,House,"HOUSE EDUCATION COMMITTEE: Rec. for pass. if am., ref. to Calendar & Rules Committee",19,0,0,0,19
1959531,1500011,2025-02-26,House,"HOUSE HEALTH SUBCOMMITTEE: Rec. for pass by s/c ref. to Health Committee",9,0,0,0,9
1959531,1504382,2025-03-04,House,"HOUSE HEALTH COMMITTEE: Rec. for pass. if am., ref. to Finance, Ways, and Means Committee",18,0,0,0,18
1959531,1551861,2025-04-17,House,"HOUSE FINANCE, WAYS, AND MEANS SUBCOMMITTEE: Rec. for pass by s/c ref. to Finance, Ways, and Means Committee",11,0,0,0,11
1959531,1553393,2025-04-17,House,"HOUSE FINANCE, WAYS, AND MEANS COMMITTEE: Rec. for pass; ref to Calendar & Rules Committee",27,0,0,0,27
1959533,1527537,2025-03-26,Senate,"SENATE ENERGY, AGRICULTURE AND NATURAL RESOURCES COMMITTEE: Recommended for passage, refer to Senate Finance, Ways, and Means Committee",8,1,0,0,9
1959533,1539686,2025-04-08,Senate,"SENATE FINANCE, WAYS AND MEANS COMMITTEE: Recommended for passage, refer to Senate Calendar Committee",9,0,1,0,10
1959533,1549595,2025-04-15,Senate,"FLOOR VOTE: Third Consideration",26,2,3,0,31
1959533,1551175,2025-04-17,House,"FLOOR VOTE: REGULAR CALENDAR PASSAGE ON THIRD CONSIDERATION",73,23,0,0,96
1959535,1500088,2025-02-26,House,"HOUSE HEALTH SUBCOMMITTEE: Rec. for pass by s/c ref. to Health Committee",6,2,0,0,8
1959535,1504688,2025-03-04,House,"HOUSE HEALTH COMMITTEE: Rec. for pass; ref to Calendar & Rules Committee",16,2,0,0,18
1959539,1504752,2025-03-04,House,"HOUSE EDUCATION COMMITTEE: Rec. for pass; ref to Calendar & Rules Committee",17,0,0,0,17
1959539,1509638,2025-03-10,House,"FLOOR VOTE: CONSENT CALENDAR PASSAGE ON THIRD CONSIDERATION",94,0,0,0,94
1959544,1528125,2025-03-26,Senate,"SENATE ENERGY, AGRICULTURE AND NATURAL RESOURCES COMMITTEE: Recommended for passage, refer to Senate Calendar Committee",9,0,0,0,9
1959553,1485957,2025-02-10,House,"FLOOR VOTE: CONSENT CALENDAR PASSAGE ON THIRD CONSIDERATION",88,0,0,0,88
1959553,1490535,2025-02-13,Senate,"FLOOR VOTE: Motion to Adopt",31,0,0,0,31
1959555,1522339,2025-03-19,Senate,"SENATE EDUCATION COMMITTEE: Recommended for passage, refer to Senate Calendar Committee",8,0,0,0,8
1959557,1504720,2025-03-04,House,"HOUSE EDUCATION COMMITTEE: Rec. for pass; ref to Calendar & Rules Committee",17,0,0,0,17
1959557,1509601,2025-03-10,House,"FLOOR VOTE: CONSENT CALENDAR PASSAGE ON THIRD CONSIDERATION",94,0,0,0,94
1959572,1541423,2025-04-08,Senate,"SENATE JUDICIARY COMMITTEE: Recommended for passage with amendment/s, refer to Senate Calendar Committee Ayes 6, Nays 2 PNV 0",6,2,0,0,8
1959575,1528525,2025-03-26,Senate,"SENATE EDUCATION COMMITTEE: Recommended for passage with amendment/s, refer to Senate Calendar Committee Ayes 9, Nays 0 PNV 0",9,0,0,0,9
1959575,1539287,2025-04-07,Senate,"FLOOR VOTE: as Amended Third Consideration",31,0,0,0,31
1959575,1550386,2025-04-16,House,"FLOOR VOTE: REGULAR CALENDAR PASSAGE ON THIRD CONSIDERATION",93,0,0,0,93
1959577,1500094,2025-02-26,House,"INSURANCE SUBCOMMITTEE: Rec for pass if am by s/c ref. to Insurance Committee",6,0,0,0,6
1959577,1506339,2025-03-05,House,"HOUSE INSURANCE COMMITTEE: Rec. for pass. if am., ref. to Finance, Ways, and Means Committee",16,1,1,0,18
1959577,1542001,2025-04-09,House,"HOUSE FINANCE, WAYS, AND MEANS SUBCOMMITTEE: Rec for pass if am by s/c ref. to Finance, Ways, and Means Committee",11,0,0,0,11
1959577,1547143,2025-04-14,House,"HOUSE FINANCE, WAYS, AND MEANS COMMITTEE: Rec. for pass. if am., ref. to Calendar & Rules Committee",27,0,0,0,27
1959580,1485858,2025-02-10,House,"FLOOR VOTE: CONSENT CALENDAR PASSAGE ON THIRD CONSIDERATION",88,0,0,0,88
1959580,1490348,2025-02-13,Senate,"FLOOR VOTE: Motion to Adopt",31,0,0,0,31
1959592,1506157,2025-03-05,House,"HOUSE STATE & LOCAL GOVERNMENT COMMITTEE: Rec. for pass; ref to Calendar & Rules Committee",19,0,0,0,19
1959592,1511789,2025-03-10,House,"FLOOR VOTE: CONSENT CALENDAR PASSAGE ON THIRD CONSIDERATION",94,0,0,0,94
1959603,1520433,2025-03-18,House,"HOUSE EDUCATION ADMINISTRATION SUBCOMMITTEE: Rec for pass if am by s/c ref. to Education Committee",5,1,0,0,6
1959607,1528149,2025-03-26,Senate,"SENATE HEALTH AND WELFARE COMMITTEE: Recommended for passage with amendment/s, refer to Senate Calendar Committee Ayes 9, Nays 0 PNV 0",9,0,0,0,9
1959607,1539258,2025-04-07,Senate,"FLOOR VOTE: as Amended Third Consideration",30,0,1,0,31
1959607,1550135,2025-04-16,House,"FLOOR VOTE: REGULAR CALENDAR PASSAGE ON THIRD CONSIDERATION",93,1,0,0,94
1959618,1521368,2025-03-19,Senate,"SENATE HEALTH AND WELFARE COMMITTEE: Recommended for passage, refer to Senate Finance, Ways, and Means Committee",9,0,0,0,9
1959618,1552762,2025-04-21,Senate,"SENATE FINANCE, WAYS AND MEANS COMMITTEE: Recommended for passage, refer to Senate Calendar Committee",11,0,0,0,11
1959621,1525915,2025-03-25,House,"HOUSE K-12 SUBCOMMITTEE: Failed in s/c K-12 Subcommittee of Education Committee",2,6,0,0,8
1959635,1513956,2025-03-11,House,"HOUSE EDUCATION COMMITTEE: Rec. for pass; ref to Calendar & Rules Committee",17,0,0,0,17
1959635,1518688,2025-03-17,House,"FLOOR VOTE: CONSENT CALENDAR PASSAGE ON THIRD CONSIDERATION",92,0,1,0,93
1959638,1486373,2025-02-10,House,"FLOOR VOTE: CONSENT CALENDAR PASSAGE ON THIRD CONSIDERATION",88,0,0,0,88
1959638,1490005,2025-02-13,Senate,"FLOOR VOTE: Motion to Adopt",31,0,0,0,31
1959645,1527416,2025-03-26,House,"HOUSE CRIMINAL JUSTICE SUBCOMMITTEE: Rec for pass if am by s/c ref. to Judiciary Committee",8,0,1,0,9
1959645,1542019,2025-04-09,House,"HOUSE JUDICIARY COMMITTEE: Rec. for pass. if am., ref. to Calendar & Rules Committee",21,0,0,0,21
1959645,1547707,2025-04-14,House,"FLOOR VOTE: REGULAR CALENDAR AS AMENDED PASSAGE ON THIRD CONSIDERATION",91,2,1,0,94
1959645,1549502,2025-04-15,Senate,"FLOOR VOTE: Third Consideration",31,0,0,0,31
1959648,1527223,2025-03-25,Senate,"SENATE COMMERCE AND LABOR COMMITTEE: Recommended for passage with amendment/s, refer to Senate Finance, Ways, and Means Committee Ayes 5, Nays 4 PNV 0",5,4,0,0,9
1959648,1539832,2025-04-08,Senate,"SENATE FINANCE, WAYS AND MEANS COMMITTEE: Recommended for passage with amendment/s, refer to Senate Calendar Committee Ayes 8, Nays 3 PNV 0",8,3,0,0,11
1959648,1550217,2025-04-16,House,"FLOOR VOTE: REGULAR CALENDAR PASSAGE ON THIRD CONSIDERATION",82,4,4,0,90
1959648,1550897,2025-04-16,Senate,"FLOOR VOTE: as Amended Third Consideration",27,5,0,0,32
1959651,1519593,2025-03-18,House,"POPULATION HEALTH SUBCOMMITTEE: Failed in s/c Population Health Subcommittee of Health Committee",2,7,0,0,9
1959663,1505275,2025-03-04,Senate,"SENATE COMMERCE AND LABOR COMMITTEE: Recommended for passage, refer to Senate Calendar Committee",7,0,0,0,7
1959663,1514343,2025-03-10,Senate,"FLOOR VOTE: Motion to Adopt",30,0,0,0,30
1959663,1529246,2025-03-27,House,"FLOOR VOTE: REGULAR CALENDAR PASSAGE ON THIRD CONSIDERATION",93,1,0,0,94
1959666,1500123,2025-02-26,House,"HOUSE COMMERCE COMMITTEE: Rec. for pass; ref to Calendar & Rules Committee",18,0,0,0,18
1959666,1503405,2025-03-03,House,"FLOOR VOTE: CONSENT CALENDAR PASSAGE ON THIRD CONSIDERATION",89,0,0,0,89
1959677,1505483,2025-03-04,Senate,"SENATE COMMERCE AND LABOR COMMITTEE: Recommended for passage, refer to Senate Calendar Committee",7,0,0,0,7
1959677,1513388,2025-03-10,Senate,"FLOOR VOTE: Motion to Adopt",30,0,0,0,30
1959680,1533917,2025-04-01,Senate,"SENATE JUDICIARY COMMITTEE: Recommended for passage with amendment/s, refer to Senate Finance, Ways, and Means Committee Ayes 7, Nays 2 PNV 0",6,2,0,0,8
1959680,1548912,2025-04-15,Senate,"SENATE FINANCE, WAYS AND MEANS COMMITTEE: Recommended for passage, refer to Senate Calendar Committee",9,1,0,0,10
1959690,1521848,2025-03-19,House,"HOUSE CIVIL JUSTICE SUBCOMMITTEE: Rec for pass if am by s/c ref. to Judiciary Committee",6,1,0,0,7
1959698,1527539,2025-03-26,House,"HOUSE CRIMINAL JUSTICE SUBCOMMITTEE: Rec for pass if am by s/c ref. to Judiciary Committee",6,0,2,0,8
1959698,1542096,2025-04-09,House,"HOUSE JUDICIARY COMMITTEE: Rec. for pass. if am., ref. to Finance, Ways, and Means Committee",14,5,1,0,20
1959698,1547210,2025-04-14,House,"HOUSE FINANCE, WAYS, AND MEANS SUBCOMMITTEE: Rec. for pass by s/c ref. to Finance, Ways, and Means Committee",11,0,0,0,11
1959698,1549123,2025-04-15,House,"HOUSE FINANCE, WAYS, AND MEANS COMMITTEE: Rec. for pass; ref to Calendar & Rules Committee",22,0,4,0,26
1959709,1505943,2025-03-04,Senate,"SENATE JUDICIARY COMMITTEE: Recommended for passage, refer to Senate F,W& Means Committee",8,0,0,0,8
1959709,1540758,2025-04-08,Senate,"SENATE FINANCE, WAYS AND MEANS COMMITTEE: Recommended for passage, refer to Senate Calendar Committee",9,0,0,0,9
1959714,1520885,2025-03-19,House,"HOUSE CRIMINAL JUSTICE SUBCOMMITTEE: Rec. for pass by s/c ref. to Judiciary Committee",8,0,0,0,8
1959714,1534202,2025-04-02,House,"HOUSE JUDICIARY COMMITTEE: Rec. for pass; ref to Calendar & Rules Committee",19,0,0,0,19
1959714,1538505,2025-04-07,House,"FLOOR VOTE: REGULAR CALENDAR MOTION TO ADOPT",90,1,2,0,93
1959714,1552623,2025-04-21,Senate,"SENATE FINANCE, WAYS AND MEANS COMMITTEE: Recommended for concurrence by Senate Finance, Ways, and Means Committee, refer Senate Calendar Committee",9,0,1,0,10
1959714,1556483,2025-04-22,Senate,"FLOOR VOTE: Motion to Concur",30,0,1,0,31
1959720,1516856,2025-03-12,Senate,"SENATE EDUCATION COMMITTEE: Recommended for passage with amendment/s, refer to Senate Finance, Ways, and Means Committee Ayes 9, Nays 0 PNV 0",9,0,0,0,9
1959720,1539513,2025-04-08,Senate,"SENATE FINANCE, WAYS AND MEANS COMMITTEE: Recommended for passage, refer to Senate Calendar Committee",9,0,0,0,9
1959723,1536484,2025-04-02,Senate,"SENATE JUDICIARY COMMITTEE: Recommended for passage with amendment/s, refer to Senate Calendar Committee Ayes 8, Nays 0 PNV 0",8,0,0,0,8
1959723,1549511,2025-04-15,Senate,"FLOOR VOTE: as Amended Third Consideration",32,0,0,0,32
1959723,1553228,2025-04-21,House,"FLOOR VOTE: REGULAR CALENDAR PASSAGE ON THIRD CONSIDERATION",94,0,0,0,94
1959738,1519809,2025-03-18,House,"POPULATION HEALTH SUBCOMMITTEE: Failed in s/c Population Health Subcommittee of Health Committee",2,6,0,0,8
1959742,1516001,2025-03-12,Senate,"SENATE HEALTH AND WELFARE COMMITTEE: Recommended for passage with amendment/s, refer to Senate Calendar Committee Ayes 9, Nays 0 PNV 0",9,0,0,0,9
1959747,1528113,2025-03-26,Senate,"SENATE ENERGY, AGRICULTURE AND NATURAL RESOURCES COMMITTEE: Recommended for passage, refer to Senate Calendar Committee",7,1,1,0,9
1959756,1525138,2025-03-24,Senate,"SENATE JUDICIARY COMMITTEE: Recommended for passage with amendment/s, refer to Senate Calendar Committee Ayes 7, Nays 0 PNV 1",7,0,1,0,8
1959756,1549539,2025-04-15,Senate,"FLOOR VOTE: as Amended Third Consideration",30,0,0,0,30
1959756,1553220,2025-04-21,House,"FLOOR VOTE: REGULAR CALENDAR PASSAGE ON THIRD CONSIDERATION",92,0,0,0,92
1959761,1505013,2025-03-04,Senate,"SENATE COMMERCE AND LABOR COMMITTEE: Recommended for passage with amendment/s, refer to Senate Calendar Committee Ayes 7, Nays 0 PNV 0",7,0,0,0,7
1959761,1517168,2025-03-13,Senate,"FLOOR VOTE: as Amended Third Consideration",32,0,0,0,32
1959761,1529114,2025-03-27,House,"FLOOR VOTE: REGULAR CALENDAR PASSAGE ON THIRD CONSIDERATION",95,0,1,0,96
1959772,1499420,2025-02-25,House,"HOUSE AGRICULTURE & NATURAL RESOURCES COMMITTEE: Rec. for pass; ref to Calendar & Rules Committee",16,0,0,0,16
1959772,1503826,2025-03-03,House,"FLOOR VOTE: CONSENT CALENDAR PASSAGE ON THIRD CONSIDERATION",89,0,0,0,89
1959781,1528421,2025-03-26,Senate,"SENATE ENERGY, AGRICULTURE AND NATURAL RESOURCES COMMITTEE: Recommended for passage, refer to Senate Calendar Committee",9,0,0,0,9
1959783,1551881,2025-04-17,House,"HOUSE FINANCE, WAYS, AND MEANS SUBCOMMITTEE: Rec for pass if am by s/c ref. to Finance, Ways, and Means Committee",11,0,0,0,11
1959783,1553757,2025-04-17,House,"HOUSE FINANCE, WAYS, AND MEANS COMMITTEE: Rec. for pass. if am., ref. to Calendar & Rules Committee",28,0,0,0,28
1959783,1553758,2025-04-17,House,"HOUSE FINANCE, WAYS, AND MEANS COMMITTEE: Rec. for pass; ref to Calendar & Rules Committee",27,0,0,0,27
1959787,1505152,2025-03-04,House,"HOUSE EDUCATION COMMITTEE: Rec. for pass; ref to Calendar & Rules Committee",17,0,0,0,17
1959787,1512124,2025-03-10,House,"FLOOR VOTE: CONSENT CALENDAR PASSAGE ON THIRD CONSIDERATION",94,0,0,0,94
1959789,1485899,2025-02-10,House,"FLOOR VOTE: CONSENT CALENDAR PASSAGE ON THIRD CONSIDERATION",88,0,0,0,88
1959789,1490549,2025-02-13,Senate,"FLOOR VOTE: Motion to Adopt",31,0,0,0,31
1959792,1514626,2025-03-11,House,"HOUSE EDUCATION COMMITTEE: Rec. for pass; ref to Calendar & Rules Committee",17,0,0,0,17
1959792,1518823,2025-03-17,House,"FLOOR VOTE: CONSENT CALENDAR PASSAGE ON THIRD CONSIDERATION",92,0,1,0,93
1959803,1520415,2025-03-18,House,"HOUSE EDUCATION ADMINISTRATION SUBCOMMITTEE: Rec. for pass by s/c ref. to Education Committee",6,0,0,0,6
1959803,1534806,2025-04-02,House,"HOUSE EDUCATION COMMITTEE: Rec. for pass. if am., ref. to Calendar & Rules Committee",17,0,0,0,17
1959808,1532360,2025-04-01,House,"HOUSE CRIMINAL JUSTICE SUBCOMMITTEE: Rec for pass if am by s/c ref. to Judiciary Committee",7,0,2,0,9
1959808,1540403,2025-04-08,House,"HOUSE JUDICIARY COMMITTEE: Rec. for pass. if am., ref. to Finance, Ways, and Means Committee",19,1,0,0,20
1959808,1551987,2025-04-17,House,"HOUSE FINANCE, WAYS, AND MEANS SUBCOMMITTEE: Rec. for pass by s/c ref. to Finance, Ways, and Means Committee",11,0,0,0,11
1959808,1553454,2025-04-17,House,"HOUSE FINANCE, WAYS, AND MEANS COMMITTEE: Rec. for pass; ref to Calendar & Rules Committee",27,0,0,0,27
1959808,1553455,2025-04-17,House,"HOUSE FINANCE, WAYS, AND MEANS COMMITTEE: Rec. for pass; ref to Calendar & Rules Committee",28,0,0,0,28
1959813,1498731,2025-02-25,House,"HOUSE EDUCATION COMMITTEE: Rec. for pass; ref to Calendar & Rules Committee",16,0,0,0,16
1959813,1503957,2025-03-03,House,"FLOOR VOTE: CONSENT CALENDAR PASSAGE ON THIRD CONSIDERATION",89,0,0,0,89
1959817,1504837,2025-03-04,House,"HOUSE EDUCATION COMMITTEE: Rec. for pass; ref to Calendar & Rules Committee",17,0,0,0,17
1959817,1509654,2025-03-10,House,"FLOOR VOTE: CONSENT CALENDAR PASSAGE ON THIRD CONSIDERATION",94,0,0,0,94
1959820,1527460,2025-03-26,House,"HOUSE CRIMINAL JUSTICE SUBCOMMITTEE: Def. to Summer Study in Criminal Justice Subcommittee",8,0,0,0,8
1959839,1521914,2025-03-19,House,"INSURANCE SUBCOMMITTEE: Rec for pass if am by s/c ref. to Insurance Committee",5,0,0,0,5
1959839,1534970,2025-04-02,House,"HOUSE INSURANCE COMMITTEE: Rec. for pass. if am., ref. to Government Operations Committee",14,0,0,0,14
1959839,1550113,2025-04-16,House,"HOUSE GOVERNMENT OPERATIONS COMMITTEE: Rec. for pass; ref to Calendar & Rules Committee",12,0,0,0,12
1959857,1498766,2025-02-25,House,"HOUSE DEPARTMENTS & AGENCIES SUBCOMMITTEE: Rec. for pass by s/c ref. to State & Local Government Committee",6,2,0,0,8
1959857,1506407,2025-03-05,House,"HOUSE STATE & LOCAL GOVERNMENT COMMITTEE: Rec. for pass. if am., ref. to Calendar & Rules Committee",17,6,0,0,23
1959857,1509645,2025-03-10,House,"FLOOR VOTE: REGULAR CALENDAR AS AMENDED PASSAGE ON THIRD CONSIDERATION",71,22,0,0,93
1959857,1509646,2025-03-10,House,"FLOOR VOTE: REGULAR CALENDAR PREVIOUS QUESTION AS AMENDED PASSAGE ON THIRD CONSIDERATION",70,22,0,0,92
1959857,1531897,2025-03-31,Senate,"FLOOR VOTE: Motion to Table Re-Refer to Committee",24,6,0,0,30
1959857,1531898,2025-03-31,Senate,"FLOOR VOTE: as Amended Third Consideration",24,6,0,0,30
1959857,1538713,2025-04-07,House,"FLOOR VOTE: MESSAGE CALENDAR CONCUR IN SENATE AMENDMENT # 1",73,22,0,0,95
1959865,1522358,2025-03-19,Senate,"SENATE EDUCATION COMMITTEE: Recommended for passage with amendment/s, refer to Senate Finance, Ways, and Means Committee Ayes 8, Nays 0 PNV 0",8,0,0,0,8
1959867,1527737,2025-03-26,Senate,"SENATE ENERGY, AGRICULTURE AND NATURAL RESOURCES COMMITTEE: Recommended for passage, refer to Senate Finance, Ways, and Means Committee",9,0,0,0,9
1959878,1532884,2025-04-01,House,"HOUSE CRIMINAL JUSTICE SUBCOMMITTEE: Rec for pass if am by s/c ref. to Judiciary Committee",7,0,2,0,9
1959878,1543162,2025-04-09,House,"HOUSE JUDICIARY COMMITTEE: Rec. for pass. if am., ref. to Calendar & Rules Committee",20,0,0,0,20
1959882,1528193,2025-03-26,Senate,"SENATE HEALTH AND WELFARE COMMITTEE: Recommended for passage with amendment/s, refer to Senate Calendar Committee Ayes 8, Nays 0 PNV 1",8,0,1,0,9
1959888,1516875,2025-03-12,Senate,"SENATE EDUCATION COMMITTEE: Recommended for passage with amendment/s, refer to Senate Calendar Committee Ayes 7, Nays 2 PNV 0",7,2,0,0,9
1959888,1525879,2025-03-24,Senate,"FLOOR VOTE: as Amended Third Consideration",27,5,0,0,32
1959888,1547476,2025-04-14,House,"FLOOR VOTE: REGULAR CALENDAR PASSAGE ON THIRD CONSIDERATION",70,19,2,0,91
1959888,1547477,2025-04-14,House,"FLOOR VOTE: REGULAR CALENDAR PREVIOUS QUESTION PASSAGE ON THIRD CONSIDERATION",73,19,0,0,92
1959892,1506727,2025-03-05,House,"HOUSE STATE & LOCAL GOVERNMENT COMMITTEE: Rec. for pass; ref to Calendar & Rules Committee",18,0,0,0,18
1959892,1511868,2025-03-10,House,"FLOOR VOTE: CONSENT CALENDAR PASSAGE ON THIRD CONSIDERATION",94,0,0,0,94
1959901,1528156,2025-03-26,Senate,"SENATE HEALTH AND WELFARE COMMITTEE: Recommended for passage with amendment/s, refer to Senate Calendar Committee Ayes 9, Nays 0 PNV 0",9,0,0,0,9
1959901,1539261,2025-04-07,Senate,"FLOOR VOTE: as Amended Third Consideration",32,0,0,0,32
1959901,1551311,2025-04-17,House,"FLOOR VOTE: REGULAR CALENDAR PASSAGE ON THIRD CONSIDERATION",75,18,1,0,94
1959916,1500630,2025-02-26,Senate,"SENATE HEALTH AND WELFARE COMMITTEE: Recommended for passage with amendment/s, refer to Senate Calendar Committee Ayes 9, Nays 0 PNV 0",9,0,0,0,9
1959916,1514009,2025-03-03,Senate,"FLOOR VOTE: as Amended Third Consideration",31,0,0,0,31
1959916,1539382,2025-04-07,House,"FLOOR VOTE: REGULAR CALENDAR PASSAGE ON THIRD CONSIDERATION",95,0,0,0,95
1959918,1515088,2025-03-11,House,"HOUSE EDUCATION ADMINISTRATION SUBCOMMITTEE: Rec for pass if am by s/c ref. to Education Committee",6,0,0,0,6
1959918,1526502,2025-03-25,House,"HOUSE EDUCATION COMMITTEE: Rec. for pass. if am., ref. to Finance, Ways, and Means Committee",18,0,0,0,18
1959918,1534126,2025-04-02,House,"HOUSE FINANCE, WAYS, AND MEANS SUBCOMMITTEE: Rec for pass if am by s/c ref. to Finance, Ways, and Means Committee",10,0,0,0,10
1959918,1547167,2025-04-14,House,"HOUSE FINANCE, WAYS, AND MEANS COMMITTEE: Rec. for pass. if am., ref. to Calendar & Rules Committee",23,2,1,0,26
1959923,1515865,2025-03-12,Senate,"TRANSPORTATION AND SAFETY COMMITTEE: Recommended for passage, refer to Senate Calendar Committee",9,0,0,0,9
1959923,1519628,2025-03-17,Senate,"FLOOR VOTE: Motion to Adopt",32,0,0,0,32
1959931,1527790,2025-03-26,Senate,"SENATE ENERGY, AGRICULTURE AND NATURAL RESOURCES COMMITTEE: Recommended for passage, refer to Senate Calendar Committee",9,0,0,0,9
1959936,1528472,2025-03-26,Senate,"SENATE EDUCATION COMMITTEE: Recommended for passage, refer to Senate Finance, Ways, and Means Committee",9,0,0,0,9
1959950,1504732,2025-03-04,House,"HOUSE EDUCATION COMMITTEE: Rec. for pass; ref to Calendar & Rules Committee",17,0,0,0,17
1959950,1509595,2025-03-10,House,"FLOOR VOTE: CONSENT CALENDAR PASSAGE ON THIRD CONSIDERATION",94,0,0,0,94
1959952,1515650,2025-03-12,Senate,"SENATE GOVERNMENT OPERATIONS COMMITTEE: Recommended for passage with amendment/s, refer to Senate Energy, Ag., and Nat. Resources Committee Ayes 9, Nays 0 PNV 0",9,0,0,0,9
1959952,1521509,2025-03-19,Senate,"SENATE ENERGY, AGRICULTURE AND NATURAL RESOURCES COMMITTEE: Recommended for passage, refer to Senate Commerce and Labor Committee",7,1,1,0,9
1959952,1527231,2025-03-25,Senate,"SENATE COMMERCE AND LABOR COMMITTEE: Recommended for passage, refer to Senate State and Local Government Committee",6,3,0,0,9
1959952,1534349,2025-04-02,Senate,"SENATE STATE & LOCAL GOVERNMENT COMMITTEE: Recommended for passage with amendment/s, refer to Senate Calendar Committee Ayes 8, Nays 1 PNV 0",8,1,0,0,9
1959962,1514959,2025-03-11,House,"HOUSE EDUCATION ADMINISTRATION SUBCOMMITTEE: Rec. for pass by s/c ref. to Education Committee",5,1,0,0,6
1959962,1526468,2025-03-25,House,"HOUSE EDUCATION COMMITTEE: Rec. for pass. if am., ref. to Finance, Ways, and Means Committee",14,2,1,0,17
1959962,1534181,2025-04-02,House,"HOUSE FINANCE, WAYS, AND MEANS SUBCOMMITTEE: Rec. for pass by s/c ref. to Finance, Ways, and Means Committee",11,0,0,0,11
1959965,1499007,2025-02-25,House,"HOUSE EDUCATION COMMITTEE: Rec. for pass; ref to Calendar & Rules Committee",15,1,0,0,16
1959971,1504849,2025-03-04,House,"HOUSE EDUCATION INSTRUCTION SUBCOMMITTEE: Rec. for pass by s/c ref. to Education Committee",5,0,0,0,5
1959971,1532163,2025-04-01,House,"HOUSE EDUCATION COMMITTEE: Rec. for pass. if am., ref. to Calendar & Rules Committee",18,0,0,0,18
1959991,1527389,2025-03-26,House,"HOUSE CRIMINAL JUSTICE SUBCOMMITTEE: Rec. for pass by s/c ref. to Judiciary Committee",9,0,0,0,9
1959991,1541010,2025-04-08,House,"HOUSE JUDICIARY COMMITTEE: Rec. for pass. if am., ref. to Calendar & Rules Committee",20,0,0,0,20
1959993,1552675,2025-04-21,Senate,"SENATE FINANCE, WAYS AND MEANS COMMITTEE: Recommended for passage with amendment/s, refer to Senate Calendar Committee Ayes 9, Nays 2 PNV 0",9,2,0,0,11
1959997,1501232,2025-02-26,Senate,"SENATE EDUCATION COMMITTEE: Recommended for passage with amendment/s, refer to Senate Calendar Committee Ayes 9, Nays 0 PNV 0",9,0,0,0,9
1959997,1513889,2025-03-06,Senate,"FLOOR VOTE: as Amended Third Consideration",28,0,0,0,28
1959997,1547868,2025-04-14,House,"FLOOR VOTE: REGULAR CALENDAR PASSAGE ON THIRD CONSIDERATION",72,22,0,0,94
1959997,1548489,2025-04-15,House,"FLOOR VOTE: REGULAR CALENDAR AS AMENDED PASSAGE ON THIRD CONSIDERATION",70,23,0,0,93
1959997,1548490,2025-04-15,House,"FLOOR VOTE: REGULAR CALENDAR MOTION TO ADOPT AMENDMENT # 2 BY LAMBERTH PASSAGE ON THIRD CONSIDERATION",74,21,0,0,95
1959997,1548491,2025-04-15,House,"FLOOR VOTE: REGULAR CALENDAR MOTION TO CONSIDER AMENDMENT # 2 BY LAMBERTH PASSAGE ON THIRD CONSIDERATION",77,19,0,0,96
1959997,1552393,2025-04-17,Senate,"FLOOR VOTE: Motion to Concur House Amendment # 2",27,5,0,0,32
1960005,1521022,2025-03-19,House,"HOUSE HEALTH SUBCOMMITTEE: Rec for pass if am by s/c ref. to Health Committee",7,0,0,0,7
1960005,1526866,2025-03-25,House,"HOUSE HEALTH COMMITTEE: Rec. for pass. if am., ref. to Calendar & Rules Committee",21,0,0,0,21
1960005,1531691,2025-03-31,House,"FLOOR VOTE: REGULAR CALENDAR AS AMENDED PASSAGE ON THIRD CONSIDERATION",93,0,1,0,94
1960018,1527225,2025-03-25,Senate,"SENATE COMMERCE AND LABOR COMMITTEE: Recommended for passage with amendment/s, refer to Senate Calendar Committee Ayes 8, Nays 1 PNV 0",8,1,0,0,9
1960018,1550926,2025-04-16,Senate,"FLOOR VOTE: as Amended Third Consideration",26,7,0,0,33
1960018,1553318,2025-04-21,House,"FLOOR VOTE: REGULAR CALENDAR AS AMENDED PASSAGE ON THIRD CONSIDERATION",66,23,3,0,92
1960029,1494510,2025-02-19,House,"HOUSE AGRICULTURE AND NATURAL RESOURCES SUBCOMMITTEE: Rec. for pass by s/c ref. to Agriculture & Natural Resources Committee",8,0,0,0,8
1960029,1498787,2025-02-25,House,"HOUSE AGRICULTURE & NATURAL RESOURCES COMMITTEE: Rec. for pass; ref to Calendar & Rules Committee",16,0,0,0,16
1960029,1503708,2025-03-03,House,"FLOOR VOTE: CONSENT CALENDAR PASSAGE ON THIRD CONSIDERATION",89,0,0,0,89
1960029,1528087,2025-03-26,Senate,"SENATE ENERGY, AGRICULTURE AND NATURAL RESOURCES COMMITTEE: Recommended for concurrence by Senate Energy, Ag., and Nat. Resources Committee, refer Senate Calendar Committee",8,0,0,0,8
1960029,1531887,2025-03-31,Senate,"FLOOR VOTE: Motion to Adopt",30,0,0,0,30
1960031,1505672,2025-03-04,Senate,"SENATE JUDICIARY COMMITTEE: Recommended for passage, refer to Senate Calendar Committee",8,0,0,0,8
1960031,1515412,2025-03-10,Senate,"FLOOR VOTE: Motion to Adopt",30,0,0,0,30
1960035,1521235,2025-03-19,House,"HOUSE HEALTH SUBCOMMITTEE: Rec for pass if am by s/c ref. to Health Committee",7,0,0,0,7
1960035,1532863,2025-04-01,House,"HOUSE HEALTH COMMITTEE: Rec. for pass. if am., ref. to Calendar & Rules Committee",23,0,0,0,23
1960035,1539116,2025-04-07,House,"FLOOR VOTE: REGULAR CALENDAR AS AMENDED PASSAGE ON THIRD CONSIDERATION",92,1,0,0,93
1960035,1539474,2025-04-07,Senate,"FLOOR VOTE: Third Consideration",27,4,0,0,31
1960042,1505422,2025-03-04,Senate,"SENATE COMMERCE AND LABOR COMMITTEE: Recommended for passage, refer to Senate Calendar Committee",6,0,1,0,7
1960045,1520355,2025-03-18,House,"HOUSE EDUCATION COMMITTEE: Rec. for pass; ref to Calendar & Rules Committee",17,0,0,0,17
1960045,1550326,2025-04-16,House,"FLOOR VOTE: CONSENT CALENDAR PASSAGE ON THIRD CONSIDERATION",96,0,0,0,96
1960070,1527647,2025-03-26,House,"HOUSE CIVIL JUSTICE SUBCOMMITTEE: Rec. for pass by s/c ref. to Judiciary Committee",4,3,0,0,7
1960072,1515999,2025-03-11,Senate,"SENATE STATE & LOCAL GOVERNMENT COMMITTEE: Recommended for passage, refer to Senate Finance, Ways, and Means Committee",9,0,0,0,9
1960072,1539683,2025-04-08,Senate,"SENATE FINANCE, WAYS AND MEANS COMMITTEE: Recommended for passage, refer to Senate Calendar Committee",10,0,0,0,10
1960074,1506403,2025-03-05,Senate,"SENATE HEALTH AND WELFARE COMMITTEE: Recommended for passage, refer to Senate Calendar Committee",9,0,0,0,9
1960077,1515887,2025-03-12,House,"HOUSE CRIMINAL JUSTICE SUBCOMMITTEE: Rec for pass if am by s/c ref. to Judiciary Committee",7,0,0,0,7
1960077,1527542,2025-03-26,House,"HOUSE JUDICIARY COMMITTEE: Rec. for pass. if am., ref. to Finance, Ways, and Means Committee",19,0,0,0,19
1960077,1534082,2025-04-02,House,"HOUSE FINANCE, WAYS, AND MEANS SUBCOMMITTEE: Rec for pass if am by s/c ref. to Finance, Ways, and Means Committee",10,0,0,0,10
1960077,1547144,2025-04-14,House,"HOUSE FINANCE, WAYS, AND MEANS COMMITTEE: Rec. for pass. if am., ref. to Calendar & Rules Committee",27,0,0,0,27
1960077,1550358,2025-04-16,House,"FLOOR VOTE: REGULAR CALENDAR AS AMENDED PASSAGE ON THIRD CONSIDERATION",96,0,0,0,96
1960077,1556471,2025-04-21,Senate,"FLOOR VOTE: Third Consideration",32,0,0,0,32
1960081,1498893,2025-02-25,House,"HOUSE EDUCATION COMMITTEE: Rec. for pass; ref to Calendar & Rules Committee",15,1,0,0,16
1960091,1516857,2025-03-12,Senate,"SENATE EDUCATION COMMITTEE: Recommended for passage, refer to Senate Calendar Committee",9,0,0,0,9
1960091,1525783,2025-03-24,Senate,"FLOOR VOTE: Motion to Adopt",32,0,0,0,32
1960091,1547776,2025-04-14,House,"FLOOR VOTE: REGULAR CALENDAR AS AMENDED PASSAGE ON THIRD CONSIDERATION",82,14,0,0,96
1960091,1551000,2025-04-16,Senate,"FLOOR VOTE: Motion to Concur House Amendment # 1",32,0,0,0,32
1960097,1494590,2025-02-19,House,"HOUSE HEALTH SUBCOMMITTEE: Rec. for pass by s/c ref. to Health Committee",7,2,0,0,9
1960097,1504676,2025-03-04,House,"HOUSE HEALTH COMMITTEE: Rec. for pass. if am., ref. to Calendar & Rules Committee",16,2,1,0,19
1960097,1509704,2025-03-10,House,"FLOOR VOTE: REGULAR CALENDAR AS AMENDED PASSAGE ON THIRD CONSIDERATION",69,22,1,0,92
1960117,1505331,2025-03-04,Senate,"SENATE STATE & LOCAL GOVERNMENT COMMITTEE: Recommended for passage, refer to Senate Calendar Committee",9,0,0,0,9
1960117,1513563,2025-03-10,Senate,"FLOOR VOTE: Motion to Adopt",30,0,0,0,30
1960120,1505905,2025-03-04,Senate,"SENATE JUDICIARY COMMITTEE: Recommended for passage with amdt, refer to Senate Judiciary Committee",9,0,0,0,9
1960120,1517538,2025-03-13,Senate,"FLOOR VOTE: as Amended Third Consideration",32,0,0,0,32
1960120,1529284,2025-03-27,House,"FLOOR VOTE: REGULAR CALENDAR PASSAGE ON THIRD CONSIDERATION",95,1,0,0,96
1960122,1505270,2025-03-04,Senate,"SENATE STATE & LOCAL GOVERNMENT COMMITTEE: Recommended for passage, refer to Senate Calendar Committee",9,0,0,0,9
1960133,1520368,2025-03-18,House,"HOUSE EDUCATION ADMINISTRATION SUBCOMMITTEE: Rec. for pass by s/c ref. to Education Committee",5,1,0,0,6
1960133,1534613,2025-04-02,House,"HOUSE EDUCATION COMMITTEE: Rec. for pass. if am., ref. to Finance, Ways, and Means Committee",14,3,1,0,18
1960133,1541933,2025-04-09,House,"HOUSE FINANCE, WAYS, AND MEANS SUBCOMMITTEE: Rec. for pass by s/c ref. to Finance, Ways, and Means Committee",10,0,0,0,10
1960133,1547156,2025-04-14,House,"HOUSE FINANCE, WAYS, AND MEANS COMMITTEE: Rec. for pass; ref to Calendar & Rules Committee",20,6,0,0,26
1960141,1489960,2025-02-13,Senate,"FLOOR VOTE: Motion to Adopt",31,0,0,0,31
1960141,1497938,2025-02-24,House,"FLOOR VOTE: CONSENT CALENDAR PASSAGE ON THIRD CONSIDERATION",92,0,2,0,94
1960147,1500205,2025-02-26,Senate,"SENATE HEALTH AND WELFARE COMMITTEE: Recommended for passage, refer to Senate Calendar Committee",9,0,0,0,9
1960147,1514365,2025-03-03,Senate,"FLOOR VOTE: Motion to Adopt",32,0,0,0,32
1960153,1541266,2025-04-08,Senate,"SENATE JUDICIARY COMMITTEE: Failed in Senate Judiciary Committee",4,3,1,0,8
1960162,1514053,2025-03-11,Senate,"SENATE COMMERCE AND LABOR COMMITTEE: Recommended for passage with amendment/s, refer to Senate Calendar Committee Ayes 8, Nays 1 PNV 0",8,1,0,0,9
1960162,1522648,2025-03-20,House,"FLOOR VOTE: REGULAR CALENDAR PASSAGE ON THIRD CONSIDERATION",82,13,0,0,95
1960162,1522649,2025-03-20,Senate,"FLOOR VOTE: as Amended Third Consideration",27,3,2,0,32
1960166,1520846,2025-03-18,Senate,"SENATE JUDICIARY COMMITTEE: Recommended for passage with amendment/s, refer to Senate Calendar Committee Ayes 9, Nays 0 PNV 0",9,0,0,0,9
1960166,1531971,2025-03-31,Senate,"FLOOR VOTE: as Amended Third Consideration",28,1,0,0,29
1960166,1547633,2025-04-14,House,"FLOOR VOTE: REGULAR CALENDAR PASSAGE ON THIRD CONSIDERATION",86,9,0,0,95
1960168,1499347,2025-02-25,House,"HOUSE AGRICULTURE & NATURAL RESOURCES COMMITTEE: Rec. for pass; ref to Calendar & Rules Committee",16,0,0,0,16
1960168,1503508,2025-03-03,House,"FLOOR VOTE: CONSENT CALENDAR PASSAGE ON THIRD CONSIDERATION",89,0,0,0,89
1960177,1514023,2025-03-11,House,"HOUSE EDUCATION COMMITTEE: Rec. for pass; ref to Calendar & Rules Committee",17,0,0,0,17
1960177,1518907,2025-03-17,House,"FLOOR VOTE: CONSENT CALENDAR PASSAGE ON THIRD CONSIDERATION",92,0,1,0,93
1960185,1519822,2025-03-18,House,"HOUSE CHILDREN AND FAMILY AFFAIRS SUBCOMMITTEE: Rec for pass if am by s/c ref. to Judiciary Committee",6,0,0,0,6
1960185,1539461,2025-04-08,House,"HOUSE JUDICIARY COMMITTEE: Rec. for pass. if am., ref. to Calendar & Rules Committee",18,0,0,0,18
1960190,1504666,2025-03-04,House,"HOUSE EDUCATION COMMITTEE: Rec. for pass; ref to Calendar & Rules Committee",17,0,0,0,17
1960190,1509590,2025-03-10,House,"FLOOR VOTE: CONSENT CALENDAR PASSAGE ON THIRD CONSIDERATION",94,0,0,0,94
1960194,1528483,2025-03-26,Senate,"SENATE EDUCATION COMMITTEE: Recommended for passage with amendment/s, refer to Senate Finance, Ways, and Means Committee Ayes 9, Nays 0 PNV 0",9,0,0,0,9
1960194,1539631,2025-04-08,Senate,"SENATE FINANCE, WAYS AND MEANS COMMITTEE: Recommended for passage with amendment/s, refer to Senate Calendar Committee Ayes 9, Nays 1 PNV 0",9,1,0,0,10
1960194,1549613,2025-04-15,Senate,"FLOOR VOTE: as Amended Third Consideration",32,0,0,0,32
1960194,1554676,2025-04-22,House,"FLOOR VOTE: REGULAR CALENDAR PASSAGE ON THIRD CONSIDERATION",97,0,0,0,97
1960205,1520444,2025-03-18,House,"HOUSE EDUCATION ADMINISTRATION SUBCOMMITTEE: Rec for pass if am by s/c ref. to Education Committee",6,0,0,0,6
1960205,1532158,2025-04-01,House,"HOUSE EDUCATION COMMITTEE: Rec. for pass. if am., ref. to Calendar & Rules Committee",15,0,3,0,18
1960205,1538356,2025-04-07,House,"FLOOR VOTE: REGULAR CALENDAR AS AMENDED PASSAGE ON THIRD CONSIDERATION",79,11,1,0,91
1960205,1538357,2025-04-07,House,"FLOOR VOTE: REGULAR CALENDAR PREVIOUS QUESTION AS AMENDED PASSAGE ON THIRD CONSIDERATION",73,22,0,0,95
1960205,1539297,2025-04-07,Senate,"FLOOR VOTE: Third Consideration",30,1,1,0,32
1960211,1516861,2025-03-12,Senate,"SENATE EDUCATION COMMITTEE: Recommended for passage with amendment/s, refer to Senate Calendar Committee Ayes 9, Nays 0 PNV 0",9,0,0,0,9
1960211,1525791,2025-03-24,Senate,"FLOOR VOTE: as Amended Third Consideration",32,0,0,0,32
1960211,1529047,2025-03-27,House,"FLOOR VOTE: REGULAR CALENDAR PASSAGE ON THIRD CONSIDERATION",95,0,0,0,95
1960225,1528074,2025-03-26,Senate,"SENATE ENERGY, AGRICULTURE AND NATURAL RESOURCES COMMITTEE: Recommended for passage, refer to Senate Finance, Ways, and Means Committee",9,0,0,0,9
1960225,1539798,2025-04-08,Senate,"SENATE FINANCE, WAYS AND MEANS COMMITTEE: Recommended for passage, refer to Senate Calendar Committee",10,0,0,0,10
1960233,1505845,2025-03-05,Senate,"TRANSPORTATION AND SAFETY COMMITTEE: Recommended for passage with amendment/s, refer to Senate Calendar Committee Ayes 9, Nays 0 PNV 0",9,0,0,0,9
1960238,1500269,2025-02-26,House,"HOUSE CRIMINAL JUSTICE SUBCOMMITTEE: Rec. for pass by s/c ref. to Judiciary Committee",9,0,0,0,9
1960238,1506363,2025-03-05,House,"HOUSE JUDICIARY COMMITTEE: Rec. for pass; ref to Finance, Ways, and Means Committee",17,0,0,0,17
1960238,1535241,2025-04-02,House,"HOUSE FINANCE, WAYS, AND MEANS SUBCOMMITTEE: Rec. for pass by s/c ref. to Finance, Ways, and Means Committee",9,0,0,0,9
1960238,1541107,2025-04-08,House,"HOUSE FINANCE, WAYS, AND MEANS COMMITTEE: Rec. for pass; ref to Calendar & Rules Committee",28,0,0,0,28
1960243,1515804,2025-03-12,House,"HOUSE HEALTH SUBCOMMITTEE: Rec. for pass by s/c ref. to Health Committee",9,0,0,0,9
1960243,1526507,2025-03-25,House,"HOUSE HEALTH COMMITTEE: Rec. for pass; ref to Government Operations Committee",21,3,0,0,24
1960243,1549517,2025-04-16,House,"HOUSE GOVERNMENT OPERATIONS COMMITTEE: Rec. for pass; ref to Finance, Ways, and Means Committee",9,0,0,0,9
1960260,1504804,2025-03-04,House,"HOUSE EDUCATION COMMITTEE: Rec. for pass; ref to Calendar & Rules Committee",17,0,0,0,17
1960260,1509173,2025-03-10,House,"FLOOR VOTE: CONSENT CALENDAR PASSAGE ON THIRD CONSIDERATION",94,0,0,0,94
1960266,1514665,2025-03-11,Senate,"SENATE FINANCE, WAYS AND MEANS COMMITTEE: Recommended for passage, refer to Senate Calendar Committee",11,0,0,0,11
1960266,1517540,2025-03-13,House,"FLOOR VOTE: REGULAR CALENDAR PASSAGE ON THIRD CONSIDERATION",90,0,0,0,90
1960278,1527643,2025-03-26,Senate,"SENATE ENERGY, AGRICULTURE AND NATURAL RESOURCES COMMITTEE: Recommended for passage with amendment/s, refer to Senate Finance, Ways, and Means Committee Ayes 9, Nays 0 PNV 0",9,0,0,0,9
1960278,1539777,2025-04-08,Senate,"SENATE FINANCE, WAYS AND MEANS COMMITTEE: Recommended for passage, refer to Senate Calendar Committee",10,0,0,0,10
1960278,1549599,2025-04-15,Senate,"FLOOR VOTE: as Amended Third Consideration",31,0,0,0,31
1960278,1553610,2025-04-21,House,"FLOOR VOTE: REGULAR CALENDAR PASSAGE ON THIRD CONSIDERATION",92,0,0,0,92
1960280,1519696,2025-03-18,Senate,"SENATE STATE & LOCAL GOVERNMENT COMMITTEE: Recommended for passage, refer to Senate Calendar Committee",7,1,1,0,9
1960280,1531894,2025-03-31,Senate,"FLOOR VOTE: Third Consideration",24,1,5,0,30
1960280,1553268,2025-04-21,House,"FLOOR VOTE: REGULAR CALENDAR PASSAGE ON THIRD CONSIDERATION",76,16,1,0,93
1960282,1515875,2025-03-12,House,"HOUSE HEALTH SUBCOMMITTEE: Rec. for pass by s/c ref. to Health Committee",9,0,0,0,9
1960282,1526542,2025-03-25,House,"HOUSE HEALTH COMMITTEE: Rec. for pass; ref to Calendar & Rules Committee",24,0,0,0,24
1960282,1531209,2025-03-31,House,"FLOOR VOTE: CONSENT CALENDAR PASSAGE ON THIRD CONSIDERATION",93,0,2,0,95
1960284,1519862,2025-03-18,House,"HOUSE CHILDREN AND FAMILY AFFAIRS SUBCOMMITTEE: Rec. for pass by s/c ref. to Judiciary Committee",6,0,0,0,6
1960284,1543167,2025-04-09,House,"HOUSE JUDICIARY COMMITTEE: Rec. for pass. if am., ref. to Calendar & Rules Committee",19,1,1,0,21
1960291,1533975,2025-04-01,Senate,"SENATE JUDICIARY COMMITTEE: Recommended for passage w/amendment, refer to Senate Finance, Ways, and Means Committee",5,3,0,0,8
1960324,1494767,2025-02-19,House,"HOUSE AGRICULTURE AND NATURAL RESOURCES SUBCOMMITTEE: Rec. for pass by s/c ref. to Agriculture & Natural Resources Committee",8,0,0,0,8
1960324,1498590,2025-02-25,House,"HOUSE AGRICULTURE & NATURAL RESOURCES COMMITTEE: Rec. for pass; ref to Calendar & Rules Committee",16,0,0,0,16
1960324,1504090,2025-03-03,House,"FLOOR VOTE: CONSENT CALENDAR PASSAGE ON THIRD CONSIDERATION",89,0,0,0,89
1960324,1532536,2025-03-31,Senate,"FLOOR VOTE: Motion to Adopt",30,0,0,0,30
1960328,1506831,2025-03-05,House,"HOUSE PUBLIC SERVICE SUBCOMMITTEE: Rec. for pass by s/c ref. to State & Local Government Committee",6,0,0,0,6
1960328,1516761,2025-03-12,House,"HOUSE STATE & LOCAL GOVERNMENT COMMITTEE: Rec. for pass; ref to Calendar & Rules Committee",22,1,0,0,23
1960328,1518705,2025-03-17,House,"FLOOR VOTE: CONSENT CALENDAR PASSAGE ON THIRD CONSIDERATION",92,0,1,0,93
1960332,1533101,2025-04-01,House,"HOUSE CRIMINAL JUSTICE SUBCOMMITTEE: Rec. for pass by s/c ref. to Judiciary Committee",9,0,0,0,9
1960332,1539472,2025-04-08,House,"HOUSE JUDICIARY COMMITTEE: Rec. for pass; ref to Calendar & Rules Committee",17,0,2,0,19
1960332,1547657,2025-04-14,House,"FLOOR VOTE: CONSENT CALENDAR PASSAGE ON THIRD CONSIDERATION",94,0,1,0,95
1960338,1526343,2025-03-25,House,"HOUSE CHILDREN AND FAMILY AFFAIRS SUBCOMMITTEE: Rec for pass if am by s/c ref. to Judiciary Committee",7,0,0,0,7
1960338,1539942,2025-04-08,House,"HOUSE JUDICIARY COMMITTEE: Rec. for pass. if am., ref. to Calendar & Rules Committee",19,0,0,0,19
1960341,1498751,2025-02-25,House,"HOUSE DEPARTMENTS & AGENCIES SUBCOMMITTEE: Rec. for pass by s/c ref. to State & Local Government Committee",8,0,0,0,8
1960341,1541138,2025-04-08,House,"HOUSE STATE & LOCAL GOVERNMENT COMMITTEE: Rec. for pass; ref to Calendar & Rules Committee",19,0,2,0,21
1960341,1547761,2025-04-14,House,"FLOOR VOTE: CONSENT CALENDAR PASSAGE ON THIRD CONSIDERATION",94,0,1,0,95
1960345,1516022,2025-03-12,Senate,"TRANSPORTATION AND SAFETY COMMITTEE: Recommended for passage, refer to Senate Calendar Committee",9,0,0,0,9
1960345,1519301,2025-03-17,Senate,"FLOOR VOTE: Motion to Adopt",32,0,0,0,32
1960345,1553486,2025-04-21,House,"FLOOR VOTE: REGULAR CALENDAR PASSAGE ON THIRD CONSIDERATION",93,0,0,0,93
1960352,1520396,2025-03-18,House,"HOUSE EDUCATION ADMINISTRATION SUBCOMMITTEE: Rec. for pass by s/c ref. to Education Committee",6,0,0,0,6
1960352,1526383,2025-03-25,House,"HOUSE EDUCATION COMMITTEE: Rec. for pass; ref to Calendar & Rules Committee",18,0,0,0,18
1960352,1535710,2025-04-03,House,"FLOOR VOTE: REGULAR CALENDAR MOTION TO ADOPT",88,0,0,0,88
1960356,1538140,2025-04-02,Senate,"SENATE STATE & LOCAL GOVERNMENT COMMITTEE: Failed in Senate State and Local Government Committee",1,6,2,0,9
1960361,1504783,2025-03-04,House,"HOUSE TRANSPORTATION SUBCOMMITTEE: Rec for pass if am by s/c ref. to Transportation Committee",7,2,0,0,9
1960361,1519869,2025-03-18,House,"HOUSE TRANSPORTATION COMMITTEE: Rec. for pass. if am., ref. to Calendar & Rules Committee",16,3,0,0,19
1960361,1538770,2025-04-07,House,"FLOOR VOTE: REGULAR CALENDAR AS AMENDED PASSAGE ON THIRD CONSIDERATION",83,7,4,0,94
1960361,1543681,2025-04-10,Senate,"FLOOR VOTE: Third Consideration",27,1,3,0,31
1960376,1519367,2025-03-18,House,"HOUSE K-12 SUBCOMMITTEE: Rec for pass if am by s/c ref. to Education Committee",8,0,0,0,8
1960376,1532955,2025-04-01,House,"HOUSE EDUCATION COMMITTEE: Rec. for pass. if am., ref. to Finance, Ways, and Means Committee",18,0,1,0,19
1960376,1551855,2025-04-17,House,"HOUSE FINANCE, WAYS, AND MEANS SUBCOMMITTEE: Rec. for pass by s/c ref. to Finance, Ways, and Means Committee",11,0,0,0,11
1960376,1553358,2025-04-17,House,"HOUSE FINANCE, WAYS, AND MEANS COMMITTEE: Rec. for pass; ref to Calendar & Rules Committee",27,0,0,0,27
1960381,1504171,2025-03-04,House,"HOUSE K-12 SUBCOMMITTEE: Rec. for pass by s/c ref. to Education Committee",5,0,0,0,5
1960381,1533123,2025-04-01,House,"HOUSE EDUCATION COMMITTEE: Rec. for pass. if am., ref. to Government Operations Committee",15,4,0,0,19
1960381,1538452,2025-04-07,House,"HOUSE GOVERNMENT OPERATIONS COMMITTEE: Rec. for pass; ref to Calendar & Rules Committee",8,6,1,0,15
1960385,1516018,2025-03-12,House,"HOUSE BUSINESS AND UTILITIES SUBCOMMITTEE: Rec for pass if am by s/c ref. to Commerce Committee",9,0,0,0,9
1960385,1521898,2025-03-19,House,"HOUSE COMMERCE COMMITTEE: Rec. for pass. if am., ref. to Finance, Ways, and Means Committee",22,0,0,0,22
1960385,1527343,2025-03-26,House,"HOUSE FINANCE, WAYS, AND MEANS SUBCOMMITTEE: Rec. for pass by s/c ref. to Finance, Ways, and Means Committee",12,0,0,0,12
1960385,1532937,2025-04-01,House,"HOUSE FINANCE, WAYS, AND MEANS COMMITTEE: Rec. for pass; ref to Calendar & Rules Committee",27,0,0,0,27
1960390,1528153,2025-03-26,House,"HOUSE HEALTH SUBCOMMITTEE: Rec for pass if am by s/c ref. to Health Committee",9,0,0,0,9
1960390,1532994,2025-04-01,House,"HOUSE HEALTH COMMITTEE: Rec. for pass. if am., ref. to State & Local Government Committee",21,0,0,0,21
1960390,1542269,2025-04-09,House,"HOUSE STATE & LOCAL GOVERNMENT COMMITTEE: Rec. for pass. if am., ref. to Calendar & Rules Committee",18,5,0,0,23
1960405,1520379,2025-03-18,House,"HOUSE CHILDREN AND FAMILY AFFAIRS SUBCOMMITTEE: Rec for pass if am by s/c ref. to Judiciary Committee",6,0,0,0,6
1960405,1539464,2025-04-08,House,"HOUSE JUDICIARY COMMITTEE: Rec. for pass. if am., ref. to Calendar & Rules Committee",18,0,0,0,18
1960414,1527393,2025-03-26,House,"HOUSE HEALTH SUBCOMMITTEE: Rec for pass if am by s/c ref. to Health Committee",9,0,0,0,9
1960414,1533193,2025-04-01,House,"HOUSE HEALTH COMMITTEE: Rec. for pass. if am., ref. to Calendar & Rules Committee",17,5,0,0,22
1960427,1515892,2025-03-12,House,"HOUSE PUBLIC SERVICE SUBCOMMITTEE: Rec. for pass by s/c ref. to State & Local Government Committee",4,1,0,0,5
1960427,1540134,2025-04-08,House,"HOUSE STATE & LOCAL GOVERNMENT COMMITTEE: Rec. for pass; ref to Calendar & Rules Committee",19,0,2,0,21
1960433,1499424,2025-02-25,House,"HOUSE TRANSPORTATION SUBCOMMITTEE: Rec. for pass by s/c ref. to Transportation Committee",9,0,0,0,9
1960433,1504226,2025-03-04,House,"HOUSE TRANSPORTATION COMMITTEE: Rec. for pass; ref to Calendar & Rules Committee",21,0,0,0,21
1960433,1517537,2025-03-13,House,"FLOOR VOTE: REGULAR CALENDAR PASSAGE ON THIRD CONSIDERATION",71,16,0,0,87
1960433,1519889,2025-03-17,Senate,"FLOOR VOTE: Motion to Adopt",32,0,0,0,32
1960436,1506429,2025-03-05,House,"HOUSE CIVIL JUSTICE SUBCOMMITTEE: Rec. for pass by s/c ref. to Judiciary Committee",8,0,0,0,8
1960436,1521867,2025-03-19,House,"HOUSE JUDICIARY COMMITTEE: Rec. for pass; ref to Calendar & Rules Committee",21,0,0,0,21
1960436,1525678,2025-03-24,House,"FLOOR VOTE: CONSENT CALENDAR PASSAGE ON THIRD CONSIDERATION",96,0,0,0,96
1960452,1500101,2025-02-26,House,"HOUSE BANKING AND CONSUMER AFFAIRS SUBCOMMITTEE: Rec. for pass by s/c ref. to Commerce Committee",7,0,0,0,7
1960452,1520845,2025-03-19,House,"HOUSE COMMERCE COMMITTEE: Rec. for pass. if am., ref. to Government Operations Committee",23,0,0,0,23
1960457,1532206,2025-04-01,House,"HOUSE CRIMINAL JUSTICE SUBCOMMITTEE: Rec for pass if am by s/c ref. to Judiciary Committee",9,0,0,0,9
1960457,1541909,2025-04-09,House,"HOUSE JUDICIARY COMMITTEE: Rec. for pass. if am., ref. to Calendar & Rules Committee",19,0,0,0,19
1960463,1527700,2025-03-26,House,"HOUSE CRIMINAL JUSTICE SUBCOMMITTEE: Failed in s/c Criminal Justice Subcommittee of Judiciary Committee",2,7,0,0,9
1960468,1516403,2025-03-12,House,"HOUSE AGRICULTURE AND NATURAL RESOURCES SUBCOMMITTEE: Rec. for pass by s/c ref. to Agriculture & Natural Resources Committee",7,0,0,0,7
1960468,1525897,2025-03-25,House,"HOUSE AGRICULTURE & NATURAL RESOURCES COMMITTEE: Rec. for pass. if am., ref. to Government Operations Committee",16,0,0,0,16
1960468,1531142,2025-03-31,House,"HOUSE GOVERNMENT OPERATIONS COMMITTEE: Rec. for pass; ref to Finance, Ways, and Means Committee",15,0,0,0,15
1960468,1551818,2025-04-17,House,"HOUSE FINANCE, WAYS, AND MEANS SUBCOMMITTEE: Rec. for pass by s/c ref. to Finance, Ways, and Means Committee",11,0,0,0,11
1960468,1554163,2025-04-17,House,"HOUSE FINANCE, WAYS, AND MEANS COMMITTEE: Rec. for pass; ref to Calendar & Rules Committee",27,0,0,0,27
1960479,1486603,2025-02-10,House,"FLOOR VOTE: CONSENT CALENDAR PASSAGE ON THIRD CONSIDERATION",88,0,0,0,88
1960479,1490354,2025-02-13,Senate,"FLOOR VOTE: Motion to Adopt",31,0,0,0,31
1960515,1515776,2025-03-12,House,"HOUSE CRIMINAL JUSTICE SUBCOMMITTEE: Rec for pass if am by s/c ref. to Judiciary Committee",5,0,1,0,6
1960515,1527611,2025-03-26,House,"HOUSE JUDICIARY COMMITTEE: Rec. for pass. if am., ref. to Finance, Ways, and Means Committee",15,2,1,0,18
1960515,1534131,2025-04-02,House,"HOUSE FINANCE, WAYS, AND MEANS SUBCOMMITTEE: Rec. for pass by s/c ref. to Finance, Ways, and Means Committee",11,0,0,0,11
1960515,1540019,2025-04-08,House,"HOUSE FINANCE, WAYS, AND MEANS COMMITTEE: Rec. for pass; ref to Calendar & Rules Committee",28,0,0,0,28
1960515,1547777,2025-04-14,House,"FLOOR VOTE: REGULAR CALENDAR AS AMENDED PASSAGE ON THIRD CONSIDERATION",83,11,0,0,94
1960515,1556481,2025-04-22,Senate,"FLOOR VOTE: Third Consideration",29,3,1,0,33
1960520,1505708,2025-03-05,House,"HOUSE CRIMINAL JUSTICE SUBCOMMITTEE: Rec. for pass by s/c ref. to Judiciary Committee",8,0,0,0,8
1960520,1521070,2025-03-19,House,"HOUSE JUDICIARY COMMITTEE: Rec. for pass; ref to Finance, Ways, and Means Committee",22,0,0,0,22
1960520,1527457,2025-03-26,House,"HOUSE FINANCE, WAYS, AND MEANS SUBCOMMITTEE: Rec. for pass by s/c ref. to Finance, Ways, and Means Committee",11,0,0,0,11
1960520,1533290,2025-04-01,House,"HOUSE FINANCE, WAYS, AND MEANS COMMITTEE: Rec. for pass; ref to Calendar & Rules Committee",24,0,0,0,24
1960520,1538441,2025-04-07,House,"FLOOR VOTE: CONSENT CALENDAR PASSAGE ON THIRD CONSIDERATION",96,0,0,0,96
1960520,1548037,2025-04-14,Senate,"FLOOR VOTE: Motion to Adopt",32,0,0,0,32
1960524,1519941,2025-03-18,House,"HOUSE CHILDREN AND FAMILY AFFAIRS SUBCOMMITTEE: Rec for pass if am by s/c ref. to Judiciary Committee",6,0,0,0,6
1960524,1534211,2025-04-02,House,"HOUSE JUDICIARY COMMITTEE: Rec. for pass. if am., ref. to Government Operations Committee",18,0,0,0,18
1960524,1538408,2025-04-07,House,"HOUSE GOVERNMENT OPERATIONS COMMITTEE: Rec. for pass; ref to Calendar & Rules Committee",8,0,0,0,8
1960530,1500126,2025-02-26,House,"HOUSE BANKING AND CONSUMER AFFAIRS SUBCOMMITTEE: Rec. for pass by s/c ref. to Commerce Committee",7,0,0,0,7
1960530,1506414,2025-03-05,House,"HOUSE COMMERCE COMMITTEE: Rec. for pass; ref to Judiciary Committee",16,0,0,0,16
1960530,1527570,2025-03-26,House,"HOUSE JUDICIARY COMMITTEE: Rec. for pass; ref to Calendar & Rules Committee",16,0,0,0,16
1960530,1530991,2025-03-31,House,"FLOOR VOTE: CONSENT CALENDAR PASSAGE ON THIRD CONSIDERATION",93,0,2,0,95
1960535,1505846,2025-03-05,House,"INSURANCE SUBCOMMITTEE: Rec for pass if am by s/c ref. to Insurance Committee",5,0,0,0,5
1960535,1516609,2025-03-12,House,"HOUSE INSURANCE COMMITTEE: Rec. for pass. if am., ref. to Calendar & Rules Committee",16,0,0,0,16
1960540,1495149,2025-02-18,House,"HOUSE DEPARTMENTS & AGENCIES SUBCOMMITTEE: Rec. for pass by s/c ref. to State & Local Government Committee",5,0,0,0,5
1960540,1500348,2025-02-26,House,"HOUSE STATE & LOCAL GOVERNMENT COMMITTEE: Rec. for pass; ref to Finance, Ways, and Means Committee",21,0,0,0,21
1960540,1506096,2025-03-05,House,"HOUSE FINANCE, WAYS, AND MEANS SUBCOMMITTEE: Rec. for pass by s/c ref. to Finance, Ways, and Means Committee",11,0,0,0,11
1960540,1520298,2025-03-18,House,"HOUSE FINANCE, WAYS, AND MEANS COMMITTEE: Rec. for pass; ref to Calendar & Rules Committee",21,0,0,0,21
1960543,1533920,2025-04-01,Senate,"SENATE JUDICIARY COMMITTEE: Failed in Senate Judiciary Committee",3,6,0,0,9
1960549,1520282,2025-03-18,House,"HOUSE CHILDREN AND FAMILY AFFAIRS SUBCOMMITTEE: Rec for pass if am by s/c ref. to Judiciary Committee",5,0,0,0,5
1960549,1541035,2025-04-08,House,"HOUSE JUDICIARY COMMITTEE: Rec. for pass. if am., ref. to Calendar & Rules Committee",17,0,2,0,19
1960552,1527490,2025-03-26,House,"HOUSE CRIMINAL JUSTICE SUBCOMMITTEE: Failed in s/c Criminal Justice Subcommittee of Judiciary Committee",2,7,0,0,9
1960557,1503093,2025-02-26,House,"HOUSE PUBLIC SERVICE SUBCOMMITTEE:",2,2,0,0,4
1960564,1532202,2025-04-01,House,"HOUSE CRIMINAL JUSTICE SUBCOMMITTEE: Rec for pass if am by s/c ref. to Judiciary Committee",9,0,0,0,9
1960564,1542189,2025-04-09,House,"HOUSE JUDICIARY COMMITTEE: Rec. for pass. if am., ref. to Finance, Ways, and Means Committee",21,0,0,0,21
1960564,1551900,2025-04-17,House,"HOUSE FINANCE, WAYS, AND MEANS SUBCOMMITTEE: Rec. for pass by s/c ref. to Finance, Ways, and Means Committee",11,0,0,0,11
1960564,1553418,2025-04-17,House,"HOUSE FINANCE, WAYS, AND MEANS COMMITTEE: Rec. for pass; ref to Calendar & Rules Committee",27,0,0,0,27
1960568,1494504,2025-02-18,House,"HOUSE EDUCATION ADMINISTRATION SUBCOMMITTEE: Rec. for pass by s/c ref. to Education Committee",6,0,0,0,6
1960568,1534571,2025-04-02,House,"HOUSE EDUCATION COMMITTEE: Rec. for pass. if am., ref. to Calendar & Rules Committee",16,1,2,0,19
1960568,1548884,2025-04-15,House,"FLOOR VOTE: REGULAR CALENDAR AS AMENDED PASSAGE ON THIRD CONSIDERATION",87,5,5,0,97
1960568,1554467,2025-04-22,House,"FLOOR VOTE: MESSAGE CALENDAR 3 CONCUR IN SENATE AMENDMENT # 1",92,3,2,0,97
1960568,1556800,2025-04-22,Senate,"FLOOR VOTE: as Amended Third Consideration",27,6,0,0,33
1960580,1526304,2025-03-25,House,"HOUSE DEPARTMENTS & AGENCIES SUBCOMMITTEE: Rec. for pass by s/c ref. to State & Local Government Committee",8,0,0,0,8
1960580,1543142,2025-04-09,House,"HOUSE STATE & LOCAL GOVERNMENT COMMITTEE: Rec. for pass. if am., ref. to Finance, Ways, and Means Committee",22,0,0,0,22
1960580,1553742,2025-04-22,House,"HOUSE FINANCE, WAYS, AND MEANS SUBCOMMITTEE: Rec for pass if am by s/c ref. to Finance, Ways, and Means Committee",12,0,0,0,12
1960585,1506587,2025-03-05,House,"HOUSE FINANCE, WAYS, AND MEANS SUBCOMMITTEE: Rec. for pass by s/c ref. to Finance, Ways, and Means Committee",11,0,0,0,11
1960585,1519873,2025-03-18,House,"HOUSE FINANCE, WAYS, AND MEANS COMMITTEE: Rec. for pass; ref to Calendar & Rules Committee",21,0,0,0,21
1960585,1524905,2025-03-24,House,"FLOOR VOTE: CONSENT CALENDAR PASSAGE ON THIRD CONSIDERATION",96,0,0,0,96
1960585,1548020,2025-04-14,Senate,"FLOOR VOTE: Motion to Adopt",32,0,0,0,32
1960588,1519997,2025-03-18,House,"HOUSE EDUCATION ADMINISTRATION SUBCOMMITTEE: Rec for pass if am by s/c ref. to Education Committee",6,0,0,0,6
1960588,1534791,2025-04-02,House,"HOUSE EDUCATION COMMITTEE: Rec. for pass. if am., ref. to Calendar & Rules Committee",18,1,0,0,19
1960598,1515769,2025-03-12,House,"HOUSE HEALTH SUBCOMMITTEE: Rec for pass if am by s/c ref. to Health Committee",9,0,0,0,9
1960598,1526489,2025-03-25,House,"HOUSE HEALTH COMMITTEE: Rec. for pass. if am., ref. to Government Operations Committee",24,0,0,0,24
1960598,1531323,2025-03-31,House,"HOUSE GOVERNMENT OPERATIONS COMMITTEE: Rec. for pass; ref to Finance, Ways, and Means Committee",14,0,0,0,14
1960598,1542012,2025-04-09,House,"HOUSE FINANCE, WAYS, AND MEANS SUBCOMMITTEE: Rec. for pass by s/c ref. to Finance, Ways, and Means Committee",12,0,0,0,12
1960598,1547172,2025-04-14,House,"HOUSE FINANCE, WAYS, AND MEANS COMMITTEE: Rec. for pass; ref to Calendar & Rules Committee",27,0,0,0,27
1960603,1505070,2025-03-04,House,"HOUSE DEPARTMENTS & AGENCIES SUBCOMMITTEE: Rec. for pass by s/c ref. to State & Local Government Committee",8,0,0,0,8
1960603,1528392,2025-03-26,House,"HOUSE STATE & LOCAL GOVERNMENT COMMITTEE: Rec. for pass; ref to Finance, Ways, and Means Committee",20,0,0,0,20
1960603,1534265,2025-04-02,House,"HOUSE FINANCE, WAYS, AND MEANS SUBCOMMITTEE: Rec. for pass by s/c ref. to Finance, Ways, and Means Committee",11,0,0,0,11
1960603,1539491,2025-04-08,House,"HOUSE FINANCE, WAYS, AND MEANS COMMITTEE: Rec. for pass; ref to Calendar & Rules Committee",28,0,0,0,28
1960603,1553725,2025-04-21,House,"FLOOR VOTE: CONSENT CALENDAR PASSAGE ON THIRD CONSIDERATION",86,0,1,0,87
1960609,1525890,2025-03-25,House,"HOUSE DEPARTMENTS & AGENCIES SUBCOMMITTEE: Rec for pass if am by s/c ref. to State & Local Government Committee",8,0,0,0,8
1960619,1505887,2025-03-05,House,"HOUSE CRIMINAL JUSTICE SUBCOMMITTEE: Rec for pass if am by s/c ref. to Judiciary Committee",9,0,0,0,9
1960619,1521239,2025-03-19,House,"HOUSE JUDICIARY COMMITTEE: Rec. for pass. if am., ref. to Calendar & Rules Committee",22,0,0,0,22
1960622,1527228,2025-03-25,Senate,"SENATE COMMERCE AND LABOR COMMITTEE: Recommended for passage with amendment/s, refer to Senate Calendar Committee Ayes 9, Nays 0 PNV 0",9,0,0,0,9
1960631,1522060,2025-03-19,House,"HOUSE BUSINESS AND UTILITIES SUBCOMMITTEE: Failed in s/c Business and Utilities Subcommittee of Commerce Committee",3,7,0,0,10
1960653,1504640,2025-03-04,House,"HOUSE DEPARTMENTS & AGENCIES SUBCOMMITTEE: Rec. for pass by s/c ref. to State & Local Government Committee",8,0,0,0,8
1960653,1516488,2025-03-12,House,"HOUSE STATE & LOCAL GOVERNMENT COMMITTEE: Rec. for pass. if am., ref. to Government Operations Committee",23,0,0,0,23
1960653,1518377,2025-03-17,House,"HOUSE GOVERNMENT OPERATIONS COMMITTEE: Rec. for pass; ref to Finance, Ways, and Means Committee",9,2,0,0,11
1960653,1527597,2025-03-26,House,"HOUSE FINANCE, WAYS, AND MEANS SUBCOMMITTEE: Rec for pass if am by s/c ref. to Finance, Ways, and Means Committee",11,1,0,0,12
1960653,1533222,2025-04-01,House,"HOUSE FINANCE, WAYS, AND MEANS COMMITTEE: Rec. for pass. if am., ref. to Calendar & Rules Committee",24,2,0,0,26
1960653,1543985,2025-04-10,House,"FLOOR VOTE: REGULAR CALENDAR AS AMENDED PASSAGE ON THIRD CONSIDERATION",73,21,0,0,94
1960653,1552439,2025-04-17,Senate,"FLOOR VOTE: as Amended Third Consideration",24,6,2,0,32
1960653,1553291,2025-04-21,House,"FLOOR VOTE: MESSAGE CALENDAR CONCUR IN SENATE AMENDMENT # 3",60,31,2,0,93
1960657,1513817,2025-03-11,House,"HOUSE EDUCATION ADMINISTRATION SUBCOMMITTEE: Rec for pass if am by s/c ref. to Education Committee",6,0,0,0,6
1960657,1519918,2025-03-18,House,"HOUSE EDUCATION COMMITTEE: Rec. for pass. if am., ref. to Calendar & Rules Committee",18,0,0,0,18
1960681,1494999,2025-02-19,House,"HOUSE AGRICULTURE AND NATURAL RESOURCES SUBCOMMITTEE: Rec. for pass by s/c ref. to Agriculture & Natural Resources Committee",9,0,0,0,9
1960681,1498661,2025-02-25,House,"HOUSE AGRICULTURE & NATURAL RESOURCES COMMITTEE: Rec. for pass; ref to Calendar & Rules Committee",16,0,0,0,16
1960681,1503550,2025-03-03,House,"FLOOR VOTE: REGULAR CALENDAR MOTION TO ADOPT",89,0,0,0,89
1960685,1521553,2025-03-19,House,"HOUSE PUBLIC SERVICE SUBCOMMITTEE: Failed in s/c Public Service Subcommittee of State & Local Government Committee",1,4,1,0,6
1960691,1521900,2025-03-19,House,"HOUSE CITIES & COUNTIES SUBCOMMITTEE: Rec for pass if am by s/c ref. to State & Local Government Committee",4,1,1,0,6
1960700,1498744,2025-02-25,House,"HOUSE TRANSPORTATION SUBCOMMITTEE: Rec. for pass by s/c ref. to Transportation Committee",9,0,0,0,9
1960700,1504726,2025-03-04,House,"HOUSE TRANSPORTATION COMMITTEE: Rec. for pass; ref to Finance, Ways, and Means Committee",21,0,0,0,21
1960700,1551770,2025-04-17,House,"HOUSE FINANCE, WAYS, AND MEANS SUBCOMMITTEE: Rec. for pass by s/c ref. to Finance, Ways, and Means Committee",11,0,0,0,11
1960700,1553252,2025-04-17,House,"HOUSE FINANCE, WAYS, AND MEANS COMMITTEE: Rec. for pass; ref to Calendar & Rules Committee",27,0,0,0,27
1960711,1520788,2025-03-19,House,"HOUSE HIGHER EDUCATION SUBCOMMITTEE: Rec. for pass by s/c ref. to Education Committee",4,0,0,0,4
1960711,1526532,2025-03-25,House,"HOUSE EDUCATION COMMITTEE: Rec. for pass; ref to Finance, Ways, and Means Committee",17,0,0,0,17
1960739,1504920,2025-03-04,House,"HOUSE TENNCARE SUBCOMMITTEE: Rec. for pass by s/c ref. to Insurance Committee",6,0,0,0,6
1960739,1516623,2025-03-12,House,"HOUSE INSURANCE COMMITTEE: Rec. for pass; ref to Calendar & Rules Committee",15,0,0,0,15
1960739,1525265,2025-03-24,House,"FLOOR VOTE: CONSENT CALENDAR PASSAGE ON THIRD CONSIDERATION",96,0,0,0,96
1960745,1527106,2025-03-25,House,"HOUSE CHILDREN AND FAMILY AFFAIRS SUBCOMMITTEE: Rec for pass if am by s/c ref. to Judiciary Committee",6,0,0,0,6
1960745,1539427,2025-04-08,House,"HOUSE JUDICIARY COMMITTEE: Rec. for pass. if am., ref. to Calendar & Rules Committee",19,0,0,0,19
1960748,1494650,2025-02-18,House,"HOUSE EDUCATION ADMINISTRATION SUBCOMMITTEE: Rec. for pass by s/c ref. to Education Committee",6,0,0,0,6
1960748,1519818,2025-03-18,House,"HOUSE EDUCATION COMMITTEE: Rec. for pass; ref to Calendar & Rules Committee",18,0,0,0,18
1960748,1547691,2025-04-14,House,"FLOOR VOTE: CONSENT CALENDAR PASSAGE ON THIRD CONSIDERATION",94,0,1,0,95
1960755,1485881,2025-02-10,House,"FLOOR VOTE: CONSENT CALENDAR PASSAGE ON THIRD CONSIDERATION",88,0,0,0,88
1960755,1490290,2025-02-13,Senate,"FLOOR VOTE: Motion to Adopt",31,0,0,0,31
1960778,1528222,2025-03-26,House,"HOUSE AGRICULTURE AND NATURAL RESOURCES SUBCOMMITTEE: Rec for pass if am by s/c ref. to Agriculture & Natural Resources Committee",7,1,0,0,8
1960778,1532094,2025-04-01,House,"HOUSE AGRICULTURE & NATURAL RESOURCES COMMITTEE: Rec. for pass. if am., ref. to Government Operations Committee",13,3,0,0,16
1960778,1538520,2025-04-07,House,"HOUSE GOVERNMENT OPERATIONS COMMITTEE: Rec. for pass; ref to Finance, Ways, and Means Committee",9,3,3,0,15
1960778,1547215,2025-04-14,House,"HOUSE FINANCE, WAYS, AND MEANS SUBCOMMITTEE: Rec. for pass by s/c ref. to Finance, Ways, and Means Committee",12,0,0,0,12
1960778,1549156,2025-04-15,House,"HOUSE FINANCE, WAYS, AND MEANS COMMITTEE: Rec. for pass; ref to Calendar & Rules Committee",23,1,0,0,24
1960782,1528476,2025-03-26,Senate,"SENATE EDUCATION COMMITTEE: Recommended for passage with amendment/s, refer to Senate Calendar Committee Ayes 7, Nays 1 PNV 1",7,1,1,0,9
1960782,1539267,2025-04-07,Senate,"FLOOR VOTE: as Amended Third Consideration",31,0,0,0,31
1960782,1548877,2025-04-15,House,"FLOOR VOTE: REGULAR CALENDAR PASSAGE ON THIRD CONSIDERATION",93,0,3,0,96
1960793,1516520,2025-03-12,House,"HOUSE CITIES & COUNTIES SUBCOMMITTEE: Rec for pass if am by s/c ref. to State & Local Government Committee",7,0,0,0,7
1960811,1528361,2025-03-26,House,"HOUSE CIVIL JUSTICE SUBCOMMITTEE: Rec for pass if am by s/c ref. to Judiciary Committee",5,1,0,0,6
1960811,1539447,2025-04-08,House,"HOUSE JUDICIARY COMMITTEE: Rec. for pass. if am., ref. to Calendar & Rules Committee",14,6,0,0,20
1960811,1547955,2025-04-14,House,"FLOOR VOTE: REGULAR CALENDAR AS AMENDED PASSAGE ON THIRD CONSIDERATION",71,21,3,0,95
1960811,1549602,2025-04-15,Senate,"FLOOR VOTE: Third Consideration",26,6,0,0,32
1960817,1498596,2025-02-25,House,"HOUSE DEPARTMENTS & AGENCIES SUBCOMMITTEE: Rec. for pass by s/c ref. to State & Local Government Committee",7,0,0,0,7
1960817,1506700,2025-03-05,House,"HOUSE STATE & LOCAL GOVERNMENT COMMITTEE: Rec. for pass; ref to Calendar & Rules Committee",21,0,0,0,21
1960817,1512234,2025-03-10,House,"FLOOR VOTE: CONSENT CALENDAR PASSAGE ON THIRD CONSIDERATION",94,0,0,0,94
1960817,1526147,2025-03-24,Senate,"FLOOR VOTE: Motion to Adopt",32,0,0,0,32
1960823,1506334,2025-03-05,House,"HOUSE CITIES & COUNTIES SUBCOMMITTEE: Rec. for pass by s/c ref. to State & Local Government Committee",7,0,0,0,7
1960823,1521845,2025-03-19,House,"HOUSE STATE & LOCAL GOVERNMENT COMMITTEE: Rec. for pass. if am., ref. to Finance, Ways, and Means Committee",22,0,0,0,22
1960823,1534213,2025-04-02,House,"HOUSE FINANCE, WAYS, AND MEANS SUBCOMMITTEE: Rec for pass if am by s/c ref. to Finance, Ways, and Means Committee",10,0,0,0,10
1960823,1540188,2025-04-08,House,"HOUSE FINANCE, WAYS, AND MEANS COMMITTEE: Rec. for pass. if am., ref. to Calendar & Rules Committee",28,0,0,0,28
1960823,1547848,2025-04-14,House,"FLOOR VOTE: REGULAR CALENDAR AS AMENDED PASSAGE ON THIRD CONSIDERATION",86,5,2,0,93
1960823,1547849,2025-04-14,House,"FLOOR VOTE: REGULAR CALENDAR MOTION TO ADOPT AMENDMENT # 3 BY LAMBERTH PASSAGE ON THIRD CONSIDERATION",92,0,0,0,92
1960823,1549519,2025-04-15,Senate,"FLOOR VOTE: Third Consideration",28,1,1,0,30
1960827,1519746,2025-03-18,House,"HOUSE CHILDREN AND FAMILY AFFAIRS SUBCOMMITTEE: Rec. for pass by s/c ref. to Judiciary Committee",6,0,0,0,6
1960827,1540148,2025-04-08,House,"HOUSE JUDICIARY COMMITTEE: Rec. for pass; ref to Calendar & Rules Committee",16,6,0,0,22
1960827,1550367,2025-04-16,House,"FLOOR VOTE: REGULAR CALENDAR MOTION TO ADOPT",72,18,1,0,91
1960832,1527530,2025-03-26,House,"HOUSE CRIMINAL JUSTICE SUBCOMMITTEE: Rec for pass if am by s/c ref. to Judiciary Committee",7,0,0,0,7
1960832,1540123,2025-04-08,House,"HOUSE JUDICIARY COMMITTEE: Rec. for pass. if am., ref. to Finance, Ways, and Means Committee",20,0,0,0,20
1960832,1551896,2025-04-17,House,"HOUSE FINANCE, WAYS, AND MEANS SUBCOMMITTEE: Rec. for pass by s/c ref. to Finance, Ways, and Means Committee",11,0,0,0,11
1960832,1553385,2025-04-17,House,"HOUSE FINANCE, WAYS, AND MEANS COMMITTEE: Rec. for pass; ref to Calendar & Rules Committee",27,0,0,0,27
1960865,1506712,2025-03-05,House,"HOUSE HEALTH SUBCOMMITTEE: Rec. for pass by s/c ref. to Health Committee",8,0,0,0,8
1960865,1514570,2025-03-11,House,"HOUSE HEALTH COMMITTEE: Rec. for pass; ref to Calendar & Rules Committee",15,1,0,0,16
1960865,1525188,2025-03-24,House,"FLOOR VOTE: CONSENT CALENDAR PASSAGE ON THIRD CONSIDERATION",96,0,0,0,96
1960869,1500137,2025-02-26,House,"HOUSE CITIES & COUNTIES SUBCOMMITTEE: Rec. for pass by s/c ref. to State & Local Government Committee",6,0,0,0,6
1960869,1534744,2025-04-02,House,"HOUSE STATE & LOCAL GOVERNMENT COMMITTEE: Rec. for pass; ref to Calendar & Rules Committee",21,0,0,0,21
1960869,1538342,2025-04-07,House,"FLOOR VOTE: CONSENT CALENDAR PASSAGE ON THIRD CONSIDERATION",96,0,0,0,96
1960874,1506639,2025-03-05,House,"INSURANCE SUBCOMMITTEE: Rec. for pass by s/c ref. to Insurance Committee",5,0,0,0,5
1960874,1516727,2025-03-12,House,"HOUSE INSURANCE COMMITTEE: Rec. for pass; ref to Calendar & Rules Committee",16,0,0,0,16
1960885,1513549,2025-03-11,House,"HOUSE DEPARTMENTS & AGENCIES SUBCOMMITTEE: Rec for pass if am by s/c ref. to State & Local Government Committee",8,0,0,0,8
1960885,1528212,2025-03-26,House,"HOUSE STATE & LOCAL GOVERNMENT COMMITTEE: Rec. for pass. if am., ref. to Calendar & Rules Committee",20,0,1,0,21
1960890,1516427,2025-03-12,House,"HOUSE BUSINESS AND UTILITIES SUBCOMMITTEE: Failed in s/c Business and Utilities Subcommittee of Commerce Committee",4,4,1,0,9
1960894,1500076,2025-02-26,House,"HOUSE CRIMINAL JUSTICE SUBCOMMITTEE: Rec for pass if am by s/c ref. to Judiciary Committee",8,0,1,0,9
1960894,1506313,2025-03-05,House,"HOUSE JUDICIARY COMMITTEE: Rec. for pass. if am., ref. to Commerce Committee",16,4,2,0,22
1960894,1515917,2025-03-12,House,"HOUSE COMMERCE COMMITTEE: Rec. for pass. if am., ref. to Government Operations Committee",18,2,2,0,22
1960894,1518358,2025-03-17,House,"HOUSE GOVERNMENT OPERATIONS COMMITTEE: Rec. for pass; ref to Finance, Ways, and Means Committee",13,1,0,0,14
1960894,1527387,2025-03-26,House,"HOUSE FINANCE, WAYS, AND MEANS SUBCOMMITTEE: Rec for pass if am by s/c ref. to Finance, Ways, and Means Committee",11,0,0,0,11
1960894,1533401,2025-04-01,House,"HOUSE FINANCE, WAYS, AND MEANS COMMITTEE: Rec. for pass. if am., ref. to Calendar & Rules Committee",27,0,0,0,27
1960894,1544416,2025-04-10,House,"FLOOR VOTE: REGULAR CALENDAR AS AMENDED PASSAGE ON THIRD CONSIDERATION",69,21,3,0,93
1960894,1544417,2025-04-10,House,"FLOOR VOTE: REGULAR CALENDAR MOTION TO ADOPT AMENDMENT # 10 BY MARSH PASSAGE ON THIRD CONSIDERATION",87,0,4,0,91
1960894,1544418,2025-04-10,House,"FLOOR VOTE: REGULAR CALENDAR MOTION TO ADOPT AMENDMENT # 11 BY COCHRAN PASSAGE ON THIRD CONSIDERATION",56,38,1,0,95
1960894,1544419,2025-04-10,House,"FLOOR VOTE: REGULAR CALENDAR MOTION TO ADOPT AMENDMENT # 12 BY WILLIAMS PASSAGE ON THIRD CONSIDERATION",89,0,3,0,92
1960894,1552466,2025-04-17,Senate,"FLOOR VOTE: Third Consideration",23,9,0,0,32
1960898,1532787,2025-04-01,House,"HOUSE CRIMINAL JUSTICE SUBCOMMITTEE: Rec. for pass by s/c ref. to Judiciary Committee",9,0,0,0,9
1960898,1543153,2025-04-09,House,"HOUSE JUDICIARY COMMITTEE: Rec. for pass; ref to Finance, Ways, and Means Committee",20,0,1,0,21
1960898,1551822,2025-04-17,House,"HOUSE FINANCE, WAYS, AND MEANS SUBCOMMITTEE: Rec. for pass by s/c ref. to Finance, Ways, and Means Committee",11,0,0,0,11
1960898,1551823,2025-04-17,House,"HOUSE FINANCE, WAYS, AND MEANS SUBCOMMITTEE: Rec. for pass by s/c ref. to Finance, Ways, and Means Committee",11,0,0,0,11
1960898,1553379,2025-04-17,House,"HOUSE FINANCE, WAYS, AND MEANS COMMITTEE: Rec. for pass; ref to Calendar & Rules Committee",27,0,0,0,27
1960918,1527687,2025-03-26,House,"HOUSE K-12 SUBCOMMITTEE: Rec. for pass by s/c ref. to Education Committee",6,0,0,0,6
1960918,1534739,2025-04-02,House,"HOUSE EDUCATION COMMITTEE: Rec. for pass; ref to Finance, Ways, and Means Committee",19,0,0,0,19
1960918,1547061,2025-04-14,House,"HOUSE FINANCE, WAYS, AND MEANS SUBCOMMITTEE: Rec. for pass by s/c ref. to Finance, Ways, and Means Committee",10,2,0,0,12
1960918,1548998,2025-04-15,House,"HOUSE FINANCE, WAYS, AND MEANS COMMITTEE: Rec. for pass; ref to Calendar & Rules Committee",23,2,1,0,26
1960918,1550275,2025-04-16,House,"FLOOR VOTE: REGULAR CALENDAR PASSAGE ON THIRD CONSIDERATION",73,21,0,0,94
1960918,1553024,2025-04-21,Senate,"FLOOR VOTE: Motion to Adopt",33,0,0,0,33
1960924,1506345,2025-03-05,House,"HOUSE CITIES & COUNTIES SUBCOMMITTEE: Rec. for pass by s/c ref. to State & Local Government Committee",5,2,0,0,7
1960924,1521877,2025-03-19,House,"HOUSE STATE & LOCAL GOVERNMENT COMMITTEE: Rec. for pass; ref to Finance, Ways, and Means Committee",16,4,0,0,20
1960924,1551763,2025-04-17,House,"HOUSE FINANCE, WAYS, AND MEANS SUBCOMMITTEE: Rec. for pass by s/c ref. to Finance, Ways, and Means Committee",11,0,0,0,11
1960924,1553279,2025-04-17,House,"HOUSE FINANCE, WAYS, AND MEANS COMMITTEE: Rec. for pass; ref to Calendar & Rules Committee",27,0,0,0,27
1960924,1553280,2025-04-17,House,"HOUSE FINANCE, WAYS, AND MEANS COMMITTEE: Rec. for pass; ref to Calendar & Rules Committee",25,2,1,0,28
1960947,1528478,2025-03-26,Senate,"SENATE EDUCATION COMMITTEE: Recommended for passage, refer to Senate Calendar Committee",9,0,0,0,9
1960947,1531903,2025-03-31,Senate,"FLOOR VOTE: Motion to Adopt",30,0,0,0,30
1960955,1504375,2025-03-04,House,"HOUSE TRANSPORTATION SUBCOMMITTEE: Rec for pass if am by s/c ref. to Transportation Committee",9,0,0,0,9
1960955,1514106,2025-03-11,House,"HOUSE TRANSPORTATION COMMITTEE: Rec. for pass. if am., ref. to Calendar & Rules Committee",18,0,0,0,18
1960959,1504677,2025-03-04,House,"HOUSE EDUCATION ADMINISTRATION SUBCOMMITTEE: Rec. for pass by s/c ref. to Education Committee",6,0,0,0,6
1960959,1519963,2025-03-18,House,"HOUSE EDUCATION COMMITTEE: Rec. for pass. if am., ref. to Finance, Ways, and Means Committee",15,0,0,0,15
1960959,1534171,2025-04-02,House,"HOUSE FINANCE, WAYS, AND MEANS SUBCOMMITTEE: Rec. for pass by s/c ref. to Finance, Ways, and Means Committee",11,0,0,0,11
1960959,1540224,2025-04-08,House,"HOUSE FINANCE, WAYS, AND MEANS COMMITTEE: Rec. for pass; ref to Calendar & Rules Committee",28,0,0,0,28
1960966,1527610,2025-03-26,House,"HOUSE HIGHER EDUCATION SUBCOMMITTEE: Rec for pass if am by s/c ref. to Education Committee",5,0,0,0,5
1960966,1534836,2025-04-02,House,"HOUSE EDUCATION COMMITTEE: Rec. for pass. if am., ref. to Finance, Ways, and Means Committee",18,0,0,0,18
1960966,1542048,2025-04-09,House,"HOUSE FINANCE, WAYS, AND MEANS SUBCOMMITTEE: Rec for pass if am by s/c ref. to Finance, Ways, and Means Committee",11,0,0,0,11
1960966,1553405,2025-04-17,House,"HOUSE FINANCE, WAYS, AND MEANS COMMITTEE: Rec. for pass. if am., ref. to Calendar & Rules Committee",24,0,0,0,24
1963438,1487342,2025-02-12,House,"FLOOR VOTE: CONSENT CALENDAR PASSAGE ON THIRD CONSIDERATION",90,0,1,0,91
1963518,1488044,2025-02-12,House,"FLOOR VOTE: CONSENT CALENDAR PASSAGE ON THIRD CONSIDERATION",90,0,1,0,91
1963559,1507232,2025-03-05,Senate,"SENATE EDUCATION COMMITTEE: Recommended for adoption by Senate Education Committee, refer Senate Calendar Committee",9,0,0,0,9
1963559,1517219,2025-03-13,Senate,"FLOOR VOTE: Motion to Adopt",32,0,0,0,32
1963568,1507236,2025-03-05,Senate,"SENATE EDUCATION COMMITTEE: Recommended for adoption by Senate Education Committee, refer Senate Calendar Committee",9,0,0,0,9
1963568,1517136,2025-03-13,Senate,"FLOOR VOTE: Motion to Adopt",32,0,0,0,32
1963578,1499573,2025-02-25,Senate,"SENATE COMMERCE AND LABOR COMMITTEE: Recommended for adoption by Senate Commerce and Labor Committee, refer Senate Calendar Committee",7,0,0,0,7
1963578,1515104,2025-03-03,Senate,"FLOOR VOTE: Motion to Adopt",32,0,0,0,32
1963590,1541660,2025-04-09,Senate,"FLOOR VOTE: Motion to Adopt",30,0,0,0,30
1963600,1497928,2025-02-24,House,"FLOOR VOTE: CONSENT CALENDAR PASSAGE ON THIRD CONSIDERATION",92,0,2,0,94
1963614,1507390,2025-03-05,Senate,"SENATE EDUCATION COMMITTEE: Recommended for adoption by Senate Education Committee, refer Senate Calendar Committee",9,0,0,0,9
1963614,1517440,2025-03-13,Senate,"FLOOR VOTE: Motion to Adopt",32,0,0,0,32
1963625,1516946,2025-03-12,Senate,"SENATE EDUCATION COMMITTEE: Recommended for adoption by Senate Education Committee, refer Senate Calendar Committee",9,0,0,0,9
1963625,1519596,2025-03-17,Senate,"FLOOR VOTE: Motion to Adopt",32,0,0,0,32
1963638,1501311,2025-02-26,Senate,"SENATE EDUCATION COMMITTEE: Recommended for adoption by Senate Education Committee, refer Senate Calendar Committee",9,0,0,0,9
1963638,1515486,2025-03-06,Senate,"FLOOR VOTE: Motion to Adopt",32,0,0,0,32
1963651,1507505,2025-03-05,Senate,"SENATE EDUCATION COMMITTEE: Recommended for adoption by Senate Education Committee, refer Senate Calendar Committee",8,0,0,0,8
1963651,1517303,2025-03-13,Senate,"FLOOR VOTE: Motion to Adopt",32,0,0,0,32
1963664,1514017,2025-03-11,House,"HOUSE EDUCATION COMMITTEE: Rec. for pass; ref to Calendar & Rules Committee",17,0,0,0,17
1963664,1518927,2025-03-17,House,"FLOOR VOTE: CONSENT CALENDAR PASSAGE ON THIRD CONSIDERATION",92,0,1,0,93
1963677,1506677,2025-03-05,Senate,"SENATE ENERGY, AGRICULTURE AND NATURAL RESOURCES COMMITTEE: Recommended for adoption by Senate Energy, Ag., and Nat. Resources Committee, refer Senate Calendar Committee",9,0,0,0,9
1963677,1514593,2025-03-10,Senate,"FLOOR VOTE: Motion to Adopt",30,0,0,0,30
1963690,1500805,2025-02-26,Senate,"SENATE ENERGY, AGRICULTURE AND NATURAL RESOURCES COMMITTEE: Recommended for adoption by Senate Energy, Ag., and Nat. Resources Committee, refer Senate Calendar Committee",9,0,0,0,9
1963690,1513788,2025-03-03,Senate,"FLOOR VOTE: Motion to Adopt",32,0,0,0,32
1963703,1507332,2025-03-05,Senate,"SENATE EDUCATION COMMITTEE: Recommended for adoption by Senate Education Committee, refer Senate Calendar Committee",9,0,0,0,9
1963703,1517466,2025-03-13,Senate,"FLOOR VOTE: Motion to Adopt",32,0,0,0,32
1963717,1501116,2025-02-26,Senate,"SENATE EDUCATION COMMITTEE: Recommended for adoption by Senate Education Committee, refer Senate Calendar Committee",9,0,0,0,9
1963717,1515430,2025-03-06,Senate,"FLOOR VOTE: Motion to Adopt",32,0,0,0,32
1963727,1501236,2025-02-26,Senate,"SENATE EDUCATION COMMITTEE: Recommended for adoption by Senate Education Committee, refer Senate Calendar Committee",9,0,0,0,9
1963727,1507940,2025-03-06,House,"FLOOR VOTE: REGULAR CALENDAR MOTION TO CONCUR",79,9,0,0,88
1963727,1514739,2025-03-06,Senate,"FLOOR VOTE: Motion to Adopt",32,0,0,0,32
1963747,1507269,2025-03-05,Senate,"SENATE EDUCATION COMMITTEE: Recommended for adoption by Senate Education Committee, refer Senate Calendar Committee",8,0,0,0,8
1963747,1517135,2025-03-13,Senate,"FLOOR VOTE: Motion to Adopt",32,0,0,0,32
1963757,1516937,2025-03-12,Senate,"SENATE EDUCATION COMMITTEE: Recommended for adoption by Senate Education Committee, refer Senate Calendar Committee",9,0,0,0,9
1963757,1520001,2025-03-17,Senate,"FLOOR VOTE: Motion to Adopt",32,0,0,0,32
1963768,1516934,2025-03-12,Senate,"SENATE EDUCATION COMMITTEE: Recommended for adoption by Senate Education Committee, refer Senate Calendar Committee",9,0,0,0,9
1963768,1519689,2025-03-17,Senate,"FLOOR VOTE: Motion to Adopt",32,0,0,0,32
1963783,1507346,2025-03-05,Senate,"SENATE EDUCATION COMMITTEE: Recommended for adoption by Senate Education Committee, refer Senate Calendar Committee",8,0,0,0,8
1963783,1517290,2025-03-13,Senate,"FLOOR VOTE: Motion to Adopt",32,0,0,0,32
1963795,1516930,2025-03-12,Senate,"SENATE EDUCATION COMMITTEE: Recommended for adoption by Senate Education Committee, refer Senate Calendar Committee",9,0,0,0,9
1963795,1519978,2025-03-17,Senate,"FLOOR VOTE: Motion to Adopt",32,0,0,0,32
1963806,1501328,2025-02-26,Senate,"SENATE EDUCATION COMMITTEE: Recommended for adoption by Senate Education Committee, refer Senate Calendar Committee",9,0,0,0,9
1963806,1507693,2025-03-06,House,"FLOOR VOTE: REGULAR CALENDAR MOTION TO CONCUR",76,12,0,0,88
1963806,1514715,2025-03-06,Senate,"FLOOR VOTE: Motion to Adopt",32,0,0,0,32
1963819,1500659,2025-02-26,Senate,"SENATE ENERGY, AGRICULTURE AND NATURAL RESOURCES COMMITTEE: Recommended for adoption by Senate Energy, Ag., and Nat. Resources Committee, refer Senate Calendar Committee",9,0,0,0,9
1963819,1514419,2025-03-03,Senate,"FLOOR VOTE: Motion to Adopt",32,0,0,0,32
1963834,1506594,2025-03-05,Senate,"SENATE ENERGY, AGRICULTURE AND NATURAL RESOURCES COMMITTEE: Recommended for adoption by Senate Energy, Ag., and Nat. Resources Committee, refer Senate Calendar Committee",9,0,0,0,9
1963834,1514930,2025-03-10,Senate,"FLOOR VOTE: Motion to Adopt",30,0,0,0,30
1963844,1505344,2025-03-04,Senate,"SENATE STATE & LOCAL GOVERNMENT COMMITTEE: Recommended for adoption by Senate State and Local Government Committee, refer Senate Calendar Committee",9,0,0,0,9
1963844,1515470,2025-03-10,Senate,"FLOOR VOTE: Motion to Adopt",30,0,0,0,30
1963859,1507291,2025-03-05,Senate,"SENATE EDUCATION COMMITTEE: Recommended for adoption by Senate Education Committee, refer Senate Calendar Committee",7,0,0,0,7
1963859,1517185,2025-03-13,Senate,"FLOOR VOTE: Motion to Adopt",32,0,0,0,32
1963871,1506680,2025-03-05,Senate,"SENATE ENERGY, AGRICULTURE AND NATURAL RESOURCES COMMITTEE: Recommended for adoption by Senate Energy, Ag., and Nat. Resources Committee, refer Senate Calendar Committee",9,0,0,0,9
1963871,1515224,2025-03-10,Senate,"FLOOR VOTE: Motion to Adopt",30,0,0,0,30
1963886,1500614,2025-02-26,Senate,"SENATE ENERGY, AGRICULTURE AND NATURAL RESOURCES COMMITTEE: Recommended for adoption by Senate Energy, Ag., and Nat. Resources Committee, refer Senate Calendar Committee",9,0,0,0,9
1963886,1513328,2025-03-03,Senate,"FLOOR VOTE: Motion to Adopt",32,0,0,0,32
1963897,1522816,2025-03-19,Senate,"SENATE EDUCATION COMMITTEE: Recommended for adoption by Senate Education Committee, refer Senate Calendar Committee",7,0,0,0,7
1963897,1526152,2025-03-24,Senate,"FLOOR VOTE: Motion to Adopt",32,0,0,0,32
1963906,1516950,2025-03-12,Senate,"SENATE EDUCATION COMMITTEE: Recommended for adoption by Senate Education Committee, refer Senate Calendar Committee",9,0,0,0,9
1963906,1519611,2025-03-17,Senate,"FLOOR VOTE: Motion to Adopt",32,0,0,0,32
1963926,1499097,2025-02-25,House,"HOUSE EDUCATION COMMITTEE: Rec. for pass; ref to Calendar & Rules Committee",15,1,0,0,16
1963926,1507265,2025-03-06,House,"FLOOR VOTE: REGULAR CALENDAR MOTION TO ADOPT",76,12,0,0,88
1963936,1516869,2025-03-12,Senate,"SENATE EDUCATION COMMITTEE: Recommended for adoption by Senate Education Committee, refer Senate Calendar Committee",9,0,0,0,9
1963936,1519438,2025-03-17,Senate,"FLOOR VOTE: Motion to Adopt",32,0,0,0,32
1963950,1504979,2025-03-04,Senate,"SENATE STATE & LOCAL GOVERNMENT COMMITTEE: Recommended for adoption by Senate State and Local Government Committee, refer Senate Calendar Committee",9,0,0,0,9
1963950,1514830,2025-03-10,Senate,"FLOOR VOTE: Motion to Adopt",30,0,0,0,30
1963961,1507059,2025-03-05,Senate,"SENATE EDUCATION COMMITTEE: Recommended for adoption by Senate Education Committee, refer Senate Calendar Committee",9,0,0,0,9
1963961,1517050,2025-03-13,Senate,"FLOOR VOTE: Motion to Adopt",32,0,0,0,32
1963975,1497709,2025-02-24,House,"HOUSE PRIVATE ACTS COMMITTEE: Rec. for pass; ref to State & Local Government Committee",10,0,0,0,10
1963975,1516324,2025-03-12,House,"HOUSE STATE & LOCAL GOVERNMENT COMMITTEE: Rec. for pass. if am., ref. to Calendar & Rules Committee",23,0,0,0,23
1963975,1530940,2025-03-31,House,"FLOOR VOTE: REGULAR CALENDAR AS AMENDED PASSAGE ON THIRD CONSIDERATION",94,0,0,0,94
1963975,1542232,2025-04-09,Senate,"FLOOR VOTE: Motion to Adopt",30,0,0,0,30
1963987,1505504,2025-03-04,Senate,"SENATE STATE & LOCAL GOVERNMENT COMMITTEE: Recommended for adoption by Senate State and Local Government Committee, refer Senate Calendar Committee",9,0,0,0,9
1963987,1513571,2025-03-10,Senate,"FLOOR VOTE: Motion to Adopt",30,0,0,0,30
1964001,1507419,2025-03-05,Senate,"SENATE EDUCATION COMMITTEE: Recommended for adoption by Senate Education Committee, refer Senate Calendar Committee",9,0,0,0,9
1964001,1517032,2025-03-13,Senate,"FLOOR VOTE: Motion to Adopt",32,0,0,0,32
1964013,1500325,2025-02-26,Senate,"SENATE ENERGY, AGRICULTURE AND NATURAL RESOURCES COMMITTEE: Recommended for adoption by Senate Energy, Ag., and Nat. Resources Committee, refer Senate Calendar Committee",9,0,0,0,9
1964013,1515465,2025-03-03,Senate,"FLOOR VOTE: Motion to Adopt",32,0,0,0,32
1964026,1507410,2025-03-05,Senate,"SENATE EDUCATION COMMITTEE: Recommended for adoption by Senate Education Committee, refer Senate Calendar Committee",8,0,0,0,8
1964026,1517053,2025-03-13,Senate,"FLOOR VOTE: Motion to Adopt",32,0,0,0,32
1964038,1516932,2025-03-12,Senate,"SENATE EDUCATION COMMITTEE: Recommended for adoption by Senate Education Committee, refer Senate Calendar Committee",9,0,0,0,9
1964038,1519381,2025-03-17,Senate,"FLOOR VOTE: Motion to Adopt",32,0,0,0,32
1964050,1516929,2025-03-12,Senate,"SENATE EDUCATION COMMITTEE: Recommended for adoption by Senate Education Committee, refer Senate Calendar Committee",9,0,0,0,9
1964050,1519649,2025-03-17,Senate,"FLOOR VOTE: Motion to Adopt",32,0,0,0,32
1964062,1501289,2025-02-26,Senate,"SENATE EDUCATION COMMITTEE: Recommended for adoption by Senate Education Committee, refer Senate Calendar Committee",8,0,1,0,9
1964062,1515451,2025-03-06,Senate,"FLOOR VOTE: Motion to Adopt",28,0,2,0,30
1964075,1522797,2025-03-19,Senate,"SENATE EDUCATION COMMITTEE: Recommended for adoption by Senate Education Committee, refer Senate Calendar Committee",8,0,0,0,8
1964075,1526378,2025-03-24,Senate,"FLOOR VOTE: Motion to Adopt",32,0,0,0,32
1964086,1505255,2025-03-04,Senate,"SENATE STATE & LOCAL GOVERNMENT COMMITTEE: Recommended for adoption by Senate State and Local Government Committee, refer Senate Calendar Committee",9,0,0,0,9
1964086,1514144,2025-03-10,Senate,"FLOOR VOTE: Motion to Adopt",30,0,0,0,30
1964122,1498030,2025-02-24,House,"FLOOR VOTE: CONSENT CALENDAR PASSAGE ON THIRD CONSIDERATION",92,0,2,0,94
1964134,1506773,2025-03-05,House,"HOUSE STATE & LOCAL GOVERNMENT COMMITTEE: Rec. for pass; ref to Calendar & Rules Committee",20,0,0,0,20
1964134,1509696,2025-03-10,House,"FLOOR VOTE: CONSENT CALENDAR PASSAGE ON THIRD CONSIDERATION",94,0,0,0,94
1964148,1514102,2025-03-11,House,"HOUSE EDUCATION COMMITTEE: Rec. for pass; ref to Calendar & Rules Committee",17,0,0,0,17
1964148,1518853,2025-03-17,House,"FLOOR VOTE: CONSENT CALENDAR PASSAGE ON THIRD CONSIDERATION",92,0,1,0,93
1964160,1499350,2025-02-25,House,"HOUSE AGRICULTURE & NATURAL RESOURCES COMMITTEE: Rec. for pass; ref to Calendar & Rules Committee",16,0,0,0,16
1964160,1503986,2025-03-03,House,"FLOOR VOTE: CONSENT CALENDAR PASSAGE ON THIRD CONSIDERATION",89,0,0,0,89
1964173,1498279,2025-02-24,House,"FLOOR VOTE: CONSENT CALENDAR PASSAGE ON THIRD CONSIDERATION",92,0,2,0,94
1964187,1499064,2025-02-25,House,"HOUSE EDUCATION COMMITTEE: Rec. for pass; ref to Calendar & Rules Committee",16,0,0,0,16
1964187,1503977,2025-03-03,House,"FLOOR VOTE: CONSENT CALENDAR PASSAGE ON THIRD CONSIDERATION",89,0,0,0,89
1964199,1498323,2025-02-24,House,"FLOOR VOTE: CONSENT CALENDAR PASSAGE ON THIRD CONSIDERATION",92,0,2,0,94
1964212,1497812,2025-02-24,House,"FLOOR VOTE: CONSENT CALENDAR PASSAGE ON THIRD CONSIDERATION",92,0,2,0,94
1964230,1497814,2025-02-24,House,"FLOOR VOTE: CONSENT CALENDAR PASSAGE ON THIRD CONSIDERATION",92,0,2,0,94
1964241,1498008,2025-02-24,House,"FLOOR VOTE: CONSENT CALENDAR PASSAGE ON THIRD CONSIDERATION",92,0,2,0,94
1964253,1506303,2025-03-05,House,"HOUSE STATE & LOCAL GOVERNMENT COMMITTEE: Rec. for pass; ref to Calendar & Rules Committee",20,0,0,0,20
1964253,1509214,2025-03-10,House,"FLOOR VOTE: CONSENT CALENDAR PASSAGE ON THIRD CONSIDERATION",94,0,0,0,94
1964268,1497819,2025-02-24,House,"FLOOR VOTE: CONSENT CALENDAR PASSAGE ON THIRD CONSIDERATION",92,0,2,0,94
1964279,1497704,2025-02-24,House,"FLOOR VOTE: CONSENT CALENDAR PASSAGE ON THIRD CONSIDERATION",92,0,2,0,94
1964294,1498233,2025-02-24,House,"FLOOR VOTE: CONSENT CALENDAR PASSAGE ON THIRD CONSIDERATION",92,0,2,0,94
1964308,1497945,2025-02-24,House,"FLOOR VOTE: CONSENT CALENDAR PASSAGE ON THIRD CONSIDERATION",92,0,2,0,94
1964319,1498004,2025-02-24,House,"FLOOR VOTE: CONSENT CALENDAR PASSAGE ON THIRD CONSIDERATION",92,0,2,0,94
1964332,1497830,2025-02-24,House,"FLOOR VOTE: CONSENT CALENDAR PASSAGE ON THIRD CONSIDERATION",92,0,2,0,94
1964349,1506722,2025-03-05,House,"HOUSE STATE & LOCAL GOVERNMENT COMMITTEE: Rec. for pass; ref to Calendar & Rules Committee",21,0,0,0,21
1964349,1511897,2025-03-10,House,"FLOOR VOTE: CONSENT CALENDAR PASSAGE ON THIRD CONSIDERATION",94,0,0,0,94
1964360,1497821,2025-02-24,House,"FLOOR VOTE: CONSENT CALENDAR PASSAGE ON THIRD CONSIDERATION",92,0,2,0,94
1964372,1498405,2025-02-24,House,"FLOOR VOTE: CONSENT CALENDAR PASSAGE ON THIRD CONSIDERATION",92,0,2,0,94
1964390,1499285,2025-02-25,House,"HOUSE EDUCATION COMMITTEE: Rec. for pass; ref to Calendar & Rules Committee",16,0,0,0,16
1964390,1504006,2025-03-03,House,"FLOOR VOTE: CONSENT CALENDAR PASSAGE ON THIRD CONSIDERATION",89,0,0,0,89
1964400,1520369,2025-03-18,House,"HOUSE EDUCATION COMMITTEE: Rec. for pass; ref to Calendar & Rules Committee",17,0,0,0,17
1964400,1550880,2025-04-16,House,"FLOOR VOTE: CONSENT CALENDAR PASSAGE ON THIRD CONSIDERATION",96,0,0,0,96
1964413,1543149,2025-04-09,House,"HOUSE STATE & LOCAL GOVERNMENT COMMITTEE: Rec. for pass; ref to Calendar & Rules Committee",20,0,0,0,20
1964413,1550849,2025-04-16,House,"FLOOR VOTE: CONSENT CALENDAR PASSAGE ON THIRD CONSIDERATION",96,0,0,0,96
1964428,1532932,2025-04-01,House,"HOUSE EDUCATION COMMITTEE: Rec. for pass; ref to Calendar & Rules Committee",19,0,0,0,19
1964428,1550547,2025-04-16,House,"FLOOR VOTE: CONSENT CALENDAR PASSAGE ON THIRD CONSIDERATION",96,0,0,0,96
1964439,1506814,2025-03-05,House,"HOUSE STATE & LOCAL GOVERNMENT COMMITTEE: Rec. for pass; ref to Calendar & Rules Committee",21,0,0,0,21
1964439,1509691,2025-03-10,House,"FLOOR VOTE: CONSENT CALENDAR PASSAGE ON THIRD CONSIDERATION",94,0,0,0,94
1964451,1499048,2025-02-25,House,"HOUSE AGRICULTURE & NATURAL RESOURCES COMMITTEE: Rec. for pass; ref to Calendar & Rules Committee",15,0,0,0,15
1964451,1504049,2025-03-03,House,"FLOOR VOTE: CONSENT CALENDAR PASSAGE ON THIRD CONSIDERATION",89,0,0,0,89
1964461,1497831,2025-02-24,House,"FLOOR VOTE: CONSENT CALENDAR PASSAGE ON THIRD CONSIDERATION",92,0,2,0,94
1964778,1489189,2025-02-13,House,"FLOOR VOTE: CONSENT CALENDAR PASSAGE ON THIRD CONSIDERATION",91,0,0,0,91
1964778,1497964,2025-02-24,Senate,"FLOOR VOTE: Motion to Adopt",33,0,0,0,33
1964808,1498154,2025-02-24,House,"FLOOR VOTE: CONSENT CALENDAR PASSAGE ON THIRD CONSIDERATION",92,0,2,0,94
1964841,1488682,2025-02-13,House,"FLOOR VOTE: CONSENT CALENDAR PASSAGE ON THIRD CONSIDERATION",91,0,0,0,91
1964841,1497969,2025-02-24,Senate,"FLOOR VOTE: Motion to Adopt",33,0,0,0,33
1964874,1489217,2025-02-13,House,"FLOOR VOTE: CONSENT CALENDAR PASSAGE ON THIRD CONSIDERATION",91,0,0,0,91
1964874,1498133,2025-02-24,Senate,"FLOOR VOTE: Motion to Adopt",33,0,0,0,33
1964905,1489134,2025-02-13,House,"FLOOR VOTE: CONSENT CALENDAR PASSAGE ON THIRD CONSIDERATION",91,0,0,0,91
1964905,1497976,2025-02-24,Senate,"FLOOR VOTE: Motion to Adopt",33,0,0,0,33
1964940,1488665,2025-02-13,House,"FLOOR VOTE: CONSENT CALENDAR PASSAGE ON THIRD CONSIDERATION",91,0,0,0,91
1964940,1498287,2025-02-24,Senate,"FLOOR VOTE: Motion to Adopt",33,0,0,0,33
1964972,1488935,2025-02-13,House,"FLOOR VOTE: CONSENT CALENDAR PASSAGE ON THIRD CONSIDERATION",91,0,0,0,91
1964972,1497779,2025-02-24,Senate,"FLOOR VOTE: Motion to Adopt",33,0,0,0,33
1965005,1497507,2025-02-24,House,"FLOOR VOTE: CONSENT CALENDAR PASSAGE ON THIRD CONSIDERATION",92,0,2,0,94
1965292,1488846,2025-02-13,House,"FLOOR VOTE: CONSENT CALENDAR PASSAGE ON THIRD CONSIDERATION",91,0,0,0,91
1965292,1497923,2025-02-24,Senate,"FLOOR VOTE: Motion to Adopt",33,0,0,0,33
1965421,1488813,2025-02-13,House,"FLOOR VOTE: CONSENT CALENDAR PASSAGE ON THIRD CONSIDERATION",91,0,0,0,91
1965421,1498000,2025-02-24,Senate,"FLOOR VOTE: Motion to Adopt",33,0,0,0,33
1965529,1488996,2025-02-13,House,"FLOOR VOTE: CONSENT CALENDAR PASSAGE ON THIRD CONSIDERATION",91,0,0,0,91
1965529,1498156,2025-02-24,Senate,"FLOOR VOTE: Motion to Adopt",33,0,0,0,33
1965639,1489014,2025-02-13,House,"FLOOR VOTE: CONSENT CALENDAR PASSAGE ON THIRD CONSIDERATION",91,0,0,0,91
1965639,1498306,2025-02-24,Senate,"FLOOR VOTE: Motion to Adopt",33,0,0,0,33
1965958,1489250,2025-02-13,House,"FLOOR VOTE: CONSENT CALENDAR PASSAGE ON THIRD CONSIDERATION",91,0,0,0,91
1965958,1498469,2025-02-24,Senate,"FLOOR VOTE: Motion to Adopt",33,0,0,0,33
1966095,1497775,2025-02-24,Senate,"FLOOR VOTE: Motion to Adopt",33,0,0,0,33
1966095,1504077,2025-03-03,House,"FLOOR VOTE: CONSENT CALENDAR PASSAGE ON THIRD CONSIDERATION",89,0,0,0,89
1966520,1489204,2025-02-13,House,"FLOOR VOTE: CONSENT CALENDAR PASSAGE ON THIRD CONSIDERATION",91,0,0,0,91
1966520,1498480,2025-02-24,Senate,"FLOOR VOTE: Motion to Adopt",33,0,0,0,33
1966975,1488616,2025-02-13,House,"FLOOR VOTE: CONSENT CALENDAR PASSAGE ON THIRD CONSIDERATION",91,0,0,0,91
1966975,1498420,2025-02-24,Senate,"FLOOR VOTE: Motion to Adopt",33,0,0,0,33
1967072,1488622,2025-02-13,House,"FLOOR VOTE: CONSENT CALENDAR PASSAGE ON THIRD CONSIDERATION",91,0,0,0,91
1967072,1498442,2025-02-24,Senate,"FLOOR VOTE: Motion to Adopt",33,0,0,0,33
1967167,1489252,2025-02-13,House,"FLOOR VOTE: CONSENT CALENDAR PASSAGE ON THIRD CONSIDERATION",91,0,0,0,91
1967167,1498366,2025-02-24,Senate,"FLOOR VOTE: Motion to Adopt",33,0,0,0,33
1967268,1498477,2025-02-24,Senate,"FLOOR VOTE: Motion to Adopt",33,0,0,0,33
1967268,1503963,2025-03-03,House,"FLOOR VOTE: CONSENT CALENDAR PASSAGE ON THIRD CONSIDERATION",89,0,0,0,89
1967369,1489256,2025-02-13,House,"FLOOR VOTE: CONSENT CALENDAR PASSAGE ON THIRD CONSIDERATION",91,0,0,0,91
1967467,1548191,2025-04-14,Senate,"FLOOR VOTE: Motion to Adopt",32,0,0,0,32
1967622,1489214,2025-02-13,House,"FLOOR VOTE: CONSENT CALENDAR PASSAGE ON THIRD CONSIDERATION",91,0,0,0,91
1967622,1498010,2025-02-24,Senate,"FLOOR VOTE: Motion to Adopt",33,0,0,0,33
1967677,1489210,2025-02-13,House,"FLOOR VOTE: CONSENT CALENDAR PASSAGE ON THIRD CONSIDERATION",91,0,0,0,91
1967677,1498413,2025-02-24,Senate,"FLOOR VOTE: Motion to Adopt",33,0,0,0,33
1967736,1488900,2025-02-13,House,"FLOOR VOTE: CONSENT CALENDAR PASSAGE ON THIRD CONSIDERATION",91,0,0,0,91
1967736,1497865,2025-02-24,Senate,"FLOOR VOTE: Motion to Adopt",33,0,0,0,33
1967790,1488882,2025-02-13,House,"FLOOR VOTE: CONSENT CALENDAR PASSAGE ON THIRD CONSIDERATION",91,0,0,0,91
1967790,1497800,2025-02-24,Senate,"FLOOR VOTE: Motion to Adopt",33,0,0,0,33
1967847,1488885,2025-02-13,House,"FLOOR VOTE: CONSENT CALENDAR PASSAGE ON THIRD CONSIDERATION",91,0,0,0,91
1967847,1498150,2025-02-24,Senate,"FLOOR VOTE: Motion to Adopt",33,0,0,0,33
1967903,1488881,2025-02-13,House,"FLOOR VOTE: CONSENT CALENDAR PASSAGE ON THIRD CONSIDERATION",91,0,0,0,91
1967903,1497925,2025-02-24,Senate,"FLOOR VOTE: Motion to Adopt",33,0,0,0,33
1967961,1488650,2025-02-13,House,"FLOOR VOTE: CONSENT CALENDAR PASSAGE ON THIRD CONSIDERATION",91,0,0,0,91
1967961,1498346,2025-02-24,Senate,"FLOOR VOTE: Motion to Adopt",33,0,0,0,33
1968015,1488888,2025-02-13,House,"FLOOR VOTE: CONSENT CALENDAR PASSAGE ON THIRD CONSIDERATION",91,0,0,0,91
1968015,1497977,2025-02-24,Senate,"FLOOR VOTE: Motion to Adopt",33,0,0,0,33
1968070,1488623,2025-02-13,House,"FLOOR VOTE: CONSENT CALENDAR PASSAGE ON THIRD CONSIDERATION",91,0,0,0,91
1968070,1498044,2025-02-24,Senate,"FLOOR VOTE: Motion to Adopt",33,0,0,0,33
1968354,1503947,2025-03-03,House,"FLOOR VOTE: CONSENT CALENDAR PASSAGE ON THIRD CONSIDERATION",89,0,0,0,89
1968354,1518260,2025-02-27,Senate,"FLOOR VOTE: Motion to Adopt",32,0,0,0,32
1968402,1507125,2025-03-06,House,"FLOOR VOTE: CONSENT CALENDAR PASSAGE ON THIRD CONSIDERATION",91,0,1,0,92
1968402,1515448,2025-02-27,Senate,"FLOOR VOTE: Motion to Adopt",32,0,0,0,32
1968453,1509191,2025-03-10,House,"HOUSE PRIVATE ACTS COMMITTEE: Rec. for pass; ref to State & Local Government Committee",7,0,1,0,8
1968453,1534570,2025-04-02,House,"HOUSE STATE & LOCAL GOVERNMENT COMMITTEE: Rec. for pass; ref to Calendar & Rules Committee",19,2,0,0,21
1968453,1539195,2025-04-07,House,"FLOOR VOTE: CONSENT CALENDAR PASSAGE ON THIRD CONSIDERATION",96,0,0,0,96
1968453,1548013,2025-04-14,Senate,"FLOOR VOTE: Motion to Adopt",32,0,0,0,32
1968503,1507394,2025-03-06,House,"FLOOR VOTE: CONSENT CALENDAR PASSAGE ON THIRD CONSIDERATION",91,0,1,0,92
1968503,1513848,2025-02-27,Senate,"FLOOR VOTE: Motion to Adopt",32,0,0,0,32
1968554,1507529,2025-03-06,House,"FLOOR VOTE: CONSENT CALENDAR PASSAGE ON THIRD CONSIDERATION",91,0,1,0,92
1968554,1514025,2025-02-27,Senate,"FLOOR VOTE: Motion to Adopt",32,0,0,0,32
1968604,1507245,2025-03-06,House,"FLOOR VOTE: CONSENT CALENDAR PASSAGE ON THIRD CONSIDERATION",91,0,1,0,92
1968604,1513441,2025-02-27,Senate,"FLOOR VOTE: Motion to Adopt",32,0,0,0,32
1968658,1507510,2025-03-06,House,"FLOOR VOTE: CONSENT CALENDAR PASSAGE ON THIRD CONSIDERATION",91,0,1,0,92
1968658,1514178,2025-02-27,Senate,"FLOOR VOTE: Motion to Adopt",32,0,0,0,32
1968710,1507448,2025-03-06,House,"FLOOR VOTE: CONSENT CALENDAR PASSAGE ON THIRD CONSIDERATION",91,0,1,0,92
1968710,1513982,2025-02-27,Senate,"FLOOR VOTE: Motion to Adopt",32,0,0,0,32
1968761,1507266,2025-03-06,House,"FLOOR VOTE: CONSENT CALENDAR PASSAGE ON THIRD CONSIDERATION",91,0,1,0,92
1968761,1515484,2025-02-27,Senate,"FLOOR VOTE: Motion to Adopt",32,0,0,0,32
1968814,1494801,2025-02-20,House,"FLOOR VOTE: CONSENT CALENDAR PASSAGE ON THIRD CONSIDERATION",89,0,1,0,90
1968814,1507605,2025-03-05,Senate,"SENATE EDUCATION COMMITTEE: Recommended for concurrence by Senate Education Committee, refer Senate Calendar Committee",9,0,0,0,9
1968814,1517220,2025-03-13,Senate,"FLOOR VOTE: Motion to Adopt",32,0,0,0,32
1969010,1507468,2025-03-06,House,"FLOOR VOTE: CONSENT CALENDAR PASSAGE ON THIRD CONSIDERATION",91,0,1,0,92
1969010,1514222,2025-02-27,Senate,"FLOOR VOTE: Motion to Adopt",32,0,0,0,32
1969148,1507327,2025-03-06,House,"FLOOR VOTE: CONSENT CALENDAR PASSAGE ON THIRD CONSIDERATION",91,0,1,0,92
1969148,1515323,2025-02-27,Senate,"FLOOR VOTE: Motion to Adopt",32,0,0,0,32
1969289,1507267,2025-03-06,House,"FLOOR VOTE: CONSENT CALENDAR PASSAGE ON THIRD CONSIDERATION",91,0,1,0,92
1969289,1513389,2025-02-27,Senate,"FLOOR VOTE: Motion to Adopt",32,0,0,0,32
1969432,1495509,2025-02-20,House,"FLOOR VOTE: CONSENT CALENDAR PASSAGE ON THIRD CONSIDERATION",89,0,1,0,90
1969432,1514817,2025-02-27,Senate,"FLOOR VOTE: Motion to Adopt",32,0,0,0,32
1969575,1507489,2025-03-06,House,"FLOOR VOTE: CONSENT CALENDAR PASSAGE ON THIRD CONSIDERATION",91,0,1,0,92
1969575,1513163,2025-02-27,Senate,"FLOOR VOTE: Motion to Adopt",32,0,0,0,32
1969723,1507274,2025-03-06,House,"FLOOR VOTE: CONSENT CALENDAR PASSAGE ON THIRD CONSIDERATION",91,0,1,0,92
1969723,1515455,2025-02-27,Senate,"FLOOR VOTE: Motion to Adopt",32,0,0,0,32
1969869,1507271,2025-03-06,House,"FLOOR VOTE: CONSENT CALENDAR PASSAGE ON THIRD CONSIDERATION",91,0,1,0,92
1969869,1513333,2025-02-27,Senate,"FLOOR VOTE: Motion to Adopt",32,0,0,0,32
1970012,1507214,2025-03-06,House,"FLOOR VOTE: CONSENT CALENDAR PASSAGE ON THIRD CONSIDERATION",91,0,1,0,92
1970012,1514459,2025-02-27,Senate,"FLOOR VOTE: Motion to Adopt",32,0,0,0,32
1970017,1507515,2025-03-06,House,"FLOOR VOTE: CONSENT CALENDAR PASSAGE ON THIRD CONSIDERATION",91,0,1,0,92
1970017,1514716,2025-02-27,Senate,"FLOOR VOTE: Motion to Adopt",32,0,0,0,32
1971015,1548889,2025-04-15,Senate,"SENATE FINANCE, WAYS AND MEANS COMMITTEE: Recommended for passage with amendment/s, refer to Senate Calendar Committee Ayes 7, Nays 2 PNV 1",7,2,1,0,10
1971100,1549270,2025-04-15,Senate,"SENATE FINANCE, WAYS AND MEANS COMMITTEE: Recommended for passage with amendment/s, refer to Senate Calendar Committee Ayes 8, Nays 0 PNV 2",8,0,2,0,10
1971187,1549214,2025-04-15,House,"HOUSE FINANCE, WAYS, AND MEANS COMMITTEE: Rec. for pass. if am., ref. to Calendar & Rules Committee",26,0,0,0,26
1971187,1549215,2025-04-15,House,"HOUSE FINANCE, WAYS, AND MEANS SUBCOMMITTEE: Rec for pass if am by s/c ref. to Finance, Ways, and Means Committee",13,0,0,0,13
1971187,1550789,2025-04-16,House,"FLOOR VOTE: APPROPRIATIONS CALENDAR AS AMENDED PASSAGE ON THIRD CONSIDERATION",91,2,2,0,95
1971187,1551244,2025-04-16,Senate,"FLOOR VOTE: Third Consideration",33,0,0,0,33
1971278,1548944,2025-04-15,Senate,"SENATE FINANCE, WAYS AND MEANS COMMITTEE: Recommended for passage with amendment/s, refer to Senate Calendar Committee Ayes 10, Nays 0 PNV 0",10,0,0,0,10
1971366,1549147,2025-04-15,House,"HOUSE FINANCE, WAYS, AND MEANS COMMITTEE: Rec. for pass. if am., ref. to Calendar & Rules Committee",27,0,0,0,27
1971366,1549148,2025-04-15,House,"HOUSE FINANCE, WAYS, AND MEANS SUBCOMMITTEE: Rec for pass if am by s/c ref. to Finance, Ways, and Means Committee",13,0,0,0,13
1971366,1550432,2025-04-16,House,"FLOOR VOTE: APPROPRIATIONS CALENDAR AS AMENDED PASSAGE ON THIRD CONSIDERATION",79,16,1,0,96
1971366,1550433,2025-04-16,House,"FLOOR VOTE: APPROPRIATIONS CALENDAR MOTION TO ADOPT AMENDMENT # 12 BY WILLIAMS PASSAGE ON THIRD CONSIDERATION",75,22,0,0,97
1971366,1550434,2025-04-16,House,"FLOOR VOTE: APPROPRIATIONS CALENDAR MOTION TO ADOPT AMENDMENT # 16 BY FAISON PASSAGE ON THIRD CONSIDERATION",82,11,0,0,93
1971366,1550435,2025-04-16,House,"FLOOR VOTE: APPROPRIATIONS CALENDAR MOTION TO ADOPT AMENDMENT # 4 BY WILLIAMS PASSAGE ON THIRD CONSIDERATION",57,30,1,0,88
1971366,1550436,2025-04-16,House,"FLOOR VOTE: APPROPRIATIONS CALENDAR MOTION TO ADOPT AMENDMENT # 5 BY SALINAS PASSAGE ON THIRD CONSIDERATION",27,66,0,0,93
1971366,1550437,2025-04-16,House,"FLOOR VOTE: APPROPRIATIONS CALENDAR MOTION TO ADOPT AMENDMENT # 6 BY BEHN PASSAGE ON THIRD CONSIDERATION",24,69,0,0,93
1971366,1550438,2025-04-16,House,"FLOOR VOTE: APPROPRIATIONS CALENDAR MOTION TO CONSIDER AMENDMENT # 10 BY HARDAWAY PASSAGE ON THIRD CONSIDERATION",24,68,0,0,92
1971366,1550439,2025-04-16,House,"FLOOR VOTE: APPROPRIATIONS CALENDAR MOTION TO CONSIDER AMENDMENT # 11 BY BEHN PASSAGE ON THIRD CONSIDERATION",24,68,0,0,92
1971366,1550440,2025-04-16,House,"FLOOR VOTE: APPROPRIATIONS CALENDAR MOTION TO CONSIDER AMENDMENT # 12 BY WILLIAMS PASSAGE ON THIRD CONSIDERATION",69,20,0,0,89
1971366,1550441,2025-04-16,House,"FLOOR VOTE: APPROPRIATIONS CALENDAR MOTION TO CONSIDER AMENDMENT # 13 BY DIXIE PASSAGE ON THIRD CONSIDERATION",23,72,0,0,95
1971366,1550442,2025-04-16,House,"FLOOR VOTE: APPROPRIATIONS CALENDAR MOTION TO CONSIDER AMENDMENT # 14 BY GLYNN PASSAGE ON THIRD CONSIDERATION",26,71,0,0,97
1971366,1550443,2025-04-16,House,"FLOOR VOTE: APPROPRIATIONS CALENDAR MOTION TO CONSIDER AMENDMENT # 15 BY HEMMER PASSAGE ON THIRD CONSIDERATION",23,73,0,0,96
1971366,1550444,2025-04-16,House,"FLOOR VOTE: APPROPRIATIONS CALENDAR MOTION TO CONSIDER AMENDMENT # 16 BY FAISON PASSAGE ON THIRD CONSIDERATION",75,17,0,0,92
1971366,1550445,2025-04-16,House,"FLOOR VOTE: APPROPRIATIONS CALENDAR MOTION TO CONSIDER AMENDMENT # 18 BY POWELL PASSAGE ON THIRD CONSIDERATION",22,73,0,0,95
1971366,1550446,2025-04-16,House,"FLOOR VOTE: APPROPRIATIONS CALENDAR MOTION TO CONSIDER AMENDMENT # 20 BY MCKENZIE PASSAGE ON THIRD CONSIDERATION",23,71,0,0,94
1971366,1550447,2025-04-16,House,"FLOOR VOTE: APPROPRIATIONS CALENDAR MOTION TO CONSIDER AMENDMENT # 21 BY JOHNSON PASSAGE ON THIRD CONSIDERATION",23,71,0,0,94
1971366,1550448,2025-04-16,House,"FLOOR VOTE: APPROPRIATIONS CALENDAR MOTION TO CONSIDER AMENDMENT # 22 BY JONES J PASSAGE ON THIRD CONSIDERATION",21,72,0,0,93
1971366,1550449,2025-04-16,House,"FLOOR VOTE: APPROPRIATIONS CALENDAR MOTION TO CONSIDER AMENDMENT # 23 BY SALINAS PASSAGE ON THIRD CONSIDERATION",22,71,0,0,93
1971366,1550450,2025-04-16,House,"FLOOR VOTE: APPROPRIATIONS CALENDAR MOTION TO CONSIDER AMENDMENT # 24 BY BROOKS PASSAGE ON THIRD CONSIDERATION",24,68,0,0,92
1971366,1550451,2025-04-16,House,"FLOOR VOTE: APPROPRIATIONS CALENDAR MOTION TO CONSIDER AMENDMENT # 25 BY POWELL PASSAGE ON THIRD CONSIDERATION",22,70,0,0,92
1971366,1550452,2025-04-16,House,"FLOOR VOTE: APPROPRIATIONS CALENDAR MOTION TO CONSIDER AMENDMENT # 26 BY PEARSON PASSAGE ON THIRD CONSIDERATION",22,70,0,0,92
1971366,1550453,2025-04-16,House,"FLOOR VOTE: APPROPRIATIONS CALENDAR MOTION TO CONSIDER AMENDMENT # 27 BY PEARSON PASSAGE ON THIRD CONSIDERATION",24,69,0,0,93
1971366,1550454,2025-04-16,House,"FLOOR VOTE: APPROPRIATIONS CALENDAR MOTION TO CONSIDER AMENDMENT # 28 BY PEARSON PASSAGE ON THIRD CONSIDERATION",23,67,0,0,90
1971366,1550455,2025-04-16,House,"FLOOR VOTE: APPROPRIATIONS CALENDAR MOTION TO CONSIDER AMENDMENT # 29 BY PEARSON PASSAGE ON THIRD CONSIDERATION",24,69,0,0,93
1971366,1550456,2025-04-16,House,"FLOOR VOTE: APPROPRIATIONS CALENDAR MOTION TO CONSIDER AMENDMENT # 30 BY PEARSON PASSAGE ON THIRD CONSIDERATION",22,72,0,0,94
1971366,1550457,2025-04-16,House,"FLOOR VOTE: APPROPRIATIONS CALENDAR MOTION TO CONSIDER AMENDMENT # 31 BY PEARSON PASSAGE ON THIRD CONSIDERATION",25,69,0,0,94
1971366,1550458,2025-04-16,House,"FLOOR VOTE: APPROPRIATIONS CALENDAR MOTION TO CONSIDER AMENDMENT # 7 BY HARRIS PASSAGE ON THIRD CONSIDERATION",24,68,0,0,92
1971366,1550459,2025-04-16,House,"FLOOR VOTE: APPROPRIATIONS CALENDAR MOTION TO CONSIDER AMENDMENT # 8 BY MILLER PASSAGE ON THIRD CONSIDERATION",24,63,0,0,87
1971366,1550460,2025-04-16,House,"FLOOR VOTE: APPROPRIATIONS CALENDAR MOTION TO CONSIDER AMENDMENT # 9 BY CLEMMONS PASSAGE ON THIRD CONSIDERATION",24,61,0,0,85
1971366,1550461,2025-04-16,House,"FLOOR VOTE: APPROPRIATIONS CALENDAR PREVIOUS QUESTION AS AMENDED PASSAGE ON THIRD CONSIDERATION",69,24,0,0,93
1971366,1550972,2025-04-16,Senate,"FLOOR VOTE: Motion to Table Amend# 10 by Senator Campbell Third Consideration",27,5,0,0,32
1971366,1550973,2025-04-16,Senate,"FLOOR VOTE: Motion to Table Amend# 8 by Senator Yarbro Third Consideration",27,5,0,0,32
1971366,1550974,2025-04-16,Senate,"FLOOR VOTE: Third Consideration",30,2,1,0,33
1971455,1548742,2025-04-15,House,"HOUSE FINANCE, WAYS, AND MEANS COMMITTEE: Rec. for pass. if am., ref. to Calendar & Rules Committee",27,0,0,0,27
1971455,1548743,2025-04-15,House,"HOUSE FINANCE, WAYS, AND MEANS SUBCOMMITTEE: Rec for pass if am by s/c ref. to Finance, Ways, and Means Committee",13,0,0,0,13
1971455,1550087,2025-04-16,House,"FLOOR VOTE: APPROPRIATIONS CALENDAR AS AMENDED PASSAGE ON THIRD CONSIDERATION",85,9,0,0,94
1971455,1550088,2025-04-16,House,"FLOOR VOTE: APPROPRIATIONS CALENDAR PREVIOUS QUESTION AS AMENDED PASSAGE ON THIRD CONSIDERATION",73,22,0,0,95
1971455,1550884,2025-04-16,Senate,"FLOOR VOTE: Third Consideration",33,0,0,0,33
1973061,1498425,2025-02-24,House,"FLOOR VOTE: CONSENT CALENDAR PASSAGE ON THIRD CONSIDERATION",92,0,2,0,94
1973061,1515438,2025-03-03,Senate,"FLOOR VOTE: Motion to Adopt",32,0,0,0,32
1973247,1497929,2025-02-24,House,"FLOOR VOTE: CONSENT CALENDAR PASSAGE ON THIRD CONSIDERATION",92,0,2,0,94
1973247,1513454,2025-03-03,Senate,"FLOOR VOTE: Motion to Adopt",32,0,0,0,32
1973337,1507233,2025-03-06,House,"FLOOR VOTE: CONSENT CALENDAR PASSAGE ON THIRD CONSIDERATION",91,0,1,0,92
1973337,1515308,2025-02-27,Senate,"FLOOR VOTE: Motion to Adopt",32,0,0,0,32
1973430,1498444,2025-02-24,House,"FLOOR VOTE: CONSENT CALENDAR PASSAGE ON THIRD CONSIDERATION",92,0,2,0,94
1973430,1515433,2025-03-03,Senate,"FLOOR VOTE: Motion to Adopt",32,0,0,0,32
1973544,1516928,2025-03-12,Senate,"SENATE EDUCATION COMMITTEE: Recommended for adoption by Senate Education Committee, refer Senate Calendar Committee",8,0,0,0,8
1973544,1519953,2025-03-17,Senate,"FLOOR VOTE: Motion to Adopt",32,0,0,0,32
1973660,1498243,2025-02-24,House,"FLOOR VOTE: CONSENT CALENDAR PASSAGE ON THIRD CONSIDERATION",92,0,2,0,94
1973660,1515459,2025-03-03,Senate,"FLOOR VOTE: Motion to Adopt",32,0,0,0,32
1973775,1509111,2025-03-10,House,"HOUSE PRIVATE ACTS COMMITTEE: Rec. for pass; ref to State & Local Government Committee",8,0,0,0,8
1973775,1541146,2025-04-08,House,"HOUSE STATE & LOCAL GOVERNMENT COMMITTEE: Rec. for pass; ref to Calendar & Rules Committee",19,0,2,0,21
1973775,1547966,2025-04-14,House,"FLOOR VOTE: CONSENT CALENDAR PASSAGE ON THIRD CONSIDERATION",94,0,1,0,95
1975346,1497670,2025-02-24,House,"FLOOR VOTE: CONSENT CALENDAR PASSAGE ON THIRD CONSIDERATION",92,0,2,0,94
1975346,1515405,2025-03-03,Senate,"FLOOR VOTE: Motion to Adopt",32,0,0,0,32
1975450,1514107,2025-03-03,Senate,"FLOOR VOTE: Motion to Adopt",32,0,0,0,32
1975551,1498148,2025-02-24,House,"FLOOR VOTE: CONSENT CALENDAR PASSAGE ON THIRD CONSIDERATION",92,0,2,0,94
1975551,1515476,2025-03-03,Senate,"FLOOR VOTE: Motion to Adopt",32,0,0,0,32
1975651,1541642,2025-04-09,Senate,"FLOOR VOTE: Motion to Adopt",30,0,0,0,30
1976705,1497858,2025-02-24,House,"FLOOR VOTE: CONSENT CALENDAR PASSAGE ON THIRD CONSIDERATION",92,0,2,0,94
1976705,1513558,2025-03-03,Senate,"FLOOR VOTE: Motion to Adopt",32,0,0,0,32
1976747,1511896,2025-03-10,House,"FLOOR VOTE: CONSENT CALENDAR PASSAGE ON THIRD CONSIDERATION",94,0,0,0,94
1976747,1515458,2025-03-03,Senate,"FLOOR VOTE: Motion to Adopt",32,0,0,0,32
1976790,1511920,2025-03-10,House,"FLOOR VOTE: CONSENT CALENDAR PASSAGE ON THIRD CONSIDERATION",94,0,0,0,94
1976790,1515457,2025-03-03,Senate,"FLOOR VOTE: Motion to Adopt",32,0,0,0,32
1976833,1498025,2025-02-24,House,"FLOOR VOTE: CONSENT CALENDAR PASSAGE ON THIRD CONSIDERATION",92,0,2,0,94
1976833,1513442,2025-03-03,Senate,"FLOOR VOTE: Motion to Adopt",32,0,0,0,32
1976879,1497524,2025-02-24,House,"FLOOR VOTE: CONSENT CALENDAR PASSAGE ON THIRD CONSIDERATION",92,0,2,0,94
1976879,1515475,2025-03-03,Senate,"FLOOR VOTE: Motion to Adopt",32,0,0,0,32
1976915,1509768,2025-03-10,House,"FLOOR VOTE: CONSENT CALENDAR PASSAGE ON THIRD CONSIDERATION",94,0,0,0,94
1976915,1515193,2025-03-03,Senate,"FLOOR VOTE: Motion to Adopt",32,0,0,0,32
1976963,1511549,2025-03-10,House,"FLOOR VOTE: CONSENT CALENDAR PASSAGE ON THIRD CONSIDERATION",94,0,0,0,94
1976963,1514728,2025-03-03,Senate,"FLOOR VOTE: Motion to Adopt",32,0,0,0,32
1977053,1509724,2025-03-10,House,"FLOOR VOTE: CONSENT CALENDAR PASSAGE ON THIRD CONSIDERATION",94,0,0,0,94
1977053,1515053,2025-03-03,Senate,"FLOOR VOTE: Motion to Adopt",32,0,0,0,32
1977096,1497861,2025-02-24,House,"FLOOR VOTE: CONSENT CALENDAR PASSAGE ON THIRD CONSIDERATION",92,0,2,0,94
1977096,1515446,2025-03-03,Senate,"FLOOR VOTE: Motion to Adopt",32,0,0,0,32
1977137,1525369,2025-03-24,House,"HOUSE PRIVATE ACTS COMMITTEE: Rec. for pass; ref to State & Local Government Committee",9,0,0,0,9
1977137,1540536,2025-04-08,House,"HOUSE STATE & LOCAL GOVERNMENT COMMITTEE: Rec. for pass; ref to Calendar & Rules Committee",19,0,2,0,21
1977137,1547965,2025-04-14,House,"FLOOR VOTE: CONSENT CALENDAR PASSAGE ON THIRD CONSIDERATION",94,0,1,0,95
1977137,1552556,2025-04-17,Senate,"FLOOR VOTE: Motion to Adopt",33,0,0,0,33
1977143,1498464,2025-02-24,House,"FLOOR VOTE: CONSENT CALENDAR PASSAGE ON THIRD CONSIDERATION",92,0,2,0,94
1977143,1513905,2025-03-03,Senate,"FLOOR VOTE: Motion to Adopt",32,0,0,0,32
1977198,1512019,2025-03-10,House,"HOUSE PRIVATE ACTS COMMITTEE: Rec. for pass; ref to State & Local Government Committee",8,0,0,0,8
1977198,1521692,2025-03-19,House,"HOUSE STATE & LOCAL GOVERNMENT COMMITTEE: Rec. for pass; ref to Calendar & Rules Committee",22,0,0,0,22
1977198,1525671,2025-03-24,House,"FLOOR VOTE: CONSENT CALENDAR PASSAGE ON THIRD CONSIDERATION",96,0,0,0,96
1977198,1541392,2025-04-09,Senate,"FLOOR VOTE: Motion to Adopt",30,0,0,0,30
1977253,1497934,2025-02-24,House,"FLOOR VOTE: CONSENT CALENDAR PASSAGE ON THIRD CONSIDERATION",92,0,2,0,94
1977253,1514816,2025-03-03,Senate,"FLOOR VOTE: Motion to Adopt",32,0,0,0,32
1977308,1541656,2025-04-09,Senate,"FLOOR VOTE: Motion to Adopt",30,0,0,0,30
1977366,1525487,2025-03-24,House,"HOUSE PRIVATE ACTS COMMITTEE: Rec. for pass; ref to State & Local Government Committee",5,2,3,0,10
1977366,1540473,2025-04-08,House,"HOUSE STATE & LOCAL GOVERNMENT COMMITTEE: Failed in State & Local Government Committee",1,19,2,0,22
1977423,1498205,2025-02-24,House,"FLOOR VOTE: CONSENT CALENDAR PASSAGE ON THIRD CONSIDERATION",92,0,2,0,94
1977423,1513056,2025-03-03,Senate,"FLOOR VOTE: Motion to Adopt",32,0,0,0,32
1977484,1497620,2025-02-24,House,"FLOOR VOTE: CONSENT CALENDAR PASSAGE ON THIRD CONSIDERATION",92,0,2,0,94
1977484,1514300,2025-03-03,Senate,"FLOOR VOTE: Motion to Adopt",32,0,0,0,32
1977541,1497647,2025-02-24,House,"FLOOR VOTE: CONSENT CALENDAR PASSAGE ON THIRD CONSIDERATION",92,0,2,0,94
1977541,1515460,2025-03-03,Senate,"FLOOR VOTE: Motion to Adopt",32,0,0,0,32
1977600,1504946,2025-03-04,House,"HOUSE EDUCATION COMMITTEE: Rec. for pass; ref to Calendar & Rules Committee",17,0,0,0,17
1977600,1511900,2025-03-10,House,"FLOOR VOTE: CONSENT CALENDAR PASSAGE ON THIRD CONSIDERATION",94,0,0,0,94
1977658,1506444,2025-03-05,House,"HOUSE COMMERCE COMMITTEE: Rec. for pass; ref to Calendar & Rules Committee",21,0,0,0,21
1977658,1509148,2025-03-10,House,"FLOOR VOTE: CONSENT CALENDAR PASSAGE ON THIRD CONSIDERATION",94,0,0,0,94
1977715,1498325,2025-02-24,House,"FLOOR VOTE: CONSENT CALENDAR PASSAGE ON THIRD CONSIDERATION",92,0,2,0,94
1977715,1514489,2025-03-03,Senate,"FLOOR VOTE: Motion to Adopt",32,0,0,0,32
1979228,1501021,2025-02-27,House,"FLOOR VOTE: CONSENT CALENDAR PASSAGE ON THIRD CONSIDERATION",92,0,0,0,92
1979228,1515427,2025-03-06,Senate,"FLOOR VOTE: Motion to Adopt",32,0,0,0,32
1979529,1501571,2025-02-27,House,"FLOOR VOTE: CONSENT CALENDAR PASSAGE ON THIRD CONSIDERATION",92,0,0,0,92
1979529,1514298,2025-03-06,Senate,"FLOOR VOTE: Motion to Adopt",32,0,0,0,32
1979825,1501441,2025-02-27,House,"FLOOR VOTE: CONSENT CALENDAR PASSAGE ON THIRD CONSIDERATION",92,0,0,0,92
1979825,1515321,2025-03-06,Senate,"FLOOR VOTE: Motion to Adopt",32,0,0,0,32
1979831,1518246,2025-03-03,Senate,"FLOOR VOTE: Motion to Adopt",32,0,0,0,32
1979842,1518227,2025-03-03,Senate,"FLOOR VOTE: Motion to Adopt",32,0,0,0,32
1979853,1518235,2025-03-03,Senate,"FLOOR VOTE: Motion to Adopt",32,0,0,0,32
1979867,1518251,2025-03-03,Senate,"FLOOR VOTE: Motion to Adopt",32,0,0,0,32
1979879,1518243,2025-03-03,Senate,"FLOOR VOTE: Motion to Adopt",32,0,0,0,32
1979892,1518261,2025-03-03,Senate,"FLOOR VOTE: Motion to Adopt",32,0,0,0,32
1979904,1518252,2025-03-03,Senate,"FLOOR VOTE: Motion to Adopt",32,0,0,0,32
1979917,1518234,2025-03-03,Senate,"FLOOR VOTE: Motion to Adopt",32,0,0,0,32
1979929,1518259,2025-03-03,Senate,"FLOOR VOTE: Motion to Adopt",32,0,0,0,32
1979943,1518250,2025-03-03,Senate,"FLOOR VOTE: Motion to Adopt",32,0,0,0,32
1979955,1518262,2025-03-03,Senate,"FLOOR VOTE: Motion to Adopt",32,0,0,0,32
1980736,1501835,2025-02-27,House,"FLOOR VOTE: CONSENT CALENDAR PASSAGE ON THIRD CONSIDERATION",92,0,0,0,92
1980736,1513941,2025-03-06,Senate,"FLOOR VOTE: Motion to Adopt",32,0,0,0,32
1980779,1509126,2025-03-10,House,"FLOOR VOTE: CONSENT CALENDAR PASSAGE ON THIRD CONSIDERATION",94,0,0,0,94
1980779,1513753,2025-03-06,Senate,"FLOOR VOTE: Motion to Adopt",32,0,0,0,32
1980822,1501817,2025-02-27,House,"FLOOR VOTE: CONSENT CALENDAR PASSAGE ON THIRD CONSIDERATION",92,0,0,0,92
1980822,1513173,2025-03-06,Senate,"FLOOR VOTE: Motion to Adopt",32,0,0,0,32
1980867,1501823,2025-02-27,House,"FLOOR VOTE: CONSENT CALENDAR PASSAGE ON THIRD CONSIDERATION",92,0,0,0,92
1980867,1514284,2025-03-06,Senate,"FLOOR VOTE: Motion to Adopt",32,0,0,0,32
1980911,1548071,2025-04-14,Senate,"FLOOR VOTE: Motion to Adopt",32,0,0,0,32
1980955,1501775,2025-02-27,House,"FLOOR VOTE: CONSENT CALENDAR PASSAGE ON THIRD CONSIDERATION",92,0,0,0,92
1980955,1513855,2025-03-06,Senate,"FLOOR VOTE: Motion to Adopt",32,0,0,0,32
1980997,1501837,2025-02-27,House,"FLOOR VOTE: CONSENT CALENDAR PASSAGE ON THIRD CONSIDERATION",92,0,0,0,92
1980997,1514243,2025-03-06,Senate,"FLOOR VOTE: Motion to Adopt",32,0,0,0,32
1981041,1501842,2025-02-27,House,"FLOOR VOTE: CONSENT CALENDAR PASSAGE ON THIRD CONSIDERATION",92,0,0,0,92
1981041,1513564,2025-03-06,Senate,"FLOOR VOTE: Motion to Adopt",32,0,0,0,32
1981084,1501815,2025-02-27,House,"FLOOR VOTE: CONSENT CALENDAR PASSAGE ON THIRD CONSIDERATION",92,0,0,0,92
1981084,1515003,2025-03-06,Senate,"FLOOR VOTE: Motion to Adopt",32,0,0,0,32
1981127,1552462,2025-04-17,Senate,"FLOOR VOTE: Motion to Adopt",33,0,0,0,33
1981136,1501573,2025-02-27,House,"FLOOR VOTE: CONSENT CALENDAR PASSAGE ON THIRD CONSIDERATION",92,0,0,0,92
1981136,1515311,2025-03-06,Senate,"FLOOR VOTE: Motion to Adopt",32,0,0,0,32
1981165,1511361,2025-03-10,House,"FLOOR VOTE: CONSENT CALENDAR PASSAGE ON THIRD CONSIDERATION",94,0,0,0,94
1981165,1515262,2025-03-06,Senate,"FLOOR VOTE: Motion to Adopt",32,0,0,0,32
1981195,1511711,2025-03-10,House,"FLOOR VOTE: CONSENT CALENDAR PASSAGE ON THIRD CONSIDERATION",94,0,0,0,94
1981195,1515410,2025-03-06,Senate,"FLOOR VOTE: Motion to Adopt",32,0,0,0,32
1981227,1511867,2025-03-10,House,"FLOOR VOTE: CONSENT CALENDAR PASSAGE ON THIRD CONSIDERATION",94,0,0,0,94
1981227,1515441,2025-03-06,Senate,"FLOOR VOTE: Motion to Adopt",32,0,0,0,32
1981257,1501039,2025-02-27,House,"FLOOR VOTE: CONSENT CALENDAR PASSAGE ON THIRD CONSIDERATION",92,0,0,0,92
1981257,1514446,2025-03-06,Senate,"FLOOR VOTE: Motion to Adopt",32,0,0,0,32
1981292,1509652,2025-03-10,House,"HOUSE PRIVATE ACTS COMMITTEE: Rec. for pass; ref to State & Local Government Committee",9,0,0,0,9
1981292,1522166,2025-03-19,House,"HOUSE STATE & LOCAL GOVERNMENT COMMITTEE: Rec. for pass; ref to Calendar & Rules Committee",22,0,0,0,22
1981292,1525263,2025-03-24,House,"FLOOR VOTE: CONSENT CALENDAR PASSAGE ON THIRD CONSIDERATION",96,0,0,0,96
1981292,1541825,2025-04-09,Senate,"FLOOR VOTE: Motion to Adopt",30,0,0,0,30
1981321,1515734,2025-03-11,Senate,"SENATE JUDICIARY COMMITTEE: Recommended for adoption by Senate Judiciary Committee, refer Senate Calendar Committee",9,0,0,0,9
1981321,1520006,2025-03-17,Senate,"FLOOR VOTE: Motion to Adopt",32,0,0,0,32
1981355,1512367,2025-03-10,House,"FLOOR VOTE: CONSENT CALENDAR PASSAGE ON THIRD CONSIDERATION",94,0,0,0,94
1981355,1513714,2025-03-06,Senate,"FLOOR VOTE: Motion to Adopt",32,0,0,0,32
1981385,1501075,2025-02-27,House,"FLOOR VOTE: CONSENT CALENDAR PASSAGE ON THIRD CONSIDERATION",92,0,0,0,92
1981385,1514675,2025-03-06,Senate,"FLOOR VOTE: Motion to Adopt",32,0,0,0,32
1981416,1511914,2025-03-10,House,"FLOOR VOTE: CONSENT CALENDAR PASSAGE ON THIRD CONSIDERATION",94,0,0,0,94
1981416,1515463,2025-03-06,Senate,"FLOOR VOTE: Motion to Adopt",32,0,0,0,32
1981452,1518249,2025-03-03,Senate,"FLOOR VOTE: Motion to Adopt",32,0,0,0,32
1981484,1509132,2025-03-10,House,"FLOOR VOTE: CONSENT CALENDAR PASSAGE ON THIRD CONSIDERATION",94,0,0,0,94
1981484,1513803,2025-03-06,Senate,"FLOOR VOTE: Motion to Adopt",32,0,0,0,32
1981515,1512280,2025-03-10,House,"FLOOR VOTE: CONSENT CALENDAR PASSAGE ON THIRD CONSIDERATION",94,0,0,0,94
1981515,1513528,2025-03-06,Senate,"FLOOR VOTE: Motion to Adopt",32,0,0,0,32
1981549,1501088,2025-02-27,House,"FLOOR VOTE: CONSENT CALENDAR PASSAGE ON THIRD CONSIDERATION",92,0,0,0,92
1981549,1514652,2025-03-06,Senate,"FLOOR VOTE: Motion to Adopt",32,0,0,0,32
1981585,1511901,2025-03-10,House,"FLOOR VOTE: CONSENT CALENDAR PASSAGE ON THIRD CONSIDERATION",94,0,0,0,94
1981585,1515369,2025-03-06,Senate,"FLOOR VOTE: Motion to Adopt",32,0,0,0,32
1981616,1509171,2025-03-10,House,"FLOOR VOTE: CONSENT CALENDAR PASSAGE ON THIRD CONSIDERATION",94,0,0,0,94
1981616,1513911,2025-03-06,Senate,"FLOOR VOTE: Motion to Adopt",32,0,0,0,32
1981647,1509257,2025-03-10,House,"FLOOR VOTE: CONSENT CALENDAR PASSAGE ON THIRD CONSIDERATION",94,0,0,0,94
1981647,1514315,2025-03-06,Senate,"FLOOR VOTE: Motion to Adopt",32,0,0,0,32
1981679,1516083,2025-03-06,Senate,"FLOOR VOTE: Motion to Adopt",32,0,0,0,32
1981717,1509149,2025-03-10,House,"FLOOR VOTE: CONSENT CALENDAR PASSAGE ON THIRD CONSIDERATION",94,0,0,0,94
1981717,1513875,2025-03-06,Senate,"FLOOR VOTE: Motion to Adopt",32,0,0,0,32
1981759,1501417,2025-02-27,House,"FLOOR VOTE: CONSENT CALENDAR PASSAGE ON THIRD CONSIDERATION",92,0,0,0,92
1981759,1515118,2025-03-06,Senate,"FLOOR VOTE: Motion to Adopt",32,0,0,0,32
1981801,1509228,2025-03-10,House,"FLOOR VOTE: CONSENT CALENDAR PASSAGE ON THIRD CONSIDERATION",94,0,0,0,94
1981801,1514273,2025-03-06,Senate,"FLOOR VOTE: Motion to Adopt",32,0,0,0,32
1981845,1506797,2025-03-05,Senate,"SENATE ENERGY, AGRICULTURE AND NATURAL RESOURCES COMMITTEE: Recommended for adoption by Senate Energy, Ag., and Nat. Resources Committee, refer Senate Calendar Committee",9,0,0,0,9
1981845,1513284,2025-03-10,Senate,"FLOOR VOTE: Motion to Adopt",30,0,0,0,30
1981845,1540604,2025-04-08,House,"HOUSE STATE & LOCAL GOVERNMENT COMMITTEE: Rec. for pass; ref to Calendar & Rules Committee",23,0,0,0,23
1981845,1547368,2025-04-14,House,"FLOOR VOTE: CONSENT CALENDAR PASSAGE ON THIRD CONSIDERATION",94,0,1,0,95
1981887,1501120,2025-02-27,House,"FLOOR VOTE: CONSENT CALENDAR PASSAGE ON THIRD CONSIDERATION",92,0,0,0,92
1981887,1514838,2025-03-06,Senate,"FLOOR VOTE: Motion to Adopt",32,0,0,0,32
1981930,1501351,2025-02-27,House,"FLOOR VOTE: CONSENT CALENDAR PASSAGE ON THIRD CONSIDERATION",92,0,0,0,92
1981930,1514866,2025-03-06,Senate,"FLOOR VOTE: Motion to Adopt",32,0,0,0,32
1981972,1501518,2025-02-27,House,"FLOOR VOTE: CONSENT CALENDAR PASSAGE ON THIRD CONSIDERATION",92,0,0,0,92
1981972,1513099,2025-03-06,Senate,"FLOOR VOTE: Motion to Adopt",32,0,0,0,32
1982257,1503866,2025-03-03,House,"FLOOR VOTE: CONSENT CALENDAR PASSAGE ON THIRD CONSIDERATION",89,0,0,0,89
1982257,1515432,2025-03-10,Senate,"FLOOR VOTE: Motion to Adopt",30,0,0,0,30
1982272,1504071,2025-03-03,House,"FLOOR VOTE: CONSENT CALENDAR PASSAGE ON THIRD CONSIDERATION",89,0,0,0,89
1982272,1515481,2025-03-10,Senate,"FLOOR VOTE: Motion to Adopt",30,0,0,0,30
1982289,1503699,2025-03-03,House,"FLOOR VOTE: CONSENT CALENDAR PASSAGE ON THIRD CONSIDERATION",89,0,0,0,89
1982289,1515394,2025-03-10,Senate,"FLOOR VOTE: Motion to Adopt",30,0,0,0,30
1982306,1503959,2025-03-03,House,"FLOOR VOTE: CONSENT CALENDAR PASSAGE ON THIRD CONSIDERATION",89,0,0,0,89
1982306,1515440,2025-03-10,Senate,"FLOOR VOTE: Motion to Adopt",30,0,0,0,30
1982322,1503891,2025-03-03,House,"FLOOR VOTE: CONSENT CALENDAR PASSAGE ON THIRD CONSIDERATION",89,0,0,0,89
1982322,1515462,2025-03-10,Senate,"FLOOR VOTE: Motion to Adopt",30,0,0,0,30
1982341,1503709,2025-03-03,House,"FLOOR VOTE: CONSENT CALENDAR PASSAGE ON THIRD CONSIDERATION",89,0,0,0,89
1982341,1515414,2025-03-10,Senate,"FLOOR VOTE: Motion to Adopt",30,0,0,0,30
1982360,1504041,2025-03-03,House,"FLOOR VOTE: CONSENT CALENDAR PASSAGE ON THIRD CONSIDERATION",89,0,0,0,89
1982360,1515383,2025-03-10,Senate,"FLOOR VOTE: Motion to Adopt",30,0,0,0,30
1982376,1503802,2025-03-03,House,"FLOOR VOTE: CONSENT CALENDAR PASSAGE ON THIRD CONSIDERATION",89,0,0,0,89
1982376,1515305,2025-03-10,Senate,"FLOOR VOTE: Motion to Adopt",30,0,0,0,30
1982394,1503955,2025-03-03,House,"FLOOR VOTE: CONSENT CALENDAR PASSAGE ON THIRD CONSIDERATION",89,0,0,0,89
1982394,1515212,2025-03-10,Senate,"FLOOR VOTE: Motion to Adopt",30,0,0,0,30
1982410,1509725,2025-03-10,House,"FLOOR VOTE: CONSENT CALENDAR PASSAGE ON THIRD CONSIDERATION",94,0,0,0,94
1982410,1515004,2025-03-06,Senate,"FLOOR VOTE: Motion to Adopt",32,0,0,0,32
1982427,1509158,2025-03-10,House,"FLOOR VOTE: CONSENT CALENDAR PASSAGE ON THIRD CONSIDERATION",94,0,0,0,94
1982427,1513895,2025-03-06,Senate,"FLOOR VOTE: Motion to Adopt",32,0,0,0,32
1982445,1504042,2025-03-03,House,"FLOOR VOTE: CONSENT CALENDAR PASSAGE ON THIRD CONSIDERATION",89,0,0,0,89
1982445,1513781,2025-03-10,Senate,"FLOOR VOTE: Motion to Adopt",30,0,0,0,30
1982463,1503813,2025-03-03,House,"FLOOR VOTE: CONSENT CALENDAR PASSAGE ON THIRD CONSIDERATION",89,0,0,0,89
1982463,1515094,2025-03-10,Senate,"FLOOR VOTE: Motion to Adopt",30,0,0,0,30
1982480,1503884,2025-03-03,House,"FLOOR VOTE: CONSENT CALENDAR PASSAGE ON THIRD CONSIDERATION",89,0,0,0,89
1982496,1503524,2025-03-03,House,"FLOOR VOTE: CONSENT CALENDAR PASSAGE ON THIRD CONSIDERATION",89,0,0,0,89
1982496,1515044,2025-03-10,Senate,"FLOOR VOTE: Motion to Adopt",30,0,0,0,30
1982516,1503930,2025-03-03,House,"FLOOR VOTE: CONSENT CALENDAR PASSAGE ON THIRD CONSIDERATION",89,0,0,0,89
1982516,1515229,2025-03-10,Senate,"FLOOR VOTE: Motion to Adopt",30,0,0,0,30
1982533,1503840,2025-03-03,House,"FLOOR VOTE: CONSENT CALENDAR PASSAGE ON THIRD CONSIDERATION",89,0,0,0,89
1982533,1514583,2025-03-10,Senate,"FLOOR VOTE: Motion to Adopt",30,0,0,0,30
1982552,1503885,2025-03-03,House,"FLOOR VOTE: CONSENT CALENDAR PASSAGE ON THIRD CONSIDERATION",89,0,0,0,89
1982552,1514234,2025-03-10,Senate,"FLOOR VOTE: Motion to Adopt",30,0,0,0,30
1982571,1503696,2025-03-03,House,"FLOOR VOTE: CONSENT CALENDAR PASSAGE ON THIRD CONSIDERATION",89,0,0,0,89
1982571,1514950,2025-03-10,Senate,"FLOOR VOTE: Motion to Adopt",30,0,0,0,30
1982587,1509657,2025-03-10,House,"HOUSE PRIVATE ACTS COMMITTEE: Rec. for pass; ref to State & Local Government Committee",8,0,0,0,8
1982587,1528194,2025-03-26,House,"HOUSE STATE & LOCAL GOVERNMENT COMMITTEE: Rec. for pass; ref to Calendar & Rules Committee",18,2,1,0,21
1982587,1538693,2025-04-07,House,"FLOOR VOTE: CONSENT CALENDAR PASSAGE ON THIRD CONSIDERATION",96,0,0,0,96
1982587,1548108,2025-04-14,Senate,"FLOOR VOTE: Motion to Adopt",32,0,0,0,32
1982604,1503923,2025-03-03,House,"FLOOR VOTE: CONSENT CALENDAR PASSAGE ON THIRD CONSIDERATION",89,0,0,0,89
1982604,1514780,2025-03-10,Senate,"FLOOR VOTE: Motion to Adopt",30,0,0,0,30
1982622,1503701,2025-03-03,House,"FLOOR VOTE: CONSENT CALENDAR PASSAGE ON THIRD CONSIDERATION",89,0,0,0,89
1982622,1514709,2025-03-10,Senate,"FLOOR VOTE: Motion to Adopt",30,0,0,0,30
1982638,1503857,2025-03-03,House,"FLOOR VOTE: CONSENT CALENDAR PASSAGE ON THIRD CONSIDERATION",89,0,0,0,89
1982638,1515488,2025-03-10,Senate,"FLOOR VOTE: Motion to Adopt",30,0,0,0,30
1982657,1503610,2025-03-03,House,"FLOOR VOTE: CONSENT CALENDAR PASSAGE ON THIRD CONSIDERATION",89,0,0,0,89
1982657,1514729,2025-03-10,Senate,"FLOOR VOTE: Motion to Adopt",30,0,0,0,30
1982676,1504048,2025-03-03,House,"FLOOR VOTE: CONSENT CALENDAR PASSAGE ON THIRD CONSIDERATION",89,0,0,0,89
1982676,1515485,2025-03-10,Senate,"FLOOR VOTE: Motion to Adopt",30,0,0,0,30
1982692,1504062,2025-03-03,House,"FLOOR VOTE: CONSENT CALENDAR PASSAGE ON THIRD CONSIDERATION",89,0,0,0,89
1982692,1515482,2025-03-10,Senate,"FLOOR VOTE: Motion to Adopt",30,0,0,0,30
1982709,1504012,2025-03-03,House,"FLOOR VOTE: CONSENT CALENDAR PASSAGE ON THIRD CONSIDERATION",89,0,0,0,89
1982709,1515478,2025-03-10,Senate,"FLOOR VOTE: Motion to Adopt",30,0,0,0,30
1982726,1504047,2025-03-03,House,"FLOOR VOTE: CONSENT CALENDAR PASSAGE ON THIRD CONSIDERATION",89,0,0,0,89
1982726,1515467,2025-03-10,Senate,"FLOOR VOTE: Motion to Adopt",30,0,0,0,30
1983016,1503461,2025-03-03,House,"FLOOR VOTE: CONSENT CALENDAR PASSAGE ON THIRD CONSIDERATION",89,0,0,0,89
1983016,1515425,2025-03-10,Senate,"FLOOR VOTE: Motion to Adopt",30,0,0,0,30
1983295,1503982,2025-03-03,House,"FLOOR VOTE: CONSENT CALENDAR PASSAGE ON THIRD CONSIDERATION",89,0,0,0,89
1983295,1515386,2025-03-10,Senate,"FLOOR VOTE: Motion to Adopt",30,0,0,0,30
1983570,1516698,2025-03-11,Senate,"SENATE STATE & LOCAL GOVERNMENT COMMITTEE: Recommended for adoption by Senate State and Local Government Committee, refer Senate Calendar Committee",7,0,0,0,7
1983570,1519819,2025-03-17,Senate,"FLOOR VOTE: Motion to Adopt",32,0,0,0,32
1983570,1525614,2025-03-24,House,"FLOOR VOTE: CONSENT CALENDAR PASSAGE ON THIRD CONSIDERATION",96,0,0,0,96
1983980,1539466,2025-04-08,House,"HOUSE JUDICIARY COMMITTEE: Rec. for pass; ref to Calendar & Rules Committee",22,0,0,0,22
1983980,1547801,2025-04-14,House,"FLOOR VOTE: CONSENT CALENDAR PASSAGE ON THIRD CONSIDERATION",94,0,1,0,95
1984055,1512215,2025-03-10,House,"FLOOR VOTE: CONSENT CALENDAR PASSAGE ON THIRD CONSIDERATION",94,0,0,0,94
1984055,1513374,2025-03-06,Senate,"FLOOR VOTE: Motion to Adopt",32,0,0,0,32
1984125,1539456,2025-04-08,House,"HOUSE JUDICIARY COMMITTEE: Rec. for pass; ref to Calendar & Rules Committee",22,0,0,0,22
1984125,1547981,2025-04-14,House,"FLOOR VOTE: CONSENT CALENDAR PASSAGE ON THIRD CONSIDERATION",94,0,1,0,95
1984200,1503537,2025-03-03,House,"FLOOR VOTE: CONSENT CALENDAR PASSAGE ON THIRD CONSIDERATION",89,0,0,0,89
1984200,1515368,2025-03-10,Senate,"FLOOR VOTE: Motion to Adopt",30,0,0,0,30
1984271,1509732,2025-03-10,House,"FLOOR VOTE: CONSENT CALENDAR PASSAGE ON THIRD CONSIDERATION",94,0,0,0,94
1984271,1515061,2025-03-06,Senate,"FLOOR VOTE: Motion to Adopt",32,0,0,0,32
1984344,1511941,2025-03-10,House,"FLOOR VOTE: CONSENT CALENDAR PASSAGE ON THIRD CONSIDERATION",94,0,0,0,94
1984344,1515474,2025-03-06,Senate,"FLOOR VOTE: Motion to Adopt",32,0,0,0,32
1984412,1503825,2025-03-03,House,"FLOOR VOTE: CONSENT CALENDAR PASSAGE ON THIRD CONSIDERATION",89,0,0,0,89
1984412,1515387,2025-03-10,Senate,"FLOOR VOTE: Motion to Adopt",30,0,0,0,30
1984417,1503990,2025-03-03,House,"FLOOR VOTE: CONSENT CALENDAR PASSAGE ON THIRD CONSIDERATION",89,0,0,0,89
1984417,1514277,2025-03-10,Senate,"FLOOR VOTE: Motion to Adopt",30,0,0,0,30
1984532,1509553,2025-03-10,House,"FLOOR VOTE: CONSENT CALENDAR PASSAGE ON THIRD CONSIDERATION",94,0,0,0,94
1984532,1514724,2025-03-06,Senate,"FLOOR VOTE: Motion to Adopt",32,0,0,0,32
1984652,1503872,2025-03-03,House,"FLOOR VOTE: CONSENT CALENDAR PASSAGE ON THIRD CONSIDERATION",89,0,0,0,89
1984652,1513071,2025-03-10,Senate,"FLOOR VOTE: Motion to Adopt",30,0,0,0,30
1984769,1512185,2025-03-10,House,"FLOOR VOTE: CONSENT CALENDAR PASSAGE ON THIRD CONSIDERATION",94,0,0,0,94
1984769,1515466,2025-03-06,Senate,"FLOOR VOTE: Motion to Adopt",32,0,0,0,32
1984893,1553039,2025-04-21,Senate,"FLOOR VOTE: Motion to Adopt",32,0,0,0,32
1985015,1509203,2025-03-10,House,"HOUSE PRIVATE ACTS COMMITTEE: Rec. for pass; ref to State & Local Government Committee",8,0,0,0,8
1985015,1541126,2025-04-08,House,"HOUSE STATE & LOCAL GOVERNMENT COMMITTEE: Rec. for pass; ref to Calendar & Rules Committee",19,0,2,0,21
1985015,1550132,2025-04-16,House,"FLOOR VOTE: CONSENT CALENDAR PASSAGE ON THIRD CONSIDERATION",96,0,0,0,96
1985015,1553199,2025-04-21,Senate,"FLOOR VOTE: Motion to Adopt",32,0,0,0,32
1985136,1504031,2025-03-03,House,"FLOOR VOTE: CONSENT CALENDAR PASSAGE ON THIRD CONSIDERATION",89,0,0,0,89
1985257,1519070,2025-03-17,House,"HOUSE PRIVATE ACTS COMMITTEE: Rec. for pass; ref to State & Local Government Committee",9,0,0,0,9
1985257,1541137,2025-04-08,House,"HOUSE STATE & LOCAL GOVERNMENT COMMITTEE: Rec. for pass; ref to Calendar & Rules Committee",19,0,2,0,21
1985257,1550726,2025-04-16,House,"FLOOR VOTE: CONSENT CALENDAR PASSAGE ON THIRD CONSIDERATION",96,0,0,0,96
1985257,1553180,2025-04-21,Senate,"FLOOR VOTE: Motion to Adopt",32,0,0,0,32
1985378,1504085,2025-03-03,House,"FLOOR VOTE: CONSENT CALENDAR PASSAGE ON THIRD CONSIDERATION",89,0,0,0,89
1985378,1515445,2025-03-10,Senate,"FLOOR VOTE: Motion to Adopt",30,0,0,0,30
1985507,1516069,2025-03-06,Senate,"FLOOR VOTE: Motion to Adopt",32,0,0,0,32
1985560,1509650,2025-03-10,House,"FLOOR VOTE: CONSENT CALENDAR PASSAGE ON THIRD CONSIDERATION",94,0,0,0,94
1985560,1514884,2025-03-06,Senate,"FLOOR VOTE: Motion to Adopt",32,0,0,0,32
1985722,1504097,2025-03-03,House,"FLOOR VOTE: CONSENT CALENDAR PASSAGE ON THIRD CONSIDERATION",89,0,0,0,89
1985722,1515434,2025-03-10,Senate,"FLOOR VOTE: Motion to Adopt",30,0,0,0,30
1986427,1514994,2025-03-10,Senate,"FLOOR VOTE: Motion to Adopt",30,0,0,0,30
1986427,1519156,2025-03-17,House,"FLOOR VOTE: CONSENT CALENDAR PASSAGE ON THIRD CONSIDERATION",92,0,1,0,93
1986548,1520070,2025-03-17,Senate,"SENATE JUDICIARY COMMITTEE: Recommended for adoption by Senate Judiciary Committee, refer Senate Calendar Committee",7,0,0,0,7
1986548,1553176,2025-04-21,Senate,"FLOOR VOTE: Motion to Adopt",33,0,0,0,33
1986666,1519351,2025-03-17,Senate,"SENATE JUDICIARY COMMITTEE: Recommended for adoption by Senate Judiciary Committee, refer Senate Calendar Committee",7,0,0,0,7
1986666,1553179,2025-04-21,Senate,"FLOOR VOTE: Motion to Adopt",33,0,0,0,33
1986783,1503892,2025-03-03,House,"FLOOR VOTE: CONSENT CALENDAR PASSAGE ON THIRD CONSIDERATION",89,0,0,0,89
1986783,1514710,2025-03-10,Senate,"FLOOR VOTE: Motion to Adopt",30,0,0,0,30
1987139,1518277,2025-03-06,Senate,"FLOOR VOTE: Motion to Adopt",29,0,0,0,29
1987608,1503279,2025-03-03,House,"FLOOR VOTE: CONSENT CALENDAR PASSAGE ON THIRD CONSIDERATION",89,0,0,0,89
1987608,1513102,2025-03-10,Senate,"FLOOR VOTE: Motion to Adopt",30,0,0,0,30
1988070,1553079,2025-04-21,Senate,"FLOOR VOTE: Motion to Adopt",32,0,0,0,32
1988488,1507074,2025-03-06,House,"FLOOR VOTE: CONSENT CALENDAR PASSAGE ON THIRD CONSIDERATION",91,0,1,0,92
1988488,1522153,2025-03-19,Senate,"SENATE HEALTH AND WELFARE COMMITTEE: Recommended for concurrence by Senate Health and Welfare Committee, refer Senate Calendar Committee",8,0,0,0,8
1988488,1525995,2025-03-24,Senate,"FLOOR VOTE: Motion to Adopt",32,0,0,0,32
1989334,1508051,2025-03-06,House,"FLOOR VOTE: CONSENT CALENDAR PASSAGE ON THIRD CONSIDERATION",91,0,1,0,92
1989334,1528383,2025-03-26,Senate,"SENATE ENERGY, AGRICULTURE AND NATURAL RESOURCES COMMITTEE: Recommended for concurrence by Senate Energy, Ag., and Nat. Resources Committee, refer Senate Calendar Committee",8,0,0,0,8
1989334,1531841,2025-03-31,Senate,"FLOOR VOTE: Motion to Adopt",30,0,0,0,30
1989387,1507748,2025-03-06,House,"FLOOR VOTE: CONSENT CALENDAR PASSAGE ON THIRD CONSIDERATION",91,0,1,0,92
1989387,1517533,2025-03-13,Senate,"FLOOR VOTE: Motion to Adopt",32,0,0,0,32
1989440,1519072,2025-03-17,House,"HOUSE PRIVATE ACTS COMMITTEE: Rec. for pass; ref to State & Local Government Committee",8,0,0,0,8
1989440,1528407,2025-03-26,House,"HOUSE STATE & LOCAL GOVERNMENT COMMITTEE: Rec. for pass; ref to Calendar & Rules Committee",21,1,0,0,22
1989440,1539196,2025-04-07,House,"FLOOR VOTE: REGULAR CALENDAR PASSAGE ON THIRD CONSIDERATION",94,0,0,0,94
1989440,1548561,2025-04-14,Senate,"FLOOR VOTE: Motion to Adopt",32,0,0,0,32
1989493,1507199,2025-03-06,House,"FLOOR VOTE: CONSENT CALENDAR PASSAGE ON THIRD CONSIDERATION",91,0,1,0,92
1989493,1517581,2025-03-13,Senate,"FLOOR VOTE: Motion to Adopt",32,0,0,0,32
1989541,1507887,2025-03-06,House,"FLOOR VOTE: CONSENT CALENDAR PASSAGE ON THIRD CONSIDERATION",91,0,1,0,92
1989541,1517738,2025-03-13,Senate,"FLOOR VOTE: Motion to Adopt",32,0,0,0,32
1989652,1517170,2025-03-13,Senate,"FLOOR VOTE: Motion to Adopt",32,0,0,0,32
1989652,1522935,2025-03-20,House,"FLOOR VOTE: CONSENT CALENDAR PASSAGE ON THIRD CONSIDERATION",94,0,0,0,94
1989704,1517590,2025-03-13,Senate,"FLOOR VOTE: Motion to Adopt",32,0,0,0,32
1989704,1522409,2025-03-20,House,"FLOOR VOTE: CONSENT CALENDAR PASSAGE ON THIRD CONSIDERATION",94,0,0,0,94
1989764,1517014,2025-03-13,Senate,"FLOOR VOTE: Motion to Adopt",32,0,0,0,32
1989764,1523734,2025-03-20,House,"FLOOR VOTE: CONSENT CALENDAR PASSAGE ON THIRD CONSIDERATION",94,0,0,0,94
1989818,1517548,2025-03-13,Senate,"FLOOR VOTE: Motion to Adopt",32,0,0,0,32
1989818,1523350,2025-03-20,House,"FLOOR VOTE: CONSENT CALENDAR PASSAGE ON THIRD CONSIDERATION",94,0,0,0,94
1989875,1517247,2025-03-13,Senate,"FLOOR VOTE: Motion to Adopt",32,0,0,0,32
1989875,1523293,2025-03-20,House,"FLOOR VOTE: CONSENT CALENDAR PASSAGE ON THIRD CONSIDERATION",94,0,0,0,94
1989933,1517224,2025-03-13,Senate,"FLOOR VOTE: Motion to Adopt",32,0,0,0,32
1989933,1522692,2025-03-20,House,"FLOOR VOTE: CONSENT CALENDAR PASSAGE ON THIRD CONSIDERATION",94,0,0,0,94
1989988,1509536,2025-03-10,House,"FLOOR VOTE: CONSENT CALENDAR PASSAGE ON THIRD CONSIDERATION",94,0,0,0,94
1990042,1517142,2025-03-13,Senate,"FLOOR VOTE: Motion to Adopt",32,0,0,0,32
1990042,1523205,2025-03-20,House,"FLOOR VOTE: CONSENT CALENDAR PASSAGE ON THIRD CONSIDERATION",94,0,0,0,94
1990097,1507263,2025-03-06,House,"FLOOR VOTE: CONSENT CALENDAR PASSAGE ON THIRD CONSIDERATION",91,0,1,0,92
1990097,1517523,2025-03-13,Senate,"FLOOR VOTE: Motion to Adopt",32,0,0,0,32
1990204,1517165,2025-03-13,Senate,"FLOOR VOTE: Motion to Adopt",32,0,0,0,32
1990204,1522825,2025-03-20,House,"FLOOR VOTE: CONSENT CALENDAR PASSAGE ON THIRD CONSIDERATION",94,0,0,0,94
1990302,1507943,2025-03-06,House,"FLOOR VOTE: CONSENT CALENDAR PASSAGE ON THIRD CONSIDERATION",91,0,1,0,92
1990302,1517147,2025-03-13,Senate,"FLOOR VOTE: Motion to Adopt",32,0,0,0,32
1990471,1518381,2025-03-17,House,"HOUSE PRIVATE ACTS COMMITTEE: Rec. for pass; ref to State & Local Government Committee",7,0,0,0,7
1990471,1528190,2025-03-26,House,"HOUSE STATE & LOCAL GOVERNMENT COMMITTEE: Rec. for pass; ref to Calendar & Rules Committee",21,0,0,0,21
1990471,1530949,2025-03-31,House,"FLOOR VOTE: CONSENT CALENDAR PASSAGE ON THIRD CONSIDERATION",93,0,2,0,95
1990471,1536244,2025-04-03,Senate,"FLOOR VOTE: Motion to Adopt",30,0,0,0,30
1990551,1552472,2025-04-17,Senate,"FLOOR VOTE: Motion to Adopt",33,0,0,0,33
1990631,1518986,2025-03-17,House,"HOUSE PRIVATE ACTS COMMITTEE: Rec. for pass; ref to State & Local Government Committee",10,0,0,0,10
1990631,1541112,2025-04-08,House,"HOUSE STATE & LOCAL GOVERNMENT COMMITTEE: Rec. for pass; ref to Calendar & Rules Committee",19,0,2,0,21
1990631,1547809,2025-04-14,House,"FLOOR VOTE: CONSENT CALENDAR PASSAGE ON THIRD CONSIDERATION",94,0,1,0,95
1990631,1552426,2025-04-17,Senate,"FLOOR VOTE: Motion to Adopt",33,0,0,0,33
1990713,1511851,2025-03-10,House,"FLOOR VOTE: CONSENT CALENDAR PASSAGE ON THIRD CONSIDERATION",94,0,0,0,94
1990713,1519739,2025-03-17,Senate,"FLOOR VOTE: Motion to Adopt",32,0,0,0,32
1990793,1509521,2025-03-10,House,"FLOOR VOTE: CONSENT CALENDAR PASSAGE ON THIRD CONSIDERATION",94,0,0,0,94
1990793,1520040,2025-03-17,Senate,"FLOOR VOTE: Motion to Adopt",32,0,0,0,32
1990875,1509219,2025-03-10,House,"FLOOR VOTE: CONSENT CALENDAR PASSAGE ON THIRD CONSIDERATION",94,0,0,0,94
1990875,1520075,2025-03-17,Senate,"FLOOR VOTE: Motion to Adopt",32,0,0,0,32
1990960,1532209,2025-04-01,Senate,"SENATE STATE & LOCAL GOVERNMENT COMMITTEE: Recommended for adoption by Senate State and Local Government Committee, refer Senate Calendar Committee",8,0,0,0,8
1990960,1539479,2025-04-07,Senate,"FLOOR VOTE: Motion to Adopt",31,0,0,0,31
1990983,1516980,2025-03-13,Senate,"FLOOR VOTE: Motion to Adopt",32,0,0,0,32
1990983,1522503,2025-03-20,House,"FLOOR VOTE: CONSENT CALENDAR PASSAGE ON THIRD CONSIDERATION",94,0,0,0,94
1991007,1511912,2025-03-10,House,"FLOOR VOTE: CONSENT CALENDAR PASSAGE ON THIRD CONSIDERATION",94,0,0,0,94
1991007,1526032,2025-03-25,Senate,"SENATE STATE & LOCAL GOVERNMENT COMMITTEE: Recommended for concurrence by Senate State and Local Government Committee, refer Senate Calendar Committee",9,0,0,0,9
1991057,1552461,2025-04-17,Senate,"FLOOR VOTE: Motion to Adopt",33,0,0,0,33
1991083,1525280,2025-03-24,House,"HOUSE PRIVATE ACTS COMMITTEE: Rec. for pass; ref to State & Local Government Committee",11,0,0,0,11
1991083,1540007,2025-04-08,House,"HOUSE STATE & LOCAL GOVERNMENT COMMITTEE: Rec. for pass; ref to Calendar & Rules Committee",19,0,2,0,21
1991083,1547737,2025-04-14,House,"FLOOR VOTE: CONSENT CALENDAR PASSAGE ON THIRD CONSIDERATION",94,0,1,0,95
1991083,1552460,2025-04-17,Senate,"FLOOR VOTE: Motion to Adopt",33,0,0,0,33
1991159,1511299,2025-03-10,House,"FLOOR VOTE: CONSENT CALENDAR PASSAGE ON THIRD CONSIDERATION",94,0,0,0,94
1991182,1517180,2025-03-13,Senate,"FLOOR VOTE: Motion to Adopt",32,0,0,0,32
1991182,1523206,2025-03-20,House,"FLOOR VOTE: CONSENT CALENDAR PASSAGE ON THIRD CONSIDERATION",94,0,0,0,94
1991229,1516971,2025-03-13,Senate,"FLOOR VOTE: Motion to Adopt",32,0,0,0,32
1991249,1517086,2025-03-13,Senate,"FLOOR VOTE: Motion to Adopt",32,0,0,0,32
1991269,1517129,2025-03-13,Senate,"FLOOR VOTE: Motion to Adopt",32,0,0,0,32
1991288,1517549,2025-03-13,Senate,"FLOOR VOTE: Motion to Adopt",32,0,0,0,32
1991307,1517153,2025-03-13,Senate,"FLOOR VOTE: Motion to Adopt",32,0,0,0,32
1991328,1532290,2025-04-01,Senate,"SENATE STATE & LOCAL GOVERNMENT COMMITTEE: Recommended for adoption by Senate State and Local Government Committee, refer Senate Calendar Committee",8,0,0,0,8
1991328,1539251,2025-04-07,Senate,"FLOOR VOTE: Motion to Adopt",31,0,0,0,31
1991363,1517713,2025-03-13,Senate,"FLOOR VOTE: Motion to Adopt",32,0,0,0,32
1991381,1517070,2025-03-13,Senate,"FLOOR VOTE: Motion to Adopt",32,0,0,0,32
1991403,1517176,2025-03-13,Senate,"FLOOR VOTE: Motion to Adopt",32,0,0,0,32
1991420,1513738,2025-03-10,Senate,"FLOOR VOTE: Motion to Adopt",30,0,0,0,30
1991436,1509388,2025-03-10,House,"FLOOR VOTE: CONSENT CALENDAR PASSAGE ON THIRD CONSIDERATION",94,0,0,0,94
1991609,1511980,2025-03-10,House,"FLOOR VOTE: CONSENT CALENDAR PASSAGE ON THIRD CONSIDERATION",94,0,0,0,94
1991618,1511666,2025-03-10,House,"FLOOR VOTE: CONSENT CALENDAR PASSAGE ON THIRD CONSIDERATION",94,0,0,0,94
1991630,1511762,2025-03-10,House,"FLOOR VOTE: CONSENT CALENDAR PASSAGE ON THIRD CONSIDERATION",94,0,0,0,94
1991638,1509124,2025-03-10,House,"FLOOR VOTE: CONSENT CALENDAR PASSAGE ON THIRD CONSIDERATION",94,0,0,0,94
1991650,1511727,2025-03-10,House,"FLOOR VOTE: CONSENT CALENDAR PASSAGE ON THIRD CONSIDERATION",94,0,0,0,94
1991650,1519388,2025-03-17,Senate,"FLOOR VOTE: Motion to Adopt",32,0,0,0,32
1991660,1548210,2025-04-14,Senate,"FLOOR VOTE: Motion to Adopt",32,0,0,0,32
1991671,1509207,2025-03-10,House,"FLOOR VOTE: CONSENT CALENDAR PASSAGE ON THIRD CONSIDERATION",94,0,0,0,94
1991682,1509134,2025-03-10,House,"FLOOR VOTE: CONSENT CALENDAR PASSAGE ON THIRD CONSIDERATION",94,0,0,0,94
1991692,1511746,2025-03-10,House,"FLOOR VOTE: CONSENT CALENDAR PASSAGE ON THIRD CONSIDERATION",94,0,0,0,94
1991701,1512159,2025-03-10,House,"FLOOR VOTE: CONSENT CALENDAR PASSAGE ON THIRD CONSIDERATION",94,0,0,0,94
1991713,1511812,2025-03-10,House,"FLOOR VOTE: CONSENT CALENDAR PASSAGE ON THIRD CONSIDERATION",94,0,0,0,94
1991723,1517374,2025-03-13,Senate,"FLOOR VOTE: Motion to Adopt",32,0,0,0,32
1991723,1522464,2025-03-20,House,"FLOOR VOTE: CONSENT CALENDAR PASSAGE ON THIRD CONSIDERATION",94,0,0,0,94
1991735,1512271,2025-03-10,House,"FLOOR VOTE: CONSENT CALENDAR PASSAGE ON THIRD CONSIDERATION",94,0,0,0,94
1991744,1511869,2025-03-10,House,"FLOOR VOTE: CONSENT CALENDAR PASSAGE ON THIRD CONSIDERATION",94,0,0,0,94
1991755,1509239,2025-03-10,House,"FLOOR VOTE: CONSENT CALENDAR PASSAGE ON THIRD CONSIDERATION",94,0,0,0,94
1991763,1517737,2025-03-13,Senate,"FLOOR VOTE: Motion to Adopt",32,0,0,0,32
1991763,1523155,2025-03-20,House,"FLOOR VOTE: CONSENT CALENDAR PASSAGE ON THIRD CONSIDERATION",94,0,0,0,94
1991775,1509727,2025-03-10,House,"FLOOR VOTE: CONSENT CALENDAR PASSAGE ON THIRD CONSIDERATION",94,0,0,0,94
1991785,1516978,2025-03-13,Senate,"FLOOR VOTE: Motion to Adopt",32,0,0,0,32
1991785,1523689,2025-03-20,House,"FLOOR VOTE: CONSENT CALENDAR PASSAGE ON THIRD CONSIDERATION",94,0,0,0,94
1991793,1509127,2025-03-10,House,"FLOOR VOTE: CONSENT CALENDAR PASSAGE ON THIRD CONSIDERATION",94,0,0,0,94
1991808,1517424,2025-03-13,Senate,"FLOOR VOTE: Motion to Adopt",32,0,0,0,32
1991808,1523111,2025-03-20,House,"FLOOR VOTE: CONSENT CALENDAR PASSAGE ON THIRD CONSIDERATION",94,0,0,0,94
1991818,1509730,2025-03-10,House,"FLOOR VOTE: CONSENT CALENDAR PASSAGE ON THIRD CONSIDERATION",94,0,0,0,94
1991829,1509252,2025-03-10,House,"FLOOR VOTE: CONSENT CALENDAR PASSAGE ON THIRD CONSIDERATION",94,0,0,0,94
1991838,1509738,2025-03-10,House,"FLOOR VOTE: CONSENT CALENDAR PASSAGE ON THIRD CONSIDERATION",94,0,0,0,94
1991847,1511698,2025-03-10,House,"FLOOR VOTE: CONSENT CALENDAR PASSAGE ON THIRD CONSIDERATION",94,0,0,0,94
1991856,1509296,2025-03-10,House,"FLOOR VOTE: CONSENT CALENDAR PASSAGE ON THIRD CONSIDERATION",94,0,0,0,94
1991868,1536201,2025-04-03,Senate,"FLOOR VOTE: Motion to Adopt",30,0,0,0,30
1991877,1509218,2025-03-10,House,"FLOOR VOTE: CONSENT CALENDAR PASSAGE ON THIRD CONSIDERATION",94,0,0,0,94
1991889,1511826,2025-03-10,House,"FLOOR VOTE: CONSENT CALENDAR PASSAGE ON THIRD CONSIDERATION",94,0,0,0,94
1991898,1509263,2025-03-10,House,"FLOOR VOTE: CONSENT CALENDAR PASSAGE ON THIRD CONSIDERATION",94,0,0,0,94
1991908,1509615,2025-03-10,House,"FLOOR VOTE: CONSENT CALENDAR PASSAGE ON THIRD CONSIDERATION",94,0,0,0,94
1991918,1509249,2025-03-10,House,"FLOOR VOTE: CONSENT CALENDAR PASSAGE ON THIRD CONSIDERATION",94,0,0,0,94
1991929,1509710,2025-03-10,House,"FLOOR VOTE: CONSENT CALENDAR PASSAGE ON THIRD CONSIDERATION",94,0,0,0,94
1991939,1511919,2025-03-10,House,"FLOOR VOTE: CONSENT CALENDAR PASSAGE ON THIRD CONSIDERATION",94,0,0,0,94
1991949,1511811,2025-03-10,House,"FLOOR VOTE: CONSENT CALENDAR PASSAGE ON THIRD CONSIDERATION",94,0,0,0,94
1991957,1511761,2025-03-10,House,"FLOOR VOTE: CONSENT CALENDAR PASSAGE ON THIRD CONSIDERATION",94,0,0,0,94
1991968,1509225,2025-03-10,House,"FLOOR VOTE: CONSENT CALENDAR PASSAGE ON THIRD CONSIDERATION",94,0,0,0,94
1991977,1509635,2025-03-10,House,"FLOOR VOTE: CONSENT CALENDAR PASSAGE ON THIRD CONSIDERATION",94,0,0,0,94
1991985,1512313,2025-03-10,House,"FLOOR VOTE: CONSENT CALENDAR PASSAGE ON THIRD CONSIDERATION",94,0,0,0,94
1992076,1515258,2025-03-10,Senate,"FLOOR VOTE: Motion to Concur",27,0,3,0,30
1992165,1519094,2025-03-17,House,"HOUSE PRIVATE ACTS COMMITTEE: Rec. for pass; ref to State & Local Government Committee",9,0,0,0,9
1992165,1549536,2025-04-16,House,"HOUSE STATE & LOCAL GOVERNMENT COMMITTEE: Rec. for pass. if am., ref. to Calendar & Rules Committee",16,0,0,0,16
1992165,1553595,2025-04-21,House,"FLOOR VOTE: REGULAR CALENDAR AS AMENDED PASSAGE ON THIRD CONSIDERATION",93,0,0,0,93
1992165,1556951,2025-04-22,Senate,"FLOOR VOTE: Motion to Adopt",33,0,0,0,33
1992250,1556400,2025-04-22,Senate,"FLOOR VOTE: Motion to Adopt",33,0,0,0,33
1992337,1517294,2025-03-13,Senate,"FLOOR VOTE: Motion to Adopt",32,0,0,0,32
1992337,1523732,2025-03-20,House,"FLOOR VOTE: CONSENT CALENDAR PASSAGE ON THIRD CONSIDERATION",94,0,0,0,94
1992427,1517630,2025-03-13,Senate,"FLOOR VOTE: Motion to Adopt",32,0,0,0,32
1992427,1523334,2025-03-20,House,"FLOOR VOTE: CONSENT CALENDAR PASSAGE ON THIRD CONSIDERATION",94,0,0,0,94
1992514,1517113,2025-03-13,Senate,"FLOOR VOTE: Motion to Adopt",32,0,0,0,32
1992514,1522979,2025-03-20,House,"FLOOR VOTE: CONSENT CALENDAR PASSAGE ON THIRD CONSIDERATION",94,0,0,0,94
1992601,1509129,2025-03-10,House,"FLOOR VOTE: CONSENT CALENDAR PASSAGE ON THIRD CONSIDERATION",94,0,0,0,94
1992601,1519664,2025-03-17,Senate,"FLOOR VOTE: Motion to Adopt",32,0,0,0,32
1992696,1511691,2025-03-10,House,"FLOOR VOTE: CONSENT CALENDAR PASSAGE ON THIRD CONSIDERATION",94,0,0,0,94
1992696,1519331,2025-03-17,Senate,"FLOOR VOTE: Motion to Adopt",32,0,0,0,32
1992830,1511595,2025-03-10,House,"FLOOR VOTE: CONSENT CALENDAR PASSAGE ON THIRD CONSIDERATION",94,0,0,0,94
1992830,1521223,2025-03-19,Senate,"SENATE HEALTH AND WELFARE COMMITTEE: Recommended for concurrence by Senate Health and Welfare Committee, refer Senate Calendar Committee",8,0,0,0,8
1992830,1525981,2025-03-24,Senate,"FLOOR VOTE: Motion to Adopt",32,0,0,0,32
1993118,1552775,2025-04-21,Senate,"FLOOR VOTE: Motion to Adopt",32,0,0,0,32
1993138,1509640,2025-03-10,House,"FLOOR VOTE: CONSENT CALENDAR PASSAGE ON THIRD CONSIDERATION",94,0,0,0,94
1993159,1511724,2025-03-10,House,"FLOOR VOTE: CONSENT CALENDAR PASSAGE ON THIRD CONSIDERATION",94,0,0,0,94
1993180,1525605,2025-03-24,House,"HOUSE PRIVATE ACTS COMMITTEE: Rec. for pass; ref to State & Local Government Committee",9,0,0,0,9
1993180,1541091,2025-04-08,House,"HOUSE STATE & LOCAL GOVERNMENT COMMITTEE: Rec. for pass; ref to Calendar & Rules Committee",19,0,2,0,21
1993180,1547637,2025-04-14,House,"FLOOR VOTE: CONSENT CALENDAR PASSAGE ON THIRD CONSIDERATION",94,0,1,0,95
1993180,1552626,2025-04-17,Senate,"FLOOR VOTE: Motion to Adopt",33,0,0,0,33
1993200,1511647,2025-03-10,House,"FLOOR VOTE: CONSENT CALENDAR PASSAGE ON THIRD CONSIDERATION",94,0,0,0,94
1993221,1511494,2025-03-10,House,"FLOOR VOTE: CONSENT CALENDAR PASSAGE ON THIRD CONSIDERATION",94,0,0,0,94
1993244,1511554,2025-03-10,House,"FLOOR VOTE: CONSENT CALENDAR PASSAGE ON THIRD CONSIDERATION",94,0,0,0,94
1993264,1512381,2025-03-10,House,"FLOOR VOTE: CONSENT CALENDAR PASSAGE ON THIRD CONSIDERATION",94,0,0,0,94
1993286,1511638,2025-03-10,House,"FLOOR VOTE: CONSENT CALENDAR PASSAGE ON THIRD CONSIDERATION",94,0,0,0,94
1993308,1509266,2025-03-10,House,"FLOOR VOTE: CONSENT CALENDAR PASSAGE ON THIRD CONSIDERATION",94,0,0,0,94
1993328,1509612,2025-03-10,House,"FLOOR VOTE: CONSENT CALENDAR PASSAGE ON THIRD CONSIDERATION",94,0,0,0,94
1993349,1509183,2025-03-10,House,"FLOOR VOTE: CONSENT CALENDAR PASSAGE ON THIRD CONSIDERATION",94,0,0,0,94
1993371,1509598,2025-03-10,House,"FLOOR VOTE: CONSENT CALENDAR PASSAGE ON THIRD CONSIDERATION",94,0,0,0,94
1993371,1519343,2025-03-17,Senate,"FLOOR VOTE: Motion to Adopt",32,0,0,0,32
1993390,1511662,2025-03-10,House,"FLOOR VOTE: CONSENT CALENDAR PASSAGE ON THIRD CONSIDERATION",94,0,0,0,94
1993390,1519478,2025-03-17,Senate,"FLOOR VOTE: Motion to Adopt",32,0,0,0,32
1993411,1509130,2025-03-10,House,"FLOOR VOTE: CONSENT CALENDAR PASSAGE ON THIRD CONSIDERATION",94,0,0,0,94
1993432,1509313,2025-03-10,House,"FLOOR VOTE: CONSENT CALENDAR PASSAGE ON THIRD CONSIDERATION",94,0,0,0,94
1993453,1511667,2025-03-10,House,"FLOOR VOTE: CONSENT CALENDAR PASSAGE ON THIRD CONSIDERATION",94,0,0,0,94
1993473,1511477,2025-03-10,House,"FLOOR VOTE: CONSENT CALENDAR PASSAGE ON THIRD CONSIDERATION",94,0,0,0,94
1993499,1511898,2025-03-10,House,"FLOOR VOTE: CONSENT CALENDAR PASSAGE ON THIRD CONSIDERATION",94,0,0,0,94
1993762,1538553,2025-04-07,House,"HOUSE NAMING & DESIGNATING COMMITTEE: Rec. for pass; ref to State & Local Government Committee",8,1,0,0,9
1993762,1540235,2025-04-08,House,"HOUSE STATE & LOCAL GOVERNMENT COMMITTEE: Rec. for pass; ref to Calendar & Rules Committee",23,0,0,0,23
1993762,1547734,2025-04-14,House,"FLOOR VOTE: REGULAR CALENDAR AS AMENDED MOTION TO ADOPT",91,3,0,0,94
1993762,1552631,2025-04-21,Senate,"SENATE FINANCE, WAYS AND MEANS COMMITTEE: Recommended for concurrence by Senate Finance, Ways, and Means Committee, refer Senate Calendar Committee",10,1,0,0,11
1993762,1556552,2025-04-22,Senate,"FLOOR VOTE: Motion to Concur",31,2,0,0,33
1994763,1519778,2025-03-17,Senate,"FLOOR VOTE: Motion to Adopt",32,0,0,0,32
1994832,1519455,2025-03-17,Senate,"FLOOR VOTE: Motion to Adopt",32,0,0,0,32
1994832,1525573,2025-03-24,House,"FLOOR VOTE: CONSENT CALENDAR PASSAGE ON THIRD CONSIDERATION",96,0,0,0,96
1994902,1517726,2025-03-13,House,"FLOOR VOTE: CONSENT CALENDAR PASSAGE ON THIRD CONSIDERATION",90,0,0,0,90
1994902,1523190,2025-03-20,Senate,"FLOOR VOTE: Motion to Adopt",30,0,0,0,30
1994972,1517161,2025-03-13,House,"FLOOR VOTE: CONSENT CALENDAR PASSAGE ON THIRD CONSIDERATION",90,0,0,0,90
1994972,1523796,2025-03-20,Senate,"FLOOR VOTE: Motion to Adopt",30,0,0,0,30
1995042,1517221,2025-03-13,House,"FLOOR VOTE: CONSENT CALENDAR PASSAGE ON THIRD CONSIDERATION",90,0,0,0,90
1995042,1523747,2025-03-20,Senate,"FLOOR VOTE: Motion to Adopt",30,0,0,0,30
1995110,1516936,2025-03-13,House,"FLOOR VOTE: CONSENT CALENDAR PASSAGE ON THIRD CONSIDERATION",90,0,0,0,90
1995110,1522976,2025-03-20,Senate,"FLOOR VOTE: Motion to Adopt",30,0,0,0,30
1995244,1517736,2025-03-13,House,"FLOOR VOTE: CONSENT CALENDAR PASSAGE ON THIRD CONSIDERATION",90,0,0,0,90
1995244,1523520,2025-03-20,Senate,"FLOOR VOTE: Motion to Adopt",30,0,0,0,30
1996178,1552992,2025-04-21,Senate,"FLOOR VOTE: Motion to Adopt",32,0,0,0,32
1996200,1517745,2025-03-13,House,"FLOOR VOTE: CONSENT CALENDAR PASSAGE ON THIRD CONSIDERATION",90,0,0,0,90
1996200,1540891,2025-04-08,Senate,"SENATE FINANCE, WAYS AND MEANS COMMITTEE: Recommended for concurrence by Senate Finance, Ways, and Means Committee, refer Senate Calendar Committee",10,0,0,0,10
1996200,1548074,2025-04-14,Senate,"FLOOR VOTE: Motion to Adopt",32,0,0,0,32
1996224,1525617,2025-03-24,House,"HOUSE PRIVATE ACTS COMMITTEE: Rec. for pass; ref to State & Local Government Committee",6,2,3,0,11
1996224,1534630,2025-04-02,House,"HOUSE STATE & LOCAL GOVERNMENT COMMITTEE: Def. to Summer Study in State & Local Government Committee",19,0,0,0,19
1996246,1516947,2025-03-13,House,"FLOOR VOTE: CONSENT CALENDAR PASSAGE ON THIRD CONSIDERATION",90,0,0,0,90
1996246,1528393,2025-03-26,Senate,"SENATE HEALTH AND WELFARE COMMITTEE: Recommended for concurrence by Senate Health and Welfare Committee, refer Senate Calendar Committee",7,0,0,0,7
1996246,1532564,2025-03-31,Senate,"FLOOR VOTE: Motion to Adopt",30,0,0,0,30
1996273,1525004,2025-03-24,House,"HOUSE PRIVATE ACTS COMMITTEE: Rec. for pass; ref to State & Local Government Committee",10,1,0,0,11
1996273,1541139,2025-04-08,House,"HOUSE STATE & LOCAL GOVERNMENT COMMITTEE: Rec. for pass; ref to Calendar & Rules Committee",19,0,2,0,21
1996273,1547857,2025-04-14,House,"FLOOR VOTE: CONSENT CALENDAR PASSAGE ON THIRD CONSIDERATION",94,0,1,0,95
1996273,1552395,2025-04-17,Senate,"FLOOR VOTE: Motion to Adopt",33,0,0,0,33
1996296,1530999,2025-03-31,House,"HOUSE PRIVATE ACTS COMMITTEE: Rec. for pass; ref to State & Local Government Committee",5,4,1,0,10
1996296,1541135,2025-04-08,House,"HOUSE STATE & LOCAL GOVERNMENT COMMITTEE: Rec. for pass. if am., ref. to Calendar & Rules Committee",20,2,0,0,22
1996296,1550725,2025-04-16,House,"FLOOR VOTE: REGULAR CALENDAR AS AMENDED PASSAGE ON THIRD CONSIDERATION",80,8,5,0,93
1996296,1553149,2025-04-21,Senate,"FLOOR VOTE: Motion to Adopt",32,0,0,0,32
1996320,1517082,2025-03-13,House,"FLOOR VOTE: CONSENT CALENDAR PASSAGE ON THIRD CONSIDERATION",90,0,0,0,90
1996320,1522910,2025-03-20,Senate,"FLOOR VOTE: Motion to Adopt",30,0,0,0,30
1996367,1553028,2025-04-21,Senate,"FLOOR VOTE: Motion to Adopt",32,0,0,0,32
1996391,1525683,2025-03-24,House,"HOUSE PRIVATE ACTS COMMITTEE: Rec. for pass; ref to State & Local Government Committee",9,0,0,0,9
1996391,1540787,2025-04-08,House,"HOUSE STATE & LOCAL GOVERNMENT COMMITTEE: Rec. for pass; ref to Calendar & Rules Committee",19,0,2,0,21
1996391,1550277,2025-04-16,House,"FLOOR VOTE: CONSENT CALENDAR PASSAGE ON THIRD CONSIDERATION",96,0,0,0,96
1996391,1553150,2025-04-21,Senate,"FLOOR VOTE: Motion to Adopt",32,0,0,0,32
1996414,1517434,2025-03-13,House,"FLOOR VOTE: CONSENT CALENDAR PASSAGE ON THIRD CONSIDERATION",90,0,0,0,90
1996414,1523426,2025-03-20,Senate,"FLOOR VOTE: Motion to Adopt",30,0,0,0,30
1996438,1525570,2025-03-24,House,"HOUSE PRIVATE ACTS COMMITTEE: Rec. for pass; ref to State & Local Government Committee",11,0,0,0,11
1996438,1541127,2025-04-08,House,"HOUSE STATE & LOCAL GOVERNMENT COMMITTEE: Rec. for pass; ref to Calendar & Rules Committee",19,0,2,0,21
1996438,1550134,2025-04-16,House,"FLOOR VOTE: CONSENT CALENDAR PASSAGE ON THIRD CONSIDERATION",96,0,0,0,96
1996438,1552708,2025-04-21,Senate,"FLOOR VOTE: Motion to Adopt",32,0,0,0,32
1996462,1517458,2025-03-13,House,"FLOOR VOTE: CONSENT CALENDAR PASSAGE ON THIRD CONSIDERATION",90,0,0,0,90
1996462,1523859,2025-03-20,Senate,"FLOOR VOTE: Motion to Adopt",30,0,0,0,30
1996507,1523729,2025-03-20,Senate,"FLOOR VOTE: Motion to Adopt",30,0,0,0,30
1996507,1529685,2025-03-27,House,"FLOOR VOTE: CONSENT CALENDAR PASSAGE ON THIRD CONSIDERATION",94,0,2,0,96
1996532,1517456,2025-03-13,House,"FLOOR VOTE: CONSENT CALENDAR PASSAGE ON THIRD CONSIDERATION",90,0,0,0,90
1996532,1523253,2025-03-20,Senate,"FLOOR VOTE: Motion to Adopt",30,0,0,0,30
1996554,1523181,2025-03-20,Senate,"FLOOR VOTE: Motion to Adopt",30,0,0,0,30
1996554,1528896,2025-03-27,House,"FLOOR VOTE: CONSENT CALENDAR PASSAGE ON THIRD CONSIDERATION",94,0,2,0,96
1996578,1523226,2025-03-20,Senate,"FLOOR VOTE: Motion to Adopt",30,0,0,0,30
1996578,1529157,2025-03-27,House,"FLOOR VOTE: CONSENT CALENDAR PASSAGE ON THIRD CONSIDERATION",94,0,2,0,96
1996637,1523222,2025-03-20,Senate,"FLOOR VOTE: Motion to Adopt",30,0,0,0,30
1996637,1529106,2025-03-27,House,"FLOOR VOTE: CONSENT CALENDAR PASSAGE ON THIRD CONSIDERATION",94,0,2,0,96
1996666,1523853,2025-03-20,Senate,"FLOOR VOTE: Motion to Adopt",30,0,0,0,30
1996666,1528883,2025-03-27,House,"FLOOR VOTE: CONSENT CALENDAR PASSAGE ON THIRD CONSIDERATION",94,0,2,0,96
1996726,1552567,2025-04-17,Senate,"FLOOR VOTE: Motion to Adopt",33,0,0,0,33
1996783,1552465,2025-04-17,Senate,"FLOOR VOTE: Motion to Adopt",33,0,0,0,33
1996809,1523779,2025-03-20,Senate,"FLOOR VOTE: Motion to Adopt",30,0,0,0,30
1996809,1529392,2025-03-27,House,"FLOOR VOTE: CONSENT CALENDAR PASSAGE ON THIRD CONSIDERATION",94,0,2,0,96
1999462,1525587,2025-03-24,House,"HOUSE PRIVATE ACTS COMMITTEE: Rec. for pass; ref to State & Local Government Committee",11,0,0,0,11
1999462,1541018,2025-04-08,House,"HOUSE STATE & LOCAL GOVERNMENT COMMITTEE: Rec. for pass; ref to Calendar & Rules Committee",19,0,2,0,21
1999462,1547665,2025-04-14,House,"FLOOR VOTE: CONSENT CALENDAR PASSAGE ON THIRD CONSIDERATION",94,0,1,0,95
1999462,1552489,2025-04-17,Senate,"FLOOR VOTE: Motion to Adopt",33,0,0,0,33
1999487,1552745,2025-04-21,Senate,"FLOOR VOTE: Motion to Adopt",32,0,0,0,32
1999514,1525279,2025-03-24,House,"HOUSE PRIVATE ACTS COMMITTEE: Rec. for pass; ref to State & Local Government Committee",11,0,0,0,11
1999514,1541153,2025-04-08,House,"HOUSE STATE & LOCAL GOVERNMENT COMMITTEE: Rec. for pass; ref to Calendar & Rules Committee",19,0,2,0,21
1999514,1550138,2025-04-16,House,"FLOOR VOTE: CONSENT CALENDAR PASSAGE ON THIRD CONSIDERATION",96,0,0,0,96
1999514,1552735,2025-04-21,Senate,"FLOOR VOTE: Motion to Adopt",32,0,0,0,32
1999541,1525598,2025-03-24,House,"HOUSE PRIVATE ACTS COMMITTEE: Rec. for pass; ref to State & Local Government Committee",11,0,0,0,11
1999541,1541104,2025-04-08,House,"HOUSE STATE & LOCAL GOVERNMENT COMMITTEE: Rec. for pass; ref to Calendar & Rules Committee",19,0,2,0,21
1999541,1550781,2025-04-16,House,"FLOOR VOTE: REGULAR CALENDAR PASSAGE ON THIRD CONSIDERATION",86,7,0,0,93
1999541,1552983,2025-04-21,Senate,"FLOOR VOTE: Motion to Adopt",32,0,0,0,32
1999566,1519071,2025-03-17,House,"FLOOR VOTE: CONSENT CALENDAR PASSAGE ON THIRD CONSIDERATION",92,0,1,0,93
1999566,1526347,2025-03-24,Senate,"FLOOR VOTE: Motion to Adopt",33,0,0,0,33
1999594,1552879,2025-04-21,Senate,"FLOOR VOTE: Motion to Adopt",32,0,0,0,32
1999619,1519168,2025-03-17,House,"FLOOR VOTE: CONSENT CALENDAR PASSAGE ON THIRD CONSIDERATION",92,0,1,0,93
1999619,1526491,2025-03-24,Senate,"FLOOR VOTE: Motion to Adopt",33,0,0,0,33
1999645,1539117,2025-04-07,House,"HOUSE PRIVATE ACTS COMMITTEE: Rec. for pass; ref to State & Local Government Committee",5,3,2,0,10
1999645,1549742,2025-04-16,House,"HOUSE STATE & LOCAL GOVERNMENT COMMITTEE: Failed in State & Local Government Committee",4,6,7,0,17
1999672,1523300,2025-03-20,Senate,"FLOOR VOTE: Motion to Adopt",30,0,0,0,30
1999672,1528945,2025-03-27,House,"FLOOR VOTE: CONSENT CALENDAR PASSAGE ON THIRD CONSIDERATION",94,0,2,0,96
1999695,1552733,2025-04-21,Senate,"FLOOR VOTE: Motion to Adopt",32,0,0,0,32
1999720,1525601,2025-03-24,House,"HOUSE PRIVATE ACTS COMMITTEE: Rec. for pass; ref to State & Local Government Committee",5,3,1,0,9
1999720,1543034,2025-04-09,House,"HOUSE STATE & LOCAL GOVERNMENT COMMITTEE: Rec. for pass; ref to Calendar & Rules Committee",23,0,0,0,23
1999720,1550798,2025-04-16,House,"FLOOR VOTE: REGULAR CALENDAR PASSAGE ON THIRD CONSIDERATION",77,15,3,0,95
1999720,1552773,2025-04-21,Senate,"FLOOR VOTE: Motion to Adopt",32,0,0,0,32
1999732,1523201,2025-03-20,Senate,"FLOOR VOTE: Motion to Adopt",30,0,0,0,30
1999740,1519233,2025-03-17,House,"FLOOR VOTE: CONSENT CALENDAR PASSAGE ON THIRD CONSIDERATION",92,0,1,0,93
1999740,1526289,2025-03-24,Senate,"FLOOR VOTE: Motion to Adopt",33,0,0,0,33
1999749,1519239,2025-03-17,House,"FLOOR VOTE: CONSENT CALENDAR PASSAGE ON THIRD CONSIDERATION",92,0,1,0,93
1999749,1525828,2025-03-24,Senate,"FLOOR VOTE: Motion to Adopt",33,0,0,0,33
1999760,1519266,2025-03-17,House,"FLOOR VOTE: CONSENT CALENDAR PASSAGE ON THIRD CONSIDERATION",92,0,1,0,93
1999760,1526669,2025-03-24,Senate,"FLOOR VOTE: Motion to Adopt",33,0,0,0,33
1999771,1518558,2025-03-17,House,"FLOOR VOTE: CONSENT CALENDAR PASSAGE ON THIRD CONSIDERATION",92,0,1,0,93
1999771,1526334,2025-03-24,Senate,"FLOOR VOTE: Motion to Adopt",33,0,0,0,33
1999781,1518712,2025-03-17,House,"FLOOR VOTE: CONSENT CALENDAR PASSAGE ON THIRD CONSIDERATION",92,0,1,0,93
1999781,1526654,2025-03-24,Senate,"FLOOR VOTE: Motion to Adopt",33,0,0,0,33
1999792,1523768,2025-03-20,Senate,"FLOOR VOTE: Motion to Adopt",30,0,0,0,30
1999801,1518751,2025-03-17,House,"FLOOR VOTE: CONSENT CALENDAR PASSAGE ON THIRD CONSIDERATION",92,0,1,0,93
1999801,1526603,2025-03-24,Senate,"FLOOR VOTE: Motion to Adopt",33,0,0,0,33
1999815,1519262,2025-03-17,House,"FLOOR VOTE: CONSENT CALENDAR PASSAGE ON THIRD CONSIDERATION",92,0,1,0,93
1999815,1526300,2025-03-24,Senate,"FLOOR VOTE: Motion to Adopt",33,0,0,0,33
1999825,1519271,2025-03-17,House,"FLOOR VOTE: CONSENT CALENDAR PASSAGE ON THIRD CONSIDERATION",92,0,1,0,93
1999825,1526503,2025-03-24,Senate,"FLOOR VOTE: Motion to Adopt",33,0,0,0,33
1999836,1518597,2025-03-17,House,"FLOOR VOTE: CONSENT CALENDAR PASSAGE ON THIRD CONSIDERATION",92,0,1,0,93
1999836,1526518,2025-03-24,Senate,"FLOOR VOTE: Motion to Adopt",33,0,0,0,33
1999848,1518553,2025-03-17,House,"FLOOR VOTE: CONSENT CALENDAR PASSAGE ON THIRD CONSIDERATION",92,0,1,0,93
1999848,1525924,2025-03-24,Senate,"FLOOR VOTE: Motion to Adopt",33,0,0,0,33
1999856,1519049,2025-03-17,House,"FLOOR VOTE: CONSENT CALENDAR PASSAGE ON THIRD CONSIDERATION",92,0,1,0,93
1999866,1518611,2025-03-17,House,"FLOOR VOTE: CONSENT CALENDAR PASSAGE ON THIRD CONSIDERATION",92,0,1,0,93
1999875,1518721,2025-03-17,House,"FLOOR VOTE: CONSENT CALENDAR PASSAGE ON THIRD CONSIDERATION",92,0,1,0,93
1999875,1526350,2025-03-24,Senate,"FLOOR VOTE: Motion to Adopt",33,0,0,0,33
1999890,1519160,2025-03-17,House,"FLOOR VOTE: CONSENT CALENDAR PASSAGE ON THIRD CONSIDERATION",92,0,1,0,93
1999890,1526336,2025-03-24,Senate,"FLOOR VOTE: Motion to Adopt",33,0,0,0,33
1999901,1518598,2025-03-17,House,"FLOOR VOTE: CONSENT CALENDAR PASSAGE ON THIRD CONSIDERATION",92,0,1,0,93
1999901,1526526,2025-03-24,Senate,"FLOOR VOTE: Motion to Adopt",33,0,0,0,33
1999912,1519275,2025-03-17,House,"FLOOR VOTE: CONSENT CALENDAR PASSAGE ON THIRD CONSIDERATION",92,0,1,0,93
1999912,1526086,2025-03-24,Senate,"FLOOR VOTE: Motion to Adopt",33,0,0,0,33
1999921,1519264,2025-03-17,House,"FLOOR VOTE: CONSENT CALENDAR PASSAGE ON THIRD CONSIDERATION",92,0,1,0,93
1999921,1526395,2025-03-24,Senate,"FLOOR VOTE: Motion to Adopt",33,0,0,0,33
1999933,1518601,2025-03-17,House,"FLOOR VOTE: CONSENT CALENDAR PASSAGE ON THIRD CONSIDERATION",92,0,1,0,93
1999933,1526058,2025-03-24,Senate,"FLOOR VOTE: Motion to Adopt",33,0,0,0,33
1999945,1518495,2025-03-17,House,"FLOOR VOTE: CONSENT CALENDAR PASSAGE ON THIRD CONSIDERATION",92,0,1,0,93
1999945,1525833,2025-03-24,Senate,"FLOOR VOTE: Motion to Adopt",33,0,0,0,33
1999956,1518758,2025-03-17,House,"FLOOR VOTE: CONSENT CALENDAR PASSAGE ON THIRD CONSIDERATION",92,0,1,0,93
1999956,1526574,2025-03-24,Senate,"FLOOR VOTE: Motion to Adopt",33,0,0,0,33
1999970,1518608,2025-03-17,House,"FLOOR VOTE: CONSENT CALENDAR PASSAGE ON THIRD CONSIDERATION",92,0,1,0,93
1999970,1526001,2025-03-24,Senate,"FLOOR VOTE: Motion to Adopt",33,0,0,0,33
1999978,1523842,2025-03-20,Senate,"FLOOR VOTE: Motion to Adopt",30,0,0,0,30
1999988,1518820,2025-03-17,House,"FLOOR VOTE: CONSENT CALENDAR PASSAGE ON THIRD CONSIDERATION",92,0,1,0,93
1999988,1526602,2025-03-24,Senate,"FLOOR VOTE: Motion to Adopt",33,0,0,0,33
2000000,1519173,2025-03-17,House,"FLOOR VOTE: CONSENT CALENDAR PASSAGE ON THIRD CONSIDERATION",92,0,1,0,93
2000000,1526413,2025-03-24,Senate,"FLOOR VOTE: Motion to Adopt",33,0,0,0,33
2000010,1518775,2025-03-17,House,"FLOOR VOTE: CONSENT CALENDAR PASSAGE ON THIRD CONSIDERATION",92,0,1,0,93
2000010,1526007,2025-03-24,Senate,"FLOOR VOTE: Motion to Adopt",33,0,0,0,33
2000020,1523781,2025-03-20,Senate,"FLOOR VOTE: Motion to Adopt",30,0,0,0,30
2000030,1519210,2025-03-17,House,"FLOOR VOTE: CONSENT CALENDAR PASSAGE ON THIRD CONSIDERATION",92,0,1,0,93
2000030,1526557,2025-03-24,Senate,"FLOOR VOTE: Motion to Adopt",33,0,0,0,33
2000046,1519261,2025-03-17,House,"FLOOR VOTE: CONSENT CALENDAR PASSAGE ON THIRD CONSIDERATION",92,0,1,0,93
2000046,1526555,2025-03-24,Senate,"FLOOR VOTE: Motion to Adopt",33,0,0,0,33
2000845,1519658,2025-03-17,Senate,"FLOOR VOTE: Motion to Adopt",32,0,0,0,32
2001220,1523739,2025-03-20,Senate,"FLOOR VOTE: Motion to Adopt",30,0,0,0,30
2001220,1529683,2025-03-27,House,"FLOOR VOTE: CONSENT CALENDAR PASSAGE ON THIRD CONSIDERATION",94,0,2,0,96
2001596,1528802,2025-03-26,Senate,"SENATE EDUCATION COMMITTEE: Recommended for adoption by Senate Education Committee, refer Senate Calendar Committee",9,0,0,0,9
2001596,1535944,2025-04-03,Senate,"FLOOR VOTE: Motion to Adopt",30,0,0,0,30
2001973,1519258,2025-03-17,House,"FLOOR VOTE: CONSENT CALENDAR PASSAGE ON THIRD CONSIDERATION",92,0,1,0,93
2001973,1526251,2025-03-24,Senate,"FLOOR VOTE: Motion to Adopt",33,0,0,0,33
2002346,1519100,2025-03-17,House,"FLOOR VOTE: CONSENT CALENDAR PASSAGE ON THIRD CONSIDERATION",92,0,1,0,93
2002346,1526437,2025-03-24,Senate,"FLOOR VOTE: Motion to Adopt",33,0,0,0,33
2002721,1528411,2025-03-26,Senate,"SENATE HEALTH AND WELFARE COMMITTEE: Recommended for adoption by Senate Health and Welfare Committee, refer Senate Calendar Committee",7,0,0,0,7
2002721,1536377,2025-04-03,Senate,"FLOOR VOTE: Motion to Adopt",30,0,0,0,30
2003095,1523813,2025-03-20,Senate,"FLOOR VOTE: Motion to Adopt",30,0,0,0,30
2003095,1528813,2025-03-27,House,"FLOOR VOTE: CONSENT CALENDAR PASSAGE ON THIRD CONSIDERATION",94,0,2,0,96
2003472,1526094,2025-03-25,Senate,"SENATE STATE & LOCAL GOVERNMENT COMMITTEE: Recommended for adoption by Senate State and Local Government Committee, refer Senate Calendar Committee",9,0,0,0,9
2003472,1536095,2025-04-03,Senate,"FLOOR VOTE: Motion to Adopt",30,0,0,0,30
2003846,1527083,2025-03-25,Senate,"SENATE STATE & LOCAL GOVERNMENT COMMITTEE: Recommended for adoption by Senate State and Local Government Committee, refer Senate Calendar Committee",9,0,0,0,9
2003846,1535933,2025-04-03,Senate,"FLOOR VOTE: Motion to Adopt",30,0,0,0,30
2004221,1518633,2025-03-17,House,"FLOOR VOTE: CONSENT CALENDAR PASSAGE ON THIRD CONSIDERATION",92,0,1,0,93
2004221,1526160,2025-03-24,Senate,"FLOOR VOTE: Motion to Adopt",33,0,0,0,33
2004594,1523593,2025-03-20,Senate,"FLOOR VOTE: Motion to Adopt",30,0,0,0,30
2004594,1529687,2025-03-27,House,"FLOOR VOTE: CONSENT CALENDAR PASSAGE ON THIRD CONSIDERATION",94,0,2,0,96
2004684,1518658,2025-03-17,House,"FLOOR VOTE: CONSENT CALENDAR PASSAGE ON THIRD CONSIDERATION",92,0,1,0,93
2004684,1525832,2025-03-24,Senate,"FLOOR VOTE: Motion to Adopt",33,0,0,0,33
2004772,1523623,2025-03-20,Senate,"FLOOR VOTE: Motion to Adopt",30,0,0,0,30
2004772,1529681,2025-03-27,House,"FLOOR VOTE: CONSENT CALENDAR PASSAGE ON THIRD CONSIDERATION",94,0,2,0,96
2004856,1519272,2025-03-17,House,"FLOOR VOTE: CONSENT CALENDAR PASSAGE ON THIRD CONSIDERATION",92,0,1,0,93
2004944,1519253,2025-03-17,House,"FLOOR VOTE: CONSENT CALENDAR PASSAGE ON THIRD CONSIDERATION",92,0,1,0,93
2004944,1525755,2025-03-24,Senate,"FLOOR VOTE: Motion to Adopt",33,0,0,0,33
2005034,1519122,2025-03-17,House,"FLOOR VOTE: CONSENT CALENDAR PASSAGE ON THIRD CONSIDERATION",92,0,1,0,93
2005034,1525941,2025-03-24,Senate,"FLOOR VOTE: Motion to Adopt",33,0,0,0,33
2005116,1519268,2025-03-17,House,"FLOOR VOTE: CONSENT CALENDAR PASSAGE ON THIRD CONSIDERATION",92,0,1,0,93
2005116,1525805,2025-03-24,Senate,"FLOOR VOTE: Motion to Adopt",33,0,0,0,33
2005200,1518771,2025-03-17,House,"FLOOR VOTE: CONSENT CALENDAR PASSAGE ON THIRD CONSIDERATION",92,0,1,0,93
2005200,1525749,2025-03-24,Senate,"FLOOR VOTE: Motion to Adopt",33,0,0,0,33
2005290,1523487,2025-03-20,Senate,"FLOOR VOTE: Motion to Adopt",30,0,0,0,30
2005290,1529665,2025-03-27,House,"FLOOR VOTE: CONSENT CALENDAR PASSAGE ON THIRD CONSIDERATION",94,0,2,0,96
2005375,1552452,2025-04-17,Senate,"FLOOR VOTE: Motion to Adopt",33,0,0,0,33
2005455,1518583,2025-03-17,House,"FLOOR VOTE: CONSENT CALENDAR PASSAGE ON THIRD CONSIDERATION",92,0,1,0,93
2005455,1526493,2025-03-24,Senate,"FLOOR VOTE: Motion to Adopt",33,0,0,0,33
2005692,1519159,2025-03-17,House,"FLOOR VOTE: CONSENT CALENDAR PASSAGE ON THIRD CONSIDERATION",92,0,1,0,93
2005692,1526521,2025-03-24,Senate,"FLOOR VOTE: Motion to Adopt",33,0,0,0,33
2005788,1525967,2025-03-24,Senate,"FLOOR VOTE: Motion to Adopt",33,0,0,0,33
2005788,1530903,2025-03-31,House,"FLOOR VOTE: CONSENT CALENDAR PASSAGE ON THIRD CONSIDERATION",93,0,2,0,95
2005882,1519183,2025-03-17,House,"FLOOR VOTE: CONSENT CALENDAR PASSAGE ON THIRD CONSIDERATION",92,0,1,0,93
2005882,1526587,2025-03-24,Senate,"FLOOR VOTE: Motion to Adopt",33,0,0,0,33
2005972,1531035,2025-03-31,House,"HOUSE PRIVATE ACTS COMMITTEE: Rec. for pass; ref to State & Local Government Committee",10,0,0,0,10
2005972,1541095,2025-04-08,House,"HOUSE STATE & LOCAL GOVERNMENT COMMITTEE: Rec. for pass; ref to Calendar & Rules Committee",21,0,0,0,21
2005972,1547456,2025-04-14,House,"FLOOR VOTE: CONSENT CALENDAR PASSAGE ON THIRD CONSIDERATION",94,0,1,0,95
2005972,1552440,2025-04-17,Senate,"FLOOR VOTE: Motion to Adopt",33,0,0,0,33
2006019,1525778,2025-03-24,Senate,"FLOOR VOTE: Motion to Adopt",33,0,0,0,33
2006056,1519172,2025-03-17,House,"FLOOR VOTE: CONSENT CALENDAR PASSAGE ON THIRD CONSIDERATION",92,0,1,0,93
2006056,1526036,2025-03-24,Senate,"FLOOR VOTE: Motion to Adopt",33,0,0,0,33
2006094,1518737,2025-03-17,House,"FLOOR VOTE: CONSENT CALENDAR PASSAGE ON THIRD CONSIDERATION",92,0,1,0,93
2006094,1526544,2025-03-24,Senate,"FLOOR VOTE: Motion to Adopt",33,0,0,0,33
2006134,1526294,2025-03-24,Senate,"FLOOR VOTE: Motion to Adopt",33,0,0,0,33
2006134,1531026,2025-03-31,House,"FLOOR VOTE: CONSENT CALENDAR PASSAGE ON THIRD CONSIDERATION",93,0,2,0,95
2006172,1518722,2025-03-17,House,"FLOOR VOTE: CONSENT CALENDAR PASSAGE ON THIRD CONSIDERATION",92,0,1,0,93
2006172,1526457,2025-03-24,Senate,"FLOOR VOTE: Motion to Adopt",33,0,0,0,33
2006211,1526397,2025-03-24,Senate,"FLOOR VOTE: Motion to Adopt",33,0,0,0,33
2006250,1525887,2025-03-24,Senate,"FLOOR VOTE: Motion to Adopt",33,0,0,0,33
2006250,1531708,2025-03-31,House,"FLOOR VOTE: CONSENT CALENDAR PASSAGE ON THIRD CONSIDERATION",93,0,2,0,95
2006290,1526230,2025-03-24,Senate,"FLOOR VOTE: Motion to Adopt",33,0,0,0,33
2006290,1530981,2025-03-31,House,"FLOOR VOTE: CONSENT CALENDAR PASSAGE ON THIRD CONSIDERATION",93,0,2,0,95
2006326,1519141,2025-03-17,House,"FLOOR VOTE: CONSENT CALENDAR PASSAGE ON THIRD CONSIDERATION",92,0,1,0,93
2006326,1526287,2025-03-24,Senate,"FLOOR VOTE: Motion to Adopt",33,0,0,0,33
2006365,1525758,2025-03-24,Senate,"FLOOR VOTE: Motion to Adopt",33,0,0,0,33
2006365,1530921,2025-03-31,House,"FLOOR VOTE: CONSENT CALENDAR PASSAGE ON THIRD CONSIDERATION",93,0,2,0,95
2006406,1518734,2025-03-17,House,"FLOOR VOTE: CONSENT CALENDAR PASSAGE ON THIRD CONSIDERATION",92,0,1,0,93
2006406,1530980,2025-03-31,House,"FLOOR VOTE: MOTION TO ADOPT",90,1,0,0,91
2006406,1539238,2025-04-07,Senate,"FLOOR VOTE: Motion to Adopt",32,0,0,0,32
2006445,1518699,2025-03-17,House,"FLOOR VOTE: CONSENT CALENDAR PASSAGE ON THIRD CONSIDERATION",92,0,1,0,93
2006445,1531074,2025-03-31,House,"FLOOR VOTE: MOTION TO ADOPT",93,0,0,0,93
2006445,1539812,2025-04-07,Senate,"FLOOR VOTE: Motion to Adopt",32,0,0,0,32
2006484,1552429,2025-04-17,Senate,"FLOOR VOTE: Motion to Adopt",33,0,0,0,33
2006522,1526356,2025-03-24,Senate,"FLOOR VOTE: Motion to Adopt",33,0,0,0,33
2006522,1530946,2025-03-31,House,"FLOOR VOTE: CONSENT CALENDAR PASSAGE ON THIRD CONSIDERATION",93,0,2,0,95
2006559,1519177,2025-03-17,House,"FLOOR VOTE: CONSENT CALENDAR PASSAGE ON THIRD CONSIDERATION",92,0,1,0,93
2006559,1526370,2025-03-24,Senate,"FLOOR VOTE: Motion to Adopt",33,0,0,0,33
2006594,1525754,2025-03-24,Senate,"FLOOR VOTE: Motion to Adopt",33,0,0,0,33
2006594,1531024,2025-03-31,House,"FLOOR VOTE: CONSENT CALENDAR PASSAGE ON THIRD CONSIDERATION",93,0,2,0,95
2007584,1526547,2025-03-24,Senate,"FLOOR VOTE: Motion to Adopt",33,0,0,0,33
2008678,1523232,2025-03-20,House,"FLOOR VOTE: CONSENT CALENDAR PASSAGE ON THIRD CONSIDERATION",94,0,0,0,94
2008678,1529506,2025-03-27,Senate,"FLOOR VOTE: Motion to Adopt",29,0,0,0,29
2008692,1528885,2025-03-27,Senate,"FLOOR VOTE: Motion to Adopt",29,0,0,0,29
2008692,1536233,2025-04-03,House,"FLOOR VOTE: CONSENT CALENDAR PASSAGE ON THIRD CONSIDERATION",91,0,0,0,91
2008700,1528593,2025-03-27,Senate,"FLOOR VOTE: Motion to Adopt",29,0,0,0,29
2008700,1536543,2025-04-03,House,"FLOOR VOTE: CONSENT CALENDAR PASSAGE ON THIRD CONSIDERATION",91,0,0,0,91
2008712,1528766,2025-03-27,Senate,"FLOOR VOTE: Motion to Adopt",29,0,0,0,29
2008712,1535968,2025-04-03,House,"FLOOR VOTE: CONSENT CALENDAR PASSAGE ON THIRD CONSIDERATION",91,0,0,0,91
2008719,1528859,2025-03-27,Senate,"FLOOR VOTE: Motion to Adopt",29,0,0,0,29
2008719,1536063,2025-04-03,House,"FLOOR VOTE: CONSENT CALENDAR PASSAGE ON THIRD CONSIDERATION",91,0,0,0,91
2008729,1529377,2025-03-27,Senate,"FLOOR VOTE: Motion to Adopt",29,0,0,0,29
2008729,1536144,2025-04-03,House,"FLOOR VOTE: CONSENT CALENDAR PASSAGE ON THIRD CONSIDERATION",91,0,0,0,91
2008737,1523171,2025-03-20,House,"FLOOR VOTE: CONSENT CALENDAR PASSAGE ON THIRD CONSIDERATION",94,0,0,0,94
2008737,1528901,2025-03-27,Senate,"FLOOR VOTE: Motion to Adopt",29,0,0,0,29
2008747,1523733,2025-03-20,House,"FLOOR VOTE: CONSENT CALENDAR PASSAGE ON THIRD CONSIDERATION",94,0,0,0,94
2008747,1528752,2025-03-27,Senate,"FLOOR VOTE: Motion to Adopt",29,0,0,0,29
2008759,1529428,2025-03-27,Senate,"FLOOR VOTE: Motion to Adopt",29,0,0,0,29
2008759,1536375,2025-04-03,House,"FLOOR VOTE: CONSENT CALENDAR PASSAGE ON THIRD CONSIDERATION",91,0,0,0,91
2008767,1528864,2025-03-27,Senate,"FLOOR VOTE: Motion to Adopt",29,0,0,0,29
2008767,1536359,2025-04-03,House,"FLOOR VOTE: CONSENT CALENDAR PASSAGE ON THIRD CONSIDERATION",91,0,0,0,91
2008777,1528782,2025-03-27,Senate,"FLOOR VOTE: Motion to Adopt",29,0,0,0,29
2008777,1536154,2025-04-03,House,"FLOOR VOTE: CONSENT CALENDAR PASSAGE ON THIRD CONSIDERATION",91,0,0,0,91
2008785,1528851,2025-03-27,Senate,"FLOOR VOTE: Motion to Adopt",29,0,0,0,29
2008785,1535738,2025-04-03,House,"FLOOR VOTE: CONSENT CALENDAR PASSAGE ON THIRD CONSIDERATION",91,0,0,0,91
2008793,1528880,2025-03-27,Senate,"FLOOR VOTE: Motion to Adopt",29,0,0,0,29
2008793,1536317,2025-04-03,House,"FLOOR VOTE: CONSENT CALENDAR PASSAGE ON THIRD CONSIDERATION",91,0,0,0,91
2008804,1528911,2025-03-27,Senate,"FLOOR VOTE: Motion to Adopt",29,0,0,0,29
2008804,1535833,2025-04-03,House,"FLOOR VOTE: CONSENT CALENDAR PASSAGE ON THIRD CONSIDERATION",91,0,0,0,91
2008812,1529369,2025-03-27,Senate,"FLOOR VOTE: Motion to Adopt",29,0,0,0,29
2008812,1536507,2025-04-03,House,"FLOOR VOTE: CONSENT CALENDAR PASSAGE ON THIRD CONSIDERATION",91,0,0,0,91
2008821,1523605,2025-03-20,House,"FLOOR VOTE: CONSENT CALENDAR PASSAGE ON THIRD CONSIDERATION",94,0,0,0,94
2008821,1529032,2025-03-27,Senate,"FLOOR VOTE: Motion to Adopt",29,0,0,0,29
2008830,1528589,2025-03-27,Senate,"FLOOR VOTE: Motion to Adopt",29,0,0,0,29
2008830,1536682,2025-04-03,House,"FLOOR VOTE: CONSENT CALENDAR PASSAGE ON THIRD CONSIDERATION",91,0,0,0,91
2008838,1529431,2025-03-27,Senate,"FLOOR VOTE: Motion to Adopt",29,0,0,0,29
2008838,1536462,2025-04-03,House,"FLOOR VOTE: CONSENT CALENDAR PASSAGE ON THIRD CONSIDERATION",91,0,0,0,91
2008849,1522415,2025-03-20,House,"FLOOR VOTE: CONSENT CALENDAR PASSAGE ON THIRD CONSIDERATION",94,0,0,0,94
2008849,1528595,2025-03-27,Senate,"FLOOR VOTE: Motion to Adopt",29,0,0,0,29
2008857,1528985,2025-03-27,Senate,"FLOOR VOTE: Motion to Adopt",29,0,0,0,29
2008857,1536033,2025-04-03,House,"FLOOR VOTE: CONSENT CALENDAR PASSAGE ON THIRD CONSIDERATION",91,0,0,0,91
2008866,1528872,2025-03-27,Senate,"FLOOR VOTE: Motion to Adopt",29,0,0,0,29
2008866,1536115,2025-04-03,House,"FLOOR VOTE: CONSENT CALENDAR PASSAGE ON THIRD CONSIDERATION",91,0,0,0,91
2008881,1523603,2025-03-20,House,"FLOOR VOTE: CONSENT CALENDAR PASSAGE ON THIRD CONSIDERATION",94,0,0,0,94
2008881,1528884,2025-03-27,Senate,"FLOOR VOTE: Motion to Adopt",29,0,0,0,29
2008892,1528970,2025-03-27,Senate,"FLOOR VOTE: Motion to Adopt",29,0,0,0,29
2008892,1536257,2025-04-03,House,"FLOOR VOTE: CONSENT CALENDAR PASSAGE ON THIRD CONSIDERATION",91,0,0,0,91
2008913,1528963,2025-03-27,Senate,"FLOOR VOTE: Motion to Adopt",29,0,0,0,29
2008913,1535711,2025-04-03,House,"FLOOR VOTE: CONSENT CALENDAR PASSAGE ON THIRD CONSIDERATION",91,0,0,0,91
2008922,1529071,2025-03-27,Senate,"FLOOR VOTE: Motion to Adopt",29,0,0,0,29
2008922,1536500,2025-04-03,House,"FLOOR VOTE: CONSENT CALENDAR PASSAGE ON THIRD CONSIDERATION",91,0,0,0,91
2008930,1529235,2025-03-27,Senate,"FLOOR VOTE: Motion to Adopt",29,0,0,0,29
2008930,1536060,2025-04-03,House,"FLOOR VOTE: CONSENT CALENDAR PASSAGE ON THIRD CONSIDERATION",91,0,0,0,91
2008936,1528631,2025-03-27,Senate,"FLOOR VOTE: Motion to Adopt",29,0,0,0,29
2008936,1536353,2025-04-03,House,"FLOOR VOTE: CONSENT CALENDAR PASSAGE ON THIRD CONSIDERATION",91,0,0,0,91
2009021,1523664,2025-03-20,House,"FLOOR VOTE: CONSENT CALENDAR PASSAGE ON THIRD CONSIDERATION",94,0,0,0,94
2009021,1528897,2025-03-27,Senate,"FLOOR VOTE: Motion to Adopt",29,0,0,0,29
2009097,1523634,2025-03-20,House,"FLOOR VOTE: CONSENT CALENDAR PASSAGE ON THIRD CONSIDERATION",94,0,0,0,94
2009097,1529274,2025-03-27,Senate,"FLOOR VOTE: Motion to Adopt",29,0,0,0,29
2009170,1523685,2025-03-20,House,"FLOOR VOTE: CONSENT CALENDAR PASSAGE ON THIRD CONSIDERATION",94,0,0,0,94
2009170,1529381,2025-03-27,Senate,"FLOOR VOTE: Motion to Adopt",29,0,0,0,29
2009246,1523379,2025-03-20,Senate,"FLOOR VOTE: Motion to Adopt",31,0,0,0,31
2009319,1529376,2025-03-27,Senate,"FLOOR VOTE: Motion to Adopt",29,0,0,0,29
2009319,1536724,2025-04-03,House,"FLOOR VOTE: CONSENT CALENDAR PASSAGE ON THIRD CONSIDERATION",91,0,0,0,91
2009399,1528717,2025-03-27,Senate,"FLOOR VOTE: Motion to Adopt",29,0,0,0,29
2009399,1535902,2025-04-03,House,"FLOOR VOTE: CONSENT CALENDAR PASSAGE ON THIRD CONSIDERATION",91,0,0,0,91
2009461,1523295,2025-03-20,House,"FLOOR VOTE: CONSENT CALENDAR PASSAGE ON THIRD CONSIDERATION",94,0,0,0,94
2009461,1529276,2025-03-27,Senate,"FLOOR VOTE: Motion to Adopt",29,0,0,0,29
2009527,1528944,2025-03-27,Senate,"FLOOR VOTE: Motion to Adopt",29,0,0,0,29
2009527,1536393,2025-04-03,House,"FLOOR VOTE: CONSENT CALENDAR PASSAGE ON THIRD CONSIDERATION",91,0,0,0,91
2009666,1528661,2025-03-27,Senate,"FLOOR VOTE: Motion to Adopt",29,0,0,0,29
2009666,1535898,2025-04-03,House,"FLOOR VOTE: CONSENT CALENDAR PASSAGE ON THIRD CONSIDERATION",91,0,0,0,91
2009670,1525179,2025-03-24,House,"FLOOR VOTE: CONSENT CALENDAR PASSAGE ON THIRD CONSIDERATION",96,0,0,0,96
2009670,1532880,2025-03-31,Senate,"FLOOR VOTE: Motion to Adopt",30,0,0,0,30
2009674,1529022,2025-03-27,Senate,"FLOOR VOTE: Motion to Adopt",29,0,0,0,29
2009674,1536179,2025-04-03,House,"FLOOR VOTE: CONSENT CALENDAR PASSAGE ON THIRD CONSIDERATION",91,0,0,0,91
2009678,1529468,2025-03-27,Senate,"FLOOR VOTE: Motion to Adopt",29,0,0,0,29
2009678,1535689,2025-04-03,House,"FLOOR VOTE: CONSENT CALENDAR PASSAGE ON THIRD CONSIDERATION",91,0,0,0,91
2009683,1528816,2025-03-27,Senate,"FLOOR VOTE: Motion to Adopt",29,0,0,0,29
2009683,1536147,2025-04-03,House,"FLOOR VOTE: CONSENT CALENDAR PASSAGE ON THIRD CONSIDERATION",91,0,0,0,91
2009687,1528745,2025-03-27,Senate,"FLOOR VOTE: Motion to Adopt",29,0,0,0,29
2009690,1528921,2025-03-27,Senate,"FLOOR VOTE: Motion to Adopt",29,0,0,0,29
2009690,1536197,2025-04-03,House,"FLOOR VOTE: CONSENT CALENDAR PASSAGE ON THIRD CONSIDERATION",91,0,0,0,91
2009696,1525303,2025-03-24,House,"FLOOR VOTE: CONSENT CALENDAR PASSAGE ON THIRD CONSIDERATION",96,0,0,0,96
2009696,1532605,2025-03-31,Senate,"FLOOR VOTE: Motion to Adopt",30,0,0,0,30
2009699,1528794,2025-03-27,Senate,"FLOOR VOTE: Motion to Adopt",29,0,0,0,29
2009699,1536142,2025-04-03,House,"FLOOR VOTE: CONSENT CALENDAR PASSAGE ON THIRD CONSIDERATION",91,0,0,0,91
2009703,1529086,2025-03-27,Senate,"FLOOR VOTE: Motion to Adopt",29,0,0,0,29
2009703,1536415,2025-04-03,House,"FLOOR VOTE: CONSENT CALENDAR PASSAGE ON THIRD CONSIDERATION",91,0,0,0,91
2009706,1525531,2025-03-24,House,"FLOOR VOTE: CONSENT CALENDAR PASSAGE ON THIRD CONSIDERATION",96,0,0,0,96
2009706,1531876,2025-03-31,Senate,"FLOOR VOTE: Motion to Adopt",30,0,0,0,30
2009710,1525696,2025-03-24,House,"FLOOR VOTE: CONSENT CALENDAR PASSAGE ON THIRD CONSIDERATION",96,0,0,0,96
2009710,1532296,2025-03-31,Senate,"FLOOR VOTE: Motion to Adopt",30,0,0,0,30
2009715,1525352,2025-03-24,House,"FLOOR VOTE: CONSENT CALENDAR PASSAGE ON THIRD CONSIDERATION",96,0,0,0,96
2009715,1532166,2025-03-31,Senate,"FLOOR VOTE: Motion to Adopt",30,0,0,0,30
2009718,1528733,2025-03-27,Senate,"FLOOR VOTE: Motion to Adopt",29,0,0,0,29
2009718,1536075,2025-04-03,House,"FLOOR VOTE: CONSENT CALENDAR PASSAGE ON THIRD CONSIDERATION",91,0,0,0,91
2009722,1528675,2025-03-27,Senate,"FLOOR VOTE: Motion to Adopt",29,0,0,0,29
2009722,1536135,2025-04-03,House,"FLOOR VOTE: CONSENT CALENDAR PASSAGE ON THIRD CONSIDERATION",91,0,0,0,91
2009729,1529113,2025-03-27,Senate,"FLOOR VOTE: Motion to Adopt",29,0,0,0,29
2009729,1536425,2025-04-03,House,"FLOOR VOTE: CONSENT CALENDAR PASSAGE ON THIRD CONSIDERATION",91,0,0,0,91
2009733,1525191,2025-03-24,House,"FLOOR VOTE: CONSENT CALENDAR PASSAGE ON THIRD CONSIDERATION",96,0,0,0,96
2009733,1532355,2025-03-31,Senate,"FLOOR VOTE: Motion to Adopt",30,0,0,0,30
2009736,1525589,2025-03-24,House,"FLOOR VOTE: CONSENT CALENDAR PASSAGE ON THIRD CONSIDERATION",96,0,0,0,96
2009736,1532179,2025-03-31,Senate,"FLOOR VOTE: Motion to Adopt",30,0,0,0,30
2009740,1525250,2025-03-24,House,"FLOOR VOTE: CONSENT CALENDAR PASSAGE ON THIRD CONSIDERATION",96,0,0,0,96
2009740,1532078,2025-03-31,Senate,"FLOOR VOTE: Motion to Adopt",30,0,0,0,30
2009746,1525389,2025-03-24,House,"FLOOR VOTE: CONSENT CALENDAR PASSAGE ON THIRD CONSIDERATION",96,0,0,0,96
2009746,1531794,2025-03-31,Senate,"FLOOR VOTE: Motion to Adopt",30,0,0,0,30
2009749,1529194,2025-03-27,Senate,"FLOOR VOTE: Motion to Adopt",29,0,0,0,29
2009749,1536195,2025-04-03,House,"FLOOR VOTE: CONSENT CALENDAR PASSAGE ON THIRD CONSIDERATION",91,0,0,0,91
2009752,1525346,2025-03-24,House,"FLOOR VOTE: CONSENT CALENDAR PASSAGE ON THIRD CONSIDERATION",96,0,0,0,96
2009752,1532326,2025-03-31,Senate,"FLOOR VOTE: Motion to Adopt",30,0,0,0,30
2009755,1525684,2025-03-24,House,"FLOOR VOTE: CONSENT CALENDAR PASSAGE ON THIRD CONSIDERATION",96,0,0,0,96
2009755,1532987,2025-03-31,Senate,"FLOOR VOTE: Motion to Adopt",30,0,0,0,30
2009762,1529111,2025-03-27,Senate,"FLOOR VOTE: Motion to Adopt",29,0,0,0,29
2009762,1535753,2025-04-03,House,"FLOOR VOTE: CONSENT CALENDAR PASSAGE ON THIRD CONSIDERATION",91,0,0,0,91
2009765,1528769,2025-03-27,Senate,"FLOOR VOTE: Motion to Adopt",29,0,0,0,29
2009765,1536067,2025-04-03,House,"FLOOR VOTE: CONSENT CALENDAR PASSAGE ON THIRD CONSIDERATION",91,0,0,0,91
2009770,1529350,2025-03-27,Senate,"FLOOR VOTE: Motion to Adopt",29,0,0,0,29
2009770,1536140,2025-04-03,House,"FLOOR VOTE: CONSENT CALENDAR PASSAGE ON THIRD CONSIDERATION",91,0,0,0,91
2009775,1529087,2025-03-27,Senate,"FLOOR VOTE: Motion to Adopt",29,0,0,0,29
2009775,1536309,2025-04-03,House,"FLOOR VOTE: CONSENT CALENDAR PASSAGE ON THIRD CONSIDERATION",91,0,0,0,91
2009779,1529079,2025-03-27,Senate,"FLOOR VOTE: Motion to Adopt",29,0,0,0,29
2009779,1536131,2025-04-03,House,"FLOOR VOTE: CONSENT CALENDAR PASSAGE ON THIRD CONSIDERATION",91,0,0,0,91
2009784,1529440,2025-03-27,Senate,"FLOOR VOTE: Motion to Adopt",29,0,0,0,29
2009784,1536555,2025-04-03,House,"FLOOR VOTE: CONSENT CALENDAR PASSAGE ON THIRD CONSIDERATION",91,0,0,0,91
2009788,1525058,2025-03-24,House,"FLOOR VOTE: CONSENT CALENDAR PASSAGE ON THIRD CONSIDERATION",96,0,0,0,96
2009788,1532682,2025-03-31,Senate,"FLOOR VOTE: Motion to Adopt",30,0,0,0,30
2009791,1525126,2025-03-24,House,"FLOOR VOTE: CONSENT CALENDAR PASSAGE ON THIRD CONSIDERATION",96,0,0,0,96
2009791,1532030,2025-03-31,Senate,"FLOOR VOTE: Motion to Adopt",30,0,0,0,30
2009800,1525502,2025-03-24,House,"FLOOR VOTE: CONSENT CALENDAR PASSAGE ON THIRD CONSIDERATION",96,0,0,0,96
2009800,1531863,2025-03-31,Senate,"FLOOR VOTE: Motion to Adopt",30,0,0,0,30
2009804,1525195,2025-03-24,House,"FLOOR VOTE: CONSENT CALENDAR PASSAGE ON THIRD CONSIDERATION",96,0,0,0,96
2009804,1533003,2025-03-31,Senate,"FLOOR VOTE: Motion to Adopt",30,0,0,0,30
2009808,1529136,2025-03-27,Senate,"FLOOR VOTE: Motion to Adopt",29,0,0,0,29
2009808,1536040,2025-04-03,House,"FLOOR VOTE: CONSENT CALENDAR PASSAGE ON THIRD CONSIDERATION",91,0,0,0,91
2009812,1528918,2025-03-27,Senate,"FLOOR VOTE: Motion to Adopt",29,0,0,0,29
2009812,1535905,2025-04-03,House,"FLOOR VOTE: CONSENT CALENDAR PASSAGE ON THIRD CONSIDERATION",91,0,0,0,91
2009818,1529434,2025-03-27,Senate,"FLOOR VOTE: Motion to Adopt",29,0,0,0,29
2009818,1536478,2025-04-03,House,"FLOOR VOTE: CONSENT CALENDAR PASSAGE ON THIRD CONSIDERATION",91,0,0,0,91
2009821,1525621,2025-03-24,House,"FLOOR VOTE: CONSENT CALENDAR PASSAGE ON THIRD CONSIDERATION",96,0,0,0,96
2009821,1532595,2025-03-31,Senate,"FLOOR VOTE: Motion to Adopt",30,0,0,0,30
2009826,1528577,2025-03-27,Senate,"FLOOR VOTE: Motion to Adopt",29,0,0,0,29
2009826,1536592,2025-04-03,House,"FLOOR VOTE: CONSENT CALENDAR PASSAGE ON THIRD CONSIDERATION",91,0,0,0,91
2009831,1525406,2025-03-24,House,"FLOOR VOTE: CONSENT CALENDAR PASSAGE ON THIRD CONSIDERATION",96,0,0,0,96
2009831,1532844,2025-03-31,Senate,"FLOOR VOTE: Motion to Adopt",30,0,0,0,30
2009834,1529426,2025-03-27,Senate,"FLOOR VOTE: Motion to Adopt",29,0,0,0,29
2009834,1536444,2025-04-03,House,"FLOOR VOTE: CONSENT CALENDAR PASSAGE ON THIRD CONSIDERATION",91,0,0,0,91
2009842,1529192,2025-03-27,Senate,"FLOOR VOTE: Motion to Adopt",29,0,0,0,29
2009842,1536643,2025-04-03,House,"FLOOR VOTE: CONSENT CALENDAR PASSAGE ON THIRD CONSIDERATION",91,0,0,0,91
2009845,1525596,2025-03-24,House,"FLOOR VOTE: CONSENT CALENDAR PASSAGE ON THIRD CONSIDERATION",96,0,0,0,96
2009845,1532153,2025-03-31,Senate,"FLOOR VOTE: Motion to Adopt",30,0,0,0,30
2009851,1525534,2025-03-24,House,"FLOOR VOTE: CONSENT CALENDAR PASSAGE ON THIRD CONSIDERATION",96,0,0,0,96
2009851,1531859,2025-03-31,Senate,"FLOOR VOTE: Motion to Adopt",30,0,0,0,30
2009854,1525375,2025-03-24,House,"FLOOR VOTE: CONSENT CALENDAR PASSAGE ON THIRD CONSIDERATION",96,0,0,0,96
2009854,1532154,2025-03-31,Senate,"FLOOR VOTE: Motion to Adopt",30,0,0,0,30
2009858,1529507,2025-03-27,Senate,"FLOOR VOTE: Motion to Adopt",29,0,0,0,29
2009858,1536539,2025-04-03,House,"FLOOR VOTE: CONSENT CALENDAR PASSAGE ON THIRD CONSIDERATION",91,0,0,0,91
2009861,1524993,2025-03-24,House,"FLOOR VOTE: CONSENT CALENDAR PASSAGE ON THIRD CONSIDERATION",96,0,0,0,96
2009861,1531986,2025-03-31,Senate,"FLOOR VOTE: Motion to Adopt",30,0,0,0,30
2009866,1524972,2025-03-24,House,"FLOOR VOTE: CONSENT CALENDAR PASSAGE ON THIRD CONSIDERATION",96,0,0,0,96
2009866,1532382,2025-03-31,Senate,"FLOOR VOTE: Motion to Adopt",30,0,0,0,30
2009871,1525527,2025-03-24,House,"FLOOR VOTE: CONSENT CALENDAR PASSAGE ON THIRD CONSIDERATION",96,0,0,0,96
2009871,1531870,2025-03-31,Senate,"FLOOR VOTE: Motion to Adopt",30,0,0,0,30
2009875,1525537,2025-03-24,House,"FLOOR VOTE: CONSENT CALENDAR PASSAGE ON THIRD CONSIDERATION",96,0,0,0,96
2009875,1531875,2025-03-31,Senate,"FLOOR VOTE: Motion to Adopt",30,0,0,0,30
2009878,1525251,2025-03-24,House,"FLOOR VOTE: CONSENT CALENDAR PASSAGE ON THIRD CONSIDERATION",96,0,0,0,96
2009878,1531871,2025-03-31,Senate,"FLOOR VOTE: Motion to Adopt",30,0,0,0,30
2009883,1528853,2025-03-27,Senate,"FLOOR VOTE: Motion to Adopt",29,0,0,0,29
2009883,1536247,2025-04-03,House,"FLOOR VOTE: CONSENT CALENDAR PASSAGE ON THIRD CONSIDERATION",91,0,0,0,91
2009886,1525569,2025-03-24,House,"FLOOR VOTE: CONSENT CALENDAR PASSAGE ON THIRD CONSIDERATION",96,0,0,0,96
2009886,1531853,2025-03-31,Senate,"FLOOR VOTE: Motion to Adopt",30,0,0,0,30
2009889,1529156,2025-03-27,Senate,"FLOOR VOTE: Motion to Adopt",29,0,0,0,29
2009889,1536202,2025-04-03,House,"FLOOR VOTE: CONSENT CALENDAR PASSAGE ON THIRD CONSIDERATION",91,0,0,0,91
2009894,1529223,2025-03-27,Senate,"FLOOR VOTE: Motion to Adopt",29,0,0,0,29
2009894,1536080,2025-04-03,House,"FLOOR VOTE: CONSENT CALENDAR PASSAGE ON THIRD CONSIDERATION",91,0,0,0,91
2009899,1525688,2025-03-24,House,"FLOOR VOTE: CONSENT CALENDAR PASSAGE ON THIRD CONSIDERATION",96,0,0,0,96
2009899,1532631,2025-03-31,Senate,"FLOOR VOTE: Motion to Adopt",30,0,0,0,30
2009902,1528995,2025-03-27,Senate,"FLOOR VOTE: Motion to Adopt",29,0,0,0,29
2009902,1536076,2025-04-03,House,"FLOOR VOTE: CONSENT CALENDAR PASSAGE ON THIRD CONSIDERATION",91,0,0,0,91
2009905,1525677,2025-03-24,House,"FLOOR VOTE: CONSENT CALENDAR PASSAGE ON THIRD CONSIDERATION",96,0,0,0,96
2009905,1532931,2025-03-31,Senate,"FLOOR VOTE: Motion to Adopt",30,0,0,0,30
2009911,1528800,2025-03-27,Senate,"FLOOR VOTE: Motion to Adopt",29,0,0,0,29
2009911,1536105,2025-04-03,House,"FLOOR VOTE: CONSENT CALENDAR PASSAGE ON THIRD CONSIDERATION",91,0,0,0,91
2009918,1529175,2025-03-27,Senate,"FLOOR VOTE: Motion to Adopt",29,0,0,0,29
2009918,1536124,2025-04-03,House,"FLOOR VOTE: CONSENT CALENDAR PASSAGE ON THIRD CONSIDERATION",91,0,0,0,91
2009921,1525344,2025-03-24,House,"FLOOR VOTE: CONSENT CALENDAR PASSAGE ON THIRD CONSIDERATION",96,0,0,0,96
2009921,1532067,2025-03-31,Senate,"FLOOR VOTE: Motion to Adopt",30,0,0,0,30
2009924,1525301,2025-03-24,House,"FLOOR VOTE: CONSENT CALENDAR PASSAGE ON THIRD CONSIDERATION",96,0,0,0,96
2009924,1532415,2025-03-31,Senate,"FLOOR VOTE: Motion to Adopt",30,0,0,0,30
2009942,1525246,2025-03-24,House,"FLOOR VOTE: CONSENT CALENDAR PASSAGE ON THIRD CONSIDERATION",96,0,0,0,96
2009942,1532867,2025-03-31,Senate,"FLOOR VOTE: Motion to Adopt",30,0,0,0,30
2009945,1525163,2025-03-24,House,"FLOOR VOTE: CONSENT CALENDAR PASSAGE ON THIRD CONSIDERATION",96,0,0,0,96
2009945,1532686,2025-03-31,Senate,"FLOOR VOTE: Motion to Adopt",30,0,0,0,30
2009952,1524977,2025-03-24,House,"FLOOR VOTE: CONSENT CALENDAR PASSAGE ON THIRD CONSIDERATION",96,0,0,0,96
2009952,1532345,2025-03-31,Senate,"FLOOR VOTE: Motion to Adopt",30,0,0,0,30
2009956,1525033,2025-03-24,House,"FLOOR VOTE: CONSENT CALENDAR PASSAGE ON THIRD CONSIDERATION",96,0,0,0,96
2009956,1531852,2025-03-31,Senate,"FLOOR VOTE: Motion to Adopt",30,0,0,0,30
2009963,1525610,2025-03-24,House,"FLOOR VOTE: CONSENT CALENDAR PASSAGE ON THIRD CONSIDERATION",96,0,0,0,96
2009963,1532804,2025-03-31,Senate,"FLOOR VOTE: Motion to Adopt",30,0,0,0,30
2009968,1525113,2025-03-24,House,"FLOOR VOTE: CONSENT CALENDAR PASSAGE ON THIRD CONSIDERATION",96,0,0,0,96
2009968,1531979,2025-03-31,Senate,"FLOOR VOTE: Motion to Adopt",30,0,0,0,30
2009975,1525079,2025-03-24,House,"FLOOR VOTE: CONSENT CALENDAR PASSAGE ON THIRD CONSIDERATION",96,0,0,0,96
2009975,1531872,2025-03-31,Senate,"FLOOR VOTE: Motion to Adopt",30,0,0,0,30
2009979,1525399,2025-03-24,House,"FLOOR VOTE: CONSENT CALENDAR PASSAGE ON THIRD CONSIDERATION",96,0,0,0,96
2009979,1531861,2025-03-31,Senate,"FLOOR VOTE: Motion to Adopt",30,0,0,0,30
2009987,1528902,2025-03-27,Senate,"FLOOR VOTE: Motion to Adopt",29,0,0,0,29
2009987,1536262,2025-04-03,House,"FLOOR VOTE: CONSENT CALENDAR PASSAGE ON THIRD CONSIDERATION",91,0,0,0,91
2009991,1525535,2025-03-24,House,"FLOOR VOTE: CONSENT CALENDAR PASSAGE ON THIRD CONSIDERATION",96,0,0,0,96
2009991,1532304,2025-03-31,Senate,"FLOOR VOTE: Motion to Adopt",30,0,0,0,30
2009998,1525244,2025-03-24,House,"FLOOR VOTE: CONSENT CALENDAR PASSAGE ON THIRD CONSIDERATION",96,0,0,0,96
2009998,1532585,2025-03-31,Senate,"FLOOR VOTE: Motion to Adopt",30,0,0,0,30
2010005,1525362,2025-03-24,House,"FLOOR VOTE: CONSENT CALENDAR PASSAGE ON THIRD CONSIDERATION",96,0,0,0,96
2010005,1532475,2025-03-31,Senate,"FLOOR VOTE: Motion to Adopt",30,0,0,0,30
2010012,1525039,2025-03-24,House,"FLOOR VOTE: CONSENT CALENDAR PASSAGE ON THIRD CONSIDERATION",96,0,0,0,96
2010012,1532625,2025-03-31,Senate,"FLOOR VOTE: Motion to Adopt",30,0,0,0,30
2010018,1525681,2025-03-24,House,"FLOOR VOTE: CONSENT CALENDAR PASSAGE ON THIRD CONSIDERATION",96,0,0,0,96
2010018,1532889,2025-03-31,Senate,"FLOOR VOTE: Motion to Adopt",30,0,0,0,30
2010025,1525159,2025-03-24,House,"FLOOR VOTE: CONSENT CALENDAR PASSAGE ON THIRD CONSIDERATION",96,0,0,0,96
2010025,1532066,2025-03-31,Senate,"FLOOR VOTE: Motion to Adopt",30,0,0,0,30
2010031,1525018,2025-03-24,House,"FLOOR VOTE: CONSENT CALENDAR PASSAGE ON THIRD CONSIDERATION",96,0,0,0,96
2010031,1532160,2025-03-31,Senate,"FLOOR VOTE: Motion to Adopt",30,0,0,0,30
2010037,1525522,2025-03-24,House,"FLOOR VOTE: CONSENT CALENDAR PASSAGE ON THIRD CONSIDERATION",96,0,0,0,96
2010037,1532338,2025-03-31,Senate,"FLOOR VOTE: Motion to Adopt",30,0,0,0,30
2010043,1525319,2025-03-24,House,"FLOOR VOTE: CONSENT CALENDAR PASSAGE ON THIRD CONSIDERATION",96,0,0,0,96
2010043,1531823,2025-03-31,Senate,"FLOOR VOTE: Motion to Adopt",30,0,0,0,30
2010048,1528863,2025-03-27,Senate,"FLOOR VOTE: Motion to Adopt",29,0,0,0,29
2010048,1536372,2025-04-03,House,"FLOOR VOTE: CONSENT CALENDAR PASSAGE ON THIRD CONSIDERATION",91,0,0,0,91
2010053,1525526,2025-03-24,House,"FLOOR VOTE: CONSENT CALENDAR PASSAGE ON THIRD CONSIDERATION",96,0,0,0,96
2010053,1532361,2025-03-31,Senate,"FLOOR VOTE: Motion to Adopt",30,0,0,0,30
2010064,1525575,2025-03-24,House,"FLOOR VOTE: CONSENT CALENDAR PASSAGE ON THIRD CONSIDERATION",96,0,0,0,96
2010064,1532169,2025-03-31,Senate,"FLOOR VOTE: Motion to Adopt",30,0,0,0,30
2010068,1525117,2025-03-24,House,"FLOOR VOTE: CONSENT CALENDAR PASSAGE ON THIRD CONSIDERATION",96,0,0,0,96
2010068,1532861,2025-03-31,Senate,"FLOOR VOTE: Motion to Adopt",30,0,0,0,30
2010073,1525550,2025-03-24,House,"FLOOR VOTE: CONSENT CALENDAR PASSAGE ON THIRD CONSIDERATION",96,0,0,0,96
2010073,1532342,2025-03-31,Senate,"FLOOR VOTE: Motion to Adopt",30,0,0,0,30
2010083,1525149,2025-03-24,House,"FLOOR VOTE: CONSENT CALENDAR PASSAGE ON THIRD CONSIDERATION",96,0,0,0,96
2010083,1532836,2025-03-31,Senate,"FLOOR VOTE: Motion to Adopt",30,0,0,0,30
2010086,1525325,2025-03-24,House,"FLOOR VOTE: CONSENT CALENDAR PASSAGE ON THIRD CONSIDERATION",96,0,0,0,96
2010086,1532785,2025-03-31,Senate,"FLOOR VOTE: Motion to Adopt",30,0,0,0,30
2010094,1525551,2025-03-24,House,"FLOOR VOTE: CONSENT CALENDAR PASSAGE ON THIRD CONSIDERATION",96,0,0,0,96
2010094,1531869,2025-03-31,Senate,"FLOOR VOTE: Motion to Adopt",30,0,0,0,30
2010101,1525679,2025-03-24,House,"FLOOR VOTE: CONSENT CALENDAR PASSAGE ON THIRD CONSIDERATION",96,0,0,0,96
2010101,1532951,2025-03-31,Senate,"FLOOR VOTE: Motion to Adopt",30,0,0,0,30
2010106,1525065,2025-03-24,House,"FLOOR VOTE: CONSENT CALENDAR PASSAGE ON THIRD CONSIDERATION",96,0,0,0,96
2010106,1532320,2025-03-31,Senate,"FLOOR VOTE: Motion to Adopt",30,0,0,0,30
2010113,1525206,2025-03-24,House,"FLOOR VOTE: CONSENT CALENDAR PASSAGE ON THIRD CONSIDERATION",96,0,0,0,96
2010113,1531880,2025-03-31,Senate,"FLOOR VOTE: Motion to Adopt",30,0,0,0,30
2010121,1525565,2025-03-24,House,"FLOOR VOTE: CONSENT CALENDAR PASSAGE ON THIRD CONSIDERATION",96,0,0,0,96
2010121,1532915,2025-03-31,Senate,"FLOOR VOTE: Motion to Adopt",30,0,0,0,30
2010125,1525225,2025-03-24,House,"FLOOR VOTE: CONSENT CALENDAR PASSAGE ON THIRD CONSIDERATION",96,0,0,0,96
2010125,1532354,2025-03-31,Senate,"FLOOR VOTE: Motion to Adopt",30,0,0,0,30
2010138,1525363,2025-03-24,House,"FLOOR VOTE: CONSENT CALENDAR PASSAGE ON THIRD CONSIDERATION",96,0,0,0,96
2010138,1532697,2025-03-31,Senate,"FLOOR VOTE: Motion to Adopt",30,0,0,0,30
2010143,1525579,2025-03-24,House,"FLOOR VOTE: CONSENT CALENDAR PASSAGE ON THIRD CONSIDERATION",96,0,0,0,96
2010143,1532349,2025-03-31,Senate,"FLOOR VOTE: Motion to Adopt",30,0,0,0,30
2010150,1525121,2025-03-24,House,"FLOOR VOTE: CONSENT CALENDAR PASSAGE ON THIRD CONSIDERATION",96,0,0,0,96
2010150,1532793,2025-03-31,Senate,"FLOOR VOTE: Motion to Adopt",30,0,0,0,30
2010156,1525599,2025-03-24,House,"FLOOR VOTE: CONSENT CALENDAR PASSAGE ON THIRD CONSIDERATION",96,0,0,0,96
2010156,1532664,2025-03-31,Senate,"FLOOR VOTE: Motion to Adopt",30,0,0,0,30
2010163,1525405,2025-03-24,House,"FLOOR VOTE: CONSENT CALENDAR PASSAGE ON THIRD CONSIDERATION",96,0,0,0,96
2010163,1531878,2025-03-31,Senate,"FLOOR VOTE: Motion to Adopt",30,0,0,0,30
2010168,1525647,2025-03-24,House,"FLOOR VOTE: CONSENT CALENDAR PASSAGE ON THIRD CONSIDERATION",96,0,0,0,96
2010168,1532780,2025-03-31,Senate,"FLOOR VOTE: Motion to Adopt",30,0,0,0,30
2010176,1525337,2025-03-24,House,"FLOOR VOTE: CONSENT CALENDAR PASSAGE ON THIRD CONSIDERATION",96,0,0,0,96
2010176,1532070,2025-03-31,Senate,"FLOOR VOTE: Motion to Adopt",30,0,0,0,30
2010180,1525539,2025-03-24,House,"FLOOR VOTE: CONSENT CALENDAR PASSAGE ON THIRD CONSIDERATION",96,0,0,0,96
2010180,1532324,2025-03-31,Senate,"FLOOR VOTE: Motion to Adopt",30,0,0,0,30
2010188,1525506,2025-03-24,House,"FLOOR VOTE: CONSENT CALENDAR PASSAGE ON THIRD CONSIDERATION",96,0,0,0,96
2010188,1531949,2025-03-31,Senate,"FLOOR VOTE: Motion to Adopt",30,0,0,0,30
2010193,1525558,2025-03-24,House,"FLOOR VOTE: CONSENT CALENDAR PASSAGE ON THIRD CONSIDERATION",96,0,0,0,96
2010193,1532157,2025-03-31,Senate,"FLOOR VOTE: Motion to Adopt",30,0,0,0,30
2010204,1525643,2025-03-24,House,"FLOOR VOTE: CONSENT CALENDAR PASSAGE ON THIRD CONSIDERATION",96,0,0,0,96
2010204,1532191,2025-03-31,Senate,"FLOOR VOTE: Motion to Adopt",30,0,0,0,30
2010210,1529471,2025-03-27,Senate,"FLOOR VOTE: Motion to Adopt",29,0,0,0,29
2010213,1525700,2025-03-24,House,"FLOOR VOTE: CONSENT CALENDAR PASSAGE ON THIRD CONSIDERATION",96,0,0,0,96
2010213,1531867,2025-03-31,Senate,"FLOOR VOTE: Motion to Adopt",30,0,0,0,30
2010218,1525238,2025-03-24,House,"FLOOR VOTE: CONSENT CALENDAR PASSAGE ON THIRD CONSIDERATION",96,0,0,0,96
2010218,1532818,2025-03-31,Senate,"FLOOR VOTE: Motion to Adopt",30,0,0,0,30
2010224,1525377,2025-03-24,House,"FLOOR VOTE: CONSENT CALENDAR PASSAGE ON THIRD CONSIDERATION",96,0,0,0,96
2010224,1532146,2025-03-31,Senate,"FLOOR VOTE: Motion to Adopt",30,0,0,0,30
2010232,1525475,2025-03-24,House,"FLOOR VOTE: CONSENT CALENDAR PASSAGE ON THIRD CONSIDERATION",96,0,0,0,96
2010232,1531948,2025-03-31,Senate,"FLOOR VOTE: Motion to Adopt",30,0,0,0,30
2010238,1525635,2025-03-24,House,"FLOOR VOTE: CONSENT CALENDAR PASSAGE ON THIRD CONSIDERATION",96,0,0,0,96
2010238,1532055,2025-03-31,Senate,"FLOOR VOTE: Motion to Adopt",30,0,0,0,30
2010245,1525002,2025-03-24,House,"FLOOR VOTE: CONSENT CALENDAR PASSAGE ON THIRD CONSIDERATION",96,0,0,0,96
2010245,1532765,2025-03-31,Senate,"FLOOR VOTE: Motion to Adopt",30,0,0,0,30
2010250,1525680,2025-03-24,House,"FLOOR VOTE: CONSENT CALENDAR PASSAGE ON THIRD CONSIDERATION",96,0,0,0,96
2010250,1532175,2025-03-31,Senate,"FLOOR VOTE: Motion to Adopt",30,0,0,0,30
2010258,1525530,2025-03-24,House,"FLOOR VOTE: CONSENT CALENDAR PASSAGE ON THIRD CONSIDERATION",96,0,0,0,96
2010258,1532277,2025-03-31,Senate,"FLOOR VOTE: Motion to Adopt",30,0,0,0,30
2010264,1528928,2025-03-27,Senate,"FLOOR VOTE: Motion to Adopt",29,0,0,0,29
2010271,1525127,2025-03-24,House,"FLOOR VOTE: CONSENT CALENDAR PASSAGE ON THIRD CONSIDERATION",96,0,0,0,96
2010271,1532710,2025-03-31,Senate,"FLOOR VOTE: Motion to Adopt",30,0,0,0,30
2010277,1525339,2025-03-24,House,"FLOOR VOTE: CONSENT CALENDAR PASSAGE ON THIRD CONSIDERATION",96,0,0,0,96
2010277,1531820,2025-03-31,Senate,"FLOOR VOTE: Motion to Adopt",30,0,0,0,30
2010285,1525499,2025-03-24,House,"FLOOR VOTE: CONSENT CALENDAR PASSAGE ON THIRD CONSIDERATION",96,0,0,0,96
2010285,1532638,2025-03-31,Senate,"FLOOR VOTE: Motion to Adopt",30,0,0,0,30
2010290,1525564,2025-03-24,House,"FLOOR VOTE: CONSENT CALENDAR PASSAGE ON THIRD CONSIDERATION",96,0,0,0,96
2010290,1532344,2025-03-31,Senate,"FLOOR VOTE: Motion to Adopt",30,0,0,0,30
2010299,1525338,2025-03-24,House,"FLOOR VOTE: CONSENT CALENDAR PASSAGE ON THIRD CONSIDERATION",96,0,0,0,96
2010299,1531836,2025-03-31,Senate,"FLOOR VOTE: Motion to Adopt",30,0,0,0,30
2010310,1525307,2025-03-24,House,"FLOOR VOTE: CONSENT CALENDAR PASSAGE ON THIRD CONSIDERATION",96,0,0,0,96
2010310,1532101,2025-03-31,Senate,"FLOOR VOTE: Motion to Adopt",30,0,0,0,30
2010316,1525538,2025-03-24,House,"FLOOR VOTE: CONSENT CALENDAR PASSAGE ON THIRD CONSIDERATION",96,0,0,0,96
2010316,1532815,2025-03-31,Senate,"FLOOR VOTE: Motion to Adopt",30,0,0,0,30
2010321,1525682,2025-03-24,House,"FLOOR VOTE: CONSENT CALENDAR PASSAGE ON THIRD CONSIDERATION",96,0,0,0,96
2010321,1532654,2025-03-31,Senate,"FLOOR VOTE: Motion to Adopt",30,0,0,0,30
2010325,1525320,2025-03-24,House,"FLOOR VOTE: CONSENT CALENDAR PASSAGE ON THIRD CONSIDERATION",96,0,0,0,96
2010325,1532138,2025-03-31,Senate,"FLOOR VOTE: Motion to Adopt",30,0,0,0,30
2010328,1525582,2025-03-24,House,"FLOOR VOTE: CONSENT CALENDAR PASSAGE ON THIRD CONSIDERATION",96,0,0,0,96
2010328,1532474,2025-03-31,Senate,"FLOOR VOTE: Motion to Adopt",30,0,0,0,30
2010339,1528847,2025-03-27,Senate,"FLOOR VOTE: Motion to Adopt",29,0,0,0,29
2010339,1535713,2025-04-03,House,"FLOOR VOTE: CONSENT CALENDAR PASSAGE ON THIRD CONSIDERATION",91,0,0,0,91
2010709,1528776,2025-03-27,Senate,"FLOOR VOTE: Motion to Adopt",29,0,0,0,29
2010709,1535703,2025-04-03,House,"FLOOR VOTE: CONSENT CALENDAR PASSAGE ON THIRD CONSIDERATION",91,0,0,0,91
2010718,1528871,2025-03-27,Senate,"FLOOR VOTE: Motion to Adopt",29,0,0,0,29
2010718,1535796,2025-04-03,House,"FLOOR VOTE: CONSENT CALENDAR PASSAGE ON THIRD CONSIDERATION",91,0,0,0,91
2010730,1528740,2025-03-27,Senate,"FLOOR VOTE: Motion to Adopt",29,0,0,0,29
2010743,1528906,2025-03-27,Senate,"FLOOR VOTE: Motion to Adopt",29,0,0,0,29
2010743,1536323,2025-04-03,House,"FLOOR VOTE: CONSENT CALENDAR PASSAGE ON THIRD CONSIDERATION",91,0,0,0,91
2010758,1529132,2025-03-27,Senate,"FLOOR VOTE: Motion to Adopt",29,0,0,0,29
2010771,1529443,2025-03-27,Senate,"FLOOR VOTE: Motion to Adopt",29,0,0,0,29
2010785,1528654,2025-03-27,Senate,"FLOOR VOTE: Motion to Adopt",29,0,0,0,29
2010785,1535824,2025-04-03,House,"FLOOR VOTE: CONSENT CALENDAR PASSAGE ON THIRD CONSIDERATION",91,0,0,0,91
2010805,1525691,2025-03-24,House,"FLOOR VOTE: CONSENT CALENDAR PASSAGE ON THIRD CONSIDERATION",96,0,0,0,96
2010805,1531805,2025-03-31,Senate,"FLOOR VOTE: Motion to Adopt",30,0,0,0,30
2010815,1529538,2025-03-27,House,"FLOOR VOTE: REGULAR CALENDAR MOTION TO ADOPT",73,21,0,0,94
2010815,1529539,2025-03-27,House,"FLOOR VOTE: REGULAR CALENDAR PREVIOUS QUESTION MOTION TO ADOPT",72,22,0,0,94
2010815,1536072,2025-04-03,Senate,"FLOOR VOTE: Motion to Adopt",30,0,0,0,30
2010829,1528730,2025-03-27,Senate,"FLOOR VOTE: Motion to Adopt",29,0,0,0,29
2010829,1536691,2025-04-03,House,"FLOOR VOTE: CONSENT CALENDAR PASSAGE ON THIRD CONSIDERATION",91,0,0,0,91
2010843,1528904,2025-03-27,Senate,"FLOOR VOTE: Motion to Adopt",29,0,0,0,29
2010843,1536143,2025-04-03,House,"FLOOR VOTE: CONSENT CALENDAR PASSAGE ON THIRD CONSIDERATION",91,0,0,0,91
2010857,1525091,2025-03-24,House,"FLOOR VOTE: CONSENT CALENDAR PASSAGE ON THIRD CONSIDERATION",96,0,0,0,96
2010857,1532749,2025-03-31,Senate,"FLOOR VOTE: Motion to Adopt",30,0,0,0,30
2010868,1528953,2025-03-27,Senate,"FLOOR VOTE: Motion to Adopt",29,0,0,0,29
2010868,1536270,2025-04-03,House,"FLOOR VOTE: CONSENT CALENDAR PASSAGE ON THIRD CONSIDERATION",91,0,0,0,91
2010880,1528843,2025-03-27,Senate,"FLOOR VOTE: Motion to Adopt",29,0,0,0,29
2010917,1525644,2025-03-24,House,"FLOOR VOTE: CONSENT CALENDAR PASSAGE ON THIRD CONSIDERATION",96,0,0,0,96
2010917,1532599,2025-03-31,Senate,"FLOOR VOTE: Motion to Adopt",30,0,0,0,30
2010936,1528951,2025-03-27,Senate,"FLOOR VOTE: Motion to Adopt",29,0,0,0,29
2010959,1529004,2025-03-27,Senate,"FLOOR VOTE: Motion to Adopt",29,0,0,0,29
2010997,1525642,2025-03-24,House,"FLOOR VOTE: CONSENT CALENDAR PASSAGE ON THIRD CONSIDERATION",96,0,0,0,96
2010997,1532480,2025-03-31,Senate,"FLOOR VOTE: Motion to Adopt",30,0,0,0,30
2011015,1524962,2025-03-24,House,"FLOOR VOTE: CONSENT CALENDAR PASSAGE ON THIRD CONSIDERATION",96,0,0,0,96
2011015,1532064,2025-03-31,Senate,"FLOOR VOTE: Motion to Adopt",30,0,0,0,30
2011034,1525646,2025-03-24,House,"FLOOR VOTE: CONSENT CALENDAR PASSAGE ON THIRD CONSIDERATION",96,0,0,0,96
2011075,1525124,2025-03-24,House,"FLOOR VOTE: CONSENT CALENDAR PASSAGE ON THIRD CONSIDERATION",96,0,0,0,96
2011075,1531944,2025-03-31,Senate,"FLOOR VOTE: Motion to Adopt",30,0,0,0,30
2011090,1554772,2025-04-22,Senate,"SENATE FINANCE, WAYS AND MEANS COMMITTEE: Recommended for adoption by Senate Finance, Ways, and Means Committee, refer Senate Calendar Committee",10,0,0,0,10
2011090,1557347,2025-04-22,Senate,"FLOOR VOTE: Motion to Adopt",32,0,0,0,32
2011103,1525645,2025-03-24,House,"FLOOR VOTE: CONSENT CALENDAR PASSAGE ON THIRD CONSIDERATION",96,0,0,0,96
2011103,1531857,2025-03-31,Senate,"FLOOR VOTE: Motion to Adopt",30,0,0,0,30
2011118,1528655,2025-03-27,Senate,"FLOOR VOTE: Motion to Adopt",29,0,0,0,29
2011118,1535926,2025-04-03,House,"FLOOR VOTE: CONSENT CALENDAR PASSAGE ON THIRD CONSIDERATION",91,0,0,0,91
2011176,1525120,2025-03-24,House,"FLOOR VOTE: CONSENT CALENDAR PASSAGE ON THIRD CONSIDERATION",96,0,0,0,96
2011240,1529204,2025-03-27,Senate,"FLOOR VOTE: Motion to Adopt",29,0,0,0,29
2011240,1536324,2025-04-03,House,"FLOOR VOTE: CONSENT CALENDAR PASSAGE ON THIRD CONSIDERATION",91,0,0,0,91
2011364,1529065,2025-03-27,Senate,"FLOOR VOTE: Motion to Adopt",29,0,0,0,29
2011364,1536464,2025-04-03,House,"FLOOR VOTE: CONSENT CALENDAR PASSAGE ON THIRD CONSIDERATION",91,0,0,0,91
2011488,1523157,2025-03-20,Senate,"FLOOR VOTE: Motion to Adopt",31,0,0,0,31
2011510,1547721,2025-04-14,House,"FLOOR VOTE: REGULAR CALENDAR MOTION TO ADOPT",74,22,0,0,96
2011510,1547722,2025-04-14,House,"FLOOR VOTE: REGULAR CALENDAR MOTION TO ADOPT AMENDMENT # 1 BY PEARSON MOTION TO ADOPT",23,72,0,0,95
2011510,1547723,2025-04-14,House,"FLOOR VOTE: REGULAR CALENDAR MOTION TO ADOPT AMENDMENT # 2 BY PEARSON MOTION TO ADOPT",19,73,0,0,92
2011510,1547724,2025-04-14,House,"FLOOR VOTE: REGULAR CALENDAR MOTION TO ADOPT AMENDMENT # 3 BY PEARSON MOTION TO ADOPT",20,72,0,0,92
2011510,1547725,2025-04-14,House,"FLOOR VOTE: REGULAR CALENDAR PREVIOUS QUESTION MOTION TO ADOPT AMENDMENT # 1 BY PEARSON MOTION TO ADOPT",73,21,0,0,94
2011510,1547726,2025-04-14,House,"FLOOR VOTE: REGULAR CALENDAR PREVIOUS QUESTION MOTION TO ADOPT AMENDMENT # 2 BY PEARSON MOTION TO ADOPT",75,18,0,0,93
2011510,1547727,2025-04-14,House,"FLOOR VOTE: REGULAR CALENDAR PREVIOUS QUESTION MOTION TO ADOPT AMENDMENT # 3 BY PEARSON MOTION TO ADOPT",72,20,0,0,92
2011510,1553014,2025-04-21,Senate,"FLOOR VOTE: Motion to Concur",27,6,0,0,33
2011532,1539112,2025-04-07,House,"HOUSE PRIVATE ACTS COMMITTEE: Rec. for pass; ref to State & Local Government Committee",10,0,0,0,10
2011532,1543084,2025-04-09,House,"HOUSE STATE & LOCAL GOVERNMENT COMMITTEE: Rec. for pass; ref to Calendar & Rules Committee",19,0,2,0,21
2011532,1550215,2025-04-16,House,"FLOOR VOTE: CONSENT CALENDAR PASSAGE ON THIRD CONSIDERATION",96,0,0,0,96
2011532,1553178,2025-04-21,Senate,"FLOOR VOTE: Motion to Adopt",32,0,0,0,32
2011557,1525694,2025-03-24,House,"FLOOR VOTE: CONSENT CALENDAR PASSAGE ON THIRD CONSIDERATION",96,0,0,0,96
2011557,1532072,2025-03-31,Senate,"FLOOR VOTE: Motion to Adopt",30,0,0,0,30
2011577,1532365,2025-03-31,Senate,"FLOOR VOTE: Motion to Adopt",30,0,0,0,30
2011577,1538392,2025-04-07,House,"FLOOR VOTE: CONSENT CALENDAR PASSAGE ON THIRD CONSIDERATION",96,0,0,0,96
2011621,1525074,2025-03-24,House,"FLOOR VOTE: CONSENT CALENDAR PASSAGE ON THIRD CONSIDERATION",96,0,0,0,96
2011621,1532907,2025-03-31,Senate,"FLOOR VOTE: Motion to Adopt",30,0,0,0,30
2011642,1529504,2025-03-27,House,"FLOOR VOTE: CONSENT CALENDAR PASSAGE ON THIRD CONSIDERATION",94,0,2,0,96
2011710,1553085,2025-04-21,Senate,"FLOOR VOTE: Motion to Adopt",32,0,0,0,32
2011767,1525501,2025-03-24,House,"FLOOR VOTE: CONSENT CALENDAR PASSAGE ON THIRD CONSIDERATION",96,0,0,0,96
2011767,1531931,2025-03-31,Senate,"FLOOR VOTE: Motion to Adopt",30,0,0,0,30
2011828,1524952,2025-03-24,House,"FLOOR VOTE: CONSENT CALENDAR PASSAGE ON THIRD CONSIDERATION",96,0,0,0,96
2011828,1532394,2025-03-31,Senate,"FLOOR VOTE: Motion to Adopt",30,0,0,0,30
2011886,1525628,2025-03-24,House,"FLOOR VOTE: CONSENT CALENDAR PASSAGE ON THIRD CONSIDERATION",96,0,0,0,96
2011886,1532076,2025-03-31,Senate,"FLOOR VOTE: Motion to Adopt",30,0,0,0,30
2011940,1531865,2025-03-31,Senate,"FLOOR VOTE: Motion to Adopt",30,0,0,0,30
2011940,1538755,2025-04-07,House,"FLOOR VOTE: CONSENT CALENDAR PASSAGE ON THIRD CONSIDERATION",96,0,0,0,96
2011997,1525568,2025-03-24,House,"FLOOR VOTE: CONSENT CALENDAR PASSAGE ON THIRD CONSIDERATION",96,0,0,0,96
2011997,1531873,2025-03-31,Senate,"FLOOR VOTE: Motion to Adopt",30,0,0,0,30
2012625,1529638,2025-03-27,House,"FLOOR VOTE: CONSENT CALENDAR PASSAGE ON THIRD CONSIDERATION",94,0,2,0,96
2012625,1536406,2025-04-03,Senate,"FLOOR VOTE: Motion to Adopt",30,0,0,0,30
2012881,1531856,2025-03-31,Senate,"FLOOR VOTE: Motion to Adopt",30,0,0,0,30
2012881,1538752,2025-04-07,House,"FLOOR VOTE: CONSENT CALENDAR PASSAGE ON THIRD CONSIDERATION",96,0,0,0,96
2012942,1529567,2025-03-27,House,"FLOOR VOTE: CONSENT CALENDAR PASSAGE ON THIRD CONSIDERATION",94,0,2,0,96
2012942,1536183,2025-04-03,Senate,"FLOOR VOTE: Motion to Adopt",30,0,0,0,30
2013004,1529621,2025-03-27,House,"FLOOR VOTE: CONSENT CALENDAR PASSAGE ON THIRD CONSIDERATION",94,0,2,0,96
2013004,1536325,2025-04-03,Senate,"FLOOR VOTE: Motion to Adopt",30,0,0,0,30
2013063,1531842,2025-03-31,Senate,"FLOOR VOTE: Motion to Adopt",30,0,0,0,30
2013063,1538363,2025-04-07,House,"FLOOR VOTE: CONSENT CALENDAR PASSAGE ON THIRD CONSIDERATION",96,0,0,0,96
2013288,1532628,2025-03-31,Senate,"FLOOR VOTE: Motion to Adopt",30,0,0,0,30
2013449,1531002,2025-03-31,House,"FLOOR VOTE: CONSENT CALENDAR PASSAGE ON THIRD CONSIDERATION",93,0,2,0,95
2013607,1532883,2025-03-31,Senate,"FLOOR VOTE: Motion to Adopt",30,0,0,0,30
2013657,1532570,2025-03-31,Senate,"FLOOR VOTE: Motion to Adopt",30,0,0,0,30
2013657,1539201,2025-04-07,House,"FLOOR VOTE: CONSENT CALENDAR PASSAGE ON THIRD CONSIDERATION",96,0,0,0,96
2013701,1549514,2025-04-16,House,"HOUSE PRIVATE ACTS COMMITTEE: Rec. for pass; ref to State & Local Government Committee",9,1,0,0,10
2013701,1549515,2025-04-16,House,"HOUSE STATE & LOCAL GOVERNMENT COMMITTEE: Rec. for pass; ref to Calendar & Rules Committee",16,0,0,0,16
2013701,1553590,2025-04-21,House,"FLOOR VOTE: CONSENT CALENDAR PASSAGE ON THIRD CONSIDERATION",86,0,1,0,87
2013701,1556900,2025-04-22,Senate,"FLOOR VOTE: Motion to Adopt",33,0,0,0,33
2013744,1531958,2025-03-31,Senate,"FLOOR VOTE: Motion to Adopt",30,0,0,0,30
2013744,1538706,2025-04-07,House,"FLOOR VOTE: CONSENT CALENDAR PASSAGE ON THIRD CONSIDERATION",96,0,0,0,96
2013794,1532680,2025-03-31,Senate,"FLOOR VOTE: Motion to Adopt",30,0,0,0,30
2013794,1538864,2025-04-07,House,"FLOOR VOTE: CONSENT CALENDAR PASSAGE ON THIRD CONSIDERATION",96,0,0,0,96
2013806,1539035,2025-04-07,House,"HOUSE PRIVATE ACTS COMMITTEE: Rec. for pass; ref to State & Local Government Committee",10,0,0,0,10
2013806,1541045,2025-04-08,House,"HOUSE STATE & LOCAL GOVERNMENT COMMITTEE: Rec. for pass; ref to Calendar & Rules Committee",23,0,0,0,23
2013806,1547466,2025-04-14,House,"FLOOR VOTE: CONSENT CALENDAR PASSAGE ON THIRD CONSIDERATION",94,0,1,0,95
2013806,1552573,2025-04-17,Senate,"FLOOR VOTE: Motion to Adopt",33,0,0,0,33
2013823,1531439,2025-03-31,House,"FLOOR VOTE: CONSENT CALENDAR PASSAGE ON THIRD CONSIDERATION",93,0,2,0,95
2013823,1539301,2025-04-07,Senate,"FLOOR VOTE: Motion to Adopt",32,0,0,0,32
2013838,1532758,2025-03-31,Senate,"FLOOR VOTE: Motion to Adopt",30,0,0,0,30
2013838,1538627,2025-04-07,House,"FLOOR VOTE: CONSENT CALENDAR PASSAGE ON THIRD CONSIDERATION",96,0,0,0,96
2013877,1531685,2025-03-31,House,"FLOOR VOTE: CONSENT CALENDAR PASSAGE ON THIRD CONSIDERATION",93,0,2,0,95
2013877,1540157,2025-04-07,Senate,"FLOOR VOTE: Motion to Adopt",32,0,0,0,32
2013915,1532210,2025-03-31,Senate,"FLOOR VOTE: Motion to Adopt",30,0,0,0,30
2013915,1539129,2025-04-07,House,"FLOOR VOTE: CONSENT CALENDAR PASSAGE ON THIRD CONSIDERATION",96,0,0,0,96
2013928,1531671,2025-03-31,House,"FLOOR VOTE: CONSENT CALENDAR PASSAGE ON THIRD CONSIDERATION",93,0,2,0,95
2013928,1539265,2025-04-07,Senate,"FLOOR VOTE: Motion to Adopt",32,0,0,0,32
2013957,1531237,2025-03-31,House,"FLOOR VOTE: CONSENT CALENDAR PASSAGE ON THIRD CONSIDERATION",93,0,2,0,95
2013957,1539247,2025-04-07,Senate,"FLOOR VOTE: Motion to Adopt",32,0,0,0,32
2013972,1531600,2025-03-31,House,"FLOOR VOTE: CONSENT CALENDAR PASSAGE ON THIRD CONSIDERATION",93,0,2,0,95
2013972,1539248,2025-04-07,Senate,"FLOOR VOTE: Motion to Adopt",32,0,0,0,32
2013984,1552430,2025-04-17,Senate,"FLOOR VOTE: Motion to Adopt",33,0,0,0,33
2013997,1531166,2025-03-31,House,"FLOOR VOTE: CONSENT CALENDAR PASSAGE ON THIRD CONSIDERATION",93,0,2,0,95
2013997,1539766,2025-04-07,Senate,"FLOOR VOTE: Motion to Adopt",32,0,0,0,32
2014010,1532916,2025-03-31,Senate,"FLOOR VOTE: Motion to Adopt",30,0,0,0,30
2014010,1538663,2025-04-07,House,"FLOOR VOTE: CONSENT CALENDAR PASSAGE ON THIRD CONSIDERATION",96,0,0,0,96
2014052,1531257,2025-03-31,House,"FLOOR VOTE: CONSENT CALENDAR PASSAGE ON THIRD CONSIDERATION",93,0,2,0,95
2014052,1539266,2025-04-07,Senate,"FLOOR VOTE: Motion to Adopt",32,0,0,0,32
2014095,1531190,2025-03-31,House,"FLOOR VOTE: CONSENT CALENDAR PASSAGE ON THIRD CONSIDERATION",93,0,2,0,95
2014095,1539619,2025-04-07,Senate,"FLOOR VOTE: Motion to Adopt",32,0,0,0,32
2014138,1532095,2025-03-31,Senate,"FLOOR VOTE: Motion to Adopt",30,0,0,0,30
2014138,1538722,2025-04-07,House,"FLOOR VOTE: CONSENT CALENDAR PASSAGE ON THIRD CONSIDERATION",96,0,0,0,96
2014180,1557180,2025-04-22,Senate,"FLOOR VOTE: Motion to Adopt",33,0,0,0,33
2014229,1532283,2025-03-31,Senate,"FLOOR VOTE: Motion to Adopt",30,0,0,0,30
2014229,1538838,2025-04-07,House,"FLOOR VOTE: CONSENT CALENDAR PASSAGE ON THIRD CONSIDERATION",96,0,0,0,96
2014273,1531016,2025-03-31,House,"FLOOR VOTE: CONSENT CALENDAR PASSAGE ON THIRD CONSIDERATION",93,0,2,0,95
2014317,1531147,2025-03-31,House,"FLOOR VOTE: CONSENT CALENDAR PASSAGE ON THIRD CONSIDERATION",93,0,2,0,95
2014317,1539237,2025-04-07,Senate,"FLOOR VOTE: Motion to Adopt",32,0,0,0,32
2014414,1532002,2025-03-31,Senate,"FLOOR VOTE: Motion to Adopt",30,0,0,0,30
2014414,1538484,2025-04-07,House,"FLOOR VOTE: CONSENT CALENDAR PASSAGE ON THIRD CONSIDERATION",96,0,0,0,96
2014451,1532891,2025-03-31,Senate,"FLOOR VOTE: Motion to Adopt",30,0,0,0,30
2014451,1538665,2025-04-07,House,"FLOOR VOTE: CONSENT CALENDAR PASSAGE ON THIRD CONSIDERATION",96,0,0,0,96
2014491,1532670,2025-03-31,Senate,"FLOOR VOTE: Motion to Adopt",30,0,0,0,30
2014491,1538525,2025-04-07,House,"FLOOR VOTE: CONSENT CALENDAR PASSAGE ON THIRD CONSIDERATION",96,0,0,0,96
2014531,1532817,2025-03-31,Senate,"FLOOR VOTE: Motion to Adopt",30,0,0,0,30
2014531,1538644,2025-04-07,House,"FLOOR VOTE: CONSENT CALENDAR PASSAGE ON THIRD CONSIDERATION",96,0,0,0,96
2014572,1531644,2025-03-31,House,"FLOOR VOTE: CONSENT CALENDAR PASSAGE ON THIRD CONSIDERATION",93,0,2,0,95
2014572,1539694,2025-04-07,Senate,"FLOOR VOTE: Motion to Adopt",32,0,0,0,32
2014612,1532011,2025-03-31,Senate,"FLOOR VOTE: Motion to Adopt",30,0,0,0,30
2014612,1539144,2025-04-07,House,"FLOOR VOTE: CONSENT CALENDAR PASSAGE ON THIRD CONSIDERATION",96,0,0,0,96
2014841,1535988,2025-04-03,Senate,"FLOOR VOTE: Motion to Adopt",30,0,0,0,30
2014914,1536538,2025-04-03,Senate,"FLOOR VOTE: Motion to Adopt",30,0,0,0,30
2015049,1536245,2025-04-03,House,"FLOOR VOTE: REGULAR CALENDAR MOTION TO ADOPT",89,0,0,0,89
2015049,1543440,2025-04-10,Senate,"FLOOR VOTE: Motion to Adopt",31,0,0,0,31
2015117,1531501,2025-03-31,House,"FLOOR VOTE: CONSENT CALENDAR PASSAGE ON THIRD CONSIDERATION",93,0,2,0,95
2015117,1539480,2025-04-07,Senate,"FLOOR VOTE: Motion to Adopt",32,0,0,0,32
2015182,1536598,2025-04-03,Senate,"FLOOR VOTE: Motion to Adopt",30,0,0,0,30
2015182,1538818,2025-04-07,House,"FLOOR VOTE: CONSENT CALENDAR PASSAGE ON THIRD CONSIDERATION",96,0,0,0,96
2015239,1541572,2025-04-09,House,"FLOOR VOTE: CONSENT CALENDAR PASSAGE ON THIRD CONSIDERATION",89,0,0,0,89
2015252,1536388,2025-04-03,Senate,"FLOOR VOTE: Motion to Adopt",30,0,0,0,30
2015255,1536753,2025-04-03,Senate,"FLOOR VOTE: Motion to Adopt",30,0,0,0,30
2015258,1535776,2025-04-03,Senate,"FLOOR VOTE: Motion to Adopt",30,0,0,0,30
2015258,1538673,2025-04-07,House,"FLOOR VOTE: CONSENT CALENDAR PASSAGE ON THIRD CONSIDERATION",96,0,0,0,96
2015261,1536905,2025-04-03,Senate,"FLOOR VOTE: Motion to Adopt",30,0,0,0,30
2015267,1536485,2025-04-03,Senate,"FLOOR VOTE: Motion to Adopt",30,0,0,0,30
2015270,1535856,2025-04-03,Senate,"FLOOR VOTE: Motion to Adopt",30,0,0,0,30
2015274,1536162,2025-04-03,Senate,"FLOOR VOTE: Motion to Adopt",30,0,0,0,30
2015280,1536341,2025-04-03,Senate,"FLOOR VOTE: Motion to Adopt",30,0,0,0,30
2015283,1536410,2025-04-03,Senate,"FLOOR VOTE: Motion to Adopt",30,0,0,0,30
2015289,1536235,2025-04-03,Senate,"FLOOR VOTE: Motion to Adopt",30,0,0,0,30
2015292,1536901,2025-04-03,Senate,"FLOOR VOTE: Motion to Adopt",30,0,0,0,30
2015296,1536164,2025-04-03,Senate,"FLOOR VOTE: Motion to Adopt",30,0,0,0,30
2015301,1536246,2025-04-03,Senate,"FLOOR VOTE: Motion to Adopt",30,0,0,0,30
2015304,1531103,2025-03-31,House,"FLOOR VOTE: CONSENT CALENDAR PASSAGE ON THIRD CONSIDERATION",93,0,2,0,95
2015304,1540048,2025-04-07,Senate,"FLOOR VOTE: Motion to Adopt",32,0,0,0,32
2015310,1536494,2025-04-03,Senate,"FLOOR VOTE: Motion to Adopt",30,0,0,0,30
2015313,1536055,2025-04-03,Senate,"FLOOR VOTE: Motion to Adopt",30,0,0,0,30
2015317,1536265,2025-04-03,Senate,"FLOOR VOTE: Motion to Adopt",30,0,0,0,30
2015320,1535942,2025-04-03,Senate,"FLOOR VOTE: Motion to Adopt",30,0,0,0,30
2015325,1536390,2025-04-03,Senate,"FLOOR VOTE: Motion to Adopt",30,0,0,0,30
2015334,1536125,2025-04-03,Senate,"FLOOR VOTE: Motion to Adopt",30,0,0,0,30
2015338,1536715,2025-04-03,Senate,"FLOOR VOTE: Motion to Adopt",30,0,0,0,30
2015341,1535908,2025-04-03,Senate,"FLOOR VOTE: Motion to Adopt",30,0,0,0,30
2015341,1539106,2025-04-07,House,"FLOOR VOTE: CONSENT CALENDAR PASSAGE ON THIRD CONSIDERATION",96,0,0,0,96
2015345,1536189,2025-04-03,Senate,"FLOOR VOTE: Motion to Adopt",30,0,0,0,30
2015350,1536900,2025-04-03,Senate,"FLOOR VOTE: Motion to Adopt",30,0,0,0,30
2015354,1536491,2025-04-03,Senate,"FLOOR VOTE: Motion to Adopt",30,0,0,0,30
2015358,1536228,2025-04-03,Senate,"FLOOR VOTE: Motion to Adopt",30,0,0,0,30
2015361,1536087,2025-04-03,Senate,"FLOOR VOTE: Motion to Adopt",30,0,0,0,30
2015364,1536338,2025-04-03,Senate,"FLOOR VOTE: Motion to Adopt",30,0,0,0,30
2015374,1536169,2025-04-03,Senate,"FLOOR VOTE: Motion to Adopt",30,0,0,0,30
2015377,1536392,2025-04-03,Senate,"FLOOR VOTE: Motion to Adopt",30,0,0,0,30
2015380,1535839,2025-04-03,Senate,"FLOOR VOTE: Motion to Adopt",30,0,0,0,30
2015383,1536518,2025-04-03,Senate,"FLOOR VOTE: Motion to Adopt",30,0,0,0,30
2015387,1536432,2025-04-03,Senate,"FLOOR VOTE: Motion to Adopt",30,0,0,0,30
2015394,1536188,2025-04-03,Senate,"FLOOR VOTE: Motion to Adopt",30,0,0,0,30
2015397,1531101,2025-03-31,House,"FLOOR VOTE: CONSENT CALENDAR PASSAGE ON THIRD CONSIDERATION",93,0,2,0,95
2015397,1540156,2025-04-07,Senate,"FLOOR VOTE: Motion to Adopt",32,0,0,0,32
2015400,1536155,2025-04-03,Senate,"FLOOR VOTE: Motion to Adopt",30,0,0,0,30
2015405,1536620,2025-04-03,Senate,"FLOOR VOTE: Motion to Adopt",30,0,0,0,30
2015414,1535765,2025-04-03,Senate,"FLOOR VOTE: Motion to Adopt",30,0,0,0,30
2015414,1538699,2025-04-07,House,"FLOOR VOTE: CONSENT CALENDAR PASSAGE ON THIRD CONSIDERATION",96,0,0,0,96
2015418,1536041,2025-04-03,Senate,"FLOOR VOTE: Motion to Adopt",30,0,0,0,30
2015421,1536260,2025-04-03,Senate,"FLOOR VOTE: Motion to Adopt",30,0,0,0,30
2015421,1538618,2025-04-07,House,"FLOOR VOTE: CONSENT CALENDAR PASSAGE ON THIRD CONSIDERATION",96,0,0,0,96
2015425,1535836,2025-04-03,Senate,"FLOOR VOTE: Motion to Adopt",30,0,0,0,30
2015429,1536319,2025-04-03,Senate,"FLOOR VOTE: Motion to Adopt",30,0,0,0,30
2015435,1536497,2025-04-03,Senate,"FLOOR VOTE: Motion to Adopt",30,0,0,0,30
2015439,1536394,2025-04-03,Senate,"FLOOR VOTE: Motion to Adopt",30,0,0,0,30
2015443,1536276,2025-04-03,Senate,"FLOOR VOTE: Motion to Adopt",30,0,0,0,30
2015443,1539173,2025-04-07,House,"FLOOR VOTE: CONSENT CALENDAR PASSAGE ON THIRD CONSIDERATION",96,0,0,0,96
2015447,1536370,2025-04-03,Senate,"FLOOR VOTE: Motion to Adopt",30,0,0,0,30
2015447,1538733,2025-04-07,House,"FLOOR VOTE: CONSENT CALENDAR PASSAGE ON THIRD CONSIDERATION",96,0,0,0,96
2015450,1536200,2025-04-03,Senate,"FLOOR VOTE: Motion to Adopt",30,0,0,0,30
2015450,1538481,2025-04-07,House,"FLOOR VOTE: CONSENT CALENDAR PASSAGE ON THIRD CONSIDERATION",96,0,0,0,96
2015456,1536948,2025-04-03,Senate,"FLOOR VOTE: Motion to Adopt",30,0,0,0,30
2015459,1536069,2025-04-03,Senate,"FLOOR VOTE: Motion to Adopt",30,0,0,0,30
2015466,1535897,2025-04-03,Senate,"FLOOR VOTE: Motion to Adopt",30,0,0,0,30
2015470,1536627,2025-04-03,Senate,"FLOOR VOTE: Motion to Adopt",30,0,0,0,30
2015470,1538538,2025-04-07,House,"FLOOR VOTE: CONSENT CALENDAR PASSAGE ON THIRD CONSIDERATION",96,0,0,0,96
2015474,1536090,2025-04-03,Senate,"FLOOR VOTE: Motion to Adopt",30,0,0,0,30
2015478,1536582,2025-04-03,Senate,"FLOOR VOTE: Motion to Adopt",30,0,0,0,30
2015481,1531054,2025-03-31,House,"FLOOR VOTE: CONSENT CALENDAR PASSAGE ON THIRD CONSIDERATION",93,0,2,0,95
2015481,1539256,2025-04-07,Senate,"FLOOR VOTE: Motion to Adopt",32,0,0,0,32
2015484,1536498,2025-04-03,Senate,"FLOOR VOTE: Motion to Adopt",30,0,0,0,30
2015484,1538732,2025-04-07,House,"FLOOR VOTE: CONSENT CALENDAR PASSAGE ON THIRD CONSIDERATION",96,0,0,0,96
2015487,1536385,2025-04-03,Senate,"FLOOR VOTE: Motion to Adopt",30,0,0,0,30
2015490,1535861,2025-04-03,Senate,"FLOOR VOTE: Motion to Adopt",30,0,0,0,30
2015653,1535792,2025-04-03,Senate,"FLOOR VOTE: Motion to Adopt",30,0,0,0,30
2015713,1539239,2025-04-07,Senate,"FLOOR VOTE: Motion to Adopt",32,0,0,0,32
2015745,1539390,2025-04-07,Senate,"FLOOR VOTE: Motion to Adopt",32,0,0,0,32
2015745,1544830,2025-04-10,House,"FLOOR VOTE: CONSENT CALENDAR PASSAGE ON THIRD CONSIDERATION",95,0,0,0,95
2015767,1539704,2025-04-07,Senate,"FLOOR VOTE: Motion to Adopt",32,0,0,0,32
2015767,1543858,2025-04-10,House,"FLOOR VOTE: CONSENT CALENDAR PASSAGE ON THIRD CONSIDERATION",95,0,0,0,95
2015789,1539996,2025-04-07,Senate,"FLOOR VOTE: Motion to Adopt",32,0,0,0,32
2015789,1544220,2025-04-10,House,"FLOOR VOTE: CONSENT CALENDAR PASSAGE ON THIRD CONSIDERATION",95,0,0,0,95
2015812,1531412,2025-03-31,House,"FLOOR VOTE: CONSENT CALENDAR PASSAGE ON THIRD CONSIDERATION",93,0,2,0,95
2015812,1539257,2025-04-07,Senate,"FLOOR VOTE: Motion to Adopt",32,0,0,0,32
2015835,1531420,2025-03-31,House,"FLOOR VOTE: CONSENT CALENDAR PASSAGE ON THIRD CONSIDERATION",93,0,2,0,95
2015835,1539263,2025-04-07,Senate,"FLOOR VOTE: Motion to Adopt",32,0,0,0,32
2015852,1530936,2025-03-31,House,"FLOOR VOTE: CONSENT CALENDAR PASSAGE ON THIRD CONSIDERATION",93,0,2,0,95
2015852,1540299,2025-04-07,Senate,"FLOOR VOTE: Motion to Adopt",32,0,0,0,32
2015876,1539943,2025-04-07,Senate,"FLOOR VOTE: Motion to Adopt",32,0,0,0,32
2015876,1544076,2025-04-10,House,"FLOOR VOTE: CONSENT CALENDAR PASSAGE ON THIRD CONSIDERATION",95,0,0,0,95
2015898,1539508,2025-04-07,Senate,"FLOOR VOTE: Motion to Adopt",32,0,0,0,32
2015898,1544989,2025-04-10,House,"FLOOR VOTE: CONSENT CALENDAR PASSAGE ON THIRD CONSIDERATION",95,0,0,0,95
2015943,1539272,2025-04-07,Senate,"FLOOR VOTE: Motion to Adopt",32,0,0,0,32
2015943,1544798,2025-04-10,House,"FLOOR VOTE: CONSENT CALENDAR PASSAGE ON THIRD CONSIDERATION",95,0,0,0,95
2015965,1539262,2025-04-07,Senate,"FLOOR VOTE: Motion to Adopt",32,0,0,0,32
2015965,1544784,2025-04-10,House,"FLOOR VOTE: CONSENT CALENDAR PASSAGE ON THIRD CONSIDERATION",95,0,0,0,95
2016577,1536192,2025-04-03,House,"FLOOR VOTE: CONSENT CALENDAR PASSAGE ON THIRD CONSIDERATION",91,0,0,0,91
2016577,1544786,2025-04-10,Senate,"FLOOR VOTE: Motion to Adopt",31,0,0,0,31
2016602,1541282,2025-04-08,Senate,"SENATE JUDICIARY COMMITTEE: Recommended for adoption, refer to Senate Calendar Committee",5,2,1,0,8
2016602,1550899,2025-04-16,Senate,"FLOOR VOTE: Motion to Adopt",26,7,0,0,33
2016845,1536505,2025-04-03,House,"FLOOR VOTE: CONSENT CALENDAR PASSAGE ON THIRD CONSIDERATION",91,0,0,0,91
2016857,1544631,2025-04-10,Senate,"FLOOR VOTE: Motion to Adopt",31,0,0,0,31
2016857,1549094,2025-04-15,House,"FLOOR VOTE: CONSENT CALENDAR PASSAGE ON THIRD CONSIDERATION",95,0,0,0,95
2016871,1535986,2025-04-03,House,"FLOOR VOTE: CONSENT CALENDAR PASSAGE ON THIRD CONSIDERATION",91,0,0,0,91
2016871,1543338,2025-04-10,Senate,"FLOOR VOTE: Motion to Adopt",31,0,0,0,31
2016883,1544046,2025-04-10,Senate,"FLOOR VOTE: Motion to Adopt",31,0,0,0,31
2016883,1549295,2025-04-15,House,"FLOOR VOTE: CONSENT CALENDAR PASSAGE ON THIRD CONSIDERATION",95,0,0,0,95
2016893,1544412,2025-04-10,Senate,"FLOOR VOTE: Motion to Adopt",31,0,0,0,31
2016893,1549373,2025-04-15,House,"FLOOR VOTE: CONSENT CALENDAR PASSAGE ON THIRD CONSIDERATION",95,0,0,0,95
2016905,1544789,2025-04-10,Senate,"FLOOR VOTE: Motion to Adopt",31,0,0,0,31
2016905,1549337,2025-04-15,House,"FLOOR VOTE: CONSENT CALENDAR PASSAGE ON THIRD CONSIDERATION",95,0,0,0,95
2016919,1536255,2025-04-03,House,"FLOOR VOTE: CONSENT CALENDAR PASSAGE ON THIRD CONSIDERATION",91,0,0,0,91
2016919,1543691,2025-04-10,Senate,"FLOOR VOTE: Motion to Adopt",31,0,0,0,31
2016936,1544474,2025-04-10,Senate,"FLOOR VOTE: Motion to Adopt",31,0,0,0,31
2016936,1549076,2025-04-15,House,"FLOOR VOTE: CONSENT CALENDAR PASSAGE ON THIRD CONSIDERATION",95,0,0,0,95
2016959,1544361,2025-04-10,Senate,"FLOOR VOTE: Motion to Adopt",31,0,0,0,31
2016959,1548980,2025-04-15,House,"FLOOR VOTE: CONSENT CALENDAR PASSAGE ON THIRD CONSIDERATION",95,0,0,0,95
2016970,1536294,2025-04-03,House,"FLOOR VOTE: CONSENT CALENDAR PASSAGE ON THIRD CONSIDERATION",91,0,0,0,91
2016970,1544627,2025-04-10,Senate,"FLOOR VOTE: Motion to Adopt",31,0,0,0,31
2016980,1544199,2025-04-10,Senate,"FLOOR VOTE: Motion to Adopt",31,0,0,0,31
2016980,1548871,2025-04-15,House,"FLOOR VOTE: CONSENT CALENDAR PASSAGE ON THIRD CONSIDERATION",95,0,0,0,95
2016991,1543663,2025-04-10,Senate,"FLOOR VOTE: Motion to Adopt",31,0,0,0,31
2017004,1544999,2025-04-10,Senate,"FLOOR VOTE: Motion to Adopt",31,0,0,0,31
2017004,1548795,2025-04-15,House,"FLOOR VOTE: CONSENT CALENDAR PASSAGE ON THIRD CONSIDERATION",95,0,0,0,95
2017015,1544705,2025-04-10,Senate,"FLOOR VOTE: Motion to Adopt",31,0,0,0,31
2017015,1549186,2025-04-15,House,"FLOOR VOTE: CONSENT CALENDAR PASSAGE ON THIRD CONSIDERATION",95,0,0,0,95
2017026,1536161,2025-04-03,House,"FLOOR VOTE: CONSENT CALENDAR PASSAGE ON THIRD CONSIDERATION",91,0,0,0,91
2017026,1544337,2025-04-10,Senate,"FLOOR VOTE: Motion to Adopt",31,0,0,0,31
2017066,1536100,2025-04-03,House,"FLOOR VOTE: CONSENT CALENDAR PASSAGE ON THIRD CONSIDERATION",91,0,0,0,91
2017066,1543851,2025-04-10,Senate,"FLOOR VOTE: Motion to Adopt",31,0,0,0,31
2017080,1535806,2025-04-03,House,"FLOOR VOTE: CONSENT CALENDAR PASSAGE ON THIRD CONSIDERATION",91,0,0,0,91
2017080,1543507,2025-04-10,Senate,"FLOOR VOTE: Motion to Adopt",31,0,0,0,31
2017097,1536453,2025-04-03,House,"FLOOR VOTE: CONSENT CALENDAR PASSAGE ON THIRD CONSIDERATION",91,0,0,0,91
2017097,1544862,2025-04-10,Senate,"FLOOR VOTE: Motion to Adopt",31,0,0,0,31
2017113,1536570,2025-04-03,House,"FLOOR VOTE: CONSENT CALENDAR PASSAGE ON THIRD CONSIDERATION",91,0,0,0,91
2017129,1536879,2025-04-03,House,"FLOOR VOTE: CONSENT CALENDAR PASSAGE ON THIRD CONSIDERATION",91,0,0,0,91
2017129,1543474,2025-04-10,Senate,"FLOOR VOTE: Motion to Adopt",31,0,0,0,31
2017147,1536182,2025-04-03,House,"FLOOR VOTE: CONSENT CALENDAR PASSAGE ON THIRD CONSIDERATION",91,0,0,0,91
2017147,1544820,2025-04-10,Senate,"FLOOR VOTE: Motion to Adopt",31,0,0,0,31
2017161,1536292,2025-04-03,House,"FLOOR VOTE: CONSENT CALENDAR PASSAGE ON THIRD CONSIDERATION",91,0,0,0,91
2017161,1544696,2025-04-10,Senate,"FLOOR VOTE: Motion to Adopt",31,0,0,0,31
2017179,1536690,2025-04-03,House,"FLOOR VOTE: CONSENT CALENDAR PASSAGE ON THIRD CONSIDERATION",91,0,0,0,91
2017179,1544939,2025-04-10,Senate,"FLOOR VOTE: Motion to Adopt",31,0,0,0,31
2017197,1536493,2025-04-03,House,"FLOOR VOTE: CONSENT CALENDAR PASSAGE ON THIRD CONSIDERATION",91,0,0,0,91
2017197,1544819,2025-04-10,Senate,"FLOOR VOTE: Motion to Adopt",31,0,0,0,31
2017214,1535955,2025-04-03,House,"FLOOR VOTE: CONSENT CALENDAR PASSAGE ON THIRD CONSIDERATION",91,0,0,0,91
2017214,1543411,2025-04-10,Senate,"FLOOR VOTE: Motion to Adopt",31,0,0,0,31
2017249,1536531,2025-04-03,House,"FLOOR VOTE: CONSENT CALENDAR PASSAGE ON THIRD CONSIDERATION",91,0,0,0,91
2017249,1543370,2025-04-10,Senate,"FLOOR VOTE: Motion to Adopt",31,0,0,0,31
2017266,1536449,2025-04-03,House,"FLOOR VOTE: CONSENT CALENDAR PASSAGE ON THIRD CONSIDERATION",91,0,0,0,91
2017266,1543869,2025-04-10,Senate,"FLOOR VOTE: Motion to Adopt",31,0,0,0,31
2017281,1536412,2025-04-03,House,"FLOOR VOTE: CONSENT CALENDAR PASSAGE ON THIRD CONSIDERATION",91,0,0,0,91
2017281,1544014,2025-04-10,Senate,"FLOOR VOTE: Motion to Adopt",31,0,0,0,31
2017301,1536287,2025-04-03,House,"FLOOR VOTE: CONSENT CALENDAR PASSAGE ON THIRD CONSIDERATION",91,0,0,0,91
2017318,1536086,2025-04-03,House,"FLOOR VOTE: CONSENT CALENDAR PASSAGE ON THIRD CONSIDERATION",91,0,0,0,91
2017318,1544381,2025-04-10,Senate,"FLOOR VOTE: Motion to Adopt",31,0,0,0,31
2017334,1535887,2025-04-03,House,"FLOOR VOTE: CONSENT CALENDAR PASSAGE ON THIRD CONSIDERATION",91,0,0,0,91
2017334,1544010,2025-04-10,Senate,"FLOOR VOTE: Motion to Adopt",31,0,0,0,31
2017352,1536530,2025-04-03,House,"FLOOR VOTE: CONSENT CALENDAR PASSAGE ON THIRD CONSIDERATION",91,0,0,0,91
2017352,1544865,2025-04-10,Senate,"FLOOR VOTE: Motion to Adopt",31,0,0,0,31
2017370,1536146,2025-04-03,House,"FLOOR VOTE: CONSENT CALENDAR PASSAGE ON THIRD CONSIDERATION",91,0,0,0,91
2017370,1544506,2025-04-10,Senate,"FLOOR VOTE: Motion to Adopt",31,0,0,0,31
2017388,1536609,2025-04-03,House,"FLOOR VOTE: CONSENT CALENDAR PASSAGE ON THIRD CONSIDERATION",91,0,0,0,91
2017388,1544771,2025-04-10,Senate,"FLOOR VOTE: Motion to Adopt",31,0,0,0,31
2017406,1544921,2025-04-10,Senate,"FLOOR VOTE: Motion to Adopt",31,0,0,0,31
2017406,1548863,2025-04-15,House,"FLOOR VOTE: CONSENT CALENDAR PASSAGE ON THIRD CONSIDERATION",95,0,0,0,95
2017420,1531364,2025-03-31,House,"FLOOR VOTE: MOTION TO ADOPT",83,7,3,0,93
2017439,1535868,2025-04-03,House,"FLOOR VOTE: CONSENT CALENDAR PASSAGE ON THIRD CONSIDERATION",91,0,0,0,91
2017439,1544060,2025-04-10,Senate,"FLOOR VOTE: Motion to Adopt",31,0,0,0,31
2017457,1544583,2025-04-10,Senate,"FLOOR VOTE: Motion to Adopt",31,0,0,0,31
2017457,1549128,2025-04-15,House,"FLOOR VOTE: CONSENT CALENDAR PASSAGE ON THIRD CONSIDERATION",95,0,0,0,95
2017472,1536831,2025-04-03,House,"FLOOR VOTE: CONSENT CALENDAR PASSAGE ON THIRD CONSIDERATION",91,0,0,0,91
2017488,1536401,2025-04-03,House,"FLOOR VOTE: CONSENT CALENDAR PASSAGE ON THIRD CONSIDERATION",91,0,0,0,91
2017488,1543340,2025-04-10,Senate,"FLOOR VOTE: Motion to Adopt",31,0,0,0,31
2017526,1536411,2025-04-03,House,"FLOOR VOTE: CONSENT CALENDAR PASSAGE ON THIRD CONSIDERATION",91,0,0,0,91
2017526,1544334,2025-04-10,Senate,"FLOOR VOTE: Motion to Adopt",31,0,0,0,31
2017543,1536170,2025-04-03,House,"FLOOR VOTE: CONSENT CALENDAR PASSAGE ON THIRD CONSIDERATION",91,0,0,0,91
2017543,1544435,2025-04-10,Senate,"FLOOR VOTE: Motion to Adopt",31,0,0,0,31
2017560,1536597,2025-04-03,House,"FLOOR VOTE: CONSENT CALENDAR PASSAGE ON THIRD CONSIDERATION",91,0,0,0,91
2017560,1544453,2025-04-10,Senate,"FLOOR VOTE: Motion to Adopt",31,0,0,0,31
2017578,1536283,2025-04-03,House,"FLOOR VOTE: CONSENT CALENDAR PASSAGE ON THIRD CONSIDERATION",91,0,0,0,91
2017578,1544716,2025-04-10,Senate,"FLOOR VOTE: Motion to Adopt",31,0,0,0,31
2017676,1538439,2025-04-07,House,"FLOOR VOTE: CONSENT CALENDAR PASSAGE ON THIRD CONSIDERATION",96,0,0,0,96
2017676,1548301,2025-04-14,Senate,"FLOOR VOTE: Motion to Adopt",32,0,0,0,32
2017704,1543630,2025-04-10,Senate,"FLOOR VOTE: Motion to Adopt",31,0,0,0,31
2017704,1549442,2025-04-15,House,"FLOOR VOTE: CONSENT CALENDAR PASSAGE ON THIRD CONSIDERATION",95,0,0,0,95
2017733,1543666,2025-04-10,Senate,"FLOOR VOTE: Motion to Adopt",31,0,0,0,31
2017733,1548696,2025-04-15,House,"FLOOR VOTE: CONSENT CALENDAR PASSAGE ON THIRD CONSIDERATION",95,0,0,0,95
2017765,1544198,2025-04-10,Senate,"FLOOR VOTE: Motion to Adopt",31,0,0,0,31
2017765,1548808,2025-04-15,House,"FLOOR VOTE: CONSENT CALENDAR PASSAGE ON THIRD CONSIDERATION",95,0,0,0,95
2017795,1543882,2025-04-10,Senate,"FLOOR VOTE: Motion to Adopt",31,0,0,0,31
2017831,1544592,2025-04-10,Senate,"FLOOR VOTE: Motion to Adopt",31,0,0,0,31
2017831,1549248,2025-04-15,House,"FLOOR VOTE: CONSENT CALENDAR PASSAGE ON THIRD CONSIDERATION",95,0,0,0,95
2017861,1544023,2025-04-10,Senate,"FLOOR VOTE: Motion to Adopt",31,0,0,0,31
2017861,1549375,2025-04-15,House,"FLOOR VOTE: CONSENT CALENDAR PASSAGE ON THIRD CONSIDERATION",95,0,0,0,95
2017896,1538834,2025-04-07,House,"FLOOR VOTE: CONSENT CALENDAR PASSAGE ON THIRD CONSIDERATION",96,0,0,0,96
2017923,1539180,2025-04-07,House,"FLOOR VOTE: CONSENT CALENDAR PASSAGE ON THIRD CONSIDERATION",96,0,0,0,96
2017923,1548097,2025-04-14,Senate,"FLOOR VOTE: Motion to Adopt",32,0,0,0,32
2017962,1544011,2025-04-10,Senate,"FLOOR VOTE: Motion to Adopt",31,0,0,0,31
2017962,1548887,2025-04-15,House,"FLOOR VOTE: CONSENT CALENDAR PASSAGE ON THIRD CONSIDERATION",95,0,0,0,95
2017992,1539065,2025-04-07,House,"FLOOR VOTE: CONSENT CALENDAR PASSAGE ON THIRD CONSIDERATION",96,0,0,0,96
2017992,1548278,2025-04-14,Senate,"FLOOR VOTE: Motion to Adopt",32,0,0,0,32
2018022,1539178,2025-04-07,House,"FLOOR VOTE: CONSENT CALENDAR PASSAGE ON THIRD CONSIDERATION",96,0,0,0,96
2018022,1548343,2025-04-14,Senate,"FLOOR VOTE: Motion to Adopt",32,0,0,0,32
2018056,1544984,2025-04-10,Senate,"FLOOR VOTE: Motion to Adopt",31,0,0,0,31
2018056,1549294,2025-04-15,House,"FLOOR VOTE: CONSENT CALENDAR PASSAGE ON THIRD CONSIDERATION",95,0,0,0,95
2018086,1543743,2025-04-10,Senate,"FLOOR VOTE: Motion to Adopt",31,0,0,0,31
2018086,1549444,2025-04-15,House,"FLOOR VOTE: CONSENT CALENDAR PASSAGE ON THIRD CONSIDERATION",95,0,0,0,95
2018120,1543439,2025-04-10,Senate,"FLOOR VOTE: Motion to Adopt",31,0,0,0,31
2018120,1548925,2025-04-15,House,"FLOOR VOTE: CONSENT CALENDAR PASSAGE ON THIRD CONSIDERATION",95,0,0,0,95
2018154,1545006,2025-04-10,Senate,"FLOOR VOTE: Motion to Adopt",31,0,0,0,31
2018154,1549308,2025-04-15,House,"FLOOR VOTE: CONSENT CALENDAR PASSAGE ON THIRD CONSIDERATION",95,0,0,0,95
2018188,1543975,2025-04-10,Senate,"FLOOR VOTE: Motion to Adopt",31,0,0,0,31
2018188,1548589,2025-04-15,House,"FLOOR VOTE: CONSENT CALENDAR PASSAGE ON THIRD CONSIDERATION",95,0,0,0,95
2018222,1538383,2025-04-07,House,"FLOOR VOTE: CONSENT CALENDAR PASSAGE ON THIRD CONSIDERATION",96,0,0,0,96
2018254,1538690,2025-04-07,House,"FLOOR VOTE: CONSENT CALENDAR PASSAGE ON THIRD CONSIDERATION",96,0,0,0,96
2018254,1548107,2025-04-14,Senate,"FLOOR VOTE: Motion to Adopt",32,0,0,0,32
2018317,1538514,2025-04-07,House,"FLOOR VOTE: CONSENT CALENDAR PASSAGE ON THIRD CONSIDERATION",96,0,0,0,96
2018347,1544278,2025-04-10,Senate,"FLOOR VOTE: Motion to Adopt",31,0,0,0,31
2018347,1549259,2025-04-15,House,"FLOOR VOTE: CONSENT CALENDAR PASSAGE ON THIRD CONSIDERATION",95,0,0,0,95
2018385,1549908,2025-04-16,House,"HOUSE PRIVATE ACTS COMMITTEE: Rec. for pass; ref to State & Local Government Committee",10,0,0,0,10
2018385,1549909,2025-04-16,House,"HOUSE STATE & LOCAL GOVERNMENT COMMITTEE: Rec. for pass; ref to Calendar & Rules Committee",17,0,0,0,17
2018385,1554169,2025-04-21,House,"FLOOR VOTE: CONSENT CALENDAR PASSAGE ON THIRD CONSIDERATION",86,0,1,0,87
2018667,1539008,2025-04-07,House,"FLOOR VOTE: CONSENT CALENDAR PASSAGE ON THIRD CONSIDERATION",96,0,0,0,96
2018667,1548213,2025-04-14,Senate,"FLOOR VOTE: Motion to Adopt",32,0,0,0,32
2018708,1539187,2025-04-07,House,"FLOOR VOTE: CONSENT CALENDAR PASSAGE ON THIRD CONSIDERATION",96,0,0,0,96
2018748,1539095,2025-04-07,House,"FLOOR VOTE: CONSENT CALENDAR PASSAGE ON THIRD CONSIDERATION",96,0,0,0,96
2018748,1548201,2025-04-14,Senate,"FLOOR VOTE: Motion to Adopt",32,0,0,0,32
2018792,1553060,2025-04-21,Senate,"FLOOR VOTE: Motion to Adopt",32,0,0,0,32
2018833,1543401,2025-04-10,Senate,"FLOOR VOTE: Motion to Adopt",31,0,0,0,31
2018833,1549318,2025-04-15,House,"FLOOR VOTE: CONSENT CALENDAR PASSAGE ON THIRD CONSIDERATION",95,0,0,0,95
2018873,1539167,2025-04-07,House,"FLOOR VOTE: CONSENT CALENDAR PASSAGE ON THIRD CONSIDERATION",96,0,0,0,96
2018873,1548072,2025-04-14,Senate,"FLOOR VOTE: Motion to Adopt",32,0,0,0,32
2018899,1544853,2025-04-10,Senate,"FLOOR VOTE: Motion to Adopt",31,0,0,0,31
2018899,1548602,2025-04-15,House,"FLOOR VOTE: CONSENT CALENDAR PASSAGE ON THIRD CONSIDERATION",95,0,0,0,95
2018915,1543834,2025-04-10,Senate,"FLOOR VOTE: Motion to Adopt",31,0,0,0,31
2018915,1549339,2025-04-15,House,"FLOOR VOTE: CONSENT CALENDAR PASSAGE ON THIRD CONSIDERATION",95,0,0,0,95
2018933,1543387,2025-04-10,Senate,"FLOOR VOTE: Motion to Adopt",31,0,0,0,31
2018933,1549246,2025-04-15,House,"FLOOR VOTE: CONSENT CALENDAR PASSAGE ON THIRD CONSIDERATION",95,0,0,0,95
2018951,1543884,2025-04-10,Senate,"FLOOR VOTE: Motion to Adopt",31,0,0,0,31
2018951,1549446,2025-04-15,House,"FLOOR VOTE: CONSENT CALENDAR PASSAGE ON THIRD CONSIDERATION",95,0,0,0,95
2018970,1545089,2025-04-10,Senate,"FLOOR VOTE: Motion to Adopt",31,0,0,0,31
2018970,1549298,2025-04-15,House,"FLOOR VOTE: CONSENT CALENDAR PASSAGE ON THIRD CONSIDERATION",95,0,0,0,95
2018987,1543921,2025-04-10,Senate,"FLOOR VOTE: Motion to Adopt",31,0,0,0,31
2018987,1548551,2025-04-15,House,"FLOOR VOTE: CONSENT CALENDAR PASSAGE ON THIRD CONSIDERATION",95,0,0,0,95
2019006,1543368,2025-04-10,Senate,"FLOOR VOTE: Motion to Adopt",31,0,0,0,31
2019006,1549342,2025-04-15,House,"FLOOR VOTE: CONSENT CALENDAR PASSAGE ON THIRD CONSIDERATION",95,0,0,0,95
2019022,1543927,2025-04-10,Senate,"FLOOR VOTE: Motion to Adopt",31,0,0,0,31
2019022,1548915,2025-04-15,House,"FLOOR VOTE: CONSENT CALENDAR PASSAGE ON THIRD CONSIDERATION",95,0,0,0,95
2019040,1544433,2025-04-10,Senate,"FLOOR VOTE: Motion to Adopt",31,0,0,0,31
2019040,1549010,2025-04-15,House,"FLOOR VOTE: CONSENT CALENDAR PASSAGE ON THIRD CONSIDERATION",95,0,0,0,95
2019060,1543565,2025-04-10,Senate,"FLOOR VOTE: Motion to Adopt",31,0,0,0,31
2019060,1549273,2025-04-15,House,"FLOOR VOTE: CONSENT CALENDAR PASSAGE ON THIRD CONSIDERATION",95,0,0,0,95
2019076,1543577,2025-04-10,Senate,"FLOOR VOTE: Motion to Adopt",31,0,0,0,31
2019076,1549174,2025-04-15,House,"FLOOR VOTE: CONSENT CALENDAR PASSAGE ON THIRD CONSIDERATION",95,0,0,0,95
2019094,1544039,2025-04-10,Senate,"FLOOR VOTE: Motion to Adopt",31,0,0,0,31
2019094,1548749,2025-04-15,House,"FLOOR VOTE: CONSENT CALENDAR PASSAGE ON THIRD CONSIDERATION",95,0,0,0,95
2019112,1544548,2025-04-10,Senate,"FLOOR VOTE: Motion to Adopt",31,0,0,0,31
2019112,1548618,2025-04-15,House,"FLOOR VOTE: CONSENT CALENDAR PASSAGE ON THIRD CONSIDERATION",95,0,0,0,95
2019129,1543623,2025-04-10,Senate,"FLOOR VOTE: Motion to Adopt",31,0,0,0,31
2019129,1548771,2025-04-15,House,"FLOOR VOTE: CONSENT CALENDAR PASSAGE ON THIRD CONSIDERATION",95,0,0,0,95
2019148,1544577,2025-04-10,Senate,"FLOOR VOTE: Motion to Adopt",31,0,0,0,31
2019148,1548686,2025-04-15,House,"FLOOR VOTE: CONSENT CALENDAR PASSAGE ON THIRD CONSIDERATION",95,0,0,0,95
2019167,1544160,2025-04-10,Senate,"FLOOR VOTE: Motion to Adopt",31,0,0,0,31
2019186,1543781,2025-04-10,Senate,"FLOOR VOTE: Motion to Adopt",31,0,0,0,31
2019186,1548757,2025-04-15,House,"FLOOR VOTE: CONSENT CALENDAR PASSAGE ON THIRD CONSIDERATION",95,0,0,0,95
2019204,1543541,2025-04-10,Senate,"FLOOR VOTE: Motion to Adopt",31,0,0,0,31
2019204,1549193,2025-04-15,House,"FLOOR VOTE: CONSENT CALENDAR PASSAGE ON THIRD CONSIDERATION",95,0,0,0,95
2019219,1543903,2025-04-10,Senate,"FLOOR VOTE: Motion to Adopt",31,0,0,0,31
2019219,1549429,2025-04-15,House,"FLOOR VOTE: CONSENT CALENDAR PASSAGE ON THIRD CONSIDERATION",95,0,0,0,95
2019234,1543917,2025-04-10,Senate,"FLOOR VOTE: Motion to Adopt",31,0,0,0,31
2019234,1548553,2025-04-15,House,"FLOOR VOTE: CONSENT CALENDAR PASSAGE ON THIRD CONSIDERATION",95,0,0,0,95
2019255,1539190,2025-04-07,House,"FLOOR VOTE: CONSENT CALENDAR PASSAGE ON THIRD CONSIDERATION",96,0,0,0,96
2019255,1548087,2025-04-14,Senate,"FLOOR VOTE: Motion to Adopt",32,0,0,0,32
2019266,1539110,2025-04-07,House,"FLOOR VOTE: CONSENT CALENDAR PASSAGE ON THIRD CONSIDERATION",96,0,0,0,96
2019266,1548010,2025-04-14,Senate,"FLOOR VOTE: Motion to Adopt",32,0,0,0,32
2019279,1539194,2025-04-07,House,"FLOOR VOTE: CONSENT CALENDAR PASSAGE ON THIRD CONSIDERATION",96,0,0,0,96
2019279,1548131,2025-04-14,Senate,"FLOOR VOTE: Motion to Adopt",32,0,0,0,32
2019293,1539157,2025-04-07,House,"FLOOR VOTE: CONSENT CALENDAR PASSAGE ON THIRD CONSIDERATION",96,0,0,0,96
2019293,1548295,2025-04-14,Senate,"FLOOR VOTE: Motion to Adopt",32,0,0,0,32
2019306,1539177,2025-04-07,House,"FLOOR VOTE: CONSENT CALENDAR PASSAGE ON THIRD CONSIDERATION",96,0,0,0,96
2019306,1548113,2025-04-14,Senate,"FLOOR VOTE: Motion to Adopt",32,0,0,0,32
2019317,1538906,2025-04-07,House,"FLOOR VOTE: CONSENT CALENDAR PASSAGE ON THIRD CONSIDERATION",96,0,0,0,96
2019317,1548204,2025-04-14,Senate,"FLOOR VOTE: Motion to Adopt",32,0,0,0,32
2019330,1539192,2025-04-07,House,"FLOOR VOTE: CONSENT CALENDAR PASSAGE ON THIRD CONSIDERATION",96,0,0,0,96
2019330,1548643,2025-04-14,Senate,"FLOOR VOTE: Motion to Adopt",32,0,0,0,32
2019343,1544571,2025-04-10,Senate,"FLOOR VOTE: Motion to Adopt",31,0,0,0,31
2019343,1548679,2025-04-15,House,"FLOOR VOTE: CONSENT CALENDAR PASSAGE ON THIRD CONSIDERATION",95,0,0,0,95
2019355,1543636,2025-04-10,Senate,"FLOOR VOTE: Motion to Adopt",31,0,0,0,31
2019355,1549453,2025-04-15,House,"FLOOR VOTE: CONSENT CALENDAR PASSAGE ON THIRD CONSIDERATION",95,0,0,0,95
2019367,1539186,2025-04-07,House,"FLOOR VOTE: CONSENT CALENDAR PASSAGE ON THIRD CONSIDERATION",96,0,0,0,96
2019367,1548404,2025-04-14,Senate,"FLOOR VOTE: Motion to Adopt",32,0,0,0,32
2019378,1539156,2025-04-07,House,"FLOOR VOTE: CONSENT CALENDAR PASSAGE ON THIRD CONSIDERATION",96,0,0,0,96
2019378,1548451,2025-04-14,Senate,"FLOOR VOTE: Motion to Adopt",32,0,0,0,32
2019659,1539122,2025-04-07,House,"FLOOR VOTE: CONSENT CALENDAR PASSAGE ON THIRD CONSIDERATION",96,0,0,0,96
2019662,1538757,2025-04-07,House,"FLOOR VOTE: CONSENT CALENDAR PASSAGE ON THIRD CONSIDERATION",96,0,0,0,96
2019662,1548023,2025-04-14,Senate,"FLOOR VOTE: Motion to Adopt",32,0,0,0,32
2019666,1539204,2025-04-07,House,"FLOOR VOTE: CONSENT CALENDAR PASSAGE ON THIRD CONSIDERATION",96,0,0,0,96
2019671,1538570,2025-04-07,House,"FLOOR VOTE: CONSENT CALENDAR PASSAGE ON THIRD CONSIDERATION",96,0,0,0,96
2019671,1548054,2025-04-14,Senate,"FLOOR VOTE: Motion to Adopt",32,0,0,0,32
2019676,1538860,2025-04-07,House,"FLOOR VOTE: CONSENT CALENDAR PASSAGE ON THIRD CONSIDERATION",96,0,0,0,96
2019676,1548754,2025-04-14,Senate,"FLOOR VOTE: Motion to Adopt",32,0,0,0,32
2019684,1538368,2025-04-07,House,"FLOOR VOTE: CONSENT CALENDAR PASSAGE ON THIRD CONSIDERATION",96,0,0,0,96
2019688,1538501,2025-04-07,House,"FLOOR VOTE: CONSENT CALENDAR PASSAGE ON THIRD CONSIDERATION",96,0,0,0,96
2019693,1539043,2025-04-07,House,"FLOOR VOTE: CONSENT CALENDAR PASSAGE ON THIRD CONSIDERATION",96,0,0,0,96
2019698,1539053,2025-04-07,House,"FLOOR VOTE: CONSENT CALENDAR PASSAGE ON THIRD CONSIDERATION",96,0,0,0,96
2019698,1548116,2025-04-14,Senate,"FLOOR VOTE: Motion to Adopt",32,0,0,0,32
2019708,1538474,2025-04-07,House,"FLOOR VOTE: CONSENT CALENDAR PASSAGE ON THIRD CONSIDERATION",96,0,0,0,96
2019708,1548707,2025-04-14,Senate,"FLOOR VOTE: Motion to Adopt",32,0,0,0,32
2019717,1548162,2025-04-14,Senate,"FLOOR VOTE: Motion to Adopt",32,0,0,0,32
2019717,1550653,2025-04-16,House,"FLOOR VOTE: CONSENT CALENDAR PASSAGE ON THIRD CONSIDERATION",96,0,0,0,96
2019721,1538696,2025-04-07,House,"FLOOR VOTE: CONSENT CALENDAR PASSAGE ON THIRD CONSIDERATION",96,0,0,0,96
2019725,1539029,2025-04-07,House,"FLOOR VOTE: CONSENT CALENDAR PASSAGE ON THIRD CONSIDERATION",96,0,0,0,96
2019725,1548183,2025-04-14,Senate,"FLOOR VOTE: Motion to Adopt",32,0,0,0,32
2019731,1538859,2025-04-07,House,"FLOOR VOTE: CONSENT CALENDAR PASSAGE ON THIRD CONSIDERATION",96,0,0,0,96
2019731,1548126,2025-04-14,Senate,"FLOOR VOTE: Motion to Adopt",32,0,0,0,32
2019743,1538613,2025-04-07,House,"FLOOR VOTE: CONSENT CALENDAR PASSAGE ON THIRD CONSIDERATION",96,0,0,0,96
2019743,1548165,2025-04-14,Senate,"FLOOR VOTE: Motion to Adopt",32,0,0,0,32
2019750,1539175,2025-04-07,House,"FLOOR VOTE: CONSENT CALENDAR PASSAGE ON THIRD CONSIDERATION",96,0,0,0,96
2019754,1539223,2025-04-07,House,"FLOOR VOTE: CONSENT CALENDAR PASSAGE ON THIRD CONSIDERATION",96,0,0,0,96
2019754,1548012,2025-04-14,Senate,"FLOOR VOTE: Motion to Adopt",32,0,0,0,32
2019760,1548008,2025-04-14,Senate,"FLOOR VOTE: Motion to Adopt",32,0,0,0,32
2019760,1550216,2025-04-16,House,"FLOOR VOTE: CONSENT CALENDAR PASSAGE ON THIRD CONSIDERATION",96,0,0,0,96
2019769,1539181,2025-04-07,House,"FLOOR VOTE: CONSENT CALENDAR PASSAGE ON THIRD CONSIDERATION",96,0,0,0,96
2019769,1548153,2025-04-14,Senate,"FLOOR VOTE: Motion to Adopt",32,0,0,0,32
2019777,1548016,2025-04-14,Senate,"FLOOR VOTE: Motion to Adopt",32,0,0,0,32
2019777,1550241,2025-04-16,House,"FLOOR VOTE: CONSENT CALENDAR PASSAGE ON THIRD CONSIDERATION",96,0,0,0,96
2019783,1539125,2025-04-07,House,"FLOOR VOTE: CONSENT CALENDAR PASSAGE ON THIRD CONSIDERATION",96,0,0,0,96
2019788,1539206,2025-04-07,House,"FLOOR VOTE: CONSENT CALENDAR PASSAGE ON THIRD CONSIDERATION",96,0,0,0,96
2019796,1539152,2025-04-07,House,"FLOOR VOTE: CONSENT CALENDAR PASSAGE ON THIRD CONSIDERATION",96,0,0,0,96
2019802,1548129,2025-04-14,Senate,"FLOOR VOTE: Motion to Adopt",32,0,0,0,32
2019802,1550611,2025-04-16,House,"FLOOR VOTE: CONSENT CALENDAR PASSAGE ON THIRD CONSIDERATION",96,0,0,0,96
2019810,1539170,2025-04-07,House,"FLOOR VOTE: CONSENT CALENDAR PASSAGE ON THIRD CONSIDERATION",96,0,0,0,96
2019814,1539009,2025-04-07,House,"FLOOR VOTE: CONSENT CALENDAR PASSAGE ON THIRD CONSIDERATION",96,0,0,0,96
2019821,1548219,2025-04-14,Senate,"FLOOR VOTE: Motion to Adopt",32,0,0,0,32
2019821,1550157,2025-04-16,House,"FLOOR VOTE: CONSENT CALENDAR PASSAGE ON THIRD CONSIDERATION",96,0,0,0,96
2019829,1538814,2025-04-07,House,"FLOOR VOTE: CONSENT CALENDAR PASSAGE ON THIRD CONSIDERATION",96,0,0,0,96
2019829,1548002,2025-04-14,Senate,"FLOOR VOTE: Motion to Adopt",32,0,0,0,32
2019841,1538850,2025-04-07,House,"FLOOR VOTE: CONSENT CALENDAR PASSAGE ON THIRD CONSIDERATION",96,0,0,0,96
2019847,1539138,2025-04-07,House,"FLOOR VOTE: CONSENT CALENDAR PASSAGE ON THIRD CONSIDERATION",96,0,0,0,96
2019847,1548105,2025-04-14,Senate,"FLOOR VOTE: Motion to Adopt",32,0,0,0,32
2019851,1538426,2025-04-07,House,"FLOOR VOTE: CONSENT CALENDAR PASSAGE ON THIRD CONSIDERATION",96,0,0,0,96
2019860,1539113,2025-04-07,House,"FLOOR VOTE: CONSENT CALENDAR PASSAGE ON THIRD CONSIDERATION",96,0,0,0,96
2019860,1548227,2025-04-14,Senate,"FLOOR VOTE: Motion to Adopt",32,0,0,0,32
2019866,1538855,2025-04-07,House,"FLOOR VOTE: CONSENT CALENDAR PASSAGE ON THIRD CONSIDERATION",96,0,0,0,96
2019873,1538830,2025-04-07,House,"FLOOR VOTE: CONSENT CALENDAR PASSAGE ON THIRD CONSIDERATION",96,0,0,0,96
2019878,1539118,2025-04-07,House,"FLOOR VOTE: CONSENT CALENDAR PASSAGE ON THIRD CONSIDERATION",96,0,0,0,96
2019887,1539216,2025-04-07,House,"FLOOR VOTE: CONSENT CALENDAR PASSAGE ON THIRD CONSIDERATION",96,0,0,0,96
2019887,1548407,2025-04-14,Senate,"FLOOR VOTE: Motion to Adopt",32,0,0,0,32
2019893,1539141,2025-04-07,House,"FLOOR VOTE: CONSENT CALENDAR PASSAGE ON THIRD CONSIDERATION",96,0,0,0,96
2019897,1538650,2025-04-07,House,"FLOOR VOTE: CONSENT CALENDAR PASSAGE ON THIRD CONSIDERATION",96,0,0,0,96
2019897,1548109,2025-04-14,Senate,"FLOOR VOTE: Motion to Adopt",32,0,0,0,32
2019905,1538669,2025-04-07,House,"FLOOR VOTE: CONSENT CALENDAR PASSAGE ON THIRD CONSIDERATION",96,0,0,0,96
2019913,1548086,2025-04-14,Senate,"FLOOR VOTE: Motion to Adopt",32,0,0,0,32
2019913,1550538,2025-04-16,House,"FLOOR VOTE: CONSENT CALENDAR PASSAGE ON THIRD CONSIDERATION",96,0,0,0,96
2019918,1538313,2025-04-07,House,"FLOOR VOTE: CONSENT CALENDAR PASSAGE ON THIRD CONSIDERATION",96,0,0,0,96
2019918,1548188,2025-04-14,Senate,"FLOOR VOTE: Motion to Adopt",32,0,0,0,32
2019923,1539002,2025-04-07,House,"FLOOR VOTE: CONSENT CALENDAR PASSAGE ON THIRD CONSIDERATION",96,0,0,0,96
2019923,1548024,2025-04-14,Senate,"FLOOR VOTE: Motion to Adopt",32,0,0,0,32
2019930,1539171,2025-04-07,House,"FLOOR VOTE: CONSENT CALENDAR PASSAGE ON THIRD CONSIDERATION",96,0,0,0,96
2019937,1538796,2025-04-07,House,"FLOOR VOTE: CONSENT CALENDAR PASSAGE ON THIRD CONSIDERATION",96,0,0,0,96
2019937,1548051,2025-04-14,Senate,"FLOOR VOTE: Motion to Adopt",32,0,0,0,32
2019945,1538861,2025-04-07,House,"FLOOR VOTE: CONSENT CALENDAR PASSAGE ON THIRD CONSIDERATION",96,0,0,0,96
2019945,1548057,2025-04-14,Senate,"FLOOR VOTE: Motion to Adopt",32,0,0,0,32
2019950,1539061,2025-04-07,House,"FLOOR VOTE: CONSENT CALENDAR PASSAGE ON THIRD CONSIDERATION",96,0,0,0,96
2019955,1539058,2025-04-07,House,"FLOOR VOTE: CONSENT CALENDAR PASSAGE ON THIRD CONSIDERATION",96,0,0,0,96
2019955,1548283,2025-04-14,Senate,"FLOOR VOTE: Motion to Adopt",32,0,0,0,32
2019963,1539091,2025-04-07,House,"FLOOR VOTE: CONSENT CALENDAR PASSAGE ON THIRD CONSIDERATION",96,0,0,0,96
2019971,1539174,2025-04-07,House,"FLOOR VOTE: CONSENT CALENDAR PASSAGE ON THIRD CONSIDERATION",96,0,0,0,96
2019977,1548110,2025-04-14,Senate,"FLOOR VOTE: Motion to Adopt",32,0,0,0,32
2019977,1550587,2025-04-16,House,"FLOOR VOTE: CONSENT CALENDAR PASSAGE ON THIRD CONSIDERATION",96,0,0,0,96
2019981,1539188,2025-04-07,House,"FLOOR VOTE: CONSENT CALENDAR PASSAGE ON THIRD CONSIDERATION",96,0,0,0,96
2019987,1538418,2025-04-07,House,"FLOOR VOTE: CONSENT CALENDAR PASSAGE ON THIRD CONSIDERATION",96,0,0,0,96
2019987,1548075,2025-04-14,Senate,"FLOOR VOTE: Motion to Adopt",32,0,0,0,32
2019995,1539136,2025-04-07,House,"FLOOR VOTE: CONSENT CALENDAR PASSAGE ON THIRD CONSIDERATION",96,0,0,0,96
2020001,1538870,2025-04-07,House,"FLOOR VOTE: CONSENT CALENDAR PASSAGE ON THIRD CONSIDERATION",96,0,0,0,96
2020001,1548237,2025-04-14,Senate,"FLOOR VOTE: Motion to Adopt",32,0,0,0,32
2020006,1539161,2025-04-07,House,"FLOOR VOTE: CONSENT CALENDAR PASSAGE ON THIRD CONSIDERATION",96,0,0,0,96
2020012,1548568,2025-04-14,Senate,"FLOOR VOTE: Motion to Adopt",32,0,0,0,32
2020012,1550877,2025-04-16,House,"FLOOR VOTE: CONSENT CALENDAR PASSAGE ON THIRD CONSIDERATION",96,0,0,0,96
2020973,1542101,2025-04-09,House,"FLOOR VOTE: CONSENT CALENDAR PASSAGE ON THIRD CONSIDERATION",89,0,0,0,89
2021004,1543095,2025-04-09,House,"FLOOR VOTE: CONSENT CALENDAR PASSAGE ON THIRD CONSIDERATION",89,0,0,0,89
2021004,1548672,2025-04-14,Senate,"FLOOR VOTE: Motion to Adopt",32,0,0,0,32
2021034,1548716,2025-04-14,Senate,"FLOOR VOTE: Motion to Adopt",32,0,0,0,32
2021044,1548134,2025-04-14,Senate,"FLOOR VOTE: Motion to Adopt",32,0,0,0,32
2021048,1548199,2025-04-14,Senate,"FLOOR VOTE: Motion to Adopt",32,0,0,0,32
2021048,1550707,2025-04-16,House,"FLOOR VOTE: CONSENT CALENDAR PASSAGE ON THIRD CONSIDERATION",96,0,0,0,96
2021053,1542948,2025-04-09,House,"FLOOR VOTE: CONSENT CALENDAR PASSAGE ON THIRD CONSIDERATION",89,0,0,0,89
2021053,1548106,2025-04-14,Senate,"FLOOR VOTE: Motion to Adopt",32,0,0,0,32
2021064,1548329,2025-04-14,Senate,"FLOOR VOTE: Motion to Adopt",32,0,0,0,32
2021069,1548702,2025-04-14,Senate,"FLOOR VOTE: Motion to Adopt",32,0,0,0,32
2021069,1550102,2025-04-16,House,"FLOOR VOTE: CONSENT CALENDAR PASSAGE ON THIRD CONSIDERATION",96,0,0,0,96
2021078,1548027,2025-04-14,Senate,"FLOOR VOTE: Motion to Adopt",32,0,0,0,32
2021078,1550031,2025-04-16,House,"FLOOR VOTE: CONSENT CALENDAR PASSAGE ON THIRD CONSIDERATION",96,0,0,0,96
2021090,1548344,2025-04-14,Senate,"FLOOR VOTE: Motion to Adopt",32,0,0,0,32
2021097,1548203,2025-04-14,Senate,"FLOOR VOTE: Motion to Adopt",32,0,0,0,32
2021097,1550199,2025-04-16,House,"FLOOR VOTE: CONSENT CALENDAR PASSAGE ON THIRD CONSIDERATION",96,0,0,0,96
2021105,1548124,2025-04-14,Senate,"FLOOR VOTE: Motion to Adopt",32,0,0,0,32
2021105,1550619,2025-04-16,House,"FLOOR VOTE: CONSENT CALENDAR PASSAGE ON THIRD CONSIDERATION",96,0,0,0,96
2021113,1542527,2025-04-09,House,"FLOOR VOTE: CONSENT CALENDAR PASSAGE ON THIRD CONSIDERATION",89,0,0,0,89
2021113,1548102,2025-04-14,Senate,"FLOOR VOTE: Motion to Adopt",32,0,0,0,32
2021122,1548307,2025-04-14,Senate,"FLOOR VOTE: Motion to Adopt",32,0,0,0,32
2021128,1543043,2025-04-09,House,"FLOOR VOTE: CONSENT CALENDAR PASSAGE ON THIRD CONSIDERATION",89,0,0,0,89
2021128,1548053,2025-04-14,Senate,"FLOOR VOTE: Motion to Adopt",32,0,0,0,32
2021142,1548007,2025-04-14,Senate,"FLOOR VOTE: Motion to Adopt",32,0,0,0,32
2021142,1550209,2025-04-16,House,"FLOOR VOTE: CONSENT CALENDAR PASSAGE ON THIRD CONSIDERATION",96,0,0,0,96
2021149,1542666,2025-04-09,House,"FLOOR VOTE: CONSENT CALENDAR PASSAGE ON THIRD CONSIDERATION",89,0,0,0,89
2021149,1548169,2025-04-14,Senate,"FLOOR VOTE: Motion to Adopt",32,0,0,0,32
2021156,1543055,2025-04-09,House,"FLOOR VOTE: CONSENT CALENDAR PASSAGE ON THIRD CONSIDERATION",89,0,0,0,89
2021156,1548262,2025-04-14,Senate,"FLOOR VOTE: Motion to Adopt",32,0,0,0,32
2021165,1548697,2025-04-14,Senate,"FLOOR VOTE: Motion to Adopt",32,0,0,0,32
2021165,1550103,2025-04-16,House,"FLOOR VOTE: CONSENT CALENDAR PASSAGE ON THIRD CONSIDERATION",96,0,0,0,96
2021173,1548157,2025-04-14,Senate,"FLOOR VOTE: Motion to Adopt",32,0,0,0,32
2021180,1548019,2025-04-14,Senate,"FLOOR VOTE: Motion to Adopt",32,0,0,0,32
2021192,1548669,2025-04-14,Senate,"FLOOR VOTE: Motion to Adopt",32,0,0,0,32
2021207,1548143,2025-04-14,Senate,"FLOOR VOTE: Motion to Adopt",32,0,0,0,32
2021217,1548639,2025-04-14,Senate,"FLOOR VOTE: Motion to Adopt",32,0,0,0,32
2021222,1548011,2025-04-14,Senate,"FLOOR VOTE: Motion to Adopt",32,0,0,0,32
2021258,1548021,2025-04-14,Senate,"FLOOR VOTE: Motion to Adopt",32,0,0,0,32
2021277,1548447,2025-04-14,Senate,"FLOOR VOTE: Motion to Adopt",32,0,0,0,32
2021347,1548009,2025-04-14,Senate,"FLOOR VOTE: Motion to Adopt",32,0,0,0,32
2021356,1544353,2025-04-10,House,"FLOOR VOTE: CONSENT CALENDAR PASSAGE ON THIRD CONSIDERATION",95,0,0,0,95
2021356,1552464,2025-04-17,Senate,"FLOOR VOTE: Motion to Adopt",33,0,0,0,33
2021366,1545240,2025-04-10,House,"FLOOR VOTE: CONSENT CALENDAR PASSAGE ON THIRD CONSIDERATION",95,0,0,0,95
2021366,1552390,2025-04-17,Senate,"FLOOR VOTE: Motion to Adopt",33,0,0,0,33
2021380,1544499,2025-04-10,House,"FLOOR VOTE: CONSENT CALENDAR PASSAGE ON THIRD CONSIDERATION",95,0,0,0,95
2021380,1552424,2025-04-17,Senate,"FLOOR VOTE: Motion to Adopt",33,0,0,0,33
2021391,1544852,2025-04-10,House,"FLOOR VOTE: CONSENT CALENDAR PASSAGE ON THIRD CONSIDERATION",95,0,0,0,95
2021391,1552401,2025-04-17,Senate,"FLOOR VOTE: Motion to Adopt",33,0,0,0,33
2021401,1548003,2025-04-14,Senate,"FLOOR VOTE: Motion to Adopt",32,0,0,0,32
2021410,1545003,2025-04-10,House,"FLOOR VOTE: CONSENT CALENDAR PASSAGE ON THIRD CONSIDERATION",95,0,0,0,95
2021410,1552397,2025-04-17,Senate,"FLOOR VOTE: Motion to Adopt",33,0,0,0,33
2021420,1548714,2025-04-14,Senate,"FLOOR VOTE: Motion to Adopt",32,0,0,0,32
2021420,1550115,2025-04-16,House,"FLOOR VOTE: CONSENT CALENDAR PASSAGE ON THIRD CONSIDERATION",96,0,0,0,96
2021425,1548453,2025-04-14,Senate,"FLOOR VOTE: Motion to Adopt",32,0,0,0,32
2021425,1550545,2025-04-16,House,"FLOOR VOTE: CONSENT CALENDAR PASSAGE ON THIRD CONSIDERATION",96,0,0,0,96
2021432,1548073,2025-04-14,Senate,"FLOOR VOTE: Motion to Adopt",32,0,0,0,32
2021441,1548048,2025-04-14,Senate,"FLOOR VOTE: Motion to Adopt",32,0,0,0,32
2021450,1548205,2025-04-14,Senate,"FLOOR VOTE: Motion to Adopt",32,0,0,0,32
2021450,1550704,2025-04-16,House,"FLOOR VOTE: CONSENT CALENDAR PASSAGE ON THIRD CONSIDERATION",96,0,0,0,96
2021460,1545193,2025-04-10,House,"FLOOR VOTE: CONSENT CALENDAR PASSAGE ON THIRD CONSIDERATION",95,0,0,0,95
2021460,1552539,2025-04-17,Senate,"FLOOR VOTE: Motion to Adopt",33,0,0,0,33
2021469,1543750,2025-04-10,House,"FLOOR VOTE: CONSENT CALENDAR PASSAGE ON THIRD CONSIDERATION",95,0,0,0,95
2021469,1552425,2025-04-17,Senate,"FLOOR VOTE: Motion to Adopt",33,0,0,0,33
2021485,1549358,2025-04-15,House,"FLOOR VOTE: CONSENT CALENDAR PASSAGE ON THIRD CONSIDERATION",95,0,0,0,95
2021493,1544928,2025-04-10,House,"FLOOR VOTE: CONSENT CALENDAR PASSAGE ON THIRD CONSIDERATION",95,0,0,0,95
2021493,1552549,2025-04-17,Senate,"FLOOR VOTE: Motion to Adopt",33,0,0,0,33
2021500,1545181,2025-04-10,House,"FLOOR VOTE: CONSENT CALENDAR PASSAGE ON THIRD CONSIDERATION",95,0,0,0,95
2021500,1552558,2025-04-17,Senate,"FLOOR VOTE: Motion to Adopt",33,0,0,0,33
2021511,1544665,2025-04-10,House,"FLOOR VOTE: CONSENT CALENDAR PASSAGE ON THIRD CONSIDERATION",95,0,0,0,95
2021511,1552396,2025-04-17,Senate,"FLOOR VOTE: Motion to Adopt",33,0,0,0,33
2021521,1548452,2025-04-14,Senate,"FLOOR VOTE: Motion to Adopt",32,0,0,0,32
2021521,1550854,2025-04-16,House,"FLOOR VOTE: CONSENT CALENDAR PASSAGE ON THIRD CONSIDERATION",96,0,0,0,96
2021530,1543742,2025-04-10,House,"FLOOR VOTE: CONSENT CALENDAR PASSAGE ON THIRD CONSIDERATION",95,0,0,0,95
2021539,1548248,2025-04-10,House,"FLOOR VOTE: CONSENT CALENDAR PASSAGE ON THIRD CONSIDERATION",95,0,0,0,95
2021548,1548014,2025-04-14,Senate,"FLOOR VOTE: Motion to Adopt",32,0,0,0,32
2021548,1550232,2025-04-16,House,"FLOOR VOTE: CONSENT CALENDAR PASSAGE ON THIRD CONSIDERATION",96,0,0,0,96
2021557,1545215,2025-04-10,House,"FLOOR VOTE: CONSENT CALENDAR PASSAGE ON THIRD CONSIDERATION",95,0,0,0,95
2021557,1552413,2025-04-17,Senate,"FLOOR VOTE: Motion to Adopt",33,0,0,0,33
2021567,1544572,2025-04-10,House,"FLOOR VOTE: CONSENT CALENDAR PASSAGE ON THIRD CONSIDERATION",95,0,0,0,95
2021567,1552459,2025-04-17,Senate,"FLOOR VOTE: Motion to Adopt",33,0,0,0,33
2021576,1544835,2025-04-10,House,"FLOOR VOTE: CONSENT CALENDAR PASSAGE ON THIRD CONSIDERATION",95,0,0,0,95
2021576,1552555,2025-04-17,Senate,"FLOOR VOTE: Motion to Adopt",33,0,0,0,33
2021584,1543751,2025-04-10,House,"FLOOR VOTE: CONSENT CALENDAR PASSAGE ON THIRD CONSIDERATION",95,0,0,0,95
2021584,1552592,2025-04-17,Senate,"FLOOR VOTE: Motion to Adopt",33,0,0,0,33
2021593,1548077,2025-04-14,Senate,"FLOOR VOTE: Motion to Adopt",32,0,0,0,32
2021593,1550565,2025-04-16,House,"FLOOR VOTE: CONSENT CALENDAR PASSAGE ON THIRD CONSIDERATION",96,0,0,0,96
2021600,1548721,2025-04-14,Senate,"FLOOR VOTE: Motion to Adopt",32,0,0,0,32
2021600,1550131,2025-04-16,House,"FLOOR VOTE: CONSENT CALENDAR PASSAGE ON THIRD CONSIDERATION",96,0,0,0,96
2021680,1544879,2025-04-10,House,"FLOOR VOTE: CONSENT CALENDAR PASSAGE ON THIRD CONSIDERATION",95,0,0,0,95
2021680,1552471,2025-04-17,Senate,"FLOOR VOTE: Motion to Adopt",33,0,0,0,33
2021746,1544868,2025-04-10,House,"FLOOR VOTE: CONSENT CALENDAR PASSAGE ON THIRD CONSIDERATION",95,0,0,0,95
2021746,1552398,2025-04-17,Senate,"FLOOR VOTE: Motion to Adopt",33,0,0,0,33
2021810,1544127,2025-04-10,House,"FLOOR VOTE: CONSENT CALENDAR PASSAGE ON THIRD CONSIDERATION",95,0,0,0,95
2021810,1552421,2025-04-17,Senate,"FLOOR VOTE: Motion to Adopt",33,0,0,0,33
2021857,1544821,2025-04-10,House,"FLOOR VOTE: CONSENT CALENDAR PASSAGE ON THIRD CONSIDERATION",95,0,0,0,95
2021857,1552568,2025-04-17,Senate,"FLOOR VOTE: Motion to Adopt",33,0,0,0,33
2021885,1544785,2025-04-10,House,"FLOOR VOTE: CONSENT CALENDAR PASSAGE ON THIRD CONSIDERATION",95,0,0,0,95
2021885,1552392,2025-04-17,Senate,"FLOOR VOTE: Motion to Adopt",33,0,0,0,33
2021915,1545185,2025-04-10,House,"FLOOR VOTE: CONSENT CALENDAR PASSAGE ON THIRD CONSIDERATION",95,0,0,0,95
2021915,1552548,2025-04-17,Senate,"FLOOR VOTE: Motion to Adopt",33,0,0,0,33
2021943,1544242,2025-04-10,House,"FLOOR VOTE: CONSENT CALENDAR PASSAGE ON THIRD CONSIDERATION",95,0,0,0,95
2021943,1552454,2025-04-17,Senate,"FLOOR VOTE: Motion to Adopt",33,0,0,0,33
2021975,1544839,2025-04-10,House,"FLOOR VOTE: CONSENT CALENDAR PASSAGE ON THIRD CONSIDERATION",95,0,0,0,95
2021975,1552504,2025-04-17,Senate,"FLOOR VOTE: Motion to Adopt",33,0,0,0,33
2022004,1545255,2025-04-10,House,"FLOOR VOTE: CONSENT CALENDAR PASSAGE ON THIRD CONSIDERATION",95,0,0,0,95
2022004,1552564,2025-04-17,Senate,"FLOOR VOTE: Motion to Adopt",33,0,0,0,33
2022033,1544328,2025-04-10,House,"FLOOR VOTE: CONSENT CALENDAR PASSAGE ON THIRD CONSIDERATION",95,0,0,0,95
2022033,1552606,2025-04-17,Senate,"FLOOR VOTE: Motion to Adopt",33,0,0,0,33
2022060,1544520,2025-04-10,House,"FLOOR VOTE: CONSENT CALENDAR PASSAGE ON THIRD CONSIDERATION",95,0,0,0,95
2022060,1552416,2025-04-17,Senate,"FLOOR VOTE: Motion to Adopt",33,0,0,0,33
2022090,1548094,2025-04-10,House,"FLOOR VOTE: CONSENT CALENDAR PASSAGE ON THIRD CONSIDERATION",95,0,0,0,95
2022102,1544836,2025-04-10,House,"FLOOR VOTE: CONSENT CALENDAR PASSAGE ON THIRD CONSIDERATION",95,0,0,0,95
2022102,1552506,2025-04-17,Senate,"FLOOR VOTE: Motion to Adopt",33,0,0,0,33
2022106,1552417,2025-04-17,Senate,"FLOOR VOTE: Motion to Adopt",33,0,0,0,33
2022106,1554215,2025-04-21,House,"FLOOR VOTE: CONSENT CALENDAR 2 PASSAGE ON THIRD CONSIDERATION",88,0,4,0,92
2022113,1543798,2025-04-10,House,"FLOOR VOTE: CONSENT CALENDAR PASSAGE ON THIRD CONSIDERATION",95,0,0,0,95
2022113,1552400,2025-04-17,Senate,"FLOOR VOTE: Motion to Adopt",33,0,0,0,33
2022126,1552409,2025-04-17,Senate,"FLOOR VOTE: Motion to Adopt",33,0,0,0,33
2022126,1554201,2025-04-21,House,"FLOOR VOTE: CONSENT CALENDAR 2 PASSAGE ON THIRD CONSIDERATION",88,0,4,0,92
2022132,1543788,2025-04-10,House,"FLOOR VOTE: CONSENT CALENDAR PASSAGE ON THIRD CONSIDERATION",95,0,0,0,95
2022132,1552446,2025-04-17,Senate,"FLOOR VOTE: Motion to Adopt",33,0,0,0,33
2022140,1545208,2025-04-10,House,"FLOOR VOTE: CONSENT CALENDAR PASSAGE ON THIRD CONSIDERATION",95,0,0,0,95
2022140,1552420,2025-04-17,Senate,"FLOOR VOTE: Motion to Adopt",33,0,0,0,33
2022147,1552442,2025-04-17,Senate,"FLOOR VOTE: Motion to Adopt",33,0,0,0,33
2022147,1554197,2025-04-21,House,"FLOOR VOTE: CONSENT CALENDAR 2 PASSAGE ON THIRD CONSIDERATION",88,0,4,0,92
2022153,1552437,2025-04-17,Senate,"FLOOR VOTE: Motion to Adopt",33,0,0,0,33
2022159,1544818,2025-04-10,House,"FLOOR VOTE: CONSENT CALENDAR PASSAGE ON THIRD CONSIDERATION",95,0,0,0,95
2022159,1552490,2025-04-17,Senate,"FLOOR VOTE: Motion to Adopt",33,0,0,0,33
2022166,1552565,2025-04-17,Senate,"FLOOR VOTE: Motion to Adopt",33,0,0,0,33
2022166,1553800,2025-04-21,House,"FLOOR VOTE: CONSENT CALENDAR 2 PASSAGE ON THIRD CONSIDERATION",88,0,4,0,92
2022172,1544918,2025-04-10,House,"FLOOR VOTE: CONSENT CALENDAR PASSAGE ON THIRD CONSIDERATION",95,0,0,0,95
2022172,1552552,2025-04-17,Senate,"FLOOR VOTE: Motion to Adopt",33,0,0,0,33
2022179,1552570,2025-04-17,Senate,"FLOOR VOTE: Motion to Adopt",33,0,0,0,33
2022179,1553346,2025-04-21,House,"FLOOR VOTE: CONSENT CALENDAR 2 PASSAGE ON THIRD CONSIDERATION",88,0,4,0,92
2022184,1552406,2025-04-17,Senate,"FLOOR VOTE: Motion to Adopt",33,0,0,0,33
2022184,1553913,2025-04-21,House,"FLOOR VOTE: CONSENT CALENDAR 2 PASSAGE ON THIRD CONSIDERATION",88,0,4,0,92
2022198,1545258,2025-04-10,House,"FLOOR VOTE: CONSENT CALENDAR PASSAGE ON THIRD CONSIDERATION",95,0,0,0,95
2022198,1552590,2025-04-17,Senate,"FLOOR VOTE: Motion to Adopt",33,0,0,0,33
2022205,1552467,2025-04-17,Senate,"FLOOR VOTE: Motion to Adopt",33,0,0,0,33
2022211,1552598,2025-04-17,Senate,"FLOOR VOTE: Motion to Adopt",33,0,0,0,33
2022211,1554003,2025-04-21,House,"FLOOR VOTE: CONSENT CALENDAR 2 PASSAGE ON THIRD CONSIDERATION",88,0,4,0,92
2022217,1552581,2025-04-17,Senate,"FLOOR VOTE: Motion to Adopt",33,0,0,0,33
2022217,1553900,2025-04-21,House,"FLOOR VOTE: CONSENT CALENDAR 2 PASSAGE ON THIRD CONSIDERATION",88,0,4,0,92
2022223,1544104,2025-04-10,House,"FLOOR VOTE: CONSENT CALENDAR PASSAGE ON THIRD CONSIDERATION",95,0,0,0,95
2022230,1552605,2025-04-17,Senate,"FLOOR VOTE: Motion to Adopt",33,0,0,0,33
2022237,1552402,2025-04-17,Senate,"FLOOR VOTE: Motion to Adopt",33,0,0,0,33
2022245,1544829,2025-04-10,House,"FLOOR VOTE: CONSENT CALENDAR PASSAGE ON THIRD CONSIDERATION",95,0,0,0,95
2022245,1552599,2025-04-17,Senate,"FLOOR VOTE: Motion to Adopt",33,0,0,0,33
2022259,1544827,2025-04-10,House,"FLOOR VOTE: CONSENT CALENDAR PASSAGE ON THIRD CONSIDERATION",95,0,0,0,95
2022259,1552546,2025-04-17,Senate,"FLOOR VOTE: Motion to Adopt",33,0,0,0,33
2022264,1552419,2025-04-17,Senate,"FLOOR VOTE: Motion to Adopt",33,0,0,0,33
2022264,1554200,2025-04-21,House,"FLOOR VOTE: CONSENT CALENDAR 2 PASSAGE ON THIRD CONSIDERATION",88,0,4,0,92
2022288,1547908,2025-04-14,House,"FLOOR VOTE: CONSENT CALENDAR PASSAGE ON THIRD CONSIDERATION",94,0,1,0,95
2022288,1552456,2025-04-17,Senate,"FLOOR VOTE: Motion to Adopt",33,0,0,0,33
2022297,1547975,2025-04-14,House,"FLOOR VOTE: CONSENT CALENDAR PASSAGE ON THIRD CONSIDERATION",94,0,1,0,95
2022297,1552578,2025-04-17,Senate,"FLOOR VOTE: Motion to Adopt",33,0,0,0,33
2022305,1547382,2025-04-14,House,"FLOOR VOTE: CONSENT CALENDAR PASSAGE ON THIRD CONSIDERATION",94,0,1,0,95
2022305,1552488,2025-04-17,Senate,"FLOOR VOTE: Motion to Adopt",33,0,0,0,33
2022316,1547293,2025-04-14,House,"FLOOR VOTE: CONSENT CALENDAR PASSAGE ON THIRD CONSIDERATION",94,0,1,0,95
2022316,1552449,2025-04-17,Senate,"FLOOR VOTE: Motion to Adopt",33,0,0,0,33
2022326,1547883,2025-04-14,House,"FLOOR VOTE: CONSENT CALENDAR PASSAGE ON THIRD CONSIDERATION",94,0,1,0,95
2022326,1552443,2025-04-17,Senate,"FLOOR VOTE: Motion to Adopt",33,0,0,0,33
2022336,1547458,2025-04-14,House,"FLOOR VOTE: CONSENT CALENDAR PASSAGE ON THIRD CONSIDERATION",94,0,1,0,95
2022336,1552408,2025-04-17,Senate,"FLOOR VOTE: Motion to Adopt",33,0,0,0,33
2022347,1547753,2025-04-14,House,"FLOOR VOTE: CONSENT CALENDAR PASSAGE ON THIRD CONSIDERATION",94,0,1,0,95
2022347,1552453,2025-04-17,Senate,"FLOOR VOTE: Motion to Adopt",33,0,0,0,33
2022358,1547427,2025-04-14,House,"FLOOR VOTE: CONSENT CALENDAR PASSAGE ON THIRD CONSIDERATION",94,0,1,0,95
2022358,1552407,2025-04-17,Senate,"FLOOR VOTE: Motion to Adopt",33,0,0,0,33
2022368,1547395,2025-04-14,House,"FLOOR VOTE: CONSENT CALENDAR PASSAGE ON THIRD CONSIDERATION",94,0,1,0,95
2022368,1552399,2025-04-17,Senate,"FLOOR VOTE: Motion to Adopt",33,0,0,0,33
2022379,1545082,2025-04-10,House,"FLOOR VOTE: CONSENT CALENDAR PASSAGE ON THIRD CONSIDERATION",95,0,0,0,95
2022379,1552405,2025-04-17,Senate,"FLOOR VOTE: Motion to Adopt",33,0,0,0,33
2022387,1547989,2025-04-14,House,"FLOOR VOTE: CONSENT CALENDAR PASSAGE ON THIRD CONSIDERATION",94,0,1,0,95
2022387,1552475,2025-04-17,Senate,"FLOOR VOTE: Motion to Adopt",33,0,0,0,33
2022422,1552436,2025-04-17,Senate,"FLOOR VOTE: Motion to Adopt",33,0,0,0,33
2022422,1553259,2025-04-21,House,"FLOOR VOTE: CONSENT CALENDAR 2 PASSAGE ON THIRD CONSIDERATION",88,0,4,0,92
2022674,1552458,2025-04-17,Senate,"FLOOR VOTE: Motion to Adopt",33,0,0,0,33
2022674,1553377,2025-04-21,House,"FLOOR VOTE: CONSENT CALENDAR 2 PASSAGE ON THIRD CONSIDERATION",88,0,4,0,92
2022700,1552574,2025-04-17,Senate,"FLOOR VOTE: Motion to Adopt",33,0,0,0,33
2022700,1553828,2025-04-21,House,"FLOOR VOTE: CONSENT CALENDAR 2 PASSAGE ON THIRD CONSIDERATION",88,0,4,0,92
2022728,1552547,2025-04-17,Senate,"FLOOR VOTE: Motion to Adopt",33,0,0,0,33
2022728,1553628,2025-04-21,House,"FLOOR VOTE: CONSENT CALENDAR 2 PASSAGE ON THIRD CONSIDERATION",88,0,4,0,92
2022751,1552602,2025-04-17,Senate,"FLOOR VOTE: Motion to Adopt",33,0,0,0,33
2022751,1553951,2025-04-21,House,"FLOOR VOTE: CONSENT CALENDAR 2 PASSAGE ON THIRD CONSIDERATION",88,0,4,0,92
2022777,1547414,2025-04-14,House,"FLOOR VOTE: CONSENT CALENDAR PASSAGE ON THIRD CONSIDERATION",94,0,1,0,95
2022777,1552486,2025-04-17,Senate,"FLOOR VOTE: Motion to Adopt",33,0,0,0,33
2022805,1552415,2025-04-17,Senate,"FLOOR VOTE: Motion to Adopt",33,0,0,0,33
2022805,1554208,2025-04-21,House,"FLOOR VOTE: CONSENT CALENDAR 2 PASSAGE ON THIRD CONSIDERATION",88,0,4,0,92
2022831,1547969,2025-04-14,House,"FLOOR VOTE: CONSENT CALENDAR PASSAGE ON THIRD CONSIDERATION",94,0,1,0,95
2022831,1552457,2025-04-17,Senate,"FLOOR VOTE: Motion to Adopt",33,0,0,0,33
2022855,1547986,2025-04-14,House,"FLOOR VOTE: CONSENT CALENDAR PASSAGE ON THIRD CONSIDERATION",94,0,1,0,95
2022855,1552447,2025-04-17,Senate,"FLOOR VOTE: Motion to Adopt",33,0,0,0,33
2022883,1547998,2025-04-14,House,"FLOOR VOTE: CONSENT CALENDAR PASSAGE ON THIRD CONSIDERATION",94,0,1,0,95
2022883,1552394,2025-04-17,Senate,"FLOOR VOTE: Motion to Adopt",33,0,0,0,33
2022906,1547954,2025-04-14,House,"FLOOR VOTE: CONSENT CALENDAR PASSAGE ON THIRD CONSIDERATION",94,0,1,0,95
2022906,1552451,2025-04-17,Senate,"FLOOR VOTE: Motion to Adopt",33,0,0,0,33
2022928,1547945,2025-04-14,House,"FLOOR VOTE: CONSENT CALENDAR PASSAGE ON THIRD CONSIDERATION",94,0,1,0,95
2022928,1552572,2025-04-17,Senate,"FLOOR VOTE: Motion to Adopt",33,0,0,0,33
2022974,1547990,2025-04-14,House,"FLOOR VOTE: CONSENT CALENDAR PASSAGE ON THIRD CONSIDERATION",94,0,1,0,95
2023012,1552412,2025-04-17,Senate,"FLOOR VOTE: Motion to Adopt",33,0,0,0,33
2023012,1554134,2025-04-21,House,"FLOOR VOTE: CONSENT CALENDAR 2 PASSAGE ON THIRD CONSIDERATION",88,0,4,0,92
2023575,1549109,2025-04-15,House,"FLOOR VOTE: CONSENT CALENDAR PASSAGE ON THIRD CONSIDERATION",95,0,0,0,95
2023575,1552755,2025-04-21,Senate,"FLOOR VOTE: Motion to Adopt",33,0,0,0,33
2023580,1553081,2025-04-21,Senate,"FLOOR VOTE: Motion to Adopt",33,0,0,0,33
2023589,1553135,2025-04-21,Senate,"FLOOR VOTE: Motion to Adopt",33,0,0,0,33
2023594,1552627,2025-04-21,Senate,"FLOOR VOTE: Motion to Adopt",33,0,0,0,33
2023602,1552792,2025-04-21,Senate,"FLOOR VOTE: Motion to Adopt",33,0,0,0,33
2023607,1549445,2025-04-15,House,"FLOOR VOTE: CONSENT CALENDAR PASSAGE ON THIRD CONSIDERATION",95,0,0,0,95
2023607,1553192,2025-04-21,Senate,"FLOOR VOTE: Motion to Adopt",33,0,0,0,33
2023611,1548882,2025-04-15,House,"FLOOR VOTE: CONSENT CALENDAR PASSAGE ON THIRD CONSIDERATION",95,0,0,0,95
2023611,1553072,2025-04-21,Senate,"FLOOR VOTE: Motion to Adopt",33,0,0,0,33
2023638,1552705,2025-04-21,Senate,"FLOOR VOTE: Motion to Adopt",33,0,0,0,33
2023658,1553187,2025-04-21,Senate,"FLOOR VOTE: Motion to Adopt",33,0,0,0,33
2023677,1552790,2025-04-21,Senate,"FLOOR VOTE: Motion to Adopt",33,0,0,0,33
2023695,1552993,2025-04-21,Senate,"FLOOR VOTE: Motion to Adopt",33,0,0,0,33
2023716,1552750,2025-04-21,Senate,"FLOOR VOTE: Motion to Adopt",33,0,0,0,33
2023734,1553036,2025-04-21,Senate,"FLOOR VOTE: Motion to Adopt",33,0,0,0,33
2023753,1552679,2025-04-21,Senate,"FLOOR VOTE: Motion to Adopt",33,0,0,0,33
2023774,1553041,2025-04-21,Senate,"FLOOR VOTE: Motion to Adopt",33,0,0,0,33
2023791,1553026,2025-04-21,Senate,"FLOOR VOTE: Motion to Adopt",33,0,0,0,33
2023807,1553117,2025-04-21,Senate,"FLOOR VOTE: Motion to Adopt",33,0,0,0,33
2023824,1553194,2025-04-21,Senate,"FLOOR VOTE: Motion to Adopt",33,0,0,0,33
2023837,1553142,2025-04-21,Senate,"FLOOR VOTE: Motion to Adopt",33,0,0,0,33
2023870,1553153,2025-04-21,Senate,"FLOOR VOTE: Motion to Adopt",33,0,0,0,33
2023873,1553055,2025-04-21,Senate,"FLOOR VOTE: Motion to Adopt",33,0,0,0,33
2023877,1550466,2025-04-16,House,"FLOOR VOTE: CONSENT CALENDAR PASSAGE ON THIRD CONSIDERATION",96,0,0,0,96
2023877,1552678,2025-04-21,Senate,"FLOOR VOTE: Motion to Adopt",33,0,0,0,33
2023880,1550879,2025-04-16,House,"FLOOR VOTE: CONSENT CALENDAR PASSAGE ON THIRD CONSIDERATION",96,0,0,0,96
2023880,1553152,2025-04-21,Senate,"FLOOR VOTE: Motion to Adopt",33,0,0,0,33
2023887,1550857,2025-04-16,House,"FLOOR VOTE: CONSENT CALENDAR PASSAGE ON THIRD CONSIDERATION",96,0,0,0,96
2023887,1553088,2025-04-21,Senate,"FLOOR VOTE: Motion to Adopt",33,0,0,0,33
2023892,1550868,2025-04-16,House,"FLOOR VOTE: CONSENT CALENDAR PASSAGE ON THIRD CONSIDERATION",96,0,0,0,96
2023892,1552647,2025-04-21,Senate,"FLOOR VOTE: Motion to Adopt",33,0,0,0,33
2023895,1553005,2025-04-21,Senate,"FLOOR VOTE: Motion to Adopt",33,0,0,0,33
2023898,1550794,2025-04-16,House,"FLOOR VOTE: CONSENT CALENDAR PASSAGE ON THIRD CONSIDERATION",96,0,0,0,96
2023898,1553143,2025-04-21,Senate,"FLOOR VOTE: Motion to Adopt",33,0,0,0,33
2023902,1553171,2025-04-21,Senate,"FLOOR VOTE: Motion to Adopt",33,0,0,0,33
2023907,1550778,2025-04-16,House,"FLOOR VOTE: CONSENT CALENDAR PASSAGE ON THIRD CONSIDERATION",96,0,0,0,96
2023907,1552934,2025-04-21,Senate,"FLOOR VOTE: Motion to Adopt",33,0,0,0,33
2023910,1550531,2025-04-16,House,"FLOOR VOTE: CONSENT CALENDAR PASSAGE ON THIRD CONSIDERATION",96,0,0,0,96
2023910,1552995,2025-04-21,Senate,"FLOOR VOTE: Motion to Adopt",33,0,0,0,33
2023920,1550651,2025-04-16,House,"FLOOR VOTE: CONSENT CALENDAR PASSAGE ON THIRD CONSIDERATION",96,0,0,0,96
2023920,1553184,2025-04-21,Senate,"FLOOR VOTE: Motion to Adopt",33,0,0,0,33
2023925,1553030,2025-04-21,Senate,"FLOOR VOTE: Motion to Adopt",33,0,0,0,33
2023929,1550776,2025-04-16,House,"FLOOR VOTE: CONSENT CALENDAR PASSAGE ON THIRD CONSIDERATION",96,0,0,0,96
2023929,1553154,2025-04-21,Senate,"FLOOR VOTE: Motion to Adopt",33,0,0,0,33
2023933,1553134,2025-04-21,Senate,"FLOOR VOTE: Motion to Adopt",33,0,0,0,33
2023937,1553191,2025-04-21,Senate,"FLOOR VOTE: Motion to Adopt",33,0,0,0,33
2023941,1553198,2025-04-21,Senate,"FLOOR VOTE: Motion to Adopt",33,0,0,0,33
2023946,1549953,2025-04-15,Senate,"FLOOR VOTE: Motion to Adopt",32,0,0,0,32
2023946,1550866,2025-04-16,House,"FLOOR VOTE: CONSENT CALENDAR PASSAGE ON THIRD CONSIDERATION",96,0,0,0,96
2023951,1550764,2025-04-16,House,"FLOOR VOTE: CONSENT CALENDAR PASSAGE ON THIRD CONSIDERATION",96,0,0,0,96
2023951,1552789,2025-04-21,Senate,"FLOOR VOTE: Motion to Adopt",33,0,0,0,33
2023955,1550787,2025-04-16,House,"FLOOR VOTE: CONSENT CALENDAR PASSAGE ON THIRD CONSIDERATION",96,0,0,0,96
2023955,1553155,2025-04-21,Senate,"FLOOR VOTE: Motion to Adopt",33,0,0,0,33
2023958,1550068,2025-04-16,House,"FLOOR VOTE: CONSENT CALENDAR PASSAGE ON THIRD CONSIDERATION",96,0,0,0,96
2023958,1553107,2025-04-21,Senate,"FLOOR VOTE: Motion to Adopt",33,0,0,0,33
2023961,1553168,2025-04-21,Senate,"FLOOR VOTE: Motion to Adopt",33,0,0,0,33
2023965,1553151,2025-04-21,Senate,"FLOOR VOTE: Motion to Adopt",33,0,0,0,33
2023995,1552794,2025-04-21,Senate,"FLOOR VOTE: Motion to Adopt",33,0,0,0,33
2024018,1550795,2025-04-16,House,"FLOOR VOTE: CONSENT CALENDAR PASSAGE ON THIRD CONSIDERATION",96,0,0,0,96
2024018,1552736,2025-04-21,Senate,"FLOOR VOTE: Motion to Adopt",33,0,0,0,33
2024039,1552815,2025-04-21,Senate,"FLOOR VOTE: Motion to Adopt",33,0,0,0,33
2024065,1552718,2025-04-21,Senate,"FLOOR VOTE: Motion to Adopt",33,0,0,0,33
2024090,1550771,2025-04-16,House,"FLOOR VOTE: CONSENT CALENDAR PASSAGE ON THIRD CONSIDERATION",96,0,0,0,96
2024090,1553185,2025-04-21,Senate,"FLOOR VOTE: Motion to Adopt",33,0,0,0,33
2024112,1550788,2025-04-16,House,"FLOOR VOTE: CONSENT CALENDAR PASSAGE ON THIRD CONSIDERATION",96,0,0,0,96
2024112,1552796,2025-04-21,Senate,"FLOOR VOTE: Motion to Adopt",33,0,0,0,33
2024134,1549356,2025-04-15,House,"FLOOR VOTE: MOTION TO ADOPT",88,0,1,0,89
2024139,1552557,2025-04-16,House,"FLOOR VOTE: CONSENT CALENDAR PASSAGE ON THIRD CONSIDERATION",96,0,0,0,96
2024175,1550099,2025-04-16,House,"FLOOR VOTE: CONSENT CALENDAR PASSAGE ON THIRD CONSIDERATION",96,0,0,0,96
2024248,1552994,2025-04-21,Senate,"FLOOR VOTE: Motion to Adopt",33,0,0,0,33
2024250,1553588,2025-04-21,House,"HOUSE PRIVATE ACTS COMMITTEE: Rec. for pass; ref to State & Local Government Committee",11,0,0,0,11
2024250,1553589,2025-04-21,House,"HOUSE STATE & LOCAL GOVERNMENT COMMITTEE: Rec. for pass; ref to Calendar & Rules Committee",14,0,0,0,14
2024250,1554868,2025-04-22,House,"FLOOR VOTE: CONSENT CALENDAR PASSAGE ON THIRD CONSIDERATION",94,0,1,0,95
2024251,1552651,2025-04-21,Senate,"FLOOR VOTE: Motion to Adopt",33,0,0,0,33
2024252,1553172,2025-04-21,Senate,"FLOOR VOTE: Motion to Adopt",33,0,0,0,33
2024254,1553129,2025-04-21,Senate,"FLOOR VOTE: Motion to Adopt",33,0,0,0,33
2024256,1552711,2025-04-21,Senate,"FLOOR VOTE: Motion to Adopt",33,0,0,0,33
2024258,1552806,2025-04-21,Senate,"FLOOR VOTE: Motion to Adopt",33,0,0,0,33
2024259,1553165,2025-04-21,Senate,"FLOOR VOTE: Motion to Adopt",33,0,0,0,33
2024260,1553145,2025-04-21,Senate,"FLOOR VOTE: Motion to Adopt",33,0,0,0,33
2024261,1553042,2025-04-21,Senate,"FLOOR VOTE: Motion to Adopt",33,0,0,0,33
2024262,1552780,2025-04-21,Senate,"FLOOR VOTE: Motion to Adopt",33,0,0,0,33
2024264,1552948,2025-04-21,Senate,"FLOOR VOTE: Motion to Adopt",33,0,0,0,33
2024265,1553136,2025-04-21,Senate,"FLOOR VOTE: Motion to Adopt",33,0,0,0,33
2024269,1552996,2025-04-21,Senate,"FLOOR VOTE: Motion to Adopt",33,0,0,0,33
2024271,1553052,2025-04-21,Senate,"FLOOR VOTE: Motion to Adopt",33,0,0,0,33
2024272,1552668,2025-04-21,Senate,"FLOOR VOTE: Motion to Adopt",33,0,0,0,33
2024274,1553057,2025-04-21,Senate,"FLOOR VOTE: Motion to Adopt",33,0,0,0,33
2024278,1552703,2025-04-21,Senate,"FLOOR VOTE: Motion to Adopt",33,0,0,0,33
2024280,1553130,2025-04-21,Senate,"FLOOR VOTE: Motion to Adopt",33,0,0,0,33
2024283,1553133,2025-04-21,Senate,"FLOOR VOTE: Motion to Adopt",33,0,0,0,33
2024285,1551774,2025-04-17,House,"FLOOR VOTE: CONSENT CALENDAR PASSAGE ON THIRD CONSIDERATION",95,0,0,0,95
2024285,1556529,2025-04-22,Senate,"FLOOR VOTE: Motion to Adopt",33,0,0,0,33
2024286,1553100,2025-04-21,Senate,"FLOOR VOTE: Motion to Adopt",33,0,0,0,33
2024288,1553025,2025-04-21,Senate,"FLOOR VOTE: Motion to Adopt",33,0,0,0,33
2024290,1552816,2025-04-21,Senate,"FLOOR VOTE: Motion to Adopt",33,0,0,0,33
2024291,1551652,2025-04-17,House,"FLOOR VOTE: CONSENT CALENDAR PASSAGE ON THIRD CONSIDERATION",95,0,0,0,95
2024291,1556523,2025-04-22,Senate,"FLOOR VOTE: Motion to Adopt",33,0,0,0,33
2024295,1552629,2025-04-21,Senate,"FLOOR VOTE: Motion to Adopt",33,0,0,0,33
2024298,1553123,2025-04-21,Senate,"FLOOR VOTE: Motion to Adopt",33,0,0,0,33
2024299,1552804,2025-04-21,Senate,"FLOOR VOTE: Motion to Adopt",33,0,0,0,33
2024301,1553139,2025-04-21,Senate,"FLOOR VOTE: Motion to Adopt",33,0,0,0,33
2024302,1552984,2025-04-21,Senate,"FLOOR VOTE: Motion to Adopt",33,0,0,0,33
2024303,1552658,2025-04-21,Senate,"FLOOR VOTE: Motion to Adopt",33,0,0,0,33
2024304,1552715,2025-04-21,Senate,"FLOOR VOTE: Motion to Adopt",33,0,0,0,33
2024306,1552716,2025-04-21,Senate,"FLOOR VOTE: Motion to Adopt",33,0,0,0,33
2024307,1553045,2025-04-21,Senate,"FLOOR VOTE: Motion to Adopt",33,0,0,0,33
2024311,1553051,2025-04-21,Senate,"FLOOR VOTE: Motion to Adopt",33,0,0,0,33
2024313,1552702,2025-04-21,Senate,"FLOOR VOTE: Motion to Adopt",33,0,0,0,33
2024314,1553011,2025-04-21,Senate,"FLOOR VOTE: Motion to Adopt",33,0,0,0,33
2024315,1552624,2025-04-21,Senate,"FLOOR VOTE: Motion to Adopt",33,0,0,0,33
2024317,1553140,2025-04-21,Senate,"FLOOR VOTE: Motion to Adopt",33,0,0,0,33
2024321,1551444,2025-04-17,House,"FLOOR VOTE: CONSENT CALENDAR PASSAGE ON THIRD CONSIDERATION",95,0,0,0,95
2024321,1556690,2025-04-22,Senate,"FLOOR VOTE: Motion to Adopt",33,0,0,0,33
2024323,1553059,2025-04-21,Senate,"FLOOR VOTE: Motion to Adopt",33,0,0,0,33
2024325,1551445,2025-04-17,House,"FLOOR VOTE: CONSENT CALENDAR PASSAGE ON THIRD CONSIDERATION",95,0,0,0,95
2024325,1557076,2025-04-22,Senate,"FLOOR VOTE: Motion to Adopt",33,0,0,0,33
2024327,1552987,2025-04-21,Senate,"FLOOR VOTE: Motion to Adopt",33,0,0,0,33
2024328,1552691,2025-04-21,Senate,"FLOOR VOTE: Motion to Adopt",33,0,0,0,33
2024330,1552661,2025-04-21,Senate,"FLOOR VOTE: Motion to Adopt",33,0,0,0,33
2024331,1556566,2025-04-22,Senate,"FLOOR VOTE: Motion to Adopt",33,0,0,0,33
2024334,1552752,2025-04-21,Senate,"FLOOR VOTE: Motion to Adopt",33,0,0,0,33
2024335,1553021,2025-04-21,Senate,"FLOOR VOTE: Motion to Adopt",33,0,0,0,33
2024337,1553132,2025-04-21,Senate,"FLOOR VOTE: Motion to Adopt",33,0,0,0,33
2024338,1553190,2025-04-21,Senate,"FLOOR VOTE: Motion to Adopt",33,0,0,0,33
2024340,1553189,2025-04-21,Senate,"FLOOR VOTE: Motion to Adopt",33,0,0,0,33
2024341,1553157,2025-04-21,Senate,"FLOOR VOTE: Motion to Adopt",33,0,0,0,33
2024342,1551852,2025-04-17,House,"FLOOR VOTE: CONSENT CALENDAR PASSAGE ON THIRD CONSIDERATION",95,0,0,0,95
2024342,1556749,2025-04-22,Senate,"FLOOR VOTE: Motion to Adopt",33,0,0,0,33
2024359,1552809,2025-04-21,Senate,"FLOOR VOTE: Motion to Adopt",33,0,0,0,33
2024368,1552979,2025-04-21,Senate,"FLOOR VOTE: Motion to Adopt",33,0,0,0,33
2024376,1553056,2025-04-21,Senate,"FLOOR VOTE: Motion to Adopt",33,0,0,0,33
2024388,1553018,2025-04-21,Senate,"FLOOR VOTE: Motion to Adopt",33,0,0,0,33
2024397,1552799,2025-04-21,Senate,"FLOOR VOTE: Motion to Adopt",33,0,0,0,33
2024407,1552656,2025-04-21,Senate,"FLOOR VOTE: Motion to Adopt",33,0,0,0,33
2024416,1552763,2025-04-21,Senate,"FLOOR VOTE: Motion to Adopt",33,0,0,0,33
2024425,1553080,2025-04-21,Senate,"FLOOR VOTE: Motion to Adopt",33,0,0,0,33
2024434,1552729,2025-04-21,Senate,"FLOOR VOTE: Motion to Adopt",33,0,0,0,33
2024449,1552991,2025-04-21,Senate,"FLOOR VOTE: Motion to Adopt",33,0,0,0,33
2024458,1553061,2025-04-21,Senate,"FLOOR VOTE: Motion to Adopt",33,0,0,0,33
2024465,1552798,2025-04-21,Senate,"FLOOR VOTE: Motion to Adopt",33,0,0,0,33
2024475,1553167,2025-04-21,Senate,"FLOOR VOTE: Motion to Adopt",33,0,0,0,33
2024483,1553128,2025-04-21,Senate,"FLOOR VOTE: Motion to Adopt",33,0,0,0,33
2024495,1553097,2025-04-21,Senate,"FLOOR VOTE: Motion to Adopt",33,0,0,0,33
2024504,1552870,2025-04-21,Senate,"FLOOR VOTE: Motion to Adopt",33,0,0,0,33
2024523,1551242,2025-04-17,House,"FLOOR VOTE: CONSENT CALENDAR PASSAGE ON THIRD CONSIDERATION",95,0,0,0,95
2024523,1557178,2025-04-22,Senate,"FLOOR VOTE: Motion to Adopt",33,0,0,0,33
2024531,1553068,2025-04-21,Senate,"FLOOR VOTE: Motion to Adopt",33,0,0,0,33
2024545,1552758,2025-04-21,Senate,"FLOOR VOTE: Motion to Adopt",33,0,0,0,33
2024554,1553166,2025-04-21,Senate,"FLOOR VOTE: Motion to Adopt",33,0,0,0,33
2024564,1552973,2025-04-21,Senate,"FLOOR VOTE: Motion to Adopt",33,0,0,0,33
2024575,1553144,2025-04-21,Senate,"FLOOR VOTE: Motion to Adopt",33,0,0,0,33
2024585,1553049,2025-04-21,Senate,"FLOOR VOTE: Motion to Adopt",33,0,0,0,33
2024594,1551097,2025-04-17,House,"FLOOR VOTE: CONSENT CALENDAR PASSAGE ON THIRD CONSIDERATION",95,0,0,0,95
2024594,1557170,2025-04-22,Senate,"FLOOR VOTE: Motion to Adopt",33,0,0,0,33
2024605,1553181,2025-04-21,Senate,"FLOOR VOTE: Motion to Adopt",33,0,0,0,33
2024613,1550563,2025-04-16,House,"FLOOR VOTE: MOTION TO ADOPT",74,17,2,0,93
2024613,1550564,2025-04-16,House,"FLOOR VOTE: MOTION TO SUSPEND THE RULES",72,21,0,0,93
2024613,1553160,2025-04-21,Senate,"FLOOR VOTE: Motion to Adopt",33,0,0,0,33
2024630,1551713,2025-04-17,House,"FLOOR VOTE: CONSENT CALENDAR PASSAGE ON THIRD CONSIDERATION",95,0,0,0,95
2024630,1556693,2025-04-22,Senate,"FLOOR VOTE: Motion to Adopt",33,0,0,0,33
2024654,1552686,2025-04-21,Senate,"FLOOR VOTE: Motion to Adopt",33,0,0,0,33
2024668,1552846,2025-04-21,Senate,"FLOOR VOTE: Motion to Adopt",33,0,0,0,33
2024701,1552697,2025-04-21,Senate,"FLOOR VOTE: Motion to Adopt",33,0,0,0,33
2024707,1553006,2025-04-21,Senate,"FLOOR VOTE: Motion to Adopt",33,0,0,0,33
2024714,1554171,2025-04-21,House,"FLOOR VOTE: CONSENT CALENDAR PASSAGE ON THIRD CONSIDERATION",86,0,1,0,87
2024714,1557279,2025-04-22,Senate,"FLOOR VOTE: Motion to Adopt",32,0,0,0,32
2024719,1553972,2025-04-21,House,"FLOOR VOTE: CONSENT CALENDAR PASSAGE ON THIRD CONSIDERATION",86,0,1,0,87
2024719,1557463,2025-04-22,Senate,"FLOOR VOTE: Motion to Adopt",32,0,0,0,32
2024724,1552704,2025-04-21,Senate,"FLOOR VOTE: Motion to Adopt",33,0,0,0,33
2024732,1553020,2025-04-21,Senate,"FLOOR VOTE: Motion to Adopt",33,0,0,0,33
2024737,1553047,2025-04-21,Senate,"FLOOR VOTE: Motion to Adopt",33,0,0,0,33
2024743,1552802,2025-04-21,Senate,"FLOOR VOTE: Motion to Adopt",33,0,0,0,33
2024750,1553105,2025-04-21,Senate,"FLOOR VOTE: Motion to Adopt",33,0,0,0,33
2024754,1553520,2025-04-21,House,"FLOOR VOTE: CONSENT CALENDAR PASSAGE ON THIRD CONSIDERATION",86,0,1,0,87
2024754,1556612,2025-04-22,Senate,"FLOOR VOTE: Motion to Adopt",32,0,0,0,32
2024761,1552782,2025-04-21,Senate,"FLOOR VOTE: Motion to Adopt",33,0,0,0,33
2024766,1553125,2025-04-21,Senate,"FLOOR VOTE: Motion to Adopt",33,0,0,0,33
2024773,1553572,2025-04-21,House,"FLOOR VOTE: CONSENT CALENDAR PASSAGE ON THIRD CONSIDERATION",86,0,1,0,87
2024773,1556919,2025-04-22,Senate,"FLOOR VOTE: Motion to Adopt",32,0,0,0,32
2024778,1553218,2025-04-21,House,"FLOOR VOTE: CONSENT CALENDAR PASSAGE ON THIRD CONSIDERATION",86,0,1,0,87
2024778,1557299,2025-04-22,Senate,"FLOOR VOTE: Motion to Adopt",32,0,0,0,32
2024782,1554713,2025-04-22,House,"FLOOR VOTE: REGULAR CALENDAR MOTION TO ADOPT",92,1,0,0,93
2024792,1552692,2025-04-21,Senate,"FLOOR VOTE: Motion to Adopt",33,0,0,0,33
2024798,1553022,2025-04-21,Senate,"FLOOR VOTE: Motion to Adopt",33,0,0,0,33
2024802,1552771,2025-04-21,Senate,"FLOOR VOTE: Motion to Adopt",33,0,0,0,33
2024808,1553023,2025-04-21,Senate,"FLOOR VOTE: Motion to Adopt",33,0,0,0,33
2024813,1553141,2025-04-21,Senate,"FLOOR VOTE: Motion to Adopt",33,0,0,0,33
2024817,1553040,2025-04-21,Senate,"FLOOR VOTE: Motion to Adopt",33,0,0,0,33
2024826,1558384,2025-04-21,House,"FLOOR VOTE: CONSENT CALENDAR PASSAGE ON THIRD CONSIDERATION",86,0,1,0,87
2024828,1553653,2025-04-21,House,"FLOOR VOTE: CONSENT CALENDAR PASSAGE ON THIRD CONSIDERATION",86,0,1,0,87
2024828,1556858,2025-04-22,Senate,"FLOOR VOTE: Motion to Adopt",32,0,0,0,32
2024831,1558385,2025-04-21,House,"FLOOR VOTE: CONSENT CALENDAR PASSAGE ON THIRD CONSIDERATION",86,0,1,0,87
2024835,1552632,2025-04-21,Senate,"FLOOR VOTE: Motion to Adopt",33,0,0,0,33
2024840,1552813,2025-04-21,Senate,"FLOOR VOTE: Motion to Adopt",33,0,0,0,33
2024843,1553183,2025-04-21,Senate,"FLOOR VOTE: Motion to Adopt",33,0,0,0,33
2024848,1558382,2025-04-21,House,"FLOOR VOTE: CONSENT CALENDAR PASSAGE ON THIRD CONSIDERATION",86,0,1,0,87
2024852,1553820,2025-04-21,House,"FLOOR VOTE: CONSENT CALENDAR PASSAGE ON THIRD CONSIDERATION",86,0,1,0,87
2024852,1557097,2025-04-22,Senate,"FLOOR VOTE: Motion to Adopt",32,0,0,0,32
2024858,1552707,2025-04-21,Senate,"FLOOR VOTE: Motion to Adopt",33,0,0,0,33
2024863,1558390,2025-04-21,House,"FLOOR VOTE: CONSENT CALENDAR PASSAGE ON THIRD CONSIDERATION",86,0,1,0,87
2024867,1554210,2025-04-21,House,"FLOOR VOTE: CONSENT CALENDAR PASSAGE ON THIRD CONSIDERATION",86,0,1,0,87
2024867,1556848,2025-04-22,Senate,"FLOOR VOTE: Motion to Adopt",32,0,0,0,32
2024870,1558398,2025-04-21,House,"FLOOR VOTE: CONSENT CALENDAR PASSAGE ON THIRD CONSIDERATION",86,0,1,0,87
2024877,1558413,2025-04-21,House,"FLOOR VOTE: CONSENT CALENDAR PASSAGE ON THIRD CONSIDERATION",86,0,1,0,87
2024879,1558411,2025-04-21,House,"FLOOR VOTE: CONSENT CALENDAR PASSAGE ON THIRD CONSIDERATION",86,0,1,0,87
2024883,1553239,2025-04-21,House,"FLOOR VOTE: CONSENT CALENDAR PASSAGE ON THIRD CONSIDERATION",86,0,1,0,87
2024883,1557269,2025-04-22,Senate,"FLOOR VOTE: Motion to Adopt",32,0,0,0,32
2024886,1558362,2025-04-21,House,"FLOOR VOTE: CONSENT CALENDAR PASSAGE ON THIRD CONSIDERATION",86,0,1,0,87
2024892,1554175,2025-04-22,House,"FLOOR VOTE: REGULAR CALENDAR MOTION TO ADOPT",94,0,0,0,94
2024897,1553010,2025-04-21,Senate,"FLOOR VOTE: Motion to Adopt",33,0,0,0,33
2024904,1558412,2025-04-21,House,"FLOOR VOTE: CONSENT CALENDAR PASSAGE ON THIRD CONSIDERATION",86,0,1,0,87
2024911,1553201,2025-04-21,Senate,"FLOOR VOTE: Motion to Adopt",33,0,0,0,33
2024915,1558388,2025-04-21,House,"FLOOR VOTE: CONSENT CALENDAR PASSAGE ON THIRD CONSIDERATION",86,0,1,0,87
2024920,1554221,2025-04-21,House,"FLOOR VOTE: CONSENT CALENDAR PASSAGE ON THIRD CONSIDERATION",86,0,1,0,87
2024920,1556792,2025-04-22,Senate,"FLOOR VOTE: Motion to Adopt",32,0,0,0,32
2024922,1554183,2025-04-21,House,"FLOOR VOTE: CONSENT CALENDAR PASSAGE ON THIRD CONSIDERATION",86,0,1,0,87
2024922,1557361,2025-04-22,Senate,"FLOOR VOTE: Motion to Adopt",32,0,0,0,32
2024930,1554227,2025-04-21,House,"FLOOR VOTE: CONSENT CALENDAR PASSAGE ON THIRD CONSIDERATION",86,0,1,0,87
2024930,1556445,2025-04-22,Senate,"FLOOR VOTE: Motion to Adopt",32,0,0,0,32
2024933,1553058,2025-04-21,Senate,"FLOOR VOTE: Motion to Adopt",33,0,0,0,33
2024935,1558434,2025-04-21,House,"FLOOR VOTE: CONSENT CALENDAR PASSAGE ON THIRD CONSIDERATION",86,0,1,0,87
2024941,1558378,2025-04-21,House,"FLOOR VOTE: CONSENT CALENDAR PASSAGE ON THIRD CONSIDERATION",86,0,1,0,87
2024946,1558386,2025-04-21,House,"FLOOR VOTE: CONSENT CALENDAR PASSAGE ON THIRD CONSIDERATION",86,0,1,0,87
2024950,1552981,2025-04-21,Senate,"FLOOR VOTE: Motion to Adopt",33,0,0,0,33
2024955,1553953,2025-04-21,House,"FLOOR VOTE: CONSENT CALENDAR PASSAGE ON THIRD CONSIDERATION",86,0,1,0,87
2024955,1557198,2025-04-22,Senate,"FLOOR VOTE: Motion to Adopt",32,0,0,0,32
2024959,1558425,2025-04-21,House,"FLOOR VOTE: CONSENT CALENDAR PASSAGE ON THIRD CONSIDERATION",86,0,1,0,87
2024965,1558420,2025-04-21,House,"FLOOR VOTE: CONSENT CALENDAR PASSAGE ON THIRD CONSIDERATION",86,0,1,0,87
2024970,1552767,2025-04-21,Senate,"FLOOR VOTE: Motion to Adopt",33,0,0,0,33
2024974,1558389,2025-04-21,House,"FLOOR VOTE: CONSENT CALENDAR PASSAGE ON THIRD CONSIDERATION",86,0,1,0,87
2024985,1558433,2025-04-21,House,"FLOOR VOTE: CONSENT CALENDAR PASSAGE ON THIRD CONSIDERATION",86,0,1,0,87
2025010,1558410,2025-04-21,House,"FLOOR VOTE: CONSENT CALENDAR PASSAGE ON THIRD CONSIDERATION",86,0,1,0,87
2025149,1554803,2025-04-22,House,"FLOOR VOTE: CONSENT CALENDAR 3 PASSAGE ON THIRD CONSIDERATION",95,0,0,0,95
2025149,1556524,2025-04-22,Senate,"FLOOR VOTE: Motion to Adopt",33,0,0,0,33
2025151,1554190,2025-04-22,House,"FLOOR VOTE: CONSENT CALENDAR 3 PASSAGE ON THIRD CONSIDERATION",95,0,0,0,95
2025151,1556817,2025-04-22,Senate,"FLOOR VOTE: Motion to Adopt",33,0,0,0,33
2025152,1554826,2025-04-22,House,"FLOOR VOTE: CONSENT CALENDAR 3 PASSAGE ON THIRD CONSIDERATION",95,0,0,0,95
2025152,1556733,2025-04-22,Senate,"FLOOR VOTE: Motion to Adopt",33,0,0,0,33
2025154,1554236,2025-04-22,House,"FLOOR VOTE: CONSENT CALENDAR 3 PASSAGE ON THIRD CONSIDERATION",95,0,0,0,95
2025154,1557378,2025-04-22,Senate,"FLOOR VOTE: Motion to Adopt",33,0,0,0,33
2025156,1554217,2025-04-22,House,"FLOOR VOTE: CONSENT CALENDAR 3 PASSAGE ON THIRD CONSIDERATION",95,0,0,0,95
2025156,1557158,2025-04-22,Senate,"FLOOR VOTE: Motion to Adopt",33,0,0,0,33
2025159,1554947,2025-04-22,House,"FLOOR VOTE: CONSENT CALENDAR 3 PASSAGE ON THIRD CONSIDERATION",95,0,0,0,95
2025159,1557179,2025-04-22,Senate,"FLOOR VOTE: Motion to Adopt",33,0,0,0,33
2025162,1554814,2025-04-22,House,"FLOOR VOTE: CONSENT CALENDAR 3 PASSAGE ON THIRD CONSIDERATION",95,0,0,0,95
2025162,1556701,2025-04-22,Senate,"FLOOR VOTE: Motion to Adopt",33,0,0,0,33
2025164,1554801,2025-04-22,House,"FLOOR VOTE: CONSENT CALENDAR 3 PASSAGE ON THIRD CONSIDERATION",95,0,0,0,95
2025164,1556508,2025-04-22,Senate,"FLOOR VOTE: Motion to Adopt",33,0,0,0,33
2025166,1554867,2025-04-22,House,"FLOOR VOTE: CONSENT CALENDAR 3 PASSAGE ON THIRD CONSIDERATION",95,0,0,0,95
2025166,1556902,2025-04-22,Senate,"FLOOR VOTE: Motion to Adopt",33,0,0,0,33
2025168,1554811,2025-04-22,House,"FLOOR VOTE: CONSENT CALENDAR 3 PASSAGE ON THIRD CONSIDERATION",95,0,0,0,95
2025168,1557323,2025-04-22,Senate,"FLOOR VOTE: Motion to Adopt",33,0,0,0,33
2025171,1554806,2025-04-22,House,"FLOOR VOTE: CONSENT CALENDAR 3 PASSAGE ON THIRD CONSIDERATION",95,0,0,0,95
2025171,1557300,2025-04-22,Senate,"FLOOR VOTE: Motion to Adopt",33,0,0,0,33
2025176,1553627,2025-04-21,House,"FLOOR VOTE: CONSENT CALENDAR 2 PASSAGE ON THIRD CONSIDERATION",88,0,4,0,92
2025176,1556822,2025-04-22,Senate,"FLOOR VOTE: Motion to Adopt",32,0,0,0,32
2025178,1554845,2025-04-22,House,"FLOOR VOTE: CONSENT CALENDAR PASSAGE ON THIRD CONSIDERATION",94,0,1,0,95
2025180,1554211,2025-04-22,House,"FLOOR VOTE: CONSENT CALENDAR 3 PASSAGE ON THIRD CONSIDERATION",95,0,0,0,95
2025180,1556980,2025-04-22,Senate,"FLOOR VOTE: Motion to Adopt",33,0,0,0,33
2025181,1554810,2025-04-22,House,"FLOOR VOTE: CONSENT CALENDAR 3 PASSAGE ON THIRD CONSIDERATION",95,0,0,0,95
2025181,1557328,2025-04-22,Senate,"FLOOR VOTE: Motion to Adopt",33,0,0,0,33
2025183,1554926,2025-04-22,House,"FLOOR VOTE: CONSENT CALENDAR 3 PASSAGE ON THIRD CONSIDERATION",95,0,0,0,95
2025183,1557085,2025-04-22,Senate,"FLOOR VOTE: Motion to Adopt",33,0,0,0,33
2025184,1554216,2025-04-22,House,"FLOOR VOTE: CONSENT CALENDAR 3 PASSAGE ON THIRD CONSIDERATION",95,0,0,0,95
2025184,1557144,2025-04-22,Senate,"FLOOR VOTE: Motion to Adopt",33,0,0,0,33
2025188,1554820,2025-04-22,House,"FLOOR VOTE: CONSENT CALENDAR 3 PASSAGE ON THIRD CONSIDERATION",95,0,0,0,95
2025188,1556717,2025-04-22,Senate,"FLOOR VOTE: Motion to Adopt",33,0,0,0,33
2025190,1554173,2025-04-22,House,"FLOOR VOTE: CONSENT CALENDAR 3 PASSAGE ON THIRD CONSIDERATION",95,0,0,0,95
2025190,1556847,2025-04-22,Senate,"FLOOR VOTE: Motion to Adopt",33,0,0,0,33
2025192,1554804,2025-04-22,House,"FLOOR VOTE: CONSENT CALENDAR 3 PASSAGE ON THIRD CONSIDERATION",95,0,0,0,95
2025192,1557356,2025-04-22,Senate,"FLOOR VOTE: Motion to Adopt",33,0,0,0,33
2025194,1554765,2025-04-22,House,"FLOOR VOTE: CONSENT CALENDAR 3 PASSAGE ON THIRD CONSIDERATION",95,0,0,0,95
2025194,1557339,2025-04-22,Senate,"FLOOR VOTE: Motion to Adopt",33,0,0,0,33
2025196,1554834,2025-04-22,House,"FLOOR VOTE: CONSENT CALENDAR 3 PASSAGE ON THIRD CONSIDERATION",95,0,0,0,95
2025196,1556740,2025-04-22,Senate,"FLOOR VOTE: Motion to Adopt",33,0,0,0,33
2025198,1554907,2025-04-22,House,"FLOOR VOTE: CONSENT CALENDAR 3 PASSAGE ON THIRD CONSIDERATION",95,0,0,0,95
2025198,1556545,2025-04-22,Senate,"FLOOR VOTE: Motion to Adopt",33,0,0,0,33
2025202,1554312,2025-04-22,House,"FLOOR VOTE: CONSENT CALENDAR 3 PASSAGE ON THIRD CONSIDERATION",95,0,0,0,95
2025202,1557384,2025-04-22,Senate,"FLOOR VOTE: Motion to Adopt",33,0,0,0,33
2025204,1554816,2025-04-22,House,"FLOOR VOTE: CONSENT CALENDAR 3 PASSAGE ON THIRD CONSIDERATION",95,0,0,0,95
2025204,1557415,2025-04-22,Senate,"FLOOR VOTE: Motion to Adopt",33,0,0,0,33
2025206,1554929,2025-04-22,House,"FLOOR VOTE: CONSENT CALENDAR 3 PASSAGE ON THIRD CONSIDERATION",95,0,0,0,95
2025206,1557115,2025-04-22,Senate,"FLOOR VOTE: Motion to Adopt",33,0,0,0,33
2025208,1554923,2025-04-22,House,"FLOOR VOTE: CONSENT CALENDAR 3 PASSAGE ON THIRD CONSIDERATION",95,0,0,0,95
2025208,1556835,2025-04-22,Senate,"FLOOR VOTE: Motion to Adopt",33,0,0,0,33
2025209,1554159,2025-04-22,House,"FLOOR VOTE: CONSENT CALENDAR 3 PASSAGE ON THIRD CONSIDERATION",95,0,0,0,95
2025209,1557025,2025-04-22,Senate,"FLOOR VOTE: Motion to Adopt",33,0,0,0,33
2025210,1554800,2025-04-22,House,"FLOOR VOTE: CONSENT CALENDAR 3 PASSAGE ON THIRD CONSIDERATION",95,0,0,0,95
2025210,1556431,2025-04-22,Senate,"FLOOR VOTE: Motion to Adopt",33,0,0,0,33
2025211,1554204,2025-04-22,House,"FLOOR VOTE: CONSENT CALENDAR 3 PASSAGE ON THIRD CONSIDERATION",95,0,0,0,95
2025211,1556852,2025-04-22,Senate,"FLOOR VOTE: Motion to Adopt",33,0,0,0,33
2025215,1554821,2025-04-22,House,"FLOOR VOTE: CONSENT CALENDAR 3 PASSAGE ON THIRD CONSIDERATION",95,0,0,0,95
2025215,1556887,2025-04-22,Senate,"FLOOR VOTE: Motion to Adopt",33,0,0,0,33
2025217,1554797,2025-04-22,House,"FLOOR VOTE: CONSENT CALENDAR 3 PASSAGE ON THIRD CONSIDERATION",95,0,0,0,95
2025217,1556724,2025-04-22,Senate,"FLOOR VOTE: Motion to Adopt",33,0,0,0,33
2025218,1554235,2025-04-22,House,"FLOOR VOTE: CONSENT CALENDAR 3 PASSAGE ON THIRD CONSIDERATION",95,0,0,0,95
2025218,1556938,2025-04-22,Senate,"FLOOR VOTE: Motion to Adopt",33,0,0,0,33
2025219,1554165,2025-04-22,House,"FLOOR VOTE: CONSENT CALENDAR 3 PASSAGE ON THIRD CONSIDERATION",95,0,0,0,95
2025219,1557177,2025-04-22,Senate,"FLOOR VOTE: Motion to Adopt",33,0,0,0,33
2025220,1554939,2025-04-22,House,"FLOOR VOTE: CONSENT CALENDAR 3 PASSAGE ON THIRD CONSIDERATION",95,0,0,0,95
2025220,1557145,2025-04-22,Senate,"FLOOR VOTE: Motion to Adopt",33,0,0,0,33
2025222,1554862,2025-04-22,House,"FLOOR VOTE: CONSENT CALENDAR 3 PASSAGE ON THIRD CONSIDERATION",95,0,0,0,95
2025222,1556586,2025-04-22,Senate,"FLOOR VOTE: Motion to Adopt",33,0,0,0,33
2025229,1554188,2025-04-22,House,"FLOOR VOTE: CONSENT CALENDAR PASSAGE ON THIRD CONSIDERATION",94,0,1,0,95
2025229,1557050,2025-04-22,Senate,"FLOOR VOTE: Motion to Adopt",32,0,0,0,32
2025238,1556484,2025-04-22,Senate,"FLOOR VOTE: Motion to Adopt",33,0,0,0,33
2025248,1557291,2025-04-22,Senate,"FLOOR VOTE: Motion to Adopt",32,0,0,0,32
2025258,1553437,2025-04-21,House,"FLOOR VOTE: CONSENT CALENDAR 2 PASSAGE ON THIRD CONSIDERATION",88,0,4,0,92
2025269,1553449,2025-04-21,House,"FLOOR VOTE: CONSENT CALENDAR 2 PASSAGE ON THIRD CONSIDERATION",88,0,4,0,92
2025269,1557360,2025-04-22,Senate,"FLOOR VOTE: Motion to Adopt",32,0,0,0,32
2025279,1553522,2025-04-21,House,"FLOOR VOTE: CONSENT CALENDAR 2 PASSAGE ON THIRD CONSIDERATION",88,0,4,0,92
2025292,1553528,2025-04-21,House,"FLOOR VOTE: CONSENT CALENDAR 2 PASSAGE ON THIRD CONSIDERATION",88,0,4,0,92
2025303,1553531,2025-04-21,House,"FLOOR VOTE: CONSENT CALENDAR 2 PASSAGE ON THIRD CONSIDERATION",88,0,4,0,92
2025315,1554677,2025-04-22,House,"FLOOR VOTE: CONSENT CALENDAR PASSAGE ON THIRD CONSIDERATION",94,0,1,0,95
2025315,1557307,2025-04-22,Senate,"FLOOR VOTE: Motion to Adopt",32,0,0,0,32
2025327,1553561,2025-04-21,House,"FLOOR VOTE: CONSENT CALENDAR 2 PASSAGE ON THIRD CONSIDERATION",88,0,4,0,92
2025327,1557063,2025-04-22,Senate,"FLOOR VOTE: Motion to Adopt",32,0,0,0,32
2025346,1556893,2025-04-22,Senate,"FLOOR VOTE: Motion to Adopt",32,0,0,0,32
2025347,1554397,2025-04-22,House,"FLOOR VOTE: CONSENT CALENDAR PASSAGE ON THIRD CONSIDERATION",94,0,1,0,95
2025347,1556798,2025-04-22,Senate,"FLOOR VOTE: Motion to Adopt",32,0,0,0,32
2025349,1554391,2025-04-22,House,"FLOOR VOTE: CONSENT CALENDAR 3 PASSAGE ON THIRD CONSIDERATION",95,0,0,0,95
2025349,1557276,2025-04-22,Senate,"FLOOR VOTE: Motion to Adopt",33,0,0,0,33
2025351,1555065,2025-04-22,House,"FLOOR VOTE: CONSENT CALENDAR PASSAGE ON THIRD CONSIDERATION",94,0,1,0,95
2025353,1553961,2025-04-22,House,"FLOOR VOTE: CONSENT CALENDAR 3 PASSAGE ON THIRD CONSIDERATION",95,0,0,0,95
2025353,1557072,2025-04-22,Senate,"FLOOR VOTE: Motion to Adopt",33,0,0,0,33
2025355,1554718,2025-04-22,House,"FLOOR VOTE: CONSENT CALENDAR 3 PASSAGE ON THIRD CONSIDERATION",95,0,0,0,95
2025355,1557326,2025-04-22,Senate,"FLOOR VOTE: Motion to Adopt",33,0,0,0,33
2025356,1554844,2025-04-22,House,"FLOOR VOTE: CONSENT CALENDAR 3 PASSAGE ON THIRD CONSIDERATION",95,0,0,0,95
2025356,1556797,2025-04-22,Senate,"FLOOR VOTE: Motion to Adopt",33,0,0,0,33
2025357,1554202,2025-04-22,House,"FLOOR VOTE: CONSENT CALENDAR 3 PASSAGE ON THIRD CONSIDERATION",95,0,0,0,95
2025357,1557374,2025-04-22,Senate,"FLOOR VOTE: Motion to Adopt",33,0,0,0,33
2025359,1554819,2025-04-22,House,"FLOOR VOTE: CONSENT CALENDAR 3 PASSAGE ON THIRD CONSIDERATION",95,0,0,0,95
2025359,1557218,2025-04-22,Senate,"FLOOR VOTE: Motion to Adopt",33,0,0,0,33
2025361,1554178,2025-04-22,House,"FLOOR VOTE: CONSENT CALENDAR 3 PASSAGE ON THIRD CONSIDERATION",95,0,0,0,95
2025361,1557358,2025-04-22,Senate,"FLOOR VOTE: Motion to Adopt",33,0,0,0,33
2025363,1554218,2025-04-22,House,"FLOOR VOTE: CONSENT CALENDAR 3 PASSAGE ON THIRD CONSIDERATION",95,0,0,0,95
2025363,1557132,2025-04-22,Senate,"FLOOR VOTE: Motion to Adopt",33,0,0,0,33
2025365,1554809,2025-04-22,House,"FLOOR VOTE: CONSENT CALENDAR 3 PASSAGE ON THIRD CONSIDERATION",95,0,0,0,95
2025365,1557322,2025-04-22,Senate,"FLOOR VOTE: Motion to Adopt",33,0,0,0,33
2025368,1554812,2025-04-22,House,"FLOOR VOTE: CONSENT CALENDAR 3 PASSAGE ON THIRD CONSIDERATION",95,0,0,0,95
2025368,1556694,2025-04-22,Senate,"FLOOR VOTE: Motion to Adopt",33,0,0,0,33
2025370,1554869,2025-04-22,House,"FLOOR VOTE: CONSENT CALENDAR PASSAGE ON THIRD CONSIDERATION",94,0,1,0,95
2025370,1556991,2025-04-22,Senate,"FLOOR VOTE: Motion to Adopt",32,0,0,0,32
2025371,1554805,2025-04-22,House,"FLOOR VOTE: CONSENT CALENDAR 3 PASSAGE ON THIRD CONSIDERATION",95,0,0,0,95
2025371,1557333,2025-04-22,Senate,"FLOOR VOTE: Motion to Adopt",33,0,0,0,33
2025372,1554822,2025-04-22,House,"FLOOR VOTE: CONSENT CALENDAR 3 PASSAGE ON THIRD CONSIDERATION",95,0,0,0,95
2025372,1556725,2025-04-22,Senate,"FLOOR VOTE: Motion to Adopt",33,0,0,0,33
2025373,1554340,2025-04-22,House,"FLOOR VOTE: CONSENT CALENDAR 3 PASSAGE ON THIRD CONSIDERATION",95,0,0,0,95
2025373,1557403,2025-04-22,Senate,"FLOOR VOTE: Motion to Adopt",33,0,0,0,33
2025374,1554170,2025-04-22,House,"FLOOR VOTE: CONSENT CALENDAR 3 PASSAGE ON THIRD CONSIDERATION",95,0,0,0,95
2025374,1556828,2025-04-22,Senate,"FLOOR VOTE: Motion to Adopt",33,0,0,0,33
2025396,1553992,2025-04-22,House,"FLOOR VOTE: CONSENT CALENDAR 3 PASSAGE ON THIRD CONSIDERATION",95,0,0,0,95
2025396,1557104,2025-04-22,Senate,"FLOOR VOTE: Motion to Adopt",32,0,0,0,32
2025397,1554928,2025-04-22,House,"FLOOR VOTE: CONSENT CALENDAR 4 PASSAGE ON THIRD CONSIDERATION",92,0,4,0,96
2025397,1556813,2025-04-22,Senate,"FLOOR VOTE: Motion to Adopt",32,0,0,0,32
2025402,1554934,2025-04-22,House,"FLOOR VOTE: CONSENT CALENDAR 4 PASSAGE ON THIRD CONSIDERATION",92,0,4,0,96
2025402,1557098,2025-04-22,Senate,"FLOOR VOTE: Motion to Adopt",32,0,0,0,32
2025408,1554920,2025-04-22,House,"FLOOR VOTE: CONSENT CALENDAR 4 PASSAGE ON THIRD CONSIDERATION",92,0,4,0,96
2025408,1556827,2025-04-22,Senate,"FLOOR VOTE: Motion to Adopt",32,0,0,0,32
2025411,1554422,2025-04-22,House,"FLOOR VOTE: CONSENT CALENDAR 3 PASSAGE ON THIRD CONSIDERATION",95,0,0,0,95
2025411,1556782,2025-04-22,Senate,"FLOOR VOTE: Motion to Adopt",32,0,0,0,32
2025416,1558432,2025-04-22,House,"FLOOR VOTE: CONSENT CALENDAR 3 PASSAGE ON THIRD CONSIDERATION",95,0,0,0,95
2025421,1554948,2025-04-22,House,"FLOOR VOTE: CONSENT CALENDAR 4 PASSAGE ON THIRD CONSIDERATION",92,0,4,0,96
2025421,1556840,2025-04-22,Senate,"FLOOR VOTE: Motion to Adopt",32,0,0,0,32
2025425,1554778,2025-04-22,House,"FLOOR VOTE: CONSENT CALENDAR 4 PASSAGE ON THIRD CONSIDERATION",92,0,4,0,96
2025425,1556956,2025-04-22,Senate,"FLOOR VOTE: Motion to Adopt",32,0,0,0,32
2025429,1554254,2025-04-22,House,"FLOOR VOTE: CONSENT CALENDAR 3 PASSAGE ON THIRD CONSIDERATION",95,0,0,0,95
2025429,1557122,2025-04-22,Senate,"FLOOR VOTE: Motion to Adopt",32,0,0,0,32
2025435,1554927,2025-04-22,House,"FLOOR VOTE: CONSENT CALENDAR 4 PASSAGE ON THIRD CONSIDERATION",92,0,4,0,96
2025435,1556811,2025-04-22,Senate,"FLOOR VOTE: Motion to Adopt",32,0,0,0,32
2025442,1554415,2025-04-22,House,"FLOOR VOTE: CONSENT CALENDAR 4 PASSAGE ON THIRD CONSIDERATION",92,0,4,0,96
2025442,1556429,2025-04-22,Senate,"FLOOR VOTE: Motion to Adopt",32,0,0,0,32
2025447,1554931,2025-04-22,House,"FLOOR VOTE: CONSENT CALENDAR 3 PASSAGE ON THIRD CONSIDERATION",95,0,0,0,95
2025447,1556729,2025-04-22,Senate,"FLOOR VOTE: Motion to Adopt",32,0,0,0,32
2025449,1554409,2025-04-22,House,"FLOOR VOTE: CONSENT CALENDAR 4 PASSAGE ON THIRD CONSIDERATION",92,0,4,0,96
2025449,1557102,2025-04-22,Senate,"FLOOR VOTE: Motion to Adopt",32,0,0,0,32
2025454,1554842,2025-04-22,House,"FLOOR VOTE: CONSENT CALENDAR 4 PASSAGE ON THIRD CONSIDERATION",92,0,4,0,96
2025454,1557425,2025-04-22,Senate,"FLOOR VOTE: Motion to Adopt",32,0,0,0,32
2025457,1554414,2025-04-22,House,"FLOOR VOTE: CONSENT CALENDAR 4 PASSAGE ON THIRD CONSIDERATION",92,0,4,0,96
2025457,1556799,2025-04-22,Senate,"FLOOR VOTE: Motion to Adopt",32,0,0,0,32
2025464,1554275,2025-04-22,House,"FLOOR VOTE: CONSENT CALENDAR 3 PASSAGE ON THIRD CONSIDERATION",95,0,0,0,95
2025464,1556818,2025-04-22,Senate,"FLOOR VOTE: Motion to Adopt",32,0,0,0,32
2025470,1554916,2025-04-22,House,"FLOOR VOTE: CONSENT CALENDAR 3 PASSAGE ON THIRD CONSIDERATION",95,0,0,0,95
2025470,1556802,2025-04-22,Senate,"FLOOR VOTE: Motion to Adopt",32,0,0,0,32
2025479,1554695,2025-04-22,House,"FLOOR VOTE: CONSENT CALENDAR 3 PASSAGE ON THIRD CONSIDERATION",95,0,0,0,95
2025479,1556564,2025-04-22,Senate,"FLOOR VOTE: Motion to Adopt",32,0,0,0,32
2025484,1554748,2025-04-22,House,"FLOOR VOTE: CONSENT CALENDAR 3 PASSAGE ON THIRD CONSIDERATION",95,0,0,0,95
2025484,1556781,2025-04-22,Senate,"FLOOR VOTE: Motion to Adopt",32,0,0,0,32
2025488,1554413,2025-04-22,House,"FLOOR VOTE: CONSENT CALENDAR 3 PASSAGE ON THIRD CONSIDERATION",95,0,0,0,95
2025490,1554416,2025-04-22,House,"FLOOR VOTE: CONSENT CALENDAR 4 PASSAGE ON THIRD CONSIDERATION",92,0,4,0,96
2025490,1556403,2025-04-22,Senate,"FLOOR VOTE: Motion to Adopt",32,0,0,0,32
2025496,1554900,2025-04-22,House,"FLOOR VOTE: CONSENT CALENDAR 4 PASSAGE ON THIRD CONSIDERATION",92,0,4,0,96
2025496,1557045,2025-04-22,Senate,"FLOOR VOTE: Motion to Adopt",32,0,0,0,32
2025500,1554417,2025-04-22,House,"FLOOR VOTE: CONSENT CALENDAR 3 PASSAGE ON THIRD CONSIDERATION",95,0,0,0,95
2025500,1556883,2025-04-22,Senate,"FLOOR VOTE: Motion to Adopt",32,0,0,0,32
2025505,1554909,2025-04-22,House,"FLOOR VOTE: CONSENT CALENDAR 4 PASSAGE ON THIRD CONSIDERATION",92,0,4,0,96
2025505,1556410,2025-04-22,Senate,"FLOOR VOTE: Motion to Adopt",32,0,0,0,32
2025508,1554421,2025-04-22,House,"FLOOR VOTE: CONSENT CALENDAR 4 PASSAGE ON THIRD CONSIDERATION",92,0,4,0,96
2025508,1556480,2025-04-22,Senate,"FLOOR VOTE: Motion to Adopt",32,0,0,0,32
2025539,1556809,2025-04-22,Senate,"FLOOR VOTE: Motion to Adopt",32,0,0,0,32
2025561,1556697,2025-04-22,Senate,"FLOOR VOTE: Motion to Adopt",32,0,0,0,32
2025578,1556815,2025-04-22,Senate,"FLOOR VOTE: Motion to Adopt",32,0,0,0,32
2025619,1556831,2025-04-22,Senate,"FLOOR VOTE: Motion to Adopt",32,0,0,0,32
2025656,1556726,2025-04-22,Senate,"FLOOR VOTE: Motion to Adopt",32,0,0,0,32
2025709,1557421,2025-04-22,Senate,"FLOOR VOTE: Motion to Adopt",32,0,0,0,32
2025728,1557255,2025-04-22,Senate,"FLOOR VOTE: Motion to Adopt",32,0,0,0,32
2025753,1558437,2025-04-22,House,"FLOOR VOTE: CONSENT CALENDAR 4 PASSAGE ON THIRD CONSIDERATION",92,0,4,0,96
2025823,1556953,2025-04-22,Senate,"FLOOR VOTE: Motion to Adopt",32,0,0,0,32
2025843,1554941,2025-04-22,House,"FLOOR VOTE: CONSENT CALENDAR 4 PASSAGE ON THIRD CONSIDERATION",92,0,4,0,96
2025863,1556463,2025-04-22,Senate,"FLOOR VOTE: Motion to Adopt",32,0,0,0,32
