bill_id,roll_call_id,date,chamber,description,yea,nay,nv,absent,total
1904811,1475523,2025-01-27,Joint,"PD Vote Tally Sheet (Reserved for Subject Matter Public Hearing)",0,0,0,0,0
1904820,1493803,2025-02-18,Joint,"FIN Vote Tally Sheet (Reserved for Subject Matter Public Hearing)",0,0,0,0,0
1904826,1484836,2025-02-10,Joint,"ENV Vote Tally Sheet (Vote to Draft)",23,11,0,1,35
1904826,1518008,2025-03-14,Joint,"ENV Vote Tally Sheet (Joint Favorable Substitute)",23,10,0,1,34
1904826,1518009,2025-03-14,Joint,"ENV Vote Tally Sheet-A",10,19,0,5,34
1904826,1518010,2025-03-14,Joint,"ENV Vote Tally Sheet-B",8,20,0,6,34
1904826,1518011,2025-03-14,Joint,"ENV Vote Tally Sheet-C",8,21,0,5,34
1904826,1564141,2025-05-01,House,"House Roll Call Vote 62 AS AMENDED ",98,47,0,6,151
1904826,1584618,2025-06-04,Senate,"Senate Roll Call Vote 383 ",26,10,0,0,36
1904839,1473925,2025-01-23,Joint,"CE Vote Tally Sheet (Reserved for Subject Matter Public Hearing)",0,0,0,0,0
1904839,1502421,2025-02-20,Joint,"CE Vote Tally Sheet (Vote to Draft)",0,0,0,0,0
1904839,1519497,2025-03-18,Joint,"CE Vote Tally Sheet (Joint Favorable)",20,0,0,0,20
1904839,1568847,2025-05-08,House,"House Roll Call Vote 76 ",141,0,0,10,151
1904839,1575527,2025-05-21,Senate,"Senate Roll Call Vote 210 ",36,0,0,0,36
1904846,1474521,2025-01-23,Joint,"HSG Vote Tally Sheet (Reserved for Subject Matter Public Hearing)",14,6,0,0,20
1904846,1495228,2025-02-20,Joint,"HSG Vote Tally Sheet (Vote to Draft)",12,6,0,2,20
1904846,1508652,2025-03-06,Joint,"HSG Vote Tally Sheet (Joint Favorable)",12,6,0,2,20
1904846,1565378,2025-05-05,Joint,"FIN Vote Tally Sheet (Joint Favorable)",32,20,0,2,54
1904846,1570013,2025-05-12,Joint,"APP Vote Tally Sheet (Joint Favorable)",37,11,0,5,53
1904847,1474477,2025-01-23,Joint,"HSG Vote Tally Sheet (Reserved for Subject Matter Public Hearing)",20,0,0,0,20
1904847,1496069,2025-02-20,Joint,"HSG Vote Tally Sheet (Vote to Draft)",12,6,0,2,20
1904847,1508653,2025-03-06,Joint,"HSG Vote Tally Sheet (Joint Favorable)",13,5,0,2,20
1904847,1565026,2025-05-05,Joint,"FIN Vote Tally Sheet (Joint Favorable)",38,14,0,2,54
1904847,1572754,2025-05-16,Joint,"APP Vote Tally Sheet (Joint Favorable)",36,13,0,4,53
1904847,1579228,2025-05-27,House,"House Roll Call Vote 196 AS AMENDED ",84,67,0,0,151
1904847,1579229,2025-05-27,House,"House Roll Call Vote 195 HOUSE AMD J",51,100,0,0,151
1904847,1579230,2025-05-27,House,"House Roll Call Vote 194 HOUSE AMD I",50,101,0,0,151
1904847,1579231,2025-05-27,House,"House Roll Call Vote 193 HOUSE AMD H",50,101,0,0,151
1904847,1579232,2025-05-27,House,"House Roll Call Vote 192 HOUSE AMD G",50,101,0,0,151
1904847,1579233,2025-05-27,House,"House Roll Call Vote 191 HOUSE AMD E",50,101,0,0,151
1904847,1579234,2025-05-27,House,"House Roll Call Vote 190 HOUSE AMD D",0,150,0,1,151
1904847,1579235,2025-05-27,House,"House Roll Call Vote 189 HOUSE AMD C",48,100,0,3,151
1904847,1579236,2025-05-27,House,"House Roll Call Vote 188 HOUSE AMD B",92,47,0,12,151
1904847,1579237,2025-05-27,House,"House Roll Call Vote 187 HOUSE AMD A",89,46,0,16,151
1904847,1582313,2025-05-31,Senate,"Senate Roll Call Vote 323 ",20,15,1,0,36
1904847,1582314,2025-05-31,Senate,"Senate Roll Call Vote 322 ",11,24,1,0,36
1904847,1582315,2025-05-31,Senate,"Senate Roll Call Vote 321 ",11,24,1,0,36
1904847,1582316,2025-05-31,Senate,"Senate Roll Call Vote 320 ",11,24,1,0,36
1904847,1582317,2025-05-31,Senate,"Senate Roll Call Vote 319 ",10,25,1,0,36
1904847,1582318,2025-05-31,Senate,"Senate Roll Call Vote 318 ",11,24,1,0,36
1904847,1582319,2025-05-31,Senate,"Senate Roll Call Vote 317 ",11,24,1,0,36
1904847,1582320,2025-05-31,Senate,"Senate Roll Call Vote 316 ",11,24,1,0,36
1904847,1582321,2025-05-31,Senate,"Senate Roll Call Vote 315 ",11,24,1,0,36
1904847,1582322,2025-05-30,Senate,"Senate Roll Call Vote 314 ",11,24,1,0,36
1904848,1492440,2025-02-14,Joint,"GAE Vote Tally Sheet (Vote to Draft)",0,0,0,0,0
1904857,1492961,2025-02-18,Joint,"APP Vote Tally Sheet (Reserved for Subject Matter Public Hearing)",0,0,0,0,0
1904859,1491738,2025-02-14,Joint,"GAE Vote Tally Sheet (Vote to Draft)",0,0,0,0,0
1904860,1474337,2025-01-24,Joint,"ENV Vote Tally Sheet (Vote to Draft)",0,0,0,0,0
1904863,1485848,2025-02-10,Joint,"ENV Vote Tally Sheet (Vote to Draft)",0,0,0,0,0
1904863,1517982,2025-03-14,Joint,"ENV Vote Tally Sheet (Joint Favorable Substitute)",24,9,0,1,34
1904863,1558680,2025-04-25,Joint,"JUD Vote Tally Sheet (Joint Favorable)",25,12,0,4,41
1904863,1565647,2025-05-05,Joint,"APP Vote Tally Sheet (Joint Favorable)",40,10,0,3,53
1904863,1569510,2025-05-12,Joint,"FIN Vote Tally Sheet (Joint Favorable)",38,16,0,0,54
1904863,1572213,2025-05-15,Senate,"Senate Roll Call Vote 176 ",28,8,0,0,36
1904863,1580476,2025-05-28,House,"House Roll Call Vote 200 AS AMENDED ",115,33,0,3,151
1904870,1489287,2025-01-23,Joint,"ET Vote Tally Sheet (Change of Reference)",0,0,0,0,0
1904872,1472749,2025-01-17,Joint,"PD Vote Tally Sheet (Change of Reference)",0,0,0,0,0
1904876,1474305,2025-01-24,Joint,"ENV Vote Tally Sheet (Change of Reference)",0,0,0,0,0
1904885,1472997,2025-01-22,Joint,"TRA Vote Tally Sheet (Change of Reference)",0,0,0,0,0
1904885,1477622,2025-01-30,Joint,"CE Vote Tally Sheet (Vote to Draft)",0,0,0,0,0
1904885,1523342,2025-03-20,Joint,"CE Vote Tally Sheet (House)",13,0,0,0,13
1904901,1473263,2025-01-22,Joint,"GL Vote Tally Sheet (Vote to Draft)",0,0,0,0,0
1904901,1524201,2025-03-21,Joint,"GL Vote Tally Sheet (Joint Favorable Substitute)",14,7,0,1,22
1904901,1558681,2025-04-25,Joint,"JUD Vote Tally Sheet (Joint Favorable)",25,12,0,4,41
1904901,1565698,2025-05-05,Joint,"APP Vote Tally Sheet (Joint Favorable)",38,12,0,3,53
1904901,1572263,2025-05-15,Senate,"Senate Roll Call Vote 184 ",25,10,1,0,36
1904901,1572264,2025-05-15,Senate,"Senate Roll Call Vote 183 ",11,24,1,0,36
1904901,1572265,2025-05-15,Senate,"Senate Roll Call Vote 182 ",25,10,1,0,36
1904901,1581896,2025-05-29,House,"House Roll Call Vote 221 AS AMENDED ",112,34,0,5,151
1904901,1581897,2025-05-29,House,"House Roll Call Vote 220 HOUSE AMD A",47,96,0,8,151
1904902,1492948,2025-02-18,Joint,"APP Vote Tally Sheet (Reserved for Subject Matter Public Hearing)",0,0,0,0,0
1904908,1471435,2025-01-14,Joint,"LAB Vote Tally Sheet (Vote to Draft)",9,4,0,0,13
1904908,1508457,2025-03-06,Joint,"LAB Vote Tally Sheet (Joint Favorable)",9,4,0,0,13
1904908,1558694,2025-04-25,Joint,"JUD Vote Tally Sheet (Joint Favorable)",25,12,0,4,41
1904908,1565893,2025-05-05,Joint,"APP Vote Tally Sheet (Joint Favorable)",38,12,0,3,53
1904908,1580237,2025-05-28,Senate,"Senate Roll Call Vote 248 ",24,11,1,0,36
1904908,1584862,2025-05-30,House,"House Roll Call Vote 236 AS AMENDED ",87,59,0,5,151
1904920,1472178,2025-01-17,Joint,"ENV Vote Tally Sheet (Vote to Draft)",0,0,0,0,0
1904920,1527723,2025-03-24,Joint,"ENV Vote Tally Sheet (Joint Favorable Substitute)",24,6,0,4,34
1904941,1474232,2025-01-21,Joint,"AGE Vote Tally Sheet (Vote to Draft)",0,0,0,0,0
1904941,1508863,2025-03-06,Joint,"AGE Vote Tally Sheet (Joint Favorable)",14,0,0,0,14
1904943,1472834,2025-01-17,Joint,"PD Vote Tally Sheet (Change of Reference)",0,0,0,0,0
1904956,1472858,2025-01-17,Joint,"PD Vote Tally Sheet (Change of Reference)",0,0,0,0,0
1904957,1472602,2025-01-17,Joint,"PD Vote Tally Sheet (Change of Reference)",0,0,0,0,0
1904964,1472268,2025-01-17,Joint,"ENV Vote Tally Sheet (Vote to Draft)",0,0,0,0,0
1904964,1517951,2025-03-14,Joint,"ENV Vote Tally Sheet (Joint Favorable)",33,0,0,1,34
1904964,1568706,2025-05-08,Senate,"Senate Roll Call Vote 143 ",35,0,1,0,36
1904964,1584486,2025-06-03,House,"House Roll Call Vote 325 AS AMENDED ",147,0,0,4,151
1904979,1485822,2025-02-10,Joint,"ENV Vote Tally Sheet (Vote to Draft)",0,0,0,0,0
1904989,1472761,2025-01-21,Joint,"HS Vote Tally Sheet (Vote to Draft)",16,5,0,2,23
1904989,1517855,2025-03-13,Joint,"HS Vote Tally Sheet-B",0,0,0,0,0
1904989,1517859,2025-03-13,Joint,"HS Vote Tally Sheet (Joint Favorable)",15,7,0,1,23
1904989,1517860,2025-03-13,Joint,"HS Vote Tally Sheet-A",5,16,0,2,23
1904989,1517861,2025-03-13,Joint,"HS Vote Tally Sheet-C",5,16,0,2,23
1904989,1517862,2025-03-13,Joint,"HS Vote Tally Sheet-D",5,16,0,2,23
1904989,1517863,2025-03-13,Joint,"HS Vote Tally Sheet-E",5,16,0,2,23
1904989,1523029,2025-03-13,Joint,"HS Vote Tally Sheet (Joint Favorable Substitute)",15,7,0,1,23
1904989,1566316,2025-05-06,Joint,"JUD Vote Tally Sheet (Joint Favorable)",28,11,0,2,41
1904989,1569478,2025-05-12,Joint,"APP Vote Tally Sheet (Joint Favorable)",37,11,0,5,53
1905028,1472174,2025-01-17,Joint,"ENV Vote Tally Sheet (Vote to Draft)",0,0,0,0,0
1905028,1493028,2025-02-19,Joint,"ENV Vote Tally Sheet (Joint Unfavorable)",35,0,0,0,35
1905028,1493029,2025-02-19,Joint,"ENV Vote Tally Sheet (Joint Favorable)",35,0,0,0,35
1905032,1473068,2025-01-22,Joint,"TRA Vote Tally Sheet (Vote to Draft)",0,0,0,0,0
1905034,1492094,2025-02-14,Joint,"GAE Vote Tally Sheet (Vote to Draft)",17,2,0,0,19
1905034,1529692,2025-03-26,Joint,"GAE Vote Tally Sheet (Joint Favorable)",13,6,0,0,19
1905041,1472756,2025-01-17,Joint,"PD Vote Tally Sheet (Change of Reference)",0,0,0,0,0
1905054,1474341,2025-01-24,Joint,"ENV Vote Tally Sheet (Change of Reference)",0,0,0,0,0
1905069,1473159,2025-01-22,Joint,"GL Vote Tally Sheet (Vote to Draft)",0,0,0,0,0
1905069,1524150,2025-03-21,Joint,"GL Vote Tally Sheet (Joint Favorable Substitute)",17,4,0,1,22
1905069,1566059,2025-05-06,Joint,"JUD Vote Tally Sheet (Joint Favorable)",28,11,0,2,41
1905069,1569658,2025-05-12,Joint,"APP Vote Tally Sheet (Joint Favorable)",37,11,0,5,53
1905069,1571780,2025-05-14,Senate,"Senate Roll Call Vote 173 ",32,4,0,0,36
1905084,1472157,2025-01-17,Joint,"ENV Vote Tally Sheet (Vote to Draft)",0,0,0,0,0
1905084,1503118,2025-02-28,Joint,"ENV Vote Tally Sheet (Joint Favorable Substitute)",35,0,0,0,35
1905084,1558682,2025-04-25,Joint,"JUD Vote Tally Sheet (Joint Favorable)",37,0,0,4,41
1905084,1574551,2025-05-20,House,"House Roll Call Vote 155 AS AMENDED ",147,0,0,4,151
1905084,1580292,2025-05-28,Senate,"Senate Roll Call Vote 260 ",35,1,0,0,36
1905091,1472117,2025-01-17,Joint,"ENV Vote Tally Sheet (Vote to Draft)",0,0,0,0,0
1905091,1494488,2025-02-19,Joint,"ENV Vote Tally Sheet (Joint Favorable)",35,0,0,0,35
1905091,1568848,2025-05-08,House,"House Roll Call Vote 77 AS AMENDED ",141,0,0,10,151
1905091,1574739,2025-05-20,Senate,"Senate Roll Call Vote 199 ",35,0,1,0,36
1905093,1474564,2025-01-24,Joint,"ENV Vote Tally Sheet (Vote to Draft)",0,0,0,0,0
1905109,1471927,2025-01-15,Joint,"SED Vote Tally Sheet (Change of Reference)",10,5,0,0,15
1905109,1490396,2025-02-10,Joint,"ED Vote Tally Sheet (Vote to Draft)",0,0,0,0,0
1905109,1526723,2025-03-24,Joint,"ED Vote Tally Sheet (Joint Favorable Change of Reference)",30,15,0,0,45
1905109,1558192,2025-04-24,Joint,"APP Vote Tally Sheet (Joint Favorable)",41,13,0,0,54
1905109,1581865,2025-05-29,House,"House Roll Call Vote 228 AS AMENDED ",148,0,0,3,151
1905109,1583216,2025-06-02,Senate,"Senate Roll Call Vote 324 ",35,0,1,0,36
1905112,1471669,2025-01-14,Joint,"KID Vote Tally Sheet (Vote to Draft)",13,4,0,0,17
1905112,1509697,2025-03-06,Joint,"KID Vote Tally Sheet (Joint Favorable Substitute)",12,5,0,0,17
1905112,1565732,2025-05-05,Joint,"APP Vote Tally Sheet (Joint Favorable)",38,12,0,3,53
1905112,1570619,2025-05-13,Senate,"Senate Roll Call Vote 155 ",22,12,2,0,36
1905112,1570620,2025-05-13,Senate,"Senate Roll Call Vote 154 ",11,22,3,0,36
1905112,1570621,2025-05-13,Senate,"Senate Roll Call Vote 153 ",10,24,2,0,36
1905112,1570622,2025-05-13,Senate,"Senate Roll Call Vote 152 ",14,21,1,0,36
1905112,1570623,2025-05-13,Senate,"Senate Roll Call Vote 151 ",22,12,2,0,36
1905114,1472132,2025-01-17,Joint,"PH Vote Tally Sheet (Vote to Draft)",0,0,0,0,0
1905114,1528611,2025-03-27,Joint,"PH Vote Tally Sheet (Joint Favorable Substitute)",21,10,0,1,32
1905114,1528612,2025-03-27,Joint,"PH Vote Tally Sheet-D (In line 456, after “gender-affirming health care services” insert the following: “and who is at least sixteen years of age or older"")",10,20,0,2,32
1905114,1528613,2025-03-27,Joint,"PH Vote Tally Sheet-E (Strike line 503, from “Such”, through line 505 ending with “grant"")",10,19,0,3,32
1905114,1528614,2025-03-27,Joint,"PH Vote Tally Sheet-F (Amend the motion from “JFS to the Floor” to “JFS to Appropriations”)",9,18,0,5,32
1905114,1528615,2025-03-27,Joint,"PH Vote Tally Sheet-A (Strike Section 2)",10,20,0,2,32
1905114,1528616,2025-03-27,Joint,"PH Vote Tally Sheet-B (Strike Section 13)",9,17,0,6,32
1905114,1528617,2025-03-27,Joint,"PH Vote Tally Sheet-C (Strike sections 22-26)",9,19,0,4,32
1905114,1569947,2025-05-12,Joint,"JUD Vote Tally Sheet (Joint Favorable)",29,11,0,1,41
1905114,1572744,2025-05-16,Joint,"APP Vote Tally Sheet (Joint Favorable)",35,13,0,5,53
1905114,1576677,2025-05-22,Senate,"Senate Roll Call Vote 232 ",25,10,1,0,36
1905114,1576678,2025-05-22,Senate,"Senate Roll Call Vote 231 ",11,25,0,0,36
1905114,1576679,2025-05-22,Senate,"Senate Roll Call Vote 230 ",11,25,0,0,36
1905114,1576680,2025-05-22,Senate,"Senate Roll Call Vote 229 ",12,24,0,0,36
1905114,1581838,2025-05-29,House,"House Roll Call Vote 227 AS AMENDED ",92,55,0,4,151
1905114,1581839,2025-05-29,House,"House Roll Call Vote 226 HOUSE AMD F",48,99,0,4,151
1905114,1581840,2025-05-29,House,"House Roll Call Vote 225 AS AMENDED HOUSE AMD E",48,99,0,4,151
1905114,1581841,2025-05-29,House,"House Roll Call Vote 224 HOUSE AMD D",54,94,0,3,151
1905114,1581842,2025-05-29,House,"House Roll Call Vote 223 HOUSE AMD C",47,101,0,3,151
1905114,1581843,2025-05-29,House,"House Roll Call Vote 222 HOUSE AMD B",47,100,0,4,151
1905122,1483911,2025-02-07,Joint,"PD Vote Tally Sheet (Change of Reference)",0,0,0,0,0
1905126,1472836,2025-01-21,Joint,"HS Vote Tally Sheet (Vote to Draft)",21,0,0,2,23
1905128,1489279,2025-01-23,Joint,"ET Vote Tally Sheet (Change of Reference)",0,0,0,0,0
1905129,1471730,2025-01-14,Joint,"KID Vote Tally Sheet (Vote to Draft)",13,4,0,0,17
1905129,1509026,2025-03-06,Joint,"KID Vote Tally Sheet (Joint Favorable)",12,5,0,0,17
1905129,1539317,2025-04-08,Joint,"ED Vote Tally Sheet (Joint Favorable)",29,15,0,1,45
1905129,1566297,2025-05-05,Joint,"APP Vote Tally Sheet (Joint Favorable)",38,12,0,3,53
1905129,1582676,2025-05-31,House,"House Roll Call Vote 255 AS AMENDED ",133,10,0,8,151
1905129,1583628,2025-06-02,Senate,"Senate Roll Call Vote 350 ",36,0,0,0,36
1905135,1472208,2025-01-17,Joint,"ENV Vote Tally Sheet (Vote to Draft)",0,0,0,0,0
1905135,1493008,2025-02-19,Joint,"ENV Vote Tally Sheet (Joint Favorable)",35,0,0,0,35
1905135,1570832,2025-05-13,House,"House Roll Call Vote 91 ",148,0,0,3,151
1905140,1472105,2025-01-17,Joint,"ED Vote Tally Sheet (Vote to Draft)",34,9,0,2,45
1905140,1526020,2025-03-24,Joint,"ED Vote Tally Sheet (Joint Favorable)",30,15,0,0,45
1905140,1566126,2025-05-06,Joint,"JUD Vote Tally Sheet (Joint Favorable)",28,11,0,2,41
1905140,1569442,2025-05-12,Joint,"APP Vote Tally Sheet (Joint Favorable)",37,11,0,5,53
1905140,1582296,2025-05-30,Senate,"Senate Roll Call Vote 304 ",32,4,0,0,36
1905140,1582297,2025-05-30,Senate,"Senate Roll Call Vote 303 ",11,25,0,0,36
1905140,1582298,2025-05-30,Senate,"Senate Roll Call Vote 302 ",10,11,0,0,21
1905140,1582299,2025-05-30,Senate,"Senate Roll Call Vote 301 ",11,25,0,0,36
1905140,1582627,2025-05-31,House,"House Roll Call Vote 251 AS AMENDED ",101,45,0,5,151
1905140,1582628,2025-05-31,House,"House Roll Call Vote 250 HOUSE AMD A",45,100,0,6,151
1905141,1472717,2025-01-21,Joint,"INS Vote Tally Sheet (Vote to Draft)",0,0,0,0,0
1905141,1517987,2025-03-13,Joint,"INS Vote Tally Sheet (Joint Favorable Substitute)",10,3,0,0,13
1905141,1517988,2025-03-13,Joint,"INS Vote Tally Sheet-A",11,0,0,2,13
1905141,1566356,2025-05-06,Joint,"JUD Vote Tally Sheet (Joint Favorable)",28,11,0,2,41
1905141,1569552,2025-05-12,Joint,"APP Vote Tally Sheet (Joint Favorable)",37,11,0,5,53
1905141,1575160,2025-05-21,Senate,"Senate Roll Call Vote 211 ",31,5,0,0,36
1905141,1583663,2025-06-02,House,"House Roll Call Vote 272 AS AMENDED ",122,26,0,3,151
1905141,1583664,2025-06-02,House,"House Roll Call Vote 271 HOUSE AMD A",47,99,0,5,151
1905145,1484939,2025-02-10,Joint,"ENV Vote Tally Sheet (Vote to Draft)",0,0,0,0,0
1905146,1472231,2025-01-17,Joint,"ENV Vote Tally Sheet (Vote to Draft)",0,0,0,0,0
1905146,1503117,2025-02-28,Joint,"ENV Vote Tally Sheet (Joint Favorable)",35,0,0,0,35
1905146,1570728,2025-05-13,House,"House Roll Call Vote 92 ",148,0,0,3,151
1905146,1585274,2025-06-04,Senate,"Senate Roll Call Vote 421 ",36,0,0,0,36
1905156,1474389,2025-01-24,Joint,"ENV Vote Tally Sheet (Vote to Draft)",0,0,0,0,0
1905156,1503105,2025-02-28,Joint,"ENV Vote Tally Sheet (Joint Favorable)",30,5,0,0,35
1905158,1472672,2025-01-21,Joint,"HS Vote Tally Sheet (Reserved for Subject Matter Public Hearing)",21,0,0,2,23
1905181,1472718,2025-01-16,Joint,"HED Vote Tally Sheet (Vote to Draft)",0,0,0,0,0
1905181,1505689,2025-02-27,Joint,"HED Vote Tally Sheet (Joint Favorable Substitute)",18,0,0,0,18
1905181,1566165,2025-05-05,Joint,"APP Vote Tally Sheet (Joint Favorable)",38,12,0,3,53
1905181,1569487,2025-05-12,Joint,"FIN Vote Tally Sheet (Joint Favorable)",38,16,0,0,54
1905181,1571271,2025-05-14,Senate,"Senate Roll Call Vote 160 ",35,0,1,0,36
1905182,1493186,2025-02-18,Joint,"FIN Vote Tally Sheet (Reserved for Subject Matter Public Hearing)",0,0,0,0,0
1905198,1489257,2025-01-23,Joint,"ET Vote Tally Sheet (Vote to Draft)",0,0,0,0,0
1905198,1517371,2025-03-13,Joint,"ET Vote Tally Sheet (Joint Favorable Substitute)",17,8,0,0,25
1905198,1517372,2025-03-13,Joint,"ET Vote Tally Sheet-A (Joint Favorable Substitute)",8,16,0,1,25
1905198,1517974,2025-03-13,Joint,"ET Vote Tally Sheet-A (MOTION FAILED)",8,16,0,1,25
1905198,1573170,2025-05-19,Joint,"FIN Vote Tally Sheet (Joint Favorable)",32,15,2,5,54
1905198,1576972,2025-05-23,Joint,"APP Vote Tally Sheet (Joint Favorable)",41,11,0,1,53
1905198,1583277,2025-06-02,Senate,"Senate Roll Call Vote 329 ",34,1,1,0,36
1905198,1584492,2025-06-03,House,"House Roll Call Vote 312 AS AMENDED ",144,3,0,4,151
1905220,1472244,2025-01-17,Joint,"ENV Vote Tally Sheet (Vote to Draft)",0,0,0,0,0
1905220,1518027,2025-03-14,Joint,"ENV Vote Tally Sheet (Joint Favorable Substitute Change of Reference)",33,0,0,1,34
1905220,1557938,2025-04-24,Joint,"APP Vote Tally Sheet (Joint Favorable Substitute)",54,0,0,0,54
1905220,1572530,2025-05-15,Senate,"Senate Roll Call Vote 185 ",34,0,2,0,36
1905220,1581861,2025-05-29,House,"House Roll Call Vote 234 AS AMENDED ",145,0,0,6,151
1905225,1472183,2025-01-17,Joint,"ENV Vote Tally Sheet (Vote to Draft)",0,0,0,0,0
1905225,1503082,2025-02-28,Joint,"ENV Vote Tally Sheet (Joint Favorable Substitute)",24,11,0,0,35
1905229,1493571,2025-02-18,Joint,"FIN Vote Tally Sheet (Reserved for Subject Matter Public Hearing)",0,0,0,0,0
1905235,1492106,2025-02-14,Joint,"GAE Vote Tally Sheet (Vote to Draft)",0,0,0,0,0
1905249,1485764,2025-02-10,Joint,"ENV Vote Tally Sheet (Vote to Draft)",0,0,0,0,0
1905256,1474558,2025-01-24,Joint,"ENV Vote Tally Sheet (Vote to Draft)",0,0,0,0,0
1905273,1479304,2025-02-03,Joint,"GL Vote Tally Sheet (Reserved for Subject Matter Public Hearing)",0,0,0,0,0
1905275,1494410,2025-02-18,Joint,"APP Vote Tally Sheet (Reserved for Subject Matter Public Hearing)",0,0,0,0,0
1905734,1471273,2025-01-08,House,"House Roll Call Vote 1 ",133,11,0,6,150
1907548,1472810,2025-01-17,Joint,"PD Vote Tally Sheet (Change of Reference)",0,0,0,0,0
1907551,1472136,2025-01-17,Joint,"ENV Vote Tally Sheet (Vote to Draft)",0,0,0,0,0
1907551,1494417,2025-02-19,Joint,"ENV Vote Tally Sheet (Joint Favorable)",35,0,0,0,35
1907551,1571395,2025-05-14,Senate,"Senate Roll Call Vote 171 ",36,0,0,0,36
1907551,1582349,2025-05-30,House,"House Roll Call Vote 248 ",144,1,0,6,151
1907719,1492980,2025-02-18,Joint,"APP Vote Tally Sheet (Change of Reference)",0,0,0,0,0
1907775,1472598,2025-01-21,Joint,"VA Vote Tally Sheet (Vote to Draft)",0,0,0,0,0
1907775,1514604,2025-03-11,Joint,"VA Vote Tally Sheet (Joint Favorable Substitute)",20,0,0,1,21
1907807,1479823,2025-02-04,Joint,"VA Vote Tally Sheet (Change of Reference)",0,0,0,0,0
1907830,1493971,2025-02-18,Joint,"APP Vote Tally Sheet (Change of Reference)",0,0,0,0,0
1907871,1472241,2025-01-17,Joint,"ENV Vote Tally Sheet (Vote to Draft)",0,0,0,0,0
1907871,1517980,2025-03-14,Joint,"ENV Vote Tally Sheet (Joint Favorable Substitute)",33,0,0,1,34
1907871,1582015,2025-05-29,House,"House Roll Call Vote 230 AS AMENDED ",148,0,0,3,151
1907871,1585363,2025-06-04,Senate,"Senate Roll Call Vote 419 ",36,0,0,0,36
1907909,1493940,2025-02-18,Joint,"FIN Vote Tally Sheet (Reserved for Subject Matter Public Hearing)",0,0,0,0,0
1907911,1472740,2025-01-21,Joint,"VA Vote Tally Sheet (Vote to Draft)",0,0,0,0,0
1907911,1492356,2025-02-18,Joint,"VA Vote Tally Sheet (Joint Favorable)",20,0,0,0,20
1907911,1565848,2025-05-05,Joint,"APP Vote Tally Sheet (Joint Favorable)",43,7,0,3,53
1907911,1569659,2025-05-12,Joint,"FIN Vote Tally Sheet (Joint Favorable)",54,0,0,0,54
1907922,1472809,2025-01-17,Joint,"PD Vote Tally Sheet (Change of Reference)",0,0,0,0,0
1909545,1472748,2025-01-17,Joint,"PD Vote Tally Sheet (Change of Reference)",0,0,0,0,0
1909557,1492068,2025-02-14,Joint,"GAE Vote Tally Sheet (Vote to Draft)",0,0,0,0,0
1909557,1528715,2025-03-26,Joint,"GAE Vote Tally Sheet (House)",14,1,0,0,15
1909564,1472757,2025-01-17,Joint,"PD Vote Tally Sheet (Change of Reference)",0,0,0,0,0
1909591,1472813,2025-01-17,Joint,"PD Vote Tally Sheet (Change of Reference)",0,0,0,0,0
1909599,1478763,2025-02-03,Joint,"GL Vote Tally Sheet (Reserved for Subject Matter Public Hearing)",0,0,0,0,0
1909670,1472618,2025-01-17,Joint,"PD Vote Tally Sheet (Change of Reference)",0,0,0,0,0
1909725,1479172,2025-02-03,Joint,"GL Vote Tally Sheet (Reserved for Subject Matter Public Hearing)",0,0,0,0,0
1909731,1471677,2025-01-14,Joint,"KID Vote Tally Sheet (Reserved for Subject Matter Public Hearing)",0,0,0,0,0
1909764,1472816,2025-01-17,Joint,"PD Vote Tally Sheet (Change of Reference)",0,0,0,0,0
1909798,1494473,2025-02-18,Joint,"APP Vote Tally Sheet (Change of Reference)",0,0,0,0,0
1909851,1489309,2025-01-23,Joint,"ET Vote Tally Sheet (Change of Reference)",0,0,0,0,0
1911963,1473197,2025-01-22,Joint,"GL Vote Tally Sheet (Vote to Draft)",0,0,0,0,0
1911963,1516367,2025-03-12,Joint,"GL Vote Tally Sheet (Joint Favorable Change of Reference)",17,5,0,0,22
1911975,1478943,2025-02-03,Joint,"GL Vote Tally Sheet (Vote to Draft)",0,0,0,0,0
1912054,1472709,2025-01-21,Joint,"VA Vote Tally Sheet (Reserved for Subject Matter Public Hearing)",0,0,0,0,0
1912085,1473750,2025-01-23,Joint,"GOS Vote Tally Sheet (Vote to Draft)",0,0,0,0,0
1912085,1519692,2025-03-18,Joint,"GOS Vote Tally Sheet (Joint Favorable)",12,0,0,0,12
1912127,1487285,2025-02-11,Joint,"LAB Vote Tally Sheet (Vote to Draft)",9,4,0,0,13
1912127,1520567,2025-03-18,Joint,"LAB Vote Tally Sheet (Joint Favorable Substitute)",9,4,0,0,13
1912177,1479235,2025-02-03,Joint,"GL Vote Tally Sheet (Vote to Draft)",0,0,0,0,0
1912177,1524300,2025-03-21,Joint,"GL Vote Tally Sheet (Joint Favorable)",21,0,0,1,22
1912331,1479720,2025-02-04,Joint,"HED Vote Tally Sheet (Vote to Draft)",0,0,0,0,0
1912331,1514580,2025-03-11,Joint,"HED Vote Tally Sheet (Joint Favorable)",18,0,0,0,18
1912347,1479066,2025-02-03,Joint,"GL Vote Tally Sheet (Vote to Draft)",0,0,0,0,0
1912347,1524140,2025-03-21,Joint,"GL Vote Tally Sheet (Joint Favorable Substitute)",14,7,0,1,22
1912347,1575308,2025-05-21,Senate,"Senate Roll Call Vote 207 ",29,7,0,0,36
1915932,1494461,2025-02-18,Joint,"APP Vote Tally Sheet (Change of Reference)",0,0,0,0,0
1915979,1472708,2025-01-21,Joint,"VA Vote Tally Sheet (Change of Reference)",0,0,0,0,0
1916016,1489331,2025-01-23,Joint,"ET Vote Tally Sheet (Change of Reference)",0,0,0,0,0
1916038,1473112,2025-01-22,Joint,"TRA Vote Tally Sheet (Vote to Draft)",0,0,0,0,0
1916038,1518327,2025-03-12,Joint,"TRA Vote Tally Sheet (Joint Favorable)",35,0,0,0,35
1916150,1478766,2025-02-03,Joint,"GL Vote Tally Sheet (Reserved for Subject Matter Public Hearing)",0,0,0,0,0
1916231,1493375,2025-02-18,Joint,"FIN Vote Tally Sheet (Reserved for Subject Matter Public Hearing)",0,0,0,0,0
1916240,1491732,2025-02-14,Joint,"GAE Vote Tally Sheet (Vote to Draft)",0,0,0,0,0
1916243,1484765,2025-02-10,Joint,"PH Vote Tally Sheet (Change of Reference)",0,0,0,0,0
1916273,1476418,2025-01-29,Joint,"TRA Vote Tally Sheet (Vote to Draft)",0,0,0,0,0
1916336,1489377,2025-01-23,Joint,"ET Vote Tally Sheet (Change of Reference)",0,0,0,0,0
1916379,1489130,2025-01-23,Joint,"ET Vote Tally Sheet (Vote to Draft)",0,0,0,0,0
1916379,1517263,2025-03-13,Joint,"ET Vote Tally Sheet (Joint Favorable)",16,9,0,0,25
1916379,1569702,2025-05-12,Joint,"JUD Vote Tally Sheet (Joint Favorable)",28,12,0,1,41
1916415,1485981,2025-02-10,Joint,"ENV Vote Tally Sheet (Vote to Draft)",0,0,0,0,0
1916432,1485924,2025-02-10,Joint,"PH Vote Tally Sheet (Reserved for Subject Matter Public Hearing)",0,0,0,0,0
1916495,1480709,2025-02-04,Joint,"HED Vote Tally Sheet (Vote to Draft)",0,0,0,0,0
1918590,1492446,2025-02-14,Joint,"GAE Vote Tally Sheet (Vote to Draft)",0,0,0,0,0
1918636,1479427,2025-02-03,Joint,"GL Vote Tally Sheet (Vote to Draft)",0,0,0,0,0
1918636,1524277,2025-03-21,Joint,"GL Vote Tally Sheet (Joint Favorable)",21,0,0,1,22
1918636,1564997,2025-05-05,Joint,"FIN Vote Tally Sheet (Joint Favorable)",52,0,0,2,54
1918636,1585175,2025-06-04,House,"House Roll Call Vote 356 AS AMENDED ",100,46,0,5,151
1918653,1479443,2025-02-03,Joint,"GL Vote Tally Sheet (Vote to Draft)",0,0,0,0,0
1918653,1516068,2025-03-12,Joint,"GL Vote Tally Sheet (Joint Favorable)",22,0,0,0,22
1918653,1569482,2025-05-12,Joint,"FIN Vote Tally Sheet (Joint Favorable)",54,0,0,0,54
1918662,1474103,2025-01-23,Joint,"CE Vote Tally Sheet (Vote to Draft)",0,0,0,0,0
1918662,1520526,2025-03-18,Joint,"CE Vote Tally Sheet (Joint Favorable)",20,0,0,0,20
1918662,1584007,2025-06-02,Senate,"Senate Roll Call Vote 335 ",35,1,0,0,36
1918786,1491758,2025-02-14,Joint,"GAE Vote Tally Sheet (Vote to Draft)",0,0,0,0,0
1918786,1529345,2025-03-26,Joint,"GAE Vote Tally Sheet (Joint Favorable)",19,0,0,0,19
1918786,1566216,2025-05-05,Joint,"APP Vote Tally Sheet (Joint Favorable)",38,12,0,3,53
1918810,1479136,2025-02-03,Joint,"GL Vote Tally Sheet (Vote to Draft)",0,0,0,0,0
1918810,1524193,2025-03-21,Joint,"GL Vote Tally Sheet (Joint Favorable)",21,0,0,1,22
1918836,1492947,2025-02-18,Joint,"APP Vote Tally Sheet (Change of Reference)",0,0,0,0,0
1918846,1473942,2025-01-23,Joint,"CE Vote Tally Sheet (Vote to Draft)",0,0,0,0,0
1918846,1519673,2025-03-18,Joint,"CE Vote Tally Sheet (Joint Favorable)",20,0,0,0,20
1918853,1472871,2025-01-21,Joint,"VA Vote Tally Sheet (Vote to Draft)",0,0,0,0,0
1918853,1493781,2025-02-18,Joint,"VA Vote Tally Sheet (Joint Favorable Substitute)",20,0,0,0,20
1918914,1472636,2025-01-21,Joint,"VA Vote Tally Sheet (Reserved for Subject Matter Public Hearing)",0,0,0,0,0
1918929,1483009,2025-02-04,Joint,"HSG Vote Tally Sheet (Reserved for Subject Matter Public Hearing)",0,0,0,0,0
1918991,1491836,2025-02-14,Joint,"GAE Vote Tally Sheet (Vote to Draft)",0,0,0,0,0
1919023,1479468,2025-02-03,Joint,"GL Vote Tally Sheet (Vote to Draft)",0,0,0,0,0
1919023,1515985,2025-03-12,Joint,"GL Vote Tally Sheet (Joint Favorable)",22,0,0,0,22
1919023,1585161,2025-06-04,House,"House Roll Call Vote 355 AS AMENDED ",129,19,0,3,151
1920852,1489329,2025-01-30,Joint,"ET Vote Tally Sheet (Vote to Draft)",0,0,0,0,0
1920916,1472693,2025-01-21,Joint,"VA Vote Tally Sheet (Vote to Draft)",0,0,0,0,0
1920916,1492137,2025-02-18,Joint,"VA Vote Tally Sheet (Joint Favorable)",20,0,0,0,20
1920916,1541552,2025-04-09,Senate,"Senate Roll Call Vote 77 ",35,0,1,0,36
1920916,1576650,2025-05-22,House,"House Roll Call Vote 172 ",146,2,0,3,151
1921121,1482976,2025-02-04,Joint,"HSG Vote Tally Sheet (Reserved for Subject Matter Public Hearing)",0,0,0,0,0
1921121,1495255,2025-02-20,Joint,"HSG Vote Tally Sheet (Vote to Draft)",18,0,0,2,20
1921258,1478953,2025-02-03,Joint,"GL Vote Tally Sheet (Vote to Draft)",0,0,0,0,0
1921297,1478872,2025-02-03,Joint,"GL Vote Tally Sheet (Vote to Draft)",0,0,0,0,0
1921444,1472825,2025-01-21,Joint,"VA Vote Tally Sheet (Change of Reference)",0,0,0,0,0
1921567,1473346,2025-01-22,Joint,"TRA Vote Tally Sheet (Vote to Draft)",0,0,0,0,0
1921567,1518429,2025-03-12,Joint,"TRA Vote Tally Sheet (Joint Favorable)",34,0,1,0,35
1921567,1565774,2025-05-05,Joint,"APP Vote Tally Sheet (Joint Favorable)",42,8,0,3,53
1921657,1484832,2025-02-10,Joint,"ENV Vote Tally Sheet (Vote to Draft)",0,0,0,0,0
1921657,1517989,2025-03-14,Joint,"ENV Vote Tally Sheet (Joint Favorable Change of Reference)",33,0,0,1,34
1921657,1558029,2025-04-24,Joint,"APP Vote Tally Sheet (Joint Favorable)",39,15,0,0,54
1921973,1475669,2025-01-27,Joint,"PD Vote Tally Sheet (Reserved for Subject Matter Public Hearing)",0,0,0,0,0
1922056,1474523,2025-01-24,Joint,"ENV Vote Tally Sheet (Change of Reference)",0,0,0,0,0
1922081,1487294,2025-02-11,Joint,"LAB Vote Tally Sheet (Reserved for Subject Matter Public Hearing)",9,4,0,0,13
1922087,1475668,2025-01-27,Joint,"PD Vote Tally Sheet (Change of Reference)",0,0,0,0,0
1922087,1489052,2025-02-13,Joint,"ET Vote Tally Sheet (Change of Reference)",0,0,0,0,0
1922118,1479390,2025-02-03,Joint,"GL Vote Tally Sheet (Vote to Draft)",0,0,0,0,0
1922118,1516010,2025-03-12,Joint,"GL Vote Tally Sheet (Joint Favorable)",22,0,0,0,22
1924600,1486662,2025-02-11,Joint,"FIN Vote Tally Sheet (Reserved for Subject Matter Public Hearing)",36,16,0,1,53
1924692,1476027,2025-01-27,Joint,"PD Vote Tally Sheet (Change of Reference)",0,0,0,0,0
1924797,1489294,2025-01-30,Joint,"ET Vote Tally Sheet (Change of Reference)",0,0,0,0,0
1924865,1478876,2025-02-03,Joint,"GL Vote Tally Sheet (Vote to Draft)",0,0,0,0,0
1924865,1516181,2025-03-12,Joint,"GL Vote Tally Sheet (Joint Favorable)",22,0,0,0,22
1924865,1576661,2025-05-22,House,"House Roll Call Vote 186 AS AMENDED ",145,0,0,6,151
1924865,1582150,2025-05-30,Senate,"Senate Roll Call Vote 293 ",36,0,0,0,36
1924906,1485852,2025-02-11,Joint,"FIN Vote Tally Sheet (Reserved for Subject Matter Public Hearing)",0,0,0,0,0
1924967,1492469,2025-02-14,Joint,"GAE Vote Tally Sheet (Vote to Draft)",0,0,0,0,0
1924967,1529108,2025-03-26,Joint,"GAE Vote Tally Sheet (Joint Favorable Substitute)",13,6,0,0,19
1925014,1491737,2025-02-14,Joint,"GAE Vote Tally Sheet (Vote to Draft)",0,0,0,0,0
1925014,1524581,2025-03-19,Joint,"GAE Vote Tally Sheet (Joint Favorable)",19,0,0,0,19
1925049,1478958,2025-02-03,Joint,"GL Vote Tally Sheet (Reserved for Subject Matter Public Hearing)",0,0,0,0,0
1925099,1474240,2025-01-24,Joint,"ENV Vote Tally Sheet (Change of Reference)",0,0,0,0,0
1925152,1484854,2025-02-10,Joint,"ENV Vote Tally Sheet (Change of Reference)",0,0,0,0,0
1925175,1486077,2025-02-11,Joint,"FIN Vote Tally Sheet (Reserved for Subject Matter Public Hearing)",36,16,0,1,53
1925356,1473274,2025-01-22,Joint,"GL Vote Tally Sheet (Vote to Draft)",0,0,0,0,0
1925356,1524244,2025-03-21,Joint,"GL Vote Tally Sheet (Joint Favorable)",14,7,0,1,22
1925356,1565477,2025-05-05,Joint,"APP Vote Tally Sheet (Joint Favorable)",38,12,0,3,53
1925356,1580696,2025-05-28,House,"House Roll Call Vote 207 HOUSE AMD E",47,100,0,4,151
1925356,1580697,2025-05-28,House,"House Roll Call Vote 206 HOUSE AMD D",47,100,0,4,151
1925356,1580698,2025-05-28,House,"House Roll Call Vote 205 HOUSE AMD C",47,100,0,4,151
1925356,1584508,2025-06-03,House,"House Roll Call Vote 309 AS AMENDED ",132,16,0,3,151
1925384,1475710,2025-01-27,Joint,"PD Vote Tally Sheet (Reserved for Subject Matter Public Hearing)",0,0,0,0,0
1925417,1485992,2025-02-11,Joint,"FIN Vote Tally Sheet (Reserved for Subject Matter Public Hearing)",0,0,0,0,0
1925474,1475899,2025-01-28,Joint,"KID Vote Tally Sheet (Reserved for Subject Matter Public Hearing)",0,0,0,0,0
1925474,1491980,2025-02-18,Joint,"KID Vote Tally Sheet (Vote to Draft)",15,2,0,0,17
1925474,1509047,2025-03-06,Joint,"KID Vote Tally Sheet (Joint Favorable)",15,2,0,0,17
1925482,1475828,2025-01-27,Joint,"PD Vote Tally Sheet (Change of Reference)",0,0,0,0,0
1925498,1485023,2025-02-10,Joint,"ENV Vote Tally Sheet (Vote to Draft)",0,0,0,0,0
1925498,1530224,2025-03-28,Joint,"ENV Vote Tally Sheet (Joint Favorable Substitute)",33,0,0,1,34
1925498,1565962,2025-05-05,Joint,"APP Vote Tally Sheet (Joint Favorable)",42,8,0,3,53
1925606,1489844,2025-01-30,Joint,"ET Vote Tally Sheet (Change of Reference)",0,0,0,0,0
1925613,1485836,2025-02-11,Joint,"FIN Vote Tally Sheet (Reserved for Subject Matter Public Hearing)",0,0,0,0,0
1925723,1485726,2025-02-10,Joint,"ENV Vote Tally Sheet (Vote to Draft)",0,0,0,0,0
1925740,1473269,2025-01-22,Joint,"TRA Vote Tally Sheet (Vote to Draft)",0,0,0,0,0
1925740,1518378,2025-03-12,Joint,"TRA Vote Tally Sheet (Joint Favorable)",25,10,0,0,35
1927201,1493821,2025-02-18,Joint,"APP Vote Tally Sheet (Reserved for Subject Matter Public Hearing)",0,0,0,0,0
1927249,1487295,2025-02-11,Joint,"LAB Vote Tally Sheet (Reserved for Subject Matter Public Hearing)",13,0,0,0,13
1927249,1507333,2025-03-06,Joint,"LAB Vote Tally Sheet (Vote to Draft)",0,0,0,0,0
1927249,1523889,2025-03-20,Joint,"LAB Vote Tally Sheet (Joint Favorable)",13,0,0,0,13
1927279,1475410,2025-01-28,Joint,"LAB Vote Tally Sheet (Vote to Draft)",13,0,0,0,13
1927279,1523203,2025-03-20,Joint,"LAB Vote Tally Sheet (Joint Favorable Substitute)",9,4,0,0,13
1927360,1475954,2025-01-28,Joint,"LAB Vote Tally Sheet (Vote to Draft)",9,4,0,0,13
1927504,1475988,2025-01-28,Joint,"LAB Vote Tally Sheet (Vote to Draft)",13,0,0,0,13
1927504,1517151,2025-03-13,Joint,"LAB Vote Tally Sheet (Joint Favorable)",13,0,0,0,13
1927571,1475964,2025-01-28,Joint,"HS Vote Tally Sheet (Reserved for Subject Matter Public Hearing)",0,0,0,0,0
1927718,1476032,2025-01-28,Joint,"HS Vote Tally Sheet (Vote to Draft)",15,8,0,0,23
1927718,1517888,2025-03-13,Joint,"HS Vote Tally Sheet (Joint Favorable)",16,6,0,1,23
1927718,1517889,2025-03-13,Joint,"HS Vote Tally Sheet-A (Change of Reference)",5,15,0,3,23
1927718,1517890,2025-03-13,Joint,"HS Vote Tally Sheet-A (MOTION FAILED)",5,15,0,3,23
1927718,1566712,2025-05-05,Joint,"APP Vote Tally Sheet (Joint Favorable)",38,12,0,3,53
1927783,1475632,2025-01-28,Joint,"HS Vote Tally Sheet (Vote to Draft)",17,6,0,0,23
1927783,1517909,2025-03-13,Joint,"HS Vote Tally Sheet (Joint Favorable)",17,5,0,1,23
1927798,1479316,2025-02-03,Joint,"GL Vote Tally Sheet (Vote to Draft)",0,0,0,0,0
1927798,1524496,2025-03-21,Joint,"GL Vote Tally Sheet (Joint Favorable Substitute)",14,7,0,1,22
1927798,1575340,2025-05-21,Senate,"Senate Roll Call Vote 208 ",27,9,0,0,36
1928327,1475920,2025-01-28,Joint,"HS Vote Tally Sheet (Vote to Draft)",16,7,0,0,23
1928327,1517901,2025-03-13,Joint,"HS Vote Tally Sheet (Joint Favorable)",16,6,0,1,23
1928361,1479276,2025-02-03,Joint,"GL Vote Tally Sheet (Vote to Draft)",0,0,0,0,0
1928376,1473716,2025-01-23,Joint,"GOS Vote Tally Sheet (Reserved for Subject Matter Public Hearing)",0,0,0,0,0
1928376,1499578,2025-02-25,Joint,"GOS Vote Tally Sheet (Vote to Draft)",0,0,0,0,0
1928376,1520461,2025-03-18,Joint,"GOS Vote Tally Sheet (Joint Favorable Substitute)",12,0,0,0,12
1928396,1486655,2025-02-11,Joint,"FIN Vote Tally Sheet (Reserved for Subject Matter Public Hearing)",0,0,0,0,0
1928405,1475947,2025-01-28,Joint,"HS Vote Tally Sheet (Reserved for Subject Matter Public Hearing)",0,0,0,0,0
1928405,1501555,2025-02-27,Joint,"HS Vote Tally Sheet (Vote to Draft)",0,0,0,0,0
1928405,1518067,2025-03-13,Joint,"HS Vote Tally Sheet (Joint Favorable)",17,5,0,1,23
1928405,1565680,2025-05-05,Joint,"APP Vote Tally Sheet (Joint Favorable)",42,8,0,3,53
1928417,1486114,2025-02-11,Joint,"FIN Vote Tally Sheet (Reserved for Subject Matter Public Hearing)",0,0,0,0,0
1928433,1484802,2025-02-10,Joint,"PH Vote Tally Sheet (Change of Reference)",0,0,0,0,0
1928448,1475697,2025-01-28,Joint,"HS Vote Tally Sheet (Vote to Draft)",0,0,0,0,0
1928448,1505685,2025-03-04,Joint,"HS Vote Tally Sheet (Change of Reference)",16,7,0,0,23
1928525,1473055,2025-01-22,Joint,"TRA Vote Tally Sheet (Vote to Draft)",0,0,0,0,0
1928525,1518349,2025-03-12,Joint,"TRA Vote Tally Sheet (Joint Favorable Substitute)",35,0,0,0,35
1928579,1485838,2025-02-11,Joint,"FIN Vote Tally Sheet (Reserved for Subject Matter Public Hearing)",0,0,0,0,0
1928582,1475994,2025-01-28,Joint,"LAB Vote Tally Sheet (Reserved for Subject Matter Public Hearing)",9,4,0,0,13
1928582,1507517,2025-03-06,Joint,"LAB Vote Tally Sheet (Vote to Draft)",10,3,0,0,13
1928582,1520248,2025-03-18,Joint,"LAB Vote Tally Sheet (Joint Favorable Substitute)",9,4,0,0,13
1928582,1520249,2025-03-18,Joint,"LAB Vote Tally Sheet-A",0,0,0,0,0
1928582,1545986,2025-04-11,Joint,"HS Vote Tally Sheet (Joint Favorable)",14,6,0,3,23
1928582,1582271,2025-05-30,House,"House Roll Call Vote 245 AS AMENDED ",83,62,0,6,151
1928584,1479319,2025-02-03,Joint,"GL Vote Tally Sheet (Vote to Draft)",0,0,0,0,0
1928584,1516289,2025-03-12,Joint,"GL Vote Tally Sheet (Joint Favorable Substitute)",22,0,0,0,22
1928587,1478887,2025-02-03,Joint,"GL Vote Tally Sheet (Vote to Draft)",0,0,0,0,0
1928587,1524994,2025-03-24,Joint,"GL Vote Tally Sheet (Joint Favorable)",22,0,0,0,22
1928587,1558688,2025-04-25,Joint,"JUD Vote Tally Sheet (Joint Favorable)",37,0,0,4,41
1928587,1566127,2025-05-05,Joint,"APP Vote Tally Sheet (Joint Favorable)",38,12,0,3,53
1928587,1582288,2025-05-30,House,"House Roll Call Vote 244 AS AMENDED ",135,12,0,4,151
1928672,1482952,2025-02-04,Joint,"HSG Vote Tally Sheet (Change of Reference)",0,0,0,0,0
1928684,1489295,2025-01-30,Joint,"ET Vote Tally Sheet (Change of Reference)",0,0,0,0,0
1928709,1476007,2025-01-28,Joint,"HS Vote Tally Sheet (Vote to Draft)",0,0,0,0,0
1928709,1505920,2025-03-04,Joint,"HS Vote Tally Sheet (Joint Favorable)",23,0,0,0,23
1928709,1570840,2025-05-13,House,"House Roll Call Vote 100 AS AMENDED ",145,0,0,6,151
1928709,1584522,2025-06-04,Senate,"Senate Roll Call Vote 376 ",36,0,0,0,36
1928716,1487379,2025-02-11,Joint,"LAB Vote Tally Sheet (Reserved for Subject Matter Public Hearing)",13,0,0,0,13
1928716,1508008,2025-03-06,Joint,"LAB Vote Tally Sheet (Vote to Draft)",0,0,0,0,0
1928716,1522851,2025-03-20,Joint,"LAB Vote Tally Sheet (Joint Favorable)",13,0,0,0,13
1928727,1475572,2025-01-27,Joint,"PD Vote Tally Sheet (Change of Reference)",0,0,0,0,0
1928748,1487027,2025-02-11,Joint,"LAB Vote Tally Sheet (Change of Reference)",13,0,0,0,13
1928753,1473074,2025-01-22,Joint,"TRA Vote Tally Sheet (Reserved for Subject Matter Public Hearing)",0,0,0,0,0
1928766,1475643,2025-01-27,Joint,"PD Vote Tally Sheet (Reserved for Subject Matter Public Hearing)",0,0,0,0,0
1928781,1484235,2025-02-05,Joint,"PD Vote Tally Sheet (Change of Reference)",0,0,0,0,0
1928785,1491913,2025-02-14,Joint,"GAE Vote Tally Sheet (Vote to Draft)",0,0,0,0,0
1928785,1516777,2025-03-12,Joint,"GAE Vote Tally Sheet (Joint Favorable)",19,0,0,0,19
1928788,1487237,2025-02-11,Joint,"LAB Vote Tally Sheet (Reserved for Subject Matter Public Hearing)",13,0,0,0,13
1928788,1508132,2025-03-06,Joint,"LAB Vote Tally Sheet (Vote to Draft)",0,0,0,0,0
1928788,1522855,2025-03-20,Joint,"LAB Vote Tally Sheet (Joint Favorable)",13,0,0,0,13
1928788,1568778,2025-05-08,House,"House Roll Call Vote 86 ",141,0,0,10,151
1928788,1582347,2025-05-30,Senate,"Senate Roll Call Vote 309 ",36,0,0,0,36
1928799,1479307,2025-02-03,Joint,"GL Vote Tally Sheet (Vote to Draft)",0,0,0,0,0
1928802,1474476,2025-01-24,Joint,"ENV Vote Tally Sheet (Change of Reference)",0,0,0,0,0
1928821,1485132,2025-02-10,Joint,"ENV Vote Tally Sheet (Vote to Draft)",0,0,0,0,0
1928909,1479848,2025-02-04,Joint,"BA Vote Tally Sheet (Vote to Draft)",0,0,0,0,0
1928909,1513116,2025-03-11,Joint,"BA Vote Tally Sheet (Joint Favorable)",13,0,0,0,13
1928982,1492942,2025-02-18,Joint,"FIN Vote Tally Sheet (Reserved for Subject Matter Public Hearing)",0,0,0,0,0
1928994,1487403,2025-02-11,Joint,"LAB Vote Tally Sheet (Vote to Draft)",13,0,0,0,13
1928994,1519675,2025-03-18,Joint,"LAB Vote Tally Sheet (Joint Favorable Substitute)",9,4,0,0,13
1929017,1479908,2025-02-04,Joint,"VA Vote Tally Sheet (Vote to Draft)",0,0,0,0,0
1929017,1492415,2025-02-18,Joint,"VA Vote Tally Sheet (Joint Favorable)",20,0,0,0,20
1929032,1479033,2025-02-03,Joint,"GL Vote Tally Sheet (Vote to Draft)",0,0,0,0,0
1931727,1493856,2025-02-18,Joint,"APP Vote Tally Sheet (Change of Reference)",0,0,0,0,0
1931733,1475882,2025-01-28,Joint,"HS Vote Tally Sheet (Vote to Draft)",0,0,0,0,0
1931733,1506049,2025-03-04,Joint,"HS Vote Tally Sheet (Joint Favorable Substitute)",16,6,0,1,23
1931733,1582308,2025-05-30,Senate,"Senate Roll Call Vote 296 ",35,0,1,0,36
1931747,1484960,2025-02-10,Joint,"ENV Vote Tally Sheet (Vote to Draft)",0,0,0,0,0
1931748,1479983,2025-02-04,Joint,"HED Vote Tally Sheet (Vote to Draft)",0,0,0,0,0
1931748,1519008,2025-03-13,Joint,"HED Vote Tally Sheet (Joint Favorable Substitute)",16,2,0,0,18
1931748,1519009,2025-03-13,Joint,"HED Vote Tally Sheet-A",0,0,0,0,0
1931748,1566483,2025-05-05,Joint,"APP Vote Tally Sheet (Joint Favorable Substitute)",38,12,0,3,53
1931751,1475754,2025-01-28,Joint,"KID Vote Tally Sheet (Vote to Draft)",11,5,0,1,17
1931751,1511526,2025-03-06,Joint,"KID Vote Tally Sheet (Joint Favorable Substitute)",16,1,0,0,17
1931751,1571744,2025-05-14,House,"House Roll Call Vote 115 AS AMENDED ",147,0,0,4,151
1931751,1583796,2025-06-02,Senate,"Senate Roll Call Vote 345 ",36,0,0,0,36
1931753,1493182,2025-02-18,Joint,"FIN Vote Tally Sheet (Reserved for Subject Matter Public Hearing)",37,15,0,1,53
1931872,1475924,2025-01-28,Joint,"HS Vote Tally Sheet (Reserved for Subject Matter Public Hearing)",0,0,0,0,0
1931873,1476902,2025-01-29,Joint,"TRA Vote Tally Sheet (Change of Reference)",0,0,0,0,0
1931879,1476349,2025-01-29,Joint,"TRA Vote Tally Sheet (Vote to Draft)",0,0,0,0,0
1931879,1518372,2025-03-12,Joint,"TRA Vote Tally Sheet (Joint Favorable)",35,0,0,0,35
1931879,1565957,2025-05-05,Joint,"APP Vote Tally Sheet (Joint Favorable)",42,8,0,3,53
1931897,1477953,2025-01-30,Joint,"GOS Vote Tally Sheet (Vote to Draft)",0,0,0,0,0
1931897,1499439,2025-02-25,Joint,"GOS Vote Tally Sheet (Joint Favorable)",9,0,0,3,12
1931897,1573864,2025-05-19,House,"House Roll Call Vote 130 AS AMENDED ",120,11,0,20,151
1931899,1479194,2025-02-03,Joint,"GL Vote Tally Sheet (Vote to Draft)",0,0,0,0,0
1931899,1524171,2025-03-21,Joint,"GL Vote Tally Sheet (Joint Favorable)",18,3,0,1,22
1931907,1486341,2025-02-11,Joint,"FIN Vote Tally Sheet (Reserved for Subject Matter Public Hearing)",0,0,0,0,0
1931907,1524608,2025-03-24,Joint,"FIN Vote Tally Sheet (Vote to Draft)",0,0,0,0,0
1931907,1556766,2025-04-24,Joint,"FIN Vote Tally Sheet (Joint Favorable)",42,10,0,0,52
1931918,1487265,2025-02-11,Joint,"LAB Vote Tally Sheet (Vote to Draft)",9,4,0,0,13
1931918,1520208,2025-03-18,Joint,"LAB Vote Tally Sheet (Joint Favorable)",9,4,0,0,13
1931918,1569733,2025-05-12,Joint,"JUD Vote Tally Sheet (Joint Favorable)",25,15,0,1,41
1931920,1475562,2025-01-28,Joint,"LAB Vote Tally Sheet (Vote to Draft)",13,0,0,0,13
1931920,1508323,2025-03-06,Joint,"LAB Vote Tally Sheet (Joint Favorable Substitute)",9,4,0,0,13
1931920,1566148,2025-05-05,Joint,"APP Vote Tally Sheet (Joint Favorable)",38,12,0,3,53
1931930,1486970,2025-02-11,Joint,"LAB Vote Tally Sheet (Vote to Draft)",12,1,0,0,13
1931930,1517131,2025-03-13,Joint,"LAB Vote Tally Sheet (Joint Favorable)",13,0,0,0,13
1931973,1492496,2025-02-14,Joint,"GAE Vote Tally Sheet (Vote to Draft)",0,0,0,0,0
1931973,1529438,2025-03-26,Joint,"GAE Vote Tally Sheet (Joint Favorable)",19,0,0,0,19
1931973,1582775,2025-05-31,House,"House Roll Call Vote 270 ",142,0,0,9,151
1931977,1490676,2025-02-14,Joint,"JUD Vote Tally Sheet (Change of Reference)",0,0,0,0,0
1931985,1489385,2025-01-30,Joint,"ET Vote Tally Sheet (Change of Reference)",0,0,0,0,0
1931993,1479979,2025-02-04,Joint,"HED Vote Tally Sheet (Vote to Draft)",0,0,0,0,0
1932104,1480307,2025-02-04,Joint,"BA Vote Tally Sheet (Vote to Draft)",0,0,0,0,0
1932117,1491884,2025-02-14,Joint,"GAE Vote Tally Sheet (Vote to Draft)",0,0,0,0,0
1932117,1521831,2025-03-19,Joint,"GAE Vote Tally Sheet (Joint Favorable Substitute)",13,6,0,0,19
1932117,1573428,2025-05-19,House,"House Roll Call Vote 139 AS AMENDED ",95,45,0,11,151
1932178,1476002,2025-01-28,Joint,"KID Vote Tally Sheet (Reserved for Subject Matter Public Hearing)",0,0,0,0,0
1932178,1492149,2025-02-18,Joint,"KID Vote Tally Sheet (Vote to Draft)",17,0,0,0,17
1932178,1509293,2025-03-06,Joint,"KID Vote Tally Sheet (Joint Favorable)",17,0,0,0,17
1932191,1493184,2025-02-18,Joint,"FIN Vote Tally Sheet (Reserved for Subject Matter Public Hearing)",0,0,0,0,0
1932246,1492035,2025-02-14,Joint,"GAE Vote Tally Sheet (Vote to Draft)",0,0,0,0,0
1932258,1482664,2025-02-04,Joint,"HSG Vote Tally Sheet (Change of Reference)",0,0,0,0,0
1932294,1480271,2025-02-04,Joint,"BA Vote Tally Sheet (Vote to Draft)",0,0,0,0,0
1932298,1482513,2025-02-04,Joint,"HSG Vote Tally Sheet (Change of Reference)",0,0,0,0,0
1932316,1474533,2025-01-24,Joint,"ENV Vote Tally Sheet (Vote to Draft)",0,0,0,0,0
1932316,1503275,2025-02-28,Joint,"ENV Vote Tally Sheet (Joint Favorable Substitute)",35,0,0,0,35
1932316,1558672,2025-04-25,Joint,"JUD Vote Tally Sheet (Joint Favorable)",32,5,0,4,41
1932316,1565407,2025-05-05,Joint,"FIN Vote Tally Sheet (Joint Favorable)",52,0,0,2,54
1932323,1479210,2025-02-03,Joint,"GL Vote Tally Sheet (Vote to Draft)",0,0,0,0,0
1932342,1486839,2025-02-11,Joint,"FIN Vote Tally Sheet (Reserved for Subject Matter Public Hearing)",0,0,0,0,0
1932342,1534892,2025-04-02,Joint,"FIN Vote Tally Sheet (Vote to Draft)",0,0,0,0,0
1932342,1557129,2025-04-24,Joint,"FIN Vote Tally Sheet (Joint Favorable)",40,12,0,0,52
1932348,1476023,2025-01-28,Joint,"HS Vote Tally Sheet (Reserved for Subject Matter Public Hearing)",22,1,0,0,23
1932374,1475951,2025-01-28,Joint,"HS Vote Tally Sheet (Reserved for Subject Matter Public Hearing)",0,0,0,0,0
1932384,1478987,2025-02-03,Joint,"GL Vote Tally Sheet (Vote to Draft)",0,0,0,0,0
1932384,1525160,2025-03-24,Joint,"GL Vote Tally Sheet (Joint Favorable)",22,0,0,0,22
1932386,1479254,2025-02-03,Joint,"GL Vote Tally Sheet (Vote to Draft)",0,0,0,0,0
1932386,1525132,2025-03-24,Joint,"GL Vote Tally Sheet (Joint Favorable)",15,7,0,0,22
1932386,1566475,2025-05-05,Joint,"APP Vote Tally Sheet (Joint Favorable)",38,12,0,3,53
1932418,1491717,2025-02-14,Joint,"GAE Vote Tally Sheet (Vote to Draft)",0,0,0,0,0
1932418,1529397,2025-03-26,Joint,"GAE Vote Tally Sheet (Joint Favorable)",19,0,0,0,19
1932424,1491743,2025-02-14,Joint,"GAE Vote Tally Sheet (Vote to Draft)",0,0,0,0,0
1932443,1475939,2025-01-28,Joint,"HS Vote Tally Sheet (Reserved for Subject Matter Public Hearing)",0,0,0,0,0
1932443,1501128,2025-02-27,Joint,"HS Vote Tally Sheet (Vote to Draft)",0,0,0,0,0
1932443,1517954,2025-03-13,Joint,"HS Vote Tally Sheet (Joint Favorable)",22,0,0,1,23
1932443,1565959,2025-05-05,Joint,"APP Vote Tally Sheet (Joint Favorable)",42,8,0,3,53
1932495,1474534,2025-01-24,Joint,"ENV Vote Tally Sheet (Vote to Draft)",0,0,0,0,0
1932495,1517908,2025-03-14,Joint,"ENV Vote Tally Sheet (Joint Favorable Substitute)",33,0,0,1,34
1932495,1584450,2025-06-03,House,"House Roll Call Vote 336 ",146,1,0,4,151
1932495,1585231,2025-06-04,Senate,"Senate Roll Call Vote 412 ",36,0,0,0,36
1932527,1483971,2025-02-05,Joint,"PD Vote Tally Sheet (Change of Reference)",0,0,0,0,0
1932529,1493050,2025-02-18,Joint,"FIN Vote Tally Sheet (Reserved for Subject Matter Public Hearing)",0,0,0,0,0
1932535,1492409,2025-02-14,Joint,"GAE Vote Tally Sheet (Vote to Draft)",0,0,0,0,0
1932535,1516596,2025-03-12,Joint,"GAE Vote Tally Sheet (Joint Favorable Substitute)",13,6,0,0,19
1932536,1475650,2025-01-28,Joint,"HS Vote Tally Sheet (Reserved for Subject Matter Public Hearing)",0,0,0,0,0
1932537,1480233,2025-02-04,Joint,"HED Vote Tally Sheet (Vote to Draft)",0,0,0,0,0
1932537,1505805,2025-02-27,Joint,"HED Vote Tally Sheet (Joint Favorable)",18,0,0,0,18
1932537,1579211,2025-05-27,House,"House Roll Call Vote 198 ",126,25,0,0,151
1932537,1584448,2025-06-04,Senate,"Senate Roll Call Vote 361 ",35,0,1,0,36
1932543,1493003,2025-02-18,Joint,"APP Vote Tally Sheet (Change of Reference)",0,0,0,0,0
1932567,1493597,2025-02-18,Joint,"APP Vote Tally Sheet (Vote to Draft)",0,0,0,0,0
1932567,1558535,2025-04-24,Joint,"APP Vote Tally Sheet (Joint Favorable Substitute)",54,0,0,0,54
1932587,1475932,2025-01-28,Joint,"HS Vote Tally Sheet (Reserved for Subject Matter Public Hearing)",0,0,0,0,0
1932601,1475753,2025-01-28,Joint,"LAB Vote Tally Sheet (Vote to Draft)",13,0,0,0,13
1932601,1517158,2025-03-13,Joint,"LAB Vote Tally Sheet (Joint Favorable)",13,0,0,0,13
1932601,1580321,2025-05-28,Senate,"Senate Roll Call Vote 252 ",34,2,0,0,36
1932626,1475956,2025-01-28,Joint,"HS Vote Tally Sheet (Vote to Draft)",0,0,0,0,0
1932626,1506164,2025-03-04,Joint,"HS Vote Tally Sheet (Joint Favorable)",23,0,0,0,23
1932639,1475565,2025-01-28,Joint,"KID Vote Tally Sheet (Vote to Draft)",11,5,0,1,17
1932639,1492463,2025-02-18,Joint,"KID Vote Tally Sheet (Joint Favorable)",11,6,0,0,17
1932641,1480040,2025-02-04,Joint,"HED Vote Tally Sheet (Vote to Draft)",0,0,0,0,0
1932641,1518644,2025-03-13,Joint,"HED Vote Tally Sheet (Joint Favorable Substitute)",18,0,0,0,18
1932641,1565677,2025-05-06,Joint,"JUD Vote Tally Sheet (Joint Favorable)",28,11,0,2,41
1932654,1476003,2025-01-28,Joint,"KID Vote Tally Sheet (Vote to Draft)",11,5,0,1,17
1932654,1498947,2025-02-25,Joint,"KID Vote Tally Sheet (Joint Favorable Change of Reference)",16,1,0,0,17
1932693,1479900,2025-02-04,Joint,"VA Vote Tally Sheet (Vote to Draft)",15,5,0,0,20
1932693,1514155,2025-03-11,Joint,"VA Vote Tally Sheet (Joint Favorable Substitute)",20,0,0,1,21
1932734,1475578,2025-01-28,Joint,"LAB Vote Tally Sheet (Reserved for Subject Matter Public Hearing)",9,4,0,0,13
1932803,1479077,2025-02-03,Joint,"GL Vote Tally Sheet (Reserved for Subject Matter Public Hearing)",0,0,0,0,0
1932818,1475776,2025-01-28,Joint,"KID Vote Tally Sheet (Vote to Draft)",12,5,0,0,17
1932818,1492887,2025-02-18,Joint,"KID Vote Tally Sheet (Joint Favorable)",12,5,0,0,17
1932905,1474266,2025-01-24,Joint,"ENV Vote Tally Sheet (Vote to Draft)",0,0,0,0,0
1932934,1492939,2025-02-18,Joint,"FIN Vote Tally Sheet (Reserved for Subject Matter Public Hearing)",0,0,0,0,0
1932947,1491782,2025-02-14,Joint,"GAE Vote Tally Sheet (Vote to Draft)",0,0,0,0,0
1932947,1529759,2025-03-27,Joint,"GAE Vote Tally Sheet (Joint Favorable)",18,1,0,0,19
1932951,1477934,2025-01-30,Joint,"GOS Vote Tally Sheet (Vote to Draft)",0,0,0,0,0
1932951,1499332,2025-02-25,Joint,"GOS Vote Tally Sheet (Joint Favorable)",9,0,0,3,12
1932987,1489834,2025-01-30,Joint,"ET Vote Tally Sheet (Change of Reference)",0,0,0,0,0
1933013,1479842,2025-02-04,Joint,"HED Vote Tally Sheet (Vote to Draft)",14,3,0,1,18
1933013,1518766,2025-03-13,Joint,"HED Vote Tally Sheet (Joint Favorable Substitute Change of Reference)",14,4,0,0,18
1933037,1492987,2025-02-18,Joint,"FIN Vote Tally Sheet (Reserved for Subject Matter Public Hearing)",37,15,0,1,53
1933038,1486598,2025-02-11,Joint,"FIN Vote Tally Sheet (Reserved for Subject Matter Public Hearing)",0,0,0,0,0
1933038,1524661,2025-03-24,Joint,"FIN Vote Tally Sheet (Vote to Draft)",0,0,0,0,0
1933038,1556645,2025-04-24,Joint,"FIN Vote Tally Sheet (Joint Favorable)",36,16,0,0,52
1933050,1475342,2025-01-28,Joint,"HS Vote Tally Sheet (Reserved for Subject Matter Public Hearing)",0,0,0,0,0
1935359,1484865,2025-02-10,Joint,"ENV Vote Tally Sheet (Vote to Draft)",0,0,0,0,0
1935370,1485837,2025-02-10,Joint,"ENV Vote Tally Sheet (Vote to Draft)",0,0,0,0,0
1935374,1484962,2025-02-10,Joint,"ENV Vote Tally Sheet (Vote to Draft)",0,0,0,0,0
1935374,1530230,2025-03-28,Joint,"ENV Vote Tally Sheet (Joint Favorable Substitute)",33,0,0,1,34
1935374,1570736,2025-05-13,House,"House Roll Call Vote 107 AS AMENDED ",144,0,0,7,151
1935374,1576583,2025-05-22,Senate,"Senate Roll Call Vote 226 ",35,0,1,0,36
1935385,1480048,2025-02-04,Joint,"BA Vote Tally Sheet (Vote to Draft)",0,0,0,0,0
1935385,1515277,2025-03-11,Joint,"BA Vote Tally Sheet (Joint Favorable Substitute)",13,0,0,0,13
1935390,1486172,2025-02-11,Joint,"LAB Vote Tally Sheet (Vote to Draft)",13,0,0,0,13
1935390,1508250,2025-03-06,Joint,"LAB Vote Tally Sheet (Joint Favorable Substitute)",9,4,0,0,13
1935390,1582356,2025-05-30,House,"House Roll Call Vote 246 AS AMENDED ",144,0,0,7,151
1935395,1492850,2025-02-18,Joint,"VA Vote Tally Sheet (Joint Favorable)",20,0,0,0,20
1935406,1485424,2025-02-10,Joint,"ENV Vote Tally Sheet (Vote to Draft)",0,0,0,0,0
1935406,1528326,2025-03-24,Joint,"ENV Vote Tally Sheet (Joint Favorable Substitute)",32,0,0,2,34
1935406,1558698,2025-04-25,Joint,"JUD Vote Tally Sheet (Joint Favorable)",37,0,0,4,41
1935440,1480068,2025-02-04,Joint,"HED Vote Tally Sheet (Joint Favorable)",14,3,0,1,18
1935460,1486135,2025-02-10,Joint,"ENV Vote Tally Sheet (Vote to Draft)",0,0,0,0,0
1935467,1486482,2025-02-11,Joint,"LAB Vote Tally Sheet (Reserved for Subject Matter Public Hearing)",13,0,0,0,13
1935467,1508199,2025-03-06,Joint,"LAB Vote Tally Sheet (Vote to Draft)",0,0,0,0,0
1935467,1522877,2025-03-20,Joint,"LAB Vote Tally Sheet (Joint Favorable)",13,0,0,0,13
1935467,1566576,2025-05-05,Joint,"APP Vote Tally Sheet (Joint Favorable)",38,12,0,3,53
1935496,1495048,2025-02-20,Joint,"INS Vote Tally Sheet (Joint Favorable Substitute)",13,0,0,0,13
1935496,1584519,2025-06-03,House,"House Roll Call Vote 324 ",148,0,0,3,151
1935496,1585331,2025-06-04,Senate,"Senate Roll Call Vote 415 ",36,0,0,0,36
1935498,1513680,2025-03-11,Joint,"VA Vote Tally Sheet (Joint Favorable)",20,0,0,1,21
1935498,1566097,2025-05-05,Joint,"APP Vote Tally Sheet (Joint Favorable)",43,7,0,3,53
1935503,1495977,2025-02-20,Joint,"INS Vote Tally Sheet (Joint Favorable)",10,3,0,0,13
1935503,1585675,2025-06-04,House,"House Roll Call Vote 373 AS AMENDED ",150,0,0,1,151
1935509,1486197,2025-02-11,Joint,"LAB Vote Tally Sheet (Vote to Draft)",11,2,0,0,13
1935516,1489350,2025-01-30,Joint,"ET Vote Tally Sheet (Change of Reference)",0,0,0,0,0
1935526,1485897,2025-02-10,Joint,"PD Vote Tally Sheet (Change of Reference)",0,0,0,0,0
1935558,1492697,2025-02-18,Joint,"VA Vote Tally Sheet (Joint Favorable)",17,3,0,0,20
1935558,1562424,2025-04-30,House,"House Roll Call Vote 56 AS AMENDED ",146,0,0,5,151
1935558,1562425,2025-04-30,House,"House Roll Call Vote 55 HOUSE AMD A",139,7,0,5,151
1935558,1576786,2025-05-23,Senate,"Senate Roll Call Vote 239 ",36,0,0,0,36
1935625,1491792,2025-02-14,Joint,"GAE Vote Tally Sheet (Vote to Draft)",0,0,0,0,0
1935634,1486150,2025-02-10,Joint,"ENV Vote Tally Sheet (Vote to Draft)",0,0,0,0,0
1935639,1485893,2025-02-10,Joint,"ENV Vote Tally Sheet (Vote to Draft)",0,0,0,0,0
1935653,1480763,2025-02-04,Joint,"HSG Vote Tally Sheet (Reserved for Subject Matter Public Hearing)",0,0,0,0,0
1935659,1493047,2025-02-18,Joint,"VA Vote Tally Sheet (Joint Favorable Change of Reference)",20,0,0,0,20
1935670,1485791,2025-02-10,Joint,"ENV Vote Tally Sheet (Vote to Draft)",0,0,0,0,0
1935670,1527951,2025-03-24,Joint,"ENV Vote Tally Sheet (Joint Favorable)",29,4,0,1,34
1935670,1558673,2025-04-25,Joint,"JUD Vote Tally Sheet (Joint Favorable)",37,0,0,4,41
1935670,1565392,2025-05-05,Joint,"FIN Vote Tally Sheet (Joint Favorable)",52,0,0,2,54
1935696,1477380,2025-01-30,Joint,"CE Vote Tally Sheet (Reserved for Subject Matter Public Hearing)",0,0,0,0,0
1935699,1485983,2025-02-11,Joint,"KID Vote Tally Sheet (Change of Reference)",0,0,0,0,0
1935699,1490565,2025-02-11,Joint,"KID Vote Tally Sheet (Change of Reference)",0,0,0,0,0
1935768,1484867,2025-02-10,Joint,"ENV Vote Tally Sheet (Vote to Draft)",0,0,0,0,0
1935768,1518014,2025-03-14,Joint,"ENV Vote Tally Sheet (Joint Favorable Substitute)",33,0,0,1,34
1935768,1570758,2025-05-13,House,"House Roll Call Vote 93 ",138,9,0,4,151
1935775,1476935,2025-01-29,Joint,"TRA Vote Tally Sheet (Vote to Draft)",0,0,0,0,0
1935778,1484923,2025-02-10,Joint,"ENV Vote Tally Sheet (Vote to Draft)",24,11,0,0,35
1935786,1485847,2025-02-10,Joint,"ENV Vote Tally Sheet (Vote to Draft)",0,0,0,0,0
1935786,1530161,2025-03-28,Joint,"ENV Vote Tally Sheet (Joint Favorable)",30,2,0,2,34
1935791,1480135,2025-02-04,Joint,"HED Vote Tally Sheet (Joint Favorable)",17,0,0,1,18
1935821,1485001,2025-02-10,Joint,"ENV Vote Tally Sheet (Vote to Draft)",0,0,0,0,0
1935821,1518129,2025-03-14,Joint,"ENV Vote Tally Sheet (Joint Favorable Change of Reference)",33,0,0,1,34
1935821,1557293,2025-04-24,Joint,"FIN Vote Tally Sheet (Joint Favorable)",52,0,0,0,52
1935828,1496063,2025-02-20,Joint,"INS Vote Tally Sheet (Joint Favorable Substitute)",12,1,0,0,13
1935828,1585120,2025-06-04,Senate,"Senate Roll Call Vote 416 ",36,0,0,0,36
1935828,1585121,2025-06-03,House,"House Roll Call Vote 322 ",148,0,0,3,151
1935843,1479994,2025-02-04,Joint,"HED Vote Tally Sheet (Joint Favorable Substitute)",16,1,0,1,18
1935870,1479829,2025-02-04,Joint,"VA Vote Tally Sheet (Reserved for Subject Matter Public Hearing)",0,0,0,0,0
1935870,1493851,2025-02-18,Joint,"VA Vote Tally Sheet (Vote to Draft)",0,0,0,0,0
1935870,1515246,2025-03-11,Joint,"VA Vote Tally Sheet (Joint Favorable)",20,0,0,1,21
1935888,1489376,2025-02-13,Joint,"ET Vote Tally Sheet (Change of Reference)",0,0,0,0,0
1935916,1485819,2025-02-10,Joint,"ENV Vote Tally Sheet (Vote to Draft)",0,0,0,0,0
1935916,1530124,2025-03-28,Joint,"ENV Vote Tally Sheet (Joint Favorable Substitute)",33,0,0,1,34
1935916,1584454,2025-06-03,House,"House Roll Call Vote 337 ",147,0,0,4,151
1935916,1585243,2025-06-04,Senate,"Senate Roll Call Vote 413 ",36,0,0,0,36
1935930,1485597,2025-02-10,Joint,"ENV Vote Tally Sheet (Vote to Draft)",22,13,0,0,35
1935930,1527833,2025-03-24,Joint,"ENV Vote Tally Sheet (Joint Favorable Substitute)",19,14,0,1,34
1935940,1491874,2025-02-14,Joint,"GAE Vote Tally Sheet (Vote to Draft)",0,0,0,0,0
1935940,1529664,2025-03-26,Joint,"GAE Vote Tally Sheet (Joint Favorable)",16,3,0,0,19
1935948,1482948,2025-02-04,Joint,"HSG Vote Tally Sheet (Change of Reference)",0,0,0,0,0
1935953,1486920,2025-02-11,Joint,"LAB Vote Tally Sheet (Reserved for Subject Matter Public Hearing)",13,0,0,0,13
1935953,1508195,2025-03-06,Joint,"LAB Vote Tally Sheet (Vote to Draft)",0,0,0,0,0
1935953,1517167,2025-03-13,Joint,"LAB Vote Tally Sheet (Joint Favorable)",13,0,0,0,13
1935953,1566319,2025-05-05,Joint,"APP Vote Tally Sheet (Joint Favorable)",38,12,0,3,53
1935970,1486972,2025-02-11,Joint,"LAB Vote Tally Sheet (Reserved for Subject Matter Public Hearing)",9,4,0,0,13
1935981,1482651,2025-02-04,Joint,"HSG Vote Tally Sheet (Reserved for Subject Matter Public Hearing)",0,0,0,0,0
1935981,1495991,2025-02-20,Joint,"HSG Vote Tally Sheet (Vote to Draft)",18,0,0,2,20
1935981,1508659,2025-03-06,Joint,"HSG Vote Tally Sheet (Joint Favorable)",12,6,0,2,20
1935984,1485099,2025-02-10,Joint,"ENV Vote Tally Sheet (Change of Reference)",0,0,0,0,0
1935993,1475896,2025-01-28,Joint,"HS Vote Tally Sheet (Vote to Draft)",0,0,0,0,0
1935993,1506571,2025-03-04,Joint,"HS Vote Tally Sheet (Joint Favorable Substitute)",22,0,0,1,23
1936001,1485224,2025-02-10,Joint,"ENV Vote Tally Sheet (Vote to Draft)",0,0,0,0,0
1936001,1527940,2025-03-24,Joint,"ENV Vote Tally Sheet (Joint Favorable Substitute)",25,8,0,1,34
1936019,1486829,2025-02-10,Joint,"PD Vote Tally Sheet (Reserved for Subject Matter Public Hearing)",0,0,0,0,0
1936036,1495059,2025-02-20,Joint,"INS Vote Tally Sheet (Joint Favorable)",13,0,0,0,13
1936036,1564539,2025-05-01,House,"House Roll Call Vote 59 ",145,0,0,6,151
1936036,1583727,2025-06-02,Senate,"Senate Roll Call Vote 339 ",36,0,0,0,36
1936040,1479988,2025-02-04,Joint,"HED Vote Tally Sheet (Joint Favorable)",17,0,0,1,18
1936040,1568013,2025-05-07,Senate,"Senate Roll Call Vote 125 ",36,0,0,0,36
1936052,1492814,2025-02-18,Joint,"VA Vote Tally Sheet (Joint Favorable)",20,0,0,0,20
1936072,1479672,2025-02-04,Joint,"HED Vote Tally Sheet (Joint Favorable)",17,0,0,1,18
1936072,1543141,2025-04-09,Senate,"Senate Roll Call Vote 75 ",35,0,1,0,36
1936072,1576722,2025-05-22,House,"House Roll Call Vote 179 ",146,2,0,3,151
1936114,1486098,2025-02-10,Joint,"PD Vote Tally Sheet (Reserved for Subject Matter Public Hearing)",0,0,0,0,0
1936118,1485069,2025-02-10,Joint,"ENV Vote Tally Sheet (Vote to Draft)",0,0,0,0,0
1936118,1530039,2025-03-28,Joint,"ENV Vote Tally Sheet (Joint Favorable Substitute)",31,2,0,1,34
1936123,1515453,2025-03-11,Joint,"VA Vote Tally Sheet (Joint Favorable)",10,9,1,1,21
1936123,1515454,2025-03-11,Joint,"VA Vote Tally Sheet-A",5,11,0,5,21
1936140,1513601,2025-03-11,Joint,"VA Vote Tally Sheet (Joint Favorable Substitute)",20,0,0,1,21
1936140,1543964,2025-04-08,Joint,"HED Vote Tally Sheet (Joint Favorable)",18,0,0,0,18
1936140,1565402,2025-05-05,Joint,"FIN Vote Tally Sheet (Joint Favorable)",52,0,0,2,54
1936164,1485725,2025-02-10,Joint,"ENV Vote Tally Sheet (Vote to Draft)",0,0,0,0,0
1936164,1518118,2025-03-14,Joint,"ENV Vote Tally Sheet (Joint Favorable)",33,0,0,1,34
1936164,1574785,2025-05-20,House,"House Roll Call Vote 150 AS AMENDED ",146,0,0,5,151
1936164,1585410,2025-06-04,Senate,"Senate Roll Call Vote 420 ",36,0,0,0,36
1936200,1485724,2025-02-10,Joint,"ENV Vote Tally Sheet (Vote to Draft)",0,0,0,0,0
1936225,1487352,2025-02-11,Joint,"LAB Vote Tally Sheet (Reserved for Subject Matter Public Hearing)",13,0,0,0,13
1936225,1507341,2025-03-06,Joint,"LAB Vote Tally Sheet (Vote to Draft)",9,4,0,0,13
1936225,1522879,2025-03-20,Joint,"LAB Vote Tally Sheet (Joint Favorable)",9,4,0,0,13
1936248,1485110,2025-02-10,Joint,"ENV Vote Tally Sheet (Vote to Draft)",0,0,0,0,0
1936248,1530004,2025-03-28,Joint,"ENV Vote Tally Sheet (Joint Favorable Substitute)",33,0,0,1,34
1936260,1477474,2025-01-30,Joint,"GOS Vote Tally Sheet (Vote to Draft)",0,0,0,0,0
1936292,1482259,2025-02-04,Joint,"HSG Vote Tally Sheet (Change of Reference)",0,0,0,0,0
1936316,1486425,2025-02-10,Joint,"PD Vote Tally Sheet (Reserved for Subject Matter Public Hearing)",0,0,0,0,0
1936322,1484903,2025-02-10,Joint,"ENV Vote Tally Sheet (Vote to Draft)",0,0,0,0,0
1936322,1528132,2025-03-24,Joint,"ENV Vote Tally Sheet (Joint Favorable Substitute)",23,10,0,1,34
1936342,1479830,2025-02-04,Joint,"HED Vote Tally Sheet (Joint Favorable)",15,2,0,1,18
1936350,1505790,2025-02-27,Joint,"HED Vote Tally Sheet (Joint Favorable Substitute)",18,0,0,0,18
1936350,1584525,2025-06-04,Senate,"Senate Roll Call Vote 369 ",36,0,0,0,36
1936350,1584526,2025-06-03,House,"House Roll Call Vote 298 AS AMENDED ",142,1,0,8,151
1936352,1484973,2025-02-10,Joint,"ENV Vote Tally Sheet (Vote to Draft)",0,0,0,0,0
1936352,1517981,2025-03-14,Joint,"ENV Vote Tally Sheet (Joint Favorable Substitute)",33,0,0,1,34
1936378,1495945,2025-02-20,Joint,"INS Vote Tally Sheet (Joint Favorable)",12,1,0,0,13
1936378,1584510,2025-06-03,House,"House Roll Call Vote 323 ",147,1,0,3,151
1936378,1585399,2025-06-04,Senate,"Senate Roll Call Vote 417 ",36,0,0,0,36
1936396,1493044,2025-02-18,Joint,"VA Vote Tally Sheet (Joint Favorable)",16,3,0,1,20
1936396,1566591,2025-05-05,Joint,"APP Vote Tally Sheet (Joint Favorable)",43,7,0,3,53
1936396,1582410,2025-05-30,House,"House Roll Call Vote 243 AS AMENDED ",148,0,0,3,151
1936396,1582411,2025-05-30,House,"House Roll Call Vote 242 HOUSE AMD A",143,5,0,3,151
1936396,1583644,2025-06-02,Senate,"Senate Roll Call Vote 340 ",36,0,0,0,36
1936402,1491790,2025-02-14,Joint,"GAE Vote Tally Sheet (Vote to Draft)",0,0,0,0,0
1936402,1528746,2025-03-26,Joint,"GAE Vote Tally Sheet (Joint Favorable Substitute)",14,5,0,0,19
1936427,1487001,2025-02-11,Joint,"KID Vote Tally Sheet (Change of Reference)",0,0,0,0,0
1938112,1482178,2025-02-04,Joint,"HSG Vote Tally Sheet (Reserved for Subject Matter Public Hearing)",0,0,0,0,0
1938112,1495321,2025-02-20,Joint,"HSG Vote Tally Sheet (Vote to Draft)",18,0,0,2,20
1938121,1479620,2025-02-04,Joint,"VA Vote Tally Sheet (Reserved for Subject Matter Public Hearing)",0,0,0,0,0
1938121,1493072,2025-02-18,Joint,"VA Vote Tally Sheet (Vote to Draft)",0,0,0,0,0
1938121,1513681,2025-03-11,Joint,"VA Vote Tally Sheet (Joint Favorable Substitute)",20,0,0,1,21
1938126,1479626,2025-02-04,Joint,"VA Vote Tally Sheet (Vote to Draft)",0,0,0,0,0
1938126,1492702,2025-02-18,Joint,"VA Vote Tally Sheet (Joint Favorable)",20,0,0,0,20
1938166,1484257,2025-02-05,Joint,"PD Vote Tally Sheet (Change of Reference)",0,0,0,0,0
1938219,1482822,2025-02-04,Joint,"HSG Vote Tally Sheet (Change of Reference)",0,0,0,0,0
1938257,1480157,2025-02-04,Joint,"VA Vote Tally Sheet (Reserved for Subject Matter Public Hearing)",0,0,0,0,0
1938257,1493020,2025-02-18,Joint,"VA Vote Tally Sheet (Vote to Draft)",0,0,0,0,0
1938257,1515247,2025-03-11,Joint,"VA Vote Tally Sheet (Joint Favorable)",20,0,0,1,21
1938286,1480826,2025-02-04,Joint,"HSG Vote Tally Sheet (Reserved for Subject Matter Public Hearing)",14,6,0,0,20
1938304,1477348,2025-01-30,Joint,"GOS Vote Tally Sheet (Vote to Draft)",0,0,0,0,0
1938304,1519629,2025-03-18,Joint,"GOS Vote Tally Sheet (Joint Favorable)",12,0,0,0,12
1938420,1475729,2025-01-28,Joint,"HS Vote Tally Sheet (Vote to Draft)",17,6,0,0,23
1938420,1506007,2025-03-04,Joint,"HS Vote Tally Sheet (Joint Favorable)",16,7,0,0,23
1938464,1479711,2025-02-04,Joint,"VA Vote Tally Sheet (Vote to Draft)",0,0,0,0,0
1938464,1492870,2025-02-18,Joint,"VA Vote Tally Sheet (Joint Favorable)",20,0,0,0,20
1938516,1482964,2025-02-04,Joint,"HSG Vote Tally Sheet (Change of Reference)",0,0,0,0,0
1938579,1486773,2025-02-10,Joint,"PD Vote Tally Sheet (Reserved for Subject Matter Public Hearing)",0,0,0,0,0
1938616,1479871,2025-02-04,Joint,"VA Vote Tally Sheet (Reserved for Subject Matter Public Hearing)",0,0,0,0,0
1938616,1493057,2025-02-18,Joint,"VA Vote Tally Sheet (Vote to Draft)",0,0,0,0,0
1938616,1515236,2025-03-11,Joint,"VA Vote Tally Sheet (Joint Favorable)",20,0,0,1,21
1938634,1478791,2025-02-03,Joint,"GL Vote Tally Sheet (Reserved for Subject Matter Public Hearing)",0,0,0,0,0
1938652,1479560,2025-02-04,Joint,"VA Vote Tally Sheet (Vote to Draft)",0,0,0,0,0
1938652,1513399,2025-03-11,Joint,"VA Vote Tally Sheet (Joint Favorable Substitute Change of Reference)",20,0,0,1,21
1938657,1485851,2025-02-10,Joint,"PD Vote Tally Sheet (Reserved for Subject Matter Public Hearing)",0,0,0,0,0
1938657,1513470,2025-03-07,Joint,"PD Vote Tally Sheet (Vote to Draft)",0,0,0,0,0
1938657,1531045,2025-03-28,Joint,"PD Vote Tally Sheet (Joint Favorable)",12,8,1,1,22
1938677,1486398,2025-02-11,Joint,"LAB Vote Tally Sheet (Vote to Draft)",9,4,0,0,13
1938677,1519691,2025-03-18,Joint,"LAB Vote Tally Sheet (Joint Favorable)",9,4,0,0,13
1938697,1480092,2025-02-04,Joint,"VA Vote Tally Sheet (Reserved for Subject Matter Public Hearing)",0,0,0,0,0
1938697,1493137,2025-02-18,Joint,"VA Vote Tally Sheet (Vote to Draft)",0,0,0,0,0
1938697,1515558,2025-03-11,Joint,"VA Vote Tally Sheet (Joint Favorable)",20,0,0,1,21
1938764,1482738,2025-02-04,Joint,"HSG Vote Tally Sheet (Change of Reference)",0,0,0,0,0
1938791,1503081,2025-02-28,Joint,"ENV Vote Tally Sheet (Joint Favorable Substitute)",34,1,0,0,35
1938810,1477472,2025-01-30,Joint,"CE Vote Tally Sheet (Reserved for Subject Matter Public Hearing)",0,0,0,0,0
1938846,1491728,2025-02-14,Joint,"GAE Vote Tally Sheet (Vote to Draft)",0,0,0,0,0
1938846,1530268,2025-03-26,Joint,"GAE Vote Tally Sheet (Joint Favorable)",13,6,0,0,19
1938846,1571909,2025-05-14,House,"House Roll Call Vote 118 AS AMENDED ",100,46,0,5,151
1938849,1485830,2025-02-10,Joint,"ENV Vote Tally Sheet (Vote to Draft)",0,0,0,0,0
1938901,1476893,2025-01-29,Joint,"TRA Vote Tally Sheet (Change of Reference)",0,0,0,0,0
1938912,1491778,2025-02-14,Joint,"GAE Vote Tally Sheet (Vote to Draft)",0,0,0,0,0
1938912,1529737,2025-03-26,Joint,"GAE Vote Tally Sheet (Joint Favorable)",13,6,0,0,19
1938921,1486014,2025-02-10,Joint,"PH Vote Tally Sheet (Reserved for Subject Matter Public Hearing)",26,6,0,1,33
1939572,1474373,2025-01-22,Joint,"JUD Vote Tally Sheet (Joint Favorable)",39,0,0,1,40
1939572,1475737,2025-01-28,Senate,"Senate Roll Call Vote 27 ",34,0,1,0,35
1939572,1491355,2025-01-28,House,"House Roll Call Vote 11 CONSENT CALENDAR ",141,0,0,9,150
1939589,1474387,2025-01-22,Joint,"JUD Vote Tally Sheet (Joint Favorable)",38,0,1,1,40
1939589,1476043,2025-01-28,House,"House Roll Call Vote 3 ",144,0,0,6,150
1939589,1476044,2025-01-28,Senate,"Senate Roll Call Vote 25 ",34,0,1,0,35
1939609,1474377,2025-01-22,Joint,"JUD Vote Tally Sheet (Joint Favorable)",38,0,1,1,40
1939609,1475590,2025-01-28,Senate,"Senate Roll Call Vote 33 ",34,0,1,0,35
1939609,1478630,2025-01-28,House,"House Roll Call Vote 9 ",143,0,0,7,150
1939629,1474374,2025-01-22,Joint,"JUD Vote Tally Sheet (Joint Favorable)",38,1,0,1,40
1939629,1475908,2025-01-28,House,"House Roll Call Vote 2 ",131,13,0,6,150
1939629,1475909,2025-01-28,Senate,"Senate Roll Call Vote 18 ",31,3,1,0,35
1939648,1474385,2025-01-22,Joint,"JUD Vote Tally Sheet (Joint Favorable)",38,0,1,1,40
1939648,1476061,2025-01-28,House,"House Roll Call Vote 6 ",143,0,0,7,150
1939648,1476062,2025-01-28,Senate,"Senate Roll Call Vote 20 ",34,0,1,0,35
1939670,1474465,2025-01-22,Joint,"JUD Vote Tally Sheet (Joint Favorable)",38,0,1,1,40
1939670,1475587,2025-01-28,Senate,"Senate Roll Call Vote 31 ",34,0,1,0,35
1939670,1478629,2025-01-28,House,"House Roll Call Vote 10 ",142,0,0,8,150
1939689,1474487,2025-01-22,Joint,"JUD Vote Tally Sheet (Joint Favorable)",39,0,0,1,40
1939689,1475978,2025-01-28,Senate,"Senate Roll Call Vote 32 ",34,0,1,0,35
1939689,1491600,2025-01-28,House,"House Roll Call Vote 11 CONSENT CALENDAR ",141,0,0,9,150
1939707,1474382,2025-01-22,Joint,"JUD Vote Tally Sheet (Joint Favorable)",39,0,0,1,40
1939707,1478623,2025-01-28,Senate,"Senate Roll Call Vote 23 ",34,0,1,0,35
1939707,1491068,2025-01-28,House,"House Roll Call Vote 11 CONSENT CALENDAR ",141,0,0,9,150
1939726,1474375,2025-01-22,Joint,"JUD Vote Tally Sheet (Joint Favorable)",39,0,0,1,40
1939726,1475461,2025-01-28,Senate,"Senate Roll Call Vote 21 ",34,0,1,0,35
1939726,1478624,2025-01-28,House,"House Roll Call Vote 11 CONSENT CALENDAR ",141,0,0,9,150
1939750,1474383,2025-01-22,Joint,"JUD Vote Tally Sheet (Joint Favorable)",39,0,0,1,40
1939750,1475508,2025-01-28,Senate,"Senate Roll Call Vote 24 ",34,0,1,0,35
1939750,1491165,2025-01-28,House,"House Roll Call Vote 11 CONSENT CALENDAR ",141,0,0,9,150
1939770,1474379,2025-01-22,Joint,"JUD Vote Tally Sheet (Joint Favorable)",38,0,1,1,40
1939770,1475755,2025-01-28,House,"House Roll Call Vote 5 ",132,12,0,6,150
1939770,1475756,2025-01-28,Senate,"Senate Roll Call Vote 19 ",34,0,1,0,35
1939790,1474393,2025-01-22,Joint,"JUD Vote Tally Sheet (Joint Favorable)",39,0,0,1,40
1939790,1475989,2025-01-28,Senate,"Senate Roll Call Vote 22 ",34,0,1,0,35
1939790,1491607,2025-01-28,House,"House Roll Call Vote 11 CONSENT CALENDAR ",141,0,0,9,150
1939809,1474489,2025-01-22,Joint,"JUD Vote Tally Sheet (Joint Favorable)",38,0,1,1,40
1939809,1475739,2025-01-28,House,"House Roll Call Vote 8 ",143,0,0,7,150
1939809,1475740,2025-01-28,Senate,"Senate Roll Call Vote 29 ",34,0,1,0,35
1939830,1474376,2025-01-22,Joint,"JUD Vote Tally Sheet (Joint Favorable)",38,1,0,1,40
1939830,1476034,2025-01-28,House,"House Roll Call Vote 4 ",142,3,0,5,150
1939830,1476035,2025-01-28,Senate,"Senate Roll Call Vote 34 ",32,1,2,0,35
1939850,1474384,2025-01-22,Joint,"JUD Vote Tally Sheet (Joint Favorable)",39,0,0,1,40
1939850,1475750,2025-01-28,Senate,"Senate Roll Call Vote 30 ",34,0,1,0,35
1939850,1491384,2025-01-28,House,"House Roll Call Vote 11 CONSENT CALENDAR ",141,0,0,9,150
1939870,1474380,2025-01-22,Joint,"JUD Vote Tally Sheet (Joint Favorable)",39,0,0,1,40
1939870,1475941,2025-01-28,House,"House Roll Call Vote 7 ",139,6,0,5,150
1939870,1475942,2025-01-28,Senate,"Senate Roll Call Vote 26 ",34,0,1,0,35
1939889,1474381,2025-01-22,Joint,"JUD Vote Tally Sheet (Joint Favorable)",39,0,0,1,40
1939889,1475474,2025-01-28,Senate,"Senate Roll Call Vote 28 ",34,0,1,0,35
1939889,1491091,2025-01-28,House,"House Roll Call Vote 11 CONSENT CALENDAR ",141,0,0,9,150
1939912,1475015,2025-01-23,Joint,"EXN Vote Tally Sheet (Joint Favorable)",19,0,0,1,20
1939912,1506789,2025-03-05,Senate,"Senate Roll Call Vote 47 ",35,0,1,0,36
1941356,1474932,2025-01-24,Joint,"JUD Vote Tally Sheet (Joint Favorable)",37,0,1,3,41
1941356,1475683,2025-01-28,House,"House Roll Call Vote 23 ",137,1,0,12,150
1941356,1475684,2025-01-28,Senate,"Senate Roll Call Vote 15 ",34,0,1,0,35
1941368,1474795,2025-01-24,Joint,"JUD Vote Tally Sheet (Joint Favorable)",37,1,0,3,41
1941368,1475960,2025-01-28,House,"House Roll Call Vote 21 ",110,28,0,12,150
1941368,1475961,2025-01-28,Senate,"Senate Roll Call Vote 14 ",34,0,1,0,35
1941378,1474962,2025-01-24,Joint,"JUD Vote Tally Sheet (Joint Favorable)",38,0,0,3,41
1941378,1475734,2025-01-28,House,"House Roll Call Vote 16 ",105,38,0,7,150
1941378,1475735,2025-01-28,Senate,"Senate Roll Call Vote 1 ",26,7,2,0,35
1941404,1477954,2025-01-30,Joint,"CE Vote Tally Sheet (Reserved for Subject Matter Public Hearing)",0,0,0,0,0
1941416,1474815,2025-01-24,Joint,"JUD Vote Tally Sheet (Joint Favorable)",38,0,0,3,41
1941416,1475479,2025-01-28,Senate,"Senate Roll Call Vote 7 ",34,0,1,0,35
1941416,1491686,2025-01-28,House,"House Roll Call Vote 24 CONSENT CALENDAR ",139,0,0,11,150
1941426,1477451,2025-01-30,Joint,"CE Vote Tally Sheet (Change of Reference)",0,0,0,0,0
1941437,1474964,2025-01-24,Joint,"JUD Vote Tally Sheet (Joint Favorable)",36,0,2,3,41
1941437,1475694,2025-01-28,House,"House Roll Call Vote 20 ",126,12,0,12,150
1941437,1475695,2025-01-28,Senate,"Senate Roll Call Vote 11 ",34,0,1,0,35
1941450,1484067,2025-02-05,Joint,"PD Vote Tally Sheet (Change of Reference)",0,0,0,0,0
1941460,1474798,2025-01-23,Joint,"EXN Vote Tally Sheet (Joint Favorable)",19,0,0,1,20
1941460,1506990,2025-03-05,Senate,"Senate Roll Call Vote 46 ",35,0,1,0,36
1941474,1477966,2025-01-30,Joint,"CE Vote Tally Sheet (Reserved for Subject Matter Public Hearing)",0,0,0,0,0
1941474,1502320,2025-02-20,Joint,"CE Vote Tally Sheet (Change of Reference)",0,0,0,0,0
1941485,1474831,2025-01-24,Joint,"JUD Vote Tally Sheet (Joint Favorable)",38,0,0,3,41
1941485,1475497,2025-01-28,Senate,"Senate Roll Call Vote 5 ",34,0,1,0,35
1941485,1491687,2025-01-28,House,"House Roll Call Vote 24 CONSENT CALENDAR ",139,0,0,11,150
1941498,1475127,2025-01-24,Joint,"JUD Vote Tally Sheet (Joint Favorable)",38,0,0,3,41
1941498,1475943,2025-01-28,Senate,"Senate Roll Call Vote 9 ",34,0,1,0,35
1941498,1491563,2025-01-28,House,"House Roll Call Vote 24 CONSENT CALENDAR ",139,0,0,11,150
1941519,1474723,2025-01-24,Joint,"JUD Vote Tally Sheet (Joint Favorable)",38,0,0,3,41
1941519,1475337,2025-01-28,Senate,"Senate Roll Call Vote 6 ",34,0,1,0,35
1941519,1491565,2025-01-28,House,"House Roll Call Vote 24 CONSENT CALENDAR ",139,0,0,11,150
1941530,1491773,2025-02-14,Joint,"GAE Vote Tally Sheet (Vote to Draft)",0,0,0,0,0
1941530,1522045,2025-03-19,Joint,"GAE Vote Tally Sheet (Joint Favorable Substitute)",19,0,0,0,19
1941571,1474700,2025-01-24,Joint,"JUD Vote Tally Sheet (Joint Favorable)",38,0,0,3,41
1941571,1475553,2025-01-28,Senate,"Senate Roll Call Vote 3 ",34,0,1,0,35
1941571,1478626,2025-01-28,House,"House Roll Call Vote 24 CONSENT CALENDAR ",139,0,0,11,150
1941638,1474893,2025-01-24,Joint,"JUD Vote Tally Sheet (Joint Favorable)",38,0,0,3,41
1941638,1476010,2025-01-28,House,"House Roll Call Vote 15 ",138,5,0,7,150
1941638,1476011,2025-01-28,Senate,"Senate Roll Call Vote 2 ",29,5,1,0,35
1941650,1475006,2025-01-24,Joint,"JUD Vote Tally Sheet (Joint Favorable)",37,1,0,3,41
1941650,1475787,2025-01-28,House,"House Roll Call Vote 19 ",136,3,0,11,150
1941650,1475788,2025-01-28,Senate,"Senate Roll Call Vote 4 ",34,0,1,0,35
1941660,1474724,2025-01-24,Joint,"JUD Vote Tally Sheet (Joint Favorable)",38,0,0,3,41
1941660,1475348,2025-01-28,Senate,"Senate Roll Call Vote 10 ",34,0,1,0,35
1941660,1476045,2025-01-28,House,"House Roll Call Vote 18 ",126,15,0,9,150
1941683,1474909,2025-01-24,Joint,"JUD Vote Tally Sheet (Joint Favorable)",38,0,0,3,41
1941683,1475615,2025-01-28,Senate,"Senate Roll Call Vote 12 ",34,0,1,0,35
1941683,1491278,2025-01-28,House,"House Roll Call Vote 24 CONSENT CALENDAR ",139,0,0,11,150
1941697,1475072,2025-01-24,Joint,"JUD Vote Tally Sheet (Joint Favorable)",37,0,1,3,41
1941697,1475456,2025-01-28,Senate,"Senate Roll Call Vote 13 ",34,0,1,0,35
1941697,1476069,2025-01-28,House,"House Roll Call Vote 22 ",137,1,0,12,150
1941707,1474811,2025-01-24,Joint,"JUD Vote Tally Sheet (Joint Favorable)",38,0,0,3,41
1941707,1475475,2025-01-28,Senate,"Senate Roll Call Vote 8 ",34,0,1,0,35
1941707,1478625,2025-01-28,House,"House Roll Call Vote 17 ",119,23,0,8,150
1941729,1480272,2025-02-04,Joint,"VA Vote Tally Sheet (Vote to Draft)",0,0,0,0,0
1941729,1515309,2025-03-11,Joint,"VA Vote Tally Sheet (Joint Favorable Substitute)",19,1,0,1,21
1942325,1475361,2025-01-28,Senate,"Senate Roll Call Vote 16 ",34,0,1,0,35
1942501,1475995,2025-01-28,Senate,"Senate Roll Call Vote 17 ",34,0,1,0,35
1942683,1475962,2025-01-28,House,"House Roll Call Vote 14 EMERGENCY CERTIFICATION ",143,0,0,7,150
1942875,1479680,2025-02-04,Joint,"VA Vote Tally Sheet (Reserved for Subject Matter Public Hearing)",0,0,0,0,0
1942909,1480119,2025-02-04,Joint,"VA Vote Tally Sheet (Vote to Draft)",0,0,0,0,0
1942909,1515301,2025-03-11,Joint,"VA Vote Tally Sheet (Joint Favorable Substitute Change of Reference)",20,0,0,1,21
1942928,1479918,2025-02-04,Joint,"VA Vote Tally Sheet (Reserved for Subject Matter Public Hearing)",0,0,0,0,0
1942978,1479914,2025-02-04,Joint,"VA Vote Tally Sheet (Vote to Draft)",0,0,0,0,0
1942978,1514264,2025-03-11,Joint,"VA Vote Tally Sheet (Joint Favorable Substitute)",20,0,0,1,21
1943020,1492107,2025-02-14,Joint,"GAE Vote Tally Sheet (Vote to Draft)",0,0,0,0,0
1943020,1521807,2025-03-19,Joint,"GAE Vote Tally Sheet (Joint Favorable Substitute)",14,5,0,0,19
1943144,1479603,2025-02-04,Joint,"VA Vote Tally Sheet (Vote to Draft)",0,0,0,0,0
1943158,1478622,2025-01-28,House,"House Roll Call Vote 12 EMERGENCY CERTIFICATION ",143,0,0,7,150
1943281,1478621,2025-01-28,House,"House Roll Call Vote 13 EMERGENCY CERTIFICATION ",143,0,0,7,150
1944581,1493032,2025-02-18,Joint,"FIN Vote Tally Sheet (Reserved for Subject Matter Public Hearing)",0,0,0,0,0
1944585,1492504,2025-02-14,Joint,"PD Vote Tally Sheet (Joint Favorable)",17,1,0,4,22
1944591,1505305,2025-03-04,Joint,"AGE Vote Tally Sheet (Joint Favorable)",13,0,0,1,14
1944596,1513516,2025-03-07,Joint,"PD Vote Tally Sheet (Joint Favorable)",20,0,0,2,22
1944596,1565396,2025-05-05,Joint,"FIN Vote Tally Sheet (Joint Favorable)",45,6,0,3,54
1944601,1516841,2025-03-12,Joint,"PD Vote Tally Sheet (Joint Favorable Substitute)",13,7,0,2,22
1944601,1567016,2025-05-07,Senate,"Senate Roll Call Vote 116 ",23,11,2,0,36
1944601,1585101,2025-06-04,House,"House Roll Call Vote 368 AS AMENDED ",84,65,0,2,151
1944620,1491800,2025-02-14,Joint,"PD Vote Tally Sheet (Joint Favorable)",18,0,0,4,22
1944644,1513560,2025-03-07,Joint,"PD Vote Tally Sheet (Joint Favorable Change of Reference)",20,0,0,2,22
1944663,1516836,2025-03-12,Joint,"PD Vote Tally Sheet (Joint Favorable Substitute)",12,8,0,2,22
1944663,1516982,2025-03-12,Joint,"PD Vote Tally Sheet-A",8,10,0,4,22
1944663,1516983,2025-03-12,Joint,"PD Vote Tally Sheet-B",7,12,0,3,22
1944663,1516984,2025-03-12,Joint,"PD Vote Tally Sheet-C",7,11,0,4,22
1944663,1516985,2025-03-12,Joint,"PD Vote Tally Sheet-D",7,11,0,4,22
1944663,1516986,2025-03-12,Joint,"PD Vote Tally Sheet-E",6,12,0,4,22
1944663,1557961,2025-04-24,Joint,"APP Vote Tally Sheet (Joint Favorable)",40,14,0,0,54
1944674,1484246,2025-02-05,Joint,"PD Vote Tally Sheet (Reserved for Subject Matter Public Hearing)",11,8,0,3,22
1944681,1492839,2025-02-18,Joint,"AGE Vote Tally Sheet (Joint Favorable Substitute)",14,0,0,0,14
1944688,1485193,2025-02-10,Joint,"PH Vote Tally Sheet (Joint Favorable Substitute)",32,0,0,1,33
1944694,1493672,2025-02-19,Joint,"PH Vote Tally Sheet (Joint Favorable Substitute)",31,1,0,1,33
1944701,1508717,2025-03-06,Joint,"AGE Vote Tally Sheet (Joint Favorable Substitute Change of Reference)",14,0,0,0,14
1944707,1477597,2025-01-30,Joint,"CE Vote Tally Sheet (Reserved for Subject Matter Public Hearing)",0,0,0,0,0
1944737,1492250,2025-02-14,Joint,"PD Vote Tally Sheet (Joint Favorable Substitute)",18,0,0,4,22
1944737,1564327,2025-05-01,Senate,"Senate Roll Call Vote 108 ",30,6,0,0,36
1944737,1585342,2025-06-04,House,"House Roll Call Vote 358 ",150,0,0,1,151
1944749,1517430,2025-03-13,Joint,"ET Vote Tally Sheet (Joint Favorable Substitute)",25,0,0,0,25
1944749,1565572,2025-05-05,Joint,"APP Vote Tally Sheet (Joint Favorable)",38,12,0,3,53
1944749,1582768,2025-05-31,House,"House Roll Call Vote 249 AS AMENDED ",144,1,0,6,151
1944749,1584954,2025-06-04,Senate,"Senate Roll Call Vote 392 ",34,1,1,0,36
1944774,1485520,2025-02-10,Joint,"PH Vote Tally Sheet (Joint Favorable)",32,0,0,1,33
1944788,1494303,2025-02-19,Joint,"PH Vote Tally Sheet (Joint Favorable)",20,12,0,1,33
1944828,1477935,2025-01-30,Joint,"CE Vote Tally Sheet (Reserved for Subject Matter Public Hearing)",0,0,0,0,0
1944828,1502327,2025-02-20,Joint,"CE Vote Tally Sheet (Vote to Draft)",0,0,0,0,0
1944828,1520431,2025-03-18,Joint,"CE Vote Tally Sheet (Joint Favorable Substitute)",20,0,0,0,20
1944837,1516870,2025-03-12,Joint,"PD Vote Tally Sheet (Joint Favorable)",15,5,0,2,22
1944842,1491716,2025-02-14,Joint,"PD Vote Tally Sheet (Joint Favorable)",18,0,0,4,22
1944842,1564110,2025-05-01,House,"House Roll Call Vote 61 ",146,0,0,5,151
1944842,1585273,2025-06-04,Senate,"Senate Roll Call Vote 414 ",36,0,0,0,36
1944861,1485206,2025-02-10,Joint,"PH Vote Tally Sheet (Joint Favorable Substitute)",32,0,0,1,33
1944883,1477387,2025-01-30,Joint,"CE Vote Tally Sheet (Reserved for Subject Matter Public Hearing)",13,6,0,0,19
1944883,1502325,2025-02-28,Joint,"CE Vote Tally Sheet (Vote to Draft)",15,3,0,1,19
1944883,1522630,2025-03-20,Joint,"CE Vote Tally Sheet (Joint Favorable Change of Reference)",17,3,0,0,20
1944890,1477839,2025-01-30,Joint,"CE Vote Tally Sheet (Reserved for Subject Matter Public Hearing)",0,0,0,0,0
1944890,1502336,2025-02-20,Joint,"CE Vote Tally Sheet (Vote to Draft)",0,0,0,0,0
1944890,1523847,2025-03-20,Joint,"CE Vote Tally Sheet (Joint Favorable Substitute)",20,0,0,0,20
1944890,1523848,2025-03-20,Joint,"CE Vote Tally Sheet-A (Joint Favorable Substitute)",0,0,0,0,0
1944890,1572038,2025-05-15,Senate,"Senate Roll Call Vote 174 ",35,1,0,0,36
1944890,1585722,2025-06-04,House,"House Roll Call Vote 343 AS AMENDED ",139,6,0,6,151
1944897,1492429,2025-02-18,Joint,"AGE Vote Tally Sheet (Joint Favorable)",12,2,0,0,14
1944910,1486068,2025-02-10,Joint,"PD Vote Tally Sheet (Reserved for Subject Matter Public Hearing)",0,0,0,0,0
1944916,1492781,2025-02-18,Joint,"AGE Vote Tally Sheet (Joint Favorable)",12,2,0,0,14
1944916,1566136,2025-05-05,Joint,"APP Vote Tally Sheet (Joint Favorable)",38,12,0,3,53
1944932,1482959,2025-02-04,Joint,"HSG Vote Tally Sheet (Change of Reference)",0,0,0,0,0
1944932,1486900,2025-02-10,Joint,"PD Vote Tally Sheet (Reserved for Subject Matter Public Hearing)",0,0,0,0,0
1944932,1513430,2025-03-07,Joint,"PD Vote Tally Sheet (Vote to Draft)",19,1,0,2,22
1944932,1530782,2025-03-28,Joint,"PD Vote Tally Sheet (Joint Favorable)",21,0,0,1,22
1944932,1531517,2025-03-28,Joint,"PD Vote Tally Sheet-A (Joint Favorable Substitute)",0,0,0,0,0
1944983,1477908,2025-01-30,Joint,"CE Vote Tally Sheet (Reserved for Subject Matter Public Hearing)",0,0,0,0,0
1944989,1492030,2025-02-18,Joint,"AGE Vote Tally Sheet (Joint Favorable)",14,0,0,0,14
1945001,1513547,2025-03-07,Joint,"PD Vote Tally Sheet (Joint Favorable)",20,0,0,2,22
1945001,1576886,2025-05-22,Senate,"Senate Roll Call Vote 228 ",34,1,1,0,36
1945013,1506666,2025-03-05,Joint,"PH Vote Tally Sheet (Joint Favorable Substitute)",32,0,0,0,32
1945039,1504342,2025-03-04,Joint,"AGE Vote Tally Sheet (Joint Favorable Substitute)",13,0,0,1,14
1945039,1532180,2025-04-01,Joint,"INS Vote Tally Sheet (Joint Favorable)",11,2,0,0,13
1945039,1565666,2025-05-05,Joint,"APP Vote Tally Sheet (Joint Favorable)",41,9,0,3,53
1945039,1568553,2025-05-08,House,"House Roll Call Vote 79 AS AMENDED ",147,0,0,4,151
1945039,1575189,2025-05-21,Senate,"Senate Roll Call Vote 209 ",36,0,0,0,36
1945044,1513559,2025-03-07,Joint,"PD Vote Tally Sheet (Joint Favorable Change of Reference)",20,0,0,2,22
1945044,1545775,2025-04-10,Joint,"JUD Vote Tally Sheet (Joint Favorable Substitute)",39,0,0,2,41
1945044,1545776,2025-04-10,Joint,"JUD Vote Tally Sheet-A (Joint Favorable Substitute)",0,0,0,0,0
1945049,1477904,2025-01-30,Joint,"CE Vote Tally Sheet (Change of Reference)",0,0,0,0,0
1945056,1484908,2025-02-10,Joint,"PH Vote Tally Sheet (Joint Favorable)",32,0,0,1,33
1945056,1565003,2025-05-05,Joint,"FIN Vote Tally Sheet (Joint Favorable)",52,0,0,2,54
1945056,1580616,2025-05-28,House,"House Roll Call Vote 202 ",148,0,0,3,151
1945063,1477929,2025-01-30,Joint,"CE Vote Tally Sheet (Change of Reference)",0,0,0,0,0
1946498,1520852,2025-03-18,Joint,"LAB Vote Tally Sheet (Joint Favorable Substitute)",9,4,0,0,13
1946498,1568879,2025-05-08,House,"House Roll Call Vote 85 ",131,12,0,8,151
1946539,1508389,2025-03-06,Joint,"LAB Vote Tally Sheet (Joint Favorable)",9,4,0,0,13
1946539,1566562,2025-05-05,Joint,"APP Vote Tally Sheet (Joint Favorable)",38,12,0,3,53
1946539,1576768,2025-05-22,House,"House Roll Call Vote 183 AS AMENDED ",100,46,0,5,151
1946559,1492872,2025-02-18,Joint,"KID Vote Tally Sheet (Joint Favorable)",12,5,0,0,17
1946559,1565804,2025-05-05,Joint,"APP Vote Tally Sheet (Joint Favorable)",38,12,0,3,53
1946680,1519817,2025-03-18,Joint,"ET Vote Tally Sheet (Joint Favorable Substitute)",17,6,0,2,25
1946701,1508416,2025-03-06,Joint,"LAB Vote Tally Sheet (Joint Favorable)",9,4,0,0,13
1946748,1509022,2025-03-06,Joint,"KID Vote Tally Sheet (Joint Favorable Substitute)",13,4,0,0,17
1946748,1571742,2025-05-14,House,"House Roll Call Vote 110 AS AMENDED ",110,37,0,4,151
1946890,1492296,2025-02-18,Joint,"KID Vote Tally Sheet (Joint Favorable Change of Reference)",13,4,0,0,17
1946912,1508381,2025-03-06,Joint,"LAB Vote Tally Sheet (Joint Favorable)",9,4,0,0,13
1946912,1564447,2025-05-01,Senate,"Senate Roll Call Vote 114 ",25,11,0,0,36
1946912,1564448,2025-05-01,Senate,"Senate Roll Call Vote 113 ",10,17,0,0,27
1946912,1580657,2025-05-28,House,"House Roll Call Vote 199 ",102,38,0,11,151
1947009,1517192,2025-03-13,Joint,"LAB Vote Tally Sheet (Joint Favorable)",12,1,0,0,13
1947009,1566549,2025-05-05,Joint,"APP Vote Tally Sheet (Joint Favorable)",38,12,0,3,53
1947031,1508364,2025-03-06,Joint,"LAB Vote Tally Sheet (Joint Favorable)",13,0,0,0,13
1947031,1566606,2025-05-05,Joint,"APP Vote Tally Sheet (Joint Favorable)",38,12,0,3,53
1947076,1479026,2025-02-03,Joint,"GL Vote Tally Sheet (Change of Reference)",0,0,0,0,0
1947076,1486857,2025-02-11,Joint,"LAB Vote Tally Sheet (Reserved for Subject Matter Public Hearing)",13,0,0,0,13
1947149,1509040,2025-03-06,Joint,"KID Vote Tally Sheet (Joint Favorable Substitute)",13,4,0,0,17
1947193,1508398,2025-03-06,Joint,"LAB Vote Tally Sheet (Joint Favorable)",9,4,0,0,13
1947193,1566658,2025-05-05,Joint,"APP Vote Tally Sheet (Joint Favorable)",38,12,0,3,53
1947193,1571789,2025-05-14,Senate,"Senate Roll Call Vote 169 ",24,12,0,0,36
1947193,1571790,2025-05-14,Senate,"Senate Roll Call Vote 168 ",11,25,0,0,36
1947219,1499700,2025-02-25,Joint,"KID Vote Tally Sheet (Joint Favorable Substitute)",17,0,0,0,17
1947219,1561954,2025-04-30,Senate,"Senate Roll Call Vote 98 ",36,0,0,0,36
1947219,1561955,2025-04-30,Senate,"Senate Roll Call Vote 97 ",11,25,0,0,36
1947219,1585172,2025-06-03,House,"House Roll Call Vote 303 ",145,0,0,6,151
1947291,1507672,2025-03-06,Joint,"LAB Vote Tally Sheet (Joint Favorable)",13,0,0,0,13
1947313,1499589,2025-02-25,Joint,"KID Vote Tally Sheet (Joint Favorable Substitute)",17,0,0,0,17
1947313,1566608,2025-05-05,Joint,"APP Vote Tally Sheet (Joint Favorable)",42,8,0,3,53
1947335,1479546,2025-02-04,Joint,"GOS Vote Tally Sheet (Vote to Draft)",0,0,0,0,0
1947335,1520230,2025-03-18,Joint,"GOS Vote Tally Sheet (Joint Favorable Substitute)",8,4,0,0,12
1947362,1492879,2025-02-18,Joint,"KID Vote Tally Sheet (Joint Favorable)",17,0,0,0,17
1947362,1541521,2025-04-09,Senate,"Senate Roll Call Vote 74 ",35,0,1,0,36
1947362,1582761,2025-05-31,House,"House Roll Call Vote 267 ",143,0,0,8,151
1947382,1492723,2025-02-18,Joint,"KID Vote Tally Sheet (Joint Favorable)",14,3,0,0,17
1947382,1565571,2025-05-05,Joint,"APP Vote Tally Sheet (Joint Favorable)",38,12,0,3,53
1949174,1502662,2025-02-28,Joint,"GAE Vote Tally Sheet (Joint Favorable)",15,4,0,0,19
1949174,1558675,2025-04-25,Joint,"JUD Vote Tally Sheet (Joint Favorable)",35,2,0,4,41
1949196,1502885,2025-02-28,Joint,"GAE Vote Tally Sheet (Joint Favorable)",14,5,0,0,19
1949219,1502904,2025-02-28,Joint,"GAE Vote Tally Sheet (Joint Favorable)",14,5,0,0,19
1949219,1540522,2025-04-07,Joint,"PD Vote Tally Sheet (Joint Favorable)",17,3,0,2,22
1949243,1521565,2025-03-19,Joint,"GAE Vote Tally Sheet (Joint Favorable Substitute)",13,6,0,0,19
1949267,1502883,2025-02-28,Joint,"GAE Vote Tally Sheet (Joint Favorable)",18,1,0,0,19
1949267,1580859,2025-05-28,Senate,"Senate Roll Call Vote 256 ",35,1,0,0,36
1949267,1580860,2025-05-28,Senate,"Senate Roll Call Vote 255 ",12,24,0,0,36
1949289,1502755,2025-02-28,Joint,"GAE Vote Tally Sheet (Joint Favorable)",13,6,0,0,19
1949312,1502694,2025-02-28,Joint,"GAE Vote Tally Sheet (Joint Favorable)",19,0,0,0,19
1949312,1571345,2025-05-13,House,"House Roll Call Vote 94 ",147,0,0,4,151
1949312,1585442,2025-06-04,Senate,"Senate Roll Call Vote 423 ",36,0,0,0,36
1949339,1502525,2025-02-28,Joint,"GAE Vote Tally Sheet (Joint Favorable Substitute)",19,0,0,0,19
1949339,1566514,2025-05-05,Joint,"APP Vote Tally Sheet (Joint Favorable)",42,8,0,3,53
1949361,1502822,2025-02-28,Joint,"GAE Vote Tally Sheet (Joint Favorable)",13,6,0,0,19
1949385,1502522,2025-02-28,Joint,"GAE Vote Tally Sheet (Joint Favorable)",19,0,0,0,19
1949385,1561510,2025-04-28,House,"House Roll Call Vote 51 AS AMENDED ",145,0,0,6,151
1949385,1568344,2025-05-08,Senate,"Senate Roll Call Vote 134 ",35,0,1,0,36
1949407,1502549,2025-02-28,Joint,"GAE Vote Tally Sheet (Joint Favorable Substitute)",14,5,0,0,19
1949432,1502876,2025-02-28,Joint,"GAE Vote Tally Sheet (Joint Favorable Substitute)",13,5,1,0,19
1949432,1569486,2025-05-12,Joint,"APP Vote Tally Sheet (Joint Favorable)",36,12,0,5,53
1949455,1502773,2025-02-28,Joint,"GAE Vote Tally Sheet (Joint Favorable)",13,6,0,0,19
1949476,1502676,2025-02-28,Joint,"GAE Vote Tally Sheet (Joint Favorable)",19,0,0,0,19
1949501,1502497,2025-02-28,Joint,"GAE Vote Tally Sheet (Joint Favorable)",13,6,0,0,19
1949525,1502586,2025-02-28,Joint,"GAE Vote Tally Sheet (Joint Favorable Substitute)",19,0,0,0,19
1949525,1502587,2025-02-28,Joint,"GAE Vote Tally Sheet-A",0,0,0,0,0
1949525,1565705,2025-05-05,Joint,"APP Vote Tally Sheet (Joint Favorable)",38,12,0,3,53
1949525,1582010,2025-05-30,Senate,"Senate Roll Call Vote 291 ",36,0,0,0,36
1949548,1502815,2025-02-28,Joint,"GAE Vote Tally Sheet (Joint Favorable)",14,5,0,0,19
1949548,1568280,2025-05-08,Senate,"Senate Roll Call Vote 136 ",8,17,0,0,25
1949548,1568281,2025-05-08,Senate,"Senate Roll Call Vote 135 ",31,5,0,0,36
1949548,1568784,2025-05-08,Senate,"Senate Roll Call Vote 137 ",35,1,0,0,36
1949548,1574203,2025-05-15,House,"House Roll Call Vote 129 AS AMENDED ",106,38,0,7,151
1949548,1574204,2025-05-15,House,"House Roll Call Vote 128 HOUSE AMD E",46,98,0,7,151
1949548,1574205,2025-05-15,House,"House Roll Call Vote 127 HOUSE AMD D",46,97,0,8,151
1949548,1574206,2025-05-15,House,"House Roll Call Vote 126 HOUSE AMD C",46,98,0,7,151
1949548,1574207,2025-05-15,House,"House Roll Call Vote 125 HOUSE AMD B",47,97,0,7,151
1949548,1574208,2025-05-15,House,"House Roll Call Vote 124 HOUSE AMD A",48,97,0,6,151
1949570,1502896,2025-02-28,Joint,"GAE Vote Tally Sheet (Joint Favorable)",19,0,0,0,19
1949570,1585766,2025-06-04,Senate,"Senate Roll Call Vote 403 ",36,0,0,0,36
1949588,1502617,2025-02-28,Joint,"GAE Vote Tally Sheet (Joint Favorable)",14,5,0,0,19
1950432,1478148,2025-01-30,Joint,"EXN Vote Tally Sheet (Joint Favorable)",20,0,0,1,21
1950432,1549063,2025-04-15,Senate,"Senate Roll Call Vote 82 ",31,0,5,0,36
1950633,1478154,2025-01-30,Joint,"EXN Vote Tally Sheet (House)",11,0,0,0,11
1950842,1478158,2025-01-30,Joint,"EXN Vote Tally Sheet (Joint Favorable)",20,0,0,1,21
1950842,1506981,2025-03-05,Senate,"Senate Roll Call Vote 48 ",35,0,1,0,36
1951779,1490554,2025-02-14,Joint,"JUD Vote Tally Sheet (Senate)",9,1,0,2,12
1952406,1520254,2025-03-18,Joint,"PS Vote Tally Sheet (Joint Favorable)",29,0,0,0,29
1952406,1558695,2025-04-25,Joint,"JUD Vote Tally Sheet (Joint Favorable)",29,7,1,4,41
1952555,1519752,2025-03-18,Joint,"PS Vote Tally Sheet (Joint Favorable Substitute)",29,0,0,0,29
1952555,1570849,2025-05-13,House,"House Roll Call Vote 102 ",146,0,0,5,151
1952702,1490061,2025-02-14,Joint,"JUD Vote Tally Sheet (Joint Favorable)",20,3,0,6,29
1952846,1520702,2025-03-18,Joint,"PS Vote Tally Sheet (Joint Favorable)",29,0,0,0,29
1955041,1524066,2025-03-19,Joint,"TRA Vote Tally Sheet (Joint Favorable Substitute)",30,4,0,1,35
1955065,1524900,2025-03-24,Joint,"GL Vote Tally Sheet (Joint Favorable Substitute)",22,0,0,0,22
1955065,1558686,2025-04-25,Joint,"JUD Vote Tally Sheet (Joint Favorable Substitute)",37,0,0,4,41
1955065,1558687,2025-04-25,Joint,"JUD Vote Tally Sheet-A (Joint Favorable)",0,0,0,0,0
1955065,1576690,2025-05-23,Senate,"Senate Roll Call Vote 236 ",36,0,0,0,36
1955065,1584516,2025-06-03,House,"House Roll Call Vote 300 AS AMENDED ",146,0,0,5,151
1955095,1520720,2025-03-18,Joint,"PS Vote Tally Sheet (Joint Favorable Change of Reference)",29,0,0,0,29
1955125,1519068,2025-03-12,Joint,"TRA Vote Tally Sheet (Joint Favorable Substitute)",35,0,0,0,35
1955125,1558696,2025-04-25,Joint,"JUD Vote Tally Sheet (Joint Favorable)",37,0,0,4,41
1955154,1516045,2025-03-12,Joint,"GL Vote Tally Sheet (Joint Favorable Substitute)",22,0,0,0,22
1955154,1571364,2025-05-14,House,"House Roll Call Vote 108 AS AMENDED ",121,26,0,4,151
1955186,1520229,2025-03-18,Joint,"PS Vote Tally Sheet (Joint Favorable)",29,0,0,0,29
1955213,1515976,2025-03-12,Joint,"GL Vote Tally Sheet (Joint Favorable)",22,0,0,0,22
1955213,1549163,2025-04-15,Senate,"Senate Roll Call Vote 89 ",31,0,5,0,36
1955213,1580973,2025-05-28,House,"House Roll Call Vote 215 ",147,0,0,4,151
1955246,1520611,2025-03-18,Joint,"PS Vote Tally Sheet (Joint Favorable Substitute)",29,0,0,0,29
1955246,1565611,2025-05-05,Joint,"APP Vote Tally Sheet (Joint Favorable)",44,6,0,3,53
1955246,1572047,2025-05-15,Senate,"Senate Roll Call Vote 181 ",36,0,0,0,36
1955246,1582901,2025-05-31,House,"House Roll Call Vote 266 ",144,0,0,7,151
1955276,1524792,2025-03-24,Joint,"GL Vote Tally Sheet (Joint Favorable)",18,4,0,0,22
1955313,1519925,2025-03-18,Joint,"PS Vote Tally Sheet (Joint Favorable)",29,0,0,0,29
1955313,1572180,2025-05-15,Senate,"Senate Roll Call Vote 180 ",36,0,0,0,36
1955340,1516007,2025-03-12,Joint,"GL Vote Tally Sheet (Joint Favorable Substitute)",15,7,0,0,22
1955369,1519052,2025-03-12,Joint,"TRA Vote Tally Sheet (Joint Favorable Substitute)",35,0,0,0,35
1955401,1525130,2025-03-24,Joint,"GL Vote Tally Sheet (Joint Favorable Substitute)",22,0,0,0,22
1955401,1580603,2025-05-28,House,"House Roll Call Vote 218 AS AMENDED ",146,0,0,5,151
1955401,1582178,2025-05-30,Senate,"Senate Roll Call Vote 310 ",36,0,0,0,36
1955428,1523982,2025-03-19,Joint,"TRA Vote Tally Sheet (Joint Favorable Substitute)",34,0,0,1,35
1955459,1525815,2025-03-24,Joint,"GL Vote Tally Sheet (Joint Favorable Substitute)",22,0,0,0,22
1955459,1525816,2025-03-24,Joint,"GL Vote Tally Sheet-A",0,0,0,0,0
1955459,1583617,2025-06-02,House,"House Roll Call Vote 280 AS AMENDED ",146,0,0,5,151
1955459,1584529,2025-06-04,Senate,"Senate Roll Call Vote 366 ",36,0,0,0,36
1955489,1517092,2025-03-12,Joint,"GL Vote Tally Sheet (Joint Favorable Substitute)",14,8,0,0,22
1955519,1520616,2025-03-18,Joint,"PS Vote Tally Sheet (Joint Favorable Substitute)",29,0,0,0,29
1955519,1566325,2025-05-05,Joint,"APP Vote Tally Sheet (Joint Favorable)",40,10,0,3,53
1955519,1583695,2025-06-02,House,"House Roll Call Vote 282 AS AMENDED ",148,0,0,3,151
1955519,1584863,2025-06-04,Senate,"Senate Roll Call Vote 396 ",36,0,0,0,36
1955519,1585694,2025-06-04,House,"House Roll Call Vote 375 AS AMENDED ",149,0,0,2,151
1955549,1525457,2025-03-24,Joint,"GL Vote Tally Sheet (Joint Favorable Substitute)",22,0,0,0,22
1957508,1492688,2025-02-18,Joint,"KID Vote Tally Sheet (Joint Favorable Change of Reference)",17,0,0,0,17
1957508,1505919,2025-03-05,Joint,"PH Vote Tally Sheet (Joint Favorable)",24,8,0,0,32
1957508,1566115,2025-05-05,Joint,"APP Vote Tally Sheet (Joint Favorable)",38,12,0,3,53
1957516,1513118,2025-03-11,Joint,"BA Vote Tally Sheet (Joint Favorable Substitute)",13,0,0,0,13
1957516,1576670,2025-05-23,Senate,"Senate Roll Call Vote 237 ",36,0,0,0,36
1957516,1584523,2025-06-03,House,"House Roll Call Vote 334 ",147,0,0,4,151
1957523,1508590,2025-03-06,Joint,"LAB Vote Tally Sheet (Joint Favorable)",9,4,0,0,13
1957549,1530764,2025-03-28,Joint,"ED Vote Tally Sheet (Joint Favorable Substitute Change of Reference)",28,15,0,2,45
1957549,1557976,2025-04-24,Joint,"APP Vote Tally Sheet (Joint Favorable Substitute)",39,14,0,1,54
1957558,1508882,2025-03-06,Joint,"HSG Vote Tally Sheet (Joint Favorable Substitute Change of Reference)",16,2,0,2,20
1957568,1519638,2025-03-18,Joint,"CE Vote Tally Sheet (Joint Favorable)",19,1,0,0,20
1957574,1507456,2025-03-06,Joint,"BA Vote Tally Sheet (Joint Favorable)",12,0,0,1,13
1957574,1561752,2025-04-30,Senate,"Senate Roll Call Vote 93 ",34,0,2,0,36
1957574,1584461,2025-06-03,House,"House Roll Call Vote 329 ",148,0,0,3,151
1957584,1558120,2025-04-24,Joint,"APP Vote Tally Sheet (Joint Favorable Substitute)",40,14,0,0,54
1957584,1585260,2025-06-04,House,"House Roll Call Vote 378 AS AMENDED ",149,0,0,2,151
1957591,1523349,2025-03-20,Joint,"LAB Vote Tally Sheet (Joint Favorable)",9,4,0,0,13
1957601,1523975,2025-03-20,Joint,"LAB Vote Tally Sheet (Joint Favorable Substitute)",9,4,0,0,13
1957609,1524118,2025-03-21,Joint,"PH Vote Tally Sheet (Joint Favorable)",24,8,0,0,32
1957609,1524119,2025-03-21,Joint,"PH Vote Tally Sheet-A (Deletes Lines 110-112)",9,20,0,3,32
1957609,1565809,2025-05-05,Joint,"APP Vote Tally Sheet (Joint Favorable)",38,12,0,3,53
1957618,1508866,2025-03-06,Joint,"HSG Vote Tally Sheet (Joint Favorable)",12,6,0,2,20
1957618,1508867,2025-03-06,Joint,"HSG Vote Tally Sheet-A (MOTION FAILED)",5,12,0,3,20
1957628,1509019,2025-03-06,Joint,"KID Vote Tally Sheet (Joint Favorable Substitute)",12,5,0,0,17
1957637,1537561,2025-04-04,Joint,"JUD Vote Tally Sheet (Joint Favorable Substitute)",38,2,1,0,41
1957637,1584524,2025-06-03,House,"House Roll Call Vote 308 HOUSE AMD A",102,46,0,3,151
1957637,1585335,2025-06-04,House,"House Roll Call Vote 376 AS AMENDED ",150,0,0,1,151
1957645,1507334,2025-03-06,Joint,"BA Vote Tally Sheet (Joint Favorable)",12,0,0,1,13
1957645,1569742,2025-05-12,Joint,"JUD Vote Tally Sheet (Joint Favorable)",40,0,0,1,41
1957645,1574746,2025-05-20,Senate,"Senate Roll Call Vote 203 ",35,0,1,0,36
1957645,1584474,2025-06-03,House,"House Roll Call Vote 333 AS AMENDED ",148,0,0,3,151
1957674,1508415,2025-03-06,Joint,"BA Vote Tally Sheet (Joint Favorable)",12,0,0,1,13
1957674,1583645,2025-06-02,House,"House Roll Call Vote 279 ",147,0,0,4,151
1957674,1584495,2025-06-04,Senate,"Senate Roll Call Vote 372 ",36,0,0,0,36
1957688,1490632,2025-02-14,Joint,"JUD Vote Tally Sheet (Joint Favorable Substitute)",36,0,0,5,41
1957707,1517725,2025-03-13,Joint,"CE Vote Tally Sheet (Joint Favorable)",18,2,0,0,20
1957715,1499574,2025-02-25,Joint,"INS Vote Tally Sheet (Joint Favorable)",13,0,0,0,13
1957724,1513471,2025-03-11,Joint,"INS Vote Tally Sheet (Joint Favorable Substitute)",12,1,0,0,13
1957734,1508703,2025-03-06,Joint,"HSG Vote Tally Sheet (Joint Favorable Substitute)",18,0,0,2,20
1957734,1566284,2025-05-05,Joint,"APP Vote Tally Sheet (Joint Favorable)",42,8,0,3,53
1957742,1519026,2025-03-13,Joint,"HED Vote Tally Sheet (Joint Favorable Substitute)",13,5,0,0,18
1957742,1566650,2025-05-05,Joint,"APP Vote Tally Sheet (Joint Favorable)",38,12,0,3,53
1957750,1494994,2025-02-20,Joint,"INS Vote Tally Sheet (Joint Favorable Substitute)",12,1,0,0,13
1957750,1568079,2025-05-07,House,"House Roll Call Vote 73 ",144,1,0,6,151
1957750,1584608,2025-06-04,Senate,"Senate Roll Call Vote 365 ",36,0,0,0,36
1957760,1490370,2025-02-14,Joint,"JUD Vote Tally Sheet (Joint Favorable)",37,0,0,4,41
1957769,1520784,2025-03-18,Joint,"HS Vote Tally Sheet (Joint Favorable Substitute)",16,6,0,1,23
1957769,1520785,2025-03-18,Joint,"HS Vote Tally Sheet-A (MOTION FAILED)",4,12,0,7,23
1957769,1566236,2025-05-06,Joint,"JUD Vote Tally Sheet (Joint Favorable)",29,10,0,2,41
1957769,1569479,2025-05-12,Joint,"APP Vote Tally Sheet (Joint Favorable)",38,11,0,4,53
1957778,1492970,2025-02-18,Joint,"VA Vote Tally Sheet (Joint Favorable Substitute)",20,0,0,0,20
1957778,1492971,2025-02-18,Joint,"VA Vote Tally Sheet-A",6,11,0,3,20
1957778,1566390,2025-05-05,Joint,"APP Vote Tally Sheet (Joint Favorable)",44,6,0,3,53
1957778,1569407,2025-05-12,Joint,"FIN Vote Tally Sheet (Joint Favorable)",54,0,0,0,54
1957778,1582011,2025-05-30,Senate,"Senate Roll Call Vote 287 ",36,0,0,0,36
1957786,1492494,2025-02-18,Joint,"VA Vote Tally Sheet (Joint Favorable)",20,0,0,0,20
1957796,1490327,2025-02-14,Joint,"JUD Vote Tally Sheet (Joint Favorable Substitute)",36,0,0,5,41
1957804,1508628,2025-03-06,Joint,"HSG Vote Tally Sheet (Joint Favorable Substitute)",18,0,0,2,20
1957824,1490590,2025-02-14,Joint,"JUD Vote Tally Sheet (Joint Favorable)",35,0,2,4,41
1957832,1496086,2025-02-20,Joint,"HSG Vote Tally Sheet (Joint Favorable)",18,0,0,2,20
1957840,1490194,2025-02-14,Joint,"JUD Vote Tally Sheet (Joint Favorable Substitute)",36,0,0,5,41
1957852,1508861,2025-03-06,Joint,"HSG Vote Tally Sheet (Joint Favorable)",14,4,0,2,20
1957859,1506128,2025-02-27,Joint,"HED Vote Tally Sheet (Joint Favorable Substitute Change of Reference)",18,0,0,0,18
1957859,1557826,2025-04-24,Joint,"FIN Vote Tally Sheet (Joint Favorable)",52,0,0,0,52
1957867,1499369,2025-02-25,Joint,"KID Vote Tally Sheet (Joint Favorable)",12,5,0,0,17
1957876,1524225,2025-03-21,Joint,"GL Vote Tally Sheet (Joint Favorable)",20,1,0,1,22
1957883,1490516,2025-02-14,Joint,"JUD Vote Tally Sheet (Joint Favorable)",37,0,0,4,41
1957893,1520206,2025-03-18,Joint,"PS Vote Tally Sheet (Joint Favorable)",22,7,0,0,29
1957893,1568850,2025-05-08,House,"House Roll Call Vote 78 AS AMENDED ",97,45,0,9,151
1957904,1495970,2025-02-20,Joint,"HSG Vote Tally Sheet (Joint Favorable)",18,0,0,2,20
1957911,1495637,2025-02-20,Joint,"HSG Vote Tally Sheet (Joint Favorable)",18,0,0,2,20
1957911,1570928,2025-05-13,House,"House Roll Call Vote 95 AS AMENDED ",147,0,0,4,151
1957911,1582166,2025-05-30,Senate,"Senate Roll Call Vote 305 ",36,0,0,0,36
1957921,1490213,2025-02-14,Joint,"JUD Vote Tally Sheet (Joint Favorable Substitute)",36,0,0,5,41
1957928,1490196,2025-02-14,Joint,"JUD Vote Tally Sheet (Joint Favorable Substitute)",36,0,0,5,41
1957937,1499357,2025-02-25,Joint,"KID Vote Tally Sheet (Joint Favorable)",12,5,0,0,17
1957954,1513448,2025-03-11,Joint,"INS Vote Tally Sheet (Joint Favorable)",11,2,0,0,13
1957965,1507690,2025-03-06,Joint,"BA Vote Tally Sheet (Joint Favorable Substitute)",12,0,0,1,13
1957965,1565404,2025-05-05,Joint,"FIN Vote Tally Sheet (Joint Favorable)",52,0,0,2,54
1957973,1508687,2025-03-06,Joint,"HSG Vote Tally Sheet (Joint Favorable Substitute)",11,8,0,1,20
1957973,1508688,2025-03-06,Joint,"HSG Vote Tally Sheet-A (MOTION FAILED)",4,10,0,6,20
1957973,1508689,2025-03-06,Joint,"HSG Vote Tally Sheet-B",0,0,0,0,0
1957973,1508690,2025-03-06,Joint,"HSG Vote Tally Sheet-C (MOTION FAILED)",4,11,0,5,20
1957973,1508691,2025-03-06,Joint,"HSG Vote Tally Sheet-H",3,14,0,3,20
1957973,1508692,2025-03-06,Joint,"HSG Vote Tally Sheet-I",3,14,0,3,20
1957973,1508693,2025-03-06,Joint,"HSG Vote Tally Sheet-J",3,14,0,3,20
1957973,1508694,2025-03-06,Joint,"HSG Vote Tally Sheet-D (MOTION FAILED)",6,10,0,4,20
1957973,1508695,2025-03-06,Joint,"HSG Vote Tally Sheet-E (MOTION FAILED)",4,10,0,6,20
1957973,1508696,2025-03-06,Joint,"HSG Vote Tally Sheet-F (MOTION FAILED)",5,12,0,3,20
1957973,1508697,2025-03-06,Joint,"HSG Vote Tally Sheet-G (MOTION FAILED)",4,14,0,2,20
1957973,1508698,2025-03-06,Joint,"HSG Vote Tally Sheet-K (MOTION FAILED)",3,13,0,4,20
1957973,1508699,2025-03-06,Joint,"HSG Vote Tally Sheet-L (MOTION FAILED)",3,13,0,4,20
1957973,1508700,2025-03-06,Joint,"HSG Vote Tally Sheet-M (MOTION FAILED)",3,12,0,5,20
1957973,1508701,2025-03-06,Joint,"HSG Vote Tally Sheet-N (MOTION FAILED)",4,13,0,3,20
1957980,1507951,2025-03-06,Joint,"LAB Vote Tally Sheet (Joint Favorable)",9,4,0,0,13
1957995,1513431,2025-03-11,Joint,"VA Vote Tally Sheet (Joint Favorable Substitute)",14,6,0,1,21
1958002,1508663,2025-03-06,Joint,"HSG Vote Tally Sheet (Joint Favorable)",12,6,0,2,20
1958002,1508664,2025-03-06,Joint,"HSG Vote Tally Sheet-A (MOTION FAILED)",6,12,0,2,20
1958009,1492307,2025-02-18,Joint,"KID Vote Tally Sheet (Joint Favorable Change of Reference)",17,0,0,0,17
1958009,1526008,2025-03-24,Joint,"ED Vote Tally Sheet (Joint Favorable Change of Reference)",31,14,0,0,45
1958009,1557958,2025-04-24,Joint,"APP Vote Tally Sheet (Joint Favorable)",43,11,0,0,54
1958019,1513316,2025-03-11,Joint,"INS Vote Tally Sheet (Joint Favorable Substitute)",7,6,0,0,13
1958019,1565984,2025-05-05,Joint,"APP Vote Tally Sheet (Joint Favorable)",33,17,0,3,53
1958028,1505824,2025-02-27,Joint,"HED Vote Tally Sheet (Joint Favorable)",15,3,0,0,18
1958028,1541931,2025-04-09,Senate,"Senate Roll Call Vote 76 ",35,0,1,0,36
1958036,1516911,2025-03-13,Joint,"CE Vote Tally Sheet (Joint Favorable)",19,1,0,0,20
1958045,1507993,2025-03-06,Joint,"LAB Vote Tally Sheet (Joint Favorable)",9,4,0,0,13
1958045,1565861,2025-05-05,Joint,"APP Vote Tally Sheet (Joint Favorable)",38,12,0,3,53
1958045,1567355,2025-05-07,House,"House Roll Call Vote 72 AS AMENDED ",97,48,0,6,151
1958045,1567356,2025-05-07,House,"House Roll Call Vote 71 HOUSE AMD D",47,101,0,3,151
1958045,1567357,2025-05-07,House,"House Roll Call Vote 70 HOUSE AMD C",47,99,0,5,151
1958045,1567358,2025-05-07,House,"House Roll Call Vote 69 HOUSE AMD B",48,97,0,6,151
1958055,1492507,2025-02-18,Joint,"VA Vote Tally Sheet (Joint Favorable)",20,0,0,0,20
1958064,1516268,2025-03-12,Joint,"GL Vote Tally Sheet (Joint Favorable)",15,7,0,0,22
1958072,1499579,2025-02-25,Joint,"INS Vote Tally Sheet (Joint Favorable)",13,0,0,0,13
1958072,1582032,2025-05-30,Senate,"Senate Roll Call Vote 289 ",36,0,0,0,36
1958072,1585158,2025-06-03,House,"House Roll Call Vote 335 ",147,0,0,4,151
1958081,1499085,2025-02-25,Joint,"KID Vote Tally Sheet (Joint Favorable)",12,5,0,0,17
1958099,1513477,2025-03-11,Joint,"HED Vote Tally Sheet (Joint Favorable Substitute)",18,0,0,0,18
1958099,1540065,2025-04-08,Joint,"ED Vote Tally Sheet (Joint Favorable)",44,0,0,1,45
1958108,1498659,2025-02-25,Joint,"GOS Vote Tally Sheet (Joint Favorable Substitute)",9,0,0,3,12
1958108,1570931,2025-05-13,House,"House Roll Call Vote 105 AS AMENDED ",145,0,0,6,151
1958108,1583342,2025-06-02,Senate,"Senate Roll Call Vote 325 ",35,0,1,0,36
1958117,1506108,2025-02-27,Joint,"HED Vote Tally Sheet (Joint Favorable Substitute)",15,3,0,0,18
1958117,1575266,2025-05-20,Senate,"Senate Roll Call Vote 194 ",35,0,1,0,36
1958117,1575267,2025-05-20,Senate,"Senate Roll Call Vote 193 ",35,0,1,0,36
1958117,1584509,2025-06-03,House,"House Roll Call Vote 327 AS AMENDED ",148,0,0,3,151
1958123,1517940,2025-03-14,Joint,"ENV Vote Tally Sheet (Joint Favorable)",27,5,0,2,34
1958123,1574777,2025-05-20,House,"House Roll Call Vote 151 AS AMENDED ",144,3,0,4,151
1958123,1584531,2025-06-04,Senate,"Senate Roll Call Vote 367 ",36,0,0,0,36
1958132,1506460,2025-02-27,Joint,"HED Vote Tally Sheet (Joint Favorable Substitute)",18,0,0,0,18
1958132,1566492,2025-05-05,Joint,"APP Vote Tally Sheet (Joint Favorable)",38,12,0,3,53
1958132,1581031,2025-05-28,House,"House Roll Call Vote 211 AS AMENDED ",147,0,0,4,151
1958132,1583333,2025-06-02,Senate,"Senate Roll Call Vote 327 ",36,0,0,0,36
1958142,1507264,2025-03-06,Joint,"BA Vote Tally Sheet (Joint Favorable)",12,0,0,1,13
1958142,1561504,2025-04-28,House,"House Roll Call Vote 49 ",145,0,0,6,151
1958142,1574963,2025-05-20,Senate,"Senate Roll Call Vote 204 ",35,0,1,0,36
1958153,1556770,2025-04-24,Joint,"FIN Vote Tally Sheet (Joint Favorable Substitute)",50,2,0,0,52
1958160,1492102,2025-02-18,Joint,"KID Vote Tally Sheet (Joint Favorable)",14,3,0,0,17
1958160,1583590,2025-06-02,House,"House Roll Call Vote 276 ",147,0,0,4,151
1958168,1514116,2025-03-11,Joint,"INS Vote Tally Sheet (Joint Favorable)",12,1,0,0,13
1958168,1558683,2025-04-25,Joint,"JUD Vote Tally Sheet (Joint Favorable)",37,0,0,4,41
1958168,1565838,2025-05-06,Joint,"APP Vote Tally Sheet (Joint Favorable)",41,9,0,3,53
1958177,1495965,2025-02-20,Joint,"HSG Vote Tally Sheet (Joint Favorable Substitute)",18,0,0,2,20
1958177,1575735,2025-05-21,Senate,"Senate Roll Call Vote 206 ",36,0,0,0,36
1958177,1585746,2025-06-04,House,"House Roll Call Vote 346 ",146,0,0,5,151
1958187,1555175,2025-04-22,Joint,"APP Vote Tally Sheet (Joint Favorable)",43,10,0,1,54
1958187,1573179,2025-05-19,Senate,"Senate Roll Call Vote 186 ",10,24,2,0,36
1958187,1578026,2025-05-19,House,"House Roll Call Vote 131 AS AMENDED ",98,46,0,7,151
1958187,1578027,2025-05-19,Senate,"Senate Roll Call Vote 187 ",24,10,2,0,36
1958197,1506674,2025-02-27,Joint,"HED Vote Tally Sheet (Joint Favorable Substitute)",18,0,0,0,18
1958197,1572319,2025-05-14,Senate,"Senate Roll Call Vote 167 ",36,0,0,0,36
1958197,1585148,2025-06-03,House,"House Roll Call Vote 328 ",148,0,0,3,151
1958205,1518616,2025-03-13,Joint,"HED Vote Tally Sheet (Joint Favorable Substitute)",15,3,0,0,18
1958214,1513812,2025-03-11,Joint,"INS Vote Tally Sheet (Joint Favorable Substitute)",12,1,0,0,13
1958222,1530754,2025-03-28,Joint,"ED Vote Tally Sheet (Joint Favorable Substitute Change of Reference)",32,11,0,2,45
1958222,1558052,2025-04-24,Joint,"APP Vote Tally Sheet (Joint Favorable)",45,9,0,0,54
1958231,1523122,2025-03-20,Joint,"LAB Vote Tally Sheet (Joint Favorable)",9,4,0,0,13
1958231,1582354,2025-05-30,Senate,"Senate Roll Call Vote 295 ",35,0,1,0,36
1958247,1523294,2025-03-20,Joint,"LAB Vote Tally Sheet (Joint Favorable)",9,4,0,0,13
1958256,1499402,2025-02-25,Joint,"GOS Vote Tally Sheet (Joint Favorable)",9,0,0,3,12
1958256,1582939,2025-05-31,House,"House Roll Call Vote 268 ",144,0,0,7,151
1958263,1530760,2025-03-28,Joint,"ED Vote Tally Sheet (Joint Favorable)",29,14,0,2,45
1958263,1530840,2025-03-31,Joint,"ED Vote Tally Sheet (Joint Favorable Change of Reference)",29,14,0,2,45
1958263,1557963,2025-04-24,Joint,"APP Vote Tally Sheet (Joint Favorable)",40,14,0,0,54
1958271,1507400,2025-03-06,Joint,"BA Vote Tally Sheet (Joint Favorable)",12,0,0,1,13
1958271,1558677,2025-04-25,Joint,"JUD Vote Tally Sheet (Joint Favorable)",37,0,0,4,41
1958282,1554958,2025-04-22,Joint,"APP Vote Tally Sheet (Joint Favorable Substitute)",40,13,0,1,54
1958282,1554959,2025-04-22,Joint,"APP Vote Tally Sheet-A (MOTION FAILED)",11,41,0,2,54
1958282,1554960,2025-04-22,Joint,"APP Vote Tally Sheet-B",45,6,0,3,54
1958289,1499423,2025-02-25,Joint,"KID Vote Tally Sheet (Joint Favorable)",12,5,0,0,17
1958297,1556598,2025-04-24,Joint,"FIN Vote Tally Sheet (Joint Favorable Substitute)",33,19,0,0,52
1958297,1556599,2025-04-24,Joint,"FIN Vote Tally Sheet-A",27,21,0,4,52
1958303,1517596,2025-03-13,Joint,"CE Vote Tally Sheet (Joint Favorable)",19,1,0,0,20
1958303,1576897,2025-05-22,Senate,"Senate Roll Call Vote 222 ",36,0,0,0,36
1958303,1582777,2025-05-31,House,"House Roll Call Vote 263 AS AMENDED ",144,0,0,7,151
1961646,1483904,2025-02-06,Joint,"EXN Vote Tally Sheet (Joint Favorable)",19,0,0,2,21
1961646,1506133,2025-03-05,Senate,"Senate Roll Call Vote 49 ",35,0,1,0,36
1961831,1483907,2025-02-06,Joint,"EXN Vote Tally Sheet (Joint Favorable)",19,0,0,2,21
1961831,1506871,2025-03-05,Senate,"Senate Roll Call Vote 50 ",35,0,1,0,36
1961832,1484020,2025-02-06,Joint,"EXN Vote Tally Sheet (Joint Favorable)",20,0,0,1,21
1962839,1539205,2025-04-07,Joint,"JUD Vote Tally Sheet (Joint Favorable)",41,0,0,0,41
1962839,1567582,2025-05-07,Senate,"Senate Roll Call Vote 126 ",36,0,0,0,36
1962839,1585484,2025-06-04,House,"House Roll Call Vote 360 AS AMENDED ",148,0,0,3,151
1962873,1502262,2025-02-28,Joint,"ENV Vote Tally Sheet (Joint Favorable Substitute)",25,10,0,0,35
1962873,1502263,2025-02-28,Joint,"ENV Vote Tally Sheet-A (MOTION FAILED)",11,24,0,0,35
1962907,1503086,2025-02-28,Joint,"ENV Vote Tally Sheet (Joint Favorable)",35,0,0,0,35
1962907,1561967,2025-04-30,Senate,"Senate Roll Call Vote 96 ",36,0,0,0,36
1962907,1570809,2025-05-13,House,"House Roll Call Vote 90 ",148,0,0,3,151
1962974,1504645,2025-03-04,Joint,"AGE Vote Tally Sheet (Joint Favorable Change of Reference)",13,0,0,1,14
1962974,1515235,2025-03-11,Joint,"INS Vote Tally Sheet (Joint Favorable)",13,0,0,0,13
1963009,1505428,2025-03-04,Joint,"AGE Vote Tally Sheet (Joint Favorable Substitute)",12,1,0,1,14
1963043,1505114,2025-03-04,Joint,"AGE Vote Tally Sheet (Joint Favorable)",13,0,0,1,14
1963079,1503132,2025-02-28,Joint,"ENV Vote Tally Sheet (Joint Favorable Substitute Change of Reference)",24,11,0,0,35
1963079,1557999,2025-04-24,Joint,"APP Vote Tally Sheet (Joint Favorable Substitute)",38,15,0,1,54
1963079,1585308,2025-06-04,House,"House Roll Call Vote 340 AS AMENDED ",138,0,0,13,151
1963114,1505217,2025-03-04,Joint,"AGE Vote Tally Sheet (Joint Favorable)",10,3,0,1,14
1963114,1568824,2025-05-08,House,"House Roll Call Vote 82 AS AMENDED ",124,19,0,8,151
1963114,1576161,2025-05-22,Senate,"Senate Roll Call Vote 217 ",26,10,0,0,36
1963114,1576162,2025-05-22,Senate,"Senate Roll Call Vote 216 ",11,25,0,0,36
1963114,1576163,2025-05-22,Senate,"Senate Roll Call Vote 215 ",11,25,0,0,36
1963148,1517917,2025-03-14,Joint,"ENV Vote Tally Sheet (Joint Favorable Substitute)",33,0,0,1,34
1963181,1541262,2025-04-08,Joint,"JUD Vote Tally Sheet (Joint Favorable)",40,1,0,0,41
1963181,1567823,2025-05-07,Senate,"Senate Roll Call Vote 127 ",35,1,0,0,36
1963181,1576672,2025-05-22,House,"House Roll Call Vote 178 HOUSE AMD A",48,100,0,3,151
1963181,1580712,2025-05-28,House,"House Roll Call Vote 203 AS AMENDED ",144,4,0,3,151
1963181,1583312,2025-06-02,Senate,"Senate Roll Call Vote 330 ",34,2,0,0,36
1963216,1503099,2025-02-28,Joint,"ENV Vote Tally Sheet (Joint Favorable)",35,0,0,0,35
1963249,1505506,2025-03-04,Joint,"AGE Vote Tally Sheet (Joint Favorable Substitute)",13,0,0,1,14
1963283,1537405,2025-04-04,Joint,"JUD Vote Tally Sheet (Joint Favorable Substitute)",41,0,0,0,41
1963283,1537406,2025-04-04,Joint,"JUD Vote Tally Sheet-A (Joint Favorable Substitute)",0,0,0,0,0
1963283,1572466,2025-05-15,House,"House Roll Call Vote 121 ",139,0,0,12,151
1963283,1583654,2025-06-02,Senate,"Senate Roll Call Vote 342 ",36,0,0,0,36
1963313,1505449,2025-03-04,Joint,"AGE Vote Tally Sheet (Joint Favorable Substitute)",10,3,0,1,14
1964108,1506494,2025-03-05,Joint,"PH Vote Tally Sheet (Joint Favorable)",28,4,0,0,32
1964226,1505850,2025-03-05,Joint,"PH Vote Tally Sheet (Joint Favorable)",32,0,0,0,32
1964226,1533435,2025-04-01,Joint,"INS Vote Tally Sheet (Joint Favorable)",11,2,0,0,13
1964226,1566533,2025-05-05,Joint,"APP Vote Tally Sheet (Joint Favorable)",43,7,0,3,53
1964346,1524190,2025-03-21,Joint,"PH Vote Tally Sheet (Joint Favorable Substitute)",23,9,0,0,32
1965431,1525523,2025-03-21,Joint,"PD Vote Tally Sheet (Joint Favorable Substitute)",19,0,0,3,22
1965437,1495338,2025-02-20,Joint,"HSG Vote Tally Sheet (Joint Favorable)",18,0,0,2,20
1965437,1568009,2025-05-07,Senate,"Senate Roll Call Vote 119 ",36,0,0,0,36
1965437,1568010,2025-05-07,Senate,"Senate Roll Call Vote 118 ",9,12,0,0,21
1965437,1585151,2025-06-03,House,"House Roll Call Vote 331 ",148,0,0,3,151
1965439,1520284,2025-03-18,Joint,"PS Vote Tally Sheet (Joint Favorable)",29,0,0,0,29
1965445,1520052,2025-03-18,Joint,"PS Vote Tally Sheet (Joint Favorable Substitute)",29,0,0,0,29
1965447,1498609,2025-02-25,Joint,"GOS Vote Tally Sheet (Joint Favorable)",9,0,0,3,12
1965452,1499012,2025-02-25,Joint,"KID Vote Tally Sheet (Joint Favorable)",17,0,0,0,17
1965452,1576733,2025-05-22,Senate,"Senate Roll Call Vote 219 ",36,0,0,0,36
1965452,1576734,2025-05-22,Senate,"Senate Roll Call Vote 218 ",11,25,0,0,36
1965452,1584462,2025-06-03,House,"House Roll Call Vote 320 AS AMENDED ",148,0,0,3,151
1965455,1517242,2025-03-12,Joint,"ED Vote Tally Sheet (Joint Favorable)",40,0,0,5,45
1965455,1562265,2025-04-30,Senate,"Senate Roll Call Vote 104 ",36,0,0,0,36
1965455,1570884,2025-05-13,House,"House Roll Call Vote 89 ",148,0,0,3,151
1965462,1517143,2025-03-13,Joint,"LAB Vote Tally Sheet (Joint Favorable)",9,4,0,0,13
1965472,1513406,2025-03-07,Joint,"PD Vote Tally Sheet (Joint Favorable Substitute)",20,0,0,2,22
1965472,1585350,2025-06-04,Senate,"Senate Roll Call Vote 398 ",36,0,0,0,36
1965479,1517850,2025-03-13,Joint,"LAB Vote Tally Sheet (Joint Favorable Substitute)",9,4,0,0,13
1965480,1506504,2025-03-04,Joint,"HS Vote Tally Sheet (Joint Favorable)",19,3,0,1,23
1965482,1508775,2025-03-06,Joint,"HSG Vote Tally Sheet (Joint Favorable)",12,6,0,2,20
1965490,1520092,2025-03-18,Joint,"PS Vote Tally Sheet (Joint Favorable Substitute)",29,0,0,0,29
1965495,1525773,2025-03-21,Joint,"ED Vote Tally Sheet (Joint Favorable)",33,11,0,1,45
1965500,1519955,2025-03-18,Joint,"ET Vote Tally Sheet (Joint Favorable Substitute)",24,0,0,1,25
1965507,1522251,2025-03-18,Joint,"HS Vote Tally Sheet (Joint Favorable Substitute)",22,0,0,1,23
1965507,1566551,2025-05-05,Joint,"APP Vote Tally Sheet (Joint Favorable Substitute)",42,8,0,3,53
1965507,1582333,2025-05-30,House,"House Roll Call Vote 238 AS AMENDED ",148,0,0,3,151
1965507,1585609,2025-06-04,Senate,"Senate Roll Call Vote 427 ",36,0,0,0,36
1965511,1512488,2025-03-07,Joint,"PD Vote Tally Sheet (Joint Favorable)",12,8,0,2,22
1965517,1537795,2025-04-04,Joint,"JUD Vote Tally Sheet (Joint Favorable Substitute)",41,0,0,0,41
1965517,1537796,2025-04-04,Joint,"JUD Vote Tally Sheet-A (Joint Favorable Substitute)",0,0,0,0,0
1965522,1508713,2025-03-06,Joint,"HSG Vote Tally Sheet (Joint Favorable)",17,1,0,2,20
1965523,1524275,2025-03-21,Joint,"GL Vote Tally Sheet (Joint Favorable)",21,0,0,1,22
1965523,1561505,2025-04-28,House,"House Roll Call Vote 50 AS AMENDED ",114,30,0,7,151
1965523,1585720,2025-06-04,Senate,"Senate Roll Call Vote 400 ",36,0,0,0,36
1965526,1508871,2025-03-06,Joint,"HSG Vote Tally Sheet (Joint Favorable)",11,7,0,2,20
1965532,1519935,2025-03-18,Joint,"PS Vote Tally Sheet (Joint Favorable)",29,0,0,0,29
1965534,1517387,2025-03-12,Joint,"ED Vote Tally Sheet (Joint Favorable)",30,10,0,5,45
1965535,1508870,2025-03-06,Joint,"HSG Vote Tally Sheet (Joint Favorable Substitute)",17,1,0,2,20
1965543,1505702,2025-03-04,Joint,"HS Vote Tally Sheet (Joint Favorable)",23,0,0,0,23
1965552,1530755,2025-03-28,Joint,"ED Vote Tally Sheet (Joint Favorable)",29,14,0,2,45
1965552,1584245,2025-06-03,House,"House Roll Call Vote 302 AS AMENDED ",134,12,0,5,151
1965552,1584999,2025-06-04,Senate,"Senate Roll Call Vote 399 ",36,0,0,0,36
1965552,1585336,2025-06-04,House,"House Roll Call Vote 380 AS AMENDED ",147,0,0,4,151
1965554,1495358,2025-02-20,Joint,"HSG Vote Tally Sheet (Joint Favorable)",18,0,0,2,20
1965562,1495416,2025-02-20,Joint,"HSG Vote Tally Sheet (Joint Favorable)",18,0,0,2,20
1965568,1508859,2025-03-06,Joint,"HSG Vote Tally Sheet (Joint Favorable Substitute)",12,6,0,2,20
1965569,1495328,2025-02-20,Joint,"HSG Vote Tally Sheet (Joint Favorable)",18,0,0,2,20
1965572,1508680,2025-03-06,Joint,"HSG Vote Tally Sheet (Joint Favorable Substitute)",12,6,0,2,20
1965572,1508681,2025-03-06,Joint,"HSG Vote Tally Sheet-A (MOTION FAILED)",6,12,0,2,20
1965572,1557954,2025-04-24,Joint,"APP Vote Tally Sheet (Joint Favorable)",42,12,0,0,54
1965575,1513377,2025-03-07,Joint,"PD Vote Tally Sheet (Joint Favorable)",20,0,0,2,22
1965577,1540708,2025-04-08,Joint,"JUD Vote Tally Sheet (Joint Favorable Substitute)",41,0,0,0,41
1965589,1498625,2025-02-25,Joint,"GOS Vote Tally Sheet (Joint Favorable)",9,0,0,3,12
1965591,1517358,2025-03-13,Joint,"ET Vote Tally Sheet (Joint Favorable)",18,7,0,0,25
1965595,1519867,2025-03-18,Joint,"PS Vote Tally Sheet (Joint Favorable Change of Reference)",25,3,1,0,29
1965595,1556976,2025-04-24,Joint,"FIN Vote Tally Sheet (Joint Favorable)",47,5,0,0,52
1965595,1556977,2025-04-24,Joint,"FIN Vote Tally Sheet-A",16,29,0,7,52
1965596,1546181,2025-04-10,Joint,"JUD Vote Tally Sheet (Joint Favorable Substitute)",39,0,0,2,41
1965596,1570881,2025-05-13,House,"House Roll Call Vote 99 ",147,0,0,4,151
1965596,1580333,2025-05-28,Senate,"Senate Roll Call Vote 261 ",36,0,0,0,36
1965604,1506589,2025-03-04,Joint,"HS Vote Tally Sheet (Joint Favorable)",23,0,0,0,23
1965610,1545309,2025-04-10,Joint,"JUD Vote Tally Sheet (Joint Favorable Substitute)",39,0,0,2,41
1965610,1545310,2025-04-10,Joint,"JUD Vote Tally Sheet-A",0,0,0,0,0
1965610,1570804,2025-05-13,House,"House Roll Call Vote 98 ",144,3,0,4,151
1965610,1585329,2025-06-04,Senate,"Senate Roll Call Vote 424 ",36,0,0,0,36
1965614,1512728,2025-03-07,Joint,"PD Vote Tally Sheet (Joint Favorable)",20,0,0,2,22
1965616,1499154,2025-02-25,Joint,"INS Vote Tally Sheet (Joint Favorable)",11,2,0,0,13
1965620,1508705,2025-03-06,Joint,"HSG Vote Tally Sheet (Joint Favorable)",18,0,0,2,20
1965630,1517468,2025-03-13,Joint,"ET Vote Tally Sheet (Joint Favorable)",18,7,0,0,25
1965634,1516927,2025-03-12,Joint,"GL Vote Tally Sheet (Joint Favorable)",22,0,0,0,22
1965641,1519767,2025-03-18,Joint,"PS Vote Tally Sheet (Joint Favorable Substitute)",29,0,0,0,29
1965641,1548908,2025-04-15,Senate,"Senate Roll Call Vote 90 ",31,0,5,0,36
1965641,1584754,2025-06-03,House,"House Roll Call Vote 330 ",148,0,0,3,151
1965642,1531114,2025-03-28,Joint,"PD Vote Tally Sheet (Joint Favorable Substitute)",21,0,0,1,22
1965645,1509018,2025-03-06,Joint,"KID Vote Tally Sheet (Joint Favorable Change of Reference)",15,2,0,0,17
1965645,1558019,2025-04-24,Joint,"APP Vote Tally Sheet (Joint Favorable Substitute)",52,2,0,0,54
1965645,1583661,2025-06-02,House,"House Roll Call Vote 273 AS AMENDED ",125,23,0,3,151
1965648,1505807,2025-03-04,Joint,"HS Vote Tally Sheet (Joint Favorable)",23,0,0,0,23
1965648,1565948,2025-05-05,Joint,"APP Vote Tally Sheet (Joint Favorable)",38,12,0,3,53
1965651,1513375,2025-03-07,Joint,"PD Vote Tally Sheet (Joint Favorable Substitute)",20,0,0,2,22
1965651,1571794,2025-05-14,Senate,"Senate Roll Call Vote 166 ",29,7,0,0,36
1965651,1576778,2025-05-22,House,"House Roll Call Vote 182 ",125,22,0,4,151
1965652,1495308,2025-02-20,Joint,"HSG Vote Tally Sheet (Joint Favorable)",14,4,0,2,20
1965652,1540509,2025-04-07,Joint,"PD Vote Tally Sheet (Joint Favorable)",13,7,0,2,22
1965660,1508052,2025-03-06,Joint,"LAB Vote Tally Sheet (Joint Favorable)",11,2,0,0,13
1965660,1580352,2025-05-28,Senate,"Senate Roll Call Vote 250 ",25,11,0,0,36
1965660,1580353,2025-05-28,Senate,"Senate Roll Call Vote 249 ",11,25,0,0,36
1965660,1585141,2025-06-03,House,"House Roll Call Vote 296 AS AMENDED ",96,42,0,13,151
1965662,1516851,2025-03-12,Joint,"PD Vote Tally Sheet (Joint Favorable Substitute)",20,0,0,2,22
1965662,1568768,2025-05-08,House,"House Roll Call Vote 81 AS AMENDED ",134,9,0,8,151
1965662,1583299,2025-06-02,Senate,"Senate Roll Call Vote 333 ",36,0,0,0,36
1965671,1520400,2025-03-18,Joint,"ET Vote Tally Sheet (Joint Favorable)",24,0,0,1,25
1965671,1568895,2025-05-08,Senate,"Senate Roll Call Vote 138 ",35,0,1,0,36
1965671,1585534,2025-06-04,House,"House Roll Call Vote 357 ",148,0,0,3,151
1965676,1524224,2025-03-21,Joint,"GL Vote Tally Sheet (Joint Favorable Substitute)",21,0,0,1,22
1965676,1583770,2025-06-03,Senate,"Senate Roll Call Vote 353 ",33,2,1,0,36
1965676,1583771,2025-06-03,Senate,"Senate Roll Call Vote 352 ",33,1,2,0,36
1965676,1584465,2025-06-04,House,"House Roll Call Vote 339 AS AMENDED ",127,15,0,9,151
1965680,1518036,2025-03-13,Joint,"HS Vote Tally Sheet (Joint Favorable)",22,0,0,1,23
1965680,1570192,2025-05-13,Senate,"Senate Roll Call Vote 148 ",35,0,1,0,36
1965688,1508892,2025-03-06,Joint,"HSG Vote Tally Sheet (Joint Favorable Substitute)",12,6,0,2,20
1965690,1517370,2025-03-12,Joint,"ED Vote Tally Sheet (Joint Favorable)",30,10,0,5,45
1965697,1522913,2025-03-20,Joint,"LAB Vote Tally Sheet (Joint Favorable Substitute)",9,4,0,0,13
1965698,1505870,2025-03-04,Joint,"HS Vote Tally Sheet (Joint Favorable)",21,2,0,0,23
1965714,1525520,2025-03-21,Joint,"PD Vote Tally Sheet (Joint Favorable)",19,0,0,3,22
1965719,1509033,2025-03-06,Joint,"KID Vote Tally Sheet (Joint Favorable Substitute)",14,3,0,0,17
1965723,1519020,2025-03-13,Joint,"HED Vote Tally Sheet (Joint Favorable Substitute)",18,0,0,0,18
1965723,1563189,2025-04-30,Senate,"Senate Roll Call Vote 100 ",36,0,0,0,36
1965723,1563190,2025-04-30,Senate,"Senate Roll Call Vote 99 ",11,24,1,0,36
1965723,1578981,2025-05-22,House,"House Roll Call Vote 180 ",146,0,0,5,151
1965724,1517019,2025-03-12,Joint,"ED Vote Tally Sheet (Joint Favorable)",40,0,0,5,45
1965724,1565140,2025-05-05,Joint,"FIN Vote Tally Sheet (Joint Favorable)",52,0,0,2,54
1965729,1513421,2025-03-07,Joint,"PD Vote Tally Sheet (Joint Favorable)",20,0,0,2,22
1965729,1566565,2025-05-05,Joint,"APP Vote Tally Sheet (Joint Favorable)",42,8,0,3,53
1965730,1508181,2025-03-06,Joint,"LAB Vote Tally Sheet (Joint Favorable)",12,1,0,0,13
1965732,1524566,2025-03-21,Joint,"PD Vote Tally Sheet (Joint Favorable Substitute)",19,0,0,3,22
1965732,1561506,2025-04-28,House,"House Roll Call Vote 52 AS AMENDED ",144,0,0,7,151
1965732,1582304,2025-05-30,Senate,"Senate Roll Call Vote 308 ",36,0,0,0,36
1965735,1530757,2025-03-28,Joint,"ED Vote Tally Sheet (Joint Favorable Substitute)",32,12,0,1,45
1965738,1552044,2025-03-18,Joint,"ET Vote Tally Sheet (Change of Reference)",0,0,0,0,0
1968524,1488628,2025-02-11,Joint,"EXN Vote Tally Sheet (Joint Favorable)",20,0,0,1,21
1968524,1548511,2025-04-15,Senate,"Senate Roll Call Vote 83 ",31,0,5,0,36
1968693,1488630,2025-02-11,Joint,"EXN Vote Tally Sheet (Joint Favorable)",20,0,0,1,21
1968693,1506964,2025-03-05,Senate,"Senate Roll Call Vote 45 ",34,1,1,0,36
1968864,1488640,2025-02-11,Joint,"EXN Vote Tally Sheet (Joint Favorable)",20,0,0,1,21
1968864,1506335,2025-03-05,Senate,"Senate Roll Call Vote 44 ",34,1,1,0,36
1970039,1506442,2025-03-05,Joint,"PH Vote Tally Sheet (Joint Favorable Substitute)",32,0,0,0,32
1970039,1557430,2025-04-24,Joint,"FIN Vote Tally Sheet (Joint Favorable)",52,0,0,0,52
1970058,1517876,2025-03-13,Joint,"INS Vote Tally Sheet (Joint Favorable)",12,1,0,0,13
1970080,1506690,2025-03-05,Joint,"PH Vote Tally Sheet (Joint Favorable)",32,0,0,0,32
1970099,1505735,2025-03-05,Joint,"PH Vote Tally Sheet (Joint Favorable)",32,0,0,0,32
1970099,1566401,2025-05-05,Joint,"APP Vote Tally Sheet (Joint Favorable)",42,8,0,3,53
1970122,1506312,2025-03-05,Joint,"PH Vote Tally Sheet (Joint Favorable)",32,0,0,0,32
1970144,1505987,2025-03-05,Joint,"PH Vote Tally Sheet (Joint Favorable)",24,8,0,0,32
1970144,1583692,2025-06-02,House,"House Roll Call Vote 275 AS AMENDED ",148,0,0,3,151
1970144,1584533,2025-06-04,Senate,"Senate Roll Call Vote 371 ",36,0,0,0,36
1970165,1516671,2025-03-12,Joint,"PH Vote Tally Sheet (Joint Favorable)",32,0,0,0,32
1970184,1513305,2025-03-11,Joint,"INS Vote Tally Sheet (Joint Favorable Change of Reference)",11,2,0,0,13
1970184,1541733,2025-04-08,Joint,"JUD Vote Tally Sheet (Joint Favorable Substitute)",41,0,0,0,41
1970184,1541734,2025-04-08,Joint,"JUD Vote Tally Sheet-A (Joint Favorable Substitute)",0,0,0,0,0
1970184,1577071,2025-05-23,Joint,"APP Vote Tally Sheet (Joint Favorable)",43,9,0,1,53
1970205,1505793,2025-03-05,Joint,"PH Vote Tally Sheet (Joint Favorable)",23,9,0,0,32
1970229,1516173,2025-03-12,Joint,"PH Vote Tally Sheet (Joint Favorable)",26,6,0,0,32
1970288,1505851,2025-03-05,Joint,"PH Vote Tally Sheet (Joint Favorable)",26,6,0,0,32
1970288,1565149,2025-05-05,Joint,"FIN Vote Tally Sheet (Joint Favorable)",52,0,0,2,54
1970306,1504550,2025-03-04,Joint,"AGE Vote Tally Sheet (Joint Favorable)",13,0,0,1,14
1971562,1524165,2025-03-21,Joint,"PH Vote Tally Sheet (Joint Favorable Substitute)",32,0,0,0,32
1971603,1515303,2025-03-11,Joint,"INS Vote Tally Sheet (Joint Favorable Substitute)",11,2,0,0,13
1971603,1570927,2025-05-13,House,"House Roll Call Vote 106 AS AMENDED ",131,13,0,7,151
1971603,1584540,2025-06-04,Senate,"Senate Roll Call Vote 381 ",36,0,0,0,36
1971617,1545198,2025-04-10,Joint,"JUD Vote Tally Sheet (Joint Favorable)",39,0,0,2,41
1971617,1580130,2025-05-27,House,"House Roll Call Vote 197 ",135,16,0,0,151
1971617,1583662,2025-06-02,Senate,"Senate Roll Call Vote 331 ",36,0,0,0,36
1971629,1537584,2025-04-04,Joint,"JUD Vote Tally Sheet (Joint Favorable Substitute)",41,0,0,0,41
1971629,1571998,2025-05-14,Senate,"Senate Roll Call Vote 163 ",35,0,1,0,36
1971629,1585155,2025-06-03,House,"House Roll Call Vote 338 AS AMENDED ",147,0,0,4,151
1971641,1539268,2025-04-07,Joint,"JUD Vote Tally Sheet (Joint Favorable)",32,9,0,0,41
1971641,1566302,2025-05-05,Joint,"APP Vote Tally Sheet (Joint Favorable)",38,12,0,3,53
1971654,1540630,2025-04-08,Joint,"JUD Vote Tally Sheet (Joint Favorable)",31,10,0,0,41
1971654,1576835,2025-05-22,Senate,"Senate Roll Call Vote 225 ",33,2,1,0,36
1971654,1583345,2025-05-28,House,"House Roll Call Vote 217 ",109,37,0,5,151
1973897,1504547,2025-03-04,Joint,"AGE Vote Tally Sheet (Joint Favorable)",11,2,0,1,14
1973901,1507944,2025-03-06,Joint,"BA Vote Tally Sheet (Joint Favorable)",12,0,0,1,13
1973907,1516889,2025-03-12,Joint,"PD Vote Tally Sheet (Joint Favorable)",13,7,0,2,22
1973913,1512633,2025-03-07,Joint,"PD Vote Tally Sheet (Joint Favorable Substitute)",20,0,0,2,22
1973913,1585615,2025-06-04,Senate,"Senate Roll Call Vote 397 ",36,0,0,0,36
1973920,1512701,2025-03-07,Joint,"PD Vote Tally Sheet (Joint Favorable)",17,3,0,2,22
1973926,1504570,2025-03-04,Joint,"AGE Vote Tally Sheet (Joint Favorable)",11,2,0,1,14
1973946,1512661,2025-03-07,Joint,"PD Vote Tally Sheet (Joint Favorable)",17,3,0,2,22
1973946,1583632,2025-06-03,House,"House Roll Call Vote 294 AS AMENDED ",104,43,0,4,151
1973946,1585752,2025-06-04,Senate,"Senate Roll Call Vote 401 ",25,11,0,0,36
1973953,1513336,2025-03-07,Joint,"PD Vote Tally Sheet (Joint Favorable)",20,0,0,2,22
1973953,1583678,2025-06-02,House,"House Roll Call Vote 281 ",136,12,0,3,151
1973959,1512683,2025-03-07,Joint,"PD Vote Tally Sheet (Joint Favorable)",18,3,0,1,22
1973959,1570001,2025-05-12,Joint,"APP Vote Tally Sheet (Joint Favorable)",40,8,0,5,53
1973965,1507148,2025-03-06,Joint,"BA Vote Tally Sheet (Joint Favorable)",12,0,0,1,13
1973972,1508026,2025-03-06,Joint,"BA Vote Tally Sheet (Joint Favorable)",12,0,0,1,13
1973999,1508862,2025-03-06,Joint,"AGE Vote Tally Sheet (Joint Favorable Substitute)",14,0,0,0,14
1974004,1508864,2025-03-06,Joint,"AGE Vote Tally Sheet (Joint Favorable)",13,1,0,0,14
1974013,1507970,2025-03-06,Joint,"BA Vote Tally Sheet (Joint Favorable Substitute)",12,0,0,1,13
1974021,1507467,2025-03-06,Joint,"BA Vote Tally Sheet (Joint Favorable)",12,0,0,1,13
1974021,1569978,2025-05-12,Joint,"JUD Vote Tally Sheet (Joint Favorable)",40,0,0,1,41
1974021,1572207,2025-05-15,Senate,"Senate Roll Call Vote 175 ",35,1,0,0,36
1974021,1581777,2025-05-29,House,"House Roll Call Vote 232 AS AMENDED ",140,6,0,5,151
1974028,1516862,2025-03-12,Joint,"PD Vote Tally Sheet (Joint Favorable Substitute)",13,7,0,2,22
1974035,1513010,2025-03-07,Joint,"PD Vote Tally Sheet (Joint Favorable)",20,0,0,2,22
1974041,1515318,2025-03-11,Joint,"BA Vote Tally Sheet (Joint Favorable)",13,0,0,0,13
1974041,1558701,2025-04-25,Joint,"JUD Vote Tally Sheet (Joint Favorable)",37,0,0,4,41
1974041,1568791,2025-05-08,House,"House Roll Call Vote 87 AS AMENDED ",140,0,0,11,151
1974041,1582220,2025-05-30,Senate,"Senate Roll Call Vote 292 ",36,0,0,0,36
1974048,1507602,2025-03-06,Joint,"BA Vote Tally Sheet (Joint Favorable)",12,0,0,1,13
1974048,1582117,2025-05-30,Senate,"Senate Roll Call Vote 297 ",34,1,1,0,36
1974054,1508868,2025-03-06,Joint,"AGE Vote Tally Sheet (Joint Favorable)",14,0,0,0,14
1974054,1565840,2025-05-05,Joint,"APP Vote Tally Sheet (Joint Favorable)",42,8,0,3,53
1974054,1581030,2025-05-28,Senate,"Senate Roll Call Vote 251 ",36,0,0,0,36
1974060,1531835,2025-03-28,Joint,"PD Vote Tally Sheet (Joint Favorable Substitute)",21,0,0,1,22
1974067,1512686,2025-03-07,Joint,"PD Vote Tally Sheet (Joint Favorable)",20,0,0,2,22
1974067,1568466,2025-05-08,House,"House Roll Call Vote 80 AS AMENDED ",147,0,0,4,151
1974067,1584500,2025-06-04,Senate,"Senate Roll Call Vote 362 ",34,1,1,0,36
1974075,1516896,2025-03-12,Joint,"PD Vote Tally Sheet (Joint Favorable)",20,0,0,2,22
1974093,1512662,2025-03-07,Joint,"PD Vote Tally Sheet (Joint Favorable)",17,3,0,2,22
1974093,1585712,2025-06-04,House,"House Roll Call Vote 379 HOUSE AMD A",80,70,0,1,151
1974099,1507226,2025-03-06,Joint,"BA Vote Tally Sheet (Joint Favorable)",12,0,0,1,13
1974099,1565110,2025-05-05,Joint,"FIN Vote Tally Sheet (Joint Favorable)",51,1,0,2,54
1974106,1508857,2025-03-06,Joint,"AGE Vote Tally Sheet (Joint Favorable)",14,0,0,0,14
1974106,1566318,2025-05-05,Joint,"APP Vote Tally Sheet (Joint Favorable)",38,12,0,3,53
1974112,1517121,2025-03-12,Joint,"PD Vote Tally Sheet (Joint Favorable Substitute)",12,8,0,2,22
1974112,1580721,2025-05-28,House,"House Roll Call Vote 210 AS AMENDED ",116,32,0,3,151
1975662,1525727,2025-03-21,Joint,"ED Vote Tally Sheet (Joint Favorable Substitute)",44,0,0,1,45
1975667,1517720,2025-03-13,Joint,"ET Vote Tally Sheet (Joint Favorable Substitute)",21,4,0,0,25
1975667,1582907,2025-05-31,House,"House Roll Call Vote 269 AS AMENDED ",67,76,0,8,151
1975672,1508893,2025-03-06,Joint,"HSG Vote Tally Sheet (Joint Favorable Substitute)",13,5,0,2,20
1975672,1565853,2025-05-05,Joint,"APP Vote Tally Sheet (Joint Favorable)",38,12,0,3,53
1975677,1520080,2025-03-18,Joint,"ET Vote Tally Sheet (Joint Favorable Substitute Change of Reference)",24,0,0,1,25
1975682,1509585,2025-03-06,Joint,"KID Vote Tally Sheet (Joint Favorable)",13,4,0,0,17
1975682,1566455,2025-05-05,Joint,"APP Vote Tally Sheet (Joint Favorable)",38,12,0,3,53
1975688,1509030,2025-03-06,Joint,"KID Vote Tally Sheet (Joint Favorable Substitute Change of Reference)",10,7,0,0,17
1975696,1506568,2025-03-05,Joint,"PH Vote Tally Sheet (Joint Favorable Substitute)",32,0,0,0,32
1975711,1517869,2025-03-13,Joint,"INS Vote Tally Sheet (Joint Favorable)",13,0,0,0,13
1975719,1525148,2025-03-21,Joint,"ED Vote Tally Sheet (Joint Favorable)",29,15,0,1,45
1975726,1508684,2025-03-06,Joint,"HSG Vote Tally Sheet (Joint Favorable)",13,5,0,2,20
1975756,1530781,2025-03-28,Joint,"ED Vote Tally Sheet (Joint Favorable Substitute Change of Reference)",30,14,0,1,45
1975756,1558330,2025-04-24,Joint,"APP Vote Tally Sheet (Joint Favorable)",37,17,0,0,54
1975760,1508676,2025-03-06,Joint,"HSG Vote Tally Sheet (Joint Favorable)",18,0,0,2,20
1975760,1539731,2025-04-07,Joint,"PD Vote Tally Sheet (Joint Favorable)",20,0,0,2,22
1975760,1585691,2025-06-04,House,"House Roll Call Vote 347 AS AMENDED ",145,2,0,4,151
1975766,1517104,2025-03-13,Joint,"CE Vote Tally Sheet (Joint Favorable Change of Reference)",19,0,1,0,20
1975766,1557846,2025-04-24,Joint,"FIN Vote Tally Sheet (Joint Favorable)",52,0,0,0,52
1975775,1520202,2025-03-18,Joint,"PS Vote Tally Sheet (Joint Favorable Substitute)",25,3,1,0,29
1975780,1505749,2025-03-04,Joint,"HS Vote Tally Sheet (Joint Favorable)",21,1,0,1,23
1975780,1571175,2025-05-13,Senate,"Senate Roll Call Vote 147 ",24,11,1,0,36
1975788,1518315,2025-03-12,Joint,"TRA Vote Tally Sheet (Joint Favorable Substitute)",30,5,0,0,35
1975808,1520575,2025-03-18,Joint,"PS Vote Tally Sheet (Joint Favorable Change of Reference)",29,0,0,0,29
1975808,1557899,2025-04-24,Joint,"FIN Vote Tally Sheet (Joint Favorable)",52,0,0,0,52
1975819,1522255,2025-03-18,Joint,"HS Vote Tally Sheet (Joint Favorable Substitute)",21,1,0,1,23
1975819,1566661,2025-05-06,Joint,"JUD Vote Tally Sheet (Joint Favorable)",36,3,0,2,41
1975819,1569971,2025-05-12,Joint,"APP Vote Tally Sheet (Joint Favorable)",40,8,0,5,53
1975819,1585594,2025-06-04,Senate,"Senate Roll Call Vote 433 ",36,0,0,0,36
1975828,1505358,2025-03-04,Joint,"AGE Vote Tally Sheet (Joint Favorable)",13,0,0,1,14
1975828,1535816,2025-04-01,Joint,"HED Vote Tally Sheet (Joint Favorable)",17,0,0,1,18
1975828,1564939,2025-05-05,Joint,"FIN Vote Tally Sheet (Joint Favorable)",52,0,0,2,54
1975841,1508675,2025-03-06,Joint,"HSG Vote Tally Sheet (Joint Favorable)",16,2,0,2,20
1975857,1524197,2025-03-21,Joint,"GL Vote Tally Sheet (Joint Favorable Substitute)",16,5,0,1,22
1975857,1558670,2025-04-25,Joint,"JUD Vote Tally Sheet (Joint Favorable)",28,9,0,4,41
1975857,1566294,2025-05-05,Joint,"APP Vote Tally Sheet (Joint Favorable)",38,12,0,3,53
1975857,1571145,2025-05-14,Senate,"Senate Roll Call Vote 158 ",26,9,1,0,36
1975857,1571146,2025-05-14,Senate,"Senate Roll Call Vote 157 ",11,24,1,0,36
1975857,1571147,2025-05-14,Senate,"Senate Roll Call Vote 156 ",28,7,1,0,36
1975864,1508678,2025-03-06,Joint,"HSG Vote Tally Sheet (Joint Favorable Substitute)",14,4,0,2,20
1975880,1524861,2025-03-24,Joint,"GL Vote Tally Sheet (Joint Favorable Substitute)",14,8,0,0,22
1975880,1569735,2025-05-12,Joint,"JUD Vote Tally Sheet (Joint Favorable)",28,13,0,0,41
1975880,1574418,2025-05-20,Senate,"Senate Roll Call Vote 198 ",24,11,1,0,36
1975880,1574419,2025-05-20,Senate,"Senate Roll Call Vote 197 ",11,24,1,0,36
1975880,1574420,2025-05-20,Senate,"Senate Roll Call Vote 196 ",11,24,1,0,36
1975880,1574421,2025-05-20,Senate,"Senate Roll Call Vote 195 ",24,11,1,0,36
1975886,1518317,2025-03-12,Joint,"TRA Vote Tally Sheet (Joint Favorable Substitute)",35,0,0,0,35
1975886,1566614,2025-05-05,Joint,"APP Vote Tally Sheet (Joint Favorable)",40,9,0,4,53
1975896,1520683,2025-03-18,Joint,"PS Vote Tally Sheet (Joint Favorable Substitute)",29,0,0,0,29
1975896,1571665,2025-05-14,House,"House Roll Call Vote 120 ",144,3,0,4,151
1975896,1576703,2025-05-22,Senate,"Senate Roll Call Vote 227 ",35,0,1,0,36
1975900,1508282,2025-03-06,Joint,"LAB Vote Tally Sheet (Joint Favorable)",13,0,0,0,13
1975900,1576605,2025-05-22,House,"House Roll Call Vote 176 ",147,0,0,4,151
1975900,1583653,2025-06-02,Senate,"Senate Roll Call Vote 337 ",36,0,0,0,36
1975906,1515907,2025-03-12,Joint,"PH Vote Tally Sheet (Joint Favorable)",22,10,0,0,32
1975906,1571245,2025-05-13,Senate,"Senate Roll Call Vote 150 ",24,11,1,0,36
1975906,1571246,2025-05-13,Senate,"Senate Roll Call Vote 149 ",11,24,1,0,36
1975914,1517856,2025-03-13,Joint,"INS Vote Tally Sheet (Joint Favorable)",13,0,0,0,13
1975914,1565946,2025-05-05,Joint,"APP Vote Tally Sheet (Joint Favorable)",42,8,0,3,53
1975929,1506686,2025-03-05,Joint,"PH Vote Tally Sheet (Joint Favorable)",23,9,0,0,32
1975935,1517148,2025-03-13,Joint,"LAB Vote Tally Sheet (Joint Favorable Substitute)",9,4,0,0,13
1975935,1569468,2025-05-12,Joint,"APP Vote Tally Sheet (Joint Favorable)",37,10,1,5,53
1975945,1524737,2025-03-24,Joint,"GL Vote Tally Sheet (Joint Favorable Substitute)",22,0,0,0,22
1975945,1558678,2025-04-25,Joint,"JUD Vote Tally Sheet (Joint Favorable Substitute)",36,1,0,4,41
1975945,1558679,2025-04-25,Joint,"JUD Vote Tally Sheet-A (Joint Favorable Substitute)",0,0,0,0,0
1975945,1576684,2025-05-23,Senate,"Senate Roll Call Vote 235 ",36,0,0,0,36
1975945,1584521,2025-06-03,House,"House Roll Call Vote 301 AS AMENDED ",147,1,0,3,151
1975962,1524474,2025-03-19,Joint,"TRA Vote Tally Sheet (Joint Favorable Substitute)",33,1,0,1,35
1975962,1578983,2025-05-27,Senate,"Senate Roll Call Vote 240 ",31,4,1,0,36
1975962,1582820,2025-05-31,House,"House Roll Call Vote 253 AS AMENDED ",110,34,0,7,151
1975966,1516155,2025-03-12,Joint,"GL Vote Tally Sheet (Joint Favorable)",22,0,0,0,22
1975966,1561507,2025-04-28,House,"House Roll Call Vote 47 AS AMENDED ",145,0,0,6,151
1975966,1580429,2025-05-28,Senate,"Senate Roll Call Vote 263 ",36,0,0,0,36
1975972,1519876,2025-03-18,Joint,"PS Vote Tally Sheet (Joint Favorable Substitute)",24,5,0,0,29
1975978,1525383,2025-03-21,Joint,"ED Vote Tally Sheet (Joint Favorable Substitute Change of Reference)",44,0,0,1,45
1975978,1558213,2025-04-24,Joint,"APP Vote Tally Sheet (Joint Favorable Substitute)",54,0,0,0,54
1975978,1580946,2025-05-28,House,"House Roll Call Vote 212 ",146,0,0,5,151
1975983,1528586,2025-03-27,Joint,"PH Vote Tally Sheet (Joint Favorable)",21,10,0,1,32
1975992,1520714,2025-03-18,Joint,"PS Vote Tally Sheet (Joint Favorable Substitute)",29,0,0,0,29
1975992,1566629,2025-05-05,Joint,"APP Vote Tally Sheet (Joint Favorable)",43,7,0,3,53
1976001,1540120,2025-04-07,Joint,"JUD Vote Tally Sheet (Joint Favorable)",41,0,0,0,41
1976001,1575143,2025-05-21,House,"House Roll Call Vote 170 AS AMENDED ",147,0,0,4,151
1976001,1583282,2025-06-02,Senate,"Senate Roll Call Vote 334 ",36,0,0,0,36
1976001,1584995,2025-06-03,House,"House Roll Call Vote 306 AS AMENDED ",146,0,0,5,151
1976007,1525173,2025-03-21,Joint,"ED Vote Tally Sheet (Joint Favorable Substitute Change of Reference)",30,14,0,1,45
1976011,1517933,2025-03-13,Joint,"HS Vote Tally Sheet (Joint Favorable)",16,6,0,1,23
1976020,1508650,2025-03-06,Joint,"HSG Vote Tally Sheet (Joint Favorable Substitute)",15,3,0,2,20
1976026,1524055,2025-03-20,Joint,"LAB Vote Tally Sheet (Joint Favorable)",9,4,0,0,13
1976026,1565793,2025-05-05,Joint,"APP Vote Tally Sheet (Joint Favorable)",38,12,0,3,53
1976031,1530767,2025-03-28,Joint,"ED Vote Tally Sheet (Joint Favorable Substitute)",39,5,0,1,45
1976042,1508752,2025-03-06,Joint,"HSG Vote Tally Sheet (Joint Favorable)",17,1,0,2,20
1976042,1585317,2025-06-04,Senate,"Senate Roll Call Vote 436 ",36,0,0,0,36
1976042,1585318,2025-06-04,House,"House Roll Call Vote 369 AS AMENDED ",140,9,0,2,151
1976049,1509754,2025-03-06,Joint,"KID Vote Tally Sheet (Joint Favorable)",17,0,0,0,17
1976049,1572026,2025-05-14,House,"House Roll Call Vote 109 ",145,0,0,6,151
1976049,1576129,2025-05-22,Senate,"Senate Roll Call Vote 220 ",36,0,0,0,36
1976060,1505671,2025-03-04,Joint,"HS Vote Tally Sheet (Joint Favorable Substitute)",16,6,0,1,23
1976060,1565815,2025-05-05,Joint,"APP Vote Tally Sheet (Joint Favorable)",42,8,0,3,53
1976060,1580725,2025-05-28,Senate,"Senate Roll Call Vote 259 ",28,8,0,0,36
1976060,1585338,2025-06-04,House,"House Roll Call Vote 344 AS AMENDED ",139,9,0,3,151
1976065,1520309,2025-03-18,Joint,"PS Vote Tally Sheet (Joint Favorable)",15,14,0,0,29
1976070,1504610,2025-03-04,Joint,"AGE Vote Tally Sheet (Joint Favorable Change of Reference)",13,0,0,1,14
1976078,1508725,2025-03-06,Joint,"HSG Vote Tally Sheet (Joint Favorable)",13,5,0,2,20
1976078,1539312,2025-04-07,Joint,"PD Vote Tally Sheet (Joint Favorable)",12,8,0,2,22
1976078,1574717,2025-05-20,House,"House Roll Call Vote 154 AS AMENDED ",94,54,0,3,151
1976078,1574718,2025-05-20,House,"House Roll Call Vote 153 HOUSE AMD C",48,99,0,4,151
1976078,1574719,2025-05-20,House,"House Roll Call Vote 152 HOUSE AMD B",46,99,0,6,151
1976093,1517116,2025-03-13,Joint,"LAB Vote Tally Sheet (Joint Favorable Substitute)",9,4,0,0,13
1976093,1566517,2025-05-05,Joint,"APP Vote Tally Sheet (Joint Favorable)",38,12,0,3,53
1976093,1574188,2025-05-20,Senate,"Senate Roll Call Vote 190 ",27,8,1,0,36
1976093,1574189,2025-05-20,Senate,"Senate Roll Call Vote 189 ",11,23,2,0,36
1976093,1574190,2025-05-20,Senate,"Senate Roll Call Vote 188 ",9,11,2,0,22
1976099,1517800,2025-03-13,Joint,"ET Vote Tally Sheet (Joint Favorable Substitute)",19,6,0,0,25
1976110,1506311,2025-03-04,Joint,"HS Vote Tally Sheet (Joint Favorable)",16,7,0,0,23
1976120,1507990,2025-03-06,Joint,"LAB Vote Tally Sheet (Joint Favorable)",13,0,0,0,13
1976120,1584597,2025-06-03,House,"House Roll Call Vote 326 ",148,0,0,3,151
1976120,1585426,2025-06-04,Senate,"Senate Roll Call Vote 429 ",36,0,0,0,36
1976128,1545907,2025-04-10,Joint,"JUD Vote Tally Sheet (Joint Favorable Substitute)",28,11,0,2,41
1976128,1571817,2025-05-14,Senate,"Senate Roll Call Vote 172 ",36,0,0,0,36
1976128,1578815,2025-05-22,House,"House Roll Call Vote 173 AS AMENDED ",93,55,0,3,151
1976133,1517444,2025-03-12,Joint,"ED Vote Tally Sheet (Joint Favorable)",32,8,0,5,45
1976133,1570697,2025-05-13,House,"House Roll Call Vote 88 AS AMENDED ",128,20,0,3,151
1976142,1539082,2025-04-07,Joint,"JUD Vote Tally Sheet (Joint Favorable Substitute)",31,10,0,0,41
1976142,1539083,2025-04-07,Joint,"JUD Vote Tally Sheet-A (Joint Favorable Substitute)",31,10,0,0,41
1976142,1539084,2025-04-07,Joint,"JUD Vote Tally Sheet-B (Joint Favorable Substitute)",0,0,0,0,0
1976142,1562360,2025-04-30,House,"House Roll Call Vote 54 AS AMENDED ",100,46,0,5,151
1976142,1562361,2025-04-30,House,"House Roll Call Vote 53 HOUSE AMD B",46,100,0,5,151
1976142,1581335,2025-05-29,Senate,"Senate Roll Call Vote 268 ",11,25,0,0,36
1976142,1581336,2025-05-29,Senate,"Senate Roll Call Vote 267 ",11,25,0,0,36
1976142,1581337,2025-05-29,Senate,"Senate Roll Call Vote 266 ",11,25,0,0,36
1976142,1581993,2025-05-30,Senate,"Senate Roll Call Vote 284 ",25,11,0,0,36
1976142,1581994,2025-05-29,Senate,"Senate Roll Call Vote 283 ",12,24,0,0,36
1976142,1581995,2025-05-29,Senate,"Senate Roll Call Vote 282 ",11,25,0,0,36
1976142,1581996,2025-05-29,Senate,"Senate Roll Call Vote 281 ",11,25,0,0,36
1976142,1581997,2025-05-29,Senate,"Senate Roll Call Vote 280 ",11,25,0,0,36
1976142,1581998,2025-05-29,Senate,"Senate Roll Call Vote 279 ",12,24,0,0,36
1976142,1581999,2025-05-29,Senate,"Senate Roll Call Vote 278 ",11,25,0,0,36
1976142,1582000,2025-05-29,Senate,"Senate Roll Call Vote 277 ",11,25,0,0,36
1976142,1582001,2025-05-29,Senate,"Senate Roll Call Vote 276 ",11,25,0,0,36
1976142,1582002,2025-05-29,Senate,"Senate Roll Call Vote 275 ",11,25,0,0,36
1976142,1582003,2025-05-29,Senate,"Senate Roll Call Vote 274 ",11,25,0,0,36
1976142,1582004,2025-05-29,Senate,"Senate Roll Call Vote 273 ",12,24,0,0,36
1976142,1582005,2025-05-29,Senate,"Senate Roll Call Vote 272 ",11,25,0,0,36
1976142,1582006,2025-05-29,Senate,"Senate Roll Call Vote 271 ",11,25,0,0,36
1976142,1582007,2025-05-29,Senate,"Senate Roll Call Vote 270 ",11,25,0,0,36
1976142,1582008,2025-05-29,Senate,"Senate Roll Call Vote 269 ",11,25,0,0,36
1976148,1525064,2025-03-21,Joint,"ED Vote Tally Sheet (Joint Favorable)",42,2,0,1,45
1976148,1571712,2025-05-14,Senate,"Senate Roll Call Vote 170 ",33,3,0,0,36
1976152,1518997,2025-03-12,Joint,"TRA Vote Tally Sheet (Joint Favorable)",35,0,0,0,35
1976160,1508856,2025-03-06,Joint,"HSG Vote Tally Sheet (Joint Favorable)",18,0,0,2,20
1976160,1566636,2025-05-05,Joint,"APP Vote Tally Sheet (Joint Favorable)",42,8,0,3,53
1976175,1506397,2025-03-04,Joint,"HS Vote Tally Sheet (Joint Favorable)",23,0,0,0,23
1976175,1536693,2025-04-03,Joint,"AGE Vote Tally Sheet (Joint Favorable)",13,0,0,1,14
1976175,1583618,2025-06-02,House,"House Roll Call Vote 277 AS AMENDED ",147,0,0,4,151
1976181,1509517,2025-03-06,Joint,"KID Vote Tally Sheet (Joint Favorable Substitute)",17,0,0,0,17
1976181,1567092,2025-05-07,Senate,"Senate Roll Call Vote 124 ",36,0,0,0,36
1976181,1567093,2025-05-07,Senate,"Senate Roll Call Vote 123 ",12,24,0,0,36
1976181,1567094,2025-05-07,Senate,"Senate Roll Call Vote 122 ",36,0,0,0,36
1976181,1584641,2025-06-03,House,"House Roll Call Vote 332 AS AMENDED ",148,0,0,3,151
1976187,1524178,2025-03-19,Joint,"TRA Vote Tally Sheet (Joint Favorable Substitute)",34,0,0,1,35
1976187,1558702,2025-04-25,Joint,"JUD Vote Tally Sheet (Joint Favorable Substitute)",37,0,0,4,41
1976197,1520093,2025-03-18,Joint,"ET Vote Tally Sheet (Joint Favorable Substitute)",17,8,0,0,25
1976201,1517728,2025-03-12,Joint,"ED Vote Tally Sheet (Joint Favorable Substitute Change of Reference)",40,0,0,5,45
1976201,1558048,2025-04-24,Joint,"APP Vote Tally Sheet (Joint Favorable Substitute)",54,0,0,0,54
1976207,1517915,2025-03-13,Joint,"INS Vote Tally Sheet (Joint Favorable Substitute)",10,3,0,0,13
1976219,1519972,2025-03-18,Joint,"ET Vote Tally Sheet (Joint Favorable)",14,10,0,1,25
1976231,1520552,2025-03-18,Joint,"PS Vote Tally Sheet (Joint Favorable Substitute)",29,0,0,0,29
1976231,1571743,2025-05-14,House,"House Roll Call Vote 119 AS AMENDED ",147,0,0,4,151
1976231,1585234,2025-06-04,Senate,"Senate Roll Call Vote 425 ",36,0,0,0,36
1976236,1505922,2025-03-04,Joint,"HS Vote Tally Sheet (Joint Favorable)",23,0,0,0,23
1976241,1524004,2025-03-19,Joint,"TRA Vote Tally Sheet (Joint Favorable Substitute)",25,9,0,1,35
1977907,1524571,2025-03-21,Joint,"PD Vote Tally Sheet (Joint Favorable)",12,7,0,3,22
1978037,1531174,2025-03-28,Joint,"PD Vote Tally Sheet (Joint Favorable Substitute)",18,3,0,1,22
1978037,1531175,2025-03-28,Joint,"PD Vote Tally Sheet-A (Joint Favorable Substitute)",0,0,0,0,0
1978909,1496156,2025-02-20,Joint,"EXN Vote Tally Sheet (Joint Favorable)",13,8,0,0,21
1978909,1501796,2025-02-26,Joint,"JUD Vote Tally Sheet (Joint Favorable)",39,0,0,2,41
1978909,1506662,2025-03-05,Senate,"Senate Roll Call Vote 65 ",31,0,5,0,36
1978909,1511427,2025-03-05,House,"House Roll Call Vote 32 CONSENT CALENDAR ",147,0,0,3,150
1979857,1518059,2025-03-14,Joint,"ENV Vote Tally Sheet (Joint Favorable Change of Reference)",33,0,0,1,34
1979884,1537600,2025-04-04,Joint,"JUD Vote Tally Sheet (Joint Favorable Substitute)",41,0,0,0,41
1979884,1570989,2025-05-13,House,"House Roll Call Vote 97 ",147,0,0,4,151
1979884,1585417,2025-06-04,Senate,"Senate Roll Call Vote 393 ",36,0,0,0,36
1979913,1545295,2025-04-10,Joint,"JUD Vote Tally Sheet (Joint Favorable Substitute)",39,0,0,2,41
1979913,1563153,2025-04-30,Senate,"Senate Roll Call Vote 101 ",35,0,1,0,36
1979913,1578974,2025-05-22,House,"House Roll Call Vote 175 ",147,0,0,4,151
1979940,1537493,2025-04-04,Joint,"JUD Vote Tally Sheet-A (Joint Favorable)",12,23,1,5,41
1979940,1537494,2025-04-04,Joint,"JUD Vote Tally Sheet (Joint Favorable)",29,12,0,0,41
1979940,1573756,2025-05-19,House,"House Roll Call Vote 145 ",74,65,0,12,151
1979940,1573757,2025-05-19,House,"House Roll Call Vote 144 HOUSE AMD E",43,100,0,8,151
1979940,1573758,2025-05-19,House,"House Roll Call Vote 143 HOUSE AMD D",47,96,0,8,151
1979940,1573759,2025-05-19,House,"House Roll Call Vote 142 HOUSE AMD C",44,96,0,11,151
1979940,1573760,2025-05-19,House,"House Roll Call Vote 141 HOUSE AMD B",44,96,0,11,151
1979940,1573761,2025-05-19,House,"House Roll Call Vote 140 HOUSE AMD A",44,96,0,11,151
1979966,1537806,2025-04-04,Joint,"JUD Vote Tally Sheet (Joint Favorable Substitute)",41,0,0,0,41
1979966,1574744,2025-05-20,Senate,"Senate Roll Call Vote 192 ",35,0,1,0,36
1979966,1585784,2025-06-04,House,"House Roll Call Vote 361 AS AMENDED ",149,0,0,2,151
1980689,1498500,2025-02-24,House,"House Roll Call Vote 29 EMERGENCY CERTIFICATION ",140,5,0,5,150
1980689,1498501,2025-02-24,House,"House Roll Call Vote 28 HOUSE AMD A",48,96,0,6,150
1980689,1499021,2025-02-25,Senate,"Senate Roll Call Vote 39 ",34,0,1,0,35
1980690,1498074,2025-02-24,House,"House Roll Call Vote 27 EMERGENCY CERTIFICATION ",94,49,0,7,150
1980690,1498075,2025-02-24,House,"House Roll Call Vote 26 HOUSE AMD B",47,95,0,8,150
1980690,1498076,2025-02-24,House,"House Roll Call Vote 25 HOUSE AMD A",49,89,0,12,150
1980690,1498834,2025-02-25,Senate,"Senate Roll Call Vote 38 ",25,9,1,0,35
1980690,1498835,2025-02-25,Senate,"Senate Roll Call Vote 37 ",25,9,1,0,35
1980690,1498836,2025-02-25,Senate,"Senate Roll Call Vote 36 ",9,23,3,0,35
1981736,1514326,2025-03-11,Joint,"INS Vote Tally Sheet (Joint Favorable Substitute)",12,1,0,0,13
1981736,1582012,2025-05-30,Senate,"Senate Roll Call Vote 285 ",30,6,0,0,36
1981752,1518086,2025-03-13,Joint,"INS Vote Tally Sheet (Joint Favorable)",8,5,0,0,13
1981752,1564348,2025-05-01,Senate,"Senate Roll Call Vote 110 ",20,14,2,0,36
1981752,1564349,2025-05-01,Senate,"Senate Roll Call Vote 109 ",11,23,2,0,36
1981771,1520580,2025-03-18,Joint,"PS Vote Tally Sheet (Joint Favorable)",29,0,0,0,29
1981771,1548883,2025-04-15,Senate,"Senate Roll Call Vote 91 ",31,0,5,0,36
1981787,1545896,2025-04-10,Joint,"JUD Vote Tally Sheet (Joint Favorable Substitute)",29,10,0,2,41
1981787,1572025,2025-05-15,Senate,"Senate Roll Call Vote 178 ",31,5,0,0,36
1981806,1518099,2025-03-13,Joint,"INS Vote Tally Sheet (Joint Favorable Substitute)",13,0,0,0,13
1981806,1549001,2025-04-15,Joint,"PS Vote Tally Sheet (Joint Favorable)",27,0,0,2,29
1981822,1520600,2025-03-18,Joint,"PS Vote Tally Sheet (Joint Favorable Substitute)",29,0,0,0,29
1981822,1582760,2025-05-30,House,"House Roll Call Vote 247 AS AMENDED ",145,0,0,6,151
1981822,1583684,2025-06-02,Senate,"Senate Roll Call Vote 344 ",36,0,0,0,36
1981859,1517852,2025-03-13,Joint,"INS Vote Tally Sheet (Joint Favorable Substitute Change of Reference)",13,0,0,0,13
1981859,1539160,2025-04-07,Joint,"JUD Vote Tally Sheet (Joint Favorable)",40,1,0,0,41
1981895,1515320,2025-03-11,Joint,"INS Vote Tally Sheet (Joint Favorable)",13,0,0,0,13
1981895,1571316,2025-05-14,Senate,"Senate Roll Call Vote 161 ",35,0,1,0,36
1981910,1539242,2025-04-07,Joint,"JUD Vote Tally Sheet (MOTION FAILED)",13,28,0,0,41
1981926,1537623,2025-04-04,Joint,"JUD Vote Tally Sheet (Joint Favorable)",41,0,0,0,41
1981946,1519797,2025-03-18,Joint,"PS Vote Tally Sheet (Joint Favorable Substitute)",29,0,0,0,29
1981981,1520085,2025-03-18,Joint,"PS Vote Tally Sheet (Joint Favorable)",29,0,0,0,29
1981996,1519956,2025-03-18,Joint,"PS Vote Tally Sheet (Joint Favorable)",29,0,0,0,29
1982010,1520283,2025-03-18,Joint,"PS Vote Tally Sheet (Joint Favorable Substitute)",29,0,0,0,29
1982010,1583716,2025-06-02,Senate,"Senate Roll Call Vote 351 ",36,0,0,0,36
1983579,1524926,2025-03-21,Joint,"ED Vote Tally Sheet (Joint Favorable Substitute)",44,0,0,1,45
1983595,1517473,2025-03-12,Joint,"ED Vote Tally Sheet (Joint Favorable)",40,0,0,5,45
1983595,1565397,2025-05-05,Joint,"FIN Vote Tally Sheet (Joint Favorable)",52,0,0,2,54
1983618,1526381,2025-03-24,Joint,"ED Vote Tally Sheet (Joint Favorable Substitute)",42,3,0,0,45
1983637,1518097,2025-03-13,Joint,"INS Vote Tally Sheet (Joint Favorable Substitute)",9,4,0,0,13
1983637,1566237,2025-05-06,Joint,"APP Vote Tally Sheet (MOTION FAILED)",19,30,0,4,53
1983660,1526022,2025-03-24,Joint,"ED Vote Tally Sheet (Joint Favorable Substitute)",33,12,0,0,45
1983683,1526384,2025-03-24,Joint,"ED Vote Tally Sheet (Joint Favorable)",43,2,0,0,45
1983708,1505956,2025-03-05,Joint,"PH Vote Tally Sheet (Joint Favorable Substitute)",32,0,0,0,32
1983725,1516172,2025-03-12,Joint,"PH Vote Tally Sheet (Joint Favorable Change of Reference)",32,0,0,0,32
1983744,1524094,2025-03-21,Joint,"PH Vote Tally Sheet (Joint Favorable)",32,0,0,0,32
1983770,1505784,2025-03-05,Joint,"PH Vote Tally Sheet (Joint Favorable Substitute)",32,0,0,0,32
1983770,1561508,2025-04-28,House,"House Roll Call Vote 46 AS AMENDED ",144,0,0,7,151
1983770,1583633,2025-06-02,Senate,"Senate Roll Call Vote 346 ",36,0,0,0,36
1983787,1517467,2025-03-12,Joint,"ED Vote Tally Sheet (Joint Favorable Substitute)",40,0,0,5,45
1983810,1515245,2025-03-11,Joint,"INS Vote Tally Sheet (Joint Favorable)",9,4,0,0,13
1983810,1582536,2025-05-30,House,"House Roll Call Vote 239 AS AMENDED ",145,2,0,4,151
1985513,1519551,2025-03-18,Joint,"CE Vote Tally Sheet (Joint Favorable)",19,1,0,0,20
1985516,1520922,2025-03-18,Joint,"HS Vote Tally Sheet (Joint Favorable Substitute)",17,5,0,1,23
1985516,1581970,2025-05-29,House,"House Roll Call Vote 229 AS AMENDED ",148,0,0,3,151
1985516,1585681,2025-06-04,Senate,"Senate Roll Call Vote 426 ",36,0,0,0,36
1985519,1520313,2025-03-18,Joint,"GOS Vote Tally Sheet (Joint Favorable)",12,0,0,0,12
1985521,1508616,2025-03-06,Joint,"HSG Vote Tally Sheet (Joint Favorable Change of Reference)",16,2,0,2,20
1985526,1515322,2025-03-11,Joint,"HED Vote Tally Sheet (Joint Favorable Substitute)",18,0,0,0,18
1985526,1564504,2025-05-01,House,"House Roll Call Vote 58 ",145,0,0,6,151
1985526,1572227,2025-05-15,Senate,"Senate Roll Call Vote 179 ",36,0,0,0,36
1985529,1515336,2025-03-11,Joint,"HED Vote Tally Sheet (Joint Favorable Substitute)",18,0,0,0,18
1985532,1513402,2025-03-11,Joint,"BA Vote Tally Sheet (Joint Favorable)",13,0,0,0,13
1985532,1571655,2025-05-14,House,"House Roll Call Vote 114 AS AMENDED ",146,0,0,5,151
1985532,1571656,2025-05-14,House,"House Roll Call Vote 113 HOUSE AMD A",105,42,0,4,151
1985532,1582009,2025-05-30,Senate,"Senate Roll Call Vote 286 ",36,0,0,0,36
1985532,1582301,2025-05-30,House,"House Roll Call Vote 241 AS AMENDED ",148,0,0,3,151
1985535,1515310,2025-03-11,Joint,"HED Vote Tally Sheet (Joint Favorable)",18,0,0,0,18
1985535,1541807,2025-04-09,Senate,"Senate Roll Call Vote 80 ",35,0,1,0,36
1985535,1574820,2025-05-20,House,"House Roll Call Vote 148 ",145,0,0,6,151
1985547,1520219,2025-03-18,Joint,"GOS Vote Tally Sheet (Joint Favorable Substitute)",12,0,0,0,12
1985547,1566000,2025-05-05,Joint,"APP Vote Tally Sheet (Joint Favorable)",41,8,0,4,53
1985552,1518447,2025-03-13,Joint,"HED Vote Tally Sheet (Joint Favorable Change of Reference)",18,0,0,0,18
1985556,1508869,2025-03-06,Joint,"HSG Vote Tally Sheet (Joint Favorable)",18,0,0,2,20
1985564,1515285,2025-03-11,Joint,"BA Vote Tally Sheet (Joint Favorable)",13,0,0,0,13
1985568,1520364,2025-03-18,Joint,"GOS Vote Tally Sheet (Joint Favorable)",11,1,0,0,12
1985570,1517942,2025-03-13,Joint,"HS Vote Tally Sheet (Joint Favorable)",22,0,0,1,23
1985570,1566275,2025-05-05,Joint,"APP Vote Tally Sheet (Joint Favorable Substitute)",50,0,0,3,53
1985570,1573697,2025-05-19,House,"House Roll Call Vote 138 AS AMENDED ",143,0,0,8,151
1985570,1584532,2025-05-30,Senate,"Senate Roll Call Vote 294 ",36,0,0,0,36
1985575,1513117,2025-03-11,Joint,"BA Vote Tally Sheet (Joint Favorable Substitute)",9,4,0,0,13
1985575,1563949,2025-05-01,House,"House Roll Call Vote 57 AS AMENDED ",144,0,0,7,151
1985575,1580559,2025-05-28,Senate,"Senate Roll Call Vote 264 ",36,0,0,0,36
1985580,1520783,2025-03-18,Joint,"HS Vote Tally Sheet (Joint Favorable Substitute)",22,0,0,1,23
1985580,1565723,2025-05-05,Joint,"APP Vote Tally Sheet (Joint Favorable Substitute)",50,0,0,3,53
1985580,1576696,2025-05-22,House,"House Roll Call Vote 181 AS AMENDED ",147,0,0,4,151
1985580,1584441,2025-06-04,Senate,"Senate Roll Call Vote 374 ",36,0,0,0,36
1985584,1519059,2025-03-13,Joint,"HED Vote Tally Sheet (Joint Favorable Substitute)",18,0,0,0,18
1985584,1568002,2025-05-07,Senate,"Senate Roll Call Vote 117 ",36,0,0,0,36
1985584,1580975,2025-05-28,House,"House Roll Call Vote 213 AS AMENDED ",147,0,0,4,151
1985584,1583291,2025-06-02,Senate,"Senate Roll Call Vote 326 ",36,0,0,0,36
1985586,1514937,2025-03-11,Joint,"HED Vote Tally Sheet (Joint Favorable Substitute)",13,5,0,0,18
1985589,1520789,2025-03-18,Joint,"HS Vote Tally Sheet (Joint Favorable Substitute)",17,5,0,1,23
1985589,1566272,2025-05-05,Joint,"APP Vote Tally Sheet (Joint Favorable Substitute)",40,10,0,3,53
1985592,1518089,2025-03-13,Joint,"HS Vote Tally Sheet (Joint Favorable)",15,7,0,1,23
1985594,1519636,2025-03-18,Joint,"GOS Vote Tally Sheet (Joint Favorable Substitute)",12,0,0,0,12
1985594,1566534,2025-05-05,Joint,"APP Vote Tally Sheet (Joint Favorable Substitute)",43,6,0,4,53
1985594,1580703,2025-05-28,House,"House Roll Call Vote 214 AS AMENDED ",147,0,0,4,151
1985599,1517865,2025-03-13,Joint,"HS Vote Tally Sheet (Joint Favorable)",16,6,0,1,23
1985599,1570032,2025-05-12,Joint,"JUD Vote Tally Sheet (Joint Favorable)",28,12,0,1,41
1985602,1517959,2025-03-13,Joint,"INS Vote Tally Sheet (Joint Favorable Substitute)",13,0,0,0,13
1985607,1521181,2025-03-18,Joint,"HS Vote Tally Sheet (Joint Favorable Substitute)",22,0,0,1,23
1985607,1566632,2025-05-05,Joint,"APP Vote Tally Sheet (Joint Favorable Substitute)",44,6,0,3,53
1985611,1517626,2025-03-13,Joint,"LAB Vote Tally Sheet (Joint Favorable)",9,4,0,0,13
1985611,1566398,2025-05-05,Joint,"APP Vote Tally Sheet (Joint Favorable)",38,12,0,3,53
1985617,1515062,2025-03-11,Joint,"VA Vote Tally Sheet (Joint Favorable)",20,0,0,1,21
1985618,1520172,2025-03-18,Joint,"GOS Vote Tally Sheet (Joint Favorable)",12,0,0,0,12
1985624,1515343,2025-03-11,Joint,"VA Vote Tally Sheet (Joint Favorable)",20,0,0,1,21
1985627,1520365,2025-03-18,Joint,"PS Vote Tally Sheet (Joint Favorable Change of Reference)",29,0,0,0,29
1985627,1557978,2025-04-24,Joint,"APP Vote Tally Sheet (Joint Favorable Substitute)",54,0,0,0,54
1985630,1515274,2025-03-11,Joint,"BA Vote Tally Sheet (Joint Favorable)",13,0,0,0,13
1985646,1521833,2025-03-18,Joint,"HS Vote Tally Sheet (Joint Favorable)",15,7,0,1,23
1985647,1517864,2025-03-13,Joint,"HS Vote Tally Sheet (Joint Favorable)",22,0,0,1,23
1985647,1566223,2025-05-05,Joint,"APP Vote Tally Sheet (Joint Favorable)",42,8,0,3,53
1985650,1518069,2025-03-13,Joint,"HS Vote Tally Sheet (Joint Favorable)",18,4,0,1,23
1985650,1518070,2025-03-13,Joint,"HS Vote Tally Sheet-A (Change of Reference)",5,15,0,3,23
1985650,1518071,2025-03-13,Joint,"HS Vote Tally Sheet-A (MOTION FAILED)",5,15,0,3,23
1985654,1507675,2025-03-06,Joint,"LAB Vote Tally Sheet (Joint Favorable)",12,1,0,0,13
1985654,1563290,2025-04-30,Senate,"Senate Roll Call Vote 102 ",36,0,0,0,36
1985654,1567725,2025-05-07,House,"House Roll Call Vote 74 ",144,0,0,7,151
1985657,1515302,2025-03-11,Joint,"HED Vote Tally Sheet (Joint Favorable)",18,0,0,0,18
1985659,1515244,2025-03-11,Joint,"VA Vote Tally Sheet (Joint Favorable)",20,0,0,1,21
1985659,1540616,2025-04-07,Joint,"PD Vote Tally Sheet (Joint Favorable)",20,0,0,2,22
1985661,1520095,2025-03-18,Joint,"PS Vote Tally Sheet (Joint Favorable Substitute)",29,0,0,0,29
1985667,1518596,2025-03-13,Joint,"HED Vote Tally Sheet (Joint Favorable)",18,0,0,0,18
1985667,1565952,2025-05-05,Joint,"APP Vote Tally Sheet (Joint Favorable)",42,8,0,3,53
1985667,1576550,2025-05-22,Senate,"Senate Roll Call Vote 221 ",36,0,0,0,36
1985668,1520466,2025-03-18,Joint,"GOS Vote Tally Sheet (Joint Favorable)",12,0,0,0,12
1985668,1577065,2025-05-23,Joint,"APP Vote Tally Sheet (Joint Favorable)",48,4,0,1,53
1985668,1584859,2025-06-04,Senate,"Senate Roll Call Vote 387 ",36,0,0,0,36
1985674,1508858,2025-03-06,Joint,"HSG Vote Tally Sheet (Joint Favorable Substitute)",12,6,0,2,20
1985674,1564938,2025-05-05,Joint,"FIN Vote Tally Sheet (Joint Favorable)",35,17,0,2,54
1985677,1523967,2025-03-20,Joint,"CE Vote Tally Sheet (Joint Favorable)",20,0,0,0,20
1985677,1563251,2025-04-30,Senate,"Senate Roll Call Vote 103 ",36,0,0,0,36
1985677,1570120,2025-05-08,House,"House Roll Call Vote 75 AS AMENDED ",140,0,0,11,151
1985678,1515015,2025-03-11,Joint,"HED Vote Tally Sheet (Joint Favorable)",18,0,0,0,18
1985678,1542301,2025-04-09,Senate,"Senate Roll Call Vote 79 ",35,0,1,0,36
1985678,1574818,2025-05-20,House,"House Roll Call Vote 147 ",144,0,0,7,151
1985683,1515288,2025-03-11,Joint,"INS Vote Tally Sheet (Joint Favorable)",10,3,0,0,13
1985683,1565900,2025-05-05,Joint,"APP Vote Tally Sheet (Joint Favorable)",32,18,0,3,53
1985691,1513228,2025-03-11,Joint,"BA Vote Tally Sheet (Joint Favorable Substitute)",13,0,0,0,13
1985692,1520537,2025-03-18,Joint,"GOS Vote Tally Sheet (Joint Favorable)",8,4,0,0,12
1985698,1519519,2025-03-18,Joint,"CE Vote Tally Sheet (Joint Favorable)",20,0,0,0,20
1985700,1517939,2025-03-13,Joint,"HS Vote Tally Sheet (Joint Favorable Substitute)",16,6,0,1,23
1985700,1566625,2025-05-05,Joint,"APP Vote Tally Sheet (Joint Favorable)",38,12,0,3,53
1985705,1523052,2025-03-20,Joint,"LAB Vote Tally Sheet (Joint Favorable Substitute)",9,4,0,0,13
1985705,1568447,2025-05-08,Senate,"Senate Roll Call Vote 142 ",24,11,1,0,36
1985705,1568448,2025-05-08,Senate,"Senate Roll Call Vote 141 ",11,24,1,0,36
1985705,1568449,2025-05-08,Senate,"Senate Roll Call Vote 140 ",11,24,1,0,36
1985705,1583673,2025-06-02,House,"House Roll Call Vote 291 AS AMENDED ",102,46,0,3,151
1985714,1520025,2025-03-18,Joint,"GOS Vote Tally Sheet (Joint Favorable)",12,0,0,0,12
1985714,1569999,2025-05-12,Joint,"APP Vote Tally Sheet (Joint Favorable)",33,15,0,5,53
1985714,1574764,2025-05-20,Senate,"Senate Roll Call Vote 205 ",34,1,1,0,36
1985714,1578830,2025-05-22,House,"House Roll Call Vote 171 AS AMENDED ",92,46,0,13,151
1985716,1517950,2025-03-13,Joint,"INS Vote Tally Sheet (Joint Favorable)",11,2,0,0,13
1985725,1508879,2025-03-06,Joint,"HSG Vote Tally Sheet (Joint Favorable)",17,1,0,2,20
1985725,1508880,2025-03-06,Joint,"HSG Vote Tally Sheet-A (MOTION FAILED)",0,0,0,0,0
1985725,1519415,2025-03-06,Joint,"HSG Vote Tally Sheet-A",0,0,0,0,0
1985725,1519416,2025-03-06,Joint,"HSG Vote Tally Sheet (Joint Favorable Substitute)",17,1,0,2,20
1985725,1519417,2025-03-06,Joint,"HSG Vote Tally Sheet-A",0,0,0,0,0
1985725,1540544,2025-04-07,Joint,"PD Vote Tally Sheet (Joint Favorable)",15,5,0,2,22
1985732,1517875,2025-03-13,Joint,"HS Vote Tally Sheet (Joint Favorable)",17,5,0,1,23
1985732,1561509,2025-04-28,House,"House Roll Call Vote 48 AS AMENDED ",145,0,0,6,151
1985732,1580709,2025-05-28,Senate,"Senate Roll Call Vote 265 ",36,0,0,0,36
1985735,1515284,2025-03-11,Joint,"BA Vote Tally Sheet (Joint Favorable Substitute)",13,0,0,0,13
1985735,1566175,2025-05-05,Joint,"APP Vote Tally Sheet (Joint Favorable)",42,8,0,3,53
1985737,1521358,2025-03-18,Joint,"HS Vote Tally Sheet (Joint Favorable Substitute)",16,6,0,1,23
1985737,1574865,2025-05-20,House,"House Roll Call Vote 159 AS AMENDED ",141,5,0,5,151
1985743,1513237,2025-03-11,Joint,"BA Vote Tally Sheet (Joint Favorable Substitute)",13,0,0,0,13
1985743,1566627,2025-05-06,Joint,"JUD Vote Tally Sheet (Joint Favorable)",39,0,0,2,41
1985743,1569548,2025-05-12,Joint,"FIN Vote Tally Sheet (Joint Favorable)",41,13,0,0,54
1985746,1520458,2025-03-18,Joint,"GOS Vote Tally Sheet (Joint Favorable)",12,0,0,0,12
1985749,1517931,2025-03-13,Joint,"INS Vote Tally Sheet (Joint Favorable Substitute)",12,1,0,0,13
1985750,1520178,2025-03-18,Joint,"ET Vote Tally Sheet (Joint Favorable Substitute)",14,9,1,1,25
1985750,1520179,2025-03-18,Joint,"ET Vote Tally Sheet-A (MOTION FAILED)",7,15,0,3,25
1985750,1584512,2025-06-03,House,"House Roll Call Vote 299 AS AMENDED ",103,42,0,6,151
1985755,1520408,2025-03-18,Joint,"GOS Vote Tally Sheet (Joint Favorable Substitute)",12,0,0,0,12
1985755,1566522,2025-05-05,Joint,"APP Vote Tally Sheet (Joint Favorable)",41,8,0,4,53
1985755,1584737,2025-06-03,House,"House Roll Call Vote 318 AS AMENDED ",146,2,0,3,151
1985755,1585554,2025-06-04,Senate,"Senate Roll Call Vote 434 ",36,0,0,0,36
1985760,1523950,2025-03-20,Joint,"CE Vote Tally Sheet (Joint Favorable Substitute)",20,0,0,0,20
1985760,1581146,2025-05-28,House,"House Roll Call Vote 209 AS AMENDED ",147,0,0,4,151
1985760,1582331,2025-05-30,Senate,"Senate Roll Call Vote 306 ",36,0,0,0,36
1985763,1515260,2025-03-11,Joint,"VA Vote Tally Sheet (Joint Favorable Change of Reference)",20,0,0,1,21
1985765,1513026,2025-03-11,Joint,"BA Vote Tally Sheet (Joint Favorable)",13,0,0,0,13
1985765,1569596,2025-05-12,Joint,"APP Vote Tally Sheet (Joint Favorable)",35,13,0,5,53
1985765,1582204,2025-05-30,Senate,"Senate Roll Call Vote 298 ",32,3,1,0,36
1985765,1585248,2025-06-04,House,"House Roll Call Vote 349 AS AMENDED ",101,46,0,4,151
1985768,1515222,2025-03-11,Joint,"HED Vote Tally Sheet (Joint Favorable)",18,0,0,0,18
1985768,1564415,2025-05-01,House,"House Roll Call Vote 60 AS AMENDED ",146,0,0,5,151
1985768,1585136,2025-06-04,Senate,"Senate Roll Call Vote 373 ",36,0,0,0,36
1985771,1518006,2025-03-13,Joint,"HS Vote Tally Sheet (Joint Favorable)",16,6,0,1,23
1985771,1566640,2025-05-05,Joint,"APP Vote Tally Sheet (Joint Favorable)",38,12,0,3,53
1985772,1517723,2025-03-13,Joint,"CE Vote Tally Sheet (Joint Favorable Substitute)",20,0,0,0,20
1985772,1561993,2025-04-30,Senate,"Senate Roll Call Vote 95 ",36,0,0,0,36
1985772,1585137,2025-06-03,House,"House Roll Call Vote 319 ",148,0,0,3,151
1986253,1501603,2025-02-26,Joint,"JUD Vote Tally Sheet (Joint Favorable)",33,6,0,2,41
1986253,1506415,2025-03-05,House,"House Roll Call Vote 39 ",120,25,0,5,150
1986253,1506416,2025-03-05,Senate,"Senate Roll Call Vote 54 ",28,7,1,0,36
1986265,1505996,2025-02-26,Joint,"JUD Vote Tally Sheet (Joint Favorable)",39,0,0,2,41
1986265,1506132,2025-03-05,Senate,"Senate Roll Call Vote 52 ",35,0,1,0,36
1986265,1509093,2025-03-05,House,"House Roll Call Vote 40 CONSENT CALENDAR ",145,0,0,5,150
1986279,1501612,2025-02-26,Joint,"JUD Vote Tally Sheet (Joint Favorable)",39,0,0,2,41
1986279,1506748,2025-03-05,Senate,"Senate Roll Call Vote 57 ",35,0,1,0,36
1986279,1511646,2025-03-05,House,"House Roll Call Vote 40 CONSENT CALENDAR ",145,0,0,5,150
1986291,1501606,2025-02-26,Joint,"JUD Vote Tally Sheet (Joint Favorable)",39,0,0,2,41
1986291,1506591,2025-03-05,Senate,"Senate Roll Call Vote 56 ",35,0,1,0,36
1986291,1509741,2025-03-05,House,"House Roll Call Vote 40 CONSENT CALENDAR ",145,0,0,5,150
1986303,1501600,2025-02-26,Joint,"JUD Vote Tally Sheet (Joint Favorable)",38,1,0,2,41
1986303,1506367,2025-03-05,Senate,"Senate Roll Call Vote 53 ",34,1,1,0,36
1986303,1509522,2025-03-05,House,"House Roll Call Vote 40 CONSENT CALENDAR ",145,0,0,5,150
1986310,1501930,2025-02-26,Joint,"JUD Vote Tally Sheet (Joint Favorable)",37,1,0,3,41
1986310,1509150,2025-03-05,House,"House Roll Call Vote 32 CONSENT CALENDAR ",147,0,0,3,150
1986310,1509151,2025-03-05,Senate,"Senate Roll Call Vote 64 ",30,1,5,0,36
1986355,1501932,2025-02-26,Joint,"JUD Vote Tally Sheet (Joint Favorable)",39,0,0,2,41
1986355,1506822,2025-03-05,Senate,"Senate Roll Call Vote 66 ",31,0,5,0,36
1986355,1511858,2025-03-05,House,"House Roll Call Vote 32 CONSENT CALENDAR ",147,0,0,3,150
1986405,1501928,2025-02-26,Joint,"JUD Vote Tally Sheet (Joint Favorable)",36,0,2,3,41
1986405,1506445,2025-03-05,Senate,"Senate Roll Call Vote 71 ",31,0,5,0,36
1986405,1506446,2025-03-05,House,"House Roll Call Vote 33 ",144,0,0,6,150
1986457,1501918,2025-02-26,Joint,"JUD Vote Tally Sheet (Joint Favorable)",39,0,0,2,41
1986457,1506865,2025-03-05,House,"House Roll Call Vote 37 ",145,0,0,5,150
1986457,1506866,2025-03-05,Senate,"Senate Roll Call Vote 51 ",35,0,1,0,36
1986505,1501927,2025-02-26,Joint,"JUD Vote Tally Sheet (Joint Favorable)",39,0,0,2,41
1986505,1506751,2025-03-05,Senate,"Senate Roll Call Vote 58 ",35,0,1,0,36
1986505,1511677,2025-03-05,House,"House Roll Call Vote 40 CONSENT CALENDAR ",145,0,0,5,150
1986557,1501941,2025-02-26,Joint,"JUD Vote Tally Sheet (Joint Favorable)",39,0,0,2,41
1986557,1506492,2025-03-05,Senate,"Senate Roll Call Vote 67 ",31,0,5,0,36
1986557,1509633,2025-03-05,House,"House Roll Call Vote 32 CONSENT CALENDAR ",147,0,0,3,150
1986609,1501940,2025-02-26,Joint,"JUD Vote Tally Sheet (Joint Favorable)",39,0,0,2,41
1986609,1506646,2025-03-05,Senate,"Senate Roll Call Vote 69 ",31,0,5,0,36
1986609,1511384,2025-03-05,House,"House Roll Call Vote 32 CONSENT CALENDAR ",147,0,0,3,150
1986655,1501943,2025-02-26,Joint,"JUD Vote Tally Sheet (Joint Favorable)",39,0,0,2,41
1986655,1506847,2025-03-05,Senate,"Senate Roll Call Vote 70 ",31,0,5,0,36
1986655,1511939,2025-03-05,House,"House Roll Call Vote 32 CONSENT CALENDAR ",147,0,0,3,150
1986702,1501946,2025-02-26,Joint,"JUD Vote Tally Sheet (Joint Favorable)",39,0,0,2,41
1986702,1506738,2025-03-05,House,"House Roll Call Vote 40 CONSENT CALENDAR ",145,0,0,5,150
1986702,1506739,2025-03-05,Senate,"Senate Roll Call Vote 59 ",35,0,1,0,36
1986750,1501944,2025-02-26,Joint,"JUD Vote Tally Sheet (Joint Favorable)",39,0,0,2,41
1986750,1506820,2025-03-05,Senate,"Senate Roll Call Vote 63 ",32,0,4,0,36
1986750,1506821,2025-03-05,House,"House Roll Call Vote 32 CONSENT CALENDAR ",147,0,0,3,150
1986803,1501959,2025-02-26,Joint,"JUD Vote Tally Sheet (Joint Favorable)",39,0,0,2,41
1986803,1506781,2025-03-05,Senate,"Senate Roll Call Vote 68 ",31,0,5,0,36
1986803,1511726,2025-03-05,House,"House Roll Call Vote 32 CONSENT CALENDAR ",147,0,0,3,150
1986851,1501960,2025-02-26,Joint,"JUD Vote Tally Sheet (Joint Favorable)",36,3,0,2,41
1986851,1506805,2025-03-05,House,"House Roll Call Vote 38 ",137,8,0,5,150
1986851,1506806,2025-03-05,Senate,"Senate Roll Call Vote 55 ",34,1,1,0,36
1987609,1502085,2025-02-26,Joint,"JUD Vote Tally Sheet (Joint Favorable)",39,0,0,2,41
1987609,1506776,2025-03-05,Senate,"Senate Roll Call Vote 72 ",31,0,5,0,36
1987609,1511678,2025-03-05,House,"House Roll Call Vote 32 CONSENT CALENDAR ",147,0,0,3,150
1987626,1516597,2025-03-12,Joint,"GAE Vote Tally Sheet (Joint Favorable)",14,5,0,0,19
1987637,1516572,2025-03-12,Joint,"GAE Vote Tally Sheet (Joint Favorable)",19,0,0,0,19
1987637,1577978,2025-05-23,Senate,"Senate Roll Call Vote 234 ",36,0,0,0,36
1987650,1522124,2025-03-19,Joint,"GAE Vote Tally Sheet (Joint Favorable Substitute)",13,6,0,0,19
1987662,1516592,2025-03-12,Joint,"GAE Vote Tally Sheet (Joint Favorable)",19,0,0,0,19
1987662,1548972,2025-04-14,Joint,"PD Vote Tally Sheet (Joint Favorable)",20,0,0,2,22
1987673,1516579,2025-03-12,Joint,"GAE Vote Tally Sheet (Joint Favorable)",19,0,0,0,19
1987673,1543182,2025-04-09,House,"House Roll Call Vote 43 ",147,0,0,3,150
1987673,1568128,2025-05-08,Senate,"Senate Roll Call Vote 132 ",10,26,0,0,36
1987673,1568129,2025-05-08,Senate,"Senate Roll Call Vote 131 ",11,25,0,0,36
1987673,1570158,2025-05-08,Senate,"Senate Roll Call Vote 133 ",36,0,0,0,36
1987688,1537712,2025-04-04,Joint,"JUD Vote Tally Sheet (Joint Favorable Substitute)",41,0,0,0,41
1987688,1537713,2025-04-04,Joint,"JUD Vote Tally Sheet-A (Joint Favorable Substitute)",0,0,0,0,0
1987698,1528697,2025-03-26,Joint,"GAE Vote Tally Sheet (Joint Favorable)",19,0,0,0,19
1987711,1529213,2025-03-26,Joint,"GAE Vote Tally Sheet (Joint Favorable)",16,3,0,0,19
1987726,1529987,2025-03-26,Joint,"GAE Vote Tally Sheet (Joint Favorable)",13,6,0,0,19
1987734,1541244,2025-04-08,Joint,"JUD Vote Tally Sheet (Joint Favorable)",29,12,0,0,41
1987747,1537624,2025-04-04,Joint,"JUD Vote Tally Sheet (Joint Favorable)",41,0,0,0,41
1987759,1516740,2025-03-12,Joint,"GAE Vote Tally Sheet (Joint Favorable Substitute)",19,0,0,0,19
1987759,1568825,2025-05-08,Senate,"Senate Roll Call Vote 139 ",35,0,1,0,36
1987759,1584986,2025-06-02,House,"House Roll Call Vote 274 AS AMENDED ",148,0,0,3,151
1987783,1541258,2025-04-08,Joint,"JUD Vote Tally Sheet (Joint Favorable Substitute)",41,0,0,0,41
1987783,1541259,2025-04-08,Joint,"JUD Vote Tally Sheet-A (Joint Favorable Substitute)",0,0,0,0,0
1987783,1567574,2025-05-07,Senate,"Senate Roll Call Vote 121 ",36,0,0,0,36
1987795,1519146,2025-03-13,Joint,"HED Vote Tally Sheet (Joint Favorable Substitute)",17,1,0,0,18
1987795,1582143,2025-05-29,House,"House Roll Call Vote 231 AS AMENDED ",148,0,0,3,151
1987795,1585649,2025-06-04,Senate,"Senate Roll Call Vote 418 ",36,0,0,0,36
1987808,1529550,2025-03-26,Joint,"GAE Vote Tally Sheet (Joint Favorable Substitute)",13,6,0,0,19
1987818,1541273,2025-04-08,Joint,"JUD Vote Tally Sheet (Joint Favorable)",41,0,0,0,41
1987818,1583687,2025-06-02,Senate,"Senate Roll Call Vote 343 ",36,0,0,0,36
1987827,1539243,2025-04-07,Joint,"JUD Vote Tally Sheet (Joint Favorable Substitute)",40,1,0,0,41
1987827,1568792,2025-05-08,House,"House Roll Call Vote 84 AS AMENDED ",143,0,0,8,151
1987827,1568793,2025-05-08,House,"House Roll Call Vote 83 HOUSE AMD B",63,79,0,9,151
1987827,1576700,2025-05-22,Senate,"Senate Roll Call Vote 224 ",35,0,1,0,36
1987827,1576701,2025-05-22,Senate,"Senate Roll Call Vote 223 ",12,24,0,0,36
1989011,1541241,2025-04-08,Joint,"JUD Vote Tally Sheet (Joint Favorable Substitute)",41,0,0,0,41
1989011,1574753,2025-05-20,Senate,"Senate Roll Call Vote 202 ",35,0,1,0,36
1989091,1537629,2025-04-04,Joint,"JUD Vote Tally Sheet (Joint Favorable)",35,6,0,0,41
1989091,1580978,2025-05-28,House,"House Roll Call Vote 208 AS AMENDED ",148,0,0,3,151
1989091,1583651,2025-06-02,Senate,"Senate Roll Call Vote 347 ",36,0,0,0,36
1989171,1537620,2025-04-04,Joint,"JUD Vote Tally Sheet (Joint Favorable Substitute)",30,11,0,0,41
1990129,1540722,2025-04-08,Joint,"JUD Vote Tally Sheet (Joint Favorable)",41,0,0,0,41
1990129,1574678,2025-05-20,Senate,"Senate Roll Call Vote 201 ",35,0,1,0,36
1990151,1539104,2025-04-07,Joint,"JUD Vote Tally Sheet (Joint Favorable Substitute)",41,0,0,0,41
1990170,1539273,2025-04-07,Joint,"JUD Vote Tally Sheet (Joint Favorable Substitute)",41,0,0,0,41
1990170,1571779,2025-05-14,House,"House Roll Call Vote 112 AS AMENDED ",147,0,0,4,151
1990170,1583569,2025-06-02,Senate,"Senate Roll Call Vote 349 ",36,0,0,0,36
1990190,1545245,2025-04-10,Joint,"JUD Vote Tally Sheet (Joint Favorable)",35,4,0,2,41
1990190,1571040,2025-05-14,Joint,"INS Vote Tally Sheet (Joint Favorable)",8,5,0,0,13
1990214,1546117,2025-04-10,Joint,"JUD Vote Tally Sheet (Joint Favorable)",39,0,0,2,41
1990214,1570919,2025-05-13,House,"House Roll Call Vote 96 ",147,0,0,4,151
1990214,1580628,2025-05-28,Senate,"Senate Roll Call Vote 257 ",36,0,0,0,36
1990234,1539203,2025-04-07,Joint,"JUD Vote Tally Sheet (Joint Favorable)",30,11,0,0,41
1990277,1545786,2025-04-07,Joint,"JUD Vote Tally Sheet (Joint Favorable Substitute)",35,6,0,0,41
1990956,1509010,2025-03-05,House,"House Roll Call Vote 34 EMERGENCY CERTIFICATION ",106,40,0,4,150
1990956,1509011,2025-03-05,Senate,"Senate Roll Call Vote 40 ",33,1,2,0,36
1991216,1524032,2025-03-19,Joint,"TRA Vote Tally Sheet (Joint Favorable Substitute)",35,0,0,0,35
1991220,1524227,2025-03-19,Joint,"TRA Vote Tally Sheet (Joint Favorable Substitute)",22,12,0,1,35
1991220,1565161,2025-05-05,Joint,"FIN Vote Tally Sheet (Joint Favorable)",35,17,0,2,54
1991231,1529121,2025-03-27,Joint,"PH Vote Tally Sheet (Joint Favorable Substitute)",23,7,0,2,32
1991231,1572537,2025-05-15,House,"House Roll Call Vote 123 AS AMENDED ",105,42,0,4,151
1991238,1524969,2025-03-21,Joint,"PD Vote Tally Sheet (Joint Favorable)",12,7,0,3,22
1991238,1582114,2025-05-30,Senate,"Senate Roll Call Vote 300 ",33,3,0,0,36
1991238,1584471,2025-06-03,House,"House Roll Call Vote 310 AS AMENDED ",105,43,0,3,151
1991248,1516544,2025-03-12,Joint,"PH Vote Tally Sheet (Joint Favorable Substitute)",32,0,0,0,32
1991248,1576713,2025-05-22,House,"House Roll Call Vote 174 ",147,1,0,3,151
1991248,1583604,2025-06-02,Senate,"Senate Roll Call Vote 338 ",36,0,0,0,36
1991254,1524670,2025-03-21,Joint,"PD Vote Tally Sheet (Joint Favorable)",15,4,0,3,22
1991263,1524023,2025-03-19,Joint,"TRA Vote Tally Sheet (Joint Favorable Substitute)",22,12,0,1,35
1991263,1566190,2025-05-05,Joint,"APP Vote Tally Sheet (Joint Favorable)",38,12,0,3,53
1991263,1576592,2025-05-22,House,"House Roll Call Vote 184 AS AMENDED ",126,21,0,4,151
1991263,1582144,2025-05-30,Senate,"Senate Roll Call Vote 299 ",33,3,0,0,36
1991268,1524915,2025-03-21,Joint,"PD Vote Tally Sheet (Joint Favorable)",11,8,0,3,22
1991278,1524575,2025-03-21,Joint,"PD Vote Tally Sheet (Joint Favorable Substitute)",11,8,0,3,22
1991284,1525129,2025-03-21,Joint,"PD Vote Tally Sheet (Joint Favorable Substitute)",19,0,0,3,22
1991284,1576443,2025-05-22,House,"House Roll Call Vote 185 AS AMENDED ",146,0,0,5,151
1991284,1584453,2025-06-04,Senate,"Senate Roll Call Vote 364 ",36,0,0,0,36
1991292,1524693,2025-03-21,Joint,"PD Vote Tally Sheet (Joint Favorable Substitute)",19,0,0,3,22
1991299,1524370,2025-03-21,Joint,"PH Vote Tally Sheet (Joint Favorable Substitute)",29,3,0,0,32
1991299,1569936,2025-05-12,Joint,"APP Vote Tally Sheet (Joint Favorable)",43,4,0,6,53
1991299,1580911,2025-05-28,Senate,"Senate Roll Call Vote 258 ",35,0,1,0,36
1991299,1584514,2025-06-03,House,"House Roll Call Vote 316 AS AMENDED ",147,0,0,4,151
1991299,1585443,2025-06-04,Senate,"Senate Roll Call Vote 394 ",35,0,1,0,36
1991314,1524166,2025-03-21,Joint,"PH Vote Tally Sheet (Joint Favorable Substitute)",32,0,0,0,32
1991314,1582762,2025-05-31,House,"House Roll Call Vote 254 AS AMENDED ",145,0,0,6,151
1991314,1583677,2025-06-02,Senate,"Senate Roll Call Vote 336 ",36,0,0,0,36
1991321,1515857,2025-03-12,Joint,"PH Vote Tally Sheet (Joint Favorable Substitute)",32,0,0,0,32
1991335,1524726,2025-03-21,Joint,"PD Vote Tally Sheet (Joint Favorable)",19,0,0,3,22
1991335,1582038,2025-05-29,House,"House Roll Call Vote 235 ",147,0,0,4,151
1991335,1583627,2025-06-02,Senate,"Senate Roll Call Vote 348 ",36,0,0,0,36
1991346,1525077,2025-03-21,Joint,"PD Vote Tally Sheet (Joint Favorable)",16,3,0,3,22
1991350,1545347,2025-04-10,Joint,"JUD Vote Tally Sheet (Joint Favorable)",31,8,0,2,41
1991371,1524219,2025-03-19,Joint,"TRA Vote Tally Sheet (Joint Favorable Substitute)",23,12,0,0,35
1991379,1545355,2025-04-10,Joint,"JUD Vote Tally Sheet (Joint Favorable Substitute)",39,0,0,2,41
1991386,1545219,2025-04-10,Joint,"JUD Vote Tally Sheet (Joint Favorable)",39,0,0,2,41
1991386,1571465,2025-05-14,Senate,"Senate Roll Call Vote 165 ",34,2,0,0,36
1991386,1571466,2025-05-14,Senate,"Senate Roll Call Vote 164 ",11,25,0,0,36
1991391,1523992,2025-03-19,Joint,"TRA Vote Tally Sheet (Joint Favorable Substitute)",35,0,0,0,35
1991409,1530895,2025-03-28,Joint,"PD Vote Tally Sheet (Joint Favorable Substitute)",21,0,0,1,22
1991409,1585351,2025-06-04,House,"House Roll Call Vote 342 AS AMENDED ",145,0,0,6,151
1991416,1523998,2025-03-19,Joint,"TRA Vote Tally Sheet (Joint Favorable Substitute)",33,2,0,0,35
1991416,1566426,2025-05-05,Joint,"APP Vote Tally Sheet (Joint Favorable)",38,12,0,3,53
1991416,1582287,2025-05-30,House,"House Roll Call Vote 237 HOUSE AMD A",114,31,0,6,151
1991416,1582734,2025-05-31,House,"House Roll Call Vote 252 AS AMENDED ",140,5,0,6,151
1991416,1584628,2025-06-04,Senate,"Senate Roll Call Vote 385 ",35,1,0,0,36
1991422,1523974,2025-03-19,Joint,"TRA Vote Tally Sheet (Joint Favorable Substitute)",22,12,0,1,35
1991422,1565044,2025-05-05,Joint,"FIN Vote Tally Sheet (Joint Favorable)",34,18,0,2,54
1991429,1531069,2025-03-28,Joint,"PD Vote Tally Sheet (Joint Favorable Substitute)",21,0,0,1,22
1991429,1585438,2025-06-04,House,"House Roll Call Vote 359 AS AMENDED ",150,0,0,1,151
1991442,1506539,2025-03-05,Senate,"Senate Roll Call Vote 62 ",26,7,3,0,36
1991442,1506540,2025-03-05,Senate,"Senate Roll Call Vote 61 ",10,23,3,0,36
1991442,1506541,2025-03-05,House,"House Roll Call Vote 31 EMERGENCY CERTIFICATION ",117,29,0,4,150
1991442,1506542,2025-03-05,House,"House Roll Call Vote 30 EMERGENCY CERTIFICATION HOUSE AMD B",47,98,0,5,150
1991442,1506543,2025-03-05,Senate,"Senate Roll Call Vote 60 ",12,23,1,0,36
1991513,1506131,2025-03-05,Senate,"Senate Roll Call Vote 41 ",24,10,2,0,36
1991513,1506472,2025-03-05,House,"House Roll Call Vote 36 AS AMENDED ",92,51,0,7,150
1991513,1506473,2025-03-05,House,"House Roll Call Vote 35 EMERGENCY CERTIFICATION HOUSE AMD A",47,98,0,5,150
1991513,1506474,2025-03-05,Senate,"Senate Roll Call Vote 43 ",25,10,1,0,36
1991513,1506475,2025-03-05,Senate,"Senate Roll Call Vote 42 ",11,23,2,0,36
1992701,1520632,2025-03-18,Joint,"LAB Vote Tally Sheet (Joint Favorable)",10,3,0,0,13
1992702,1524988,2025-03-24,Joint,"GL Vote Tally Sheet (Joint Favorable)",22,0,0,0,22
1992702,1558674,2025-04-25,Joint,"JUD Vote Tally Sheet (Joint Favorable Substitute)",37,0,0,4,41
1992702,1569481,2025-05-12,Joint,"APP Vote Tally Sheet (Joint Favorable)",33,15,0,5,53
1992702,1584483,2025-06-03,House,"House Roll Call Vote 295 AS AMENDED ",116,22,0,13,151
1992702,1584876,2025-06-04,Senate,"Senate Roll Call Vote 395 ",36,0,0,0,36
1992709,1530324,2025-03-28,Joint,"ENV Vote Tally Sheet (Joint Favorable Substitute)",33,0,0,1,34
1992713,1524935,2025-03-24,Joint,"GL Vote Tally Sheet (Joint Favorable Substitute)",16,6,0,0,22
1992713,1566186,2025-05-05,Joint,"APP Vote Tally Sheet (Joint Favorable)",38,12,0,3,53
1992713,1585323,2025-06-04,House,"House Roll Call Vote 377 AS AMENDED ",145,4,0,2,151
1992716,1519745,2025-03-18,Joint,"GOS Vote Tally Sheet (Joint Favorable Substitute)",9,3,0,0,12
1992716,1580126,2025-05-28,Senate,"Senate Roll Call Vote 253 ",36,0,0,0,36
1992716,1585453,2025-06-04,House,"House Roll Call Vote 341 AS AMENDED ",138,0,0,13,151
1992718,1530773,2025-03-28,Joint,"ED Vote Tally Sheet (Joint Favorable)",42,0,0,3,45
1992721,1516974,2025-03-13,Joint,"CE Vote Tally Sheet (Joint Favorable)",20,0,0,0,20
1992721,1542541,2025-04-09,Senate,"Senate Roll Call Vote 78 ",35,0,1,0,36
1992721,1582892,2025-05-31,House,"House Roll Call Vote 264 ",144,0,0,7,151
1992724,1520500,2025-03-18,Joint,"GOS Vote Tally Sheet (Joint Favorable Substitute)",12,0,0,0,12
1992727,1519647,2025-03-18,Joint,"PS Vote Tally Sheet (Joint Favorable)",26,3,0,0,29
1992727,1570624,2025-05-13,House,"House Roll Call Vote 101 ",146,0,0,5,151
1992727,1582191,2025-05-30,Senate,"Senate Roll Call Vote 307 ",36,0,0,0,36
1992732,1519929,2025-03-18,Joint,"GOS Vote Tally Sheet (Joint Favorable Substitute)",12,0,0,0,12
1992732,1565046,2025-05-05,Joint,"FIN Vote Tally Sheet (Joint Favorable)",52,0,0,2,54
1992738,1520005,2025-03-18,Joint,"PS Vote Tally Sheet (Joint Favorable Substitute)",29,0,0,0,29
1992738,1565716,2025-05-05,Joint,"APP Vote Tally Sheet (Joint Favorable)",50,0,0,3,53
1992738,1582647,2025-05-31,House,"House Roll Call Vote 256 ",143,0,0,8,151
1992739,1520147,2025-03-18,Joint,"PS Vote Tally Sheet (Joint Favorable Substitute)",29,0,0,0,29
1992739,1568076,2025-05-08,Senate,"Senate Roll Call Vote 130 ",36,0,0,0,36
1992743,1519693,2025-03-18,Joint,"PS Vote Tally Sheet (Joint Favorable)",29,0,0,0,29
1992743,1568821,2025-05-08,Senate,"Senate Roll Call Vote 144 ",35,0,1,0,36
1992744,1521272,2025-03-18,Joint,"HS Vote Tally Sheet (Joint Favorable Substitute)",17,5,0,1,23
1992748,1524315,2025-03-21,Joint,"GL Vote Tally Sheet (Joint Favorable)",21,0,0,1,22
1992752,1517898,2025-03-13,Joint,"HS Vote Tally Sheet-A (Change of Reference)",6,15,0,2,23
1992752,1517899,2025-03-13,Joint,"HS Vote Tally Sheet-A (MOTION FAILED)",6,15,0,2,23
1992752,1517900,2025-03-13,Joint,"HS Vote Tally Sheet (Joint Favorable)",16,6,0,1,23
1992752,1574542,2025-05-20,Senate,"Senate Roll Call Vote 200 ",24,11,1,0,36
1992753,1517892,2025-03-13,Joint,"HS Vote Tally Sheet (Joint Favorable)",20,2,0,1,23
1992756,1528012,2025-03-24,Joint,"ENV Vote Tally Sheet (Joint Favorable Change of Reference)",32,0,0,2,34
1992761,1517866,2025-03-13,Joint,"HS Vote Tally Sheet (Joint Favorable)",15,7,0,1,23
1992764,1527789,2025-03-24,Joint,"ENV Vote Tally Sheet (Joint Favorable Substitute)",24,9,0,1,34
1992764,1558740,2025-04-25,Joint,"PD Vote Tally Sheet (Joint Favorable)",12,6,0,4,22
1992764,1558741,2025-04-25,Joint,"PD Vote Tally Sheet-A (Joint Favorable)",3,10,0,9,22
1992764,1558742,2025-04-25,Joint,"PD Vote Tally Sheet-B",3,9,0,10,22
1992764,1558743,2025-04-25,Joint,"PD Vote Tally Sheet-C",3,11,0,8,22
1992764,1558744,2025-04-25,Joint,"PD Vote Tally Sheet-D",3,11,0,8,22
1992764,1558745,2025-04-25,Joint,"PD Vote Tally Sheet-E",3,11,0,8,22
1992764,1581929,2025-05-29,House,"House Roll Call Vote 233 AS AMENDED ",146,1,0,4,151
1992764,1584493,2025-06-04,Senate,"Senate Roll Call Vote 370 ",36,0,0,0,36
1992765,1518081,2025-03-13,Joint,"HS Vote Tally Sheet (Joint Favorable)",16,6,0,1,23
1992768,1520237,2025-03-18,Joint,"PS Vote Tally Sheet (Joint Favorable Substitute)",29,0,0,0,29
1992770,1519535,2025-03-18,Joint,"CE Vote Tally Sheet (Joint Favorable Substitute)",20,0,0,0,20
1992776,1517784,2025-03-13,Joint,"LAB Vote Tally Sheet (Joint Favorable)",9,4,0,0,13
1992778,1538816,2025-04-07,Joint,"JUD Vote Tally Sheet (Joint Favorable Substitute)",41,0,0,0,41
1992788,1528192,2025-03-24,Joint,"ENV Vote Tally Sheet (Joint Favorable)",32,0,0,2,34
1992791,1517858,2025-03-13,Joint,"HS Vote Tally Sheet (Joint Favorable)",21,1,0,1,23
1992791,1566400,2025-05-05,Joint,"APP Vote Tally Sheet (Joint Favorable)",50,0,0,3,53
1992791,1583657,2025-06-03,House,"House Roll Call Vote 292 AS AMENDED ",147,0,0,4,151
1992796,1524963,2025-03-21,Joint,"ED Vote Tally Sheet (Joint Favorable Substitute)",37,7,0,1,45
1992799,1519735,2025-03-18,Joint,"GOS Vote Tally Sheet (Joint Favorable Substitute)",12,0,0,0,12
1992800,1517872,2025-03-13,Joint,"HS Vote Tally Sheet (Joint Favorable)",19,3,0,1,23
1992800,1548409,2025-04-15,Joint,"INS Vote Tally Sheet (Joint Favorable)",8,5,0,0,13
1992800,1566555,2025-05-05,Joint,"APP Vote Tally Sheet (Joint Favorable Substitute)",44,6,0,3,53
1992800,1585333,2025-06-04,Senate,"Senate Roll Call Vote 437 ",32,4,0,0,36
1992800,1585334,2025-06-04,House,"House Roll Call Vote 345 AS AMENDED ",142,5,0,4,151
1992804,1520545,2025-03-18,Joint,"PS Vote Tally Sheet (Joint Favorable)",29,0,0,0,29
1992804,1548829,2025-04-15,Senate,"Senate Roll Call Vote 92 ",27,4,5,0,36
1992804,1585402,2025-06-04,House,"House Roll Call Vote 374 ",122,28,0,1,151
1992807,1517897,2025-03-13,Joint,"HS Vote Tally Sheet (Joint Favorable Substitute)",22,0,0,1,23
1992808,1557874,2025-04-24,Joint,"FIN Vote Tally Sheet (Joint Favorable Substitute)",52,0,0,0,52
1992815,1526878,2025-03-24,Joint,"ED Vote Tally Sheet (Joint Favorable Change of Reference)",30,15,0,0,45
1992818,1520620,2025-03-18,Joint,"GOS Vote Tally Sheet (Joint Favorable Substitute)",12,0,0,0,12
1992818,1548872,2025-04-15,Joint,"INS Vote Tally Sheet (Joint Favorable)",12,1,0,0,13
1992820,1520979,2025-03-18,Joint,"HS Vote Tally Sheet (Joint Favorable)",16,6,0,1,23
1992823,1519851,2025-03-18,Joint,"GOS Vote Tally Sheet (Joint Favorable)",11,1,0,0,12
1992824,1523268,2025-03-20,Joint,"LAB Vote Tally Sheet (Joint Favorable Substitute)",9,4,0,0,13
1992824,1565869,2025-05-06,Joint,"JUD Vote Tally Sheet (Joint Favorable)",28,11,0,2,41
1992827,1528091,2025-03-24,Joint,"ENV Vote Tally Sheet (Joint Favorable Substitute)",32,0,0,2,34
1992836,1517881,2025-03-13,Joint,"HS Vote Tally Sheet-A (Change of Reference)",5,15,0,3,23
1992836,1517882,2025-03-13,Joint,"HS Vote Tally Sheet (Joint Favorable)",15,7,0,1,23
1992836,1517883,2025-03-13,Joint,"HS Vote Tally Sheet-A (MOTION FAILED)",5,15,0,3,23
1992840,1517024,2025-03-13,Joint,"CE Vote Tally Sheet (Joint Favorable Change of Reference)",20,0,0,0,20
1992840,1558436,2025-04-24,Joint,"APP Vote Tally Sheet (Joint Favorable)",44,10,0,0,54
1992842,1556464,2025-04-24,Joint,"FIN Vote Tally Sheet (Joint Favorable Substitute)",52,0,0,0,52
1992844,1557897,2025-04-24,Joint,"FIN Vote Tally Sheet (Joint Favorable)",50,2,0,0,52
1992849,1523752,2025-03-20,Joint,"LAB Vote Tally Sheet (Joint Favorable Substitute)",9,4,0,0,13
1992849,1572699,2025-05-16,Joint,"APP Vote Tally Sheet (Joint Favorable)",36,13,0,4,53
1992854,1524797,2025-03-24,Joint,"GL Vote Tally Sheet (Joint Favorable)",22,0,0,0,22
1992855,1517913,2025-03-13,Joint,"HS Vote Tally Sheet (Joint Favorable)",17,5,0,1,23
1992855,1564445,2025-05-01,Senate,"Senate Roll Call Vote 105 ",36,0,0,0,36
1992855,1582917,2025-05-31,House,"House Roll Call Vote 265 ",142,0,0,9,151
1992862,1517914,2025-03-13,Joint,"HS Vote Tally Sheet (Joint Favorable)",22,0,0,1,23
1992865,1517239,2025-03-13,Joint,"LAB Vote Tally Sheet (Joint Favorable)",9,4,0,0,13
1992866,1520166,2025-03-18,Joint,"PS Vote Tally Sheet (Joint Favorable)",29,0,0,0,29
1992866,1584477,2025-06-03,House,"House Roll Call Vote 317 AS AMENDED ",146,2,0,3,151
1992866,1585295,2025-06-04,Senate,"Senate Roll Call Vote 422 ",36,0,0,0,36
1992871,1521282,2025-03-18,Joint,"HS Vote Tally Sheet (Joint Favorable Substitute)",22,0,0,1,23
1992872,1517857,2025-03-13,Joint,"HS Vote Tally Sheet (Joint Favorable)",17,5,0,1,23
1992882,1517891,2025-03-13,Joint,"HS Vote Tally Sheet (Joint Favorable)",15,7,0,1,23
1992885,1528056,2025-03-24,Joint,"ENV Vote Tally Sheet (Joint Favorable)",32,0,0,2,34
1992885,1585227,2025-06-04,Senate,"Senate Roll Call Vote 430 ",36,0,0,0,36
1992885,1585228,2025-06-04,House,"House Roll Call Vote 353 AS AMENDED ",149,0,0,2,151
1992886,1541214,2025-04-08,Joint,"JUD Vote Tally Sheet (Joint Favorable)",41,0,0,0,41
1992886,1566279,2025-05-05,Joint,"APP Vote Tally Sheet (Joint Favorable)",38,12,0,3,53
1992892,1524914,2025-03-21,Joint,"ED Vote Tally Sheet (Joint Favorable Change of Reference)",44,0,0,1,45
1992892,1558586,2025-04-24,Joint,"APP Vote Tally Sheet (Joint Favorable Substitute)",54,0,0,0,54
1992894,1520606,2025-03-18,Joint,"PS Vote Tally Sheet (Joint Favorable)",18,11,0,0,29
1992894,1564321,2025-05-01,Senate,"Senate Roll Call Vote 107 ",25,11,0,0,36
1992894,1564322,2025-05-01,Senate,"Senate Roll Call Vote 106 ",11,25,0,0,36
1992897,1517778,2025-03-13,Joint,"LAB Vote Tally Sheet (Joint Favorable)",9,4,0,0,13
1992897,1572240,2025-05-14,Senate,"Senate Roll Call Vote 162 ",27,8,1,0,36
1992900,1520544,2025-03-18,Joint,"PS Vote Tally Sheet (Joint Favorable)",29,0,0,0,29
1992900,1565922,2025-05-05,Joint,"APP Vote Tally Sheet (Joint Favorable)",38,12,0,3,53
1992902,1525000,2025-03-21,Joint,"ED Vote Tally Sheet (Joint Favorable Substitute Change of Reference)",37,7,0,1,45
1992906,1520617,2025-03-18,Joint,"PS Vote Tally Sheet (Joint Favorable)",29,0,0,0,29
1992909,1524274,2025-03-21,Joint,"GL Vote Tally Sheet (Joint Favorable)",21,0,0,1,22
1992909,1585267,2025-06-04,Senate,"Senate Roll Call Vote 404 ",36,0,0,0,36
1992909,1585268,2025-06-04,House,"House Roll Call Vote 354 AS AMENDED ",148,0,0,3,151
1992910,1519667,2025-03-18,Joint,"CE Vote Tally Sheet (Joint Favorable)",20,0,0,0,20
1992916,1520094,2025-03-18,Joint,"PS Vote Tally Sheet (Joint Favorable Substitute)",29,0,0,0,29
1992919,1528181,2025-03-24,Joint,"ENV Vote Tally Sheet (Joint Favorable Substitute)",23,10,0,1,34
1992919,1566597,2025-05-05,Joint,"APP Vote Tally Sheet (Joint Favorable)",38,12,0,3,53
1992919,1569549,2025-05-12,Joint,"FIN Vote Tally Sheet (Joint Favorable)",39,15,0,0,54
1992919,1578994,2025-05-27,Joint,"JUD Vote Tally Sheet (Joint Favorable)",31,4,0,6,41
1992919,1583612,2025-06-02,Senate,"Senate Roll Call Vote 328 ",35,1,0,0,36
1992919,1585254,2025-06-04,House,"House Roll Call Vote 350 AS AMENDED ",148,0,0,3,151
1992921,1520041,2025-03-18,Joint,"LAB Vote Tally Sheet (Joint Favorable Substitute)",9,4,0,0,13
1992924,1524143,2025-03-21,Joint,"GL Vote Tally Sheet (Joint Favorable Substitute)",21,0,0,1,22
1992924,1524144,2025-03-21,Joint,"GL Vote Tally Sheet-A (Strike Subsection F.)",0,0,0,0,0
1992924,1571734,2025-05-14,House,"House Roll Call Vote 111 AS AMENDED ",147,0,0,4,151
1992925,1527802,2025-03-24,Joint,"ENV Vote Tally Sheet (Joint Favorable)",24,9,0,1,34
1992925,1566589,2025-05-05,Joint,"APP Vote Tally Sheet (Joint Favorable)",38,12,0,3,53
1992934,1519642,2025-03-18,Joint,"PS Vote Tally Sheet (Joint Favorable Change of Reference)",29,0,0,0,29
1992935,1524276,2025-03-21,Joint,"GL Vote Tally Sheet (Joint Favorable)",21,0,0,1,22
1992935,1571065,2025-05-14,Senate,"Senate Roll Call Vote 159 ",35,0,1,0,36
1992935,1580590,2025-05-28,House,"House Roll Call Vote 219 AS AMENDED ",147,0,0,4,151
1992940,1524350,2025-03-21,Joint,"GL Vote Tally Sheet (Joint Favorable)",21,0,0,1,22
1992941,1517871,2025-03-13,Joint,"HS Vote Tally Sheet (Joint Favorable)",22,0,0,1,23
1992941,1563326,2025-04-30,Senate,"Senate Roll Call Vote 94 ",35,0,1,0,36
1992945,1528206,2025-03-24,Joint,"ENV Vote Tally Sheet (Joint Favorable)",32,0,0,2,34
1992946,1517944,2025-03-13,Joint,"HS Vote Tally Sheet-A (Change of Reference)",6,14,0,3,23
1992946,1517945,2025-03-13,Joint,"HS Vote Tally Sheet (Joint Favorable)",16,6,0,1,23
1992946,1517946,2025-03-13,Joint,"HS Vote Tally Sheet-A (MOTION FAILED)",6,14,0,3,23
1992951,1523004,2025-03-20,Joint,"CE Vote Tally Sheet (Joint Favorable Substitute Change of Reference)",19,1,0,0,20
1992951,1556589,2025-04-24,Joint,"FIN Vote Tally Sheet (Joint Favorable)",52,0,0,0,52
1992951,1583656,2025-06-02,House,"House Roll Call Vote 283 AS AMENDED ",125,22,0,4,151
1992951,1584946,2025-06-04,Senate,"Senate Roll Call Vote 391 ",36,0,0,0,36
1992953,1517018,2025-03-13,Joint,"CE Vote Tally Sheet (Joint Favorable)",20,0,0,0,20
1992953,1585339,2025-06-04,Senate,"Senate Roll Call Vote 432 ",36,0,0,0,36
1992957,1520787,2025-03-18,Joint,"HS Vote Tally Sheet (Joint Favorable Substitute)",16,6,0,1,23
1992958,1521923,2025-03-18,Joint,"HS Vote Tally Sheet (Joint Favorable)",17,5,0,1,23
1993094,1507036,2025-02-20,Joint,"EXN Vote Tally Sheet (Joint Favorable)",13,8,0,0,21
1993094,1543232,2025-04-09,House,"House Roll Call Vote 42 ",91,52,0,7,150
1993094,1549182,2025-04-15,Senate,"Senate Roll Call Vote 81 ",21,0,15,0,36
1994043,1529424,2025-03-26,Joint,"GAE Vote Tally Sheet (Joint Favorable Substitute)",13,6,0,0,19
1994043,1560901,2025-04-29,Joint,"ET Vote Tally Sheet (Joint Favorable)",15,8,0,2,25
1994068,1521908,2025-03-19,Joint,"GAE Vote Tally Sheet (Joint Favorable)",19,0,0,0,19
1994095,1522235,2025-03-19,Joint,"GAE Vote Tally Sheet (Joint Favorable Substitute)",13,6,0,0,19
1994095,1558739,2025-04-25,Joint,"PD Vote Tally Sheet (Joint Favorable)",11,7,0,4,22
1994124,1529104,2025-03-26,Joint,"GAE Vote Tally Sheet (Joint Favorable)",13,6,0,0,19
1994152,1521814,2025-03-19,Joint,"GAE Vote Tally Sheet (Joint Favorable)",13,6,0,0,19
1994152,1565975,2025-05-05,Joint,"APP Vote Tally Sheet (Joint Favorable)",41,8,0,4,53
1995372,1537580,2025-04-04,Joint,"JUD Vote Tally Sheet (Joint Favorable Substitute)",28,12,0,1,41
1995372,1537581,2025-04-04,Joint,"JUD Vote Tally Sheet-A (Joint Favorable Substitute)",10,25,0,6,41
1995498,1545403,2025-04-10,Joint,"JUD Vote Tally Sheet (Joint Favorable)",28,11,0,2,41
1995498,1569943,2025-05-12,Joint,"APP Vote Tally Sheet (Joint Favorable)",30,16,1,6,53
1996609,1545092,2025-04-10,Joint,"JUD Vote Tally Sheet (Joint Favorable)",39,0,0,2,41
1996609,1573746,2025-05-19,House,"House Roll Call Vote 133 ",144,0,0,7,151
1996609,1585754,2025-06-04,Senate,"Senate Roll Call Vote 407 ",36,0,0,0,36
1996648,1545506,2025-04-10,Joint,"JUD Vote Tally Sheet (Joint Favorable Substitute)",27,12,0,2,41
1996648,1574761,2025-05-20,House,"House Roll Call Vote 158 AS AMENDED ",100,46,0,5,151
1996648,1574762,2025-05-20,House,"House Roll Call Vote 157 HOUSE AMD A",99,47,0,5,151
1996690,1539109,2025-04-07,Joint,"JUD Vote Tally Sheet (Joint Favorable Substitute)",29,12,0,0,41
1996732,1537622,2025-04-04,Joint,"JUD Vote Tally Sheet (Joint Favorable)",41,0,0,0,41
1996732,1570967,2025-05-13,Senate,"Senate Roll Call Vote 146 ",34,0,2,0,36
1996732,1570968,2025-05-13,Senate,"Senate Roll Call Vote 145 ",24,10,2,0,36
1996732,1580646,2025-05-28,House,"House Roll Call Vote 216 AS AMENDED ",145,0,0,6,151
1996771,1545211,2025-04-10,Joint,"JUD Vote Tally Sheet (Joint Favorable Substitute)",39,0,0,2,41
2000052,1539470,2025-04-07,Joint,"JUD Vote Tally Sheet (Joint Favorable Substitute)",41,0,0,0,41
2000052,1566016,2025-05-05,Joint,"APP Vote Tally Sheet (Joint Favorable)",42,8,0,3,53
2000070,1541172,2025-04-08,Joint,"JUD Vote Tally Sheet (Joint Favorable Substitute)",29,12,0,0,41
2000089,1529181,2025-03-27,Joint,"PH Vote Tally Sheet (Joint Favorable Substitute)",19,11,0,2,32
2000089,1529182,2025-03-27,Joint,"PH Vote Tally Sheet-A (After the last section, add the following and renumber sections and internal references accordingly: Sec. 501 (NEW) (Effective July 1, 2025) No person)",12,18,0,2,32
2000089,1529183,2025-03-27,Joint,"PH Vote Tally Sheet-B (After the last section, add the following and renumber sections and internal references accordingly: Sec. 501 (NEW) (Effective July 1, 2025) If a newb)",10,20,0,2,32
2000089,1529184,2025-03-27,Joint,"PH Vote Tally Sheet-C (After the last section, add the following and renumber sections and internal references accordingly: Sec. 501 (NEW) (Effective from passage) All induc)",10,18,0,4,32
2000089,1529185,2025-03-27,Joint,"PH Vote Tally Sheet-D (After the last section, add the following and renumber sections and internal references accordingly: Sec. 501 (NEW) (Effective from passage) All induc)",11,16,0,5,32
2000089,1529186,2025-03-27,Joint,"PH Vote Tally Sheet-E (Strike sections 2-4)",10,18,0,4,32
2000089,1530489,2025-03-27,Joint,"PH Vote Tally Sheet (Joint Favorable Substitute)",19,11,0,2,32
2000089,1530490,2025-03-27,Joint,"PH Vote Tally Sheet-A (On File in the Public Health Committee)",12,18,0,2,32
2000089,1530491,2025-03-27,Joint,"PH Vote Tally Sheet-B (On File in the Public Health Committee)",10,20,0,2,32
2000089,1530492,2025-03-27,Joint,"PH Vote Tally Sheet-C (On File in the Public Health Committee)",10,18,0,4,32
2000089,1530493,2025-03-27,Joint,"PH Vote Tally Sheet-D (On File in the Public Health Committee)",11,16,0,5,32
2000089,1530494,2025-03-27,Joint,"PH Vote Tally Sheet-E (Delete Sections 2-4)",10,18,0,4,32
2000089,1563895,2025-05-01,House,"House Roll Call Vote 65 AS AMENDED ",117,27,0,7,151
2000089,1563896,2025-05-01,House,"House Roll Call Vote 64 HOUSE AMD C",55,88,0,8,151
2000089,1563897,2025-05-01,House,"House Roll Call Vote 63 HOUSE AMD B",61,85,0,5,151
2000089,1578875,2025-05-27,Senate,"Senate Roll Call Vote 241 ",31,5,0,0,36
2000109,1524138,2025-03-21,Joint,"PH Vote Tally Sheet (Joint Favorable Substitute)",32,0,0,0,32
2000131,1539633,2025-04-07,Joint,"JUD Vote Tally Sheet (Joint Favorable Substitute)",41,0,0,0,41
2000149,1541161,2025-04-08,Joint,"JUD Vote Tally Sheet (Joint Favorable Substitute)",41,0,0,0,41
2000149,1563801,2025-05-01,Senate,"Senate Roll Call Vote 112 ",35,0,1,0,36
2000149,1563802,2025-05-01,Senate,"Senate Roll Call Vote 111 ",11,24,1,0,36
2000149,1576602,2025-05-22,House,"House Roll Call Vote 177 AS AMENDED ",141,6,0,4,151
2000188,1529140,2025-03-27,Joint,"PH Vote Tally Sheet (Joint Favorable)",20,10,0,2,32
2000210,1529299,2025-03-27,Joint,"PH Vote Tally Sheet (Joint Favorable Substitute)",21,9,0,2,32
2000210,1529300,2025-03-27,Joint,"PH Vote Tally Sheet-A (Strike section 2)",10,20,0,2,32
2000210,1572749,2025-05-16,Joint,"APP Vote Tally Sheet (Joint Favorable)",40,9,0,4,53
2000210,1574752,2025-05-20,House,"House Roll Call Vote 160 AS AMENDED ",138,3,0,10,151
2000210,1580617,2025-05-28,Senate,"Senate Roll Call Vote 262 ",36,0,0,0,36
2000228,1530395,2025-03-28,Joint,"PH Vote Tally Sheet (Joint Favorable Substitute)",26,6,0,0,32
2004602,1526794,2025-03-24,Joint,"ED Vote Tally Sheet (Joint Favorable Change of Reference)",31,14,0,0,45
2004602,1558099,2025-04-24,Joint,"APP Vote Tally Sheet (Joint Favorable Substitute)",41,12,0,1,54
2004602,1576752,2025-05-23,Senate,"Senate Roll Call Vote 233 ",36,0,0,0,36
2004694,1530753,2025-03-28,Joint,"ED Vote Tally Sheet (Joint Favorable Substitute Change of Reference)",41,3,0,1,45
2004791,1545261,2025-04-10,Joint,"JUD Vote Tally Sheet (Joint Favorable)",39,0,0,2,41
2004791,1583722,2025-06-03,House,"House Roll Call Vote 293 AS AMENDED ",146,1,0,4,151
2004791,1584535,2025-06-04,Senate,"Senate Roll Call Vote 368 ",36,0,0,0,36
2004883,1526795,2025-03-24,Joint,"ED Vote Tally Sheet (Joint Favorable Substitute Change of Reference)",32,13,0,0,45
2004883,1557945,2025-04-24,Joint,"APP Vote Tally Sheet (Joint Favorable)",43,10,0,1,54
2004883,1557946,2025-04-24,Joint,"APP Vote Tally Sheet-A (MOTION FAILED)",21,25,0,8,54
2004980,1530769,2025-03-28,Joint,"ED Vote Tally Sheet (Joint Favorable Substitute)",41,3,0,1,45
2005077,1526841,2025-03-24,Joint,"ED Vote Tally Sheet (Joint Favorable Substitute)",26,19,0,0,45
2005170,1530768,2025-03-28,Joint,"ED Vote Tally Sheet (Joint Favorable)",33,11,0,1,45
2005267,1526138,2025-03-24,Joint,"ED Vote Tally Sheet (Joint Favorable Substitute Change of Reference)",29,16,0,0,45
2005364,1530756,2025-03-28,Joint,"ED Vote Tally Sheet (Joint Favorable Substitute)",42,0,0,3,45
2006604,1529508,2025-03-26,Joint,"GAE Vote Tally Sheet (Joint Favorable)",14,5,0,0,19
2006604,1566676,2025-05-06,Joint,"JUD Vote Tally Sheet (Joint Favorable)",31,8,0,2,41
2006604,1570005,2025-05-12,Joint,"APP Vote Tally Sheet (Joint Favorable)",37,11,0,5,53
2006619,1529247,2025-03-26,Joint,"GAE Vote Tally Sheet (Joint Favorable)",13,6,0,0,19
2006619,1558699,2025-04-25,Joint,"JUD Vote Tally Sheet (Joint Favorable)",36,1,0,4,41
2006636,1529709,2025-03-26,Joint,"GAE Vote Tally Sheet (Joint Favorable Substitute)",14,5,0,0,19
2006653,1529102,2025-03-26,Joint,"GAE Vote Tally Sheet (Joint Favorable Substitute)",13,6,0,0,19
2006661,1528850,2025-03-26,Joint,"GAE Vote Tally Sheet (Joint Favorable Substitute)",13,6,0,0,19
2006661,1566243,2025-05-05,Joint,"APP Vote Tally Sheet (Joint Favorable)",38,12,0,3,53
2006680,1529278,2025-03-26,Joint,"GAE Vote Tally Sheet (Joint Favorable)",19,0,0,0,19
2006680,1583708,2025-06-02,House,"House Roll Call Vote 278 AS AMENDED ",147,0,0,4,151
2006697,1528714,2025-03-26,Joint,"GAE Vote Tally Sheet (Joint Favorable Substitute)",13,6,0,0,19
2006697,1566618,2025-05-05,Joint,"APP Vote Tally Sheet (Joint Favorable)",38,12,0,3,53
2006715,1528860,2025-03-26,Joint,"GAE Vote Tally Sheet (Joint Favorable)",19,0,0,0,19
2006715,1566631,2025-05-06,Joint,"JUD Vote Tally Sheet (Joint Favorable)",39,0,0,2,41
2006731,1529490,2025-03-26,Joint,"GAE Vote Tally Sheet (Joint Favorable)",13,6,0,0,19
2006750,1529263,2025-03-26,Joint,"GAE Vote Tally Sheet (Joint Favorable)",17,2,0,0,19
2006750,1565917,2025-05-05,Joint,"APP Vote Tally Sheet (Joint Favorable)",42,8,0,3,53
2006766,1528789,2025-03-26,Joint,"GAE Vote Tally Sheet (Joint Favorable)",18,1,0,0,19
2006766,1584473,2025-06-03,House,"House Roll Call Vote 321 ",148,0,0,3,151
2006784,1529028,2025-03-26,Joint,"GAE Vote Tally Sheet (Joint Favorable Substitute)",18,1,0,0,19
2006784,1568020,2025-05-07,Senate,"Senate Roll Call Vote 129 ",36,0,0,0,36
2006784,1582388,2025-05-30,House,"House Roll Call Vote 240 ",147,0,0,4,151
2006802,1528775,2025-03-26,Joint,"GAE Vote Tally Sheet (Joint Favorable)",18,1,0,0,19
2006820,1529051,2025-03-26,Joint,"GAE Vote Tally Sheet (Joint Favorable Substitute)",14,5,0,0,19
2006838,1529337,2025-03-26,Joint,"GAE Vote Tally Sheet (Joint Favorable)",13,6,0,0,19
2006854,1529317,2025-03-26,Joint,"GAE Vote Tally Sheet (Joint Favorable Substitute)",13,6,0,0,19
2006854,1566602,2025-05-05,Joint,"APP Vote Tally Sheet (Joint Favorable)",38,12,0,3,53
2006873,1529201,2025-03-26,Joint,"GAE Vote Tally Sheet (Joint Favorable Substitute)",17,2,0,0,19
2006873,1566600,2025-05-05,Joint,"APP Vote Tally Sheet (Joint Favorable)",42,8,0,3,53
2006891,1529135,2025-03-26,Joint,"GAE Vote Tally Sheet (Joint Favorable)",19,0,0,0,19
2006891,1569722,2025-05-12,Joint,"JUD Vote Tally Sheet (Joint Favorable)",29,11,0,1,41
2006908,1529082,2025-03-26,Joint,"GAE Vote Tally Sheet (Joint Favorable)",18,1,0,0,19
2006908,1568085,2025-05-07,Senate,"Senate Roll Call Vote 128 ",36,0,0,0,36
2006908,1585509,2025-06-04,House,"House Roll Call Vote 365 ",145,0,0,6,151
2006924,1529238,2025-03-26,Joint,"GAE Vote Tally Sheet (Joint Favorable)",13,6,0,0,19
2007081,1517846,2025-03-13,Joint,"EXN Vote Tally Sheet (Joint Favorable)",20,1,0,0,21
2007081,1542921,2025-04-09,House,"House Roll Call Vote 41 ",136,9,0,5,150
2007081,1549043,2025-04-15,Senate,"Senate Roll Call Vote 87 ",23,7,6,0,36
2008282,1530186,2025-03-28,Joint,"ENV Vote Tally Sheet (Joint Favorable Substitute)",27,6,0,1,34
2008282,1572033,2025-05-15,Senate,"Senate Roll Call Vote 177 ",34,2,0,0,36
2008282,1585133,2025-06-04,House,"House Roll Call Vote 352 AS AMENDED ",121,28,0,2,151
2008282,1585134,2025-06-04,House,"House Roll Call Vote 351 HOUSE AMD A",121,28,0,2,151
2008399,1530107,2025-03-28,Joint,"ENV Vote Tally Sheet (Joint Favorable Substitute)",30,3,0,1,34
2008399,1580681,2025-05-28,House,"House Roll Call Vote 201 AS AMENDED ",101,45,0,5,151
2008399,1584642,2025-06-04,Senate,"Senate Roll Call Vote 384 ",32,4,0,0,36
2009405,1545091,2025-04-10,Joint,"JUD Vote Tally Sheet (Joint Favorable Substitute)",39,0,0,2,41
2009405,1583712,2025-06-02,Senate,"Senate Roll Call Vote 332 ",36,0,0,0,36
2009405,1585678,2025-06-04,House,"House Roll Call Vote 363 AS AMENDED ",149,1,0,1,151
2009408,1558061,2025-04-24,Joint,"APP Vote Tally Sheet (Joint Favorable)",40,14,0,0,54
2009421,1545315,2025-04-10,Joint,"JUD Vote Tally Sheet (Joint Favorable Substitute)",39,0,0,2,41
2009421,1573751,2025-05-19,House,"House Roll Call Vote 134 ",144,0,0,7,151
2009421,1585753,2025-06-04,Senate,"Senate Roll Call Vote 408 ",36,0,0,0,36
2009436,1558357,2025-04-24,Joint,"APP Vote Tally Sheet (Joint Favorable Substitute)",49,5,0,0,54
2009436,1584534,2025-06-03,House,"House Roll Call Vote 313 ",141,7,0,3,151
2009446,1558622,2025-04-24,Joint,"APP Vote Tally Sheet (Joint Favorable)",54,0,0,0,54
2009459,1558383,2025-04-24,Joint,"APP Vote Tally Sheet (Joint Favorable)",54,0,0,0,54
2009459,1580838,2025-05-28,Senate,"Senate Roll Call Vote 254 ",36,0,0,0,36
2009459,1584996,2025-06-03,House,"House Roll Call Vote 297 ",140,1,0,10,151
2009469,1545139,2025-04-10,Joint,"JUD Vote Tally Sheet (Joint Favorable Substitute)",39,0,0,2,41
2009469,1573841,2025-05-19,House,"House Roll Call Vote 132 ",144,0,0,7,151
2009469,1585525,2025-06-04,Senate,"Senate Roll Call Vote 409 ",36,0,0,0,36
2009483,1558245,2025-04-24,Joint,"APP Vote Tally Sheet (Joint Favorable Substitute)",54,0,0,0,54
2009483,1558246,2025-04-24,Joint,"APP Vote Tally Sheet-A",0,0,0,0,0
2009483,1584858,2025-06-03,House,"House Roll Call Vote 314 ",148,0,0,3,151
2009511,1545284,2025-04-10,Joint,"JUD Vote Tally Sheet (Joint Favorable Substitute)",39,0,0,2,41
2009511,1573804,2025-05-19,House,"House Roll Call Vote 136 AS AMENDED ",144,0,0,7,151
2009511,1585294,2025-06-04,Senate,"Senate Roll Call Vote 411 ",36,0,0,0,36
2009514,1545303,2025-04-10,Joint,"JUD Vote Tally Sheet (Joint Favorable Substitute)",39,0,0,2,41
2009514,1583705,2025-06-02,Senate,"Senate Roll Call Vote 341 ",36,0,0,0,36
2009514,1585679,2025-06-04,House,"House Roll Call Vote 364 ",148,0,0,3,151
2009529,1558628,2025-04-24,Joint,"APP Vote Tally Sheet (Joint Favorable)",54,0,0,0,54
2009529,1582033,2025-05-30,Senate,"Senate Roll Call Vote 288 ",36,0,0,0,36
2009529,1585138,2025-06-03,House,"House Roll Call Vote 315 AS AMENDED ",148,0,0,3,151
2009533,1539166,2025-04-07,Joint,"JUD Vote Tally Sheet (Joint Favorable Substitute)",36,5,0,0,41
2009533,1572188,2025-05-15,House,"House Roll Call Vote 122 ",139,4,0,8,151
2009533,1585310,2025-06-04,Senate,"Senate Roll Call Vote 406 ",36,0,0,0,36
2009558,1545294,2025-04-10,Joint,"JUD Vote Tally Sheet (Joint Favorable Substitute)",39,0,0,2,41
2009558,1573424,2025-05-19,House,"House Roll Call Vote 135 ",144,0,0,7,151
2009558,1585393,2025-06-04,Senate,"Senate Roll Call Vote 410 ",36,0,0,0,36
2009583,1558601,2025-04-24,Joint,"APP Vote Tally Sheet (Joint Favorable)",45,9,0,0,54
2010350,1530032,2025-03-28,Joint,"PH Vote Tally Sheet (Joint Favorable Substitute)",32,0,0,0,32
2010357,1545190,2025-04-10,Joint,"JUD Vote Tally Sheet (Joint Favorable)",39,0,0,2,41
2010359,1529289,2025-03-27,Joint,"GAE Vote Tally Sheet (Joint Favorable Substitute)",13,6,0,0,19
2010359,1576899,2025-05-23,Joint,"APP Vote Tally Sheet (Joint Favorable)",38,14,0,1,53
2010364,1557402,2025-04-24,Joint,"FIN Vote Tally Sheet (Joint Favorable Substitute)",52,0,0,0,52
2010372,1528635,2025-03-26,Joint,"GAE Vote Tally Sheet (Joint Favorable Substitute)",13,6,0,0,19
2010374,1529429,2025-03-26,Joint,"GAE Vote Tally Sheet (Joint Favorable)",18,1,0,0,19
2010382,1545217,2025-04-10,Joint,"JUD Vote Tally Sheet (Joint Favorable)",39,0,0,2,41
2010386,1545083,2025-04-10,Joint,"JUD Vote Tally Sheet (Joint Favorable)",39,0,0,2,41
2010398,1529439,2025-03-26,Joint,"GAE Vote Tally Sheet (Joint Favorable)",14,5,0,0,19
2010406,1529462,2025-03-26,Joint,"GAE Vote Tally Sheet (Joint Favorable Substitute)",13,6,0,0,19
2010406,1571016,2025-05-13,House,"House Roll Call Vote 104 AS AMENDED ",99,46,0,6,151
2010406,1571017,2025-05-13,House,"House Roll Call Vote 103 HOUSE AMD B",47,99,0,5,151
2010409,1530275,2025-03-28,Joint,"PH Vote Tally Sheet (Joint Favorable Substitute)",31,1,0,0,32
2010416,1529666,2025-03-27,Joint,"GAE Vote Tally Sheet (Joint Favorable Substitute)",13,6,0,0,19
2010416,1569567,2025-05-12,Joint,"APP Vote Tally Sheet (Joint Favorable)",38,10,0,5,53
2010422,1529805,2025-03-26,Joint,"GAE Vote Tally Sheet (Joint Favorable)",13,6,0,0,19
2010434,1529525,2025-03-26,Joint,"GAE Vote Tally Sheet (Joint Favorable Substitute)",13,6,0,0,19
2010434,1566365,2025-05-05,Joint,"APP Vote Tally Sheet (Joint Favorable)",38,12,0,3,53
2010441,1545311,2025-04-10,Joint,"JUD Vote Tally Sheet (Joint Favorable)",39,0,0,2,41
2010443,1529644,2025-03-26,Joint,"GAE Vote Tally Sheet (Joint Favorable Substitute)",13,6,0,0,19
2010452,1529423,2025-03-26,Joint,"GAE Vote Tally Sheet (Joint Favorable)",17,2,0,0,19
2010457,1545349,2025-04-10,Joint,"JUD Vote Tally Sheet (Joint Favorable)",30,9,0,2,41
2010459,1529293,2025-03-27,Joint,"PH Vote Tally Sheet (Joint Favorable Change of Reference)",31,0,0,1,32
2010459,1558627,2025-04-24,Joint,"APP Vote Tally Sheet (Joint Favorable Substitute)",54,0,0,0,54
2010468,1556713,2025-04-24,Joint,"FIN Vote Tally Sheet (Joint Favorable Substitute)",50,2,0,0,52
2010468,1585756,2025-06-04,House,"House Roll Call Vote 381 AS AMENDED ",144,1,0,6,151
2010468,1585757,2025-06-04,Senate,"Senate Roll Call Vote 402 ",36,0,0,0,36
2010476,1528543,2025-03-27,Joint,"PH Vote Tally Sheet (Joint Favorable)",24,7,0,1,32
2010476,1576946,2025-05-23,Joint,"APP Vote Tally Sheet (Joint Favorable)",43,9,0,1,53
2010479,1529775,2025-03-26,Joint,"GAE Vote Tally Sheet (Joint Favorable)",19,0,0,0,19
2010479,1529776,2025-03-26,Joint,"GAE Vote Tally Sheet-B (MOTION FAILED)",6,13,0,0,19
2010479,1529777,2025-03-26,Joint,"GAE Vote Tally Sheet-C (MOTION FAILED)",6,11,0,2,19
2010479,1529778,2025-03-26,Joint,"GAE Vote Tally Sheet-D",6,12,0,1,19
2010479,1529779,2025-03-26,Joint,"GAE Vote Tally Sheet-E (MOTION FAILED)",5,12,0,2,19
2010479,1565877,2025-05-05,Joint,"APP Vote Tally Sheet (Joint Favorable)",47,3,0,3,53
2010483,1530117,2025-03-28,Joint,"PH Vote Tally Sheet (Joint Favorable Substitute)",23,9,0,0,32
2010483,1530118,2025-03-28,Joint,"PH Vote Tally Sheet-A (On File in the Public Health Committee)",23,0,0,9,32
2010483,1530119,2025-03-28,Joint,"PH Vote Tally Sheet-B (Delete Section 2)",9,13,0,10,32
2010491,1528700,2025-03-27,Joint,"PH Vote Tally Sheet (Joint Favorable Change of Reference)",31,0,0,1,32
2010491,1558281,2025-04-24,Joint,"APP Vote Tally Sheet (Joint Favorable Substitute)",54,0,0,0,54
2010494,1557462,2025-04-24,Joint,"FIN Vote Tally Sheet (Joint Favorable Substitute)",52,0,0,0,52
2010506,1556456,2025-04-24,Joint,"FIN Vote Tally Sheet (Joint Favorable Substitute)",52,0,0,0,52
2010511,1530264,2025-03-28,Joint,"PH Vote Tally Sheet (Joint Favorable)",22,10,0,0,32
2010511,1530265,2025-03-28,Joint,"PH Vote Tally Sheet-A (On File in the Public Health Committee)",9,18,0,5,32
2010511,1571795,2025-05-14,House,"House Roll Call Vote 117 AS AMENDED ",101,46,0,4,151
2010511,1571796,2025-05-14,House,"House Roll Call Vote 116 HOUSE AMD B",54,93,0,4,151
2010515,1529773,2025-03-26,Joint,"GAE Vote Tally Sheet (Joint Favorable)",16,3,0,0,19
2010704,1520740,2025-03-18,Joint,"EXN Vote Tally Sheet (Joint Favorable)",20,0,1,0,21
2010704,1549487,2025-04-15,Senate,"Senate Roll Call Vote 84 ",30,1,5,0,36
2010704,1561511,2025-04-28,House,"House Roll Call Vote 45 ",126,9,0,16,151
2010799,1520742,2025-03-18,Joint,"EXN Vote Tally Sheet (Joint Favorable)",21,0,0,0,21
2010799,1549484,2025-04-15,Senate,"Senate Roll Call Vote 85 ",31,0,5,0,36
2011116,1545202,2025-04-10,Joint,"JUD Vote Tally Sheet (Joint Favorable Substitute)",33,6,0,2,41
2011116,1574215,2025-05-20,Senate,"Senate Roll Call Vote 191 ",35,0,1,0,36
2011116,1584485,2025-06-03,House,"House Roll Call Vote 307 AS AMENDED ",99,49,0,3,151
2011116,1585303,2025-06-04,Senate,"Senate Roll Call Vote 405 ",36,0,0,0,36
2011193,1541003,2025-04-08,Joint,"JUD Vote Tally Sheet (Joint Favorable Substitute)",41,0,0,0,41
2011193,1541004,2025-04-08,Joint,"JUD Vote Tally Sheet-A (Joint Favorable Substitute)",0,0,0,0,0
2011193,1569608,2025-05-12,Joint,"APP Vote Tally Sheet (Joint Favorable)",40,8,0,5,53
2011271,1541110,2025-04-08,Joint,"JUD Vote Tally Sheet (Joint Favorable Substitute)",31,10,0,0,41
2011271,1569661,2025-05-12,Joint,"APP Vote Tally Sheet (Joint Favorable)",37,11,0,5,53
2011271,1576749,2025-05-23,Senate,"Senate Roll Call Vote 238 ",36,0,0,0,36
2011271,1585263,2025-06-04,Senate,"Senate Roll Call Vote 435 ",36,0,0,0,36
2011271,1585264,2025-06-04,House,"House Roll Call Vote 367 AS AMENDED ",147,1,0,3,151
2011349,1537617,2025-04-04,Joint,"JUD Vote Tally Sheet (Joint Favorable Substitute)",41,0,0,0,41
2011349,1537618,2025-04-04,Joint,"JUD Vote Tally Sheet-A (Joint Favorable Substitute)",0,0,0,0,0
2011349,1565860,2025-05-05,Joint,"APP Vote Tally Sheet (Joint Favorable)",40,10,0,3,53
2012005,1537625,2025-04-04,Joint,"JUD Vote Tally Sheet (Joint Favorable Substitute)",41,0,0,0,41
2012005,1537626,2025-04-04,Joint,"JUD Vote Tally Sheet-A (Joint Favorable Substitute)",0,0,0,0,0
2012005,1567827,2025-05-07,Senate,"Senate Roll Call Vote 120 ",36,0,0,0,36
2012005,1585466,2025-06-04,House,"House Roll Call Vote 362 ",149,0,0,2,151
2012120,1545186,2025-04-10,Joint,"JUD Vote Tally Sheet (Joint Favorable Substitute)",39,0,0,2,41
2012120,1573809,2025-05-19,House,"House Roll Call Vote 137 AS AMENDED ",143,0,0,8,151
2012120,1582217,2025-05-30,Senate,"Senate Roll Call Vote 311 ",36,0,0,0,36
2012628,1557947,2025-04-24,Joint,"APP Vote Tally Sheet (Joint Favorable)",43,11,0,0,54
2012651,1558338,2025-04-24,Joint,"APP Vote Tally Sheet (Joint Favorable Substitute)",49,5,0,0,54
2012720,1558130,2025-04-24,Joint,"APP Vote Tally Sheet (Joint Favorable Substitute)",51,2,0,1,54
2012742,1558054,2025-04-24,Joint,"APP Vote Tally Sheet (Joint Favorable)",40,14,0,0,54
2013613,1545110,2025-04-10,Joint,"JUD Vote Tally Sheet (Joint Favorable)",38,1,0,2,41
2013655,1545282,2025-04-10,Joint,"JUD Vote Tally Sheet (Joint Favorable)",38,1,0,2,41
2013699,1537616,2025-04-04,Joint,"JUD Vote Tally Sheet (Joint Favorable Substitute)",41,0,0,0,41
2013699,1566342,2025-05-05,Joint,"APP Vote Tally Sheet (Joint Favorable)",42,8,0,3,53
2013699,1574754,2025-05-20,House,"House Roll Call Vote 156 AS AMENDED ",145,0,0,6,151
2013699,1585167,2025-06-04,Senate,"Senate Roll Call Vote 363 ",35,1,0,0,36
2014415,1539244,2025-04-07,Joint,"JUD Vote Tally Sheet (Joint Favorable Substitute)",22,19,0,0,41
2014415,1539245,2025-04-07,Joint,"JUD Vote Tally Sheet-A (Joint Favorable Substitute)",0,0,0,0,0
2014452,1545317,2025-04-10,Joint,"JUD Vote Tally Sheet (Joint Favorable Substitute)",39,0,0,2,41
2014452,1545318,2025-04-10,Joint,"JUD Vote Tally Sheet-A",0,0,0,0,0
2014492,1540926,2025-04-08,Joint,"JUD Vote Tally Sheet (Joint Favorable Substitute)",41,0,0,0,41
2014492,1540927,2025-04-08,Joint,"JUD Vote Tally Sheet-A (Joint Favorable Substitute)",0,0,0,0,0
2014492,1575083,2025-05-21,House,"House Roll Call Vote 169 AS AMENDED ",96,51,0,4,151
2014492,1575084,2025-05-21,House,"House Roll Call Vote 168 HOUSE AMD H",57,89,0,5,151
2014492,1575085,2025-05-21,House,"House Roll Call Vote 167 HOUSE AMD G",50,95,0,6,151
2014492,1575086,2025-05-21,House,"House Roll Call Vote 166 HOUSE AMD F",59,86,0,6,151
2014492,1575087,2025-05-21,House,"House Roll Call Vote 165 HOUSE AMD E",48,97,0,6,151
2014492,1575088,2025-05-21,House,"House Roll Call Vote 164 HOUSE AMD D",48,98,0,5,151
2014492,1575089,2025-05-21,House,"House Roll Call Vote 163 HOUSE AMD C",48,97,0,6,151
2014492,1575090,2025-05-21,House,"House Roll Call Vote 162 HOUSE AMD B",48,97,0,6,151
2014492,1575091,2025-05-21,House,"House Roll Call Vote 161 HOUSE AMD A",90,49,0,12,151
2014492,1579372,2025-05-27,Senate,"Senate Roll Call Vote 247 ",25,11,0,0,36
2014492,1579373,2025-05-27,Senate,"Senate Roll Call Vote 246 ",10,25,1,0,36
2014492,1579374,2025-05-27,Senate,"Senate Roll Call Vote 245 ",12,24,0,0,36
2014492,1579375,2025-05-27,Senate,"Senate Roll Call Vote 244 ",12,24,0,0,36
2014492,1579376,2025-05-27,Senate,"Senate Roll Call Vote 243 ",12,24,0,0,36
2014492,1579377,2025-05-27,Senate,"Senate Roll Call Vote 242 ",11,25,0,0,36
2014530,1545302,2025-04-10,Joint,"JUD Vote Tally Sheet (Joint Favorable)",38,1,0,2,41
2014573,1541140,2025-04-08,Joint,"JUD Vote Tally Sheet (Joint Favorable Substitute)",41,0,0,0,41
2014613,1545326,2025-04-10,Joint,"JUD Vote Tally Sheet (Joint Favorable)",38,1,0,2,41
2015276,1556624,2025-04-24,Joint,"FIN Vote Tally Sheet (Joint Favorable Substitute)",52,0,0,0,52
2015307,1557936,2025-04-24,Joint,"APP Vote Tally Sheet (Joint Favorable)",48,6,0,0,54
2015337,1557011,2025-04-24,Joint,"FIN Vote Tally Sheet (Joint Favorable Substitute)",52,0,0,0,52
2015370,1558304,2025-04-24,Joint,"APP Vote Tally Sheet (Joint Favorable)",40,14,0,0,54
2015401,1556746,2025-04-24,Joint,"FIN Vote Tally Sheet (Joint Favorable Substitute)",52,0,0,0,52
2015401,1574799,2025-05-20,House,"House Roll Call Vote 146 ",136,0,0,15,151
2015401,1585658,2025-06-04,Senate,"Senate Roll Call Vote 428 ",36,0,0,0,36
2015432,1556517,2025-04-24,Joint,"FIN Vote Tally Sheet (Joint Favorable)",52,0,0,0,52
2015464,1556470,2025-04-24,Joint,"FIN Vote Tally Sheet (Joint Favorable)",52,0,0,0,52
2015493,1558347,2025-04-24,Joint,"APP Vote Tally Sheet (Joint Favorable)",49,5,0,0,54
2018388,1557081,2025-04-24,Joint,"FIN Vote Tally Sheet (Joint Favorable)",52,0,0,0,52
2018529,1556651,2025-04-24,Joint,"FIN Vote Tally Sheet (Joint Favorable Substitute)",52,0,0,0,52
2018624,1533926,2025-04-01,Joint,"EXN Vote Tally Sheet (Joint Favorable)",18,0,0,3,21
2018624,1549196,2025-04-15,Senate,"Senate Roll Call Vote 86 ",31,0,5,0,36
2021414,1542249,2025-04-09,House,"House Roll Call Vote 44 EMERGENCY CERTIFICATION ",145,2,0,3,150
2021414,1542250,2025-04-09,Senate,"Senate Roll Call Vote 73 ",31,3,2,0,36
2021636,1557049,2025-04-24,Joint,"FIN Vote Tally Sheet (Joint Favorable)",36,16,0,0,52
2021655,1556758,2025-04-24,Joint,"FIN Vote Tally Sheet (Joint Favorable)",52,0,0,0,52
2021675,1556723,2025-04-24,Joint,"FIN Vote Tally Sheet (Joint Favorable Substitute)",37,15,0,0,52
2021693,1557012,2025-04-24,Joint,"FIN Vote Tally Sheet (MOTION FAILED)",17,35,0,0,52
2021716,1556509,2025-04-24,Joint,"FIN Vote Tally Sheet (Joint Favorable Substitute)",37,15,0,0,52
2021736,1556728,2025-04-24,Joint,"FIN Vote Tally Sheet (Joint Favorable Substitute)",52,0,0,0,52
2021736,1582023,2025-05-30,Senate,"Senate Roll Call Vote 290 ",36,0,0,0,36
2021736,1585661,2025-06-04,Senate,"Senate Roll Call Vote 431 ",36,0,0,0,36
2021736,1585662,2025-06-04,House,"House Roll Call Vote 366 AS AMENDED ",148,0,0,3,151
2021772,1557073,2025-04-24,Joint,"FIN Vote Tally Sheet (Joint Favorable)",52,0,0,0,52
2021790,1556595,2025-04-24,Joint,"FIN Vote Tally Sheet (Joint Favorable Substitute)",33,19,0,0,52
2021811,1556908,2025-04-24,Joint,"FIN Vote Tally Sheet (Joint Favorable)",34,17,0,1,52
2022314,1557116,2025-04-24,Joint,"FIN Vote Tally Sheet (Joint Favorable Substitute)",52,0,0,0,52
2022314,1580566,2025-05-28,House,"House Roll Call Vote 204 AS AMENDED ",149,0,0,2,151
2022341,1558295,2025-04-23,Joint,"APP Vote Tally Sheet (House)",37,1,0,2,40
2022341,1569391,2025-05-07,House,"House Roll Call Vote 68 ",109,34,0,8,151
2022371,1556558,2025-04-24,Joint,"FIN Vote Tally Sheet (Joint Favorable Substitute)",35,17,0,0,52
2022371,1574047,2025-05-20,Joint,"JUD Vote Tally Sheet (Joint Favorable Substitute)",32,0,0,9,41
2022371,1574048,2025-05-20,Joint,"JUD Vote Tally Sheet-A (Joint Favorable Substitute)",11,21,0,9,41
2022371,1574049,2025-05-20,Joint,"JUD Vote Tally Sheet-B (Joint Favorable Substitute)",29,4,0,8,41
2022397,1556620,2025-04-24,Joint,"FIN Vote Tally Sheet (Joint Favorable)",45,6,1,0,52
2022934,1558296,2025-04-23,Joint,"APP Vote Tally Sheet (Senate)",14,0,0,0,14
2022934,1567489,2025-05-07,Senate,"Senate Roll Call Vote 115 ",25,8,3,0,36
2023032,1545354,2025-04-10,Joint,"EXN Vote Tally Sheet (Senate)",7,0,0,2,9
2023032,1548534,2025-04-15,Senate,"Senate Roll Call Vote 88 ",28,3,5,0,36
2023525,1545735,2025-04-10,Joint,"EXN Vote Tally Sheet (House)",10,2,0,0,12
2024176,1561612,2025-04-30,Joint,"SED Vote Tally Sheet (Joint Favorable Substitute)",8,7,0,0,15
2024176,1561613,2025-04-30,Joint,"SED Vote Tally Sheet-A",6,9,0,0,15
2024176,1576885,2025-05-23,Joint,"APP Vote Tally Sheet (Joint Favorable)",42,10,0,1,53
2024209,1561638,2025-04-30,Joint,"SED Vote Tally Sheet (Joint Favorable Substitute)",8,7,0,0,15
2024209,1561639,2025-04-30,Joint,"SED Vote Tally Sheet-A",6,9,0,0,15
2024209,1576994,2025-05-23,Joint,"ED Vote Tally Sheet (Joint Favorable)",25,13,0,7,45
2026804,1565486,2025-05-05,Joint,"APP Vote Tally Sheet (Senate)",14,0,0,0,14
2026804,1575987,2025-05-22,Senate,"Senate Roll Call Vote 212 ",36,0,0,0,36
2026976,1565889,2025-05-05,Joint,"APP Vote Tally Sheet (House)",30,6,0,3,39
2026976,1578074,2025-05-20,House,"House Roll Call Vote 149 ",134,12,0,5,151
2026987,1559693,2025-04-25,Joint,"JUD Vote Tally Sheet (Joint Favorable)",31,4,1,5,41
2026987,1567913,2025-05-07,House,"House Roll Call Vote 67 ",115,24,0,12,151
2026987,1576633,2025-05-22,Senate,"Senate Roll Call Vote 213 ",34,2,0,0,36
2027020,1559695,2025-04-25,Joint,"JUD Vote Tally Sheet (Joint Favorable)",27,10,0,4,41
2027020,1567807,2025-05-07,House,"House Roll Call Vote 66 ",88,55,0,8,151
2027020,1576548,2025-05-22,Senate,"Senate Roll Call Vote 214 ",27,9,0,0,36
2027190,1572032,2025-05-15,Joint,"GOS Vote Tally Sheet (Joint Favorable Substitute)",11,1,0,0,12
2027190,1584439,2025-06-03,House,"House Roll Call Vote 305 AS AMENDED ",145,2,0,4,151
2027196,1572028,2025-05-15,Joint,"GOS Vote Tally Sheet (Joint Favorable)",11,1,0,0,12
2027213,1571901,2025-05-15,Joint,"GOS Vote Tally Sheet (Joint Favorable)",12,0,0,0,12
2027213,1582346,2025-05-30,Senate,"Senate Roll Call Vote 313 ",36,0,0,0,36
2027213,1584988,2025-06-03,House,"House Roll Call Vote 304 ",133,14,0,4,151
2027224,1571890,2025-05-15,Joint,"GOS Vote Tally Sheet (Joint Favorable Substitute)",11,1,0,0,12
2027224,1582844,2025-05-31,House,"House Roll Call Vote 259 ",132,11,0,8,151
2027224,1584816,2025-06-04,Senate,"Senate Roll Call Vote 388 ",33,3,0,0,36
2027232,1571929,2025-05-15,Joint,"GOS Vote Tally Sheet (Joint Favorable Substitute)",11,1,0,0,12
2027232,1582785,2025-05-31,House,"House Roll Call Vote 262 ",136,8,0,7,151
2027232,1585607,2025-06-04,Senate,"Senate Roll Call Vote 389 ",35,1,0,0,36
2027241,1572030,2025-05-15,Joint,"GOS Vote Tally Sheet (Joint Favorable)",11,1,0,0,12
2027241,1582903,2025-05-31,House,"House Roll Call Vote 260 ",112,32,0,7,151
2027241,1584843,2025-06-04,Senate,"Senate Roll Call Vote 390 ",27,9,0,0,36
2027251,1572035,2025-05-15,Joint,"GOS Vote Tally Sheet (Joint Favorable)",12,0,0,0,12
2027251,1582874,2025-05-31,House,"House Roll Call Vote 258 ",142,1,0,8,151
2027251,1584518,2025-06-04,Senate,"Senate Roll Call Vote 379 ",36,0,0,0,36
2027258,1571936,2025-05-15,Joint,"GOS Vote Tally Sheet (Joint Favorable Substitute)",11,1,0,0,12
2027258,1582908,2025-05-31,House,"House Roll Call Vote 257 ",116,28,0,7,151
2027258,1584539,2025-06-04,Senate,"Senate Roll Call Vote 375 ",36,0,0,0,36
2027269,1572039,2025-05-15,Joint,"GOS Vote Tally Sheet (Joint Favorable Substitute)",12,0,0,0,12
2027269,1584502,2025-06-04,Senate,"Senate Roll Call Vote 378 ",36,0,0,0,36
2027269,1585494,2025-06-04,House,"House Roll Call Vote 371 AS AMENDED ",150,0,0,1,151
2027278,1572040,2025-05-15,Joint,"GOS Vote Tally Sheet (Joint Favorable)",11,1,0,0,12
2027278,1582909,2025-05-31,House,"House Roll Call Vote 261 ",126,18,0,7,151
2027278,1584538,2025-06-04,Senate,"Senate Roll Call Vote 380 ",36,0,0,0,36
2027285,1572031,2025-05-15,Joint,"GOS Vote Tally Sheet (Joint Favorable)",11,1,0,0,12
2027285,1584541,2025-06-04,Senate,"Senate Roll Call Vote 382 ",36,0,0,0,36
2027285,1585553,2025-06-04,House,"House Roll Call Vote 370 ",150,0,0,1,151
2027293,1572037,2025-05-15,Joint,"GOS Vote Tally Sheet (House)",11,1,0,0,12
2027293,1573190,2025-05-15,Joint,"GOS Vote Tally Sheet (Joint Favorable Substitute)",11,1,0,0,12
2027293,1584536,2025-06-04,Senate,"Senate Roll Call Vote 377 ",36,0,0,0,36
2027293,1585593,2025-06-04,House,"House Roll Call Vote 372 ",149,0,0,2,151
2027301,1571878,2025-05-15,Joint,"GOS Vote Tally Sheet (Joint Favorable Substitute)",12,0,0,0,12
2027301,1582310,2025-05-30,Senate,"Senate Roll Call Vote 312 ",36,0,0,0,36
2027301,1585145,2025-06-03,House,"House Roll Call Vote 311 ",145,0,0,6,151
2027308,1572024,2025-05-15,Joint,"GOS Vote Tally Sheet (Joint Favorable Substitute)",12,0,0,0,12
2034928,1583635,2025-06-02,House,"House Roll Call Vote 290 AS AMENDED ",99,49,0,3,151
2034928,1583636,2025-06-02,House,"House Roll Call Vote 289 EMERGENCY CERTIFICATION HOUSE AMD F",47,97,0,7,151
2034928,1583637,2025-06-02,House,"House Roll Call Vote 288 EMERGENCY CERTIFICATION HOUSE AMD E",38,102,0,11,151
2034928,1583638,2025-06-02,House,"House Roll Call Vote 287 EMERGENCY CERTIFICATION HOUSE AMD D",44,96,0,11,151
2034928,1583639,2025-06-02,House,"House Roll Call Vote 286 EMERGENCY CERTIFICATION HOUSE AMD C",46,99,0,6,151
2034928,1583640,2025-06-02,House,"House Roll Call Vote 285 EMERGENCY CERTIFICATION HOUSE AMD B",46,98,0,7,151
2034928,1583641,2025-06-02,House,"House Roll Call Vote 284 EMERGENCY CERTIFICATION HOUSE AMD A",100,46,0,5,151
2034928,1584141,2025-06-03,Senate,"Senate Roll Call Vote 355 ",10,25,1,0,36
2034928,1584142,2025-06-03,Senate,"Senate Roll Call Vote 354 ",11,25,0,0,36
2034928,1584487,2025-06-03,Senate,"Senate Roll Call Vote 360 ",25,11,0,0,36
2034928,1584488,2025-06-03,Senate,"Senate Roll Call Vote 359 ",11,25,0,0,36
2034928,1584489,2025-06-03,Senate,"Senate Roll Call Vote 358 ",11,25,0,0,36
2034928,1584490,2025-06-03,Senate,"Senate Roll Call Vote 357 ",11,25,0,0,36
2034928,1584491,2025-06-03,Senate,"Senate Roll Call Vote 356 ",11,25,0,0,36
2035434,1584750,2025-06-04,Senate,"Senate Roll Call Vote 386 ",35,1,0,0,36
2035434,1585596,2025-06-04,House,"House Roll Call Vote 348 EMERGENCY CERTIFICATION ",144,4,0,3,151
