bill_id,roll_call_id,date,chamber,description,yea,nay,nv,absent,total
1893344,1535026,2025-04-02,Assembly,"Do pass and be re-referred to the Committee on [Appropriations]",17,0,0,0,17
1893344,1577277,2025-05-23,Assembly,"Do pass",14,0,0,1,15
1893344,1583530,2025-06-02,Assembly,"AB 1 Connolly Assembly Third Reading",79,0,0,0,79
1893344,1595190,2025-06-25,Senate,"Do pass, but first be re-referred to the Committee on [Appropriations] with the recommendation: To Consent Calendar",7,0,0,0,7
1893344,1599526,2025-08-18,Senate,"Placed on suspense file",7,0,0,0,7
1893344,1600259,2025-08-29,Senate,"Do pass",7,0,0,0,7
1893344,1601958,2025-09-11,Senate,"Assembly 3rd Reading AB1 Connolly et al. By Allen",40,0,0,0,40
1893346,1558358,2025-04-24,Assembly,"Do pass and be re-referred to the Committee on [Appropriations]",7,3,0,2,12
1893346,1577924,2025-05-23,Assembly,"Do pass",11,3,0,1,15
1893346,1583563,2025-06-02,Assembly,"AB 11 Lee Assembly Third Reading",47,20,0,12,79
1893348,1528312,2025-03-26,Assembly,"Do pass and be re-referred to the Committee on [Appropriations]",18,0,0,0,18
1893348,1577333,2025-05-23,Assembly,"Do pass as amended",11,0,0,4,15
1893348,1584392,2025-06-03,Assembly,"AB 13 Ransom Assembly Third Reading",79,0,0,0,79
1893348,1598491,2025-07-15,Senate,"Do pass as amended, but first amend, and re-refer to the Committee on [Appropriations]",16,0,0,1,17
1893348,1599491,2025-08-18,Senate,"Placed on suspense file",7,0,0,0,7
1893349,1526958,2025-03-25,Assembly,"Do pass and be re-referred to the Committee on [Natural Resources] with recommendation: To Consent Calendar",13,0,0,0,13
1893349,1538900,2025-04-07,Assembly,"Do pass and be re-referred to the Committee on [Appropriations] with recommendation: To Consent Calendar",14,0,0,0,14
1893349,1555969,2025-04-23,Assembly,"Do pass. To Consent Calendar",15,0,0,0,15
1893349,1564261,2025-05-01,Assembly,"AB 14 Hart Consent Calendar Second Day Regular Session",76,0,0,3,79
1893349,1588066,2025-06-10,Senate,"Do pass, but first be re-referred to the Committee on [Environmental Quality] with the recommendation: To Consent Calendar",7,0,0,0,7
1893349,1597401,2025-07-02,Senate,"Do pass, but first be re-referred to the Committee on [Appropriations] with the recommendation: To Consent Calendar",8,0,0,0,8
1893349,1598830,2025-07-17,Senate,"Consent Calendar 2nd AB14 Hart et al",35,0,0,5,40
1893349,1601628,2025-09-09,Senate,"Assembly 3rd Reading AB14 Hart et al. By Limón",40,0,0,0,40
1893350,1505308,2025-03-04,Assembly,"Do pass and be re-referred to the Committee on [Appropriations]",9,0,0,0,9
1893350,1577430,2025-05-23,Assembly,"Do pass as amended",11,1,0,3,15
1893350,1584225,2025-06-03,Assembly,"AB 15 Gipson Assembly Third Reading",70,2,0,7,79
1893350,1598477,2025-07-15,Senate,"Do pass as amended, but first amend, and re-refer to the Committee on [Appropriations]",5,0,0,1,6
1893350,1599439,2025-08-18,Senate,"Placed on suspense file",7,0,0,0,7
1893350,1600669,2025-08-29,Senate,"Do pass",5,0,0,2,7
1893350,1601226,2025-09-08,Senate,"Assembly 3rd Reading AB15 Gipson et al. By Richardson",30,0,0,10,40
1893350,1601459,2025-09-09,Assembly,"AB 15 Gipson Concurrence in Senate Amendments",72,0,0,8,80
1893351,1542868,2025-04-09,Assembly,"Do pass as amended and be re-referred to the Committee on [Appropriations]",7,0,0,0,7
1893351,1565317,2025-05-05,Assembly,"AB 16 Alanis Assembly Third Reading",75,0,0,4,79
1893351,1597205,2025-07-01,Senate,"Do pass",5,0,0,0,5
1893351,1601866,2025-09-11,Senate,"Assembly 3rd Reading AB16 Alanis By Alvarado-Gil",39,0,0,1,40
1893351,1602215,2025-09-13,Assembly,"AB 16 Alanis Concurrence in Senate Amendments",74,0,0,6,80
1893352,1528316,2025-03-26,Assembly,"Do pass and be re-referred to the Committee on [Appropriations] with recommendation: To Consent Calendar",7,0,0,0,7
1893352,1542731,2025-04-09,Assembly,"Do pass. To Consent Calendar",14,0,0,1,15
1893352,1557486,2025-04-24,Assembly,"AB 17 Alanis Consent Calendar Second Day Regular Session",75,0,0,4,79
1893352,1597145,2025-07-01,Senate,"Do pass, but first be re-referred to the Committee on [Appropriations] with the recommendation: To Consent Calendar",5,0,0,0,5
1893352,1598903,2025-07-17,Senate,"Consent Calendar 2nd AB17 Alanis",35,0,0,5,40
1893355,1535143,2025-04-01,Assembly,"Do pass as amended and be re-referred to the Committee on [Judiciary]",9,0,0,6,15
1893355,1540876,2025-04-08,Assembly,"Do pass",9,0,0,3,12
1893355,1569755,2025-05-12,Assembly,"AB 2 Lowenthal Assembly Third Reading",66,0,0,13,79
1893356,1558353,2025-04-24,Assembly,"Do pass and be re-referred to the Committee on [Human Services]",2,7,0,3,12
1893357,1558374,2025-04-24,Assembly,"Do pass and be re-referred to the Committee on [Judiciary]",5,2,0,5,12
1893357,1558375,2025-04-24,Assembly,Reconsideration,5,2,0,5,12
1893361,1542906,2025-04-09,Assembly,"Do pass and be re-referred to the Committee on [Judiciary]",2,5,0,0,7
1893361,1542907,2025-04-09,Assembly,Reconsideration,2,5,0,0,7
1893363,1566682,2025-05-05,Assembly,"Do pass and be re-referred to the Committee on [Appropriations]",7,0,0,0,7
1893363,1577284,2025-05-23,Assembly,"Do pass",14,0,0,1,15
1893363,1582252,2025-05-29,Assembly,"AB 27 Schiavo Assembly Third Reading",71,0,0,8,79
1893363,1595198,2025-06-25,Senate,"Do pass, but first be re-referred to the Committee on [Rules]",5,0,0,0,5
1893363,1597716,2025-07-07,Senate,"Do pass, but first be re-referred to the Committee on [Appropriations] with the recommendation: To Consent Calendar",5,0,0,0,5
1893364,1559478,2025-04-28,Assembly,"Do pass as amended and be re-referred to the Committee on [Appropriations]",11,3,0,0,14
1893364,1577598,2025-05-23,Assembly,"Do pass",11,3,0,1,15
1893364,1582245,2025-05-29,Assembly,"AB 28 Schiavo Assembly Third Reading",56,9,0,14,79
1893364,1598780,2025-07-16,Senate,"Do pass as amended, but first amend, and re-refer to the Committee on [Appropriations]",7,0,0,1,8
1893364,1599537,2025-08-18,Senate,"Placed on suspense file",7,0,0,0,7
1893364,1600534,2025-08-29,Senate,"Do pass",5,2,0,0,7
1893365,1533476,2025-04-01,Assembly,"Do pass and be re-referred to the Committee on [Appropriations]",15,0,0,0,15
1893367,1525455,2025-03-24,Assembly,"Do pass as amended and be re-referred to the Committee on [Appropriations]",12,0,0,2,14
1893367,1577264,2025-05-23,Assembly,"Do pass",13,0,0,2,15
1893367,1585095,2025-06-04,Assembly,"AB 30 Alvarez Third Reading Urgency",77,0,0,2,79
1893367,1597398,2025-07-02,Senate,"Do pass, but first be re-referred to the Committee on [Transportation]",8,0,0,0,8
1893367,1597877,2025-07-08,Senate,"Do pass, but first be re-referred to the Committee on [Appropriations]",15,0,0,0,15
1893367,1599471,2025-08-18,Senate,"Placed on suspense file",7,0,0,0,7
1893367,1600287,2025-08-29,Senate,"Do pass",7,0,0,0,7
1893367,1600885,2025-09-03,Senate,"Assembly 3rd Reading AB30 Alvarez et al. By Richardson Urgency Clause",40,0,0,0,40
1893368,1505298,2025-03-04,Assembly,"Do pass and be re-referred to the Committee on [Appropriations] with recommendation: To Consent Calendar",9,0,0,0,9
1893368,1577887,2025-05-23,Assembly,"Do pass",14,0,0,1,15
1893368,1583542,2025-06-02,Assembly,"AB 31 Ramos Assembly Third Reading",79,0,0,0,79
1893369,1505311,2025-03-04,Assembly,"Do pass and be re-referred to the Committee on [Transportation] with recommendation: To Consent Calendar",9,0,0,0,9
1893369,1525418,2025-03-24,Assembly,"Do pass and be re-referred to the Committee on [Appropriations] with recommendation: To Consent Calendar",16,0,0,0,16
1893370,1554642,2025-04-21,Assembly,"Do pass and be re-referred to the Committee on [Appropriations]",12,2,0,2,16
1893370,1577931,2025-05-23,Assembly,"Do pass",11,1,0,3,15
1893370,1582248,2025-05-29,Assembly,"AB 33 Aguiar-Curry Assembly Third Reading",57,7,0,15,79
1893370,1594574,2025-06-24,Senate,"Do pass, but first be re-referred to the Committee on [Judiciary]",10,3,0,2,15
1893370,1598315,2025-07-14,Senate,"Placed on suspense file",7,0,0,0,7
1893370,1600720,2025-08-29,Senate,"Do pass",5,2,0,0,7
1893373,1542683,2025-04-09,Assembly,"Do pass and be re-referred to the Committee on [Local Government] with recommendation: To Consent Calendar",12,0,0,0,12
1893373,1556030,2025-04-23,Assembly,"Do pass and be re-referred to the Committee on [Appropriations] with recommendation: To Consent Calendar",10,0,0,0,10
1893373,1562918,2025-04-30,Assembly,"Do pass. To Consent Calendar",14,0,0,1,15
1893373,1568676,2025-05-08,Assembly,"AB 36 Soria Consent Calendar Second Day Regular Session",69,0,0,10,79
1893373,1598518,2025-07-15,Senate,"Do pass, but first be re-referred to the Committee on [Appropriations] with the recommendation: To Consent Calendar",10,0,0,1,11
1893373,1601549,2025-09-09,Senate,"Assembly 3rd Reading AB36 Soria By Padilla",40,0,0,0,40
1893376,1542830,2025-04-09,Assembly,"Do pass and be re-referred to the Committee on [Utilities and Energy]",10,0,0,0,10
1893376,1564296,2025-04-30,Assembly,"Do pass and be re-referred to the Committee on [Appropriations]",16,0,0,2,18
1893376,1575486,2025-05-21,Assembly,"Do pass",12,3,0,0,15
1893376,1584322,2025-06-03,Assembly,"AB 39 Zbur Assembly Third Reading",65,10,0,4,79
1893376,1597513,2025-07-02,Senate,"Do pass as amended, but first amend, and re-refer to the Committee on [Energy, Utilities and Communications]",5,2,0,0,7
1893376,1598458,2025-07-15,Senate,"Do pass as amended, but first amend, and re-refer to the Committee on [Appropriations]",12,4,0,1,17
1893376,1601664,2025-09-09,Senate,"Assembly 3rd Reading AB39 Zbur et al. By Limón",30,10,0,0,40
1893377,1533584,2025-04-01,Assembly,"Do pass and be re-referred to the Committee on [Appropriations]",11,2,0,2,15
1893378,1526967,2025-03-25,Assembly,"Do pass and be re-referred to the Committee on [Appropriations]",12,0,0,3,15
1893378,1542691,2025-04-09,Assembly,"Do pass",10,3,0,2,15
1893378,1552883,2025-04-21,Assembly,"AB 40 Bonta Third Reading Urgency",58,9,0,12,79
1893378,1589097,2025-06-11,Senate,"Do pass, but first be re-referred to the Committee on [Appropriations]",7,1,0,3,11
1893380,1526962,2025-03-25,Assembly,"Do pass and be re-referred to the Committee on [Appropriations]",7,0,0,0,7
1893380,1577346,2025-05-23,Assembly,"Do pass",14,0,0,1,15
1893380,1584354,2025-06-03,Assembly,"AB 42 Bryan Assembly Third Reading",79,0,0,0,79
1893380,1597242,2025-06-30,Senate,"Do pass, but first be re-referred to the Committee on [Appropriations] with the recommendation: To Consent Calendar",5,0,0,0,5
1893380,1598253,2025-07-14,Senate,"Placed on suspense file",7,0,0,0,7
1893380,1600717,2025-08-29,Senate,"Do pass",7,0,0,0,7
1893380,1601188,2025-09-04,Senate,"Special Consent AB42 Bryan",39,0,0,1,40
1893380,1601319,2025-09-08,Assembly,"AB 42 Bryan Concurrence in Senate Amendments",79,0,0,1,80
1893381,1525415,2025-03-24,Assembly,"Do pass and be re-referred to the Committee on [Appropriations]",11,0,0,3,14
1893381,1577153,2025-05-23,Assembly,"Do pass",11,1,0,3,15
1893381,1582257,2025-05-29,Assembly,"AB 43 Schultz Assembly Third Reading",57,3,0,19,79
1893381,1594597,2025-06-24,Senate,"Do pass, but first be re-referred to the Committee on [Appropriations]",5,2,0,0,7
1893381,1600929,2025-09-03,Senate,"Assembly 3rd Reading AB43 Schultz By Laird",30,10,0,0,40
1893382,1556198,2025-04-23,Assembly,"Do pass and be re-referred to the Committee on [Appropriations] with recommendation: To Consent Calendar",18,0,0,0,18
1893382,1577875,2025-05-23,Assembly,"Do pass",14,0,0,1,15
1893382,1582240,2025-05-29,Assembly,"AB 44 Schultz Assembly Third Reading",69,0,0,10,79
1893382,1598484,2025-07-15,Senate,"Do pass as amended, but first amend, and re-refer to the Committee on [Appropriations]",15,1,0,1,17
1893382,1599596,2025-08-18,Senate,"Placed on suspense file",7,0,0,0,7
1893382,1600714,2025-08-29,Senate,"Do pass",7,0,0,0,7
1893382,1601503,2025-09-09,Senate,"Assembly 3rd Reading AB44 Schultz By McNerney",40,0,0,0,40
1893383,1555919,2025-04-22,Assembly,"Do pass and be re-referred to the Committee on [Judiciary]",10,2,0,3,15
1893383,1561190,2025-04-29,Assembly,"Do pass and be re-referred to the Committee on [Appropriations]",9,2,0,1,12
1893383,1577541,2025-05-23,Assembly,"Do pass",11,2,0,2,15
1893383,1584275,2025-06-03,Assembly,"AB 45 Bauer-Kahan Assembly Third Reading",63,11,0,5,79
1893383,1598762,2025-07-15,Senate,"Do pass, but first be re-referred to the Committee on [Appropriations]",11,1,0,1,13
1893383,1599632,2025-08-18,Senate,"Placed on suspense file",7,0,0,0,7
1893383,1600710,2025-08-29,Senate,"Do pass",5,2,0,0,7
1893383,1602297,2025-09-12,Senate,"Assembly 3rd Reading AB45 Bauer-Kahan et al. By Menjivar",29,9,0,2,40
1893383,1602298,2025-09-13,Assembly,"AB 45 Bauer-Kahan Concurrence in Senate Amendments",61,12,0,7,80
1893384,1562748,2025-04-29,Assembly,"Do pass as amended and be re-referred to the Committee on [Appropriations]",8,0,0,1,9
1893384,1571634,2025-05-14,Assembly,"Do pass",13,1,0,1,15
1893384,1573629,2025-05-19,Assembly,"AB 46 Nguyen Assembly Third Reading",56,7,0,16,79
1893384,1597970,2025-07-08,Senate,"Do pass as amended, but first amend, and re-refer to the Committee on [Appropriations]",4,0,0,2,6
1893385,1554585,2025-04-22,Assembly,"Do pass as amended and be re-referred to the Committee on [Appropriations]",8,0,0,1,9
1893386,1555914,2025-04-22,Assembly,"Do pass and be re-referred to the Committee on [Housing and Community Development]",6,2,0,2,10
1893386,1562859,2025-04-30,Assembly,"Do pass and be re-referred to the Committee on [Appropriations]",9,1,0,2,12
1893386,1577797,2025-05-23,Assembly,"Do pass",11,3,0,1,15
1893386,1585066,2025-06-04,Assembly,"AB 48 Alvarez Assembly Third Reading",68,9,0,2,79
1893387,1544955,2025-04-09,Assembly,"Do pass as amended and be re-referred to the Committee on [Judiciary]",7,2,0,0,9
1893387,1561047,2025-04-29,Assembly,"Do pass and be re-referred to the Committee on [Appropriations]",8,2,0,2,12
1893387,1571572,2025-05-14,Assembly,"Do pass",11,4,0,0,15
1893387,1579275,2025-05-27,Assembly,"AB 49 Muratsuchi Third Reading Urgency",62,9,0,8,79
1893387,1598047,2025-07-09,Senate,"Do pass, but first be re-referred to the Committee on [Judiciary]",6,1,0,0,7
1893387,1598639,2025-07-15,Senate,"Do pass as amended, but first amend, and re-refer to the Committee on [Appropriations]",11,1,0,1,13
1893387,1599474,2025-08-18,Senate,"Do pass",5,2,0,0,7
1893387,1600833,2025-09-02,Senate,"Assembly 3rd Reading AB49 Muratsuchi et al. By Gonzalez Urgency Clause",33,0,0,7,40
1893387,1600834,2025-09-02,Assembly,"AB 49 MURATSUCHI Concurrence in Senate Amendments",61,7,0,11,79
1893388,1542735,2025-04-09,Assembly,"Do pass and be re-referred to the Committee on [Appropriations]",7,0,0,0,7
1893388,1577942,2025-05-23,Assembly,"Do pass",14,0,0,1,15
1893388,1582242,2025-05-29,Assembly,"AB 5 Berman Assembly Third Reading",71,0,0,8,79
1893388,1597194,2025-07-01,Senate,"Do pass as amended, but first amend, and re-refer to the Committee on [Appropriations]",5,0,0,0,5
1893388,1598301,2025-07-14,Senate,"Placed on suspense file",7,0,0,0,7
1893388,1600536,2025-08-29,Senate,"Do pass",7,0,0,0,7
1893388,1601269,2025-09-08,Senate,"Assembly 3rd Reading AB5 Berman et al. By Allen",38,0,0,2,40
1893388,1601518,2025-09-09,Assembly,"AB 5 Berman Concurrence in Senate Amendments",79,0,0,1,80
1893389,1533523,2025-04-01,Assembly,"Do pass as amended and be re-referred to the Committee on [Health]",17,0,0,1,18
1893389,1556061,2025-04-23,Assembly,"Do pass",15,0,0,0,15
1893389,1559381,2025-04-28,Assembly,"AB 50 Bonta Third Reading Urgency",73,0,0,6,79
1893389,1586923,2025-06-09,Senate,"Do pass, but first be re-referred to the Committee on [Appropriations]",7,0,0,4,11
1893389,1601254,2025-09-08,Senate,"Assembly 3rd Reading AB50 Bonta By Ashby Urgency Clause",39,0,0,1,40
1893390,1564175,2025-04-30,Assembly,"Do pass as amended and be re-referred to the Committee on [Appropriations]",6,2,0,1,9
1893392,1566726,2025-05-05,Assembly,"Do pass and be re-referred to the Committee on [Appropriations]",7,0,0,0,7
1893392,1577620,2025-05-23,Assembly,"Do pass",14,0,0,1,15
1893392,1582234,2025-05-29,Assembly,"AB 53 Ramos Assembly Third Reading",70,0,0,9,79
1893393,1540847,2025-04-08,Assembly,"Do pass and be re-referred to the Committee on [Judiciary]",12,0,0,3,15
1893393,1561153,2025-04-29,Assembly,"Do pass and be re-referred to the Committee on [Appropriations]",8,1,0,3,12
1893393,1567875,2025-05-07,Assembly,"Do pass",11,1,0,3,15
1893393,1569930,2025-05-12,Assembly,"AB 54 Krell Assembly Third Reading",61,10,0,8,79
1893393,1595672,2025-06-25,Senate,"Do pass as amended, but first amend, and re-refer to the Committee on [Judiciary]",9,1,0,1,11
1893393,1598741,2025-07-15,Senate,"Do pass, but first be re-referred to the Committee on [Appropriations]",11,0,0,2,13
1893394,1540944,2025-04-08,Assembly,"Do pass as amended and be re-referred to the Committee on [Appropriations]",15,0,0,0,15
1893394,1555939,2025-04-23,Assembly,"Do pass",15,0,0,0,15
1893394,1559378,2025-04-28,Assembly,"AB 55 Bonta Assembly Third Reading",75,0,0,4,79
1893394,1589127,2025-06-11,Senate,"Do pass, but first be re-referred to the Committee on [Appropriations] with the recommendation: To Consent Calendar",9,0,0,2,11
1893394,1596783,2025-06-30,Senate,"Placed on suspense file",6,0,0,1,7
1893394,1600479,2025-08-29,Senate,"Do pass",7,0,0,0,7
1893394,1601228,2025-09-08,Senate,"Assembly 3rd Reading AB55 Bonta et al. By Caballero",39,0,0,1,40
1893394,1601517,2025-09-09,Assembly,"AB 55 Bonta Concurrence in Senate Amendments",80,0,0,0,80
1893395,1556035,2025-04-22,Assembly,"Do pass and be re-referred to the Committee on [Judiciary]",11,1,0,3,15
1893395,1561004,2025-04-29,Assembly,"Do pass as amended and be re-referred to the Committee on [Appropriations]",10,1,0,1,12
1893395,1577323,2025-05-23,Assembly,"Do pass",11,1,0,3,15
1893395,1582244,2025-05-29,Assembly,"AB 56 Bauer-Kahan Assembly Third Reading",50,0,0,29,79
1893395,1597408,2025-07-01,Senate,"Do pass as amended, but first amend, and re-refer to the Committee on [Health]",12,0,0,1,13
1893395,1598880,2025-07-16,Senate,"Do pass, but first be re-referred to the Committee on [Appropriations]",10,0,0,1,11
1893395,1599567,2025-08-18,Senate,"Placed on suspense file",7,0,0,0,7
1893395,1600281,2025-08-29,Senate,"Do pass as amended",5,2,0,0,7
1893395,1601861,2025-09-11,Senate,"Assembly 3rd Reading AB56 Bauer-Kahan et al. By Weber Pierson",30,5,0,5,40
1893395,1602308,2025-09-12,Assembly,"AB 56 Bauer-Kahan Concurrence in Senate Amendments",59,7,0,14,80
1893396,1528248,2025-03-26,Assembly,"Do pass as amended and be re-referred to the Committee on [Judiciary]",8,0,0,3,11
1893396,1554631,2025-04-22,Assembly,"Do pass as amended and be re-referred to the Committee on [Appropriations]",9,2,0,1,12
1893396,1577311,2025-05-23,Assembly,"Do pass",11,1,0,3,15
1893396,1582256,2025-05-29,Assembly,"AB 57 McKinnor Assembly Third Reading",52,10,0,17,79
1893396,1591891,2025-06-17,Senate,"Do pass, but first be re-referred to the Committee on [Judiciary]",7,2,0,2,11
1893396,1597931,2025-07-08,Senate,"Do pass, but first be re-referred to the Committee on [Appropriations]",11,1,0,1,13
1893396,1599617,2025-08-18,Senate,"Placed on suspense file",7,0,0,0,7
1893396,1600723,2025-08-29,Senate,"Do pass as amended",5,2,0,0,7
1893396,1601295,2025-09-08,Senate,"Assembly 3rd Reading AB57 McKinnor et al. By Smallwood-Cuevas",28,9,0,3,40
1893396,1601675,2025-09-09,Assembly,"AB 57 McKinnor Concurrence in Senate Amendments",60,10,0,10,80
1893397,1561095,2025-04-29,Assembly,"Do pass and be re-referred to the Committee on [Appropriations] with recommendation: To Consent Calendar",10,0,0,0,10
1893398,1528314,2025-03-26,Assembly,"Do pass as amended",8,0,0,2,10
1893398,1533521,2025-04-01,Assembly,"AB 59 Aguiar-Curry Assembly Third Reading",77,0,0,3,80
1893398,1592595,2025-06-18,Senate,"Do pass as amended, but first amend, and re-refer to the Committee on [Energy, Utilities and Communications]",7,0,0,0,7
1893398,1597756,2025-07-07,Senate,"Do pass, but first be re-referred to the Committee on [Appropriations]",16,0,0,1,17
1893398,1600825,2025-09-02,Senate,"Assembly 3rd Reading AB59 Aguiar-Curry By Cabaldon",40,0,0,0,40
1893398,1600966,2025-09-03,Assembly,"AB 59 Aguiar-Curry Concurrence in Senate Amendments",79,0,0,0,79
1893399,1562772,2025-04-30,Assembly,"Do pass as amended and be re-referred to the Committee on [Appropriations]",11,0,0,1,12
1893399,1577488,2025-05-23,Assembly,"Do pass",14,0,0,1,15
1893399,1583535,2025-06-02,Assembly,"AB 6 Ward Assembly Third Reading",79,0,0,0,79
1893399,1597529,2025-07-01,Senate,"Do pass, but first be re-referred to the Committee on [Appropriations]",11,0,0,0,11
1893399,1598311,2025-07-14,Senate,"Placed on suspense file",7,0,0,0,7
1893400,1528321,2025-03-25,Assembly,"Do pass",5,1,0,1,7
1893400,1565242,2025-05-05,Assembly,"AB 60 Papan Assembly Third Reading",63,4,0,12,79
1893400,1597437,2025-07-02,Senate,"Do pass as amended",6,0,0,2,8
1893400,1601261,2025-09-08,Senate,"Assembly 3rd Reading AB60 Papan By Weber Pierson",36,0,0,4,40
1893400,1601674,2025-09-09,Assembly,"AB 60 Papan Concurrence in Senate Amendments",65,2,0,13,80
1893401,1528242,2025-03-26,Assembly,"Do pass as amended, and be re-referred to the Committee on [Appropriations] with recommendation: To Consent Calendar",18,0,0,0,18
1893401,1577520,2025-05-23,Assembly,"Do pass",14,0,0,1,15
1893401,1583523,2025-06-02,Assembly,"AB 61 Pacheco Assembly Third Reading",79,0,0,0,79
1893401,1597748,2025-07-07,Senate,"Do pass as amended, but first amend, and re-refer to the Committee on [Appropriations]",15,0,0,2,17
1893401,1599436,2025-08-18,Senate,"Placed on suspense file",7,0,0,0,7
1893402,1561134,2025-04-29,Assembly,"Do pass and be re-referred to the Committee on [Appropriations]",9,1,0,2,12
1893402,1577157,2025-05-23,Assembly,"Do pass",11,2,0,2,15
1893402,1582233,2025-05-29,Assembly,"AB 62 McKinnor Assembly Third Reading",57,4,0,18,79
1893402,1598774,2025-07-15,Senate,"Do pass, but first be re-referred to the Committee on [Appropriations]",13,0,0,0,13
1893402,1600070,2025-08-25,Senate,"Placed on suspense file",6,0,0,1,7
1893402,1600454,2025-08-29,Senate,"Do pass as amended",5,2,0,0,7
1893402,1601230,2025-09-08,Senate,"Assembly 3rd Reading AB62 McKinnor et al. By Smallwood-Cuevas",30,7,0,3,40
1893402,1601480,2025-09-09,Assembly,"AB 62 McKinnor Concurrence in Senate Amendments",66,4,0,10,80
1893404,1555947,2025-04-22,Assembly,"Do pass and be re-referred to the Committee on [Judiciary]",6,3,0,1,10
1893404,1561200,2025-04-29,Assembly,"Do pass and be re-referred to the Committee on [Appropriations]",8,2,0,2,12
1893404,1577440,2025-05-23,Assembly,"Do pass",11,3,0,1,15
1893404,1584414,2025-06-03,Assembly,"AB 7 Bryan Assembly Third Reading",54,17,0,8,79
1893404,1598117,2025-07-09,Senate,"Do pass, but first be re-referred to the Committee on [Judiciary]",5,2,0,0,7
1893404,1598659,2025-07-15,Senate,"Do pass, but first be re-referred to the Committee on [Appropriations]",11,2,0,0,13
1893404,1599395,2025-08-18,Senate,"Placed on suspense file",7,0,0,0,7
1893404,1600692,2025-08-29,Senate,"Do pass",5,2,0,0,7
1893404,1601673,2025-09-09,Senate,"Assembly 3rd Reading AB7 Bryan et al. By Richardson",30,10,0,0,40
1893404,1602364,2025-09-12,Assembly,"AB 7 Bryan Concurrence in Senate Amendments",55,18,0,7,80
1893405,1554551,2025-04-22,Assembly,"Do pass and be re-referred to the Committee on [Revenue and Taxation]",17,0,0,1,18
1893405,1561131,2025-04-28,Assembly,"Do pass as amended and be re-referred to the Committee on [Appropriations]",6,1,0,0,7
1893405,1577904,2025-05-23,Assembly,"Do pass as amended",11,0,0,4,15
1893405,1583370,2025-06-02,Assembly,"AB 8 Aguiar-Curry Assembly Third Reading",73,1,0,5,79
1893405,1597685,2025-07-07,Senate,"Do pass, but first be re-referred to the Committee on [Revenue and Taxation]",11,0,0,0,11
1893405,1598091,2025-07-09,Senate,"Do pass, but first be re-referred to the Committee on [Appropriations]",5,0,0,0,5
1893405,1599524,2025-08-18,Senate,"Placed on suspense file",7,0,0,0,7
1893405,1600482,2025-08-29,Senate,"Do pass as amended",7,0,0,0,7
1893405,1602057,2025-09-12,Senate,"Assembly 3rd Reading AB8 Aguiar-Curry By Ashby",37,0,0,3,40
1893405,1602058,2025-09-13,Assembly,"AB 8 AGUIAR-CURRY Concurrence in Senate Amendments",73,1,0,6,80
1893409,1591151,2025-06-16,Assembly,"Be adopted. To third reading",10,0,0,1,11
1893410,1511429,2025-03-10,Assembly,"Be adopted. To third reading",9,0,0,2,11
1893413,1569849,2025-05-12,Assembly,"Be adopted. To Consent Calendar",7,0,0,4,11
1893413,1572435,2025-05-15,Assembly,"ACR 5 Nguyen Consent Calendar Second Day Regular Session",69,0,0,10,79
1893413,1593162,2025-06-19,Senate,"Special Consent ACR5 Nguyen et al",35,0,0,5,40
1893415,1470866,2024-12-03,Assembly,"HR 1 PACHECO Assembly Third Reading",58,19,0,2,79
1893415,1564795,2024-12-02,Assembly,"HR 1 PACHECO Assembly Third Reading",58,19,0,2,79
1893416,1470867,2024-12-03,Assembly,"HR 2 RIVAS Assembly Third Reading By AGUIAR-CURRY",78,0,0,1,79
1893416,1564794,2024-12-02,Assembly,"HR 2 RIVAS Assembly Third Reading By AGUIAR-CURRY",78,0,0,1,79
1893417,1470868,2024-12-03,Assembly,"HR 3 RIVAS Assembly Third Reading By AGUIAR-CURRY",77,0,0,2,79
1893417,1564797,2024-12-02,Assembly,"HR 3 RIVAS Assembly Third Reading By AGUIAR-CURRY",77,0,0,2,79
1893418,1470869,2024-12-03,Assembly,"HR 4 ESSAYLI Assembly Third Reading Motion to Lay on the Table By AGUIAR-CURRY",58,19,0,2,79
1893418,1564793,2024-12-02,Assembly,"HR 4 ESSAYLI Assembly Third Reading Motion to Lay on the Table By AGUIAR-CURRY",58,19,0,2,79
1893420,1474061,2025-01-23,Assembly,"Be adopted. To Consent Calendar",10,0,0,1,11
1893420,1477873,2025-01-30,Assembly,"HR 6 Connolly Consent Calendar Second Day Regular Session",69,0,0,10,79
1893421,1516577,2025-03-12,Senate,"Do pass, but first be re-referred to the Committee on [Military and Veterans Affairs]",5,0,0,0,5
1893421,1559469,2025-04-28,Senate,"Do pass, but first be re-referred to the Committee on [Appropriations]",4,0,0,1,5
1893421,1569922,2025-05-12,Senate,"Placed on suspense file",7,0,0,0,7
1893422,1526886,2025-03-25,Senate,"Do pass, but first be re-referred to the Committee on [Appropriations]",11,3,0,1,15
1893422,1552820,2025-04-21,Senate,"Placed on suspense file",6,0,0,1,7
1893422,1577487,2025-05-23,Senate,"Do pass",5,1,0,1,7
1893422,1584363,2025-06-03,Senate,"Senate 3rd Reading SB10 Padilla",29,10,0,1,40
1893423,1535095,2025-04-01,Senate,"Do pass, but first be re-referred to the Committee on [Public Safety]",12,0,0,1,13
1893423,1554574,2025-04-22,Senate,"Do pass, but first be re-referred to the Committee on [Appropriations]",6,0,0,0,6
1893423,1565260,2025-05-05,Senate,"Placed on suspense file",7,0,0,0,7
1893423,1577876,2025-05-23,Senate,"Do pass as amended",6,0,0,1,7
1893423,1586419,2025-06-02,Senate,"Senate 3rd Reading SB11 Ashby",38,0,0,2,40
1893423,1591882,2025-06-17,Assembly,"Do pass as amended and be re-referred to the Committee on [Public Safety]",11,0,0,1,12
1893423,1597228,2025-07-01,Assembly,"Do pass and be re-referred to the Committee on [Privacy and Consumer Protection]",9,0,0,0,9
1893423,1598585,2025-07-16,Assembly,"Do pass as amended and be re-referred to the Committee on [Appropriations]",15,0,0,0,15
1893423,1600330,2025-08-29,Assembly,"Do pass as amended",11,0,0,4,15
1893423,1602299,2025-09-12,Senate,"Unfinished Business SB11 Ashby Concurrence",37,0,0,3,40
1893423,1602300,2025-09-12,Assembly,"SB 11 Ashby Senate Third Reading By Bauer-Kahan",79,0,0,1,80
1893424,1515256,2025-03-11,Senate,"Do pass as amended, but first amend, and re-refer to the Committee on [Judiciary]",11,1,0,3,15
1893424,1556135,2025-04-22,Senate,"Do pass, but first be re-referred to the Committee on [Appropriations]",11,0,0,2,13
1893424,1565314,2025-05-05,Senate,"Placed on suspense file",7,0,0,0,7
1893425,1521950,2025-03-19,Senate,"Do pass, but first be re-referred to the Committee on [Energy, Utilities and Communications] with the recommendation: To Consent Calendar",8,0,0,0,8
1893425,1538973,2025-04-07,Senate,"Do pass as amended, but first amend, and re-refer to the Committee on [Appropriations]",16,0,0,1,17
1893425,1559404,2025-04-28,Senate,"Placed on suspense file",7,0,0,0,7
1893426,1554581,2025-04-22,Senate,"Do pass as amended, but first amend, and re-refer to the Committee on [Environmental Quality]",8,5,0,2,15
1893426,1562896,2025-04-30,Senate,"Do pass as amended, but first amend, and re-refer to the Committee on [Appropriations]",5,2,0,1,8
1893426,1573522,2025-05-19,Senate,"Placed on suspense file",5,0,0,2,7
1893426,1577585,2025-05-23,Senate,"Do pass as amended",5,1,0,1,7
1893426,1585036,2025-06-04,Senate,"Senate 3rd Reading SB14 Blakespear",21,10,0,9,40
1893426,1597740,2025-07-07,Assembly,"Do pass as amended and be re-referred to the Committee on [Governmental Organization]",11,0,0,3,14
1893427,1526945,2025-03-25,Senate,"Do pass, but first be re-referred to the Committee on [Rules]",4,1,0,1,6
1893427,1538950,2025-04-07,Senate,"Placed on suspense file",7,0,0,0,7
1893428,1556156,2025-04-22,Senate,"Do pass as amended, but first amend, and re-refer to the Committee on [Health]",10,0,0,1,11
1893428,1569774,2025-05-12,Senate,"Placed on suspense file",7,0,0,0,7
1893428,1577584,2025-05-23,Senate,"Do pass",5,0,0,2,7
1893428,1584241,2025-06-03,Senate,"Senate 3rd Reading SB16 Blakespear",29,2,0,9,40
1893429,1555910,2025-04-23,Senate,"Do pass as amended, but first amend, and re-refer to the Committee on [Labor, Public Employment and Retirement ]",5,0,0,0,5
1893429,1569891,2025-05-12,Senate,"Placed on suspense file",7,0,0,0,7
1893430,1561202,2025-04-29,Senate,"Do pass as amended, but first amend, and re-refer to the Committee on [Appropriations]",4,0,0,1,5
1893430,1573572,2025-05-19,Senate,"Placed on suspense file",5,0,0,2,7
1893430,1577468,2025-05-23,Senate,"Do pass",6,0,0,1,7
1893430,1581696,2025-05-29,Senate,"Special Consent SB18 Rubio et al",38,0,0,2,40
1893430,1597455,2025-07-02,Assembly,"Do pass and be re-referred to the Committee on [Appropriations]",7,0,0,1,8
1893431,1526968,2025-03-25,Senate,"Do pass, but first be re-referred to the Committee on [Appropriations]",6,0,0,0,6
1893431,1538923,2025-04-07,Senate,"Placed on suspense file",7,0,0,0,7
1893431,1577267,2025-05-23,Senate,"Do pass as amended",6,0,0,1,7
1893431,1586395,2025-06-02,Senate,"Senate 3rd Reading SB19 Rubio et al",38,0,0,2,40
1893431,1597278,2025-07-01,Assembly,"Do pass and be re-referred to the Committee on [Appropriations]",8,0,0,1,9
1893431,1600491,2025-08-29,Assembly,"Do pass",15,0,0,0,15
1893431,1601574,2025-09-09,Assembly,"SB 19 Rubio Senate Third Reading By Patel",74,0,0,6,80
1893431,1601847,2025-09-11,Senate,"Unfinished Business SB19 Rubio et al. Concurrence",40,0,0,0,40
1893432,1522002,2025-03-19,Senate,"Do pass, but first be re-referred to the Committee on [Appropriations]",3,2,0,3,8
1893432,1522003,2025-03-19,Senate,"[First] hearing set for [03-19-2025]: Failed passage in Committee. Reconsideration granted",8,0,0,0,8
1893433,1528273,2025-03-26,Senate,"Do pass as amended, but first amend, and re-refer to the Committee on [Health]",5,0,0,0,5
1893433,1552843,2025-04-21,Senate,"Placed on suspense file",6,0,0,1,7
1893433,1577667,2025-05-23,Senate,"Do pass as amended",6,0,0,1,7
1893433,1586420,2025-06-02,Senate,"Senate 3rd Reading SB20 Menjivar et al",38,0,0,2,40
1893433,1598024,2025-07-09,Assembly,"Do pass and be re-referred to the Committee on [Appropriations]",6,0,0,1,7
1893433,1600461,2025-08-29,Assembly,"Do pass as amended",11,0,0,4,15
1893433,1601340,2025-09-08,Assembly,"SB 20 Menjivar Senate Third Reading By Celeste Rodriguez",77,0,0,3,80
1893433,1601519,2025-09-09,Senate,"Unfinished Business SB20 Menjivar et al. Concurrence",40,0,0,0,40
1893434,1555981,2025-04-23,Senate,"Do pass, but first be re-referred to the Committee on [Housing]",7,0,0,0,7
1893434,1562866,2025-04-29,Senate,"Do pass, but first be re-referred to the Committee on [Appropriations]",11,0,0,0,11
1893434,1579289,2025-05-27,Senate,"Senate 3rd Reading SB21 Durazo",39,0,0,1,40
1893434,1597471,2025-07-02,Assembly,"Do pass as amended and be re-referred to the Committee on [Local Government]",12,0,0,0,12
1893434,1598836,2025-07-16,Assembly,"Do pass. To Consent Calendar",10,0,0,0,10
1893434,1599030,2025-07-16,Assembly,"Do pass and be re-referred to the Committee on [Appropriations] with recommendation: To Consent Calendar",10,0,0,0,10
1893434,1599779,2025-08-20,Assembly,"Do pass. To Consent Calendar",15,0,0,0,15
1893434,1601341,2025-09-08,Assembly,"SB 21 Durazo Senate Third Reading By Mark González",79,0,0,1,80
1893434,1601600,2025-09-09,Senate,"Unfinished Business SB21 Durazo et al. Concurrence",40,0,0,0,40
1893435,1542756,2025-04-08,Senate,"Do pass as amended",11,2,0,0,13
1893435,1586444,2025-06-02,Senate,"Senate 3rd Reading SB22 Laird",27,10,0,3,40
1893435,1594675,2025-06-24,Assembly,"Do pass as amended",9,4,0,2,15
1893435,1602073,2025-09-12,Senate,"Unfinished Business SB22 Laird Concurrence",37,0,0,3,40
1893436,1516569,2025-03-12,Senate,"Do pass, but first be re-referred to the Committee on [Military and Veterans Affairs]",5,0,0,0,5
1893437,1554468,2025-04-21,Senate,"Do pass, but first be re-referred to the Committee on [Judiciary]",13,4,0,0,17
1893437,1565273,2025-05-05,Senate,"Placed on suspense file",7,0,0,0,7
1893437,1577442,2025-05-23,Senate,"Do pass",5,1,0,1,7
1893437,1586428,2025-06-02,Senate,"Senate 3rd Reading SB24 McNerney",28,10,0,2,40
1893437,1595202,2025-06-25,Assembly,"Do pass as amended and be re-referred to the Committee on [Appropriations]",11,1,0,6,18
1893437,1600608,2025-08-29,Assembly,"Do pass as amended",9,1,0,5,15
1893437,1602142,2025-09-12,Senate,"Unfinished Business SB24 McNerney et al. Concurrence",29,9,0,2,40
1893438,1542879,2025-04-08,Senate,"Do pass as amended, but first amend, and re-refer to the Committee on [Appropriations]",12,0,0,1,13
1893438,1559465,2025-04-28,Senate,"Placed on suspense file",7,0,0,0,7
1893438,1577161,2025-05-23,Senate,"Do pass",6,0,0,1,7
1893438,1586409,2025-06-02,Senate,"Senate 3rd Reading SB25 Umberg",36,1,0,3,40
1893438,1594576,2025-06-24,Assembly,"Do pass and be re-referred to the Committee on [Appropriations]",10,0,0,2,12
1893438,1600644,2025-08-29,Assembly,"Do pass",11,1,0,3,15
1893439,1487029,2025-02-11,Senate,"Do pass, but first be re-referred to the Committee on [Business, Professions and Economic Development]",10,1,0,2,13
1893439,1503908,2025-03-03,Senate,"Do pass as amended, but first amend, and re-refer to the Committee on [Appropriations]",8,0,0,3,11
1893439,1517828,2025-03-13,Senate,"Senate 3rd Reading SB26 Umberg et al. Urgency Clause",35,0,0,5,40
1893439,1528286,2025-03-26,Assembly,"Do pass",9,0,0,3,12
1893439,1533497,2025-04-01,Senate,"Unfinished Business SB26 Umberg et al. Urgency Clause Concurrence",38,1,0,1,40
1893439,1533498,2025-04-01,Assembly,"SB 26 Umberg Third Reading Urgency By Kalra",77,0,0,3,80
1893440,1542742,2025-04-08,Senate,"Do pass",12,0,0,1,13
1893440,1579251,2025-05-27,Senate,"Senate 3rd Reading SB27 Umberg Urgency Clause",39,0,0,1,40
1893440,1597197,2025-07-01,Assembly,"Do pass and be re-referred to the Committee on [Health]",11,0,0,1,12
1893440,1598105,2025-07-08,Assembly,"Do pass and be re-referred to the Committee on [Public Safety]",16,0,0,0,16
1893440,1598556,2025-07-15,Assembly,"Do pass as amended and be re-referred to the Committee on [Appropriations]",9,0,0,0,9
1893440,1600603,2025-08-29,Assembly,"Do pass as amended",11,0,0,4,15
1893440,1602296,2025-09-12,Senate,"Unfinished Business SB27 Umberg Concurrence",38,0,0,2,40
1893441,1526889,2025-03-25,Senate,"Do pass, but first be re-referred to the Committee on [Appropriations]",6,0,0,0,6
1893441,1538866,2025-04-07,Senate,"Placed on suspense file",7,0,0,0,7
1893441,1577160,2025-05-23,Senate,"Do pass as amended",6,0,0,1,7
1893441,1581770,2025-05-29,Senate,"Senate 3rd Reading SB28 Umberg et al. Urgency Clause",38,0,0,2,40
1893442,1535054,2025-04-01,Senate,"Do pass, but first be re-referred to the Committee on [Appropriations]",9,2,0,2,13
1893442,1552909,2025-04-21,Senate,"Placed on suspense file",6,0,0,1,7
1893442,1577692,2025-05-23,Senate,"Do pass as amended",5,1,0,1,7
1893442,1585087,2025-06-04,Senate,"Senate 3rd Reading SB29 Laird",21,10,0,9,40
1893442,1597927,2025-07-08,Assembly,"Do pass and be re-referred to the Committee on [Appropriations]",9,3,0,0,12
1893443,1561090,2025-04-29,Senate,"Do pass, but first be re-referred to the Committee on [Appropriations]",5,0,0,0,5
1893443,1569911,2025-05-12,Senate,"Placed on suspense file",7,0,0,0,7
1893443,1577752,2025-05-23,Senate,"Do pass as amended",6,0,0,1,7
1893443,1585025,2025-06-04,Senate,"Special Consent SB3 Cervantes",39,0,0,1,40
1893443,1598561,2025-07-16,Assembly,"Do pass as amended and be re-referred to the Committee on [Appropriations]",7,0,0,0,7
1893443,1600750,2025-08-29,Assembly,"Do pass",15,0,0,0,15
1893443,1601352,2025-09-08,Assembly,"SB 3 Cervantes Senate Third Reading By Berman",79,0,0,1,80
1893443,1601768,2025-09-10,Senate,"Unfinished Business SB3 Cervantes et al. Concurrence",40,0,0,0,40
1893444,1542877,2025-04-08,Senate,"Do pass, but first be re-referred to the Committee on [Environmental Quality]",11,3,0,1,15
1893444,1562815,2025-04-30,Senate,"Do pass as amended, but first amend, and re-refer to the Committee on [Appropriations]",6,0,0,2,8
1893444,1580558,2025-05-28,Senate,"Senate 3rd Reading SB30 Cortese",28,10,0,2,40
1893444,1598450,2025-07-14,Assembly,"Do pass as amended and be re-referred to the Committee on [Appropriations]",10,5,0,1,16
1893444,1599739,2025-08-20,Assembly,"Do pass",11,4,0,0,15
1893444,1601531,2025-09-09,Assembly,"SB 30 Cortese Senate Third Reading By Wilson",53,22,0,5,80
1893444,1601722,2025-09-10,Senate,"Unfinished Business SB30 Cortese et al. Concurrence",29,10,0,1,40
1893445,1526905,2025-03-25,Senate,"Do pass as amended, but first amend, and re-refer to the Committee on [Environmental Quality]",7,0,0,0,7
1893445,1563095,2025-04-30,Senate,"Do pass, but first be re-referred to the Committee on [Appropriations]",8,0,0,0,8
1893445,1569877,2025-05-12,Senate,"Placed on suspense file",7,0,0,0,7
1893445,1577188,2025-05-23,Senate,"Do pass",5,0,0,2,7
1893445,1577189,2025-05-23,Senate,"[05-23-2025] set for [First] hearing: Reconsideration of favorable vote granted",6,0,0,1,7
1893445,1577190,2025-05-23,Senate,"Do pass",6,0,0,1,7
1893445,1581708,2025-05-29,Senate,"Special Consent SB31 McNerney et al",38,0,0,2,40
1893445,1591865,2025-06-17,Assembly,"Do pass and be re-referred to the Committee on [Environmental Safety and Toxic Materials]",10,0,0,3,13
1893445,1597181,2025-07-01,Assembly,"Do pass and be re-referred to the Committee on [Appropriations] with recommendation: To Consent Calendar",7,0,0,0,7
1893445,1600679,2025-08-29,Assembly,"Do pass",15,0,0,0,15
1893445,1600937,2025-09-03,Assembly,"SB 31 McNerney Senate Third Reading By Alvarez",79,0,0,0,79
1893445,1601195,2025-09-04,Senate,"Unfinished Business SB31 McNerney et al. Concurrence",39,0,0,1,40
1893446,1564259,2025-04-30,Senate,"Do pass, but first be re-referred to the Committee on [Appropriations]",9,0,0,2,11
1893446,1569839,2025-05-12,Senate,"Placed on suspense file",7,0,0,0,7
1893446,1577910,2025-05-23,Senate,"Do pass",6,0,0,1,7
1893446,1586430,2025-06-02,Senate,"Senate 3rd Reading SB32 Weber Pierson",36,0,0,4,40
1893446,1597246,2025-07-01,Assembly,"Do pass and be re-referred to the Committee on [Appropriations]",15,0,0,1,16
1893447,1521980,2025-03-19,Senate,"Do pass, but first be re-referred to the Committee on [Human Services]",6,1,0,0,7
1893447,1552831,2025-04-21,Senate,"Do pass, but first be re-referred to the Committee on [Appropriations]",5,0,0,0,5
1893447,1565227,2025-05-05,Senate,"Placed on suspense file",7,0,0,0,7
1893448,1556165,2025-04-23,Senate,"Do pass, but first be re-referred to the Committee on [Transportation]",8,0,0,0,8
1893448,1561019,2025-04-28,Senate,"Do pass as amended, but first amend, and re-refer to the Committee on [Appropriations]",14,0,0,1,15
1893448,1569920,2025-05-12,Senate,"Placed on suspense file",7,0,0,0,7
1893448,1577765,2025-05-23,Senate,"Do pass",6,0,0,1,7
1893448,1584279,2025-06-03,Senate,"Senate 3rd Reading SB34 Richardson",31,1,0,8,40
1893448,1597731,2025-07-07,Assembly,"Do pass as amended and be re-referred to the Committee on [Transportation]",10,1,0,3,14
1893448,1598404,2025-07-14,Assembly,"Do pass as amended and be re-referred to the Committee on [Appropriations]",14,0,0,2,16
1893448,1600702,2025-08-29,Assembly,"Do pass",15,0,0,0,15
1893448,1602082,2025-09-12,Senate,"Unfinished Business SB34 Richardson Motion to Reconsider Concurrence",30,0,0,10,40
1893448,1602083,2025-09-12,Senate,"Unfinished Business SB34 Richardson Motion to Reconsider Concurrence Reconsider",35,0,0,5,40
1893448,1602084,2025-09-12,Senate,"Unfinished Business SB34 Richardson Motion to Reconsider Concurrence",30,0,0,10,40
1893449,1526955,2025-03-25,Senate,"Do pass, but first be re-referred to the Committee on [Appropriations] with the recommendation: To Consent Calendar",6,0,0,0,6
1893449,1538909,2025-04-07,Senate,"Placed on suspense file",7,0,0,0,7
1893449,1577959,2025-05-23,Senate,"Do pass as amended",6,0,0,1,7
1893449,1586432,2025-06-02,Senate,"Senate 3rd Reading SB4 Cervantes et al",38,0,0,2,40
1893449,1591881,2025-06-17,Assembly,"Do pass and be re-referred to the Committee on [Appropriations] with recommendation: To Consent Calendar",9,0,0,0,9
1893450,1555964,2025-04-23,Senate,"Do pass as amended",5,2,0,0,7
1893450,1586351,2025-06-02,Senate,"Senate 3rd Reading SB5 Cabaldon",32,5,0,3,40
1893450,1598851,2025-07-16,Assembly,"Do pass",9,0,0,1,10
1893450,1601374,2025-09-08,Assembly,"SB 5 Cabaldon Senate Third Reading By Wilson",67,2,0,11,80
1893450,1601563,2025-09-09,Senate,"Unfinished Business SB5 Cabaldon Concurrence",33,6,0,1,40
1893451,1526911,2025-03-25,Senate,"Do pass, but first be re-referred to the Committee on [Appropriations]",6,0,0,0,6
1893451,1538940,2025-04-07,Senate,"Placed on suspense file",7,0,0,0,7
1893451,1577755,2025-05-23,Senate,"Do pass",6,0,0,1,7
1893451,1584367,2025-06-03,Senate,"Senate 3rd Reading SB6 Ashby",38,0,0,2,40
1893451,1597236,2025-07-01,Assembly,"Do pass and be re-referred to the Committee on [Appropriations]",9,0,0,0,9
1893452,1542930,2025-04-09,Senate,"Do pass, but first be re-referred to the Committee on [Judiciary]",4,1,0,0,5
1893452,1562926,2025-04-29,Senate,"Do pass as amended, but first amend, and re-refer to the Committee on [Appropriations]",11,2,0,0,13
1893452,1573502,2025-05-19,Senate,"Placed on suspense file",5,0,0,2,7
1893452,1577935,2025-05-23,Senate,"Do pass",5,1,0,1,7
1893452,1586388,2025-06-02,Senate,"Senate 3rd Reading SB7 McNerney et al",27,10,0,3,40
1893452,1595678,2025-06-25,Assembly,"Do pass and be re-referred to the Committee on [Privacy and Consumer Protection]",5,0,0,2,7
1893452,1598719,2025-07-16,Assembly,"Do pass and be re-referred to the Committee on [Appropriations]",9,4,0,2,15
1893452,1600264,2025-08-29,Assembly,"Do pass as amended",10,4,0,1,15
1893452,1602234,2025-09-12,Senate,"Unfinished Business SB7 McNerney et al. Concurrence",28,9,0,3,40
1893453,1528292,2025-03-26,Senate,"Do pass as amended",5,0,0,0,5
1893453,1579255,2025-05-27,Senate,"Senate 3rd Reading SB8 Ashby et al",39,0,0,1,40
1893453,1598035,2025-07-09,Assembly,"Do pass",14,0,0,3,17
1893453,1600212,2025-08-28,Assembly,"SB 8 Ashby Senate Third Reading By Krell",75,0,0,4,79
1893454,1556076,2025-04-22,Senate,"Do pass as amended, but first amend, and re-refer to the Committee on [Local Government]",10,1,0,0,11
1893454,1567866,2025-05-07,Senate,"Do pass as amended",5,0,0,2,7
1893454,1580537,2025-05-28,Senate,"Senate 3rd Reading SB9 Arreguín",28,4,0,8,40
1893454,1592571,2025-06-18,Assembly,"Do pass as amended and be re-referred to the Committee on [Local Government]",9,0,0,3,12
1893454,1598868,2025-07-16,Assembly,"Do pass",9,0,0,1,10
1893454,1600238,2025-08-28,Assembly,"SB 9 Arreguín Senate Third Reading By Carrillo",62,2,0,15,79
1893454,1600948,2025-09-03,Senate,"Unfinished Business SB9 Arreguín et al. Concurrence",31,3,0,6,40
1893455,1469564,2024-12-02,Senate,"W/O REF. TO FILE SCR1 McGuire",29,9,0,1,39
1893455,1536784,2025-04-03,Assembly,"SCR 1 McGuire Senate Third Reading By Pacheco",56,19,0,4,79
1893456,1469565,2024-12-02,Senate,"W/O REF. TO FILE SCR2 Umberg",37,1,0,1,39
1893456,1470870,2024-12-03,Assembly,"SCR 2 Umberg Senate Third Reading By AGUIAR-CURRY",78,0,0,1,79
1893456,1564798,2024-12-02,Assembly,"SCR 2 Umberg Senate Third Reading By AGUIAR-CURRY",78,0,0,1,79
1893457,1483663,2025-02-06,Senate,"Senate 3rd Reading SCR3 Laird",33,0,0,6,39
1893457,1591902,2025-06-17,Assembly,"Be adopted. To Consent Calendar",7,0,0,0,7
1893457,1594072,2025-06-23,Assembly,"SCR 3 Laird Consent Calendar Second Day Regular Session",71,0,0,8,79
1893458,1559377,2025-04-28,Senate,"Senate 3rd Reading SCR4 Umberg et al",39,0,0,1,40
1893458,1573553,2025-05-19,Assembly,"Be adopted. To Consent Calendar",6,0,0,5,11
1893458,1577453,2025-05-23,Assembly,"SCR 4 Umberg Consent Calendar Second Day Regular Session",71,0,0,8,79
1893462,1469566,2024-12-02,Senate,"W/O REF. TO FILE SR4 Gonzalez",29,9,0,1,39
1893465,1477878,2025-01-30,Senate,"Senate 3rd Reading SR7 Ochoa Bogh et al",36,0,0,3,39
1894276,1473353,2025-01-22,Senate,"Do pass",8,2,0,0,10
1894276,1474135,2025-01-23,Senate,"Senate 3rd Reading SB1 Wiener et al",27,9,0,3,39
1894276,1479278,2025-02-03,Assembly,"SB 1 Wiener Senate Third Reading By GABRIEL Amend By DEMAIO Set #1 Motion to Lay on the Table By AGUIAR-CURRY First Extraordinary Session",56,17,0,6,79
1894276,1479279,2025-02-03,Assembly,"SB 1 Wiener Senate Third Reading By GABRIEL Motion First Extraordinary Session",59,3,0,17,79
1894276,1479280,2025-02-03,Assembly,"SB 1 Wiener Senate Third Reading By GABRIEL First Extraordinary Session",58,17,0,4,79
1894442,1526932,2025-03-25,Assembly,"Do pass and be re-referred to the Committee on [Appropriations]",15,0,0,0,15
1894442,1577941,2025-05-23,Assembly,"Do pass",14,0,0,1,15
1894442,1582241,2025-05-29,Assembly,"AB 64 Pacheco Assembly Third Reading",69,0,0,10,79
1894442,1592599,2025-06-18,Senate,"Do pass as amended, but first amend, and re-refer to the Committee on [Appropriations]",10,0,0,1,11
1894442,1597674,2025-07-07,Senate,"Placed on suspense file",6,0,0,1,7
1894442,1600588,2025-08-29,Senate,"Do pass",7,0,0,0,7
1894442,1601590,2025-09-09,Senate,"Assembly 3rd Reading AB64 Pacheco et al. By Limón",40,0,0,0,40
1894443,1516570,2025-03-12,Assembly,"Do pass and be re-referred to the Committee on [Higher Education]",8,0,0,1,9
1894443,1556129,2025-04-22,Assembly,"Do pass and be re-referred to the Committee on [Appropriations]",8,0,0,2,10
1894443,1577817,2025-05-23,Assembly,"Do pass",11,0,0,4,15
1894443,1582247,2025-05-29,Assembly,"AB 65 Aguiar-Curry Assembly Third Reading",62,0,0,17,79
1894444,1525416,2025-03-24,Assembly,"Do pass and be re-referred to the Committee on [Appropriations]",10,0,0,4,14
1894444,1577751,2025-05-23,Assembly,"Do pass",14,0,0,1,15
1894444,1585819,2025-06-05,Assembly,"AB 66 Tangipa Assembly Third Reading",58,1,0,20,79
1894444,1597453,2025-07-02,Senate,"Do pass as amended, but first amend, and re-refer to the Committee on [Natural Resources and Water]",7,0,0,1,8
1894445,1557476,2025-04-23,Senate,"Do pass, but first be re-referred to the Committee on [Judiciary]",11,0,0,0,11
1894445,1562905,2025-04-29,Senate,"Do pass as amended, but first amend, and re-refer to the Committee on [Appropriations]",13,0,0,0,13
1894445,1569764,2025-05-12,Senate,"Placed on suspense file",7,0,0,0,7
1894445,1577822,2025-05-23,Senate,"Do pass",6,0,0,1,7
1894445,1581737,2025-05-29,Senate,"Special Consent SB35 Umberg",38,0,0,2,40
1894445,1598406,2025-07-15,Assembly,"Do pass as amended and be re-referred to the Committee on [Appropriations]",16,0,0,0,16
1894446,1542913,2025-04-08,Senate,"Do pass, but first be re-referred to the Committee on [Public Safety]",10,0,0,3,13
1894446,1554634,2025-04-22,Senate,"Do pass, but first be re-referred to the Committee on [Appropriations]",5,1,0,0,6
1894446,1565225,2025-05-05,Senate,"Placed on suspense file",7,0,0,0,7
1894446,1577648,2025-05-23,Senate,"Do pass as amended",5,1,0,1,7
1894446,1584268,2025-06-03,Senate,"Senate 3rd Reading SB36 Umberg et al",29,7,0,4,40
1894446,1594641,2025-06-24,Assembly,"Do pass as amended and be re-referred to the Committee on [Public Safety]",9,3,0,0,12
1894446,1598733,2025-07-15,Assembly,"Do pass as amended and be re-referred to the Committee on [Appropriations]",7,2,0,0,9
1894446,1600716,2025-08-29,Assembly,"Do pass as amended",11,4,0,0,15
1894446,1601572,2025-09-09,Assembly,"SB 36 Umberg Senate Third Reading By Krell",60,17,0,3,80
1894446,1601914,2025-09-11,Senate,"Unfinished Business SB36 Umberg et al. Concurrence",30,8,0,2,40
1894447,1562961,2025-04-29,Senate,"Do pass, but first be re-referred to the Committee on [Appropriations]",13,0,0,0,13
1894447,1569803,2025-05-12,Senate,"Placed on suspense file",7,0,0,0,7
1894447,1577794,2025-05-23,Senate,"Do pass",6,0,0,1,7
1894447,1585805,2025-06-05,Senate,"Senate 3rd Reading SB37 Umberg",36,0,0,4,40
1894447,1597833,2025-07-08,Assembly,"Do pass and be re-referred to the Committee on [Appropriations]",12,0,0,0,12
1894447,1600517,2025-08-29,Assembly,"Do pass as amended",11,0,0,4,15
1894447,1602140,2025-09-12,Senate,"Unfinished Business SB37 Umberg Concurrence",37,0,0,3,40
1894448,1540941,2025-04-08,Senate,"Do pass as amended, but first amend, and re-refer to the Committee on [Appropriations]",6,0,0,0,6
1894448,1559418,2025-04-28,Senate,"Placed on suspense file",7,0,0,0,7
1894449,1521988,2025-03-19,Senate,"Do pass and be ordered to the Consent Calendar",8,0,0,0,8
1894449,1530385,2025-03-28,Senate,"Consent Calendar 2nd SB39 Weber Pierson Urgency Clause",34,0,0,6,40
1894449,1591892,2025-06-17,Assembly,"Do pass. To Consent Calendar",7,0,0,0,7
1894449,1596038,2025-06-27,Assembly,"SB 39 Weber Pierson Consent Calendar Second Day Regular Session",75,0,0,4,79
1894449,1601366,2025-09-08,Assembly,"SB 39 Weber Pierson Third Reading Urgency By Irwin",78,0,0,2,80
1894449,1601917,2025-09-11,Senate,"Unfinished Business SB39 Weber Pierson Urgency Clause Concurrence",40,0,0,0,40
1894450,1535046,2025-04-02,Senate,"Do pass as amended, but first amend, and re-refer to the Committee on [Appropriations]",11,0,0,0,11
1894450,1552932,2025-04-21,Senate,"Placed on suspense file",6,0,0,1,7
1894450,1577365,2025-05-23,Senate,"Do pass as amended",6,0,0,1,7
1894450,1580506,2025-05-28,Senate,"Senate 3rd Reading SB40 Wiener et al",37,0,0,3,40
1894450,1598444,2025-07-15,Assembly,"Do pass as amended and be re-referred to the Committee on [Appropriations]",16,0,0,0,16
1894450,1599727,2025-08-20,Assembly,"Do pass",15,0,0,0,15
1894450,1600964,2025-09-03,Assembly,"SB 40 Wiener Senate Third Reading By Bains",79,0,0,0,79
1894450,1601539,2025-09-09,Senate,"Unfinished Business SB40 Wiener et al. Concurrence",40,0,0,0,40
1894451,1557473,2025-04-23,Senate,"Do pass, but first be re-referred to the Committee on [Judiciary]",11,0,0,0,11
1894451,1562835,2025-04-29,Senate,"Do pass, but first be re-referred to the Committee on [Appropriations]",13,0,0,0,13
1894451,1569919,2025-05-12,Senate,"Placed on suspense file",7,0,0,0,7
1894451,1577759,2025-05-23,Senate,"Do pass",6,0,0,1,7
1894451,1580489,2025-05-28,Senate,"Senate 3rd Reading SB41 Wiener et al",37,0,0,3,40
1894451,1598019,2025-07-08,Assembly,"Do pass and be re-referred to the Committee on [Judiciary]",14,0,0,2,16
1894451,1598381,2025-07-15,Assembly,"Do pass as amended and be re-referred to the Committee on [Appropriations]",11,0,0,1,12
1894451,1600695,2025-08-29,Assembly,"Do pass as amended",11,0,0,4,15
1894451,1601521,2025-09-09,Assembly,"SB 41 Wiener Senate Third Reading By Bonta",69,2,0,9,80
1894451,1601718,2025-09-10,Senate,"Unfinished Business SB41 Wiener et al. Concurrence",40,0,0,0,40
1894656,1540905,2025-04-08,Assembly,"Do pass and be re-referred to the Committee on [Privacy and Consumer Protection]",9,3,0,0,12
1894656,1564149,2025-05-01,Assembly,"Do pass and be re-referred to the Committee on [Appropriations]",10,2,0,3,15
1894817,1533573,2025-04-01,Senate,"Do pass as amended, but first amend, and re-refer to the Committee on [Appropriations]",4,1,0,0,5
1894817,1552862,2025-04-21,Senate,"Placed on suspense file",6,0,0,1,7
1894817,1577574,2025-05-23,Senate,"Do pass as amended",5,1,0,1,7
1894817,1586417,2025-06-02,Senate,"Senate 3rd Reading SB42 Umberg et al",28,10,0,2,40
1894817,1597451,2025-07-02,Assembly,"Do pass and be re-referred to the Committee on [Appropriations]",5,2,0,0,7
1894817,1600752,2025-08-29,Assembly,"Do pass",11,4,0,0,15
1894817,1602271,2025-09-12,Senate,"Unfinished Business SB42 Umberg et al. Concurrence",29,8,0,3,40
1894817,1602272,2025-09-12,Assembly,"SB 42 Umberg Senate Third Reading By Lee",59,20,0,1,80
1894818,1563057,2025-04-29,Senate,"Do pass, but first be re-referred to the Committee on [Appropriations]",13,0,0,0,13
1894818,1569879,2025-05-12,Senate,"Placed on suspense file",7,0,0,0,7
1894819,1555943,2025-04-22,Senate,"Do pass, but first be re-referred to the Committee on [Appropriations] with the recommendation: To Consent Calendar",13,0,0,0,13
1894819,1565311,2025-05-05,Senate,"Placed on suspense file",7,0,0,0,7
1894820,1472238,2025-01-17,Senate,"Senate 3rd Reading SCR5 Ochoa Bogh",32,0,0,7,39
1894820,1485621,2025-02-10,Assembly,"Be adopted. To Consent Calendar",9,0,0,2,11
1895841,1534990,2025-04-02,Assembly,"Do pass and be re-referred to the Committee on [Appropriations] with recommendation: To Consent Calendar",17,0,0,0,17
1895841,1577199,2025-05-23,Assembly,"Do pass",14,0,0,1,15
1895841,1585809,2025-06-05,Assembly,"AB 69 Calderon Assembly Third Reading",78,0,0,1,79
1896226,1525474,2025-03-24,Assembly,"Do pass and be re-referred to the Committee on [Appropriations]",13,0,0,1,14
1896226,1577509,2025-05-23,Assembly,"Do pass as amended",11,0,0,4,15
1896226,1583393,2025-06-02,Assembly,"AB 70 Aguiar-Curry Assembly Third Reading",79,0,0,0,79
1896226,1597480,2025-07-02,Senate,"Do pass, but first be re-referred to the Committee on [Appropriations] with the recommendation: To Consent Calendar",8,0,0,0,8
1896226,1598233,2025-07-14,Senate,"Placed on suspense file",7,0,0,0,7
1896226,1600373,2025-08-29,Senate,"Do pass",7,0,0,0,7
1896226,1601802,2025-09-10,Senate,"Assembly 3rd Reading AB70 Aguiar-Curry By Grayson",40,0,0,0,40
1896227,1505321,2025-03-04,Assembly,"Do pass as amended and be re-referred to the Committee on [Appropriations]",9,0,0,0,9
1896625,1526906,2025-03-25,Assembly,"Do pass and be re-referred to the Committee on [Appropriations]",14,0,0,1,15
1896626,1530375,2025-03-28,Assembly,"Be adopted. To third reading",7,0,0,4,11
1896626,1557516,2025-04-24,Senate,"Special Consent ACR6 Ta et al. By Cortese",37,0,0,3,40
1896627,1483686,2025-02-06,Senate,"Special Consent ACR7 Bryan et al",37,0,0,2,39
1896628,1521970,2025-03-19,Senate,"Do pass, but first be re-referred to the Committee on [Appropriations]",5,2,0,1,8
1896628,1538944,2025-04-07,Senate,"Placed on suspense file",7,0,0,0,7
1896630,1567904,2025-05-06,Senate,"Do pass",12,0,0,1,13
1896630,1580527,2025-05-28,Senate,"Senate 3rd Reading SB47 Umberg",38,0,0,2,40
1896630,1594605,2025-06-24,Assembly,"Do pass. To Consent Calendar",12,0,0,0,12
1896630,1596033,2025-06-27,Assembly,"SB 47 Umberg Consent Calendar Second Day Regular Session",75,0,0,4,79
1896630,1601905,2025-09-11,Senate,"Unfinished Business SB47 Umberg et al. Urgency Clause Concurrence",40,0,0,0,40
1896850,1477881,2025-01-30,Senate,"Special Consent ACR8 Wallis et al",36,0,0,3,39
1897055,1535008,2025-04-02,Assembly,"Do pass and be re-referred to the Committee on [Privacy and Consumer Protection]",15,0,0,2,17
1897055,1564246,2025-05-01,Assembly,"Do pass and be re-referred to the Committee on [Appropriations]",13,0,0,2,15
1897055,1577506,2025-05-23,Assembly,"Do pass as amended",11,0,0,4,15
1897055,1584313,2025-06-03,Assembly,"AB 75 Calderon Assembly Third Reading",76,1,0,2,79
1897055,1598109,2025-07-09,Senate,"Do pass, but first be re-referred to the Committee on [Judiciary]",7,0,0,0,7
1897055,1598705,2025-07-15,Senate,"Do pass, but first be re-referred to the Committee on [Appropriations]",13,0,0,0,13
1897055,1599562,2025-08-18,Senate,"Placed on suspense file",7,0,0,0,7
1897056,1542900,2025-04-09,Assembly,"Do pass as amended and be re-referred to the Committee on [Housing and Community Development]",8,1,0,1,10
1897056,1562856,2025-04-30,Assembly,"Do pass",10,1,0,1,12
1897056,1568666,2025-05-08,Assembly,"AB 76 Alvarez Assembly Third Reading",66,0,0,13,79
1897056,1598643,2025-07-16,Senate,"Do pass as amended",7,0,0,0,7
1897056,1601622,2025-09-09,Senate,"Assembly 3rd Reading AB76 Alvarez By Padilla",40,0,0,0,40
1897057,1483666,2025-02-06,Senate,"Special Consent ACR9 Pellerin et al",37,0,0,2,39
1897058,1534991,2025-04-02,Senate,"Do pass, but first be re-referred to the Committee on [Public Safety]",6,1,0,0,7
1897058,1562974,2025-04-29,Senate,"Do pass, but first be re-referred to the Committee on [Appropriations]",11,1,0,1,13
1897058,1569804,2025-05-12,Senate,"Placed on suspense file",7,0,0,0,7
1897058,1577596,2025-05-23,Senate,"Do pass",5,1,0,1,7
1897058,1586435,2025-06-02,Senate,"Senate 3rd Reading SB48 Gonzalez et al. Urgency Clause",29,7,0,4,40
1897058,1597540,2025-07-02,Assembly,"Do pass and be re-referred to the Committee on [Judiciary]",7,2,0,0,9
1897058,1602030,2025-09-12,Assembly,"Do pass",6,0,0,3,9
1897058,1602254,2025-09-12,Senate,"W/O REF. TO FILE SB48 Gonzalez",27,5,0,8,40
1897058,1602255,2025-09-13,Assembly,"SB 48 Gonzalez Senate Third Reading By FONG",55,3,0,22,80
1897059,1519121,2025-03-17,Senate,"Senate 3rd Reading SB49 Grove et al. Urgency Clause",37,0,0,3,40
1897059,1573630,2025-05-19,Assembly,"SB 49 Grove Third Reading Urgency By Tangipa",73,0,0,6,79
1897060,1535070,2025-04-01,Senate,"Do pass, but first be re-referred to the Committee on [Appropriations] with the recommendation: To Consent Calendar",13,0,0,0,13
1897060,1552946,2025-04-21,Senate,"Placed on suspense file",6,0,0,1,7
1897060,1577238,2025-05-23,Senate,"Do pass as amended",6,0,0,1,7
1897060,1585055,2025-06-04,Senate,"Senate 3rd Reading SB50 Ashby",38,0,0,2,40
1897060,1594586,2025-06-24,Assembly,"Do pass as amended, and be re-referred to the Committee on [Judiciary] with recommendation: To Consent Calendar",15,0,0,0,15
1897060,1598389,2025-07-15,Assembly,"Do pass and be re-referred to the Committee on [Appropriations] with recommendation: To Consent Calendar",12,0,0,0,12
1897060,1600290,2025-08-29,Assembly,"Do pass as amended",11,0,0,4,15
1897060,1601375,2025-09-08,Assembly,"SB 50 Ashby Senate Third Reading By Bonta",79,0,0,1,80
1897060,1601568,2025-09-09,Senate,"Unfinished Business SB50 Ashby Concurrence",40,0,0,0,40
1897061,1535032,2025-04-01,Senate,"Be adopted. Ordered to third reading",12,0,0,1,13
1897061,1591153,2025-06-16,Senate,"Senate 3rd Reading SJR1 Wiener et al",28,0,0,12,40
1897061,1597185,2025-07-01,Assembly,"Be adopted. To third reading",11,0,0,1,12
1897061,1601138,2025-09-04,Assembly,"SJR 1 Wiener Senate Third Reading By Zbur",68,0,0,11,79
1897215,1521999,2025-03-19,Assembly,"Do pass and be re-referred to the Committee on [Appropriations] with recommendation: To Consent Calendar",19,0,0,3,22
1897215,1556148,2025-04-23,Assembly,"Do pass. To Consent Calendar",15,0,0,0,15
1897215,1564224,2025-05-01,Assembly,"AB 77 Aguiar-Curry Consent Calendar Second Day Regular Session",76,0,0,3,79
1897215,1588071,2025-06-10,Senate,"Do pass, but first be re-referred to the Committee on [Appropriations] with the recommendation: To Consent Calendar",14,0,0,1,15
1897216,1471321,2025-01-13,Senate,"Senate 3rd Reading SCR6 Choi",32,0,0,7,39
1897216,1479231,2025-02-03,Assembly,"Be adopted. To Consent Calendar",11,0,0,0,11
1897216,1483668,2025-02-06,Assembly,"SCR 6 Choi Consent Calendar Second Day Regular Session",72,0,0,7,79
1897437,1505310,2025-03-04,Assembly,"Do pass. To Consent Calendar",12,0,0,0,12
1897437,1511453,2025-03-10,Assembly,"AB 78 Chen Consent Calendar Second Day",72,0,0,8,80
1897437,1595131,2025-06-24,Senate,"Do pass and be ordered to the Consent Calendar",12,0,0,1,13
1897437,1597565,2025-07-03,Senate,"Consent Calendar 2nd AB78 Chen",35,0,0,5,40
1897438,1515291,2025-03-11,Assembly,"Do pass and be re-referred to the Committee on [Higher Education] with recommendation: To Consent Calendar",6,0,0,1,7
1897438,1556181,2025-04-22,Assembly,"Do pass and be re-referred to the Committee on [Appropriations] with recommendation: To Consent Calendar",10,0,0,0,10
1897438,1577347,2025-05-23,Assembly,"Do pass",14,0,0,1,15
1897438,1582226,2025-05-29,Assembly,"AB 79 Arambula Assembly Third Reading",69,0,0,10,79
1897438,1597221,2025-06-30,Senate,"Do pass, but first be re-referred to the Committee on [Education] with the recommendation: To Consent Calendar",5,0,0,0,5
1897438,1598028,2025-07-09,Senate,"Do pass, but first be re-referred to the Committee on [Appropriations] with the recommendation: To Consent Calendar",7,0,0,0,7
1897438,1599469,2025-08-18,Senate,"Placed on suspense file",7,0,0,0,7
1897438,1600747,2025-08-29,Senate,"Do pass",7,0,0,0,7
1897438,1601091,2025-09-04,Senate,"Special Consent AB79 Arambula By Pérez",39,0,0,1,40
1897439,1554546,2025-04-21,Senate,"Do pass, but first be re-referred to the Committee on [Appropriations]",9,2,0,6,17
1897439,1565321,2025-05-05,Senate,"Placed on suspense file",7,0,0,0,7
1897440,1503924,2025-03-03,Senate,"Senate 3rd Reading SCR7 Niello",24,6,0,9,39
1897818,1538951,2025-04-07,Assembly,"Do pass and be re-referred to the Committee on [Appropriations]",11,0,0,3,14
1897818,1577482,2025-05-23,Assembly,"Do pass as amended",11,0,0,4,15
1897818,1583443,2025-06-02,Assembly,"AB 80 Aguiar-Curry Assembly Third Reading",70,1,0,8,79
1897818,1597509,2025-07-02,Senate,"Do pass as amended, but first amend, and re-refer to the Committee on [Judiciary] with the recommendation: To Consent Calendar",8,0,0,0,8
1897818,1599527,2025-08-18,Senate,"Placed on suspense file",7,0,0,0,7
1897819,1545043,2025-04-08,Assembly,"Do pass and be re-referred to the Committee on [Appropriations]",7,0,0,1,8
1897819,1577678,2025-05-23,Assembly,"Do pass",14,0,0,1,15
1897819,1585071,2025-06-04,Assembly,"AB 81 Ta Assembly Third Reading",78,0,0,1,79
1897819,1598254,2025-07-14,Senate,"Do pass, but first be re-referred to the Committee on [Appropriations] with the recommendation: To Consent Calendar",5,0,0,0,5
1897819,1599528,2025-08-18,Senate,"Placed on suspense file",7,0,0,0,7
1897819,1600280,2025-08-29,Senate,"Do pass",7,0,0,0,7
1897819,1601187,2025-09-04,Senate,"Special Consent AB81 Ta et al. By Grove",39,0,0,1,40
1897820,1472237,2025-01-17,Senate,"Senate 3rd Reading SCR8 Weber Pierson et al",32,0,0,7,39
1897820,1485616,2025-02-10,Assembly,"Be adopted. To Consent Calendar",9,0,0,2,11
1898368,1554517,2025-04-22,Assembly,"Do pass and be re-referred to the Committee on [Judiciary]",8,0,0,1,9
1898368,1561195,2025-04-29,Assembly,"Do pass and be re-referred to the Committee on [Appropriations]",9,0,0,3,12
1898368,1577351,2025-05-23,Assembly,"Do pass as amended",11,0,0,4,15
1898368,1583495,2025-06-02,Assembly,"AB 82 Ward Assembly Third Reading",62,5,0,12,79
1898368,1597212,2025-07-01,Senate,"Do pass, but first be re-referred to the Committee on [Judiciary]",5,1,0,0,6
1898368,1597816,2025-07-08,Senate,"Do pass as amended, but first amend, and re-refer to the Committee on [Appropriations]",11,0,0,2,13
1898368,1599408,2025-08-18,Senate,"Placed on suspense file",7,0,0,0,7
1898368,1600455,2025-08-29,Senate,"Do pass as amended",5,2,0,0,7
1898368,1601680,2025-09-09,Senate,"Assembly 3rd Reading AB82 Ward et al. By Wiener",29,8,0,3,40
1898370,1564299,2025-04-30,Assembly,"Do pass as amended and be re-referred to the Committee on [Appropriations]",7,2,0,0,9
1898370,1577642,2025-05-23,Assembly,"Do pass",10,3,0,2,15
1898370,1585802,2025-06-05,Assembly,"AB 84 Muratsuchi Assembly Third Reading",43,25,0,11,79
1898370,1598661,2025-07-16,Senate,"Do pass as amended, but first amend, and re-refer to the Committee on [Appropriations]",4,2,0,1,7
1898370,1599570,2025-08-18,Senate,"Placed on suspense file",7,0,0,0,7
1898370,1600434,2025-08-29,Senate,"Do pass as amended",4,2,0,1,7
1898372,1477876,2025-01-30,Senate,"Special Consent ACR10 Mark González et al",36,0,0,3,39
1898373,1555940,2025-04-22,Senate,"Do pass as amended, but first amend, and re-refer to the Committee on [Appropriations]",11,0,0,2,13
1898373,1565332,2025-05-05,Senate,"Placed on suspense file",7,0,0,0,7
1898373,1577742,2025-05-23,Senate,"Do pass",5,1,0,1,7
1898373,1586431,2025-06-02,Senate,"Senate 3rd Reading SB52 Pérez",28,9,0,3,40
1898373,1597199,2025-07-01,Assembly,"Do pass and be re-referred to the Committee on [Privacy and Consumer Protection]",9,3,0,0,12
1898373,1598563,2025-07-16,Assembly,"Do pass as amended and be re-referred to the Committee on [Appropriations]",10,4,0,1,15
1903331,1516568,2025-03-12,Assembly,"Do pass and be re-referred to the Committee on [Appropriations]",8,0,0,1,9
1903331,1577777,2025-05-23,Assembly,"Do pass",13,0,0,2,15
1903331,1582235,2025-05-29,Assembly,"AB 86 Boerner Assembly Third Reading",62,0,0,17,79
1903331,1595195,2025-06-25,Senate,"Do pass, but first be re-referred to the Committee on [Appropriations]",5,1,0,1,7
1903331,1597694,2025-07-07,Senate,"Placed on suspense file",6,0,0,1,7
1903331,1600699,2025-08-29,Senate,"Do pass",5,2,0,0,7
1903331,1601617,2025-09-09,Senate,"Assembly 3rd Reading AB86 Boerner By Ashby",30,10,0,0,40
1903332,1558367,2025-04-24,Assembly,"Do pass and be re-referred to the Committee on [Local Government]",10,0,0,2,12
1903332,1564216,2025-04-30,Assembly,"Do pass",9,0,0,1,10
1903332,1569824,2025-05-12,Assembly,"AB 87 Boerner Assembly Third Reading",75,0,0,4,79
1903332,1594567,2025-06-24,Senate,"Do pass, but first be re-referred to the Committee on [Local Government]",10,1,0,0,11
1903332,1598023,2025-07-09,Senate,"Do pass as amended",7,0,0,0,7
1903332,1600818,2025-09-02,Senate,"Assembly 3rd Reading AB87 Boerner By Padilla",40,0,0,0,40
1903332,1601009,2025-09-03,Assembly,"AB 87 Boerner Concurrence in Senate Amendments",77,0,0,2,79
1903333,1521944,2025-03-18,Assembly,"Do pass and be re-referred to the Committee on [Appropriations] with recommendation: To Consent Calendar",9,0,0,1,10
1903333,1577578,2025-05-23,Assembly,"Do pass",14,0,0,1,15
1903333,1585009,2025-06-04,Assembly,"AB 88 Ta Assembly Third Reading",78,0,0,1,79
1903333,1597449,2025-07-02,Senate,"Do pass, but first be re-referred to the Committee on [Military and Veterans Affairs]",7,0,0,0,7
1903333,1598308,2025-07-14,Senate,"Do pass, but first be re-referred to the Committee on [Appropriations] with the recommendation: To Consent Calendar",5,0,0,0,5
1903333,1599628,2025-08-18,Senate,"Placed on suspense file",7,0,0,0,7
1903333,1600616,2025-08-29,Senate,"Do pass",7,0,0,0,7
1903333,1601118,2025-09-04,Senate,"Special Consent AB88 Ta et al. By Seyarto",39,0,0,1,40
1903334,1533525,2025-04-01,Assembly,"Do pass and be re-referred to the Committee on [Education]",2,7,0,0,9
1903334,1533526,2025-04-01,Assembly,Reconsideration,2,6,0,1,9
1903335,1522012,2025-03-18,Assembly,"Do pass as amended and be re-referred to the Committee on [Appropriations]",6,2,0,2,10
1903335,1577594,2025-05-23,Assembly,"Do pass as amended",11,1,0,3,15
1903335,1584258,2025-06-03,Assembly,"AB 90 Jackson Assembly Third Reading",50,14,0,15,79
1903335,1597438,2025-07-02,Senate,"Do pass as amended, but first amend, and re-refer to the Committee on [Judiciary]",4,2,0,1,7
1903335,1598601,2025-07-15,Senate,"Do pass, but first be re-referred to the Committee on [Appropriations]",10,2,0,1,13
1903335,1599404,2025-08-18,Senate,"Placed on suspense file",7,0,0,0,7
1903336,1540858,2025-04-08,Assembly,"Do pass and be re-referred to the Committee on [Appropriations] with recommendation: To Consent Calendar",12,0,0,0,12
1903336,1577353,2025-05-23,Assembly,"Do pass as amended",11,0,0,4,15
1903336,1583591,2025-06-02,Assembly,"AB 91 Harabedian Assembly Third Reading",79,0,0,0,79
1903336,1594587,2025-06-24,Senate,"Do pass, but first be re-referred to the Committee on [Judiciary] with the recommendation: To Consent Calendar",15,0,0,0,15
1903336,1597913,2025-07-08,Senate,"Do pass, but first be re-referred to the Committee on [Appropriations] with the recommendation: To Consent Calendar",13,0,0,0,13
1903336,1599433,2025-08-18,Senate,"Placed on suspense file",7,0,0,0,7
1903336,1600505,2025-08-29,Senate,"Do pass as amended",7,0,0,0,7
1903336,1601849,2025-09-11,Senate,"Special Consent AB91 Harabedian et al. By Pérez",40,0,0,0,40
1903336,1602100,2025-09-12,Assembly,"AB 91 Harabedian Concurrence in Senate Amendments",80,0,0,0,80
1903338,1485612,2025-02-10,Assembly,"Be adopted. To Consent Calendar",9,0,0,2,11
1903338,1492773,2025-02-18,Assembly,"HR 7 Ta Consent Calendar Second Day",70,0,0,9,79
1903339,1475144,2025-01-27,Senate,"Senate 3rd Reading SCR9 Weber Pierson",36,0,0,3,39
1903339,1485614,2025-02-10,Assembly,"Be adopted. To Consent Calendar",9,0,0,2,11
1904793,1540939,2025-04-08,Assembly,"Do pass as amended and be re-referred to the Committee on [Local Government]",10,1,0,2,13
1904793,1564300,2025-04-30,Assembly,"Do pass as amended and be re-referred to the Committee on [Appropriations]",8,1,0,1,10
1904793,1577717,2025-05-23,Assembly,"Do pass",11,2,0,2,15
1904793,1582231,2025-05-29,Assembly,"AB 93 Papan Assembly Third Reading",51,14,0,14,79
1904793,1594683,2025-06-24,Senate,"Do pass, but first be re-referred to the Committee on [Local Government]",5,2,0,0,7
1904793,1598614,2025-07-16,Senate,"Do pass as amended, but first amend, and re-refer to the Committee on [Appropriations]",5,2,0,0,7
1904793,1599509,2025-08-18,Senate,"Placed on suspense file",7,0,0,0,7
1904793,1600667,2025-08-29,Senate,"Do pass as amended",5,2,0,0,7
1904793,1601751,2025-09-10,Senate,"Assembly 3rd Reading AB93 Papan By Laird",30,10,0,0,40
1904794,1528278,2025-03-26,Assembly,"Do pass. To Consent Calendar",7,0,0,0,7
1904794,1533556,2025-04-01,Assembly,"AB 94 Bennett Consent Calendar Second Day Regular Session",76,0,0,4,80
1904794,1597273,2025-07-01,Senate,"Do pass",5,0,0,0,5
1904794,1601157,2025-09-04,Senate,"Assembly 3rd Reading AB94 Bennett By Umberg",39,0,0,1,40
1904795,1561097,2025-04-29,Assembly,"Do pass and be re-referred to the Committee on [Appropriations]",10,0,0,0,10
1904797,1566721,2025-05-05,Assembly,"Do pass and be re-referred to the Committee on [Appropriations]",7,0,0,0,7
1904797,1577836,2025-05-23,Assembly,"Do pass",14,0,0,1,15
1904797,1585010,2025-06-04,Assembly,"AB 97 Lackey Third Reading Urgency",72,0,0,7,79
1904799,1474058,2025-01-23,Assembly,"Be adopted. To third reading",10,0,0,1,11
1904799,1490594,2025-02-14,Senate,"Special Consent ACR11 Ahrens et al",34,0,0,5,39
1904800,1526976,2025-03-25,Senate,"Do pass as amended, but first amend, and re-refer to the Committee on [Judiciary]",13,0,0,2,15
1904800,1542818,2025-04-08,Senate,"Do pass, but first be re-referred to the Committee on [Appropriations] with the recommendation: To Consent Calendar",13,0,0,0,13
1904800,1552907,2025-04-21,Senate,"Placed on suspense file",6,0,0,1,7
1904800,1577645,2025-05-23,Senate,"Do pass as amended",6,0,0,1,7
1904800,1580499,2025-05-28,Senate,"Senate 3rd Reading SB53 Wiener",37,0,0,3,40
1904800,1597216,2025-07-01,Assembly,"Do pass and be re-referred to the Committee on [Privacy and Consumer Protection]",12,0,0,0,12
1904800,1598663,2025-07-16,Assembly,"Do pass as amended and be re-referred to the Committee on [Appropriations]",10,0,0,5,15
1904800,1600698,2025-08-29,Assembly,"Do pass as amended",11,1,0,3,15
1904800,1601981,2025-09-11,Assembly,"Do pass",12,1,0,2,15
1904800,1602051,2025-09-12,Senate,"Unfinished Business SB53 Wiener et al. Concurrence",29,8,0,3,40
1904800,1602052,2025-09-12,Assembly,"SB 53 Wiener Senate Third Reading By BAUER-KAHAN",59,7,0,14,80
1904801,1542886,2025-04-08,Senate,"Do pass, but first be re-referred to the Committee on [Military and Veterans Affairs] with the recommendation: To Consent Calendar",13,0,0,0,13
1904801,1559407,2025-04-28,Senate,"Do pass, but first be re-referred to the Committee on [Appropriations] with the recommendation: To Consent Calendar",4,0,0,1,5
1904801,1569765,2025-05-12,Senate,"Placed on suspense file",7,0,0,0,7
1904801,1577674,2025-05-23,Senate,"Do pass",6,0,0,1,7
1904801,1581757,2025-05-29,Senate,"Special Consent SB54 Umberg",38,0,0,2,40
1904801,1591864,2025-06-17,Assembly,"Do pass and be re-referred to the Committee on [Military and Veterans Affairs] with recommendation: To Consent Calendar",11,0,0,1,12
1904801,1598521,2025-07-15,Assembly,"Do pass and be re-referred to the Committee on [Appropriations] with recommendation: To Consent Calendar",8,0,0,0,8
1904801,1600341,2025-08-29,Assembly,"Do pass",15,0,0,0,15
1904801,1601383,2025-09-08,Assembly,"SB 54 Umberg Senate Third Reading By Schiavo",79,0,0,1,80
1904802,1526939,2025-03-25,Senate,"Do pass as amended, but first amend, and re-refer to the Committee on [Military and Veterans Affairs] with the recommendation: To Consent Calendar",7,0,0,0,7
1904802,1559373,2025-04-28,Senate,"Do pass, but first be re-referred to the Committee on [Appropriations] with the recommendation: To Consent Calendar",4,0,0,1,5
1904802,1569917,2025-05-12,Senate,"Placed on suspense file",7,0,0,0,7
1904802,1577239,2025-05-23,Senate,"Do pass",6,0,0,1,7
1904802,1581743,2025-05-29,Senate,"Special Consent SB55 Umberg et al",38,0,0,2,40
1904802,1591888,2025-06-17,Assembly,"Do pass and be re-referred to the Committee on [Military and Veterans Affairs] with recommendation: To Consent Calendar",10,0,0,3,13
1904802,1598496,2025-07-15,Assembly,"Do pass and be re-referred to the Committee on [Appropriations] with recommendation: To Consent Calendar",8,0,0,0,8
1904803,1516571,2025-03-12,Senate,"Do pass, but first be re-referred to the Committee on [Military and Veterans Affairs] with the recommendation: To Consent Calendar",5,0,0,0,5
1904803,1559386,2025-04-28,Senate,"Do pass, but first be re-referred to the Committee on [Appropriations] with the recommendation: To Consent Calendar",4,0,0,1,5
1904803,1569925,2025-05-12,Senate,"Placed on suspense file",7,0,0,0,7
1904803,1577850,2025-05-23,Senate,"Do pass",6,0,0,1,7
1904803,1581724,2025-05-29,Senate,"Special Consent SB56 Seyarto et al",38,0,0,2,40
1904803,1597159,2025-07-01,Assembly,"Do pass and be re-referred to the Committee on [Revenue and Taxation] with recommendation: To Consent Calendar",8,0,0,0,8
1904804,1477866,2025-01-30,Senate,"Senate 3rd Reading SR9 Gonzalez",36,0,0,3,39
1908085,1523499,2025-03-20,Assembly,"AB 100 Gabriel Assembly Third Reading",53,17,0,10,80
1908085,1542899,2025-04-09,Senate,"Do pass",14,4,0,0,18
1908085,1544985,2025-04-10,Senate,"Assembly 3rd Reading AB100 Gabriel By Wiener",29,7,0,4,40
1908085,1544986,2025-04-10,Assembly,"AB 100 GABRIEL Concurrence in Senate Amendments Appeal the Decision of the Speaker By DEMAIO",18,53,0,8,79
1908085,1544987,2025-04-10,Assembly,"AB 100 GABRIEL Concurrence in Senate Amendments",56,7,0,16,79
1908086,1523669,2025-03-20,Assembly,"AB 101 Gabriel Assembly Third Reading",53,17,0,10,80
1908086,1589128,2025-06-11,Senate,"Do pass",10,6,0,2,18
1908087,1523502,2025-03-20,Assembly,"AB 102 Gabriel Assembly Third Reading",53,17,0,10,80
1908087,1595181,2025-06-25,Senate,"Do pass",13,4,0,1,18
1908087,1595980,2025-06-27,Senate,"Assembly 3rd Reading AB102 Gabriel By Wiener",29,8,0,3,40
1908087,1595981,2025-06-27,Assembly,"AB 102 GABRIEL Concurrence in Senate Amendments",59,17,0,3,79
1908088,1523587,2025-03-20,Assembly,"AB 103 Gabriel Assembly Third Reading",53,17,0,10,80
1908088,1595160,2025-06-25,Senate,"Do pass",13,0,0,5,18
1908089,1523503,2025-03-20,Assembly,"AB 104 Gabriel Assembly Third Reading",53,17,0,10,80
1908089,1598217,2025-07-14,Senate,"Do pass",15,1,0,2,18
1908089,1598900,2025-07-17,Senate,"Assembly 3rd Reading AB104 Gabriel By Wiener",29,3,0,8,40
1908089,1598901,2025-07-17,Assembly,"AB 104 GABRIEL Concurrence in Senate Amendments",73,1,0,5,79
1908090,1523658,2025-03-20,Assembly,"AB 105 Gabriel Assembly Third Reading",53,17,0,10,80
1908091,1523618,2025-03-20,Assembly,"AB 106 Gabriel Assembly Third Reading",53,17,0,10,80
1908092,1523528,2025-03-20,Assembly,"AB 107 Gabriel Assembly Third Reading",53,17,0,10,80
1908093,1523579,2025-03-20,Assembly,"AB 108 Gabriel Assembly Third Reading",53,17,0,10,80
1908094,1523672,2025-03-20,Assembly,"AB 109 Gabriel Assembly Third Reading",53,17,0,10,80
1908095,1523612,2025-03-20,Assembly,"AB 110 Gabriel Assembly Third Reading",53,17,0,10,80
1908096,1523601,2025-03-20,Assembly,"AB 111 Gabriel Assembly Third Reading",53,17,0,10,80
1908097,1523577,2025-03-20,Assembly,"AB 112 Gabriel Assembly Third Reading",53,17,0,10,80
1908098,1523536,2025-03-20,Assembly,"AB 113 Gabriel Assembly Third Reading",53,17,0,10,80
1908099,1523498,2025-03-20,Assembly,"AB 114 Gabriel Assembly Third Reading",53,17,0,10,80
1908100,1523717,2025-03-20,Assembly,"AB 115 Gabriel Assembly Third Reading",53,17,0,10,80
1908101,1523469,2025-03-20,Assembly,"AB 116 Gabriel Assembly Third Reading",53,17,0,10,80
1908101,1595217,2025-06-25,Senate,"Do pass",11,6,0,1,18
1908101,1596026,2025-06-27,Senate,"Assembly 3rd Reading AB116 BUDGET (Gabriel) By Wiener",25,10,0,5,40
1908101,1596027,2025-06-27,Assembly,"AB 116 BUDGET Concurrence in Senate Amendments By GABRIEL",58,15,0,6,79
1908102,1523644,2025-03-20,Assembly,"AB 117 Gabriel Assembly Third Reading",53,17,0,10,80
1908103,1523600,2025-03-20,Assembly,"AB 118 Gabriel Assembly Third Reading",53,17,0,10,80
1908103,1595163,2025-06-25,Senate,"Do pass",13,1,0,4,18
1908103,1595978,2025-06-27,Senate,"Assembly 3rd Reading AB118 BUDGET (Gabriel) By Wiener",29,3,0,8,40
1908103,1595979,2025-06-27,Assembly,"AB 118 BUDGET Concurrence in Senate Amendments By GABRIEL",71,0,0,8,79
1908104,1523646,2025-03-20,Assembly,"AB 119 Gabriel Assembly Third Reading",53,17,0,10,80
1908104,1598218,2025-07-14,Senate,"Do pass",13,5,0,0,18
1908105,1523467,2025-03-20,Assembly,"AB 120 Gabriel Assembly Third Reading",53,17,0,10,80
1908105,1595235,2025-06-25,Senate,"Do pass",13,5,0,0,18
1908106,1523624,2025-03-20,Assembly,"AB 121 Gabriel Assembly Third Reading",53,17,0,10,80
1908106,1595156,2025-06-25,Senate,"Do pass",13,0,0,5,18
1908106,1595994,2025-06-27,Senate,"Assembly 3rd Reading AB121 BUDGET (Gabriel) By Wiener",32,1,0,7,40
1908106,1595995,2025-06-27,Assembly,"AB 121 BUDGET Concurrence in Senate Amendments By GABRIEL",70,0,0,9,79
1908107,1523656,2025-03-20,Assembly,"AB 122 Gabriel Assembly Third Reading",53,17,0,10,80
1908108,1523698,2025-03-20,Assembly,"AB 123 Gabriel Assembly Third Reading",53,17,0,10,80
1908108,1595221,2025-06-25,Senate,"Do pass",18,0,0,0,18
1908108,1595997,2025-06-27,Senate,"Assembly 3rd Reading AB123 BUDGET (Gabriel) By Wiener",38,0,0,2,40
1908108,1595998,2025-06-27,Assembly,"AB 123 BUDGET Concurrence in Senate Amendments By GABRIEL",76,1,0,2,79
1908109,1523671,2025-03-20,Assembly,"AB 124 Gabriel Assembly Third Reading",53,17,0,10,80
1908109,1595142,2025-06-25,Senate,"Do pass",13,0,0,5,18
1908110,1523650,2025-03-20,Assembly,"AB 125 Gabriel Assembly Third Reading",53,17,0,10,80
1908111,1523485,2025-03-20,Assembly,"AB 126 Gabriel Assembly Third Reading",53,17,0,10,80
1908112,1523512,2025-03-20,Assembly,"AB 127 Gabriel Assembly Third Reading",53,17,0,10,80
1908112,1595234,2025-06-25,Senate,"Do pass",13,4,0,1,18
1908113,1523592,2025-03-20,Assembly,"AB 128 Gabriel Assembly Third Reading",53,17,0,10,80
1908113,1595201,2025-06-25,Senate,"Do pass",13,5,0,0,18
1908114,1523522,2025-03-20,Assembly,"AB 129 Gabriel Assembly Third Reading",53,17,0,10,80
1908114,1595145,2025-06-25,Senate,"Do pass",10,4,0,4,18
1908115,1523663,2025-03-20,Assembly,"AB 130 Gabriel Assembly Third Reading",53,17,0,10,80
1908115,1596760,2025-06-30,Senate,"Do pass",13,1,0,4,18
1908115,1596761,2025-06-30,Senate,"Assembly 3rd Reading AB130 BUDGET (Gabriel) By Wiener",28,5,0,7,40
1908115,1596762,2025-06-30,Assembly,"AB 130 BUDGET Concurrence in Senate Amendments By GABRIEL",62,3,0,14,79
1908116,1523674,2025-03-20,Assembly,"AB 131 Gabriel Assembly Third Reading",53,17,0,10,80
1908116,1596764,2025-06-30,Senate,"Do pass",13,2,0,3,18
1908117,1523697,2025-03-20,Assembly,"AB 132 Gabriel Assembly Third Reading",53,17,0,10,80
1908117,1595146,2025-06-25,Senate,"Do pass",15,1,0,2,18
1908118,1523682,2025-03-20,Assembly,"AB 133 Gabriel Assembly Third Reading",53,17,0,10,80
1908119,1523688,2025-03-20,Assembly,"AB 134 Gabriel Assembly Third Reading",53,17,0,10,80
1908119,1595157,2025-06-25,Senate,"Do pass",13,4,0,1,18
1908119,1596014,2025-06-27,Senate,"Assembly 3rd Reading AB134 BUDGET (Gabriel) By Wiener",29,9,0,2,40
1908119,1596015,2025-06-27,Assembly,"AB 134 BUDGET Concurrence in Senate Amendments By GABRIEL",72,1,0,6,79
1908120,1523478,2025-03-20,Assembly,"AB 135 Gabriel Assembly Third Reading",53,17,0,10,80
1908121,1523709,2025-03-20,Assembly,"AB 136 Gabriel Assembly Third Reading",53,17,0,10,80
1908121,1595137,2025-06-25,Senate,"Do pass",18,0,0,0,18
1908121,1595974,2025-06-27,Senate,"Assembly 3rd Reading AB136 BUDGET (Gabriel) By Wiener",38,0,0,2,40
1908121,1595975,2025-06-27,Assembly,"AB 136 BUDGET Concurrence in Senate Amendments By GABRIEL",76,1,0,2,79
1908122,1523719,2025-03-20,Assembly,"AB 137 Gabriel Assembly Third Reading",53,17,0,10,80
1908122,1595132,2025-06-25,Senate,"Do pass",13,5,0,0,18
1908122,1596029,2025-06-27,Senate,"Assembly 3rd Reading AB137 BUDGET (Gabriel) By Wiener",29,9,0,2,40
1908122,1596030,2025-06-27,Assembly,"AB 137 BUDGET Concurrence in Senate Amendments By GABRIEL",58,18,0,3,79
1908123,1523483,2025-03-20,Assembly,"AB 138 Gabriel Assembly Third Reading",53,17,0,10,80
1908123,1598255,2025-07-14,Senate,"Do pass",13,5,0,0,18
1908123,1598827,2025-07-17,Senate,"Assembly 3rd Reading AB138 BUDGET (Gabriel) By Wiener",28,9,0,3,40
1908123,1598828,2025-07-17,Assembly,"AB 138 BUDGET Concurrence in Senate Amendments By GABRIEL",67,4,0,8,79
1908124,1523497,2025-03-20,Assembly,"AB 139 Gabriel Assembly Third Reading",53,17,0,10,80
1908124,1596789,2025-06-30,Senate,"Do pass",14,0,0,4,18
1908125,1523445,2025-03-20,Assembly,"AB 140 Gabriel Assembly Third Reading",53,17,0,10,80
1908125,1596768,2025-06-30,Senate,"Do pass",17,0,0,1,18
1908126,1523465,2025-03-20,Assembly,"AB 141 Gabriel Assembly Third Reading",53,17,0,10,80
1908126,1595232,2025-06-25,Senate,"Do pass",17,0,0,1,18
1908127,1523565,2025-03-20,Assembly,"AB 142 Gabriel Assembly Third Reading",53,17,0,10,80
1908127,1595193,2025-06-25,Senate,"Do pass",17,0,0,1,18
1908128,1523508,2025-03-20,Assembly,"AB 143 Gabriel Assembly Third Reading",53,17,0,10,80
1908128,1595205,2025-06-25,Senate,"Do pass",13,5,0,0,18
1908128,1595965,2025-06-27,Senate,"Assembly 3rd Reading AB143 BUDGET (Gabriel) By Wiener",29,9,0,2,40
1908128,1595966,2025-06-27,Assembly,"AB 143 BUDGET Concurrence in Senate Amendments By GABRIEL",58,18,0,3,79
1908129,1523628,2025-03-20,Assembly,"AB 144 Gabriel Assembly Third Reading",53,17,0,10,80
1908129,1602367,2025-09-12,Senate,"Assembly 3rd Reading AB144 BUDGET (Gabriel) By Wiener",29,8,0,3,40
1908129,1602368,2025-09-12,Assembly,"AB 144 BUDGET Concurrence in Senate Amendments By GABRIEL",61,18,0,1,80
1908130,1523456,2025-03-20,Assembly,"AB 145 Gabriel Assembly Third Reading",53,17,0,10,80
1908131,1523513,2025-03-20,Assembly,"AB 146 Gabriel Assembly Third Reading",53,17,0,10,80
1908132,1523720,2025-03-20,Assembly,"AB 147 Gabriel Assembly Third Reading",53,17,0,10,80
1908133,1523514,2025-03-20,Assembly,"AB 148 Gabriel Assembly Third Reading",53,17,0,10,80
1908134,1523439,2025-03-20,Assembly,"AB 149 Gabriel Assembly Third Reading",53,17,0,10,80
1908134,1602164,2025-09-12,Senate,"Assembly 3rd Reading AB149 BUDGET (Gabriel) By Wiener",30,0,0,10,40
1908134,1602165,2025-09-12,Assembly,"AB 149 BUDGET Concurrence in Senate Amendments By GABRIEL",61,13,0,6,80
1908135,1523583,2025-03-20,Assembly,"AB 150 Gabriel Assembly Third Reading",53,17,0,10,80
1908136,1523648,2025-03-20,Assembly,"AB 151 Gabriel Assembly Third Reading",53,17,0,10,80
1908137,1523633,2025-03-20,Assembly,"AB 152 Gabriel Assembly Third Reading",53,17,0,10,80
1908138,1523598,2025-03-20,Assembly,"AB 153 Gabriel Assembly Third Reading",53,17,0,10,80
1908139,1523617,2025-03-20,Assembly,"AB 154 Gabriel Assembly Third Reading",53,17,0,10,80
1908139,1602343,2025-09-12,Senate,"Assembly 3rd Reading AB154 BUDGET (Gabriel) By Wiener",29,0,0,11,40
1908139,1602344,2025-09-12,Assembly,"AB 154 BUDGET Concurrence in Senate Amendments By GABRIEL",71,1,0,8,80
1908140,1523676,2025-03-20,Assembly,"AB 155 Gabriel Assembly Third Reading",53,17,0,10,80
1908141,1523486,2025-03-20,Assembly,"AB 156 Gabriel Assembly Third Reading",53,17,0,10,80
1908142,1523572,2025-03-20,Assembly,"AB 157 Gabriel Assembly Third Reading",53,17,0,10,80
1908143,1523702,2025-03-20,Assembly,"AB 158 Gabriel Assembly Third Reading",53,17,0,10,80
1908144,1523447,2025-03-20,Assembly,"AB 159 Gabriel Assembly Third Reading",53,17,0,10,80
1908145,1523477,2025-03-20,Assembly,"AB 160 Gabriel Assembly Third Reading",53,17,0,10,80
1908146,1523491,2025-03-20,Assembly,"AB 161 Gabriel Assembly Third Reading",53,17,0,10,80
1908147,1523463,2025-03-20,Assembly,"AB 162 Gabriel Assembly Third Reading",53,17,0,10,80
1908148,1523473,2025-03-20,Assembly,"AB 163 Gabriel Assembly Third Reading",53,17,0,10,80
1908149,1523666,2025-03-20,Assembly,"AB 164 Gabriel Assembly Third Reading",53,17,0,10,80
1908150,1523442,2025-03-20,Assembly,"AB 165 Gabriel Assembly Third Reading",53,17,0,10,80
1908151,1523683,2025-03-20,Assembly,"AB 166 Gabriel Assembly Third Reading",53,17,0,10,80
1908152,1523471,2025-03-20,Assembly,"AB 167 Gabriel Assembly Third Reading",53,17,0,10,80
1908153,1523608,2025-03-20,Assembly,"AB 168 Gabriel Assembly Third Reading",53,17,0,10,80
1908154,1523679,2025-03-20,Assembly,"AB 169 Gabriel Assembly Third Reading",53,17,0,10,80
1908155,1523621,2025-03-20,Assembly,"AB 170 Gabriel Assembly Third Reading",53,17,0,10,80
1908156,1523647,2025-03-20,Assembly,"AB 171 Gabriel Assembly Third Reading",53,17,0,10,80
1908157,1523541,2025-03-20,Assembly,"AB 172 Gabriel Assembly Third Reading",53,17,0,10,80
1908158,1523476,2025-03-20,Assembly,"AB 173 Gabriel Assembly Third Reading",53,17,0,10,80
1908159,1523451,2025-03-20,Assembly,"AB 174 Gabriel Assembly Third Reading",53,17,0,10,80
1908160,1523517,2025-03-20,Assembly,"AB 175 Gabriel Assembly Third Reading",53,17,0,10,80
1908161,1523542,2025-03-20,Assembly,"AB 176 Gabriel Assembly Third Reading",53,17,0,10,80
1908162,1523440,2025-03-20,Assembly,"AB 177 Gabriel Assembly Third Reading",53,17,0,10,80
1908163,1523700,2025-03-20,Assembly,"AB 178 Gabriel Assembly Third Reading",53,17,0,10,80
1908164,1523588,2025-03-20,Assembly,"AB 179 Gabriel Assembly Third Reading",53,17,0,10,80
1908165,1523454,2025-03-20,Assembly,"AB 180 Gabriel Assembly Third Reading",53,17,0,10,80
1908166,1523461,2025-03-20,Assembly,"AB 181 Gabriel Assembly Third Reading",53,17,0,10,80
1908167,1523681,2025-03-20,Assembly,"AB 182 Gabriel Assembly Third Reading",53,17,0,10,80
1908168,1523655,2025-03-20,Assembly,"AB 183 Gabriel Assembly Third Reading",53,17,0,10,80
1908169,1523532,2025-03-20,Assembly,"AB 184 Gabriel Assembly Third Reading",53,17,0,10,80
1908170,1523718,2025-03-20,Assembly,"AB 185 Gabriel Assembly Third Reading",53,17,0,10,80
1908171,1523667,2025-03-20,Assembly,"AB 186 Gabriel Assembly Third Reading",53,17,0,10,80
1908172,1523678,2025-03-20,Assembly,"AB 187 Gabriel Assembly Third Reading",53,17,0,10,80
1908173,1523580,2025-03-20,Assembly,"AB 188 Gabriel Assembly Third Reading",53,17,0,10,80
1908174,1523540,2025-03-20,Assembly,"AB 189 Gabriel Assembly Third Reading",53,17,0,10,80
1908175,1523707,2025-03-20,Assembly,"AB 190 Gabriel Assembly Third Reading",53,17,0,10,80
1908176,1523639,2025-03-20,Assembly,"AB 191 Gabriel Assembly Third Reading",53,17,0,10,80
1908177,1523680,2025-03-20,Assembly,"AB 192 Gabriel Assembly Third Reading",53,17,0,10,80
1908178,1523609,2025-03-20,Assembly,"AB 193 Gabriel Assembly Third Reading",53,17,0,10,80
1908179,1523616,2025-03-20,Assembly,"AB 194 Gabriel Assembly Third Reading",53,17,0,10,80
1908180,1523526,2025-03-20,Assembly,"AB 195 Gabriel Assembly Third Reading",53,17,0,10,80
1908181,1523569,2025-03-20,Assembly,"AB 196 Gabriel Assembly Third Reading",53,17,0,10,80
1908182,1523552,2025-03-20,Assembly,"AB 197 Gabriel Assembly Third Reading",53,17,0,10,80
1908183,1523643,2025-03-20,Assembly,"AB 198 Gabriel Assembly Third Reading",53,17,0,10,80
1908184,1523561,2025-03-20,Assembly,"AB 199 Gabriel Assembly Third Reading",53,17,0,10,80
1908185,1523488,2025-03-20,Assembly,"AB 200 Gabriel Assembly Third Reading",53,17,0,10,80
1908186,1523533,2025-03-20,Assembly,"AB 201 Gabriel Assembly Third Reading",53,17,0,10,80
1908187,1523706,2025-03-20,Assembly,"AB 202 Gabriel Assembly Third Reading",53,17,0,10,80
1908188,1523563,2025-03-20,Assembly,"AB 203 Gabriel Assembly Third Reading",53,17,0,10,80
1908189,1523627,2025-03-20,Assembly,"AB 204 Gabriel Assembly Third Reading",53,17,0,10,80
1908190,1523641,2025-03-20,Assembly,"AB 205 Gabriel Assembly Third Reading",53,17,0,10,80
1908191,1523668,2025-03-20,Assembly,"AB 206 Gabriel Assembly Third Reading",53,17,0,10,80
1908192,1523444,2025-03-20,Assembly,"AB 207 Gabriel Assembly Third Reading",53,17,0,10,80
1908193,1523543,2025-03-20,Assembly,"AB 208 Gabriel Assembly Third Reading",53,17,0,10,80
1908194,1523475,2025-03-20,Assembly,"AB 209 Gabriel Assembly Third Reading",53,17,0,10,80
1908195,1523638,2025-03-20,Assembly,"AB 210 Gabriel Assembly Third Reading",53,17,0,10,80
1908196,1523452,2025-03-20,Assembly,"AB 211 Gabriel Assembly Third Reading",53,17,0,10,80
1908197,1523481,2025-03-20,Assembly,"AB 212 Gabriel Assembly Third Reading",53,17,0,10,80
1908198,1523548,2025-03-20,Assembly,"AB 213 Gabriel Assembly Third Reading",53,17,0,10,80
1908199,1523455,2025-03-20,Assembly,"AB 214 Gabriel Assembly Third Reading",53,17,0,10,80
1908200,1523559,2025-03-20,Assembly,"AB 215 Gabriel Assembly Third Reading",53,17,0,10,80
1908201,1523584,2025-03-20,Assembly,"AB 216 Gabriel Assembly Third Reading",53,17,0,10,80
1908202,1523558,2025-03-20,Assembly,"AB 217 Gabriel Assembly Third Reading",53,17,0,10,80
1908203,1523595,2025-03-20,Assembly,"AB 218 Gabriel Assembly Third Reading",53,17,0,10,80
1908204,1523539,2025-03-20,Assembly,"AB 219 Gabriel Assembly Third Reading",53,17,0,10,80
1908205,1556052,2025-04-22,Assembly,"Do pass and be re-referred to the Committee on [Appropriations]",16,0,0,0,16
1908205,1577718,2025-05-23,Assembly,"Do pass",14,0,0,1,15
1908205,1582236,2025-05-29,Assembly,"AB 220 Jackson Assembly Third Reading",70,0,0,9,79
1908205,1595652,2025-06-25,Senate,"Do pass, but first be re-referred to the Committee on [Appropriations]",11,0,0,0,11
1908205,1598259,2025-07-14,Senate,"Placed on suspense file",7,0,0,0,7
1908205,1600521,2025-08-29,Senate,"Do pass",7,0,0,0,7
1908205,1601100,2025-09-04,Senate,"Special Consent AB220 Jackson et al",39,0,0,1,40
1908206,1556154,2025-04-23,Assembly,"Do pass and be re-referred to the Committee on [Appropriations]",22,0,0,0,22
1908206,1577492,2025-05-23,Assembly,"Do pass",14,0,0,1,15
1908206,1582228,2025-05-29,Assembly,"AB 221 Ramos Assembly Third Reading",70,0,0,9,79
1908206,1594651,2025-06-24,Senate,"Do pass, but first be re-referred to the Committee on [Appropriations] with the recommendation: To Consent Calendar",15,0,0,0,15
1908206,1599538,2025-08-18,Senate,"Placed on suspense file",7,0,0,0,7
1908206,1600537,2025-08-29,Senate,"Do pass as amended",7,0,0,0,7
1908206,1600968,2025-09-03,Senate,"Assembly 3rd Reading AB221 Ramos et al. By Richardson",40,0,0,0,40
1908206,1601307,2025-09-08,Assembly,"AB 221 Ramos Concurrence in Senate Amendments",79,0,0,1,80
1908207,1535033,2025-04-02,Assembly,"Do pass as amended and be re-referred to the Committee on [Privacy and Consumer Protection]",13,5,0,0,18
1908207,1564262,2025-05-01,Assembly,"Do pass as amended and be re-referred to the Committee on [Appropriations]",10,1,0,4,15
1908207,1577170,2025-05-23,Assembly,"Do pass as amended",11,3,0,1,15
1908207,1583486,2025-06-02,Assembly,"AB 222 Bauer-Kahan Assembly Third Reading",57,18,0,4,79
1908207,1597175,2025-07-01,Senate,"Do pass as amended, but first amend, and re-refer to the Committee on [Judiciary]",13,3,0,1,17
1908207,1598696,2025-07-15,Senate,"Do pass, but first be re-referred to the Committee on [Appropriations]",11,2,0,0,13
1908207,1599575,2025-08-18,Senate,"Placed on suspense file",7,0,0,0,7
1908208,1528263,2025-03-26,Assembly,"Do pass as amended and be re-referred to the Committee on [Appropriations]",12,1,0,5,18
1908209,1474060,2025-01-23,Assembly,"Be adopted. To third reading",10,0,0,1,11
1908210,1538904,2025-04-07,Senate,"Do pass as amended, but first amend, and re-refer to the Committee on [Appropriations]",12,3,0,2,17
1908210,1559464,2025-04-28,Senate,"Placed on suspense file",7,0,0,0,7
1908210,1577589,2025-05-23,Senate,"Do pass",5,0,0,2,7
1908210,1580479,2025-05-28,Senate,"Senate 3rd Reading SB57 Padilla et al",25,9,0,6,40
1908210,1598095,2025-07-09,Assembly,"Do pass as amended and be re-referred to the Committee on [Appropriations]",13,4,0,1,18
1908210,1600590,2025-08-29,Assembly,"Do pass as amended",10,4,0,1,15
1908210,1602167,2025-09-12,Senate,"Unfinished Business SB57 Padilla et al. Concurrence",29,8,0,3,40
1908210,1602168,2025-09-12,Assembly,"SB 57 Padilla Senate Third Reading By Hart",57,18,0,5,80
1908212,1555936,2025-04-22,Senate,"Do pass as amended, but first amend, and re-refer to the Committee on [Appropriations]",11,2,0,0,13
1908212,1565264,2025-05-05,Senate,"Placed on suspense file",7,0,0,0,7
1908212,1577542,2025-05-23,Senate,"Do pass as amended",5,1,0,1,7
1908212,1586418,2025-06-02,Senate,"Senate 3rd Reading SB59 Wiener et al. Urgency Clause",28,10,0,2,40
1908212,1591895,2025-06-17,Assembly,"Do pass as amended and be re-referred to the Committee on [Appropriations]",9,1,0,2,12
1908212,1600470,2025-08-29,Assembly,"Do pass as amended",11,4,0,0,15
1908212,1602138,2025-09-12,Senate,"Unfinished Business SB59 Wiener et al. Urgency Clause Concurrence",29,8,0,3,40
1908212,1602139,2025-09-12,Assembly,"SB 59 Wiener Third Reading Urgency By Mark González",60,16,0,4,80
1908213,1521969,2025-03-19,Senate,"Do pass, but first be re-referred to the Committee on [Military and Veterans Affairs]",7,0,0,0,7
1908213,1559498,2025-04-28,Senate,"Do pass, but first be re-referred to the Committee on [Appropriations]",4,0,0,1,5
1908213,1569790,2025-05-12,Senate,"Placed on suspense file",7,0,0,0,7
1908214,1473359,2025-01-22,Senate,"Do pass",8,2,0,0,10
1908214,1474139,2025-01-23,Senate,"Senate 3rd Reading SB2 Wiener et al",28,8,0,3,39
1908214,1479314,2025-02-03,Assembly,"SB 2 Wiener Senate Third Reading By GABRIEL Amend By CASTILLO Set #1 Motion to Lay on the Table By AGUIAR-CURRY First Extraordinary Session",55,18,0,6,79
1908214,1479315,2025-02-03,Assembly,"SB 2 Wiener Senate Third Reading By GABRIEL First Extraordinary Session",58,17,0,4,79
1909884,1505302,2025-03-04,Assembly,"Do pass. To Consent Calendar",12,0,0,0,12
1909884,1511454,2025-03-10,Assembly,"AB 223 Pacheco Consent Calendar Second Day Regular Session",72,0,0,8,80
1909884,1591870,2025-06-17,Senate,"Do pass, but first be re-referred to the Committee on [Public Safety] with the recommendation: To Consent Calendar",12,0,0,1,13
1909884,1594568,2025-06-24,Senate,"Do pass and be ordered to the Consent Calendar",6,0,0,0,6
1909884,1596006,2025-06-27,Senate,"Consent Calendar 2nd AB223 Pacheco",38,0,0,2,40
1909885,1563112,2025-04-29,Assembly,"Do pass and be re-referred to the Committee on [Appropriations]",14,0,0,2,16
1909885,1577952,2025-05-23,Assembly,"Do pass",11,0,0,4,15
1909885,1582224,2025-05-29,Assembly,"AB 224 Bonta Assembly Third Reading",60,1,0,18,79
1909885,1598902,2025-07-16,Senate,"Do pass, but first be re-referred to the Committee on [Appropriations]",10,0,0,1,11
1909885,1599484,2025-08-18,Senate,"Placed on suspense file",7,0,0,0,7
1909885,1600719,2025-08-29,Senate,"Do pass",7,0,0,0,7
1909885,1600897,2025-09-03,Senate,"Assembly 3rd Reading AB224 Bonta et al. By Menjivar",40,0,0,0,40
1909885,1601308,2025-09-08,Assembly,"AB 224 Bonta Concurrence in Senate Amendments",71,0,0,9,80
1909886,1526937,2025-03-25,Assembly,"Do pass and be re-referred to the Committee on [Appropriations] with recommendation: To Consent Calendar",15,0,0,0,15
1909886,1542797,2025-04-09,Assembly,"Do pass. To Consent Calendar",14,0,0,1,15
1909886,1557565,2025-04-24,Assembly,"AB 225 Bonta Consent Calendar Second Day Regular Session",75,0,0,4,79
1909887,1506678,2025-03-05,Assembly,"Do pass and be re-referred to the Committee on [Appropriations]",12,0,0,5,17
1909887,1521983,2025-03-19,Assembly,"Do pass",15,0,0,0,15
1909887,1533554,2025-04-01,Assembly,"AB 226 Calderon Third Reading Urgency",77,0,0,3,80
1909887,1586932,2025-06-09,Senate,"Do pass, but first be re-referred to the Committee on [Insurance]",8,0,0,3,11
1909887,1595222,2025-06-25,Senate,"Do pass, but first be re-referred to the Committee on [Appropriations] with the recommendation: To Consent Calendar",7,0,0,0,7
1909887,1599633,2025-08-18,Senate,"Placed on suspense file",7,0,0,0,7
1909887,1600351,2025-08-29,Senate,"Do pass",7,0,0,0,7
1909887,1602181,2025-09-12,Senate,"Assembly 3rd Reading AB226 Calderon et al. By Umberg Urgency Clause",37,0,0,3,40
1909887,1602182,2025-09-13,Assembly,"AB 226 CALDERON Concurrence in Senate Amendments",74,0,0,6,80
1909888,1520436,2025-03-18,Assembly,"Be adopted as amended. To Consent Calendar",9,0,0,0,9
1909888,1601953,2025-09-11,Senate,"Special Consent ACR12 Quirk-Silva et al",40,0,0,0,40
1909889,1542720,2025-04-08,Senate,"Do pass and be ordered to the Consent Calendar",13,0,0,0,13
1909889,1557497,2025-04-24,Senate,"Consent Calendar 2nd SB61 Cortese",37,0,0,3,40
1909889,1591903,2025-06-17,Assembly,"Do pass. To Consent Calendar",11,0,0,1,12
1909889,1594063,2025-06-23,Assembly,"SB 61 Cortese Consent Calendar Second Day",71,0,0,8,79
1909890,1564227,2025-04-30,Senate,"Do pass, but first be re-referred to the Committee on [Appropriations]",11,0,0,0,11
1909890,1569909,2025-05-12,Senate,"Placed on suspense file",7,0,0,0,7
1909890,1577781,2025-05-23,Senate,"Do pass",6,0,0,1,7
1909890,1579252,2025-05-27,Senate,"Senate 3rd Reading SB62 Menjivar",39,0,0,1,40
1909890,1598425,2025-07-15,Assembly,"Do pass and be re-referred to the Committee on [Appropriations]",16,0,0,0,16
1909890,1599738,2025-08-20,Assembly,"Do pass",15,0,0,0,15
1909890,1600914,2025-09-03,Assembly,"SB 62 Menjivar Senate Third Reading By Bonta",76,0,0,3,79
1909890,1601257,2025-09-08,Senate,"Unfinished Business SB62 Menjivar et al. Concurrence",39,0,0,1,40
1909891,1554639,2025-04-22,Senate,"Do pass, but first be re-referred to the Committee on [Revenue and Taxation]",11,3,0,1,15
1909891,1556186,2025-04-23,Senate,"Do pass as amended, but first amend, and re-refer to the Committee on [Appropriations]",4,1,0,0,5
1909891,1569852,2025-05-12,Senate,"Placed on suspense file",7,0,0,0,7
1909891,1577799,2025-05-23,Senate,"Do pass as amended",4,1,0,2,7
1909891,1586439,2025-06-02,Senate,"Senate 3rd Reading SB63 Wiener et al",28,10,0,2,40
1909891,1597761,2025-07-07,Assembly,"Do pass as amended and be re-referred to the Committee on [Revenue and Taxation]",11,4,0,1,16
1909891,1598524,2025-07-14,Assembly,"Do pass and be re-referred to the Committee on [Appropriations]",4,2,0,1,7
1909891,1600741,2025-08-29,Assembly,"Do pass as amended",11,4,0,0,15
1909891,1601221,2025-09-08,Assembly,"Do pass as amended",11,5,0,0,16
1909891,1602071,2025-09-12,Senate,"Unfinished Business SB63 Wiener et al. Concurrence",29,8,0,3,40
1909891,1602072,2025-09-12,Assembly,"SB 63 Wiener Senate Third Reading By Wilson",46,20,0,14,80
1909892,1522024,2025-03-19,Senate,"Do pass, but first be re-referred to the Committee on [Revenue and Taxation]",2,5,0,0,7
1909892,1522025,2025-03-19,Senate,"[First] hearing set for [03-19-2025]: Failed passage in Committee. Reconsideration granted",7,0,0,0,7
1909893,1475142,2025-01-27,Senate,"Senate 3rd Reading SCR10 Grove",36,0,0,3,39
1909893,1479229,2025-02-03,Assembly,"Be adopted. To Consent Calendar",11,0,0,0,11
1909893,1483665,2025-02-06,Assembly,"SCR 10 Grove Consent Calendar Second Day Regular Session",72,0,0,7,79
1909894,1600023,2025-08-25,Senate,"Senate 3rd Reading SCR11 Cervantes",38,0,0,2,40
1909894,1600930,2025-09-03,Assembly,"Be adopted. To Consent Calendar",6,0,0,5,11
1909894,1601413,2025-09-08,Assembly,"SCR 11 Cervantes Consent Calendar Second Day Regular Session",71,0,0,9,80
1909895,1572380,2025-05-15,Senate,"Senate 3rd Reading SR10 Wahab et al",34,0,0,6,40
1909896,1475145,2025-01-27,Senate,"Senate 3rd Reading SR11 Alvarado-Gil et al",36,0,0,3,39
1916608,1516580,2025-03-12,Assembly,"Do pass and be re-referred to the Committee on [Appropriations]",8,0,0,1,9
1916609,1505301,2025-03-04,Assembly,"Do pass and be re-referred to the Committee on [Appropriations]",8,0,0,1,9
1916611,1566698,2025-05-05,Assembly,"Do pass and be re-referred to the Committee on [Appropriations]",7,0,0,0,7
1916612,1503922,2025-03-03,Assembly,"Do pass and be re-referred to the Committee on [Revenue and Taxation]",8,0,0,1,9
1916612,1566717,2025-05-05,Assembly,"Do pass and be re-referred to the Committee on [Appropriations]",7,0,0,0,7
1916613,1521949,2025-03-19,Assembly,"Do pass and be re-referred to the Committee on [Appropriations] with recommendation: To Consent Calendar",19,0,0,3,22
1916613,1542777,2025-04-09,Assembly,"Do pass. To Consent Calendar",14,0,0,1,15
1916613,1557512,2025-04-24,Assembly,"AB 233 Gipson Consent Calendar Second Day Regular Session",75,0,0,4,79
1916613,1588082,2025-06-10,Senate,"Do pass, but first be re-referred to the Committee on [Appropriations] with the recommendation: To Consent Calendar",14,0,0,1,15
1916613,1596009,2025-06-27,Senate,"Consent Calendar 2nd AB233 Gipson",38,0,0,2,40
1916614,1535029,2025-04-02,Assembly,"Do pass",16,0,0,1,17
1916614,1538952,2025-04-07,Assembly,"AB 234 Calderon Third Reading Urgency",66,0,0,13,79
1916614,1595177,2025-06-25,Senate,"Do pass",5,0,0,2,7
1916614,1602241,2025-09-12,Senate,"Assembly 3rd Reading AB234 Calderon et al. By Caballero Urgency Clause",28,0,0,12,40
1916615,1545049,2025-04-09,Assembly,"Do pass as amended and be re-referred to the Committee on [Appropriations]",7,1,0,1,9
1916616,1503910,2025-03-03,Assembly,"Do pass and be re-referred to the Committee on [Appropriations]",8,0,0,1,9
1916617,1505304,2025-03-04,Assembly,"Do pass as amended and be re-referred to the Committee on [Appropriations]",9,0,0,0,9
1916617,1577687,2025-05-23,Assembly,"Do pass as amended",11,0,0,4,15
1916617,1584368,2025-06-03,Assembly,"AB 237 Patel Assembly Third Reading",75,0,0,4,79
1916617,1597219,2025-07-01,Senate,"Do pass as amended, but first amend, and re-refer to the Committee on [Appropriations]",6,0,0,0,6
1916617,1599642,2025-08-18,Senate,"Placed on suspense file",7,0,0,0,7
1916617,1600334,2025-08-29,Senate,"Do pass",7,0,0,0,7
1916618,1503911,2025-03-03,Assembly,"Do pass and be re-referred to the Committee on [Judiciary]",6,0,0,3,9
1916618,1505306,2025-03-04,Assembly,"Do pass and be re-referred to the Committee on [Appropriations]",11,0,0,1,12
1916618,1522001,2025-03-19,Assembly,"Do pass",13,0,0,2,15
1916618,1538987,2025-04-07,Assembly,"AB 238 Harabedian Third Reading Urgency",70,0,0,9,79
1916618,1592548,2025-06-18,Senate,"Do pass, but first be re-referred to the Committee on [Judiciary]",7,0,0,0,7
1916618,1595187,2025-06-24,Senate,"Do pass as amended, but first amend, and re-refer to the Committee on [Appropriations]",12,0,0,1,13
1916618,1598292,2025-07-14,Senate,"Do pass",7,0,0,0,7
1916618,1600810,2025-09-02,Senate,"Assembly 3rd Reading AB238 Harabedian et al. By Grayson Urgency Clause",40,0,0,0,40
1916618,1600972,2025-09-03,Assembly,"AB 238 Harabedian Concurrence in Senate Amendments",77,0,0,2,79
1916619,1528264,2025-03-26,Assembly,"Do pass as amended and be re-referred to the Committee on [Emergency Management]",11,0,0,0,11
1916619,1540975,2025-04-07,Assembly,"Do pass and be re-referred to the Committee on [Appropriations]",7,0,0,0,7
1916619,1577772,2025-05-23,Assembly,"Do pass as amended",11,0,0,4,15
1916619,1583359,2025-06-02,Assembly,"AB 239 Harabedian Third Reading Urgency",79,0,0,0,79
1916619,1594613,2025-06-24,Senate,"Do pass, but first be re-referred to the Committee on [Governmental Organization]",11,0,0,0,11
1916619,1597831,2025-07-08,Senate,"Do pass, but first be re-referred to the Committee on [Appropriations] with the recommendation: To Consent Calendar",15,0,0,0,15
1916619,1599508,2025-08-18,Senate,"Placed on suspense file",7,0,0,0,7
1916619,1600498,2025-08-29,Senate,"Do pass as amended",7,0,0,0,7
1916619,1601123,2025-09-04,Senate,"Assembly 3rd Reading AB239 Harabedian et al. By Pérez Urgency Clause",39,0,0,1,40
1916619,1601309,2025-09-08,Assembly,"AB 239 Harabedian Concurrence in Senate Amendments",79,0,0,1,80
1916620,1598207,2025-07-14,Assembly,"Be adopted. To Consent Calendar",10,0,0,1,11
1916620,1598872,2025-07-17,Assembly,"ACR 13 Jackson Consent Calendar Second Day",75,0,0,4,79
1916620,1601996,2025-09-11,Senate,"Special Consent ACR13 Jackson By Umberg",40,0,0,0,40
1916621,1535140,2025-04-01,Senate,"Do pass and be ordered to the Consent Calendar",13,0,0,0,13
1916621,1545050,2025-04-10,Senate,"Consent Calendar 2nd SB66 Umberg",35,0,0,5,40
1916621,1591884,2025-06-17,Assembly,"Do pass. To Consent Calendar",11,0,0,1,12
1916621,1594077,2025-06-23,Assembly,"SB 66 Umberg Consent Calendar Second Day Regular Session",71,0,0,8,79
1916622,1521973,2025-03-19,Senate,"Do pass, but first be re-referred to the Committee on [Military and Veterans Affairs]",7,0,0,0,7
1916622,1559481,2025-04-28,Senate,"Do pass, but first be re-referred to the Committee on [Appropriations] with the recommendation: To Consent Calendar",4,0,0,1,5
1916622,1569832,2025-05-12,Senate,"Placed on suspense file",7,0,0,0,7
1916622,1577222,2025-05-23,Senate,"Do pass",6,0,0,1,7
1916622,1581738,2025-05-29,Senate,"Special Consent SB67 Seyarto et al",38,0,0,2,40
1916622,1594669,2025-06-24,Assembly,"Do pass and be re-referred to the Committee on [Military and Veterans Affairs] with recommendation: To Consent Calendar",10,0,0,0,10
1916622,1598517,2025-07-15,Assembly,"Do pass and be re-referred to the Committee on [Appropriations] with recommendation: To Consent Calendar",8,0,0,0,8
1916622,1600656,2025-08-29,Assembly,"Do pass",15,0,0,0,15
1916622,1602115,2025-09-12,Senate,"Unfinished Business SB67 Seyarto et al. Concurrence",34,0,0,6,40
1916622,1602116,2025-09-13,Assembly,"SB 67 Seyarto Senate Third Reading By Ta",78,0,0,2,80
1916623,1545025,2025-04-09,Senate,"Do pass, but first be re-referred to the Committee on [Appropriations]",11,0,0,0,11
1916623,1559493,2025-04-28,Senate,"Placed on suspense file",7,0,0,0,7
1916623,1577744,2025-05-23,Senate,"Do pass as amended",5,0,0,2,7
1916623,1580502,2025-05-28,Senate,"Senate 3rd Reading SB68 Menjivar",32,0,0,8,40
1916623,1598070,2025-07-08,Assembly,"Do pass as amended and be re-referred to the Committee on [Appropriations]",14,1,0,1,16
1916623,1599745,2025-08-20,Assembly,"Do pass",11,2,0,2,15
1916623,1601394,2025-09-08,Assembly,"SB 68 Menjivar Senate Third Reading By Elhawary",66,1,0,13,80
1916623,1601615,2025-09-09,Senate,"Unfinished Business SB68 Menjivar Concurrence",39,0,0,1,40
1916624,1474057,2025-01-23,Senate,"Senate 3rd Reading SCR12 Umberg",36,0,0,3,39
1916624,1565339,2025-05-05,Assembly,"Be adopted. To Consent Calendar",9,0,0,2,11
1916624,1568600,2025-05-08,Assembly,"SCR 12 Umberg Consent Calendar Second Day Regular Session",69,0,0,10,79
1916624,1577485,2025-05-23,Senate,"Special Consent SCR12 Umberg",36,0,0,4,40
1916625,1477880,2025-01-30,Senate,"Senate 3rd Reading SCR13 Grayson et al",36,0,0,3,39
1916625,1485609,2025-02-10,Assembly,"Be adopted. To Consent Calendar",9,0,0,2,11
1916626,1479226,2025-02-03,Senate,"Senate 3rd Reading SR12 Wahab et al",38,0,0,1,39
1919265,1521971,2025-03-18,Assembly,"Do pass and be re-referred to the Committee on [Appropriations] with recommendation: To Consent Calendar",9,0,0,1,10
1919267,1533594,2025-04-01,Assembly,"Do pass and be re-referred to the Committee on [Appropriations] with recommendation: To Consent Calendar",15,0,0,0,15
1919268,1522017,2025-03-18,Assembly,"Do pass and be re-referred to the Committee on [Judiciary]",8,0,0,2,10
1919268,1540794,2025-04-08,Assembly,"Do pass and be re-referred to the Committee on [Appropriations] with recommendation: To Consent Calendar",12,0,0,0,12
1919268,1556187,2025-04-23,Assembly,"Do pass. To Consent Calendar",15,0,0,0,15
1919268,1564264,2025-05-01,Assembly,"AB 243 Ahrens Consent Calendar Second Day Regular Session",76,0,0,3,79
1919268,1589111,2025-06-11,Senate,"Do pass as amended, but first amend, and re-refer to the Committee on [Judiciary]",6,0,0,1,7
1919268,1595194,2025-06-24,Senate,"Do pass, but first be re-referred to the Committee on [Appropriations] with the recommendation: To Consent Calendar",12,0,0,1,13
1919268,1601793,2025-09-10,Senate,"Assembly 3rd Reading AB243 Ahrens By Wahab",40,0,0,0,40
1919270,1561107,2025-04-28,Assembly,"Do pass as amended and be re-referred to the Committee on [Appropriations]",7,0,0,0,7
1919270,1577780,2025-05-23,Assembly,"Do pass",14,0,0,1,15
1919270,1584269,2025-06-03,Assembly,"AB 245 Gipson Third Reading Urgency",79,0,0,0,79
1919270,1598049,2025-07-09,Senate,"Do pass as amended, but first amend, and re-refer to the Committee on [Appropriations]",5,0,0,0,5
1919270,1599551,2025-08-18,Senate,"Placed on suspense file",7,0,0,0,7
1919270,1600558,2025-08-29,Senate,"Do pass as amended",7,0,0,0,7
1919270,1601983,2025-09-11,Senate,"Special Consent AB245 Gipson By Umberg Urgency Clause",40,0,0,0,40
1919270,1602078,2025-09-12,Assembly,"AB 245 Gipson Concurrence in Senate Amendments",80,0,0,0,80
1919271,1490596,2025-02-14,Senate,"Special Consent ACR14 Michelle Rodriguez",34,0,0,5,39
1919272,1511440,2025-03-10,Assembly,"Be adopted. To Consent Calendar",9,0,0,2,11
1919272,1517611,2025-03-13,Assembly,"HR 9 Lackey Consent Calendar Second Day Regular Session",68,0,0,12,80
1919273,1556178,2025-04-23,Senate,"Do pass as amended, but first amend, and re-refer to the Committee on [Appropriations] with the recommendation: To Consent Calendar",8,0,0,0,8
1919273,1565230,2025-05-05,Senate,"Placed on suspense file",7,0,0,0,7
1919273,1577675,2025-05-23,Senate,"Do pass as amended",6,0,0,1,7
1919273,1580487,2025-05-28,Senate,"Senate 3rd Reading SB69 McNerney et al",35,0,0,5,40
1919273,1597817,2025-07-08,Assembly,"Do pass and be re-referred to the Committee on [Judiciary]",14,0,0,1,15
1919273,1598503,2025-07-15,Assembly,"Do pass and be re-referred to the Committee on [Appropriations] with recommendation: To Consent Calendar",12,0,0,0,12
1919274,1515275,2025-03-11,Senate,"Do pass, but first be re-referred to the Committee on [Appropriations] with the recommendation: To Consent Calendar",14,0,0,1,15
1919274,1538918,2025-04-07,Senate,"Placed on suspense file",7,0,0,0,7
1919274,1577698,2025-05-23,Senate,"Do pass",6,0,0,1,7
1919274,1581758,2025-05-29,Senate,"Special Consent SB70 Seyarto",38,0,0,2,40
1919274,1597857,2025-07-08,Assembly,"Do pass and be re-referred to the Committee on [Appropriations]",7,0,0,1,8
1919275,1521967,2025-03-19,Senate,"Do pass as amended, but first amend, and re-refer to the Committee on [Transportation]",8,0,0,0,8
1919275,1542849,2025-04-08,Senate,"Do pass, but first be re-referred to the Committee on [Appropriations]",12,0,0,3,15
1919275,1559409,2025-04-28,Senate,"Placed on suspense file",7,0,0,0,7
1919275,1577732,2025-05-23,Senate,"Do pass as amended",5,0,0,2,7
1919275,1584243,2025-06-03,Senate,"Senate 3rd Reading SB71 Wiener et al",36,0,0,4,40
1919275,1598310,2025-07-14,Assembly,"Do pass as amended and be re-referred to the Committee on [Appropriations]",12,0,0,2,14
1919275,1600593,2025-08-29,Assembly,"Do pass as amended",10,0,0,5,15
1919275,1601484,2025-09-09,Assembly,"SB 71 Wiener Senate Third Reading By Ward",78,1,0,1,80
1919275,1601778,2025-09-10,Senate,"Unfinished Business SB71 Wiener et al. Concurrence",39,0,0,1,40
1922275,1505320,2025-03-04,Assembly,"Do pass as amended",8,3,0,1,12
1922275,1561136,2025-04-29,Assembly,"Do pass as amended and be re-referred to the Committee on [Appropriations]",8,3,0,1,12
1922275,1577496,2025-05-23,Assembly,"Do pass",11,2,0,2,15
1922275,1585044,2025-06-04,Assembly,"AB 246 Bryan Assembly Third Reading",49,13,0,17,79
1922275,1598736,2025-07-15,Senate,"Do pass as amended, but first amend, and re-refer to the Committee on [Appropriations]",11,2,0,0,13
1922275,1600017,2025-08-25,Senate,"Placed on suspense file",6,0,0,1,7
1922275,1600258,2025-08-29,Senate,"Do pass",5,2,0,0,7
1922275,1601478,2025-09-09,Senate,"Assembly 3rd Reading AB246 Bryan et al. By Wahab",27,11,0,2,40
1922276,1515250,2025-03-11,Assembly,"Do pass and be re-referred to the Committee on [Appropriations]",8,0,0,1,9
1922276,1577671,2025-05-23,Assembly,"Do pass as amended",12,2,0,1,15
1922276,1584264,2025-06-03,Assembly,"Do pass",9,0,0,6,15
1922276,1585800,2025-06-05,Assembly,"AB 247 Bryan Assembly Third Reading",74,0,0,5,79
1922276,1597849,2025-07-08,Senate,"Do pass, but first be re-referred to the Committee on [Appropriations]",6,0,0,0,6
1922276,1599507,2025-08-18,Senate,"Placed on suspense file",7,0,0,0,7
1922276,1600364,2025-08-29,Senate,"Do pass",7,0,0,0,7
1922276,1601797,2025-09-10,Senate,"Assembly 3rd Reading AB247 Bryan et al. By Pérez Urgency Clause",39,0,0,1,40
1922277,1515248,2025-03-11,Assembly,"Do pass",6,0,0,3,9
1922277,1523727,2025-03-20,Assembly,"AB 248 Bryan Assembly Third Reading",51,12,0,17,80
1922277,1588094,2025-06-10,Senate,"Do pass as amended",5,0,0,1,6
1922277,1600879,2025-09-03,Senate,"Assembly 3rd Reading AB248 Bryan et al. By Becker",30,4,0,6,40
1922277,1601310,2025-09-08,Assembly,"AB 248 Bryan Concurrence in Senate Amendments",57,12,0,11,80
1922278,1528250,2025-03-26,Assembly,"Do pass as amended and be re-referred to the Committee on [Human Services]",11,0,0,0,11
1922278,1540897,2025-04-08,Assembly,"Do pass and be re-referred to the Committee on [Appropriations] with recommendation: To Consent Calendar",6,0,0,0,6
1922279,1515264,2025-03-11,Assembly,"Do pass and be re-referred to the Committee on [Appropriations]",9,2,0,1,12
1922279,1577623,2025-05-23,Assembly,"Do pass",11,1,0,3,15
1922279,1582253,2025-05-29,Assembly,"AB 250 Aguiar-Curry Assembly Third Reading",56,2,0,21,79
1922279,1597531,2025-07-01,Senate,"Do pass, but first be re-referred to the Committee on [Appropriations]",10,0,0,3,13
1922279,1598270,2025-07-14,Senate,"Placed on suspense file",7,0,0,0,7
1922279,1600586,2025-08-29,Senate,"Do pass as amended",5,2,0,0,7
1922279,1601473,2025-09-09,Senate,"Assembly 3rd Reading AB250 Aguiar-Curry By Laird",30,6,0,4,40
1922280,1526883,2025-03-25,Assembly,"Do pass",8,2,0,2,12
1922280,1533524,2025-04-01,Assembly,"AB 251 Kalra Assembly Third Reading",57,8,0,15,80
1922280,1591840,2025-06-17,Senate,"Do pass, but first be re-referred to the Committee on [Appropriations]",10,0,0,3,13
1922280,1596756,2025-06-30,Senate,"Placed on suspense file",6,0,0,1,7
1922280,1600265,2025-08-29,Senate,"Do pass",5,2,0,0,7
1922280,1601176,2025-09-04,Senate,"Assembly 3rd Reading AB251 Kalra By Wahab",29,7,0,4,40
1922280,1601311,2025-09-08,Assembly,"AB 251 Kalra Concurrence in Senate Amendments",60,10,0,10,80
1922281,1538939,2025-04-07,Assembly,"Do pass and be re-referred to the Committee on [Appropriations]",14,0,0,0,14
1922282,1516581,2025-03-12,Assembly,"Do pass as amended and be re-referred to the Committee on [Appropriations]",10,0,0,0,10
1922282,1516582,2025-03-12,Assembly,"Do pass and be re-referred to the Committee on [Local Government]",11,0,0,1,12
1922282,1522023,2025-03-19,Assembly,"Do pass",13,0,0,2,15
1922282,1533547,2025-04-01,Assembly,"AB 253 Ward Third Reading Urgency",76,0,0,4,80
1922282,1597535,2025-07-02,Senate,"Do pass as amended, but first amend, and re-refer to the Committee on [Housing]",6,0,0,1,7
1922282,1598506,2025-07-15,Senate,"Do pass as amended, but first amend, and re-refer to the Committee on [Appropriations]",10,0,0,1,11
1922282,1599517,2025-08-18,Senate,"Placed on suspense file",7,0,0,0,7
1922282,1600762,2025-08-29,Senate,"Do pass as amended",7,0,0,0,7
1922282,1601947,2025-09-11,Senate,"Assembly 3rd Reading AB253 Ward et al. By Wiener Urgency Clause",40,0,0,0,40
1922282,1602112,2025-09-12,Assembly,"AB 253 Ward Concurrence in Senate Amendments",77,0,0,3,80
1922283,1554433,2025-04-22,Assembly,"Do pass and be re-referred to the Committee on [Appropriations] with recommendation: To Consent Calendar",8,0,0,0,8
1922283,1577308,2025-05-23,Assembly,"Do pass as amended",14,0,0,1,15
1922283,1584416,2025-06-03,Assembly,"AB 254 Gallagher Assembly Third Reading",77,0,0,2,79
1922283,1597697,2025-07-07,Senate,"Do pass, but first be re-referred to the Committee on [Appropriations]",11,0,0,0,11
1922283,1599480,2025-08-18,Senate,"Placed on suspense file",7,0,0,0,7
1922284,1530386,2025-03-28,Assembly,"Be adopted. To third reading",7,0,0,4,11
1922284,1593160,2025-06-19,Senate,"Assembly 3rd Reading ACR15 Alanis et al. By Laird",35,0,0,5,40
1922285,1540816,2025-04-08,Senate,"Do pass as amended, but first amend, and re-refer to the Committee on [Appropriations]",6,0,0,1,7
1922285,1559451,2025-04-28,Senate,"Placed on suspense file",7,0,0,0,7
1922285,1577367,2025-05-23,Senate,"Do pass",5,0,0,2,7
1922285,1584345,2025-06-03,Senate,"Senate 3rd Reading SB72 Caballero et al",37,0,0,3,40
1922285,1597166,2025-07-01,Assembly,"Do pass and be re-referred to the Committee on [Appropriations]",12,0,0,1,13
1922285,1600432,2025-08-29,Assembly,"Do pass",15,0,0,0,15
1922285,1601117,2025-09-04,Assembly,"SB 72 Caballero Senate Third Reading By Soria",73,0,0,6,79
1922287,1536767,2025-04-02,Senate,"Do pass as amended, but first amend, and re-refer to the Committee on [Appropriations]",7,0,0,0,7
1922287,1552888,2025-04-21,Senate,"Placed on suspense file",6,0,0,1,7
1922287,1577543,2025-05-23,Senate,"Do pass",6,0,0,1,7
1922287,1581784,2025-05-29,Senate,"Special Consent SB74 Seyarto et al",38,0,0,2,40
1922287,1592617,2025-06-18,Assembly,"Do pass and be re-referred to the Committee on [Appropriations] with recommendation: To Consent Calendar",10,0,0,0,10
1922288,1555908,2025-04-23,Senate,"Do pass, but first be re-referred to the Committee on [Public Safety]",5,0,0,0,5
1922288,1562764,2025-04-29,Senate,"Do pass, but first be re-referred to the Committee on [Appropriations]",6,0,0,0,6
1922288,1569827,2025-05-12,Senate,"Placed on suspense file",7,0,0,0,7
1922288,1577615,2025-05-23,Senate,"Do pass",6,0,0,1,7
1922288,1586402,2025-06-02,Senate,"Senate 3rd Reading SB75 Smallwood-Cuevas",38,0,0,2,40
1922288,1598029,2025-07-09,Assembly,"Do pass and be re-referred to the Committee on [Public Safety] with recommendation: To Consent Calendar",7,0,0,0,7
1922288,1598638,2025-07-15,Assembly,"Do pass and be re-referred to the Committee on [Appropriations] with recommendation: To Consent Calendar",9,0,0,0,9
1922288,1600458,2025-08-29,Assembly,"Do pass",15,0,0,0,15
1922288,1602242,2025-09-12,Senate,"Unfinished Business SB75 Smallwood-Cuevas Concurrence",37,0,0,3,40
1922288,1602243,2025-09-12,Assembly,"SB 75 Smallwood-Cuevas Senate Third Reading By Quirk-Silva",79,1,0,0,80
1922289,1526941,2025-03-25,Senate,"Do pass, but first be re-referred to the Committee on [Appropriations]",14,0,0,1,15
1922289,1538892,2025-04-07,Senate,"Placed on suspense file",7,0,0,0,7
1922289,1577738,2025-05-23,Senate,"Do pass",6,0,0,1,7
1922289,1581753,2025-05-29,Senate,"Special Consent SB76 Seyarto",38,0,0,2,40
1922289,1598370,2025-07-14,Assembly,"Do pass and be re-referred to the Committee on [Appropriations] with recommendation: To Consent Calendar",16,0,0,0,16
1922289,1600691,2025-08-29,Assembly,"Do pass",15,0,0,0,15
1922289,1601119,2025-09-04,Assembly,"SB 76 Seyarto Senate Third Reading By Chen",75,0,0,4,79
1922290,1515269,2025-03-11,Senate,"Do pass as amended, but first amend, and re-refer to the Committee on [Appropriations]",13,0,0,2,15
1922290,1538899,2025-04-07,Senate,"Placed on suspense file",7,0,0,0,7
1922291,1542883,2025-04-08,Senate,"Do pass, but first be re-referred to the Committee on [Appropriations] with the recommendation: To Consent Calendar",15,0,0,0,15
1922291,1552891,2025-04-21,Senate,"Placed on suspense file",6,0,0,1,7
1922291,1577159,2025-05-23,Senate,"Do pass",6,0,0,1,7
1922291,1581714,2025-05-29,Senate,"Special Consent SB78 Seyarto et al",38,0,0,2,40
1922291,1597713,2025-07-07,Assembly,"Do pass and be re-referred to the Committee on [Appropriations] with recommendation: To Consent Calendar",16,0,0,0,16
1922291,1600292,2025-08-29,Assembly,"Do pass",15,0,0,0,15
1922291,1601400,2025-09-08,Assembly,"SB 78 Seyarto Senate Third Reading By Lackey",77,0,0,3,80
1922291,1602331,2025-09-12,Senate,"Unfinished Business SB78 Seyarto et al. Concurrence",38,0,0,2,40
1922292,1556032,2025-04-22,Senate,"Do pass, but first be re-referred to the Committee on [Local Government]",6,2,0,3,11
1922292,1562872,2025-04-30,Senate,"Do pass, but first be re-referred to the Committee on [Appropriations]",4,3,0,0,7
1922292,1573495,2025-05-19,Senate,"Placed on suspense file",5,0,0,2,7
1922292,1577901,2025-05-23,Senate,"Do pass as amended",4,2,0,1,7
1922292,1584417,2025-06-03,Senate,"Senate 3rd Reading SB79 Wiener",21,13,0,6,40
1922292,1597490,2025-07-02,Assembly,"Do pass as amended and be re-referred to the Committee on [Local Government]",9,2,0,1,12
1922292,1598829,2025-07-16,Assembly,"Do pass as amended and be re-referred to the Committee on [Appropriations]",6,1,0,3,10
1922292,1600426,2025-08-29,Assembly,"Do pass as amended",8,6,0,1,15
1922292,1602275,2025-09-12,Senate,"Unfinished Business SB79 Wiener et al. Concurrence",21,8,0,11,40
1926272,1558387,2025-04-24,Assembly,"Do pass and be re-referred to the Committee on [Health]",12,0,0,0,12
1926272,1562934,2025-04-29,Assembly,"Do pass and be re-referred to the Committee on [Appropriations]",15,0,0,1,16
1926272,1577570,2025-05-23,Assembly,"Do pass",13,0,0,2,15
1926272,1584234,2025-06-03,Assembly,"AB 255 Haney Assembly Third Reading",79,0,0,0,79
1926272,1594670,2025-06-24,Senate,"Do pass as amended, but first amend, and re-refer to the Committee on [Health]",11,0,0,0,11
1926272,1598288,2025-07-14,Senate,"Placed on suspense file",7,0,0,0,7
1926272,1600291,2025-08-29,Senate,"Do pass as amended",7,0,0,0,7
1926272,1601222,2025-09-08,Senate,"Assembly 3rd Reading AB255 Haney et al. By Caballero",39,0,0,1,40
1926272,1601477,2025-09-09,Assembly,"AB 255 Haney Concurrence in Senate Amendments",79,0,0,1,80
1926274,1526999,2025-03-25,Assembly,"Do pass as amended and be re-referred to the Committee on [Appropriations]",15,0,0,0,15
1926275,1561065,2025-04-28,Assembly,"Do pass as amended and be re-referred to the Committee on [Appropriations]",6,1,0,0,7
1926275,1577899,2025-05-23,Assembly,"Do pass",14,0,0,1,15
1926275,1583513,2025-06-02,Assembly,"AB 258 Connolly Assembly Third Reading",77,1,0,1,79
1926275,1595216,2025-06-25,Senate,"Do pass, but first be re-referred to the Committee on [Appropriations]",5,0,0,0,5
1926275,1597707,2025-07-07,Senate,"Placed on suspense file",6,0,0,1,7
1926275,1600343,2025-08-29,Senate,"Do pass",7,0,0,0,7
1926275,1601468,2025-09-09,Senate,"Assembly 3rd Reading AB258 Connolly et al. By Laird",40,0,0,0,40
1926276,1542896,2025-04-09,Assembly,"Do pass as amended",9,0,0,1,10
1926276,1565255,2025-05-05,Assembly,"AB 259 Blanca Rubio Assembly Third Reading",73,0,0,6,79
1926277,1540981,2025-04-08,Assembly,"Do pass and be re-referred to the Committee on [Business and Professions]",12,1,0,2,15
1926277,1561028,2025-04-29,Assembly,"Do pass and be re-referred to the Committee on [Appropriations]",14,1,0,3,18
1926277,1571545,2025-05-14,Assembly,"Do pass",11,4,0,0,15
1926277,1573589,2025-05-19,Assembly,"AB 260 Aguiar-Curry Assembly Third Reading",61,11,0,7,79
1926277,1589125,2025-06-11,Senate,"Do pass as amended, but first amend, and re-refer to the Committee on [Business, Professions and Economic Development]",6,1,0,4,11
1926277,1594040,2025-06-23,Senate,"Do pass, but first be re-referred to the Committee on [Appropriations]",8,2,0,1,11
1926277,1597741,2025-07-07,Senate,"Placed on suspense file",6,0,0,1,7
1926277,1600574,2025-08-29,Senate,"Do pass",5,2,0,0,7
1926277,1601536,2025-09-09,Senate,"Assembly 3rd Reading AB260 Aguiar-Curry et al. By Limón Urgency Clause",30,8,0,2,40
1926279,1525460,2025-03-24,Assembly,"Do pass as amended, and be re-referred to the Committee on [Emergency Management] with recommendation: To Consent Calendar",13,0,0,1,14
1926279,1561115,2025-04-28,Assembly,"Do pass and be re-referred to the Committee on [Appropriations] with recommendation: To Consent Calendar",7,0,0,0,7
1926279,1577619,2025-05-23,Assembly,"Do pass",14,0,0,1,15
1926279,1582238,2025-05-29,Assembly,"AB 261 Quirk-Silva Assembly Third Reading",70,0,0,9,79
1926279,1594610,2025-06-24,Senate,"Do pass, but first be re-referred to the Committee on [Natural Resources and Water] with the recommendation: To Consent Calendar",15,0,0,0,15
1926279,1597894,2025-07-08,Senate,"Do pass as amended, but first amend, and re-refer to the Committee on [Appropriations] with the recommendation: To Consent Calendar",7,0,0,0,7
1926279,1599593,2025-08-18,Senate,"Placed on suspense file",7,0,0,0,7
1926280,1540856,2025-04-07,Assembly,"Do pass and be re-referred to the Committee on [Appropriations]",5,2,0,0,7
1926280,1577932,2025-05-23,Assembly,"Do pass as amended",11,3,0,1,15
1926280,1583564,2025-06-02,Assembly,"AB 262 Caloza Third Reading Urgency",63,11,0,5,79
1926281,1540982,2025-04-08,Assembly,"Do pass as amended and be re-referred to the Committee on [Appropriations]",9,3,0,1,13
1926281,1556180,2025-04-23,Assembly,"Do pass",11,4,0,0,15
1926281,1565233,2025-05-05,Assembly,"AB 263 Rogers Assembly Third Reading",56,17,0,6,79
1926281,1588088,2025-06-10,Senate,"Do pass as amended, but first amend, and re-refer to the Committee on [Appropriations]",6,0,0,1,7
1926281,1601616,2025-09-09,Senate,"Assembly 3rd Reading AB263 Rogers et al. By McGuire",30,6,0,4,40
1926282,1544966,2025-04-08,Assembly,"Do pass and be re-referred to the Committee on [Appropriations]",7,0,0,1,8
1926282,1577908,2025-05-23,Assembly,"Do pass",14,0,0,1,15
1926282,1582255,2025-05-29,Assembly,"AB 264 Carrillo Assembly Third Reading",70,0,0,9,79
1926282,1598229,2025-07-14,Senate,"Do pass, but first be re-referred to the Committee on [Appropriations] with the recommendation: To Consent Calendar",5,0,0,0,5
1926282,1599422,2025-08-18,Senate,"Placed on suspense file",7,0,0,0,7
1926282,1600495,2025-08-29,Senate,"Do pass",7,0,0,0,7
1926283,1558361,2025-04-24,Assembly,"Be adopted and re-referred to the Committee on [Higher Education]",10,0,0,2,12
1926283,1561105,2025-04-29,Assembly,"Be adopted and re-referred to the Committee on [Appropriations]",7,3,0,0,10
1926284,1561130,2025-04-28,Assembly,"Be adopted. To Consent Calendar",16,0,0,0,16
1926284,1564159,2025-05-01,Assembly,"ACR 16 Gallagher Consent Calendar Second Day Regular Session",76,0,0,3,79
1926284,1588078,2025-06-10,Senate,"Be adopted, but first be re-referred to the Committee on [Appropriations] with recommendation: To Consent Calendar",13,0,0,2,15
1926284,1596032,2025-06-27,Senate,"Consent Calendar 2nd ACR16 Gallagher",38,0,0,2,40
1926284,1596748,2025-06-30,Assembly,"ACR 16 Gallagher Concurrence in Senate Amendments",77,0,0,2,79
1926285,1554584,2025-04-21,Senate,"Do pass as amended, but first amend, and re-refer to the Committee on [Appropriations]",16,0,0,1,17
1926285,1569873,2025-05-12,Senate,"Placed on suspense file",7,0,0,0,7
1926285,1577219,2025-05-23,Senate,"Do pass",6,0,0,1,7
1926285,1586389,2025-06-02,Senate,"Senate 3rd Reading SB80 Caballero et al",38,0,0,2,40
1926285,1595200,2025-06-25,Assembly,"Do pass as amended, and be re-referred to the Committee on [Appropriations] with recommendation: To Consent Calendar",18,0,0,0,18
1926285,1600661,2025-08-29,Assembly,"Do pass",15,0,0,0,15
1926285,1602235,2025-09-12,Senate,"Unfinished Business SB80 Caballero et al. Concurrence",36,0,0,4,40
1926285,1602236,2025-09-12,Assembly,"SB 80 Caballero Senate Third Reading By Harabedian",80,0,0,0,80
1929337,1554471,2025-04-22,Assembly,"Do pass and be re-referred to the Committee on [Appropriations]",8,0,0,0,8
1929337,1577562,2025-05-23,Assembly,"Do pass as amended",11,0,0,4,15
1929337,1583520,2025-06-02,Assembly,"AB 265 Caloza Assembly Third Reading",79,0,0,0,79
1929337,1597739,2025-07-07,Senate,"Do pass, but first be re-referred to the Committee on [Appropriations]",11,0,0,0,11
1929337,1599539,2025-08-18,Senate,"Placed on suspense file",7,0,0,0,7
1929337,1600626,2025-08-29,Senate,"Do pass as amended",7,0,0,0,7
1929337,1601929,2025-09-11,Senate,"Special Consent AB265 Caloza et al. By Cortese",40,0,0,0,40
1929337,1602250,2025-09-12,Assembly,"AB 265 Caloza Concurrence in Senate Amendments",80,0,0,0,80
1929338,1525470,2025-03-24,Assembly,"Do pass. To Consent Calendar",16,0,0,0,16
1929338,1530389,2025-03-28,Assembly,"AB 266 Davies Consent Calendar Second Day Regular Session",62,0,0,18,80
1929338,1588075,2025-06-10,Senate,"Do pass, but first be re-referred to the Committee on [Appropriations] with the recommendation: To Consent Calendar",13,0,0,2,15
1929338,1596749,2025-06-30,Senate,"Placed on suspense file",6,0,0,1,7
1929340,1535065,2025-04-02,Assembly,"Do pass and be re-referred to the Committee on [Public Employment and Retirement]",19,0,0,3,22
1929340,1556077,2025-04-23,Assembly,"Do pass and be re-referred to the Committee on [Appropriations]",7,0,0,0,7
1929340,1577800,2025-05-23,Assembly,"Do pass",14,0,0,1,15
1929340,1583388,2025-06-02,Assembly,"AB 268 Kalra Assembly Third Reading",78,0,0,1,79
1929340,1594654,2025-06-24,Senate,"Do pass, but first be re-referred to the Committee on [Education]",13,0,0,2,15
1929340,1598086,2025-07-09,Senate,"Do pass, but first be re-referred to the Committee on [Appropriations]",5,0,0,2,7
1929340,1599464,2025-08-18,Senate,"Placed on suspense file",7,0,0,0,7
1929340,1600431,2025-08-29,Senate,"Do pass",7,0,0,0,7
1929340,1601804,2025-09-10,Senate,"Assembly 3rd Reading AB268 Kalra et al. By Allen",36,0,0,4,40
1929342,1474062,2025-01-23,Assembly,"Be adopted. To Consent Calendar",10,0,0,1,11
1929342,1477877,2025-01-30,Assembly,"ACR 17 Hadwick Consent Calendar Second Day",69,0,0,10,79
1929342,1517820,2025-03-13,Senate,"Special Consent ACR17 Hadwick et al",36,0,0,4,40
1929343,1557592,2025-04-23,Senate,"Do pass, but first be re-referred to the Committee on [Judiciary]",9,1,0,1,11
1929343,1562817,2025-04-29,Senate,"Do pass as amended, but first amend, and re-refer to the Committee on [Appropriations]",11,0,0,2,13
1929343,1569810,2025-05-12,Senate,"Placed on suspense file",7,0,0,0,7
1929343,1577499,2025-05-23,Senate,"Do pass",5,1,0,1,7
1929343,1586427,2025-06-02,Senate,"Senate 3rd Reading SB81 Arreguín et al. Urgency Clause",28,7,0,5,40
1929343,1594631,2025-06-24,Assembly,"Do pass and be re-referred to the Committee on [Privacy and Consumer Protection]",11,1,0,4,16
1929343,1597968,2025-07-08,Assembly,"Do pass as amended and be re-referred to the Committee on [Appropriations]",11,3,0,1,15
1929343,1599769,2025-08-20,Assembly,"Do pass",11,3,0,1,15
1929343,1600821,2025-09-02,Senate,"Unfinished Business SB81 Arreguín et al. Urgency Clause Concurrence",30,7,0,3,40
1929343,1600822,2025-09-02,Assembly,"SB 81 Arreguín Third Reading Urgency By Ortega",58,11,0,10,79
1929344,1555915,2025-04-22,Senate,"Do pass, but first be re-referred to the Committee on [Appropriations]",11,2,0,0,13
1929344,1565324,2025-05-05,Senate,"Placed on suspense file",7,0,0,0,7
1929344,1577493,2025-05-23,Senate,"Do pass",5,1,0,1,7
1929344,1586421,2025-06-02,Senate,"Senate 3rd Reading SB82 Umberg",28,10,0,2,40
1929344,1597207,2025-07-01,Assembly,"Do pass",8,3,0,1,12
1929344,1601404,2025-09-08,Assembly,"SB 82 Umberg Senate Third Reading By Connolly",55,18,0,7,80
1929345,1557478,2025-04-23,Senate,"Do pass, but first be re-referred to the Committee on [Appropriations]",11,0,0,0,11
1929345,1579288,2025-05-27,Senate,"Senate 3rd Reading SB83 Umberg",39,0,0,1,40
1929345,1597163,2025-07-01,Assembly,"Do pass as amended, and be re-referred to the Committee on [Appropriations] with recommendation: To Consent Calendar",15,0,0,1,16
1929345,1600766,2025-08-29,Assembly,"Do pass",15,0,0,0,15
1929345,1601994,2025-09-11,Senate,"Unfinished Business SB83 Umberg Concurrence",40,0,0,0,40
1929346,1556009,2025-04-22,Senate,"Do pass, but first be re-referred to the Committee on [Appropriations]",11,0,0,2,13
1929346,1565266,2025-05-05,Senate,"Placed on suspense file",7,0,0,0,7
1929346,1577156,2025-05-23,Senate,"Do pass as amended",6,0,0,1,7
1929346,1585028,2025-06-04,Senate,"Senate 3rd Reading SB84 Niello et al",34,2,0,4,40
1929347,1479233,2025-02-03,Senate,"Senate 3rd Reading SCR14 Caballero et al",33,0,0,6,39
1929347,1485617,2025-02-10,Assembly,"Be adopted. To Consent Calendar",9,0,0,2,11
1929348,1477882,2025-01-30,Senate,"Senate 3rd Reading SCR15 Umberg",36,0,0,3,39
1929348,1492765,2025-02-18,Assembly,"Be adopted. To Consent Calendar",10,0,0,1,11
1929348,1498297,2025-02-24,Assembly,"SCR 15 Umberg Consent Calendar Second Day",67,0,0,12,79
1930767,1473420,2025-01-22,Senate,"Do pass",10,0,0,0,10
1930775,1473424,2025-01-22,Senate,"Do pass",10,0,0,0,10
1930775,1474136,2025-01-23,Senate,"Senate 3rd Reading SB3 Wiener et al",36,0,0,3,39
1930775,1474137,2025-01-23,Assembly,"SB 3 Wiener Senate Third Reading By GABRIEL First Extraordinary Session",79,0,0,0,79
1930793,1474131,2025-01-23,Senate,"Assembly 2nd Reading AB4 Gabriel et al. By Wiener",36,0,0,3,39
1930793,1474132,2025-01-23,Assembly,"AB 4 Gabriel Assembly Third Reading Amend By GALLAGHER Set #1 Motion to Lay on the Table By AGUIAR-CURRY First Extraordinary Session",59,19,0,1,79
1930793,1474133,2025-01-23,Assembly,"AB 4 Gabriel Assembly Third Reading First Extraordinary Session",79,0,0,0,79
1933291,1540848,2025-04-07,Assembly,"Do pass and be re-referred to the Committee on [Privacy and Consumer Protection]",7,0,0,0,7
1933291,1564271,2025-05-01,Assembly,"Do pass as amended and be re-referred to the Committee on [Appropriations]",11,0,0,4,15
1933293,1525421,2025-03-24,Assembly,"Do pass and be re-referred to the Committee on [Appropriations] with recommendation: To Consent Calendar",16,0,0,0,16
1933293,1556147,2025-04-23,Assembly,"Do pass. To Consent Calendar",15,0,0,0,15
1933293,1564182,2025-05-01,Assembly,"AB 272 Aguiar-Curry Consent Calendar Second Day Regular Session",76,0,0,3,79
1933293,1592550,2025-06-18,Senate,"Do pass and be ordered to the Consent Calendar",6,0,0,2,8
1933293,1597852,2025-07-08,Senate,"Do pass, but first be re-referred to the Committee on [Appropriations] with the recommendation: To Consent Calendar",15,0,0,0,15
1933295,1525467,2025-03-24,Assembly,"Do pass as amended, and be re-referred to the Committee on [Appropriations] with recommendation: To Consent Calendar",13,0,0,1,14
1933297,1515283,2025-03-11,Assembly,"Do pass and be re-referred to the Committee on [Public Safety]",6,0,0,1,7
1933297,1535131,2025-04-01,Assembly,"Do pass and be re-referred to the Committee on [Appropriations] with recommendation: To Consent Calendar",9,0,0,0,9
1933300,1516559,2025-03-12,Assembly,"Do pass as amended and be re-referred to the Committee on [Appropriations]",8,0,0,1,9
1933300,1577567,2025-05-23,Assembly,"Do pass",14,0,0,1,15
1933300,1584252,2025-06-03,Assembly,"AB 279 Patel Assembly Third Reading",78,1,0,0,79
1933300,1598769,2025-07-16,Senate,"Do pass, but first be re-referred to the Committee on [Appropriations] with the recommendation: To Consent Calendar",7,0,0,0,7
1933300,1599514,2025-08-18,Senate,"Placed on suspense file",7,0,0,0,7
1933301,1533533,2025-04-01,Assembly,"Do pass and be re-referred to the Committee on [Appropriations]",11,0,0,4,15
1933301,1577469,2025-05-23,Assembly,"Do pass as amended",11,1,0,3,15
1933301,1583433,2025-06-02,Assembly,"AB 280 Aguiar-Curry Assembly Third Reading",61,7,0,11,79
1933301,1598020,2025-07-09,Senate,"Do pass as amended, but first amend, and re-refer to the Committee on [Appropriations]",8,0,0,3,11
1933301,1599639,2025-08-18,Senate,"Placed on suspense file",7,0,0,0,7
1933301,1600523,2025-08-29,Senate,"Do pass",5,0,0,2,7
1933302,1567895,2025-05-06,Senate,"Do pass and be ordered to the Consent Calendar",12,0,0,1,13
1933302,1572425,2025-05-15,Senate,"Consent Calendar 2nd SB85 Umberg",34,0,0,6,40
1933302,1594674,2025-06-24,Assembly,"Do pass as amended. To Consent Calendar",12,0,0,0,12
1933302,1596754,2025-06-30,Assembly,"SB 85 Umberg Consent Calendar Second Day",78,0,0,1,79
1933302,1600067,2025-08-25,Senate,"Special Consent SB85 Umberg",37,0,0,3,40
1933303,1528249,2025-03-26,Senate,"Do pass, but first be re-referred to the Committee on [Appropriations]",5,0,0,0,5
1933303,1538970,2025-04-07,Senate,"Placed on suspense file",7,0,0,0,7
1933303,1577407,2025-05-23,Senate,"Do pass as amended",6,0,0,1,7
1933303,1585092,2025-06-04,Senate,"Special Consent SB86 McNerney et al",39,0,0,1,40
1933303,1597718,2025-07-07,Assembly,"Do pass and be re-referred to the Committee on [Revenue and Taxation]",16,0,0,0,16
1933303,1598414,2025-07-14,Assembly,"Do pass as amended and be re-referred to the Committee on [Appropriations]",7,0,0,0,7
1933303,1600680,2025-08-29,Assembly,"Do pass as amended",11,0,0,4,15
1933303,1601408,2025-09-08,Assembly,"SB 86 McNerney Senate Third Reading By Wilson",76,0,0,4,80
1933303,1601667,2025-09-09,Senate,"Unfinished Business SB86 McNerney et al. Concurrence",40,0,0,0,40
1933304,1516585,2025-03-12,Senate,"Do pass, but first be re-referred to the Committee on [Appropriations] with the recommendation: To Consent Calendar",5,0,0,0,5
1933304,1538996,2025-04-07,Senate,"Placed on suspense file",7,0,0,0,7
1933304,1577870,2025-05-23,Senate,"Do pass",6,0,0,1,7
1933304,1581712,2025-05-29,Senate,"Special Consent SB87 Seyarto et al",38,0,0,2,40
1933304,1594662,2025-06-23,Assembly,"Do pass and be re-referred to the Committee on [Appropriations]",5,0,0,2,7
1933304,1597543,2025-07-02,Assembly,"Do pass",14,0,0,1,15
1933304,1600241,2025-08-28,Assembly,"SB 87 Seyarto Senate Third Reading By Alanis",75,0,0,4,79
1933304,1600898,2025-09-03,Senate,"Unfinished Business SB87 Seyarto et al. Concurrence",40,0,0,0,40
1936622,1516573,2025-03-12,Assembly,"Do pass and be re-referred to the Committee on [Appropriations]",4,3,0,2,9
1936622,1544973,2025-04-09,Assembly,"Do pass",5,3,0,1,9
1936623,1528284,2025-03-26,Assembly,"Do pass and be re-referred to the Committee on [Judiciary]",8,2,0,1,11
1936623,1540906,2025-04-08,Assembly,"Do pass as amended and be re-referred to the Committee on [Appropriations]",9,3,0,0,12
1936623,1556043,2025-04-23,Assembly,"Do pass",11,4,0,0,15
1936623,1568633,2025-05-08,Assembly,"AB 282 Pellerin Assembly Third Reading",53,13,0,13,79
1936623,1598691,2025-07-15,Senate,"Do pass as amended, but first amend, and re-refer to the Committee on [Appropriations]",11,1,0,1,13
1936624,1522022,2025-03-19,Assembly,"Do pass and be re-referred to the Committee on [Appropriations]",7,0,0,0,7
1936624,1577830,2025-05-23,Assembly,"Do pass",12,2,0,1,15
1936624,1582249,2025-05-29,Assembly,"AB 283 Haney Assembly Third Reading",64,4,0,11,79
1936624,1592551,2025-06-18,Senate,"Do pass, but first be re-referred to the Committee on [Judiciary]",4,1,0,0,5
1936624,1597448,2025-07-01,Senate,"Do pass, but first be re-referred to the Committee on [Appropriations]",12,1,0,0,13
1936624,1598221,2025-07-14,Senate,"Placed on suspense file",7,0,0,0,7
1936624,1600473,2025-08-29,Senate,"Do pass as amended",5,2,0,0,7
1936625,1563088,2025-04-29,Assembly,"Do pass as amended and be re-referred to the Committee on [Appropriations]",7,1,0,1,9
1936626,1505300,2025-03-04,Assembly,"Do pass and be re-referred to the Committee on [Appropriations] with recommendation: To Consent Calendar",9,0,0,0,9
1936627,1564156,2025-04-30,Assembly,"Do pass and be re-referred to the Committee on [Appropriations] with recommendation: To Consent Calendar",18,0,0,0,18
1936628,1528287,2025-03-26,Assembly,"Do pass",7,0,0,0,7
1936628,1538947,2025-04-07,Assembly,"AB 287 Lackey Assembly Third Reading",72,0,0,7,79
1936628,1597272,2025-07-01,Senate,"Do pass",5,0,0,0,5
1936628,1601612,2025-09-09,Senate,"Assembly 3rd Reading AB287 Lackey et al. By Umberg",40,0,0,0,40
1936629,1534982,2025-04-02,Assembly,"Do pass and be re-referred to the Committee on [Labor and Employment]",6,0,0,1,7
1936629,1557510,2025-04-23,Assembly,"Do pass and be re-referred to the Committee on [Appropriations]",7,0,0,0,7
1936629,1577409,2025-05-23,Assembly,"Do pass",12,0,0,3,15
1936629,1583524,2025-06-02,Assembly,"AB 288 McKinnor Assembly Third Reading",68,2,0,9,79
1936629,1592569,2025-06-18,Senate,"Do pass as amended, but first amend, and re-refer to the Committee on [Judiciary]",4,1,0,0,5
1936629,1597892,2025-07-08,Senate,"Do pass, but first be re-referred to the Committee on [Appropriations]",11,1,0,1,13
1936629,1599636,2025-08-18,Senate,"Placed on suspense file",7,0,0,0,7
1936629,1600749,2025-08-29,Senate,"Do pass as amended",5,2,0,0,7
1936629,1601492,2025-09-09,Senate,"Assembly 3rd Reading AB288 McKinnor et al. By Umberg",30,10,0,0,40
1936630,1538931,2025-04-07,Assembly,"Do pass and be re-referred to the Committee on [Privacy and Consumer Protection]",15,0,0,1,16
1936630,1564189,2025-05-01,Assembly,"Do pass as amended and be re-referred to the Committee on [Appropriations]",11,2,0,2,15
1936630,1577806,2025-05-23,Assembly,"Do pass",13,1,0,1,15
1936630,1584335,2025-06-03,Assembly,"AB 289 Haney Assembly Third Reading",71,3,0,5,79
1936630,1597924,2025-07-08,Senate,"Do pass, but first be re-referred to the Committee on [Judiciary]",13,2,0,0,15
1936630,1598706,2025-07-15,Senate,"Do pass",12,0,0,1,13
1936630,1600050,2025-08-25,Senate,"Placed on suspense file",6,0,0,1,7
1936630,1600624,2025-08-29,Senate,"Do pass as amended",6,1,0,0,7
1936630,1601596,2025-09-09,Senate,"Assembly 3rd Reading AB289 Haney et al. By Cortese",36,3,0,1,40
1936631,1563011,2025-04-30,Assembly,"Do pass as amended and be re-referred to the Committee on [Appropriations]",16,0,0,1,17
1936631,1571524,2025-05-14,Assembly,"Do pass",15,0,0,0,15
1936631,1573623,2025-05-19,Assembly,"AB 290 Bauer-Kahan Assembly Third Reading",75,0,0,4,79
1936631,1598041,2025-07-09,Senate,"Do pass, but first be re-referred to the Committee on [Appropriations] with the recommendation: To Consent Calendar",7,0,0,0,7
1936631,1601891,2025-09-11,Senate,"Assembly 3rd Reading AB290 Bauer-Kahan et al. By Allen",40,0,0,0,40
1936631,1602359,2025-09-12,Assembly,"AB 290 Bauer-Kahan Concurrence in Senate Amendments",80,0,0,0,80
1936632,1545022,2025-04-09,Assembly,"Do pass as amended and be re-referred to the Committee on [Labor and Employment]",9,0,0,0,9
1936632,1557561,2025-04-23,Assembly,"Do pass and be re-referred to the Committee on [Appropriations]",7,0,0,0,7
1936632,1577250,2025-05-23,Assembly,"Do pass",14,0,0,1,15
1936632,1584409,2025-06-03,Assembly,"AB 291 Gipson Assembly Third Reading",79,0,0,0,79
1936632,1597406,2025-07-02,Senate,"Do pass, but first be re-referred to the Committee on [Labor, Public Employment and Retirement ] with the recommendation: To Consent Calendar",7,0,0,0,7
1936632,1598071,2025-07-09,Senate,"Do pass, but first be re-referred to the Committee on [Appropriations] with the recommendation: To Consent Calendar",5,0,0,0,5
1936632,1599456,2025-08-18,Senate,"Placed on suspense file",7,0,0,0,7
1936634,1526971,2025-03-25,Assembly,"Do pass",11,2,0,0,13
1936634,1533530,2025-04-01,Assembly,"AB 293 Bennett Assembly Third Reading",62,5,0,13,80
1936634,1588065,2025-06-10,Senate,"Do pass",5,0,0,2,7
1936634,1600971,2025-09-03,Senate,"Assembly 3rd Reading AB293 Bennett By Hurtado",31,3,0,6,40
1936635,1474059,2025-01-23,Assembly,"Be adopted. To third reading",10,0,0,1,11
1936635,1490597,2025-02-14,Senate,"Special Consent ACR18 Sharp-Collins et al",34,0,0,5,39
1936636,1521959,2025-03-19,Senate,"Do pass as amended, but first amend, and re-refer to the Committee on [Natural Resources and Water]",8,0,0,0,8
1936636,1554474,2025-04-22,Senate,"Do pass, but first be re-referred to the Committee on [Appropriations]",6,0,0,1,7
1936636,1565353,2025-05-05,Senate,"Placed on suspense file",7,0,0,0,7
1936636,1577533,2025-05-23,Senate,"Do pass as amended",5,0,0,2,7
1936636,1586441,2025-06-02,Senate,"Senate 3rd Reading SB88 Caballero et al",37,0,0,3,40
1936636,1594064,2025-06-23,Assembly,"Do pass as amended and be re-referred to the Committee on [Appropriations]",13,0,0,1,14
1936636,1600418,2025-08-29,Assembly,"Do pass as amended",11,0,0,4,15
1936636,1601486,2025-09-09,Assembly,"SB 88 Caballero Senate Third Reading By Aguiar-Curry",72,0,0,8,80
1936636,1601965,2025-09-11,Senate,"Unfinished Business SB88 Caballero et al. Concurrence",40,0,0,0,40
1936638,1515255,2025-03-11,Senate,"Do pass as amended, but first amend, and re-refer to the Committee on [Natural Resources and Water]",13,0,0,2,15
1936638,1554529,2025-04-22,Senate,"Do pass, but first be re-referred to the Committee on [Appropriations] with the recommendation: To Consent Calendar",6,0,0,1,7
1936638,1565367,2025-05-05,Senate,"Placed on suspense file",7,0,0,0,7
1936639,1561165,2025-04-29,Senate,"Do pass and be ordered to the Consent Calendar",5,0,0,0,5
1936639,1565246,2025-05-05,Senate,"Consent Calendar 2nd SB91 Cervantes",38,0,0,2,40
1936640,1520438,2025-03-18,Senate,"Do pass, but first be re-referred to the Committee on [Local Government]",9,1,0,1,11
1936640,1562921,2025-04-30,Senate,"Do pass as amended, but first amend, and re-refer to the Committee on [Appropriations]",6,0,0,1,7
1936640,1580483,2025-05-28,Senate,"Senate 3rd Reading SB92 Blakespear et al",31,3,0,6,40
1936640,1597384,2025-07-02,Assembly,"Do pass as amended and be re-referred to the Committee on [Local Government]",12,0,0,0,12
1936640,1598904,2025-07-16,Assembly,"Do pass",10,0,0,0,10
1936640,1600955,2025-09-03,Assembly,"SB 92 Blakespear Senate Third Reading By Ward",75,0,0,4,79
1936640,1601974,2025-09-11,Senate,"Unfinished Business SB92 Blakespear et al. Concurrence",39,0,0,1,40
1936641,1533510,2025-04-01,Senate,"Do pass as amended, but first amend, and re-refer to the Committee on [Appropriations]",6,0,0,0,6
1936641,1552895,2025-04-21,Senate,"Placed on suspense file",6,0,0,1,7
1939170,1540815,2025-04-07,Assembly,"Do pass and be re-referred to the Committee on [Appropriations]",7,0,0,0,7
1939172,1536796,2025-04-02,Assembly,"Do pass and be re-referred to the Committee on [Education]",5,2,0,0,7
1939173,1505297,2025-03-04,Assembly,"Do pass and be re-referred to the Committee on [Appropriations]",2,4,0,3,9
1939175,1516584,2025-03-12,Assembly,"Do pass",11,0,0,1,12
1939175,1533543,2025-04-01,Assembly,"AB 299 Gabriel Third Reading Urgency",77,0,0,3,80
1939175,1598682,2025-07-15,Senate,"Do pass as amended",12,0,0,1,13
1939175,1602148,2025-09-12,Senate,"Assembly 3rd Reading AB299 Gabriel et al. By Pérez Urgency Clause",37,0,0,3,40
1939175,1602149,2025-09-13,Assembly,"AB 299 GABRIEL Concurrence in Senate Amendments",80,0,0,0,80
1939176,1525446,2025-03-24,Assembly,"Do pass as amended, and be re-referred to the Committee on [Emergency Management] with recommendation: To Consent Calendar",13,0,0,1,14
1939176,1561086,2025-04-28,Assembly,"Do pass as amended and be re-referred to the Committee on [Appropriations]",7,0,0,0,7
1939176,1562836,2025-04-28,Assembly,"Amendments (Committee's)",7,0,0,0,7
1939176,1571620,2025-05-14,Assembly,"Do pass",15,0,0,0,15
1939176,1577204,2025-05-23,Assembly,"AB 300 Lackey Assembly Third Reading",72,0,0,7,79
1939176,1594681,2025-06-24,Senate,"Do pass, but first be re-referred to the Committee on [Natural Resources and Water] with the recommendation: To Consent Calendar",15,0,0,0,15
1939176,1597874,2025-07-08,Senate,"Do pass, but first be re-referred to the Committee on [Appropriations] with the recommendation: To Consent Calendar",7,0,0,0,7
1939176,1599614,2025-08-18,Senate,"Placed on suspense file",7,0,0,0,7
1939177,1516576,2025-03-12,Assembly,"Do pass and be re-referred to the Committee on [Appropriations]",11,0,0,1,12
1939177,1521966,2025-03-19,Assembly,"Do pass",15,0,0,0,15
1939177,1533542,2025-04-01,Assembly,"AB 301 Schiavo Third Reading Urgency",76,0,0,4,80
1939177,1591904,2025-06-17,Senate,"Do pass as amended, but first amend, and re-refer to the Committee on [Appropriations]",8,0,0,3,11
1939177,1601995,2025-09-11,Senate,"Assembly 3rd Reading AB301 Schiavo et al. By Grayson Urgency Clause",40,0,0,0,40
1939177,1602070,2025-09-12,Assembly,"AB 301 Schiavo Concurrence in Senate Amendments",78,0,0,2,80
1939178,1556047,2025-04-22,Assembly,"Do pass and be re-referred to the Committee on [Judiciary]",12,2,0,2,16
1939178,1561205,2025-04-29,Assembly,"Do pass as amended and be re-referred to the Committee on [Appropriations]",9,3,0,0,12
1939178,1571544,2025-05-14,Assembly,"Do pass",11,4,0,0,15
1939178,1577252,2025-05-23,Assembly,"AB 302 Bauer-Kahan Assembly Third Reading",56,11,0,12,79
1939178,1598640,2025-07-15,Senate,"Do pass as amended, but first amend, and re-refer to the Committee on [Public Safety]",11,0,0,2,13
1939178,1599512,2025-08-18,Senate,"Placed on suspense file",7,0,0,0,7
1939180,1526979,2025-03-25,Assembly,"Do pass and be re-referred to the Committee on [Appropriations] with recommendation: To Consent Calendar",15,0,0,0,15
1939183,1516574,2025-03-12,Assembly,"Do pass and be re-referred to the Committee on [Appropriations]",12,0,0,0,12
1939183,1521974,2025-03-19,Assembly,"Do pass",14,0,0,1,15
1939183,1533473,2025-04-01,Assembly,"AB 306 Schultz Third Reading Urgency",71,0,0,9,80
1939185,1562828,2025-04-29,Assembly,"Do pass. To Consent Calendar",7,0,0,0,7
1939185,1568609,2025-05-08,Assembly,"AB 308 Ramos Consent Calendar Second Day Regular Session",69,0,0,10,79
1939186,1540875,2025-04-08,Assembly,"Do pass and be re-referred to the Committee on [Appropriations]",12,1,0,2,15
1939186,1555962,2025-04-23,Assembly,"Do pass",11,3,0,1,15
1939186,1572403,2025-05-15,Assembly,"AB 309 Zbur Assembly Third Reading",54,15,0,10,79
1939186,1592554,2025-06-18,Senate,"Do pass, but first be re-referred to the Committee on [Business, Professions and Economic Development]",8,1,0,2,11
1939186,1598205,2025-07-14,Senate,"Do pass, but first be re-referred to the Committee on [Appropriations]",8,3,0,0,11
1939186,1600943,2025-09-03,Senate,"Assembly 3rd Reading AB309 Zbur et al. By Padilla Final Vote",28,11,0,1,40
1939187,1520416,2025-03-18,Assembly,"Do pass",9,0,0,0,9
1939187,1530384,2025-03-28,Assembly,"AB 310 Alanis Assembly Third Reading",61,0,0,19,80
1939187,1597507,2025-07-02,Senate,"Do pass as amended",11,0,0,0,11
1939187,1600882,2025-09-03,Senate,"Assembly 3rd Reading AB310 Alanis et al. By Valladares",38,0,0,2,40
1939187,1601312,2025-09-08,Assembly,"AB 310 Alanis Concurrence in Senate Amendments",78,0,0,2,80
1939188,1505319,2025-03-04,Assembly,"Do pass",12,0,0,0,12
1939188,1533482,2025-04-01,Assembly,"AB 311 McKinnor Third Reading Urgency",77,0,0,3,80
1939189,1528317,2025-03-26,Assembly,"Do pass",7,0,0,1,8
1939189,1533472,2025-04-01,Assembly,"AB 312 Alanis Assembly Third Reading",75,0,0,5,80
1939190,1522016,2025-03-18,Assembly,"Do pass and be re-referred to the Committee on [Appropriations] with recommendation: To Consent Calendar",9,0,0,1,10
1939190,1555968,2025-04-23,Assembly,"Do pass. To Consent Calendar",15,0,0,0,15
1939190,1564251,2025-05-01,Assembly,"AB 313 Ortega Consent Calendar Second Day Regular Session",76,0,0,3,79
1939190,1589110,2025-06-11,Senate,"Do pass, but first be re-referred to the Committee on [Appropriations] with the recommendation: To Consent Calendar",6,0,0,1,7
1939190,1596020,2025-06-27,Senate,"Consent Calendar 2nd AB313 Ortega et al",38,0,0,2,40
1939190,1597582,2025-07-03,Assembly,"AB 313 Ortega Concurrence in Senate Amendments",74,0,0,5,79
1939191,1561135,2025-04-28,Assembly,"Do pass as amended and be re-referred to the Committee on [Appropriations]",12,4,0,0,16
1939192,1526985,2025-03-25,Assembly,"Do pass and be re-referred to the Committee on [Appropriations]",14,0,0,1,15
1939193,1485619,2025-02-10,Assembly,"Be adopted. To third reading",9,0,0,2,11
1939193,1517821,2025-03-13,Senate,"Special Consent ACR19 Macedo et al",36,0,0,4,40
1939194,1479230,2025-02-03,Assembly,"Be adopted. To third reading",11,0,0,0,11
1939194,1517822,2025-03-13,Senate,"Special Consent ACR20 Macedo et al",36,0,0,4,40
1939195,1479232,2025-02-03,Assembly,"Be adopted. To Consent Calendar",11,0,0,0,11
1939195,1483667,2025-02-06,Assembly,"HR 10 Bennett Consent Calendar Second Day Regular Session",72,0,0,7,79
1939196,1523472,2025-03-20,Senate,"Senate 3rd Reading SB100 B. & F.R. (Wiener)",28,10,0,2,40
1939197,1523459,2025-03-20,Senate,"Senate 3rd Reading SB101 B. & F.R. (Wiener)",28,10,0,2,40
1939197,1590715,2025-06-13,Senate,"Unfinished Business SB101 Wiener Concurrence",26,8,0,6,40
1939197,1590716,2025-06-13,Assembly,"SB 101 Wiener Senate Third Reading By GABRIEL Amend By SANCHEZ Set #1 Motion to Lay on the Table By AGUIAR-CURRY",52,19,0,8,79
1939197,1590717,2025-06-13,Assembly,"SB 101 Wiener Senate Third Reading By GABRIEL",57,19,0,3,79
1939198,1523599,2025-03-20,Senate,"Senate 3rd Reading SB102 B. & F.R. (Wiener)",28,10,0,2,40
1939199,1523661,2025-03-20,Senate,"Senate 3rd Reading SB103 B. & F.R. (Wiener)",28,10,0,2,40
1939199,1595984,2025-06-27,Senate,"Unfinished Business SB103 Wiener Concurrence",29,3,0,8,40
1939199,1595985,2025-06-27,Assembly,"SB 103 Wiener Senate Third Reading By GABRIEL",58,17,0,4,79
1939200,1523578,2025-03-20,Senate,"Senate 3rd Reading SB104 B. & F.R. (Wiener)",28,10,0,2,40
1939201,1523622,2025-03-20,Senate,"Senate 3rd Reading SB105 B. & F.R. (Wiener)",28,10,0,2,40
1939201,1602175,2025-09-12,Senate,"Unfinished Business SB105 Wiener Concurrence",29,0,0,11,40
1939202,1523573,2025-03-20,Senate,"Senate 3rd Reading SB106 B. & F.R. (Wiener)",28,10,0,2,40
1939203,1523470,2025-03-20,Senate,"Senate 3rd Reading SB107 B. & F.R. (Wiener)",28,10,0,2,40
1939204,1523581,2025-03-20,Senate,"Senate 3rd Reading SB108 B. & F.R. (Wiener)",28,10,0,2,40
1939205,1523645,2025-03-20,Senate,"Senate 3rd Reading SB109 B. & F.R. (Wiener)",28,10,0,2,40
1939206,1523449,2025-03-20,Senate,"Senate 3rd Reading SB110 B. & F.R. (Wiener)",28,10,0,2,40
1939207,1523538,2025-03-20,Senate,"Senate 3rd Reading SB111 B. & F.R. (Wiener)",28,10,0,2,40
1939208,1523555,2025-03-20,Senate,"Senate 3rd Reading SB112 B. & F.R. (Wiener)",28,10,0,2,40
1939209,1523631,2025-03-20,Senate,"Senate 3rd Reading SB113 B. & F.R. (Wiener)",28,10,0,2,40
1939210,1523699,2025-03-20,Senate,"Senate 3rd Reading SB114 B. & F.R. (Wiener)",28,10,0,2,40
1939211,1523511,2025-03-20,Senate,"Senate 3rd Reading SB115 B. & F.R. (Wiener)",28,10,0,2,40
1939212,1523692,2025-03-20,Senate,"Senate 3rd Reading SB116 B. & F.R. (Wiener)",28,10,0,2,40
1939213,1523523,2025-03-20,Senate,"Senate 3rd Reading SB117 B. & F.R. (Wiener)",28,10,0,2,40
1939214,1523589,2025-03-20,Senate,"Senate 3rd Reading SB118 B. & F.R. (Wiener)",28,10,0,2,40
1939215,1523585,2025-03-20,Senate,"Senate 3rd Reading SB119 B. & F.R. (Wiener)",28,10,0,2,40
1939215,1597751,2025-07-07,Assembly,"SB 119 Budget and Fiscal Review Senate Third Reading By GABRIEL",59,11,0,9,79
1939215,1598845,2025-07-17,Senate,"Unfinished Business SB119 B. & F.R. (Wiener) Concurrence",28,9,0,3,40
1939216,1523610,2025-03-20,Senate,"Senate 3rd Reading SB120 B. & F.R. (Wiener)",28,10,0,2,40
1939216,1595968,2025-06-27,Senate,"Unfinished Business SB120 B. & F.R. (Wiener) Concurrence",30,7,0,3,40
1939216,1595969,2025-06-27,Assembly,"SB 120 B. & F. R. Senate Third Reading By GABRIEL",69,1,0,9,79
1939217,1523554,2025-03-20,Senate,"Senate 3rd Reading SB121 B. & F.R. (Wiener)",28,10,0,2,40
1939219,1523604,2025-03-20,Senate,"Senate 3rd Reading SB122 B. & F.R. (Wiener)",28,10,0,2,40
1939220,1523708,2025-03-20,Senate,"Senate 3rd Reading SB123 B. & F.R. (Wiener)",28,10,0,2,40
1939221,1523450,2025-03-20,Senate,"Senate 3rd Reading SB124 B. & F.R. (Wiener)",28,10,0,2,40
1939221,1596002,2025-06-27,Senate,"Unfinished Business SB124 B. & F.R. (Wiener) Concurrence",30,2,0,8,40
1939221,1596003,2025-06-27,Assembly,"SB 124 B. & F. R. Senate Third Reading By GABRIEL",74,1,0,4,79
1939222,1523711,2025-03-20,Senate,"Senate 3rd Reading SB125 B. & F.R. (Wiener)",28,10,0,2,40
1939223,1523464,2025-03-20,Senate,"Senate 3rd Reading SB126 B. & F.R. (Wiener)",28,10,0,2,40
1939224,1523479,2025-03-20,Senate,"Senate 3rd Reading SB127 B. & F.R. (Wiener)",28,10,0,2,40
1939224,1596017,2025-06-27,Senate,"Unfinished Business SB127 B. & F.R. (Wiener) Concurrence",29,9,0,2,40
1939224,1596018,2025-06-27,Assembly,"SB 127 B. & F. R. Senate Third Reading By GABRIEL",58,19,0,2,79
1939225,1523582,2025-03-20,Senate,"Senate 3rd Reading SB128 B. & F.R. (Wiener)",28,10,0,2,40
1939225,1595960,2025-06-27,Senate,"Unfinished Business SB128 B. & F.R. (Wiener) Concurrence",31,7,0,2,40
1939225,1595961,2025-06-27,Assembly,"SB 128 B. & F. R. Senate Third Reading By GABRIEL",58,18,0,3,79
1939226,1523519,2025-03-20,Senate,"Senate 3rd Reading SB129 B. & F.R. (Wiener)",28,10,0,2,40
1939226,1596808,2025-06-30,Senate,"Unfinished Business SB129 B. & F.R. (Wiener) Concurrence",30,5,0,5,40
1939226,1596809,2025-06-30,Assembly,"SB 129 B. & F. R. Senate Third Reading By GABRIEL",69,5,0,5,79
1939227,1523437,2025-03-20,Senate,"Senate 3rd Reading SB130 B. & F.R. (Wiener)",28,10,0,2,40
1939228,1523615,2025-03-20,Senate,"Senate 3rd Reading SB131 B. & F.R. (Wiener)",28,10,0,2,40
1939228,1596745,2025-06-30,Senate,"Unfinished Business SB131 B. & F.R. (Wiener) Concurrence",33,1,0,6,40
1939228,1596746,2025-06-30,Assembly,"SB 131 B. & F. R. Senate Third Reading By GABRIEL Amend By GONZALEZ, J. Set #1 Motion to Lay on the Table By AGUIAR-CURRY",55,20,0,4,79
1939228,1596747,2025-06-30,Assembly,"SB 131 B. & F. R. Senate Third Reading By GABRIEL",55,3,0,21,79
1939229,1523640,2025-03-20,Senate,"Senate 3rd Reading SB132 B. & F.R. (Wiener)",28,10,0,2,40
1939229,1595972,2025-06-27,Senate,"Unfinished Business SB132 B. & F.R. (Wiener) Concurrence",31,3,0,6,40
1939229,1595973,2025-06-27,Assembly,"SB 132 B. & F. R. Senate Third Reading By GABRIEL",68,1,0,10,79
1939230,1523489,2025-03-20,Senate,"Senate 3rd Reading SB133 B. & F.R. (Wiener)",28,10,0,2,40
1939231,1523553,2025-03-20,Senate,"Senate 3rd Reading SB134 B. & F.R. (Wiener)",28,10,0,2,40
1939232,1523675,2025-03-20,Senate,"Senate 3rd Reading SB135 B. & F.R. (Wiener)",28,10,0,2,40
1939233,1523660,2025-03-20,Senate,"Senate 3rd Reading SB136 B. & F.R. (Wiener)",28,10,0,2,40
1939234,1523531,2025-03-20,Senate,"Senate 3rd Reading SB137 B. & F.R. (Wiener)",28,10,0,2,40
1939235,1523597,2025-03-20,Senate,"Senate 3rd Reading SB138 B. & F.R. (Wiener)",28,10,0,2,40
1939236,1523576,2025-03-20,Senate,"Senate 3rd Reading SB139 B. & F.R. (Wiener)",28,10,0,2,40
1939236,1596766,2025-06-30,Senate,"Unfinished Business SB139 B. & F.R. (Wiener) Concurrence",34,1,0,5,40
1939236,1596767,2025-06-30,Assembly,"SB 139 B. & F. R. Senate Third Reading By GABRIEL",76,1,0,2,79
1939237,1523534,2025-03-20,Senate,"Senate 3rd Reading SB140 B. & F.R. (Wiener)",28,10,0,2,40
1939237,1596774,2025-06-30,Senate,"Unfinished Business SB140 B. & F.R. (Wiener) Concurrence",38,0,0,2,40
1939237,1596775,2025-06-30,Assembly,"SB 140 B. & F. R. Senate Third Reading By GABRIEL",75,0,0,4,79
1939238,1523590,2025-03-20,Senate,"Senate 3rd Reading SB141 B. & F.R. (Wiener)",28,10,0,2,40
1939238,1596024,2025-06-27,Senate,"Unfinished Business SB141 B. & F.R. (Wiener) Concurrence",37,1,0,2,40
1939238,1596025,2025-06-27,Assembly,"SB 141 B. & F. R. Senate Third Reading By GABRIEL",74,1,0,4,79
1939239,1523446,2025-03-20,Senate,"Senate 3rd Reading SB142 B. & F.R. (Wiener)",28,10,0,2,40
1939239,1595963,2025-06-27,Senate,"Unfinished Business SB142 B. & F.R. (Wiener) Urgency Clause Concurrence",37,0,0,3,40
1939239,1595964,2025-06-27,Assembly,"SB 142 B. & F. R. Third Reading Urgency By GABRIEL",72,1,0,6,79
1939240,1523620,2025-03-20,Senate,"Senate 3rd Reading SB143 B. & F.R. (Wiener)",28,10,0,2,40
1939241,1523507,2025-03-20,Senate,"Senate 3rd Reading SB144 B. & F.R. (Wiener)",28,10,0,2,40
1939242,1523596,2025-03-20,Senate,"Senate 3rd Reading SB145 B. & F.R. (Wiener)",28,10,0,2,40
1939243,1523686,2025-03-20,Senate,"Senate 3rd Reading SB146 B. & F.R. (Wiener)",28,10,0,2,40
1939243,1602217,2025-09-12,Senate,"Unfinished Business SB146 B. & F.R. (Wiener) Concurrence",30,0,0,10,40
1939244,1523544,2025-03-20,Senate,"Senate 3rd Reading SB147 B. & F.R. (Wiener)",28,10,0,2,40
1939244,1602099,2025-09-12,Senate,"Unfinished Business SB147 B. & F.R. (Wiener) Concurrence",29,0,0,11,40
1939245,1523703,2025-03-20,Senate,"Senate 3rd Reading SB148 B. & F.R. (Wiener)",28,10,0,2,40
1939245,1602101,2025-09-12,Senate,"Unfinished Business SB148 B. & F.R. (Wiener) Concurrence",29,0,0,11,40
1939246,1523560,2025-03-20,Senate,"Senate 3rd Reading SB149 B. & F.R. (Wiener)",28,10,0,2,40
1939247,1523687,2025-03-20,Senate,"Senate 3rd Reading SB150 B. & F.R. (Wiener)",28,10,0,2,40
1939248,1523527,2025-03-20,Senate,"Senate 3rd Reading SB151 B. & F.R. (Wiener)",28,10,0,2,40
1939248,1602276,2025-09-12,Senate,"Unfinished Business SB151 B. & F.R. (Wiener) Concurrence",29,0,0,11,40
1939249,1523547,2025-03-20,Senate,"Senate 3rd Reading SB152 B. & F.R. (Wiener)",28,10,0,2,40
1939250,1523613,2025-03-20,Senate,"Senate 3rd Reading SB153 B. & F.R. (Wiener)",28,10,0,2,40
1939250,1602074,2025-09-12,Senate,"Unfinished Business SB153 B. & F.R. (Wiener) Concurrence",29,0,0,11,40
1939252,1523637,2025-03-20,Senate,"Senate 3rd Reading SB154 B. & F.R. (Wiener)",28,10,0,2,40
1939253,1523714,2025-03-20,Senate,"Senate 3rd Reading SB155 B. & F.R. (Wiener)",28,10,0,2,40
1939253,1602253,2025-09-12,Senate,"Unfinished Business SB155 B. & F.R. (Wiener) Concurrence",29,7,0,4,40
1939254,1523557,2025-03-20,Senate,"Senate 3rd Reading SB156 B. & F.R. (Wiener)",28,10,0,2,40
1939254,1602081,2025-09-12,Senate,"Unfinished Business SB156 B. & F.R. (Wiener) Concurrence",29,0,0,11,40
1939255,1523509,2025-03-20,Senate,"Senate 3rd Reading SB157 B. & F.R. (Wiener)",28,10,0,2,40
1939255,1602152,2025-09-12,Senate,"Unfinished Business SB157 B. & F.R. (Wiener) Concurrence",29,0,0,11,40
1939256,1523677,2025-03-20,Senate,"Senate 3rd Reading SB158 B. & F.R. (Wiener)",28,10,0,2,40
1939256,1602201,2025-09-12,Senate,"W/O REF. TO FILE SB158 B. & F.R. (Wiener)",21,13,0,6,40
1939256,1602202,2025-09-13,Assembly,"SB 158 Budget and Fiscal Review Senate Third Reading By GABRIEL",54,18,0,8,80
1939257,1523568,2025-03-20,Senate,"Senate 3rd Reading SB159 B. & F.R. (Wiener)",28,10,0,2,40
1939257,1602124,2025-09-12,Senate,"Unfinished Business SB159 B. & F.R. (Wiener) Concurrence",31,0,0,9,40
1939258,1523564,2025-03-20,Senate,"Senate 3rd Reading SB160 B. & F.R. (Wiener)",28,10,0,2,40
1939258,1602062,2025-09-12,Senate,"Unfinished Business SB160 B. & F.R. (Wiener) Concurrence",31,0,0,9,40
1939259,1523673,2025-03-20,Senate,"Senate 3rd Reading SB161 B. & F.R. (Wiener)",28,10,0,2,40
1939259,1602117,2025-09-12,Senate,"Unfinished Business SB161 B. & F.R. (Wiener) Concurrence",29,0,0,11,40
1939260,1523654,2025-03-20,Senate,"Senate 3rd Reading SB162 B. & F.R. (Wiener)",28,10,0,2,40
1939260,1602226,2025-09-12,Senate,"Unfinished Business SB162 B. & F.R. (Wiener) Concurrence",29,0,0,11,40
1939261,1523545,2025-03-20,Senate,"Senate 3rd Reading SB163 B. & F.R. (Wiener)",28,10,0,2,40
1939262,1523636,2025-03-20,Senate,"Senate 3rd Reading SB164 B. & F.R. (Wiener)",28,10,0,2,40
1939263,1523462,2025-03-20,Senate,"Senate 3rd Reading SB165 B. & F.R. (Wiener)",28,10,0,2,40
1939264,1523619,2025-03-20,Senate,"Senate 3rd Reading SB166 B. & F.R. (Wiener)",28,10,0,2,40
1939265,1523482,2025-03-20,Senate,"Senate 3rd Reading SB167 B. & F.R. (Wiener)",28,10,0,2,40
1939266,1523632,2025-03-20,Senate,"Senate 3rd Reading SB168 B. & F.R. (Wiener)",28,10,0,2,40
1939267,1523586,2025-03-20,Senate,"Senate 3rd Reading SB169 B. & F.R. (Wiener)",28,10,0,2,40
1939268,1523448,2025-03-20,Senate,"Senate 3rd Reading SB170 B. & F.R. (Wiener)",28,10,0,2,40
1939269,1523665,2025-03-20,Senate,"Senate 3rd Reading SB171 B. & F.R. (Wiener)",28,10,0,2,40
1939270,1523657,2025-03-20,Senate,"Senate 3rd Reading SB172 B. & F.R. (Wiener)",28,10,0,2,40
1939271,1523501,2025-03-20,Senate,"Senate 3rd Reading SB173 B. & F.R. (Wiener)",28,10,0,2,40
1939272,1523571,2025-03-20,Senate,"Senate 3rd Reading SB174 B. & F.R. (Wiener)",28,10,0,2,40
1939273,1523546,2025-03-20,Senate,"Senate 3rd Reading SB175 B. & F.R. (Wiener)",28,10,0,2,40
1939274,1523684,2025-03-20,Senate,"Senate 3rd Reading SB176 B. & F.R. (Wiener)",28,10,0,2,40
1939275,1523500,2025-03-20,Senate,"Senate 3rd Reading SB177 B. & F.R. (Wiener)",28,10,0,2,40
1939276,1523611,2025-03-20,Senate,"Senate 3rd Reading SB178 B. & F.R. (Wiener)",28,10,0,2,40
1939277,1523537,2025-03-20,Senate,"Senate 3rd Reading SB179 B. & F.R. (Wiener)",28,10,0,2,40
1939278,1523496,2025-03-20,Senate,"Senate 3rd Reading SB180 B. & F.R. (Wiener)",28,10,0,2,40
1939279,1523570,2025-03-20,Senate,"Senate 3rd Reading SB181 B. & F.R. (Wiener)",28,10,0,2,40
1939280,1523693,2025-03-20,Senate,"Senate 3rd Reading SB182 B. & F.R. (Wiener)",28,10,0,2,40
1939281,1523510,2025-03-20,Senate,"Senate 3rd Reading SB183 B. & F.R. (Wiener)",28,10,0,2,40
1939282,1523602,2025-03-20,Senate,"Senate 3rd Reading SB184 B. & F.R. (Wiener)",28,10,0,2,40
1939283,1523651,2025-03-20,Senate,"Senate 3rd Reading SB185 B. & F.R. (Wiener)",28,10,0,2,40
1939284,1523649,2025-03-20,Senate,"Senate 3rd Reading SB186 B. & F.R. (Wiener)",28,10,0,2,40
1939285,1523484,2025-03-20,Senate,"Senate 3rd Reading SB187 B. & F.R. (Wiener)",28,10,0,2,40
1939286,1523492,2025-03-20,Senate,"Senate 3rd Reading SB188 B. & F.R. (Wiener)",28,10,0,2,40
1939287,1523606,2025-03-20,Senate,"Senate 3rd Reading SB189 B. & F.R. (Wiener)",28,10,0,2,40
1939288,1523460,2025-03-20,Senate,"Senate 3rd Reading SB190 B. & F.R. (Wiener)",28,10,0,2,40
1939289,1523594,2025-03-20,Senate,"Senate 3rd Reading SB191 B. & F.R. (Wiener)",28,10,0,2,40
1939291,1523549,2025-03-20,Senate,"Senate 3rd Reading SB192 B. & F.R. (Wiener)",28,10,0,2,40
1939292,1523566,2025-03-20,Senate,"Senate 3rd Reading SB193 B. & F.R. (Wiener)",28,10,0,2,40
1939293,1523441,2025-03-20,Senate,"Senate 3rd Reading SB194 B. & F.R. (Wiener)",28,10,0,2,40
1939294,1523516,2025-03-20,Senate,"Senate 3rd Reading SB195 B. & F.R. (Wiener)",28,10,0,2,40
1939295,1523529,2025-03-20,Senate,"Senate 3rd Reading SB196 B. & F.R. (Wiener)",28,10,0,2,40
1939296,1523567,2025-03-20,Senate,"Senate 3rd Reading SB197 B. & F.R. (Wiener)",28,10,0,2,40
1939297,1523670,2025-03-20,Senate,"Senate 3rd Reading SB198 B. & F.R. (Wiener)",28,10,0,2,40
1939298,1523591,2025-03-20,Senate,"Senate 3rd Reading SB199 B. & F.R. (Wiener)",28,10,0,2,40
1939299,1523524,2025-03-20,Senate,"Senate 3rd Reading SB200 B. & F.R. (Wiener)",28,10,0,2,40
1939300,1523466,2025-03-20,Senate,"Senate 3rd Reading SB201 B. & F.R. (Wiener)",28,10,0,2,40
1939301,1523518,2025-03-20,Senate,"Senate 3rd Reading SB202 B. & F.R. (Wiener)",28,10,0,2,40
1939302,1523662,2025-03-20,Senate,"Senate 3rd Reading SB203 B. & F.R. (Wiener)",28,10,0,2,40
1939303,1523562,2025-03-20,Senate,"Senate 3rd Reading SB204 B. & F.R. (Wiener)",28,10,0,2,40
1939304,1523626,2025-03-20,Senate,"Senate 3rd Reading SB205 B. & F.R. (Wiener)",28,10,0,2,40
1939305,1523575,2025-03-20,Senate,"Senate 3rd Reading SB206 B. & F.R. (Wiener)",28,10,0,2,40
1939306,1523494,2025-03-20,Senate,"Senate 3rd Reading SB207 B. & F.R. (Wiener)",28,10,0,2,40
1939307,1523515,2025-03-20,Senate,"Senate 3rd Reading SB208 B. & F.R. (Wiener)",28,10,0,2,40
1939308,1523550,2025-03-20,Senate,"Senate 3rd Reading SB209 B. & F.R. (Wiener)",28,10,0,2,40
1939309,1523704,2025-03-20,Senate,"Senate 3rd Reading SB210 B. & F.R. (Wiener)",28,10,0,2,40
1939310,1523490,2025-03-20,Senate,"Senate 3rd Reading SB211 B. & F.R. (Wiener)",28,10,0,2,40
1939311,1523443,2025-03-20,Senate,"Senate 3rd Reading SB212 B. & F.R. (Wiener)",28,10,0,2,40
1939312,1523468,2025-03-20,Senate,"Senate 3rd Reading SB213 B. & F.R. (Wiener)",28,10,0,2,40
1939313,1523705,2025-03-20,Senate,"Senate 3rd Reading SB214 B. & F.R. (Wiener)",28,10,0,2,40
1939314,1523701,2025-03-20,Senate,"Senate 3rd Reading SB215 B. & F.R. (Wiener)",28,10,0,2,40
1939315,1523530,2025-03-20,Senate,"Senate 3rd Reading SB216 B. & F.R. (Wiener)",28,10,0,2,40
1939316,1523457,2025-03-20,Senate,"Senate 3rd Reading SB217 B. & F.R. (Wiener)",28,10,0,2,40
1939317,1523713,2025-03-20,Senate,"Senate 3rd Reading SB218 B. & F.R. (Wiener)",28,10,0,2,40
1939318,1523521,2025-03-20,Senate,"Senate 3rd Reading SB219 B. & F.R. (Wiener)",28,10,0,2,40
1939320,1533471,2025-04-01,Senate,"Do pass, but first be re-referred to the Committee on [Appropriations]",6,0,0,0,6
1939320,1552957,2025-04-21,Senate,"Placed on suspense file",6,0,0,1,7
1939320,1577572,2025-05-23,Senate,"Do pass",6,0,0,1,7
1939320,1586390,2025-06-02,Senate,"Senate 3rd Reading SB221 Ochoa Bogh et al",36,0,0,4,40
1939320,1598751,2025-07-15,Assembly,"Do pass as amended and be re-referred to the Committee on [Appropriations]",8,0,0,1,9
1939320,1600352,2025-08-29,Assembly,"Do pass",15,0,0,0,15
1939320,1600981,2025-09-03,Assembly,"SB 221 Ochoa Bogh Senate Third Reading",73,0,0,6,79
1939320,1601240,2025-09-08,Senate,"Unfinished Business SB221 Ochoa Bogh et al. Concurrence",39,0,0,1,40
1939321,1555957,2025-04-23,Senate,"Do pass, but first be re-referred to the Committee on [Environmental Quality]",1,4,0,0,5
1939321,1555958,2025-04-23,Senate,"[First] hearing set for [04-23-2025]: Failed passage in Committee. Reconsideration granted",5,0,0,0,5
1939322,1538912,2025-04-07,Senate,"Do pass, but first be re-referred to the Committee on [Judiciary]",10,0,0,1,11
1939322,1555975,2025-04-22,Senate,"Do pass, but first be re-referred to the Committee on [Appropriations]",13,0,0,0,13
1939322,1565326,2025-05-05,Senate,"Placed on suspense file",7,0,0,0,7
1939324,1535050,2025-04-02,Senate,"Do pass, but first be re-referred to the Committee on [Judiciary] with the recommendation: To Consent Calendar",7,0,0,0,7
1939324,1542920,2025-04-08,Senate,"Do pass as amended, but first amend, and re-refer to the Committee on [Appropriations] with the recommendation: To Consent Calendar",13,0,0,0,13
1939324,1584426,2025-06-03,Senate,"Senate 3rd Reading SB97 Grayson",38,0,0,2,40
1939324,1597758,2025-07-07,Assembly,"Do pass and be re-referred to the Committee on [Privacy and Consumer Protection]",9,0,0,0,9
1939324,1597960,2025-07-08,Assembly,"Do pass and be re-referred to the Committee on [Appropriations]",13,0,0,2,15
1939324,1599762,2025-08-20,Assembly,"Do pass",15,0,0,0,15
1939325,1521976,2025-03-19,Senate,"Do pass as amended, but first amend, and re-refer to the Committee on [Judiciary]",6,0,0,1,7
1939325,1542927,2025-04-08,Senate,"Do pass, but first be re-referred to the Committee on [Appropriations]",11,1,0,1,13
1939325,1559487,2025-04-28,Senate,"Placed on suspense file",7,0,0,0,7
1939325,1577387,2025-05-23,Senate,"Do pass",5,1,0,1,7
1939325,1586398,2025-06-02,Senate,"Senate 3rd Reading SB98 Pérez et al. Urgency Clause",29,8,0,3,40
1939325,1597399,2025-07-02,Assembly,"Do pass and be re-referred to the Committee on [Higher Education]",7,2,0,0,9
1939325,1597930,2025-07-08,Assembly,"Do pass and be re-referred to the Committee on [Appropriations]",7,2,0,1,10
1939325,1599764,2025-08-20,Assembly,"Do pass as amended",11,3,0,1,15
1939325,1600845,2025-09-02,Senate,"Unfinished Business SB98 Pérez et al. Urgency Clause Concurrence",31,8,0,1,40
1939325,1600846,2025-09-02,Assembly,"SB 98 Pérez Third Reading Urgency By Muratsuchi",59,10,0,10,79
1939326,1552950,2025-04-21,Senate,"Do pass as amended, but first amend, and re-refer to the Committee on [Military and Veterans Affairs]",5,0,0,0,5
1939326,1559503,2025-04-28,Senate,"Do pass, but first be re-referred to the Committee on [Appropriations]",4,0,0,1,5
1939326,1569770,2025-05-12,Senate,"Placed on suspense file",7,0,0,0,7
1941749,1526992,2025-03-25,Assembly,"Do pass and be re-referred to the Committee on [Privacy and Consumer Protection]",12,0,0,0,12
1941749,1566702,2025-05-06,Assembly,"Do pass",11,2,0,2,15
1941749,1573525,2025-05-19,Assembly,"AB 316 Krell Assembly Third Reading",70,1,0,8,79
1941749,1595153,2025-06-24,Senate,"Do pass, but first be re-referred to the Committee on [Appropriations]",12,0,0,1,13
1941749,1597705,2025-07-07,Senate,"Placed on suspense file",6,0,0,1,7
1941749,1600511,2025-08-29,Senate,"Do pass",7,0,0,0,7
1941749,1601246,2025-09-08,Senate,"Assembly 3rd Reading AB316 Krell By Umberg",38,0,0,2,40
1941749,1601545,2025-09-09,Assembly,"AB 316 Krell Concurrence in Senate Amendments",78,0,0,2,80
1941750,1538941,2025-04-07,Assembly,"Do pass and be re-referred to the Committee on [Revenue and Taxation]",14,0,0,0,14
1941750,1571531,2025-05-14,Assembly,"Do pass",15,0,0,0,15
1941750,1579283,2025-05-27,Assembly,"AB 317 Jackson Assembly Third Reading",73,0,0,6,79
1941752,1515254,2025-03-11,Assembly,"Do pass as amended and be re-referred to the Committee on [Appropriations]",6,0,0,1,7
1941753,1515293,2025-03-11,Assembly,"Do pass and be re-referred to the Committee on [Appropriations] with recommendation: To Consent Calendar",6,0,0,1,7
1941753,1562928,2025-04-30,Assembly,"Do pass. To Consent Calendar",14,0,0,1,15
1941753,1568664,2025-05-08,Assembly,"AB 320 Bennett Consent Calendar Second Day Regular Session",69,0,0,10,79
1941753,1591147,2025-06-16,Senate,"Do pass as amended, but first amend, and re-refer to the Committee on [Education]",5,0,0,0,5
1941753,1597475,2025-07-02,Senate,"Do pass, but first be re-referred to the Committee on [Appropriations] with the recommendation: To Consent Calendar",7,0,0,0,7
1941753,1598295,2025-07-14,Senate,"Placed on suspense file",7,0,0,0,7
1941753,1600465,2025-08-29,Senate,"Do pass",7,0,0,0,7
1941753,1601255,2025-09-08,Senate,"Assembly 3rd Reading AB320 Bennett By Arreguín",38,0,0,2,40
1941753,1601599,2025-09-09,Assembly,"AB 320 Bennett Concurrence in Senate Amendments",80,0,0,0,80
1941754,1505322,2025-03-04,Assembly,"Do pass. To Consent Calendar",9,0,0,0,9
1941754,1517623,2025-03-13,Assembly,"AB 321 Schultz Assembly Third Reading",52,6,0,22,80
1941754,1588074,2025-06-10,Senate,"Do pass",5,1,0,0,6
1941754,1601084,2025-09-04,Senate,"Assembly 3rd Reading AB321 Schultz et al. By Wiener",23,13,0,4,40
1941754,1601313,2025-09-08,Assembly,"AB 321 Schultz Concurrence in Senate Amendments",55,12,0,13,80
1941755,1516565,2025-03-12,Assembly,"Do pass and be re-referred to the Committee on [Appropriations] with recommendation: To Consent Calendar",8,0,0,1,9
1941755,1542825,2025-04-09,Assembly,"Do pass",10,0,0,5,15
1941755,1552878,2025-04-21,Assembly,"AB 322 Ward Assembly Third Reading",62,0,0,17,79
1941755,1589107,2025-06-11,Senate,"Do pass, but first be re-referred to the Committee on [Appropriations]",4,0,0,3,7
1941755,1598658,2025-07-15,Senate,"Do pass, but first be re-referred to the Committee on [Appropriations]",11,2,0,0,13
1941755,1599467,2025-08-18,Senate,"Placed on suspense file",7,0,0,0,7
1941756,1521968,2025-03-18,Assembly,"Do pass and be re-referred to the Committee on [Appropriations]",7,0,0,3,10
1941756,1577318,2025-05-23,Assembly,"Do pass",14,0,0,1,15
1941756,1582230,2025-05-29,Assembly,"AB 323 Fong Assembly Third Reading",70,0,0,9,79
1941756,1595209,2025-06-25,Senate,"Do pass, but first be re-referred to the Committee on [Appropriations] with the recommendation: To Consent Calendar",7,0,0,0,7
1941756,1597662,2025-07-07,Senate,"Placed on suspense file",6,0,0,1,7
1941756,1600509,2025-08-29,Senate,"Do pass",7,0,0,0,7
1941756,1601108,2025-09-04,Senate,"Special Consent AB323 Fong et al",39,0,0,1,40
1941757,1562940,2025-04-30,Assembly,"Be adopted and re-referred to the Committee on [Human Services]",8,2,0,2,12
1941757,1564235,2025-05-01,Assembly,"Be adopted as amended, and re-refer to the Committee on [Appropriations]",5,2,0,0,7
1941758,1561094,2025-04-28,Assembly,"Be adopted. To Consent Calendar",16,0,0,0,16
1941758,1564220,2025-05-01,Assembly,"ACR 21 Flora Consent Calendar Second Day Regular Session",76,0,0,3,79
1941758,1588107,2025-06-10,Senate,"Be adopted, but first be re-referred to the Committee on [Appropriations] with recommendation: To Consent Calendar",13,0,0,2,15
1941758,1596016,2025-06-27,Senate,"Consent Calendar 2nd ACR21 Flora",38,0,0,2,40
1941758,1600918,2025-09-03,Assembly,"ACR 21 Flora Concurrence in Senate Amendments",78,0,0,1,79
1941759,1479228,2025-02-03,Assembly,"Be adopted. To Consent Calendar",11,0,0,0,11
1941759,1483669,2025-02-06,Assembly,"ACR 22 Muratsuchi Consent Calendar Second Day",72,0,0,7,79
1941759,1517823,2025-03-13,Senate,"Special Consent ACR22 Muratsuchi et al",36,0,0,4,40
1943407,1540940,2025-04-08,Assembly,"Do pass as amended and be re-referred to the Committee on [Privacy and Consumer Protection]",9,3,0,0,12
1943407,1564230,2025-05-01,Assembly,"Do pass and be re-referred to the Committee on [Appropriations]",10,2,0,3,15
1943407,1577926,2025-05-23,Assembly,"Do pass",11,3,0,1,15
1943407,1583511,2025-06-02,Assembly,"AB 325 Aguiar-Curry Assembly Third Reading",54,17,0,8,79
1943407,1597544,2025-07-01,Senate,"Do pass, but first be re-referred to the Committee on [Appropriations]",11,2,0,0,13
1943407,1598268,2025-07-14,Senate,"Placed on suspense file",7,0,0,0,7
1943407,1600777,2025-08-29,Senate,"Do pass as amended",5,2,0,0,7
1943407,1601916,2025-09-11,Senate,"Assembly 3rd Reading AB325 Aguiar-Curry et al. By Umberg",29,9,0,2,40
1943407,1602313,2025-09-12,Assembly,"AB 325 Aguiar-Curry Concurrence in Senate Amendments",54,18,0,8,80
1943408,1522000,2025-03-18,Assembly,"Do pass and be re-referred to the Committee on [Appropriations]",7,2,0,1,10
1943409,1505309,2025-03-04,Assembly,"Do pass as amended and be re-referred to the Committee on [Appropriations]",8,0,0,1,9
1943409,1577292,2025-05-23,Assembly,"Do pass",14,0,0,1,15
1943409,1584353,2025-06-03,Assembly,"AB 327 Ta Assembly Third Reading",71,0,0,8,79
1943409,1598396,2025-07-15,Senate,"Do pass as amended, but first amend, and re-refer to the Committee on [Appropriations]",6,0,0,0,6
1943409,1599497,2025-08-18,Senate,"Placed on suspense file",7,0,0,0,7
1943411,1545041,2025-04-09,Assembly,"Do pass and be re-referred to the Committee on [Judiciary]",2,7,0,0,9
1943412,1561111,2025-04-28,Assembly,"Do pass and be re-referred to the Committee on [Appropriations]",5,0,0,2,7
1943412,1577289,2025-05-23,Assembly,"Do pass",11,0,0,4,15
1943412,1583578,2025-06-02,Assembly,"AB 330 Rogers Assembly Third Reading",63,2,0,14,79
1943412,1595134,2025-06-25,Senate,"Do pass, but first be re-referred to the Committee on [Appropriations]",4,0,0,1,5
1943412,1601267,2025-09-08,Senate,"Assembly 3rd Reading AB330 Rogers By McNerney",36,0,0,4,40
1943413,1528320,2025-03-26,Assembly,"Do pass and be re-referred to the Committee on [Public Safety]",7,0,0,0,7
1943413,1554603,2025-04-22,Assembly,"Do pass and be re-referred to the Committee on [Appropriations]",9,0,0,0,9
1943413,1577298,2025-05-23,Assembly,"Do pass",12,0,0,3,15
1943413,1583483,2025-06-02,Assembly,"AB 331 Pellerin Assembly Third Reading",71,1,0,7,79
1943413,1597128,2025-07-01,Senate,"Do pass, but first be re-referred to the Committee on [Public Safety]",5,0,0,0,5
1943413,1598462,2025-07-15,Senate,"Do pass, but first be re-referred to the Committee on [Appropriations]",5,0,0,1,6
1943413,1599380,2025-08-18,Senate,"Placed on suspense file",7,0,0,0,7
1943414,1542889,2025-04-08,Senate,"Do pass, but first be re-referred to the Committee on [Insurance]",5,2,0,6,13
1943414,1542890,2025-04-08,Senate,"[First] hearing set for [04-09-2025]: Failed passage in Committee. Reconsideration granted",10,0,0,3,13
1943415,1535049,2025-04-02,Senate,"Do pass, but first be re-referred to the Committee on [Rules] with the recommendation: To Consent Calendar",11,0,0,0,11
1943415,1554628,2025-04-22,Senate,"Do pass as amended, but first amend, and re-refer to the Committee on [Appropriations] with the recommendation: To Consent Calendar",6,0,0,1,7
1943415,1565298,2025-05-05,Senate,"Placed on suspense file",7,0,0,0,7
1943416,1526990,2025-03-25,Senate,"Do pass as amended, but first amend, and re-refer to the Committee on [Appropriations]",7,0,0,0,7
1943416,1538943,2025-04-07,Senate,"Placed on suspense file",7,0,0,0,7
1943416,1577961,2025-05-23,Senate,"Do pass as amended",4,0,0,3,7
1943416,1585045,2025-06-04,Senate,"Senate 3rd Reading SB224 Hurtado",38,0,0,2,40
1943416,1598424,2025-07-15,Assembly,"Do pass as amended and be re-referred to the Committee on [Appropriations]",13,0,0,0,13
1943416,1600301,2025-08-29,Assembly,"Do pass as amended",15,0,0,0,15
1943416,1601595,2025-09-09,Assembly,"SB 224 Hurtado Senate Third Reading By Papan",77,1,0,2,80
1943416,1601852,2025-09-11,Senate,"Unfinished Business SB224 Hurtado Concurrence",40,0,0,0,40
1943417,1535058,2025-04-02,Senate,"Do pass, but first be re-referred to the Committee on [Appropriations]",6,0,0,1,7
1943417,1552857,2025-04-21,Senate,"Placed on suspense file",6,0,0,1,7
1943418,1492763,2025-02-18,Senate,"Senate 3rd Reading SCR16 Alvarado-Gil",36,0,0,3,39
1943418,1498300,2025-02-24,Assembly,"Be adopted. To Consent Calendar",11,0,0,0,11
1943418,1501961,2025-02-27,Assembly,"SCR 16 Alvarado-Gil Consent Calendar Second Day",66,0,0,13,79
1945196,1525454,2025-03-24,Assembly,"Do pass and be re-referred to the Committee on [Privacy and Consumer Protection] with recommendation: To Consent Calendar",16,0,0,0,16
1945196,1566710,2025-05-06,Assembly,"Do pass as amended. To Consent Calendar",14,0,0,1,15
1945196,1573542,2025-05-19,Assembly,"AB 334 Petrie-Norris Consent Calendar Second Day",74,0,0,5,79
1945196,1594577,2025-06-24,Senate,"Do pass, but first be re-referred to the Committee on [Judiciary]",13,0,0,2,15
1945196,1598548,2025-07-15,Senate,"Do pass as amended",13,0,0,0,13
1945197,1521981,2025-03-18,Assembly,"Do pass as amended and be re-referred to the Committee on [Appropriations]",8,2,0,0,10
1945198,1505323,2025-03-04,Assembly,"Do pass and be re-referred to the Committee on [Appropriations]",2,3,0,4,9
1945199,1525438,2025-03-24,Assembly,"Do pass and be re-referred to the Committee on [Appropriations]",13,0,0,1,14
1945200,1557493,2025-04-23,Assembly,"Do pass and be re-referred to the Committee on [Appropriations]",6,0,0,1,7
1945200,1577502,2025-05-23,Assembly,"Do pass as amended",11,0,0,4,15
1945200,1584385,2025-06-03,Assembly,"AB 338 Solache Third Reading Urgency",76,0,0,3,79
1945200,1595196,2025-06-25,Senate,"Do pass, but first be re-referred to the Committee on [Appropriations]",5,0,0,0,5
1945200,1597664,2025-07-07,Senate,"Placed on suspense file",6,0,0,1,7
1945200,1600368,2025-08-29,Senate,"Do pass as amended",7,0,0,0,7
1945200,1601717,2025-09-10,Senate,"Assembly 3rd Reading AB338 Solache By Pérez Urgency Clause",38,1,0,1,40
1945201,1521954,2025-03-19,Assembly,"Do pass and be re-referred to the Committee on [Appropriations]",4,0,0,3,7
1945201,1577702,2025-05-23,Assembly,"Do pass as amended",11,2,0,2,15
1945201,1583363,2025-06-02,Assembly,"AB 339 Ortega Assembly Third Reading",51,11,0,17,79
1945201,1598111,2025-07-09,Senate,"Do pass as amended, but first amend, and re-refer to the Committee on [Appropriations]",4,1,0,0,5
1945201,1599647,2025-08-18,Senate,"Placed on suspense file",7,0,0,0,7
1945201,1600324,2025-08-29,Senate,"Do pass as amended",5,2,0,0,7
1945201,1601182,2025-09-04,Senate,"Assembly 3rd Reading AB339 Ortega By Durazo",28,11,0,1,40
1945201,1601314,2025-09-08,Assembly,"AB 339 Ortega Concurrence in Senate Amendments",52,12,0,16,80
1945202,1522020,2025-03-19,Assembly,"Do pass and be re-referred to the Committee on [Appropriations]",6,0,0,1,7
1945202,1577253,2025-05-23,Assembly,"Do pass",11,0,0,4,15
1945202,1584320,2025-06-03,Assembly,"AB 340 Ahrens Assembly Third Reading",65,1,0,13,79
1945202,1595191,2025-06-25,Senate,"Do pass, but first be re-referred to the Committee on [Judiciary]",4,1,0,0,5
1945202,1598547,2025-07-15,Senate,"Do pass, but first be re-referred to the Committee on [Appropriations]",10,2,0,1,13
1945202,1599426,2025-08-18,Senate,"Placed on suspense file",7,0,0,0,7
1945203,1542916,2025-04-08,Assembly,"Do pass and be re-referred to the Committee on [Human Services] with recommendation: To Consent Calendar",10,0,0,0,10
1945203,1563117,2025-04-29,Assembly,"Do pass as amended, and be re-referred to the Committee on [Appropriations] with recommendation: To Consent Calendar",7,0,0,0,7
1945203,1577388,2025-05-23,Assembly,"Do pass",14,0,0,1,15
1945203,1584396,2025-06-03,Assembly,"AB 341 Arambula Assembly Third Reading",79,0,0,0,79
1945203,1597264,2025-06-30,Senate,"Do pass, but first be re-referred to the Committee on [Education] with the recommendation: To Consent Calendar",5,0,0,0,5
1945203,1598098,2025-07-09,Senate,"Do pass, but first be re-referred to the Committee on [Appropriations] with the recommendation: To Consent Calendar",7,0,0,0,7
1945203,1599365,2025-08-18,Senate,"Placed on suspense file",7,0,0,0,7
1945203,1600737,2025-08-29,Senate,"Do pass",7,0,0,0,7
1945203,1601231,2025-09-08,Senate,"Assembly 3rd Reading AB341 Arambula By Grayson",39,0,0,1,40
1945203,1601661,2025-09-09,Assembly,"AB 341 Arambula Concurrence in Senate Amendments",80,0,0,0,80
1945204,1556183,2025-04-23,Assembly,"Do pass as amended and be re-referred to the Committee on [Appropriations]",15,2,0,5,22
1945204,1577274,2025-05-23,Assembly,"Do pass as amended",11,1,0,3,15
1945204,1584386,2025-06-03,Assembly,"AB 342 Haney Assembly Third Reading",50,11,0,18,79
1945205,1556188,2025-04-23,Senate,"Do pass, but first be re-referred to the Committee on [Appropriations]",5,0,0,2,7
1945205,1569788,2025-05-12,Senate,"Placed on suspense file",7,0,0,0,7
1945205,1577720,2025-05-23,Senate,"Do pass",5,0,0,2,7
1945205,1586436,2025-06-02,Senate,"Senate 3rd Reading SB226 Cabaldon",32,0,0,8,40
1945206,1538993,2025-04-07,Senate,"Do pass as amended, but first amend, and re-refer to the Committee on [Local Government]",10,0,0,1,11
1945206,1567896,2025-05-07,Senate,"Do pass",7,0,0,0,7
1945206,1579263,2025-05-27,Senate,"Senate 3rd Reading SB227 Grayson et al. Urgency Clause",39,0,0,1,40
1945206,1597908,2025-07-08,Assembly,"Do pass",7,0,0,1,8
1945206,1600191,2025-08-28,Assembly,"SB 227 Grayson Third Reading Urgency By Wilson",76,0,0,3,79
1945206,1601931,2025-09-11,Senate,"Special Consent SB227 Grayson et al. Urgency Clause",40,0,0,0,40
1945207,1535125,2025-04-02,Senate,"Do pass as amended, but first amend, and re-refer to the Committee on [Appropriations]",11,0,0,0,11
1945207,1552943,2025-04-21,Senate,"Placed on suspense file",6,0,0,1,7
1945207,1577560,2025-05-23,Senate,"Do pass as amended",6,0,0,1,7
1945207,1585096,2025-06-04,Senate,"Special Consent SB228 Cervantes",39,0,0,1,40
1945207,1598063,2025-07-08,Assembly,"Do pass and be re-referred to the Committee on [Appropriations] with recommendation: To Consent Calendar",16,0,0,0,16
1945208,1526983,2025-03-25,Senate,"Do pass and be ordered to the Consent Calendar",6,0,0,0,6
1945208,1530374,2025-03-28,Senate,"Consent Calendar 2nd SB229 Alvarado-Gil",34,0,0,6,40
1945208,1591852,2025-06-17,Assembly,"Do pass. To Consent Calendar",9,0,0,0,9
1945208,1594044,2025-06-23,Assembly,"SB 229 Alvarado-Gil Consent Calendar Second Day Regular Session",71,0,0,8,79
1945209,1528310,2025-03-26,Senate,"Do pass and be ordered to the Consent Calendar",5,0,0,0,5
1945209,1533475,2025-04-01,Senate,"Consent Calendar 2nd SB230 Laird et al",39,0,0,1,40
1945209,1598087,2025-07-09,Assembly,"Do pass. To Consent Calendar",15,0,0,2,17
1945209,1600922,2025-09-03,Assembly,"SB 230 Laird Senate Third Reading By Berman",79,0,0,0,79
1945209,1601137,2025-09-04,Senate,"Unfinished Business SB230 Laird et al. Concurrence",39,0,0,1,40
1945210,1521987,2025-03-19,Senate,"Do pass as amended, but first amend, and re-refer to the Committee on [Appropriations]",8,0,0,0,8
1945210,1538880,2025-04-07,Senate,"Placed on suspense file",7,0,0,0,7
1945211,1522010,2025-03-19,Senate,"Do pass as amended, but first amend, and re-refer to the Committee on [Appropriations]",8,0,0,0,8
1945211,1538995,2025-04-07,Senate,"Placed on suspense file",7,0,0,0,7
1945212,1520417,2025-03-18,Senate,"Do pass, but first be re-referred to the Committee on [Appropriations] with the recommendation: To Consent Calendar",10,0,0,1,11
1945212,1544995,2025-04-10,Senate,"Consent Calendar 2nd SB233 Seyarto et al",35,0,0,5,40
1945212,1592549,2025-06-18,Assembly,"Do pass as amended, and be re-referred to the Committee on [Local Government] with recommendation: To Consent Calendar",11,0,0,1,12
1945212,1598834,2025-07-16,Assembly,"Do pass and be re-referred to the Committee on [Appropriations]",10,0,0,0,10
1945212,1599747,2025-08-20,Assembly,"Do pass",15,0,0,0,15
1945212,1601342,2025-09-08,Assembly,"SB 233 Seyarto Senate Third Reading By Alanis",78,0,0,2,80
1945212,1601934,2025-09-11,Senate,"Unfinished Business SB233 Seyarto et al. Concurrence",40,0,0,0,40
1945213,1527003,2025-03-25,Senate,"Do pass, but first be re-referred to the Committee on [Environmental Quality] with the recommendation: To Consent Calendar",7,0,0,0,7
1945213,1563104,2025-04-30,Senate,"Do pass, but first be re-referred to the Committee on [Appropriations] with the recommendation: To Consent Calendar",8,0,0,0,8
1945213,1569895,2025-05-12,Senate,"Placed on suspense file",7,0,0,0,7
1945213,1577511,2025-05-23,Senate,"Do pass as amended",6,0,0,1,7
1945213,1580535,2025-05-28,Senate,"Senate 3rd Reading SB234 Niello et al",37,0,0,3,40
1945213,1594068,2025-06-23,Assembly,"Do pass and be re-referred to the Committee on [Environmental Safety and Toxic Materials] with recommendation: To Consent Calendar",14,0,0,0,14
1945213,1597133,2025-07-01,Assembly,"Do pass and be re-referred to the Committee on [Appropriations] with recommendation: To Consent Calendar",7,0,0,0,7
1945214,1495956,2025-02-20,Senate,"Senate 3rd Reading SCR17 Niello",35,0,0,4,39
1945214,1511417,2025-03-10,Assembly,"Be adopted. To Consent Calendar",9,0,0,2,11
1945214,1517617,2025-03-13,Assembly,"SCR 17 Niello Consent Calendar Second Day Regular Session",68,0,0,12,80
1947434,1505316,2025-03-04,Assembly,"Do pass and be re-referred to the Committee on [Appropriations] with recommendation: To Consent Calendar",12,0,0,0,12
1947434,1577643,2025-05-23,Assembly,"Do pass",14,0,0,1,15
1947434,1583471,2025-06-02,Assembly,"AB 343 Pacheco Assembly Third Reading",79,0,0,0,79
1947434,1595161,2025-06-24,Senate,"Do pass, but first be re-referred to the Committee on [Appropriations] with the recommendation: To Consent Calendar",12,0,0,1,13
1947434,1597677,2025-07-07,Senate,"Placed on suspense file",6,0,0,1,7
1947434,1600744,2025-08-29,Senate,"Do pass",7,0,0,0,7
1947434,1601125,2025-09-04,Senate,"Special Consent AB343 Pacheco et al",39,0,0,1,40
1947434,1601315,2025-09-08,Assembly,"AB 343 Pacheco Concurrence in Senate Amendments",79,0,0,1,80
1947435,1521957,2025-03-19,Assembly,"Do pass and be re-referred to the Committee on [Appropriations]",19,0,0,3,22
1947435,1542872,2025-04-09,Assembly,"Do pass",14,0,0,1,15
1947435,1573615,2025-05-19,Assembly,"AB 344 Valencia Assembly Third Reading",75,0,0,4,79
1947435,1588072,2025-06-10,Senate,"Do pass, but first be re-referred to the Committee on [Appropriations]",14,0,0,1,15
1947435,1600803,2025-09-02,Senate,"Assembly 3rd Reading AB344 Valencia By Ashby",40,0,0,0,40
1947436,1521994,2025-03-19,Assembly,"Do pass and be re-referred to the Committee on [Appropriations] with recommendation: To Consent Calendar",7,0,0,0,7
1947437,1562771,2025-04-29,Assembly,"Do pass and be re-referred to the Committee on [Appropriations] with recommendation: To Consent Calendar",7,0,0,0,7
1947437,1577463,2025-05-23,Assembly,"Do pass as amended",11,0,0,4,15
1947437,1584348,2025-06-03,Assembly,"AB 346 Nguyen Assembly Third Reading",76,0,0,3,79
1947437,1597195,2025-06-30,Senate,"Do pass, but first be re-referred to the Committee on [Appropriations]",5,0,0,0,5
1947437,1598224,2025-07-14,Senate,"Placed on suspense file",7,0,0,0,7
1947438,1516566,2025-03-12,Assembly,"Do pass as amended and be re-referred to the Committee on [Appropriations]",8,0,0,1,9
1947438,1577724,2025-05-23,Assembly,"Do pass",13,0,0,2,15
1947438,1583437,2025-06-02,Assembly,"AB 347 Kalra Assembly Third Reading",68,3,0,8,79
1947438,1597456,2025-07-02,Senate,"Do pass, but first be re-referred to the Committee on [Appropriations]",7,0,0,0,7
1947438,1598307,2025-07-14,Senate,"Placed on suspense file",7,0,0,0,7
1947439,1555922,2025-04-22,Assembly,"Do pass as amended",16,0,0,0,16
1947439,1569867,2025-05-12,Assembly,"AB 348 Krell Assembly Third Reading",76,0,0,3,79
1947439,1589130,2025-06-11,Senate,"Do pass",9,0,0,2,11
1947439,1600917,2025-09-03,Senate,"Assembly 3rd Reading AB348 Krell et al. By Ashby",40,0,0,0,40
1947439,1601193,2025-09-04,Assembly,"AB 348 Krell Concurrence in Senate Amendments",78,0,0,1,79
1947440,1564213,2025-05-01,Assembly,"Do pass as amended and be re-referred to the Committee on [Appropriations]",6,0,0,1,7
1947440,1577260,2025-05-23,Assembly,"Do pass as amended",14,0,0,1,15
1947440,1584295,2025-06-03,Assembly,"AB 349 Dixon Assembly Third Reading",78,0,0,1,79
1947440,1597231,2025-06-30,Senate,"Do pass, but first be re-referred to the Committee on [Appropriations]",5,0,0,0,5
1947440,1598312,2025-07-14,Senate,"Placed on suspense file",7,0,0,0,7
1947440,1600417,2025-08-29,Senate,"Do pass as amended",7,0,0,0,7
1947440,1601855,2025-09-11,Senate,"Special Consent AB349 Dixon By Wahab",40,0,0,0,40
1947440,1602302,2025-09-13,Assembly,"AB 349 Dixon Concurrence in Senate Amendments",75,0,0,5,80
1947441,1555941,2025-04-22,Assembly,"Do pass as amended and be re-referred to the Committee on [Appropriations]",14,0,0,2,16
1947441,1577531,2025-05-23,Assembly,"Do pass as amended",13,0,0,2,15
1947441,1583527,2025-06-02,Assembly,"AB 350 Bonta Assembly Third Reading",75,1,0,3,79
1947441,1597489,2025-07-02,Senate,"Do pass as amended, but first amend, and re-refer to the Committee on [Appropriations]",11,0,0,0,11
1947441,1599476,2025-08-18,Senate,"Placed on suspense file",7,0,0,0,7
1947441,1600584,2025-08-29,Senate,"Do pass",7,0,0,0,7
1947442,1521975,2025-03-19,Senate,"Do pass as amended, but first amend, and re-refer to the Committee on [Appropriations] with the recommendation: To Consent Calendar",8,0,0,0,8
1947442,1538934,2025-04-07,Senate,"Placed on suspense file",7,0,0,0,7
1947443,1556005,2025-04-23,Senate,"Do pass, but first be re-referred to the Committee on [Judiciary]",8,0,0,0,8
1947443,1562876,2025-04-29,Senate,"Do pass as amended, but first amend, and re-refer to the Committee on [Appropriations] with the recommendation: To Consent Calendar",13,0,0,0,13
1947443,1573565,2025-05-19,Senate,"Placed on suspense file",5,0,0,2,7
1947443,1577206,2025-05-23,Senate,"Do pass",6,0,0,1,7
1947443,1581782,2025-05-29,Senate,"Special Consent SB236 Weber Pierson",38,0,0,2,40
1947443,1597269,2025-07-01,Assembly,"Do pass and be re-referred to the Committee on [Judiciary] with recommendation: To Consent Calendar",7,0,0,0,7
1947443,1598417,2025-07-15,Assembly,"Do pass as amended, and be re-referred to the Committee on [Appropriations] with recommendation: To Consent Calendar",12,0,0,0,12
1947443,1600490,2025-08-29,Assembly,"Do pass as amended",11,0,0,4,15
1947443,1601343,2025-09-08,Assembly,"SB 236 Weber Pierson Senate Third Reading By Elhawary",78,0,0,2,80
1947443,1601926,2025-09-11,Senate,"Unfinished Business SB236 Weber Pierson Concurrence",40,0,0,0,40
1947444,1567911,2025-05-06,Senate,"Do pass as amended, and be ordered to the Consent Calendar",12,0,0,1,13
1947444,1572410,2025-05-15,Senate,"Consent Calendar 2nd SB237 Grayson",34,0,0,6,40
1947444,1602033,2025-09-12,Assembly,"Do pass",11,2,0,1,14
1947444,1602232,2025-09-12,Senate,"W/O REF. TO FILE SB237 Grayson",28,0,0,12,40
1947444,1602233,2025-09-13,Assembly,"SB 237 Grayson Senate Third Reading By WILSON",66,4,0,10,80
1947445,1555960,2025-04-23,Senate,"Do pass, but first be re-referred to the Committee on [Judiciary]",4,1,0,0,5
1947445,1562844,2025-04-29,Senate,"Do pass as amended, but first amend, and re-refer to the Committee on [Appropriations]",11,2,0,0,13
1947445,1573559,2025-05-19,Senate,"Placed on suspense file",5,0,0,2,7
1947445,1577139,2025-05-23,Senate,"Do pass",5,1,0,1,7
1947445,1584410,2025-06-03,Senate,"Senate 3rd Reading SB238 Smallwood-Cuevas",27,10,0,3,40
1947445,1595670,2025-06-25,Assembly,"Do pass and be re-referred to the Committee on [Privacy and Consumer Protection]",5,1,0,1,7
1947446,1530377,2025-03-28,Senate,"Senate 3rd Reading SCR18 Archuleta et al",31,0,0,9,40
1947446,1552899,2025-04-21,Assembly,"Be adopted. To Consent Calendar",10,0,0,1,11
1947446,1557509,2025-04-24,Assembly,"SCR 18 Archuleta Consent Calendar Second Day Regular Session",75,0,0,4,79
1947447,1523474,2025-03-20,Senate,"Senate 3rd Reading SR13 Archuleta",38,0,0,2,40
1947448,1559479,2025-04-28,Senate,"Senate 3rd Reading SR14 Cervantes et al",39,0,0,1,40
1949669,1563079,2025-04-30,Assembly,"Do pass and be re-referred to the Committee on [Appropriations]",2,3,0,2,7
1949669,1563080,2025-04-30,Assembly,Reconsideration,4,0,0,3,7
1949670,1526959,2025-03-25,Assembly,"Do pass and be re-referred to the Committee on [Appropriations]",9,0,0,0,9
1949670,1577580,2025-05-23,Assembly,"Do pass",14,0,0,1,15
1949670,1583556,2025-06-02,Assembly,"AB 352 Pacheco Assembly Third Reading",77,0,0,2,79
1949670,1594642,2025-06-24,Senate,"Do pass as amended, but first amend, and re-refer to the Committee on [Appropriations] with the recommendation: To Consent Calendar",6,0,0,0,6
1949670,1597661,2025-07-07,Senate,"Placed on suspense file",6,0,0,1,7
1949670,1600772,2025-08-29,Senate,"Do pass as amended",7,0,0,0,7
1949670,1601102,2025-09-04,Senate,"Assembly 3rd Reading AB352 Pacheco By Ashby",39,0,0,1,40
1949670,1601316,2025-09-08,Assembly,"AB 352 Pacheco Concurrence in Senate Amendments",75,0,0,5,80
1949671,1562782,2025-04-30,Assembly,"Do pass as amended and be re-referred to the Committee on [Appropriations]",7,2,0,1,10
1949671,1577313,2025-05-23,Assembly,"Do pass as amended",11,3,0,1,15
1949671,1585124,2025-06-04,Assembly,"AB 353 Boerner Assembly Third Reading",58,18,0,3,79
1949672,1542754,2025-04-08,Assembly,"Do pass as amended, and be re-referred to the Committee on [Appropriations] with recommendation: To Consent Calendar",9,0,0,0,9
1949672,1562885,2025-04-30,Assembly,"Do pass. To Consent Calendar",14,0,0,1,15
1949672,1568595,2025-05-08,Assembly,"AB 354 Michelle Rodriguez Consent Calendar Second Day Regular Session",69,0,0,10,79
1949672,1588080,2025-06-10,Senate,"Do pass, but first be re-referred to the Committee on [Appropriations] with the recommendation: To Consent Calendar",6,0,0,0,6
1949672,1595992,2025-06-27,Senate,"Consent Calendar 2nd AB354 Michelle Rodriguez Urgency Clause",38,0,0,2,40
1949673,1505296,2025-03-04,Assembly,"Do pass and be re-referred to the Committee on [Appropriations]",9,0,0,0,9
1949674,1563076,2025-04-29,Assembly,"Do pass and be re-referred to the Committee on [Appropriations]",13,0,0,3,16
1949674,1577165,2025-05-23,Assembly,"Do pass",11,0,0,4,15
1949674,1584283,2025-06-03,Assembly,"AB 356 Patel Assembly Third Reading",63,4,0,12,79
1949674,1598114,2025-07-09,Senate,"Do pass, but first be re-referred to the Committee on [Local Government]",9,0,0,2,11
1949675,1559459,2025-04-28,Assembly,"Do pass as amended and be re-referred to the Committee on [Appropriations]",12,0,0,2,14
1949675,1577621,2025-05-23,Assembly,"Do pass",14,0,0,1,15
1949675,1585814,2025-06-05,Assembly,"AB 357 Alvarez Assembly Third Reading",76,0,0,3,79
1949675,1597919,2025-07-08,Senate,"Do pass as amended, but first amend, and re-refer to the Committee on [Housing]",7,0,0,0,7
1949675,1601911,2025-09-11,Senate,"Assembly 3rd Reading AB357 Alvarez By Wiener",40,0,0,0,40
1949675,1602095,2025-09-12,Assembly,"AB 357 Alvarez Concurrence in Senate Amendments",78,0,0,2,80
1949676,1515272,2025-03-11,Assembly,"Do pass as amended and be re-referred to the Committee on [Privacy and Consumer Protection]",6,0,0,3,9
1949676,1556003,2025-04-22,Assembly,"Do pass and be re-referred to the Committee on [Appropriations]",10,0,0,5,15
1949676,1563021,2025-04-30,Assembly,"Do pass",14,0,0,1,15
1949676,1572417,2025-05-15,Assembly,"AB 358 Alvarez Assembly Third Reading",63,1,0,15,79
1949676,1594673,2025-06-24,Senate,"Do pass as amended, but first amend, and re-refer to the Committee on [Appropriations]",6,0,0,0,6
1949676,1597676,2025-07-07,Senate,"Placed on suspense file",6,0,0,1,7
1949677,1528300,2025-03-26,Assembly,"Do pass and be re-referred to the Committee on [Appropriations] with recommendation: To Consent Calendar",7,0,0,0,7
1949677,1577874,2025-05-23,Assembly,"Do pass",14,0,0,1,15
1949677,1583499,2025-06-02,Assembly,"AB 359 Ramos Assembly Third Reading",79,0,0,0,79
1949677,1597141,2025-07-01,Senate,"Do pass as amended, but first amend, and re-refer to the Committee on [Appropriations] with the recommendation: To Consent Calendar",5,0,0,0,5
1949677,1598857,2025-07-17,Senate,"Consent Calendar 2nd AB359 Ramos",35,0,0,5,40
1949677,1600068,2025-08-25,Assembly,"AB 359 Ramos Concurrence in Senate Amendments",76,0,0,3,79
1949678,1540990,2025-04-08,Assembly,"Do pass as amended and be re-referred to the Committee on [Appropriations]",17,0,0,1,18
1949679,1516586,2025-03-12,Assembly,"Do pass as amended",7,0,0,2,9
1949679,1577666,2025-05-23,Assembly,"Do pass",12,1,0,2,15
1949679,1583427,2025-06-02,Assembly,"AB 361 Schultz Assembly Third Reading",70,3,0,6,79
1949679,1595176,2025-06-25,Senate,"Do pass",5,2,0,0,7
1949679,1601001,2025-09-03,Senate,"Assembly 3rd Reading AB361 Schultz By Pérez",31,8,0,1,40
1949680,1540852,2025-04-08,Assembly,"Do pass and be re-referred to the Committee on [Environmental Safety and Toxic Materials]",9,0,0,4,13
1949680,1561106,2025-04-29,Assembly,"Do pass and be re-referred to the Committee on [Appropriations]",5,0,0,2,7
1949681,1565228,2025-05-05,Assembly,"Be adopted. To Consent Calendar",9,0,0,2,11
1949681,1568617,2025-05-08,Assembly,"ACR 23 Quirk-Silva Consent Calendar Second Day Regular Session",69,0,0,10,79
1949681,1593171,2025-06-19,Senate,"Special Consent ACR23 Quirk-Silva et al",35,0,0,5,40
1949682,1573610,2025-05-19,Assembly,"Be adopted. To Consent Calendar",6,0,0,5,11
1949682,1577201,2025-05-23,Assembly,"ACR 24 Alanis Consent Calendar Second Day Regular Session",71,0,0,8,79
1949682,1593179,2025-06-19,Senate,"Special Consent ACR24 Alanis et al",35,0,0,5,40
1949683,1536847,2025-04-02,Senate,"Do pass as amended, but first amend, and re-refer to the Committee on [Judiciary]",5,2,0,0,7
1949683,1567898,2025-05-06,Senate,"Do pass",10,1,0,2,13
1949685,1528272,2025-03-26,Senate,"Do pass and be ordered to the Consent Calendar",7,0,0,0,7
1949685,1533469,2025-04-01,Senate,"Consent Calendar 2nd SB241 Cervantes",39,0,0,1,40
1949685,1594687,2025-06-24,Assembly,"Do pass as amended",9,0,0,1,10
1949685,1601344,2025-09-08,Assembly,"SB 241 Cervantes Senate Third Reading By Fong",78,1,0,1,80
1949685,1601755,2025-09-10,Senate,"Unfinished Business SB241 Cervantes Concurrence",40,0,0,0,40
1949686,1564185,2025-04-30,Senate,"Do pass as amended, but first amend, and re-refer to the Committee on [Appropriations]",9,2,0,0,11
1949686,1573594,2025-05-19,Senate,"Placed on suspense file",5,0,0,2,7
1949687,1542766,2025-04-08,Senate,"Do pass, but first be re-referred to the Committee on [Health]",12,0,0,1,13
1949687,1564172,2025-04-30,Senate,"Do pass, but first be re-referred to the Committee on [Appropriations]",8,0,0,3,11
1949687,1569907,2025-05-12,Senate,"Placed on suspense file",7,0,0,0,7
1949687,1577484,2025-05-23,Senate,"Do pass",5,0,0,2,7
1949687,1584231,2025-06-03,Senate,"Senate 3rd Reading SB243 Padilla et al",28,4,0,8,40
1949687,1597813,2025-07-08,Assembly,"Do pass and be re-referred to the Committee on [Judiciary]",11,1,0,3,15
1949687,1598431,2025-07-15,Assembly,"Do pass and be re-referred to the Committee on [Appropriations]",9,1,0,2,12
1949687,1600507,2025-08-29,Assembly,"Do pass",13,1,0,1,15
1949687,1601857,2025-09-11,Senate,"Unfinished Business SB243 Padilla et al. Concurrence",33,3,0,4,40
1949688,1535110,2025-04-02,Senate,"Do pass, but first be re-referred to the Committee on [Governmental Organization]",7,0,0,0,7
1949688,1552966,2025-04-21,Senate,"Placed on suspense file",6,0,0,1,7
1949688,1577905,2025-05-23,Senate,"Do pass as amended",6,0,0,1,7
1949688,1585004,2025-06-04,Senate,"Special Consent SB244 Grayson",39,0,0,1,40
1949688,1597891,2025-07-08,Assembly,"Do pass and be re-referred to the Committee on [Appropriations] with recommendation: To Consent Calendar",10,0,0,0,10
1949689,1554522,2025-04-22,Senate,"Do pass, but first be re-referred to the Committee on [Appropriations]",5,1,0,0,6
1949689,1565342,2025-05-05,Senate,"Placed on suspense file",7,0,0,0,7
1949689,1577737,2025-05-23,Senate,"Do pass as amended",5,1,0,1,7
1949689,1586385,2025-06-02,Senate,"Senate 3rd Reading SB245 Reyes By Arreguín",29,9,0,2,40
1949689,1598765,2025-07-15,Assembly,"Do pass and be re-referred to the Committee on [Appropriations]",7,0,0,2,9
1949689,1600402,2025-08-29,Assembly,"Do pass",11,0,0,4,15
1949689,1602246,2025-09-12,Senate,"Unfinished Business SB245 Reyes Concurrence",29,7,0,4,40
1949689,1602247,2025-09-12,Assembly,"SB 245 Reyes Senate Third Reading By Bryan",65,5,0,10,80
1949690,1535031,2025-04-02,Senate,"Do pass, but first be re-referred to the Committee on [Appropriations] with the recommendation: To Consent Calendar",11,0,0,0,11
1949690,1552913,2025-04-21,Senate,"Placed on suspense file",6,0,0,1,7
1949690,1577243,2025-05-23,Senate,"Do pass",6,0,0,1,7
1949690,1581768,2025-05-29,Senate,"Special Consent SB246 Grove et al",38,0,0,2,40
1949690,1591875,2025-06-17,Assembly,"Do pass and be re-referred to the Committee on [Appropriations] with recommendation: To Consent Calendar",15,0,0,1,16
1949690,1600480,2025-08-29,Assembly,"Do pass",15,0,0,0,15
1949690,1601145,2025-09-04,Assembly,"SB 246 Grove Senate Third Reading By Hadwick",77,0,0,2,79
1949691,1554579,2025-04-22,Senate,"Do pass, but first be re-referred to the Committee on [Appropriations]",10,4,0,1,15
1949692,1526980,2025-03-25,Senate,"Do pass, but first be re-referred to the Committee on [Appropriations]",5,1,0,0,6
1949692,1538913,2025-04-07,Senate,"Placed on suspense file",7,0,0,0,7
1949692,1577410,2025-05-23,Senate,"Do pass as amended",5,1,0,1,7
1949692,1585064,2025-06-04,Senate,"Senate 3rd Reading SB248 Rubio",28,11,0,1,40
1949692,1597252,2025-07-01,Assembly,"Do pass and be re-referred to the Committee on [Appropriations]",8,0,0,1,9
1949693,1542856,2025-04-09,Senate,"Do pass, but first be re-referred to the Committee on [Elections and Constitutional Amendments]",5,2,0,0,7
1949693,1561176,2025-04-29,Senate,"Do pass as amended, but first amend, and re-refer to the Committee on [Appropriations]",3,1,0,1,5
1949693,1569902,2025-05-12,Senate,"Placed on suspense file",7,0,0,0,7
1949693,1577255,2025-05-23,Senate,"Do pass",5,1,0,1,7
1949693,1586423,2025-06-02,Senate,"Senate 3rd Reading SB249 Umberg",27,10,0,3,40
1949693,1597421,2025-07-02,Assembly,"Do pass and be re-referred to the Committee on [Education]",5,2,0,0,7
1949693,1598782,2025-07-16,Assembly,"Do pass and be re-referred to the Committee on [Appropriations]",7,2,0,0,9
1949694,1528293,2025-03-26,Senate,"Do pass, but first be re-referred to the Committee on [Appropriations] with the recommendation: To Consent Calendar",10,0,0,1,11
1949694,1538862,2025-04-07,Senate,"Placed on suspense file",7,0,0,0,7
1949694,1577175,2025-05-23,Senate,"Do pass",6,0,0,1,7
1949694,1581700,2025-05-29,Senate,"Special Consent SB250 Ochoa Bogh",38,0,0,2,40
1949694,1594666,2025-06-24,Assembly,"Do pass and be re-referred to the Committee on [Appropriations]",15,0,0,1,16
1949694,1597446,2025-07-02,Assembly,"Do pass",14,0,0,1,15
1949694,1601072,2025-09-04,Assembly,"SB 250 Ochoa Bogh Senate Third Reading By Chen",77,0,0,2,79
1949694,1601790,2025-09-10,Senate,"Unfinished Business SB250 Ochoa Bogh Concurrence",40,0,0,0,40
1953052,1521953,2025-03-18,Assembly,"Do pass as amended and be re-referred to the Committee on [Human Services]",7,1,0,2,10
1953052,1540861,2025-04-08,Assembly,"Do pass and be re-referred to the Committee on [Appropriations]",5,1,0,0,6
1953054,1528268,2025-03-26,Assembly,"Do pass as amended, and be re-referred to the Committee on [Judiciary] with recommendation: To Consent Calendar",18,0,0,0,18
1953054,1540938,2025-04-08,Assembly,"Do pass and be re-referred to the Committee on [Appropriations] with recommendation: To Consent Calendar",12,0,0,0,12
1953054,1555898,2025-04-23,Assembly,"Do pass. To Consent Calendar",15,0,0,0,15
1953054,1564201,2025-05-01,Assembly,"AB 365 Schiavo Consent Calendar Second Day Regular Session",76,0,0,3,79
1953054,1591866,2025-06-17,Senate,"Do pass as amended, but first amend, and re-refer to the Committee on [Judiciary]",14,0,0,3,17
1953054,1597548,2025-07-01,Senate,"Do pass as amended, but first amend, and re-refer to the Committee on [Appropriations]",13,0,0,0,13
1953054,1600886,2025-09-03,Senate,"Assembly 3rd Reading AB365 Schiavo By Durazo",40,0,0,0,40
1953054,1601317,2025-09-08,Assembly,"AB 365 Schiavo Concurrence in Senate Amendments",79,0,0,1,80
1953055,1563098,2025-04-29,Assembly,"Do pass as amended and be re-referred to the Committee on [Appropriations]",9,0,0,0,9
1953055,1577628,2025-05-23,Assembly,"Do pass as amended",11,0,0,4,15
1953055,1583567,2025-06-02,Assembly,"AB 366 Petrie-Norris Assembly Third Reading",78,0,0,1,79
1953055,1598422,2025-07-15,Senate,"Do pass as amended, but first amend, and re-refer to the Committee on [Appropriations]",6,0,0,0,6
1953055,1599579,2025-08-18,Senate,"Placed on suspense file",7,0,0,0,7
1953055,1600707,2025-08-29,Senate,"Do pass as amended",7,0,0,0,7
1953055,1602125,2025-09-12,Senate,"Assembly 3rd Reading AB366 Petrie-Norris et al. By Archuleta",37,0,0,3,40
1953055,1602126,2025-09-13,Assembly,"AB 366 PETRIE-NORRIS Concurrence in Senate Amendments",78,0,0,2,80
1953056,1540841,2025-04-07,Assembly,"Do pass and be re-referred to the Committee on [Utilities and Energy]",6,1,0,0,7
1953056,1564177,2025-04-30,Assembly,"Do pass as amended and be re-referred to the Committee on [Appropriations]",18,0,0,0,18
1953056,1577473,2025-05-23,Assembly,"Do pass as amended",11,0,0,4,15
1953056,1583532,2025-06-02,Assembly,"AB 367 Bennett Assembly Third Reading",75,1,0,3,79
1953056,1594688,2025-06-24,Senate,"Do pass as amended, but first amend, and re-refer to the Committee on [Local Government]",6,1,0,0,7
1953056,1598046,2025-07-09,Senate,"Do pass as amended, but first amend, and re-refer to the Committee on [Appropriations]",5,1,0,1,7
1953056,1599473,2025-08-18,Senate,"Placed on suspense file",7,0,0,0,7
1953056,1600380,2025-08-29,Senate,"Do pass as amended",5,2,0,0,7
1953056,1601250,2025-09-08,Senate,"Assembly 3rd Reading AB367 Bennett et al. By Limón",30,7,0,3,40
1953056,1601495,2025-09-09,Assembly,"AB 367 Bennett Concurrence in Senate Amendments",74,1,0,5,80
1953057,1535089,2025-04-02,Assembly,"Do pass as amended, and be re-referred to the Committee on [Natural Resources] with recommendation: To Consent Calendar",18,0,0,0,18
1953057,1558723,2025-04-21,Assembly,"Do pass and be re-referred to the Committee on [Appropriations] with recommendation: To Consent Calendar",14,0,0,0,14
1953057,1577371,2025-05-23,Assembly,"Do pass",14,0,0,1,15
1953057,1583514,2025-06-02,Assembly,"AB 368 Ward Assembly Third Reading",79,0,0,0,79
1953057,1597746,2025-07-07,Senate,"Do pass as amended, but first amend, and re-refer to the Committee on [Appropriations]",16,0,0,1,17
1953057,1599550,2025-08-18,Senate,"Placed on suspense file",7,0,0,0,7
1953057,1600310,2025-08-29,Senate,"Do pass as amended",7,0,0,0,7
1953057,1601265,2025-09-08,Senate,"Assembly 3rd Reading AB368 Ward et al. By Becker",39,0,0,1,40
1953057,1601467,2025-09-09,Assembly,"AB 368 Ward Concurrence in Senate Amendments",79,0,0,1,80
1953058,1540872,2025-04-08,Assembly,"Do pass as amended. To Consent Calendar",12,0,0,0,12
1953058,1557544,2025-04-24,Assembly,"AB 369 Michelle Rodriguez Consent Calendar Second Day",75,0,0,4,79
1953058,1591869,2025-06-17,Senate,"Do pass and be ordered to the Consent Calendar",12,0,0,1,13
1953058,1594076,2025-06-23,Senate,"Consent Calendar 2nd AB369 Michelle Rodriguez",37,0,0,3,40
1953058,1597577,2025-07-03,Assembly,"AB 369 Michelle Rodriguez Concurrence in Senate Amendments",75,0,0,4,79
1953059,1515265,2025-03-11,Assembly,"Do pass as amended, and be re-referred to the Committee on [Appropriations] with recommendation: To Consent Calendar",12,0,0,0,12
1953059,1542895,2025-04-09,Assembly,"Do pass. To Consent Calendar",14,0,0,1,15
1953059,1557499,2025-04-24,Assembly,"AB 370 Carrillo Consent Calendar Second Day Regular Session",75,0,0,4,79
1953059,1591842,2025-06-17,Senate,"Do pass, but first be re-referred to the Committee on [Appropriations] with the recommendation: To Consent Calendar",12,0,0,1,13
1953059,1597596,2025-07-03,Senate,"Consent Calendar 2nd AB370 Carrillo",35,0,0,5,40
1953060,1555974,2025-04-22,Assembly,"Do pass as amended and be re-referred to the Committee on [Appropriations]",15,0,0,1,16
1953061,1540953,2025-04-07,Assembly,"Do pass and be re-referred to the Committee on [Environmental Safety and Toxic Materials]",7,0,0,0,7
1953061,1561166,2025-04-29,Assembly,"Do pass and be re-referred to the Committee on [Appropriations] with recommendation: To Consent Calendar",7,0,0,0,7
1953061,1577451,2025-05-23,Assembly,"Do pass",13,0,0,2,15
1953061,1583505,2025-06-02,Assembly,"AB 372 Bennett Assembly Third Reading",79,0,0,0,79
1953061,1594650,2025-06-24,Senate,"Do pass, but first be re-referred to the Committee on [Natural Resources and Water]",15,0,0,0,15
1953061,1598655,2025-07-16,Senate,"Do pass, but first be re-referred to the Committee on [Appropriations] with the recommendation: To Consent Calendar",7,0,0,0,7
1953061,1599440,2025-08-18,Senate,"Placed on suspense file",7,0,0,0,7
1953061,1600333,2025-08-29,Senate,"Do pass as amended",7,0,0,0,7
1953062,1515249,2025-03-11,Assembly,"Do pass and be re-referred to the Committee on [Human Services]",9,0,0,3,12
1953062,1526890,2025-03-25,Assembly,"Do pass",6,0,0,1,7
1953062,1538910,2025-04-07,Assembly,"AB 373 Blanca Rubio Assembly Third Reading",64,0,0,15,79
1953062,1591897,2025-06-17,Senate,"Do pass, but first be re-referred to the Committee on [Human Services]",10,1,0,2,13
1953062,1597699,2025-07-07,Senate,"Do pass",4,1,0,0,5
1953062,1600890,2025-09-03,Senate,"Assembly 3rd Reading AB373 Blanca Rubio By Arreguín",30,8,0,2,40
1953063,1522004,2025-03-19,Assembly,"Do pass and be re-referred to the Committee on [Higher Education]",6,0,0,1,7
1953063,1556167,2025-04-22,Assembly,"Do pass",8,0,0,2,10
1953063,1568665,2025-05-08,Assembly,"AB 374 Nguyen Assembly Third Reading",73,0,0,6,79
1953063,1589135,2025-06-11,Senate,"Do pass, but first be re-referred to the Committee on [Appropriations]",5,0,0,0,5
1953063,1594054,2025-06-23,Senate,"Placed on suspense file",7,0,0,0,7
1953063,1600693,2025-08-29,Senate,"Do pass as amended",7,0,0,0,7
1953063,1601556,2025-09-09,Senate,"Assembly 3rd Reading AB374 Nguyen et al. By Cervantes",40,0,0,0,40
1953064,1540796,2025-04-08,Assembly,"Do pass and be re-referred to the Committee on [Appropriations] with recommendation: To Consent Calendar",17,0,0,1,18
1953066,1525431,2025-03-24,Assembly,"Do pass and be re-referred to the Committee on [Appropriations] with recommendation: To Consent Calendar",16,0,0,0,16
1953066,1563050,2025-04-30,Assembly,"Do pass. To Consent Calendar",14,0,0,1,15
1953066,1568650,2025-05-08,Assembly,"AB 377 Tangipa Consent Calendar Second Day Regular Session",69,0,0,10,79
1953066,1588055,2025-06-10,Senate,"Do pass, but first be re-referred to the Committee on [Appropriations] with the recommendation: To Consent Calendar",13,0,0,2,15
1953066,1597595,2025-07-03,Senate,"Consent Calendar 2nd AB377 Tangipa",35,0,0,5,40
1953066,1598276,2025-07-14,Assembly,"AB 377 Tangipa Concurrence in Senate Amendments",72,0,0,7,79
1953067,1522005,2025-03-19,Assembly,"Do pass and be re-referred to the Committee on [Education]",6,0,0,1,7
1953067,1529533,2025-03-26,Assembly,"Do pass and be re-referred to the Committee on [Appropriations]",7,2,0,0,9
1953067,1577708,2025-05-23,Assembly,"Do pass",12,2,0,1,15
1953067,1583559,2025-06-02,Assembly,"AB 378 Valencia Assembly Third Reading",64,11,0,4,79
1953067,1592564,2025-06-18,Senate,"Do pass, but first be re-referred to the Committee on [Appropriations]",4,1,0,0,5
1953067,1596784,2025-06-30,Senate,"Placed on suspense file",6,0,0,1,7
1953067,1600676,2025-08-29,Senate,"Do pass",5,2,0,0,7
1953067,1602085,2025-09-12,Senate,"Assembly 3rd Reading AB378 Valencia et al. By Cervantes",29,9,0,2,40
1953067,1602086,2025-09-13,Assembly,"AB 378 Valencia Concurrence in Senate Amendments",61,12,0,7,80
1953068,1563116,2025-04-29,Assembly,"Do pass as amended and be re-referred to the Committee on [Appropriations]",7,0,0,2,9
1953068,1564252,2025-05-01,Assembly,"AB 379 Krell Assembly Second Reading Amend By SCHULTZ Set #1 Appeal the Decision of the Speaker By MACEDO",18,50,0,11,79
1953068,1564253,2025-05-01,Assembly,"AB 379 Krell Assembly Second Reading Amend By SCHULTZ Set #1 Motion to Lay on the Table By MACEDO",21,55,0,3,79
1953068,1564254,2025-05-01,Assembly,"AB 379 Krell Assembly Second Reading Amend By SCHULTZ Set #1",56,21,0,2,79
1953068,1567907,2025-05-07,Assembly,"Do pass as amended",15,0,0,0,15
1953068,1572402,2025-05-15,Assembly,"AB 379 Schultz Assembly Third Reading",74,0,0,5,79
1953068,1588068,2025-06-10,Senate,"Do pass, but first be re-referred to the Committee on [Appropriations]",6,0,0,0,6
1953068,1597742,2025-07-07,Senate,"Do pass",6,0,0,1,7
1953068,1598282,2025-07-14,Senate,"Assembly 3rd Reading AB379 Schultz et al. By Arreguín",33,2,0,5,40
1953069,1515259,2025-03-11,Assembly,"Do pass as amended and be re-referred to the Committee on [Appropriations]",5,0,0,4,9
1953069,1577609,2025-05-23,Assembly,"Do pass as amended",11,1,0,3,15
1953069,1585008,2025-06-04,Assembly,"AB 380 Mark González Assembly Third Reading",49,9,0,21,79
1953069,1597958,2025-07-08,Senate,"Do pass, but first be re-referred to the Committee on [Appropriations]",4,1,0,1,6
1953069,1599427,2025-08-18,Senate,"Placed on suspense file",7,0,0,0,7
1953070,1534992,2025-04-02,Assembly,"Do pass and be re-referred to the Committee on [Labor and Employment]",21,0,0,1,22
1953070,1557481,2025-04-23,Assembly,"Do pass and be re-referred to the Committee on [Appropriations] with recommendation: To Consent Calendar",7,0,0,0,7
1953070,1577258,2025-05-23,Assembly,"Do pass as amended",11,0,0,4,15
1953070,1584428,2025-06-03,Assembly,"AB 381 Stefani Assembly Third Reading",79,0,0,0,79
1953070,1594604,2025-06-24,Senate,"Do pass, but first be re-referred to the Committee on [Labor, Public Employment and Retirement ] with the recommendation: To Consent Calendar",15,0,0,0,15
1953070,1598057,2025-07-09,Senate,"Do pass, but first be re-referred to the Committee on [Appropriations] with the recommendation: To Consent Calendar",5,0,0,0,5
1953070,1599643,2025-08-18,Senate,"Placed on suspense file",7,0,0,0,7
1953071,1554442,2025-04-21,Assembly,"Do pass and be re-referred to the Committee on [Appropriations]",15,0,0,1,16
1953071,1577364,2025-05-23,Assembly,"Do pass",13,0,0,2,15
1953071,1583412,2025-06-02,Assembly,"AB 382 Berman Assembly Third Reading",78,0,0,1,79
1953071,1597888,2025-07-08,Senate,"Do pass, but first be re-referred to the Committee on [Appropriations]",15,0,0,0,15
1953071,1599437,2025-08-18,Senate,"Placed on suspense file",7,0,0,0,7
1953071,1600309,2025-08-29,Senate,"Do pass",7,0,0,0,7
1953071,1601490,2025-09-09,Senate,"Assembly 3rd Reading AB382 Berman By Grayson",40,0,0,0,40
1953072,1515261,2025-03-11,Assembly,"Do pass as amended and be re-referred to the Committee on [Appropriations]",8,0,0,1,9
1953072,1577841,2025-05-23,Assembly,"Do pass",14,0,0,1,15
1953072,1585816,2025-06-05,Assembly,"AB 383 Davies Assembly Third Reading",69,1,0,9,79
1953072,1598398,2025-07-15,Senate,"Do pass as amended, but first amend, and re-refer to the Committee on [Appropriations]",6,0,0,0,6
1953072,1599530,2025-08-18,Senate,"Placed on suspense file",7,0,0,0,7
1953072,1600631,2025-08-29,Senate,"Do pass",7,0,0,0,7
1953072,1601237,2025-09-08,Senate,"Assembly 3rd Reading AB383 Davies By Ochoa Bogh",39,0,0,1,40
1953072,1602160,2025-09-13,Assembly,"AB 383 Davies Concurrence in Senate Amendments",70,0,0,10,80
1953073,1556078,2025-04-22,Assembly,"Do pass and be re-referred to the Committee on [Appropriations]",13,0,0,3,16
1953074,1564198,2025-04-30,Assembly,"Do pass and be re-referred to the Committee on [Appropriations] with recommendation: To Consent Calendar",10,0,0,0,10
1953074,1571566,2025-05-14,Assembly,"Do pass. To Consent Calendar",15,0,0,0,15
1953074,1577618,2025-05-23,Assembly,"AB 385 Ramos Consent Calendar Second Day",71,0,0,8,79
1953074,1598099,2025-07-09,Senate,"Do pass, but first be re-referred to the Committee on [Appropriations] with the recommendation: To Consent Calendar",7,0,0,0,7
1953074,1600052,2025-08-25,Senate,"Consent Calendar 2nd AB385 Ramos",37,0,0,3,40
1953074,1600623,2025-08-29,Assembly,"AB 385 Ramos Concurrence in Senate Amendments",71,0,0,8,79
1953076,1515253,2025-03-11,Assembly,"Do pass",11,1,0,0,12
1953076,1517619,2025-03-13,Assembly,"AB 387 Alanis Assembly Third Reading",67,0,0,13,80
1953077,1564192,2025-04-30,Assembly,"Do pass and be re-referred to the Committee on [Appropriations]",18,0,0,0,18
1953079,1525478,2025-03-24,Assembly,"Do pass and be re-referred to the Committee on [Appropriations]",16,0,0,0,16
1953079,1542737,2025-04-09,Assembly,"Do pass",14,0,0,1,15
1953079,1559468,2025-04-28,Assembly,"AB 390 Wilson Assembly Third Reading",74,0,0,5,79
1953079,1588086,2025-06-10,Senate,"Do pass, but first be re-referred to the Committee on [Appropriations] with the recommendation: To Consent Calendar",13,0,0,2,15
1953079,1597585,2025-07-03,Senate,"Consent Calendar 2nd AB390 Wilson et al",35,0,0,5,40
1953079,1598173,2025-07-10,Assembly,"AB 390 Wilson Concurrence in Senate Amendments",73,0,0,6,79
1953080,1567905,2025-05-07,Assembly,"Do pass as amended. To Consent Calendar",12,0,0,0,12
1953080,1572416,2025-05-15,Assembly,"AB 391 Michelle Rodriguez Consent Calendar Second Day Regular Session",69,0,0,10,79
1953080,1591850,2025-06-17,Senate,"Do pass as amended, and be ordered to the Consent Calendar",12,0,0,1,13
1953080,1600853,2025-09-02,Senate,"Assembly 3rd Reading AB391 Michelle Rodriguez By Caballero",40,0,0,0,40
1953080,1600969,2025-09-03,Assembly,"AB 391 Michelle Rodriguez Concurrence in Senate Amendments",79,0,0,0,79
1953081,1535040,2025-04-01,Assembly,"Do pass and be re-referred to the Committee on [Judiciary]",14,0,0,1,15
1953081,1554608,2025-04-22,Assembly,"Do pass as amended and be re-referred to the Committee on [Appropriations]",12,0,0,0,12
1953081,1577344,2025-05-23,Assembly,"Do pass as amended",14,0,0,1,15
1953081,1585801,2025-06-05,Assembly,"AB 392 Dixon Assembly Third Reading",78,0,0,1,79
1953081,1597922,2025-07-08,Senate,"Do pass as amended, but first amend, and re-refer to the Committee on [Public Safety]",13,0,0,0,13
1953081,1599629,2025-08-18,Senate,"Placed on suspense file",7,0,0,0,7
1953082,1521972,2025-03-19,Assembly,"Do pass and be re-referred to the Committee on [Appropriations]",6,0,0,1,7
1953082,1577249,2025-05-23,Assembly,"Do pass as amended",11,1,0,3,15
1953082,1583400,2025-06-02,Assembly,"AB 393 Connolly Assembly Third Reading",62,7,0,10,79
1953082,1592602,2025-06-18,Senate,"Do pass as amended, but first amend, and re-refer to the Committee on [Appropriations]",4,1,0,0,5
1953082,1596791,2025-06-30,Senate,"Placed on suspense file",6,0,0,1,7
1953082,1600274,2025-08-29,Senate,"Do pass",5,2,0,0,7
1953082,1601266,2025-09-08,Senate,"Assembly 3rd Reading AB393 Connolly et al. By Richardson",29,10,0,1,40
1953082,1601560,2025-09-09,Assembly,"AB 393 Connolly Concurrence in Senate Amendments",60,9,0,11,80
1953083,1534996,2025-04-01,Assembly,"Do pass and be re-referred to the Committee on [Judiciary]",9,0,0,0,9
1953083,1554500,2025-04-22,Assembly,"Do pass as amended and be re-referred to the Committee on [Appropriations]",12,0,0,0,12
1953083,1577539,2025-05-23,Assembly,"Do pass",14,0,0,1,15
1953083,1583401,2025-06-02,Assembly,"AB 394 Wilson Assembly Third Reading",76,0,0,3,79
1953083,1597261,2025-07-01,Senate,"Do pass, but first be re-referred to the Committee on [Judiciary]",6,0,0,0,6
1953083,1598771,2025-07-15,Senate,"Do pass as amended, but first amend, and re-refer to the Committee on [Appropriations]",13,0,0,0,13
1953083,1599613,2025-08-18,Senate,"Placed on suspense file",7,0,0,0,7
1953083,1600542,2025-08-29,Senate,"Do pass",7,0,0,0,7
1953083,1601889,2025-09-11,Senate,"Assembly 3rd Reading AB394 Wilson et al. By Ashby",40,0,0,0,40
1953083,1602310,2025-09-12,Assembly,"AB 394 Wilson Concurrence in Senate Amendments",77,0,0,3,80
1953084,1545044,2025-04-09,Assembly,"Do pass as amended, and be re-referred to the Committee on [Higher Education] with recommendation: To Consent Calendar",9,0,0,0,9
1953084,1561035,2025-04-29,Assembly,"Do pass as amended, and be re-referred to the Committee on [Appropriations] with recommendation: To Consent Calendar",10,0,0,0,10
1953084,1577553,2025-05-23,Assembly,"Do pass",14,0,0,1,15
1953084,1583379,2025-06-02,Assembly,"AB 395 Gabriel Assembly Third Reading",79,0,0,0,79
1953084,1595164,2025-06-25,Senate,"Do pass as amended, but first amend, and re-refer to the Committee on [Judiciary] with the recommendation: To Consent Calendar",7,0,0,0,7
1953086,1561057,2025-04-28,Assembly,"Do pass and be re-referred to the Committee on [Appropriations]",5,1,0,1,7
1953089,1552904,2025-04-21,Senate,"Do pass",5,1,0,1,7
1953089,1557492,2025-04-24,Senate,"Senate 3rd Reading SB251 Caballero Urgency Clause",28,0,0,12,40
1953089,1597430,2025-07-02,Assembly,"Do pass",11,0,0,4,15
1953089,1598870,2025-07-17,Assembly,"SB 251 Caballero Third Reading Urgency By Wicks",73,0,0,6,79
1953091,1567889,2025-05-06,Senate,"Do pass",12,0,0,1,13
1953091,1580538,2025-05-28,Senate,"Senate 3rd Reading SB253 Umberg",38,0,0,2,40
1953091,1594620,2025-06-24,Assembly,"Do pass as amended",12,0,0,0,12
1953091,1601345,2025-09-08,Assembly,"SB 253 Umberg Senate Third Reading By Kalra",78,0,0,2,80
1953091,1601749,2025-09-10,Senate,"Unfinished Business SB253 Umberg et al. Concurrence",40,0,0,0,40
1953092,1563065,2025-04-29,Senate,"Do pass, but first be re-referred to the Committee on [Appropriations]",13,2,0,2,17
1953092,1569842,2025-05-12,Senate,"Placed on suspense file",7,0,0,0,7
1953092,1577481,2025-05-23,Senate,"Do pass as amended",5,1,0,1,7
1953092,1585065,2025-06-04,Senate,"Senate 3rd Reading SB254 Becker et al. Urgency Clause",29,10,0,1,40
1953092,1598570,2025-07-16,Assembly,"Do pass and be re-referred to the Committee on [Natural Resources]",11,5,0,2,18
1953092,1598908,2025-07-17,Assembly,"Do pass and be re-referred to the Committee on [Appropriations]",9,4,0,1,14
1953092,1600638,2025-08-29,Assembly,"Do pass",9,4,0,2,15
1953092,1602034,2025-09-12,Assembly,"Do pass",16,0,0,2,18
1953092,1602303,2025-09-12,Senate,"W/O REF. TO FILE SB254 Becker",30,2,0,8,40
1953092,1602304,2025-09-13,Assembly,"SB 254 Becker Third Reading Urgency By Petrie-Norris",69,0,0,11,80
1953093,1536809,2025-04-02,Senate,"Do pass, but first be re-referred to the Committee on [Judiciary]",7,0,0,0,7
1953093,1556108,2025-04-22,Senate,"Do pass, but first be re-referred to the Committee on [Appropriations] with the recommendation: To Consent Calendar",13,0,0,0,13
1953093,1568647,2025-05-08,Senate,"Consent Calendar 2nd SB255 Seyarto",36,0,0,4,40
1953093,1592573,2025-06-18,Assembly,"Do pass and be re-referred to the Committee on [Judiciary] with recommendation: To Consent Calendar",10,0,0,0,10
1953093,1594649,2025-06-24,Assembly,"Do pass and be re-referred to the Committee on [Appropriations] with recommendation: To Consent Calendar",12,0,0,0,12
1953093,1598066,2025-07-09,Assembly,"Do pass. To Consent Calendar",15,0,0,0,15
1953093,1598866,2025-07-17,Assembly,"SB 255 Seyarto Consent Calendar Second Day Regular Session",75,0,0,4,79
1953093,1600813,2025-09-02,Assembly,"SB 255 Seyarto Senate Third Reading By Lackey",77,0,0,2,79
1953093,1601930,2025-09-11,Senate,"Special Consent SB255 Seyarto",40,0,0,0,40
1953094,1563124,2025-04-29,Senate,"Do pass as amended, but first amend, and re-refer to the Committee on [Appropriations]",14,2,0,1,17
1953094,1573554,2025-05-19,Senate,"Placed on suspense file",5,0,0,2,7
1953094,1577786,2025-05-23,Senate,"Do pass",5,1,0,1,7
1953094,1584274,2025-06-03,Senate,"Senate 3rd Reading SB256 Pérez",30,8,0,2,40
1953094,1598138,2025-07-09,Assembly,"Do pass and be re-referred to the Committee on [Emergency Management]",13,4,0,1,18
1953094,1598386,2025-07-14,Assembly,"Do pass as amended and be re-referred to the Committee on [Appropriations]",5,2,0,0,7
1953095,1557484,2025-04-23,Senate,"Do pass, but first be re-referred to the Committee on [Appropriations]",11,0,0,0,11
1953095,1569752,2025-05-12,Senate,"Placed on suspense file",7,0,0,0,7
1953095,1577229,2025-05-23,Senate,"Do pass",6,0,0,1,7
1953095,1584362,2025-06-03,Senate,"Senate 3rd Reading SB257 Wahab et al",39,0,0,1,40
1953095,1598504,2025-07-15,Assembly,"Do pass as amended and be re-referred to the Committee on [Appropriations]",14,0,0,2,16
1953095,1600704,2025-08-29,Assembly,"Do pass",14,0,0,1,15
1953095,1601626,2025-09-09,Assembly,"SB 257 Wahab Senate Third Reading By Bonta",68,0,0,12,80
1953095,1601810,2025-09-10,Senate,"Unfinished Business SB257 Wahab et al. Concurrence",40,0,0,0,40
1953096,1562914,2025-04-29,Senate,"Do pass, but first be re-referred to the Committee on [Appropriations]",6,0,0,0,6
1953096,1569785,2025-05-12,Senate,"Placed on suspense file",7,0,0,0,7
1953096,1577501,2025-05-23,Senate,"Do pass",6,0,0,1,7
1953096,1586434,2025-06-02,Senate,"Senate 3rd Reading SB258 Wahab et al",37,0,0,3,40
1953096,1598720,2025-07-15,Assembly,"Do pass and be re-referred to the Committee on [Appropriations]",9,0,0,0,9
1953096,1600580,2025-08-29,Assembly,"Do pass as amended",11,0,0,4,15
1953096,1602237,2025-09-12,Senate,"Unfinished Business SB258 Wahab et al. Concurrence",38,0,0,2,40
1953097,1556142,2025-04-22,Senate,"Do pass as amended",11,1,0,1,13
1953097,1580521,2025-05-28,Senate,"Senate 3rd Reading SB259 Wahab",30,9,0,1,40
1953097,1594646,2025-06-24,Assembly,"Do pass and be re-referred to the Committee on [Judiciary]",10,4,0,1,15
1953097,1598511,2025-07-15,Assembly,"Do pass",8,3,0,1,12
1953098,1533560,2025-04-01,Senate,"Do pass as amended, but first amend, and re-refer to the Committee on [Insurance]",6,0,0,0,6
1953098,1556141,2025-04-23,Senate,"Do pass, but first be re-referred to the Committee on [Appropriations]",5,0,0,2,7
1953098,1569792,2025-05-12,Senate,"Placed on suspense file",7,0,0,0,7
1953099,1528323,2025-03-26,Senate,"Do pass as amended, but first amend, and re-refer to the Committee on [Judiciary]",4,1,0,0,5
1953099,1542837,2025-04-08,Senate,"Do pass as amended, but first amend, and re-refer to the Committee on [Appropriations]",11,0,0,2,13
1953099,1559425,2025-04-28,Senate,"Placed on suspense file",7,0,0,0,7
1953099,1577894,2025-05-23,Senate,"Do pass as amended",5,0,0,2,7
1953099,1585108,2025-06-04,Senate,"Senate 3rd Reading SB261 Wahab et al",29,6,0,5,40
1953099,1598103,2025-07-09,Assembly,"Do pass and be re-referred to the Committee on [Judiciary]",7,0,0,0,7
1953099,1598463,2025-07-15,Assembly,"Do pass and be re-referred to the Committee on [Appropriations]",11,0,0,1,12
1953099,1600754,2025-08-29,Assembly,"Do pass as amended",11,0,0,4,15
1953099,1601346,2025-09-08,Assembly,"SB 261 Wahab Senate Third Reading By Kalra",71,1,0,8,80
1953099,1601571,2025-09-09,Senate,"Unfinished Business SB261 Wahab et al. Concurrence",30,6,0,4,40
1953100,1520448,2025-03-18,Senate,"Do pass as amended, but first amend, and re-refer to the Committee on [Appropriations]",7,2,0,2,11
1953100,1584284,2025-06-03,Senate,"Senate 3rd Reading SB262 Wahab",24,13,0,3,40
1953100,1597504,2025-07-02,Assembly,"Do pass as amended and be re-referred to the Committee on [Local Government]",10,2,0,0,12
1953100,1598899,2025-07-16,Assembly,"Do pass and be re-referred to the Committee on [Appropriations]",8,2,0,0,10
1953100,1599752,2025-08-20,Assembly,"Do pass",11,4,0,0,15
1953100,1601347,2025-09-08,Assembly,"SB 262 Wahab Senate Third Reading By Ahrens",57,15,0,8,80
1953100,1601648,2025-09-09,Senate,"Unfinished Business SB262 Wahab et al. Concurrence",27,11,0,2,40
1953101,1527004,2025-03-25,Senate,"Do pass, but first be re-referred to the Committee on [Business, Professions and Economic Development]",14,0,0,1,15
1953101,1559466,2025-04-28,Senate,"Do pass, but first be re-referred to the Committee on [Appropriations]",11,0,0,0,11
1953101,1569794,2025-05-12,Senate,"Placed on suspense file",7,0,0,0,7
1953101,1577569,2025-05-23,Senate,"Do pass as amended",6,0,0,1,7
1953101,1580478,2025-05-28,Senate,"Senate 3rd Reading SB263 Gonzalez et al. Urgency Clause",35,1,0,4,40
1953101,1597770,2025-07-07,Assembly,"Do pass and be re-referred to the Committee on [Economic Development, Growth, and Household Impact]",14,0,0,2,16
1953101,1597861,2025-07-08,Assembly,"Do pass and be re-referred to the Committee on [Appropriations]",7,0,0,1,8
1953101,1600589,2025-08-29,Assembly,"Do pass as amended",11,1,0,3,15
1953101,1601551,2025-09-09,Assembly,"SB 263 Gonzalez Senate Third Reading By Lowenthal",69,5,0,6,80
1953101,1601764,2025-09-10,Senate,"Unfinished Business SB263 Gonzalez et al. Concurrence",40,0,0,0,40
1953104,1561161,2025-04-29,Senate,"Do pass as amended, but first amend, and re-refer to the Committee on [Appropriations]",5,0,0,0,5
1953104,1569838,2025-05-12,Senate,"Placed on suspense file",7,0,0,0,7
1953105,1571643,2025-05-14,Senate,"Do pass, but first be re-referred to the Committee on [Appropriations]",5,0,0,0,5
1953105,1573637,2025-05-19,Senate,"Placed on suspense file",5,0,0,2,7
1953106,1571582,2025-05-14,Senate,"Do pass, but first be re-referred to the Committee on [Appropriations]",5,0,0,0,5
1953106,1573573,2025-05-19,Senate,"Placed on suspense file",5,0,0,2,7
1953107,1571654,2025-05-14,Senate,"Do pass, but first be re-referred to the Committee on [Appropriations]",5,0,0,0,5
1953107,1573514,2025-05-19,Senate,"Placed on suspense file",5,0,0,2,7
1953108,1533540,2025-04-01,Senate,"Do pass as amended, but first amend, and re-refer to the Committee on [Judiciary]",5,0,0,0,5
1953108,1555977,2025-04-22,Senate,"Do pass, but first be re-referred to the Committee on [Appropriations] with the recommendation: To Consent Calendar",13,0,0,0,13
1953108,1565308,2025-05-05,Senate,"Placed on suspense file",7,0,0,0,7
1953109,1501957,2025-02-27,Senate,"Senate 3rd Reading SCR19 Wahab et al",36,0,0,3,39
1953109,1552861,2025-04-21,Assembly,"Be adopted. To Consent Calendar",10,0,0,1,11
1953109,1557524,2025-04-24,Assembly,"SCR 19 Wahab Consent Calendar Second Day Regular Session",75,0,0,4,79
1955744,1561139,2025-04-28,Assembly,"Do pass and be re-referred to the Committee on [Appropriations]",5,1,0,1,7
1955745,1525476,2025-03-24,Assembly,"Do pass and be re-referred to the Committee on [Appropriations]",9,3,0,2,14
1955745,1577510,2025-05-23,Assembly,"Do pass",11,3,0,1,15
1955745,1583574,2025-06-02,Assembly,"AB 399 Boerner Assembly Third Reading",54,18,0,7,79
1955745,1594592,2025-06-24,Senate,"Do pass as amended, but first amend, and re-refer to the Committee on [Appropriations]",5,2,0,0,7
1955745,1597667,2025-07-07,Senate,"Placed on suspense file",6,0,0,1,7
1955745,1600775,2025-08-29,Senate,"Do pass as amended",5,2,0,0,7
1955745,1601158,2025-09-04,Senate,"Assembly 3rd Reading AB399 Boerner et al. By Padilla",29,10,0,1,40
1955745,1601318,2025-09-08,Assembly,"AB 399 Boerner Concurrence in Senate Amendments",58,18,0,4,80
1955746,1515268,2025-03-11,Assembly,"Do pass and be re-referred to the Committee on [Appropriations]",8,0,0,1,9
1955746,1577779,2025-05-23,Assembly,"Do pass",14,0,0,1,15
1955746,1583384,2025-06-02,Assembly,"AB 400 Pacheco Assembly Third Reading",71,0,0,8,79
1955746,1597256,2025-07-01,Senate,"Do pass, but first be re-referred to the Committee on [Appropriations]",5,0,0,1,6
1955746,1598286,2025-07-14,Senate,"Placed on suspense file",7,0,0,0,7
1955746,1600384,2025-08-29,Senate,"Do pass as amended",7,0,0,0,7
1955746,1601993,2025-09-11,Senate,"Special Consent AB400 Pacheco et al. By Rubio",40,0,0,0,40
1955746,1602184,2025-09-12,Assembly,"AB 400 Pacheco Concurrence in Senate Amendments",73,0,0,7,80
1955747,1529518,2025-03-26,Assembly,"Do pass and be re-referred to the Committee on [Appropriations]",9,0,0,0,9
1955748,1521985,2025-03-18,Assembly,"Do pass and be re-referred to the Committee on [Appropriations]",9,0,0,1,10
1955748,1577138,2025-05-23,Assembly,"Do pass as amended",11,1,0,3,15
1955748,1585110,2025-06-04,Assembly,"AB 402 Patel Assembly Third Reading",79,0,0,0,79
1955749,1526964,2025-03-25,Assembly,"Do pass and be re-referred to the Committee on [Appropriations] with recommendation: To Consent Calendar",15,0,0,0,15
1955751,1542814,2025-04-08,Assembly,"Do pass as amended and be re-referred to the Committee on [Natural Resources]",5,2,0,0,7
1955751,1559467,2025-04-28,Assembly,"Do pass as amended and be re-referred to the Committee on [Appropriations]",10,4,0,0,14
1955752,1528304,2025-03-26,Assembly,"Do pass and be re-referred to the Committee on [Appropriations] with recommendation: To Consent Calendar",18,0,0,0,18
1955752,1556080,2025-04-23,Assembly,"Do pass. To Consent Calendar",15,0,0,0,15
1955752,1564155,2025-05-01,Assembly,"AB 406 Bennett Consent Calendar Second Day Regular Session",76,0,0,3,79
1955752,1598073,2025-07-09,Senate,"Do pass, but first be re-referred to the Committee on [Judiciary]",4,1,0,0,5
1955752,1598586,2025-07-15,Senate,"Do pass, but first be re-referred to the Committee on [Appropriations]",11,0,0,2,13
1955752,1600993,2025-09-03,Senate,"Assembly 3rd Reading AB406 Schiavo By Smallwood-Cuevas Urgency Clause",30,2,0,8,40
1955752,1601725,2025-09-10,Assembly,"With recommendation: That Senate amendments be concurred in",5,0,0,2,7
1955753,1552887,2025-04-21,Assembly,"Do pass as amended and be re-referred to the Committee on [Local Government]",9,0,0,0,9
1955753,1564272,2025-04-30,Assembly,"Do pass as amended and be re-referred to the Committee on [Appropriations]",10,0,0,0,10
1955754,1554527,2025-04-22,Assembly,"Do pass and be re-referred to the Committee on [Judiciary]",16,0,0,2,18
1955754,1561055,2025-04-29,Assembly,"Do pass and be re-referred to the Committee on [Appropriations]",10,0,0,2,12
1955754,1575480,2025-05-21,Assembly,"Do pass",14,1,0,0,15
1955754,1579281,2025-05-27,Assembly,"AB 408 Berman Assembly Third Reading",72,0,0,7,79
1955754,1597728,2025-07-07,Senate,"Do pass, but first be re-referred to the Committee on [Judiciary]",7,1,0,3,11
1955755,1542905,2025-04-09,Assembly,"Do pass and be re-referred to the Committee on [Higher Education]",8,0,0,2,10
1955755,1555952,2025-04-22,Assembly,"Do pass",8,1,0,1,10
1955755,1569828,2025-05-12,Assembly,"AB 409 Arambula Assembly Third Reading",66,6,0,7,79
1955756,1535021,2025-04-01,Assembly,"Do pass as amended and be re-referred to the Committee on [Appropriations]",12,1,0,2,15
1955756,1577586,2025-05-23,Assembly,"Do pass",14,0,0,1,15
1955756,1584314,2025-06-03,Assembly,"AB 410 Wilson Assembly Third Reading",77,2,0,0,79
1955756,1598778,2025-07-15,Senate,"Do pass, but first be re-referred to the Committee on [Appropriations]",13,0,0,0,13
1955756,1599616,2025-08-18,Senate,"Placed on suspense file",7,0,0,0,7
1955757,1528270,2025-03-26,Assembly,"Do pass and be re-referred to the Committee on [Natural Resources]",8,0,0,0,8
1955757,1558705,2025-04-21,Assembly,"Do pass as amended and be re-referred to the Committee on [Appropriations]",14,0,0,0,14
1955757,1577912,2025-05-23,Assembly,"Do pass",14,0,0,1,15
1955757,1583380,2025-06-02,Assembly,"AB 411 Papan Assembly Third Reading",79,0,0,0,79
1955757,1597121,2025-07-01,Senate,"Do pass, but first be re-referred to the Committee on [Environmental Quality]",5,0,0,0,5
1955757,1598753,2025-07-16,Senate,"Do pass as amended, but first amend, and re-refer to the Committee on [Appropriations]",8,0,0,0,8
1955757,1599409,2025-08-18,Senate,"Placed on suspense file",7,0,0,0,7
1955757,1600390,2025-08-29,Senate,"Do pass",7,0,0,0,7
1955757,1601278,2025-09-08,Senate,"Assembly 3rd Reading AB411 Papan et al. By Blakespear",39,0,0,1,40
1955757,1601611,2025-09-09,Assembly,"AB 411 Papan Concurrence in Senate Amendments",77,0,0,3,80
1955758,1520437,2025-03-18,Assembly,"Do pass as amended and be re-referred to the Committee on [Judiciary]",10,3,0,2,15
1955758,1566713,2025-05-06,Assembly,"Do pass as amended",9,1,0,2,12
1955758,1569916,2025-05-12,Assembly,"AB 412 Bauer-Kahan Assembly Third Reading",45,16,0,18,79
1955759,1558373,2025-04-24,Assembly,"Do pass and be re-referred to the Committee on [Appropriations] with recommendation: To Consent Calendar",11,0,0,1,12
1955759,1577224,2025-05-23,Assembly,"Do pass",13,0,0,2,15
1955759,1583447,2025-06-02,Assembly,"AB 413 Fong Assembly Third Reading",79,0,0,0,79
1955759,1591838,2025-06-17,Senate,"Do pass, but first be re-referred to the Committee on [Appropriations] with the recommendation: To Consent Calendar",9,0,0,2,11
1955759,1596755,2025-06-30,Senate,"Placed on suspense file",6,0,0,1,7
1955759,1600579,2025-08-29,Senate,"Do pass",7,0,0,0,7
1955759,1601162,2025-09-04,Senate,"Special Consent AB413 Fong",39,0,0,1,40
1955760,1515266,2025-03-11,Assembly,"Do pass as amended. To Consent Calendar",12,0,0,0,12
1955760,1523694,2025-03-20,Assembly,"AB 414 Pellerin Consent Calendar Second Day",66,1,0,13,80
1955760,1595239,2025-06-24,Senate,"Do pass",11,0,0,2,13
1955760,1600839,2025-09-02,Senate,"Assembly 3rd Reading AB414 Pellerin By Laird",39,0,0,1,40
1955760,1600962,2025-09-03,Assembly,"AB 414 Pellerin Concurrence in Senate Amendments",76,0,0,3,79
1955761,1554624,2025-04-22,Assembly,"Do pass and be re-referred to the Committee on [Appropriations] with recommendation: To Consent Calendar",8,0,0,0,8
1955761,1571576,2025-05-14,Assembly,"Do pass. To Consent Calendar",15,0,0,0,15
1955761,1577846,2025-05-23,Assembly,"AB 415 Chen Consent Calendar Second Day Regular Session",71,0,0,8,79
1955762,1535113,2025-04-02,Senate,"Do pass, but first be re-referred to the Committee on [Appropriations] with the recommendation: To Consent Calendar",7,0,0,0,7
1955762,1552927,2025-04-21,Senate,"Placed on suspense file",6,0,0,1,7
1955762,1577749,2025-05-23,Senate,"Do pass as amended",6,0,0,1,7
1955762,1585113,2025-06-04,Senate,"Special Consent SB271 Reyes",39,0,0,1,40
1955762,1597974,2025-07-08,Assembly,"Do pass and be re-referred to the Committee on [Human Services] with recommendation: To Consent Calendar",10,0,0,0,10
1955762,1598407,2025-07-15,Assembly,"Do pass and be re-referred to the Committee on [Appropriations] with recommendation: To Consent Calendar",7,0,0,0,7
1955762,1600279,2025-08-29,Assembly,"Do pass",15,0,0,0,15
1955762,1602197,2025-09-12,Senate,"Unfinished Business SB271 Reyes Concurrence",37,0,0,3,40
1955762,1602198,2025-09-12,Assembly,"SB 271 Reyes Senate Third Reading By Fong",80,0,0,0,80
1955763,1526896,2025-03-25,Senate,"Do pass and be ordered to the Consent Calendar",14,0,0,1,15
1955763,1533494,2025-04-01,Senate,"Consent Calendar 2nd SB272 Becker",39,0,0,1,40
1955763,1592568,2025-06-18,Assembly,"Do pass. To Consent Calendar",10,0,0,0,10
1955763,1600217,2025-08-28,Assembly,"SB 272 Becker Senate Third Reading By Stefani",75,1,0,3,79
1955763,1600996,2025-09-03,Senate,"Unfinished Business SB272 Becker et al. Concurrence",40,0,0,0,40
1955765,1555979,2025-04-22,Senate,"Do pass, but first be re-referred to the Committee on [Public Safety]",10,2,0,1,13
1955765,1562937,2025-04-29,Senate,"Do pass as amended, but first amend, and re-refer to the Committee on [Appropriations]",5,1,0,0,6
1955765,1569800,2025-05-12,Senate,"Placed on suspense file",7,0,0,0,7
1955765,1577309,2025-05-23,Senate,"Do pass as amended",5,1,0,1,7
1955765,1584304,2025-06-03,Senate,"Senate 3rd Reading SB274 Cervantes",27,10,0,3,40
1955765,1584305,2025-06-03,Senate,"Senate 3rd Reading SB274 Cervantes Reconsider",39,0,0,1,40
1955765,1584306,2025-06-03,Senate,"Senate 3rd Reading SB274 Cervantes",26,10,0,4,40
1955765,1586939,2025-06-03,Senate,"Senate 3rd Reading SB274 Cervantes Motion to Reconsider",27,10,0,3,40
1955765,1586940,2025-06-03,Senate,"Senate 3rd Reading SB274 Cervantes Motion to Reconsider Reconsider",39,0,0,1,40
1955765,1586941,2025-06-03,Senate,"Senate 3rd Reading SB274 Cervantes Motion to Reconsider",26,10,0,4,40
1955765,1597652,2025-07-07,Assembly,"Do pass and be re-referred to the Committee on [Privacy and Consumer Protection]",12,4,0,0,16
1955765,1598554,2025-07-16,Assembly,"Do pass as amended and be re-referred to the Committee on [Appropriations]",9,4,0,2,15
1955765,1600703,2025-08-29,Assembly,"Do pass",10,3,0,2,15
1955765,1602355,2025-09-12,Senate,"Unfinished Business SB274 Cervantes et al. Concurrence",28,6,0,6,40
1955765,1602356,2025-09-13,Assembly,"SB 274 Cervantes Senate Third Reading By Bauer-Kahan",41,29,0,10,80
1955766,1528298,2025-03-26,Senate,"Do pass, but first be re-referred to the Committee on [Appropriations] with the recommendation: To Consent Calendar",5,0,0,0,5
1955766,1538914,2025-04-07,Senate,"Placed on suspense file",7,0,0,0,7
1955766,1577656,2025-05-23,Senate,"Do pass",6,0,0,1,7
1955766,1581728,2025-05-29,Senate,"Special Consent SB275 Smallwood-Cuevas",38,0,0,2,40
1955766,1595663,2025-06-25,Assembly,"Do pass and be re-referred to the Committee on [Appropriations] with recommendation: To Consent Calendar",7,0,0,0,7
1955766,1600760,2025-08-29,Assembly,"Do pass as amended",11,0,0,4,15
1955766,1601348,2025-09-08,Assembly,"SB 275 Smallwood-Cuevas Senate Third Reading By Ortega",78,1,0,1,80
1955766,1601585,2025-09-09,Senate,"Unfinished Business SB275 Smallwood-Cuevas Concurrence",40,0,0,0,40
1955767,1521948,2025-03-19,Senate,"Do pass, but first be re-referred to the Committee on [Public Safety]",7,0,0,0,7
1955767,1554525,2025-04-22,Senate,"Do pass as amended, but first amend, and re-refer to the Committee on [Appropriations]",6,0,0,0,6
1955767,1579254,2025-05-27,Senate,"Senate 3rd Reading SB276 Wiener et al. Urgency Clause",39,0,0,1,40
1955767,1597610,2025-07-02,Assembly,"Do pass and be re-referred to the Committee on [Public Safety]",10,0,0,0,10
1955767,1598708,2025-07-15,Assembly,"Do pass as amended",9,0,0,0,9
1955767,1600230,2025-08-28,Assembly,"SB 276 Wiener Third Reading Urgency By Stefani",65,2,0,12,79
1955767,1601130,2025-09-04,Senate,"Unfinished Business SB276 Wiener et al. Urgency Clause Concurrence",39,0,0,1,40
1955768,1540923,2025-04-08,Senate,"Do pass, but first be re-referred to the Committee on [Appropriations]",4,1,0,1,6
1955768,1552910,2025-04-21,Senate,"Placed on suspense file",6,0,0,1,7
1955769,1528318,2025-03-26,Senate,"Do pass, but first be re-referred to the Committee on [Judiciary] with the recommendation: To Consent Calendar",10,0,0,1,11
1955769,1542764,2025-04-08,Senate,"Do pass, but first be re-referred to the Committee on [Appropriations] with the recommendation: To Consent Calendar",13,0,0,0,13
1955769,1552872,2025-04-21,Senate,"Placed on suspense file",6,0,0,1,7
1955769,1577778,2025-05-23,Senate,"Do pass",6,0,0,1,7
1955769,1581773,2025-05-29,Senate,"Special Consent SB278 Cabaldon et al",38,0,0,2,40
1955769,1591894,2025-06-17,Assembly,"Do pass and be re-referred to the Committee on [Privacy and Consumer Protection] with recommendation: To Consent Calendar",15,0,0,1,16
1955769,1598609,2025-07-16,Assembly,"Do pass as amended, and be re-referred to the Committee on [Appropriations] with recommendation: To Consent Calendar",15,0,0,0,15
1955769,1600657,2025-08-29,Assembly,"Do pass as amended",11,0,0,4,15
1955769,1601349,2025-09-08,Assembly,"SB 278 Cabaldon Senate Third Reading By Mark González",79,0,0,1,80
1955769,1601618,2025-09-09,Senate,"Unfinished Business SB278 Cabaldon et al. Concurrence",40,0,0,0,40
1958461,1533567,2025-04-01,Assembly,"Do pass and be re-referred to the Committee on [Judiciary]",15,0,0,0,15
1958461,1566692,2025-05-06,Assembly,"Do pass as amended",12,0,0,0,12
1958461,1572389,2025-05-15,Assembly,"AB 416 Krell Assembly Third Reading",71,0,0,8,79
1958461,1597503,2025-07-02,Senate,"Do pass, but first be re-referred to the Committee on [Judiciary]",11,0,0,0,11
1958461,1598759,2025-07-15,Senate,"Do pass as amended, but first amend, and re-refer to the Committee on [Appropriations]",13,0,0,0,13
1958461,1599388,2025-08-18,Senate,"Placed on suspense file",7,0,0,0,7
1958461,1600319,2025-08-29,Senate,"Do pass",7,0,0,0,7
1958461,1600913,2025-09-03,Senate,"Assembly 3rd Reading AB416 Krell et al. By Menjivar",40,0,0,0,40
1958461,1601184,2025-09-04,Assembly,"AB 416 Krell Concurrence in Senate Amendments",75,0,0,4,79
1958462,1528296,2025-03-26,Assembly,"Do pass as amended",7,0,0,3,10
1958462,1533520,2025-04-01,Assembly,"AB 417 Carrillo Assembly Third Reading",62,0,0,18,80
1958462,1592606,2025-06-18,Senate,"Do pass",5,0,0,2,7
1958462,1600919,2025-09-03,Senate,"Assembly 3rd Reading AB417 Carrillo By Durazo",31,5,0,4,40
1958463,1515267,2025-03-10,Assembly,"Do pass and be re-referred to the Committee on [Appropriations]",7,0,0,0,7
1958463,1526970,2025-03-25,Assembly,"Do pass and be re-referred to the Committee on [Appropriations] with recommendation: To Consent Calendar",12,0,0,0,12
1958463,1542802,2025-04-09,Assembly,"Do pass. To Consent Calendar",14,0,0,1,15
1958463,1557574,2025-04-24,Assembly,"AB 418 Wilson Consent Calendar Second Day Regular Session",75,0,0,4,79
1958463,1595152,2025-06-25,Senate,"Do pass, but first be re-referred to the Committee on [Judiciary]",5,0,0,0,5
1958463,1597935,2025-07-08,Senate,"Do pass, but first be re-referred to the Committee on [Appropriations] with the recommendation: To Consent Calendar",13,0,0,0,13
1958463,1600060,2025-08-25,Senate,"Consent Calendar 2nd AB418 Wilson et al. By Seyarto",37,0,0,3,40
1958464,1529522,2025-03-26,Assembly,"Do pass and be re-referred to the Committee on [Judiciary]",7,2,0,0,9
1958464,1540888,2025-04-08,Assembly,"Do pass and be re-referred to the Committee on [Appropriations]",9,1,0,2,12
1958464,1577226,2025-05-23,Assembly,"Do pass",11,1,0,3,15
1958464,1583358,2025-06-02,Assembly,"AB 419 Connolly Assembly Third Reading",64,8,0,7,79
1958464,1595155,2025-06-25,Senate,"Do pass, but first be re-referred to the Committee on [Judiciary]",6,1,0,0,7
1958464,1597934,2025-07-08,Senate,"Do pass, but first be re-referred to the Committee on [Appropriations]",11,1,0,1,13
1958464,1599543,2025-08-18,Senate,"Placed on suspense file",7,0,0,0,7
1958464,1600696,2025-08-29,Senate,"Do pass",5,2,0,0,7
1958464,1601769,2025-09-10,Senate,"Assembly 3rd Reading AB419 Connolly By Pérez",31,8,0,1,40
1958465,1556201,2025-04-23,Assembly,"Do pass as amended, and be re-referred to the Committee on [Appropriations] with recommendation: To Consent Calendar",18,0,0,0,18
1958465,1571575,2025-05-14,Assembly,"Do pass. To Consent Calendar",15,0,0,0,15
1958465,1577890,2025-05-23,Assembly,"AB 420 Petrie-Norris Consent Calendar Second Day Regular Session",71,0,0,8,79
1958465,1598472,2025-07-15,Senate,"Do pass as amended, but first amend, and re-refer to the Committee on [Appropriations] with the recommendation: To Consent Calendar",16,0,0,1,17
1958465,1600034,2025-08-25,Senate,"Consent Calendar 2nd AB420 Petrie-Norris",37,0,0,3,40
1958465,1600877,2025-09-03,Assembly,"AB 420 Petrie-Norris Concurrence in Senate Amendments",79,0,0,0,79
1958467,1545005,2025-04-09,Assembly,"Do pass as amended, and be re-referred to the Committee on [Appropriations] with recommendation: To Consent Calendar",9,0,0,0,9
1958467,1577672,2025-05-23,Assembly,"Do pass",14,0,0,1,15
1958467,1583487,2025-06-02,Assembly,"AB 422 Jackson Assembly Third Reading",79,0,0,0,79
1958467,1595218,2025-06-25,Senate,"Do pass, but first be re-referred to the Committee on [Appropriations]",7,0,0,0,7
1958467,1597724,2025-07-07,Senate,"Placed on suspense file",6,0,0,1,7
1958467,1600660,2025-08-29,Senate,"Do pass",7,0,0,0,7
1958467,1601732,2025-09-10,Senate,"Assembly 3rd Reading AB422 Jackson By Hurtado",40,0,0,0,40
1958469,1556109,2025-04-22,Assembly,"Do pass and be re-referred to the Committee on [Appropriations] with recommendation: To Consent Calendar",16,0,0,0,16
1958469,1575478,2025-05-21,Assembly,"Do pass. To Consent Calendar",15,0,0,0,15
1958469,1579286,2025-05-27,Assembly,"AB 424 Davies Consent Calendar Second Day Regular Session",76,0,0,3,79
1958469,1595657,2025-06-25,Senate,"Do pass, but first be re-referred to the Committee on [Appropriations] with the recommendation: To Consent Calendar",11,0,0,0,11
1958469,1598250,2025-07-14,Senate,"Placed on suspense file",7,0,0,0,7
1958469,1600419,2025-08-29,Senate,"Do pass",7,0,0,0,7
1958469,1601175,2025-09-04,Senate,"Special Consent AB424 Davies",39,0,0,1,40
1958470,1555916,2025-04-22,Assembly,"Do pass as amended and be re-referred to the Committee on [Appropriations]",16,0,0,0,16
1958471,1540820,2025-04-07,Assembly,"Do pass and be re-referred to the Committee on [Judiciary]",7,0,0,0,7
1958471,1554578,2025-04-22,Assembly,"Do pass and be re-referred to the Committee on [Appropriations] with recommendation: To Consent Calendar",12,0,0,0,12
1958471,1577390,2025-05-23,Assembly,"Do pass",14,0,0,1,15
1958471,1585808,2025-06-05,Assembly,"AB 426 Dixon Assembly Third Reading",76,0,0,3,79
1958471,1597837,2025-07-08,Senate,"Do pass, but first be re-referred to the Committee on [Appropriations]",12,0,0,1,13
1958471,1599545,2025-08-18,Senate,"Placed on suspense file",7,0,0,0,7
1958472,1540955,2025-04-08,Assembly,"Do pass as amended and be re-referred to the Committee on [Judiciary]",16,0,0,2,18
1958472,1554598,2025-04-22,Assembly,"Do pass and be re-referred to the Committee on [Appropriations] with recommendation: To Consent Calendar",12,0,0,0,12
1958473,1534999,2025-04-02,Assembly,"Do pass and be re-referred to the Committee on [Local Government]",17,0,0,0,17
1958473,1542860,2025-04-09,Assembly,"Do pass and be re-referred to the Committee on [Appropriations]",10,0,0,0,10
1958473,1556010,2025-04-23,Assembly,"Do pass",15,0,0,0,15
1958473,1565340,2025-05-05,Assembly,"AB 428 Blanca Rubio Assembly Third Reading",76,0,0,3,79
1958473,1592586,2025-06-18,Senate,"Do pass, but first be re-referred to the Committee on [Energy, Utilities and Communications]",7,0,0,0,7
1958473,1597709,2025-07-07,Senate,"Do pass, but first be re-referred to the Committee on [Appropriations]",16,0,0,1,17
1958473,1600950,2025-09-03,Senate,"Assembly 3rd Reading AB428 Blanca Rubio By McNerney",38,1,0,1,40
1958474,1566700,2025-05-05,Assembly,"Do pass as amended and be re-referred to the Committee on [Appropriations]",7,0,0,0,7
1958474,1577610,2025-05-23,Assembly,"Do pass",14,0,0,1,15
1958474,1585001,2025-06-04,Assembly,"AB 429 Hadwick Third Reading Urgency",77,0,0,2,79
1958475,1563110,2025-04-29,Assembly,"Do pass as amended and be re-referred to the Committee on [Appropriations]",12,0,0,1,13
1958476,1561016,2025-04-28,Assembly,"Do pass as amended and be re-referred to the Committee on [Appropriations]",15,0,0,1,16
1958476,1577234,2025-05-23,Assembly,"Do pass",14,0,0,1,15
1958476,1583470,2025-06-02,Assembly,"AB 431 Wilson Assembly Third Reading",79,0,0,0,79
1958477,1554555,2025-04-22,Assembly,"Do pass as amended and be re-referred to the Committee on [Health]",14,0,0,4,18
1958477,1563060,2025-04-29,Assembly,"Do pass and be re-referred to the Committee on [Appropriations]",15,0,0,1,16
1958477,1577857,2025-05-23,Assembly,"Do pass as amended",11,0,0,4,15
1958477,1584390,2025-06-03,Assembly,"AB 432 Bauer-Kahan Assembly Third Reading",70,1,0,8,79
1958477,1597675,2025-07-07,Senate,"Do pass, but first be re-referred to the Committee on [Health]",9,0,0,2,11
1958477,1598833,2025-07-16,Senate,"Do pass as amended, but first amend, and re-refer to the Committee on [Appropriations]",10,0,0,1,11
1958477,1599405,2025-08-18,Senate,"Placed on suspense file",7,0,0,0,7
1958477,1600405,2025-08-29,Senate,"Do pass as amended",7,0,0,0,7
1958477,1601677,2025-09-09,Senate,"Assembly 3rd Reading AB432 Bauer-Kahan et al. By Rubio",39,0,0,1,40
1958478,1562802,2025-04-29,Assembly,"Do pass and be re-referred to the Committee on [Appropriations]",2,4,0,3,9
1958480,1485611,2025-02-10,Assembly,"Be adopted. To Consent Calendar",9,0,0,2,11
1958480,1517824,2025-03-13,Senate,"Special Consent ACR26 Bonta et al",36,0,0,4,40
1958481,1492774,2025-02-18,Assembly,"Be adopted. To third reading",10,0,0,1,11
1958481,1517825,2025-03-13,Senate,"Special Consent ACR27 Blanca Rubio et al",36,0,0,4,40
1958482,1492766,2025-02-18,Assembly,"Be adopted. To third reading",10,0,0,1,11
1958482,1536795,2025-04-03,Senate,"Special Consent ACR28 Ortega et al",39,0,0,1,40
1958483,1492777,2025-02-18,Assembly,"Be adopted. To third reading",10,0,0,1,11
1958484,1521982,2025-03-19,Senate,"Do pass as amended, but first amend, and re-refer to the Committee on [Appropriations]",7,0,0,1,8
1958484,1538961,2025-04-07,Senate,"Placed on suspense file",7,0,0,0,7
1958484,1577793,2025-05-23,Senate,"Do pass as amended",5,0,0,2,7
1958484,1581775,2025-05-29,Senate,"Senate 3rd Reading SB279 McNerney et al",38,0,0,2,40
1958484,1597755,2025-07-07,Assembly,"Do pass and be re-referred to the Committee on [Appropriations]",14,0,0,0,14
1958484,1600601,2025-08-29,Assembly,"Do pass as amended",11,0,0,4,15
1958484,1601350,2025-09-08,Assembly,"SB 279 McNerney Senate Third Reading By Soria",79,0,0,1,80
1958484,1601598,2025-09-09,Senate,"Unfinished Business SB279 McNerney et al. Concurrence",40,0,0,0,40
1958485,1533541,2025-04-01,Senate,"Do pass, but first be re-referred to the Committee on [Appropriations]",5,0,0,0,5
1958485,1581736,2025-05-29,Senate,"Senate 3rd Reading SB280 Cervantes et al",38,0,0,2,40
1958485,1597488,2025-07-02,Assembly,"Do pass and be re-referred to the Committee on [Appropriations] with recommendation: To Consent Calendar",7,0,0,0,7
1958485,1598598,2025-07-16,Assembly,"Do pass. To Consent Calendar",13,0,0,2,15
1958485,1599696,2025-08-19,Assembly,"Do pass and be re-referred to the Committee on [Appropriations]",5,2,0,0,7
1958485,1599721,2025-08-20,Assembly,"Do pass",11,4,0,0,15
1958485,1599868,2025-08-21,Senate,"Unfinished Business SB280 Cervantes et al. Urgency Clause Concurrence",30,8,0,2,40
1958485,1599869,2025-08-21,Assembly,"SB 280 Cervantes Third Reading Urgency By Pellerin Amend By GALLAGHER Set #2 Motion to Lay on the Table By AGUIAR-CURRY",54,19,0,6,79
1958485,1599870,2025-08-21,Assembly,"SB 280 Cervantes Third Reading Urgency By Pellerin Amend By CASTILLO Set #1 Motion to Lay on the Table By AGUIAR-CURRY",56,19,0,4,79
1958485,1599871,2025-08-21,Assembly,"SB 280 Cervantes Third Reading Urgency By Pellerin Amend By GALLAGHER Set #3 Motion to Lay on the Table By AGUIAR-CURRY",56,19,0,4,79
1958485,1599872,2025-08-21,Assembly,"SB 280 Cervantes Third Reading Urgency By Pellerin Amend By TANGIPA Set #4 Motion to Lay on the Table By AGUIAR-CURRY",54,19,0,6,79
1958485,1599873,2025-08-21,Assembly,"SB 280 Cervantes Third Reading Urgency By Pellerin",57,20,0,2,79
1958486,1526989,2025-03-25,Senate,"Do pass",5,1,0,0,6
1958486,1580495,2025-05-28,Senate,"Senate 3rd Reading SB281 Pérez",28,10,0,2,40
1958486,1591872,2025-06-17,Assembly,"Do pass",7,2,0,0,9
1958486,1600221,2025-08-28,Assembly,"SB 281 Pérez Senate Third Reading By Gabriel",53,18,0,8,79
1958486,1600977,2025-09-03,Senate,"Unfinished Business SB281 Pérez et al. Concurrence",30,10,0,0,40
1958487,1538915,2025-04-07,Senate,"Do pass, but first be re-referred to the Committee on [Local Government]",13,0,0,4,17
1958487,1556097,2025-04-23,Senate,"Do pass as amended, but first amend, and re-refer to the Committee on [Appropriations]",5,0,0,2,7
1958487,1569815,2025-05-12,Senate,"Placed on suspense file",7,0,0,0,7
1958488,1554530,2025-04-21,Senate,"Do pass, but first be re-referred to the Committee on [Local Government]",16,0,0,1,17
1958488,1562753,2025-04-30,Senate,"Do pass as amended, but first amend, and re-refer to the Committee on [Appropriations]",7,0,0,0,7
1958488,1573543,2025-05-19,Senate,"Placed on suspense file",5,0,0,2,7
1958488,1577626,2025-05-23,Senate,"Do pass",6,0,0,1,7
1958488,1580507,2025-05-28,Senate,"Senate 3rd Reading SB283 Laird",38,0,0,2,40
1958488,1595210,2025-06-25,Assembly,"Do pass as amended and be re-referred to the Committee on [Local Government]",18,0,0,0,18
1958488,1598840,2025-07-16,Assembly,"Do pass as amended and be re-referred to the Committee on [Appropriations]",10,0,0,0,10
1958488,1599746,2025-08-20,Assembly,"Do pass",15,0,0,0,15
1958488,1601493,2025-09-09,Assembly,"SB 283 Laird Senate Third Reading By Petrie-Norris",80,0,0,0,80
1958488,1601766,2025-09-10,Senate,"Unfinished Business SB283 Laird et al. Concurrence",40,0,0,0,40
1958489,1571548,2025-05-14,Senate,"Do pass, but first be re-referred to the Committee on [Appropriations]",5,0,0,0,5
1958489,1573516,2025-05-19,Senate,"Placed on suspense file",5,0,0,2,7
1958489,1577282,2025-05-23,Senate,"Do pass",6,0,0,1,7
1958489,1581763,2025-05-29,Senate,"Special Consent SB284 Seyarto",38,0,0,2,40
1958490,1536855,2025-04-02,Senate,"Do pass, but first be re-referred to the Committee on [Appropriations]",6,2,0,0,8
1958490,1552949,2025-04-21,Senate,"Placed on suspense file",6,0,0,1,7
1961044,1525453,2025-03-24,Assembly,"Do pass and be re-referred to the Committee on [Appropriations]",12,0,0,4,16
1961044,1567885,2025-05-07,Assembly,"Do pass",11,2,0,2,15
1961044,1577529,2025-05-23,Assembly,"AB 435 Wilson Assembly Third Reading",35,12,0,32,79
1961044,1585022,2025-06-04,Assembly,"AB 435 Wilson Assembly Third Reading",42,16,0,21,79
1961044,1597896,2025-07-08,Senate,"Do pass, but first be re-referred to the Committee on [Appropriations]",14,0,0,1,15
1961044,1600801,2025-09-02,Senate,"Assembly 3rd Reading AB435 Wilson By Cortese",40,0,0,0,40
1961044,1601320,2025-09-08,Assembly,"AB 435 Wilson Concurrence in Senate Amendments",49,13,0,18,80
1961045,1525469,2025-03-24,Assembly,"Do pass and be re-referred to the Committee on [Local Government]",13,0,0,1,14
1961045,1542806,2025-04-09,Assembly,"Do pass and be re-referred to the Committee on [Appropriations]",10,0,0,0,10
1961046,1520453,2025-03-18,Assembly,"Do pass as amended",9,0,0,0,9
1961046,1530388,2025-03-28,Assembly,"AB 437 Lackey Assembly Third Reading",62,0,0,18,80
1961046,1592584,2025-06-18,Senate,"Do pass and be ordered to the Consent Calendar",7,0,0,0,7
1961047,1554564,2025-04-21,Assembly,"Do pass and be re-referred to the Committee on [Appropriations] with recommendation: To Consent Calendar",15,0,0,1,16
1961047,1567924,2025-05-07,Assembly,"Do pass. To Consent Calendar",15,0,0,0,15
1961047,1572440,2025-05-15,Assembly,"AB 438 Hadwick Consent Calendar Second Day",69,0,0,10,79
1961047,1588093,2025-06-10,Senate,"Do pass, but first be re-referred to the Committee on [Appropriations]",13,0,0,2,15
1961047,1600832,2025-09-02,Senate,"Assembly 3rd Reading AB438 Hadwick By Limón",40,0,0,0,40
1961047,1601075,2025-09-04,Assembly,"AB 438 Hadwick Concurrence in Senate Amendments",77,0,0,2,79
1961048,1525449,2025-03-24,Assembly,"Do pass and be re-referred to the Committee on [Appropriations]",11,1,0,2,14
1961048,1542817,2025-04-09,Assembly,"Do pass",10,2,0,3,15
1961048,1559400,2025-04-28,Assembly,"AB 439 Rogers Assembly Third Reading",54,13,0,12,79
1961048,1588053,2025-06-10,Senate,"Do pass, but first be re-referred to the Committee on [Appropriations]",6,1,0,0,7
1961048,1600983,2025-09-03,Senate,"Assembly 3rd Reading AB439 Rogers By Allen",31,8,0,1,40
1961049,1540801,2025-04-08,Assembly,"Do pass as amended, and be re-referred to the Committee on [Appropriations] with recommendation: To Consent Calendar",15,0,0,0,15
1961049,1577378,2025-05-23,Assembly,"Do pass",14,0,0,1,15
1961049,1583417,2025-06-02,Assembly,"AB 440 Ramos Assembly Third Reading",79,0,0,0,79
1961049,1595664,2025-06-25,Senate,"Do pass, but first be re-referred to the Committee on [Appropriations] with the recommendation: To Consent Calendar",11,0,0,0,11
1961049,1598303,2025-07-14,Senate,"Placed on suspense file",7,0,0,0,7
1961049,1600387,2025-08-29,Senate,"Do pass",7,0,0,0,7
1961049,1601241,2025-09-08,Senate,"Assembly 3rd Reading AB440 Ramos et al. By Rubio",39,0,0,1,40
1961049,1601623,2025-09-09,Assembly,"AB 440 Ramos Concurrence in Senate Amendments",80,0,0,0,80
1961050,1540889,2025-04-07,Assembly,"Do pass and be re-referred to the Committee on [Appropriations]",7,0,0,0,7
1961050,1577444,2025-05-23,Assembly,"Do pass as amended",14,0,0,1,15
1961050,1585068,2025-06-04,Assembly,"AB 441 Hadwick Assembly Third Reading",78,0,0,1,79
1961050,1594566,2025-06-24,Senate,"Do pass, but first be re-referred to the Committee on [Natural Resources and Water] with the recommendation: To Consent Calendar",15,0,0,0,15
1961052,1535121,2025-04-02,Assembly,"Do pass and be re-referred to the Committee on [Appropriations] with recommendation: To Consent Calendar",18,0,0,0,18
1961052,1537461,2025-04-02,Assembly,"Do pass and be re-referred to the Committee on [Natural Resources] with recommendation: To Consent Calendar",18,0,0,0,18
1961052,1558727,2025-04-21,Assembly,"Do pass and be re-referred to the Committee on [Appropriations] with recommendation: To Consent Calendar",14,0,0,0,14
1961052,1577955,2025-05-23,Assembly,"Do pass",14,0,0,1,15
1961052,1583362,2025-06-02,Assembly,"AB 443 Bennett Assembly Third Reading",79,0,0,0,79
1961052,1597210,2025-07-01,Senate,"Do pass, but first be re-referred to the Committee on [Appropriations]",17,0,0,0,17
1961052,1598239,2025-07-14,Senate,"Placed on suspense file",7,0,0,0,7
1961054,1562832,2025-04-30,Assembly,"Do pass as amended and be re-referred to the Committee on [Appropriations]",20,0,0,2,22
1961054,1571564,2025-05-14,Assembly,"Do pass",15,0,0,0,15
1961054,1573588,2025-05-19,Assembly,"AB 445 Aguiar-Curry Assembly Third Reading",75,0,0,4,79
1961054,1588077,2025-06-10,Senate,"Do pass, but first be re-referred to the Committee on [Appropriations]",14,0,0,1,15
1961054,1594081,2025-06-23,Senate,"Placed on suspense file",7,0,0,0,7
1961054,1600382,2025-08-29,Senate,"Do pass as amended",7,0,0,0,7
1961054,1601927,2025-09-11,Senate,"Special Consent AB445 Aguiar-Curry By Niello",40,0,0,0,40
1961054,1602157,2025-09-12,Assembly,"AB 445 Aguiar-Curry Concurrence in Senate Amendments",79,0,0,1,80
1961055,1520418,2025-03-18,Assembly,"Do pass as amended and be re-referred to the Committee on [Judiciary]",10,3,0,2,15
1961055,1566683,2025-05-06,Assembly,"Do pass",8,3,0,1,12
1961055,1569831,2025-05-12,Assembly,"AB 446 Ward Assembly Third Reading",47,20,0,12,79
1961055,1598735,2025-07-15,Senate,"Do pass as amended, but first amend, and re-refer to the Committee on [Appropriations]",10,2,0,1,13
1961055,1599572,2025-08-18,Senate,"Placed on suspense file",7,0,0,0,7
1961055,1600372,2025-08-29,Senate,"Do pass as amended",4,2,0,1,7
1961056,1540894,2025-04-08,Assembly,"Do pass as amended and be re-referred to the Committee on [Health]",15,0,0,3,18
1961056,1562907,2025-04-29,Assembly,"Do pass as amended, and be re-referred to the Committee on [Appropriations] with recommendation: To Consent Calendar",16,0,0,0,16
1961056,1571599,2025-05-14,Assembly,"Do pass. To Consent Calendar",15,0,0,0,15
1961056,1577194,2025-05-23,Assembly,"AB 447 Mark González Consent Calendar Second Day Regular Session",71,0,0,8,79
1961056,1594094,2025-06-23,Senate,"Do pass, but first be re-referred to the Committee on [Health] with the recommendation: To Consent Calendar",11,0,0,0,11
1961056,1597497,2025-07-02,Senate,"Do pass, but first be re-referred to the Committee on [Appropriations] with the recommendation: To Consent Calendar",11,0,0,0,11
1961056,1600053,2025-08-25,Senate,"Consent Calendar 2nd AB447 Mark González",37,0,0,3,40
1961057,1562915,2025-04-29,Assembly,"Do pass and be re-referred to the Committee on [Appropriations]",16,0,0,0,16
1961058,1527002,2025-03-25,Assembly,"Do pass and be re-referred to the Committee on [Appropriations]",10,0,0,2,12
1961058,1577470,2025-05-23,Assembly,"Do pass",11,0,0,4,15
1961058,1583458,2025-06-02,Assembly,"AB 449 Jackson Assembly Third Reading",66,1,0,12,79
1961058,1597495,2025-07-01,Senate,"Do pass, but first be re-referred to the Committee on [Appropriations]",11,0,0,2,13
1961058,1598294,2025-07-14,Senate,"Placed on suspense file",7,0,0,0,7
1961058,1600271,2025-08-29,Senate,"Do pass",4,0,0,3,7
1961058,1601260,2025-09-08,Senate,"Assembly 3rd Reading AB449 Jackson By Durazo",30,2,0,8,40
1961058,1601601,2025-09-09,Assembly,"AB 449 Jackson Concurrence in Senate Amendments",64,5,0,11,80
1961059,1554483,2025-04-22,Assembly,"Do pass and be re-referred to the Committee on [Human Services]",6,1,0,0,7
1961059,1562969,2025-04-29,Assembly,"Do pass as amended and be re-referred to the Committee on [Appropriations]",5,2,0,0,7
1961059,1577790,2025-05-23,Assembly,"Do pass",11,2,0,2,15
1961059,1583550,2025-06-02,Assembly,"AB 450 Carrillo Assembly Third Reading",64,7,0,8,79
1961059,1597772,2025-07-07,Senate,"Do pass as amended, but first amend, and re-refer to the Committee on [Appropriations]",4,0,0,1,5
1961059,1599390,2025-08-18,Senate,"Placed on suspense file",7,0,0,0,7
1961059,1600367,2025-08-29,Senate,"Do pass as amended",5,2,0,0,7
1961059,1601668,2025-09-09,Senate,"Assembly 3rd Reading AB450 Carrillo et al. By Padilla",31,8,0,1,40
1961060,1515273,2025-03-11,Assembly,"Do pass and be re-referred to the Committee on [Appropriations] with recommendation: To Consent Calendar",8,0,0,1,9
1961060,1577659,2025-05-23,Assembly,"Do pass",14,0,0,1,15
1961060,1583408,2025-06-02,Assembly,"AB 451 Petrie-Norris Assembly Third Reading",78,0,0,1,79
1961060,1594589,2025-06-24,Senate,"Do pass as amended, but first amend, and re-refer to the Committee on [Judiciary]",6,0,0,0,6
1961060,1597972,2025-07-08,Senate,"Do pass, but first be re-referred to the Committee on [Appropriations]",13,0,0,0,13
1961060,1599493,2025-08-18,Senate,"Placed on suspense file",7,0,0,0,7
1961060,1600556,2025-08-29,Senate,"Do pass",7,0,0,0,7
1961060,1601992,2025-09-11,Senate,"Assembly 3rd Reading AB451 Petrie-Norris By Blakespear",40,0,0,0,40
1961060,1602155,2025-09-12,Assembly,"AB 451 Petrie-Norris Concurrence in Senate Amendments",80,0,0,0,80
1961061,1538907,2025-04-07,Assembly,"Do pass as amended and be re-referred to the Committee on [Appropriations]",10,0,0,4,14
1961062,1545007,2025-04-09,Assembly,"Do pass as amended, and be re-referred to the Committee on [Appropriations] with recommendation: To Consent Calendar",9,0,0,0,9
1961063,1526931,2025-03-25,Assembly,"Do pass as amended and be re-referred to the Committee on [Appropriations]",10,3,0,0,13
1961063,1542878,2025-04-09,Assembly,"Do pass",10,4,0,1,15
1961063,1573577,2025-05-19,Assembly,"AB 454 Kalra Third Reading Urgency",59,12,0,8,79
1961063,1588085,2025-06-10,Senate,"Do pass, but first be re-referred to the Committee on [Appropriations]",5,2,0,0,7
1961063,1600963,2025-09-03,Senate,"Assembly 3rd Reading AB454 Kalra et al. By Allen Urgency Clause",30,10,0,0,40
1961063,1601173,2025-09-04,Assembly,"AB 454 Kalra Concurrence in Senate Amendments",58,17,0,4,79
1961064,1540884,2025-04-08,Assembly,"Do pass and be re-referred to the Committee on [Environmental Safety and Toxic Materials] with recommendation: To Consent Calendar",12,0,0,0,12
1961064,1561197,2025-04-29,Assembly,"Do pass and be re-referred to the Committee on [Appropriations] with recommendation: To Consent Calendar",7,0,0,0,7
1961064,1571608,2025-05-14,Assembly,"Do pass. To Consent Calendar",15,0,0,0,15
1961064,1577711,2025-05-23,Assembly,"AB 455 Ortega Consent Calendar Second Day Regular Session",71,0,0,8,79
1961064,1597483,2025-07-02,Senate,"Do pass as amended, but first amend, and re-refer to the Committee on [Judiciary]",8,0,0,0,8
1961064,1598730,2025-07-15,Senate,"Do pass as amended, but first amend, and re-refer to the Committee on [Appropriations]",13,0,0,0,13
1961064,1600985,2025-09-03,Senate,"Assembly 3rd Reading AB455 Ortega By Menjivar",40,0,0,0,40
1961064,1601070,2025-09-04,Assembly,"AB 455 Ortega Concurrence in Senate Amendments",77,0,0,2,79
1961065,1567868,2025-05-07,Assembly,"Do pass as amended",8,1,0,3,12
1961065,1585806,2025-06-05,Assembly,"AB 456 Connolly Assembly Third Reading",74,0,0,5,79
1961065,1597400,2025-07-01,Senate,"Do pass and be ordered to the Consent Calendar",13,0,0,0,13
1961065,1598165,2025-07-10,Senate,"Consent Calendar 2nd AB456 Connolly",37,0,0,3,40
1961066,1542816,2025-04-09,Assembly,"Do pass and be re-referred to the Committee on [Appropriations] with recommendation: To Consent Calendar",12,0,0,0,12
1961066,1555987,2025-04-23,Assembly,"Do pass. To Consent Calendar",15,0,0,0,15
1961066,1564241,2025-05-01,Assembly,"AB 457 Soria Consent Calendar Second Day Regular Session",76,0,0,3,79
1961066,1591861,2025-06-17,Senate,"Do pass, but first be re-referred to the Committee on [Local Government] with the recommendation: To Consent Calendar",9,0,0,2,11
1961066,1598689,2025-07-16,Senate,"Do pass, but first be re-referred to the Committee on [Appropriations] with the recommendation: To Consent Calendar",7,0,0,0,7
1961066,1600045,2025-08-25,Senate,"Consent Calendar 2nd AB457 Soria et al",37,0,0,3,40
1961067,1535128,2025-04-01,Assembly,"Do pass as amended and be re-referred to the Committee on [Appropriations]",8,0,0,1,9
1961067,1577818,2025-05-23,Assembly,"Do pass as amended",11,2,0,2,15
1961067,1584326,2025-06-03,Assembly,"AB 458 Stefani Assembly Third Reading",66,3,0,10,79
1961068,1562946,2025-04-30,Assembly,"Do pass and be re-referred to the Committee on [Appropriations]",2,4,0,1,7
1961068,1562947,2025-04-30,Assembly,Reconsideration,5,0,0,2,7
1961069,1533532,2025-04-01,Assembly,"Do pass and be re-referred to the Committee on [Appropriations]",15,0,0,0,15
1961069,1577275,2025-05-23,Assembly,"Do pass",14,0,0,1,15
1961069,1584228,2025-06-03,Assembly,"AB 460 Chen Assembly Third Reading",77,0,0,2,79
1961069,1597420,2025-07-02,Senate,"Do pass as amended, but first amend, and re-refer to the Committee on [Appropriations]",11,0,0,0,11
1961069,1599612,2025-08-18,Senate,"Placed on suspense file",7,0,0,0,7
1961069,1600767,2025-08-29,Senate,"Do pass",7,0,0,0,7
1961069,1601464,2025-09-09,Senate,"Assembly 3rd Reading AB460 Chen By Valladares",40,0,0,0,40
1961069,1602320,2025-09-12,Assembly,"AB 460 Chen Concurrence in Senate Amendments",78,0,0,2,80
1961070,1540851,2025-04-08,Assembly,"Do pass and be re-referred to the Committee on [Public Safety]",5,1,0,0,6
1961070,1562917,2025-04-29,Assembly,"Do pass and be re-referred to the Committee on [Appropriations]",7,0,0,2,9
1961070,1577694,2025-05-23,Assembly,"Do pass",11,2,0,2,15
1961070,1583488,2025-06-02,Assembly,"AB 461 Ahrens Assembly Third Reading",60,9,0,10,79
1961070,1597203,2025-06-30,Senate,"Do pass, but first be re-referred to the Committee on [Public Safety]",4,1,0,0,5
1961070,1598367,2025-07-15,Senate,"Do pass, but first be re-referred to the Committee on [Appropriations]",5,1,0,0,6
1961070,1599435,2025-08-18,Senate,"Placed on suspense file",7,0,0,0,7
1961070,1600721,2025-08-29,Senate,"Do pass as amended",5,2,0,0,7
1961070,1601566,2025-09-09,Senate,"Assembly 3rd Reading AB461 Ahrens et al. By Pérez",29,9,0,2,40
1961071,1516564,2025-03-12,Assembly,"Do pass and be re-referred to the Committee on [Appropriations]",11,0,0,1,12
1961071,1522013,2025-03-19,Assembly,"Do pass",15,0,0,0,15
1961071,1533550,2025-04-01,Assembly,"AB 462 Lowenthal Third Reading Urgency",77,0,0,3,80
1961071,1597902,2025-07-08,Senate,"Do pass as amended, but first amend, and re-refer to the Committee on [Housing]",7,0,0,0,7
1961071,1598423,2025-07-15,Senate,"Do pass as amended, but first amend, and re-refer to the Committee on [Appropriations]",10,0,0,1,11
1961071,1599516,2025-08-18,Senate,"Placed on suspense file",7,0,0,0,7
1961071,1600348,2025-08-29,Senate,"Do pass as amended",7,0,0,0,7
1961071,1601839,2025-09-11,Senate,"Assembly 3rd Reading AB462 Lowenthal et al. By Grayson Urgency Clause",39,0,0,1,40
1961071,1602166,2025-09-12,Assembly,"AB 462 Lowenthal Concurrence in Senate Amendments",79,0,0,1,80
1961072,1556021,2025-04-22,Assembly,"Do pass as amended, and be re-referred to the Committee on [Appropriations] with recommendation: To Consent Calendar",16,0,0,0,16
1961072,1567916,2025-05-07,Assembly,"Do pass. To Consent Calendar",15,0,0,0,15
1961072,1572415,2025-05-15,Assembly,"AB 463 Michelle Rodriguez Consent Calendar Second Day Regular Session",69,0,0,10,79
1961072,1589091,2025-06-11,Senate,"Do pass as amended, but first amend, and re-refer to the Committee on [Judiciary] with the recommendation: To Consent Calendar",9,0,0,2,11
1961072,1597461,2025-07-01,Senate,"Do pass, but first be re-referred to the Committee on [Appropriations] with the recommendation: To Consent Calendar",13,0,0,0,13
1961072,1598907,2025-07-17,Senate,"Consent Calendar 2nd AB463 Michelle Rodriguez",35,0,0,5,40
1961072,1599564,2025-08-18,Assembly,"AB 463 Michelle Rodriguez Concurrence in Senate Amendments",76,0,0,3,79
1961073,1515251,2025-03-11,Assembly,"Do pass as amended, and be re-referred to the Committee on [Judiciary] with recommendation: To Consent Calendar",8,0,0,1,9
1961073,1526972,2025-03-25,Assembly,"Do pass as amended and be re-referred to the Committee on [Appropriations]",12,0,0,0,12
1961074,1535090,2025-04-02,Assembly,"Do pass and be re-referred to the Committee on [Appropriations]",5,0,0,2,7
1961075,1522041,2025-03-18,Assembly,"Do pass and be re-referred to the Committee on [Appropriations]",10,0,0,0,10
1961075,1577141,2025-05-23,Assembly,"Do pass as amended",11,0,0,4,15
1961075,1583463,2025-06-02,Assembly,"AB 466 Solache Assembly Third Reading",79,0,0,0,79
1961075,1595178,2025-06-25,Senate,"Do pass, but first be re-referred to the Committee on [Appropriations] with the recommendation: To Consent Calendar",7,0,0,0,7
1961075,1598148,2025-07-10,Senate,"Consent Calendar 2nd AB466 Solache",37,0,0,3,40
1961076,1542915,2025-04-09,Assembly,"Do pass as amended",9,0,0,1,10
1961076,1565240,2025-05-05,Assembly,"AB 467 Fong Assembly Third Reading",65,7,0,7,79
1961077,1542924,2025-04-08,Assembly,"Do pass as amended and be re-referred to the Committee on [Appropriations]",8,0,0,1,9
1961077,1577450,2025-05-23,Assembly,"Do pass",14,0,0,1,15
1961077,1584250,2025-06-03,Assembly,"AB 468 Gabriel Assembly Third Reading",72,0,0,7,79
1961077,1598497,2025-07-15,Senate,"Do pass as amended, but first amend, and re-refer to the Committee on [Appropriations]",6,0,0,0,6
1961077,1599462,2025-08-18,Senate,"Placed on suspense file",7,0,0,0,7
1961077,1600268,2025-08-29,Senate,"Do pass, but first be re-referred to the Committee on [Rules]",7,0,0,0,7
1961077,1601925,2025-09-11,Senate,"Assembly 3rd Reading AB468 Gabriel et al. By Arreguín",38,0,0,2,40
1961077,1602218,2025-09-12,Assembly,"AB 468 Gabriel Concurrence in Senate Amendments",72,0,0,8,80
1961079,1562964,2025-04-30,Assembly,"Do pass as amended and be re-referred to the Committee on [Appropriations]",8,1,0,1,10
1961079,1577290,2025-05-23,Assembly,"Do pass and be re-referred to the Committee on [Rules]",12,0,0,3,15
1961079,1594071,2025-06-23,Assembly,"Do pass",7,0,0,2,9
1961079,1596012,2025-06-27,Assembly,"AB 470 McKinnor Assembly Third Reading",58,2,0,19,79
1961079,1598371,2025-07-15,Senate,"Do pass, but first be re-referred to the Committee on [Judiciary]",9,1,0,7,17
1961079,1599465,2025-08-18,Senate,"Placed on suspense file",7,0,0,0,7
1961080,1525465,2025-03-24,Assembly,"Do pass",13,0,0,1,14
1961080,1544959,2025-04-10,Assembly,"AB 471 Hart Assembly Third Reading",66,2,0,11,79
1961080,1592608,2025-06-18,Senate,"Do pass as amended, but first amend, and re-refer to the Committee on [Local Government]",6,0,0,2,8
1961080,1598699,2025-07-16,Senate,"Do pass as amended",5,1,0,1,7
1961080,1600942,2025-09-03,Senate,"Assembly 3rd Reading AB471 Hart et al. By Laird",33,0,0,7,40
1961080,1601071,2025-09-04,Assembly,"AB 471 Hart Concurrence in Senate Amendments",74,2,0,3,79
1961081,1535048,2025-04-02,Assembly,"Do pass as amended, and be re-referred to the Committee on [Natural Resources] with recommendation: To Consent Calendar",18,0,0,0,18
1961081,1558709,2025-04-21,Assembly,"Do pass as amended, and be re-referred to the Committee on [Appropriations] with recommendation: To Consent Calendar",14,0,0,0,14
1961083,1527009,2025-03-25,Assembly,"Do pass and be re-referred to the Committee on [Human Services]",8,3,0,1,12
1961083,1540933,2025-04-08,Assembly,"Do pass and be re-referred to the Committee on [Revenue and Taxation] with recommendation: To Consent Calendar",6,0,0,0,6
1961083,1561037,2025-04-28,Assembly,"Do pass as amended and be re-referred to the Committee on [Appropriations]",7,0,0,0,7
1961083,1577835,2025-05-23,Assembly,"Do pass as amended",11,0,0,4,15
1961083,1583586,2025-06-02,Assembly,"AB 474 Ward Assembly Third Reading",77,0,0,2,79
1961083,1597484,2025-07-01,Senate,"Do pass, but first be re-referred to the Committee on [Human Services]",12,0,0,1,13
1961083,1597680,2025-07-07,Senate,"Do pass as amended, but first amend, and re-refer to the Committee on [Appropriations]",5,0,0,0,5
1961083,1599609,2025-08-18,Senate,"Placed on suspense file",7,0,0,0,7
1961083,1600614,2025-08-29,Senate,"Do pass as amended",7,0,0,0,7
1961083,1601538,2025-09-09,Senate,"Assembly 3rd Reading AB474 Ward By Ochoa Bogh",39,0,0,1,40
1961085,1485607,2025-02-10,Assembly,"Be adopted. To third reading",9,0,0,2,11
1961085,1517826,2025-03-13,Senate,"Special Consent ACR29 Irwin et al",36,0,0,4,40
1961086,1540867,2025-04-08,Senate,"Do pass as amended, but first amend, and re-refer to the Committee on [Appropriations]",6,0,0,0,6
1961086,1559419,2025-04-28,Senate,"Placed on suspense file",7,0,0,0,7
1961087,1554590,2025-04-22,Senate,"Do pass, but first be re-referred to the Committee on [Appropriations]",6,0,0,1,7
1961087,1565292,2025-05-05,Senate,"Placed on suspense file",7,0,0,0,7
1961090,1540853,2025-04-07,Senate,"Do pass, but first be re-referred to the Committee on [Appropriations] with the recommendation: To Consent Calendar",5,0,0,0,5
1961090,1552894,2025-04-21,Senate,"Placed on suspense file",6,0,0,1,7
1961090,1577673,2025-05-23,Senate,"Do pass",6,0,0,1,7
1961090,1581745,2025-05-29,Senate,"Special Consent SB290 Smallwood-Cuevas",38,0,0,2,40
1961090,1598445,2025-07-15,Assembly,"Do pass as amended and be re-referred to the Committee on [Appropriations]",7,0,0,0,7
1961091,1552877,2025-04-21,Senate,"Do pass as amended, but first amend, and re-refer to the Committee on [Judiciary]",11,0,0,0,11
1961091,1562750,2025-04-29,Senate,"Do pass as amended, but first amend, and re-refer to the Committee on [Appropriations]",13,0,0,0,13
1961091,1580486,2025-05-28,Senate,"Senate 3rd Reading SB291 Grayson",35,0,0,5,40
1961091,1594572,2025-06-24,Assembly,"Do pass and be re-referred to the Committee on [Insurance] with recommendation: To Consent Calendar",16,0,0,2,18
1961091,1598687,2025-07-16,Assembly,"Do pass and be re-referred to the Committee on [Appropriations] with recommendation: To Consent Calendar",17,0,0,0,17
1961091,1600494,2025-08-29,Assembly,"Do pass",15,0,0,0,15
1961091,1601351,2025-09-08,Assembly,"SB 291 Grayson Senate Third Reading By Carrillo",79,0,0,1,80
1961091,1601528,2025-09-09,Senate,"Unfinished Business SB291 Grayson Concurrence",40,0,0,0,40
1961092,1562766,2025-04-29,Senate,"Do pass as amended, but first amend, and re-refer to the Committee on [Appropriations]",16,0,0,1,17
1961092,1573617,2025-05-19,Senate,"Placed on suspense file",5,0,0,2,7
1961092,1577795,2025-05-23,Senate,"Do pass",6,0,0,1,7
1961092,1584259,2025-06-03,Senate,"Senate 3rd Reading SB292 Cervantes",38,0,0,2,40
1961092,1598694,2025-07-16,Assembly,"Do pass as amended and be re-referred to the Committee on [Appropriations]",17,0,0,1,18
1961092,1600757,2025-08-29,Assembly,"Do pass",14,0,0,1,15
1961092,1601882,2025-09-11,Senate,"Unfinished Business SB292 Cervantes Concurrence",40,0,0,0,40
1961093,1542828,2025-04-09,Senate,"Do pass as amended, but first amend, and re-refer to the Committee on [Appropriations]",5,0,0,0,5
1961093,1559431,2025-04-28,Senate,"Placed on suspense file",7,0,0,0,7
1961093,1577701,2025-05-23,Senate,"Do pass",6,0,0,1,7
1961093,1581795,2025-05-29,Senate,"Special Consent SB293 Pérez",38,0,0,2,40
1961093,1598439,2025-07-14,Assembly,"Do pass and be re-referred to the Committee on [Appropriations]",7,0,0,0,7
1961093,1600547,2025-08-29,Assembly,"Do pass as amended",11,0,0,4,15
1961093,1602211,2025-09-12,Senate,"Unfinished Business SB293 Pérez Concurrence",38,0,0,2,40
1961094,1556146,2025-04-23,Senate,"Do pass, but first be re-referred to the Committee on [Judiciary]",4,1,0,0,5
1961094,1562980,2025-04-29,Senate,"Do pass as amended, but first amend, and re-refer to the Committee on [Appropriations]",11,2,0,0,13
1961094,1573595,2025-05-19,Senate,"Placed on suspense file",5,0,0,2,7
1961094,1577928,2025-05-23,Senate,"Do pass",5,1,0,1,7
1961094,1580544,2025-05-28,Senate,"Senate 3rd Reading SB294 Reyes et al",28,10,0,2,40
1961094,1595676,2025-06-25,Assembly,"Do pass and be re-referred to the Committee on [Judiciary]",7,0,0,0,7
1961094,1597915,2025-07-08,Assembly,"Do pass and be re-referred to the Committee on [Appropriations]",10,1,0,1,12
1961094,1600643,2025-08-29,Assembly,"Do pass as amended",11,1,0,3,15
1961094,1602129,2025-09-12,Senate,"Unfinished Business SB294 Reyes et al. Concurrence",29,8,0,3,40
1961094,1602130,2025-09-12,Assembly,"SB 294 Reyes Senate Third Reading By Ortega",67,8,0,5,80
1961095,1562860,2025-04-29,Senate,"Do pass as amended, but first amend, and re-refer to the Committee on [Public Safety]",11,2,0,0,13
1961095,1573566,2025-05-19,Senate,"Placed on suspense file",5,0,0,2,7
1961095,1577193,2025-05-23,Senate,"Do pass",5,1,0,1,7
1961095,1584323,2025-06-03,Senate,"Senate 3rd Reading SB295 Hurtado et al",29,10,0,1,40
1961095,1597182,2025-07-01,Assembly,"Do pass and be re-referred to the Committee on [Privacy and Consumer Protection]",9,3,0,0,12
1961095,1598676,2025-07-16,Assembly,"Do pass and be re-referred to the Committee on [Appropriations]",9,4,0,2,15
1961095,1600500,2025-08-29,Assembly,"Do pass as amended",10,4,0,1,15
1961095,1602173,2025-09-13,Assembly,"SB 295 Hurtado Senate Third Reading By Bauer-Kahan",13,24,0,43,80
1961096,1501963,2025-02-27,Senate,"Senate 3rd Reading SR15 Ochoa Bogh et al",36,0,0,3,39
1964662,1526956,2025-03-25,Assembly,"Do pass and be re-referred to the Committee on [Appropriations]",6,1,0,2,9
1964663,1554515,2025-04-22,Assembly,"Do pass as amended and be re-referred to the Committee on [Public Safety]",18,0,0,0,18
1964663,1562821,2025-04-29,Assembly,"Do pass as amended, and be re-referred to the Committee on [Appropriations] with recommendation: To Consent Calendar",9,0,0,0,9
1964663,1577907,2025-05-23,Assembly,"Do pass",14,0,0,1,15
1964663,1584251,2025-06-03,Assembly,"AB 476 Mark González Assembly Third Reading",79,0,0,0,79
1964663,1597744,2025-07-07,Senate,"Do pass, but first be re-referred to the Committee on [Public Safety]",11,0,0,0,11
1964663,1598481,2025-07-15,Senate,"Do pass as amended, but first amend, and re-refer to the Committee on [Appropriations]",6,0,0,0,6
1964663,1599644,2025-08-18,Senate,"Placed on suspense file",7,0,0,0,7
1964663,1600487,2025-08-29,Senate,"Do pass as amended",7,0,0,0,7
1964663,1601970,2025-09-11,Senate,"Assembly 3rd Reading AB476 Mark González et al. By Arreguín",40,0,0,0,40
1964663,1602087,2025-09-12,Assembly,"AB 476 Mark González Concurrence in Senate Amendments",80,0,0,0,80
1964664,1545038,2025-04-09,Assembly,"Do pass and be re-referred to the Committee on [Appropriations]",9,0,0,0,9
1964664,1577322,2025-05-23,Assembly,"Do pass",12,1,0,2,15
1964664,1584351,2025-06-03,Assembly,"AB 477 Muratsuchi Assembly Third Reading",72,1,0,6,79
1964664,1597418,2025-07-02,Senate,"Do pass, but first be re-referred to the Committee on [Appropriations]",4,1,0,2,7
1964664,1598245,2025-07-14,Senate,"Placed on suspense file",7,0,0,0,7
1964665,1561033,2025-04-28,Assembly,"Do pass and be re-referred to the Committee on [Appropriations]",7,0,0,0,7
1964665,1577937,2025-05-23,Assembly,"Do pass as amended",11,0,0,4,15
1964665,1583421,2025-06-02,Assembly,"AB 478 Zbur Assembly Third Reading",78,0,0,1,79
1964665,1597864,2025-07-08,Senate,"Do pass, but first be re-referred to the Committee on [Business, Professions and Economic Development]",14,0,0,1,15
1964665,1598238,2025-07-14,Senate,"Do pass as amended, but first amend, and re-refer to the Committee on [Appropriations]",11,0,0,0,11
1964665,1599366,2025-08-18,Senate,"Placed on suspense file",7,0,0,0,7
1964665,1600728,2025-08-29,Senate,"Do pass as amended",7,0,0,0,7
1964665,1601956,2025-09-11,Senate,"Special Consent AB478 Zbur et al. By Allen",40,0,0,0,40
1964665,1602046,2025-09-12,Assembly,"AB 478 Zbur Concurrence in Senate Amendments",80,0,0,0,80
1964667,1528299,2025-03-26,Assembly,"Do pass and be re-referred to the Committee on [Revenue and Taxation] with recommendation: To Consent Calendar",10,0,0,1,11
1964667,1561173,2025-04-28,Assembly,"Do pass and be re-referred to the Committee on [Appropriations]",7,0,0,0,7
1964667,1577647,2025-05-23,Assembly,"Do pass",14,0,0,1,15
1964667,1583566,2025-06-02,Assembly,"AB 480 Quirk-Silva Assembly Third Reading",79,0,0,0,79
1964667,1591855,2025-06-17,Senate,"Do pass, but first be re-referred to the Committee on [Revenue and Taxation] with the recommendation: To Consent Calendar",9,0,0,2,11
1964667,1598069,2025-07-09,Senate,"Do pass, but first be re-referred to the Committee on [Appropriations] with the recommendation: To Consent Calendar",5,0,0,0,5
1964667,1600057,2025-08-25,Senate,"Placed on suspense file",6,0,0,1,7
1964667,1600518,2025-08-29,Senate,"Do pass",7,0,0,0,7
1964667,1601171,2025-09-04,Senate,"Special Consent AB480 Quirk-Silva By McNerney",39,0,0,1,40
1964668,1533531,2025-04-01,Assembly,"Do pass as amended and be re-referred to the Committee on [Appropriations]",15,0,0,3,18
1964668,1577700,2025-05-23,Assembly,"Do pass",14,0,0,1,15
1964668,1585072,2025-06-04,Assembly,"AB 481 Blanca Rubio Assembly Third Reading",54,1,0,24,79
1964668,1597734,2025-07-07,Senate,"Do pass, but first be re-referred to the Committee on [Appropriations]",7,0,0,4,11
1964668,1599478,2025-08-18,Senate,"Placed on suspense file",7,0,0,0,7
1964669,1528258,2025-03-26,Assembly,"Do pass and be re-referred to the Committee on [Appropriations]",8,0,0,0,8
1964669,1542823,2025-04-09,Assembly,"Do pass",14,0,0,1,15
1964669,1573622,2025-05-19,Assembly,"AB 482 Solache Assembly Third Reading",74,1,0,4,79
1964669,1597146,2025-07-01,Senate,"Do pass, but first be re-referred to the Committee on [Judiciary]",5,0,0,0,5
1964669,1598553,2025-07-15,Senate,"Do pass, but first be re-referred to the Committee on [Appropriations] with the recommendation: To Consent Calendar",13,0,0,0,13
1964669,1600841,2025-09-02,Senate,"Assembly 3rd Reading AB482 Solache By Hurtado",40,0,0,0,40
1964669,1600994,2025-09-03,Assembly,"AB 482 Solache Concurrence in Senate Amendments",78,1,0,0,79
1964670,1535042,2025-04-01,Assembly,"Do pass",9,4,0,2,15
1964670,1538938,2025-04-07,Assembly,"AB 483 Irwin Assembly Third Reading",47,12,0,20,79
1964670,1595169,2025-06-24,Senate,"Do pass",11,1,0,1,13
1964670,1601522,2025-09-09,Senate,"Assembly 3rd Reading AB483 Irwin By Laird",39,1,0,0,40
1964671,1540870,2025-04-08,Assembly,"Do pass. To Consent Calendar",12,0,0,0,12
1964671,1552931,2025-04-21,Assembly,"AB 484 Dixon Consent Calendar Second Day Regular Session",73,0,0,6,79
1964671,1597419,2025-07-01,Senate,"Do pass as amended, and be ordered to the Consent Calendar",13,0,0,0,13
1964671,1601903,2025-09-11,Senate,"Assembly 3rd Reading AB484 Dixon By Umberg",40,0,0,0,40
1964671,1602156,2025-09-13,Assembly,"AB 484 Dixon Concurrence in Senate Amendments",73,0,0,7,80
1964672,1521984,2025-03-19,Assembly,"Do pass and be re-referred to the Committee on [Appropriations]",5,0,0,2,7
1964672,1577608,2025-05-23,Assembly,"Do pass",11,0,0,4,15
1964672,1584355,2025-06-03,Assembly,"AB 485 Ortega Assembly Third Reading",56,7,0,16,79
1964672,1598093,2025-07-09,Senate,"Do pass, but first be re-referred to the Committee on [Judiciary]",4,0,0,1,5
1964672,1598625,2025-07-15,Senate,"Do pass, but first be re-referred to the Committee on [Appropriations]",11,0,0,2,13
1964672,1599506,2025-08-18,Senate,"Placed on suspense file",7,0,0,0,7
1964673,1526928,2025-03-25,Assembly,"Do pass as amended and be re-referred to the Committee on [Appropriations]",9,0,0,0,9
1964673,1577627,2025-05-23,Assembly,"Do pass as amended",11,0,0,4,15
1964673,1585049,2025-06-04,Assembly,"AB 486 Lackey Assembly Third Reading",73,0,0,6,79
1964673,1597868,2025-07-08,Senate,"Do pass, but first be re-referred to the Committee on [Appropriations]",6,0,0,0,6
1964673,1599416,2025-08-18,Senate,"Placed on suspense file",7,0,0,0,7
1964673,1600410,2025-08-29,Senate,"Do pass",7,0,0,0,7
1964673,1601170,2025-09-04,Senate,"Special Consent AB486 Lackey",39,0,0,1,40
1964673,1602036,2025-09-12,Assembly,"With recommendation: That Senate amendments be concurred in",9,0,0,0,9
1964673,1602219,2025-09-13,Assembly,"AB 486 Lackey Concurrence in Senate Amendments",67,0,0,13,80
1964674,1535102,2025-04-02,Assembly,"Do pass and be re-referred to the Committee on [Appropriations] with recommendation: To Consent Calendar",17,0,0,0,17
1964674,1577169,2025-05-23,Assembly,"Do pass",14,0,0,1,15
1964674,1584318,2025-06-03,Assembly,"AB 487 Insurance Assembly Third Reading By CALDERON",78,0,0,1,79
1964674,1598022,2025-07-09,Senate,"Do pass, but first be re-referred to the Committee on [Judiciary] with the recommendation: To Consent Calendar",7,0,0,0,7
1964674,1598579,2025-07-15,Senate,"Do pass, but first be re-referred to the Committee on [Appropriations] with the recommendation: To Consent Calendar",13,0,0,0,13
1964674,1600026,2025-08-25,Senate,"Consent Calendar 2nd AB487 INS. (Calderon)",37,0,0,3,40
1964674,1601152,2025-09-04,Assembly,"AB 487 Insurance Concurrence in Senate Amendments By CALDERON",77,0,0,2,79
1964676,1533592,2025-04-01,Assembly,"Do pass and be re-referred to the Committee on [Privacy and Consumer Protection]",17,0,0,1,18
1964676,1556016,2025-04-22,Assembly,"Do pass and be re-referred to the Committee on [Appropriations] with recommendation: To Consent Calendar",14,0,0,1,15
1964676,1577242,2025-05-23,Assembly,"Do pass",14,0,0,1,15
1964676,1583517,2025-06-02,Assembly,"AB 489 Bonta Assembly Third Reading",79,0,0,0,79
1964676,1594059,2025-06-23,Senate,"Do pass, but first be re-referred to the Committee on [Judiciary]",10,0,0,1,11
1964676,1598606,2025-07-15,Senate,"Do pass, but first be re-referred to the Committee on [Appropriations]",13,0,0,0,13
1964676,1599387,2025-08-18,Senate,"Placed on suspense file",7,0,0,0,7
1964676,1600746,2025-08-29,Senate,"Do pass",7,0,0,0,7
1964676,1601129,2025-09-04,Senate,"Special Consent AB489 Bonta et al. By Weber Pierson",39,0,0,1,40
1964676,1601321,2025-09-08,Assembly,"AB 489 Bonta Concurrence in Senate Amendments",79,0,0,1,80
1964678,1525436,2025-03-24,Assembly,"Do pass as amended and be re-referred to the Committee on [Appropriations]",9,3,0,2,14
1964679,1533466,2025-04-01,Assembly,"Do pass and be re-referred to the Committee on [Appropriations]",15,0,0,0,15
1964679,1555956,2025-04-23,Assembly,"Do pass",15,0,0,0,15
1964679,1565301,2025-05-05,Assembly,"AB 492 Valencia Assembly Third Reading",76,0,0,3,79
1964679,1589119,2025-06-11,Senate,"Do pass, but first be re-referred to the Committee on [Appropriations]",6,0,0,5,11
1964679,1600830,2025-09-02,Senate,"Assembly 3rd Reading AB492 Valencia et al. By Blakespear",38,1,0,1,40
1964680,1520449,2025-03-18,Assembly,"Do pass and be re-referred to the Committee on [Appropriations]",8,0,0,1,9
1964680,1521986,2025-03-19,Assembly,"Do pass as amended",15,0,0,0,15
1964680,1533534,2025-04-01,Assembly,"AB 493 Harabedian Third Reading Urgency",77,0,0,3,80
1964680,1592581,2025-06-18,Senate,"Do pass, but first be re-referred to the Committee on [Judiciary]",7,0,0,0,7
1964680,1595136,2025-06-24,Senate,"Do pass as amended, but first amend, and re-refer to the Committee on [Appropriations] with the recommendation: To Consent Calendar",12,0,0,1,13
1964680,1598865,2025-07-17,Senate,"Consent Calendar 2nd AB493 Harabedian et al. Urgency Clause",35,0,0,5,40
1964680,1599607,2025-08-18,Assembly,"AB 493 Harabedian Concurrence in Senate Amendments",77,0,0,2,79
1964682,1554469,2025-04-22,Assembly,"Do pass and be re-referred to the Committee on [Human Services]",9,1,0,2,12
1964682,1562754,2025-04-29,Assembly,"Do pass and be re-referred to the Committee on [Appropriations]",5,1,0,1,7
1964682,1577486,2025-05-23,Assembly,"Do pass",11,3,0,1,15
1964682,1584356,2025-06-03,Assembly,"AB 495 Celeste Rodriguez Assembly Third Reading",62,7,0,10,79
1964682,1597510,2025-07-01,Senate,"Do pass, but first be re-referred to the Committee on [Human Services]",11,2,0,0,13
1964682,1597653,2025-07-07,Senate,"Do pass, but first be re-referred to the Committee on [Appropriations]",4,1,0,0,5
1964682,1599448,2025-08-18,Senate,"Placed on suspense file",7,0,0,0,7
1964682,1600476,2025-08-29,Senate,"Do pass as amended",5,2,0,0,7
1964682,1601776,2025-09-10,Senate,"Assembly 3rd Reading AB495 Celeste Rodriguez By Arreguín",29,10,0,1,40
1964685,1526933,2025-03-25,Assembly,"Do pass. To Consent Calendar",12,0,0,0,12
1964685,1533499,2025-04-01,Assembly,"AB 498 Michelle Rodriguez Consent Calendar Second Day",76,0,0,4,80
1964685,1598726,2025-07-15,Senate,"Do pass and be ordered to the Consent Calendar",13,0,0,0,13
1964685,1600048,2025-08-25,Senate,"Consent Calendar 2nd AB498 Michelle Rodriguez",37,0,0,3,40
1964686,1526942,2025-03-25,Assembly,"Do pass and be re-referred to the Committee on [Appropriations]",12,0,0,3,15
1964686,1577651,2025-05-23,Assembly,"Do pass",12,0,0,3,15
1964686,1583497,2025-06-02,Assembly,"AB 499 Ortega Assembly Third Reading",65,1,0,13,79
1964686,1595658,2025-06-25,Senate,"Do pass, but first be re-referred to the Committee on [Appropriations]",9,0,0,2,11
1964686,1598249,2025-07-14,Senate,"Placed on suspense file",7,0,0,0,7
1964686,1600670,2025-08-29,Senate,"Do pass",5,2,0,0,7
1964686,1601292,2025-09-08,Senate,"Assembly 3rd Reading AB499 Ortega By Richardson",29,10,0,1,40
1964687,1542815,2025-04-08,Assembly,"Do pass and be re-referred to the Committee on [Education]",10,0,0,0,10
1964687,1564248,2025-04-30,Assembly,"Do pass and be re-referred to the Committee on [Appropriations]",9,0,0,0,9
1964687,1571550,2025-05-14,Assembly,"Do pass",15,0,0,0,15
1964687,1577829,2025-05-23,Assembly,"AB 500 Quirk-Silva Assembly Third Reading",73,0,0,6,79
1964687,1598617,2025-07-16,Senate,"Do pass, but first be re-referred to the Committee on [Appropriations]",6,0,0,1,7
1964687,1599371,2025-08-18,Senate,"Placed on suspense file",7,0,0,0,7
1964689,1528319,2025-03-26,Assembly,"Do pass and be re-referred to the Committee on [Appropriations] with recommendation: To Consent Calendar",7,0,0,0,7
1964689,1542936,2025-04-09,Assembly,"Do pass. To Consent Calendar",14,0,0,1,15
1964689,1557527,2025-04-24,Assembly,"AB 502 Pellerin Consent Calendar Second Day Regular Session",75,0,0,4,79
1964689,1597119,2025-07-01,Senate,"Do pass, but first be re-referred to the Committee on [Rules]",4,0,0,1,5
1964689,1598568,2025-07-15,Senate,"Do pass",11,2,0,0,13
1964690,1544951,2025-04-09,Assembly,"Do pass. To Consent Calendar",9,0,0,0,9
1964690,1557563,2025-04-24,Assembly,"AB 503 Mark González Consent Calendar Second Day Regular Session",75,0,0,4,79
1964690,1589134,2025-06-11,Senate,"Do pass",6,0,0,1,7
1964690,1600805,2025-09-02,Senate,"Assembly 3rd Reading AB503 Mark González By Pérez Urgency Clause",40,0,0,0,40
1964693,1540838,2025-04-08,Assembly,"Do pass and be re-referred to the Committee on [Business and Professions] with recommendation: To Consent Calendar",12,0,0,0,12
1964693,1554650,2025-04-22,Assembly,"Do pass as amended and be re-referred to the Committee on [Appropriations]",18,0,0,0,18
1964693,1577443,2025-05-23,Assembly,"Do pass",11,0,0,4,15
1964693,1583515,2025-06-02,Assembly,"AB 506 Bennett Assembly Third Reading",71,2,0,6,79
1964693,1594070,2025-06-23,Senate,"Do pass, but first be re-referred to the Committee on [Judiciary]",9,0,0,2,11
1964693,1597900,2025-07-08,Senate,"Do pass as amended, but first amend, and re-refer to the Committee on [Appropriations]",13,0,0,0,13
1964693,1599369,2025-08-18,Senate,"Placed on suspense file",7,0,0,0,7
1964693,1600773,2025-08-29,Senate,"Do pass",7,0,0,0,7
1964693,1601294,2025-09-08,Senate,"Assembly 3rd Reading AB506 Bennett et al. By Umberg",36,2,0,2,40
1964693,1601676,2025-09-09,Assembly,"AB 506 Bennett Concurrence in Senate Amendments",70,4,0,6,80
1964694,1558372,2025-04-24,Assembly,"Do pass and be re-referred to the Committee on [Local Government]",10,0,0,2,12
1964694,1564242,2025-04-30,Assembly,"Do pass and be re-referred to the Committee on [Appropriations]",9,0,0,1,10
1964694,1571527,2025-05-14,Assembly,"Do pass",10,0,0,5,15
1964694,1577404,2025-05-23,Assembly,"AB 507 Haney Assembly Third Reading",64,1,0,14,79
1964694,1597500,2025-07-02,Senate,"Do pass as amended, but first amend, and re-refer to the Committee on [Housing]",5,2,0,0,7
1964694,1598448,2025-07-15,Senate,"Do pass, but first be re-referred to the Committee on [Appropriations]",8,2,0,1,11
1964694,1599412,2025-08-18,Senate,"Placed on suspense file",7,0,0,0,7
1964694,1600255,2025-08-29,Senate,"Do pass as amended",6,1,0,0,7
1964694,1601792,2025-09-10,Senate,"Assembly 3rd Reading AB507 Haney et al. By Wiener",30,9,0,1,40
1964695,1554672,2025-04-22,Assembly,"Do pass as amended and be re-referred to the Committee on [Appropriations]",7,0,0,0,7
1964696,1521963,2025-03-19,Assembly,"Do pass as amended and be re-referred to the Committee on [Appropriations]",19,0,0,3,22
1964696,1577524,2025-05-23,Assembly,"Do pass",14,0,0,1,15
1964696,1583489,2025-06-02,Assembly,"AB 509 Flora Assembly Third Reading",77,0,0,2,79
1964696,1594603,2025-06-24,Senate,"Do pass, but first be re-referred to the Committee on [Appropriations] with the recommendation: To Consent Calendar",15,0,0,0,15
1964696,1599452,2025-08-18,Senate,"Placed on suspense file",7,0,0,0,7
1964696,1600712,2025-08-29,Senate,"Do pass",7,0,0,0,7
1964696,1601111,2025-09-04,Senate,"Assembly 3rd Reading AB509 Flora By Rubio",39,0,0,1,40
1964696,1601322,2025-09-08,Assembly,"AB 509 Flora Concurrence in Senate Amendments",78,0,0,2,80
1964697,1555971,2025-04-22,Assembly,"Do pass as amended and be re-referred to the Committee on [Appropriations]",13,0,0,3,16
1964698,1533504,2025-04-01,Assembly,"Do pass and be re-referred to the Committee on [Appropriations] with recommendation: To Consent Calendar",17,0,0,1,18
1964699,1555993,2025-04-22,Assembly,"Do pass as amended and be re-referred to the Committee on [Appropriations]",13,0,0,3,16
1964699,1577154,2025-05-23,Assembly,"Do pass",12,0,0,3,15
1964699,1583404,2025-06-02,Assembly,"AB 512 Harabedian Assembly Third Reading",68,1,0,10,79
1964699,1598130,2025-07-09,Senate,"Do pass as amended, but first amend, and re-refer to the Committee on [Appropriations]",9,0,0,2,11
1964699,1599424,2025-08-18,Senate,"Placed on suspense file",7,0,0,0,7
1964699,1600739,2025-08-29,Senate,"Do pass",5,0,0,2,7
1964699,1601508,2025-09-09,Senate,"Assembly 3rd Reading AB512 Harabedian et al. By Becker",30,0,0,10,40
1964701,1563034,2025-04-29,Assembly,"Do pass as amended and be re-referred to the Committee on [Appropriations]",13,0,0,0,13
1964702,1540886,2025-04-08,Assembly,"Do pass and be re-referred to the Committee on [Appropriations] with recommendation: To Consent Calendar",12,0,0,0,12
1964702,1556085,2025-04-23,Assembly,"Do pass. To Consent Calendar",15,0,0,0,15
1964702,1564214,2025-05-01,Assembly,"AB 515 Pacheco Consent Calendar Second Day Regular Session",76,0,0,3,79
1964702,1598557,2025-07-15,Senate,"Do pass, but first be re-referred to the Committee on [Appropriations] with the recommendation: To Consent Calendar",13,0,0,0,13
1964702,1601651,2025-09-09,Senate,"Assembly 3rd Reading AB515 Pacheco By Umberg",40,0,0,0,40
1964703,1533513,2025-04-01,Assembly,"Do pass and be re-referred to the Committee on [Appropriations] with recommendation: To Consent Calendar",17,0,0,1,18
1964703,1555970,2025-04-23,Assembly,"Do pass. To Consent Calendar",15,0,0,0,15
1964703,1564170,2025-05-01,Assembly,"AB 516 Kalra Consent Calendar Second Day Regular Session",76,0,0,3,79
1964703,1586925,2025-06-09,Senate,"Do pass, but first be re-referred to the Committee on [Appropriations]",8,0,0,3,11
1964703,1600809,2025-09-02,Senate,"Assembly 3rd Reading AB516 Kalra et al. By Cortese",40,0,0,0,40
1964703,1600970,2025-09-03,Assembly,"AB 516 Kalra Concurrence in Senate Amendments",77,0,0,2,79
1964704,1540818,2025-04-08,Assembly,"Do pass and be re-referred to the Committee on [Appropriations] with recommendation: To Consent Calendar",15,0,0,0,15
1964705,1542855,2025-04-09,Assembly,"Do pass as amended",10,1,0,1,12
1964705,1569745,2025-05-12,Assembly,"AB 518 Ward Assembly Third Reading",63,0,0,16,79
1964705,1598433,2025-07-15,Senate,"Do pass as amended, but first amend, and re-refer to the Committee on [Rules]",9,0,0,2,11
1964705,1600010,2025-08-25,Senate,"Placed on suspense file",6,0,0,1,7
1964705,1600595,2025-08-29,Senate,"Do pass as amended",4,0,0,3,7
1964705,1601550,2025-09-09,Senate,"Assembly 3rd Reading AB518 Ward et al. By Limón",35,1,0,4,40
1964706,1554512,2025-04-22,Assembly,"Do pass",17,0,0,1,18
1964706,1565252,2025-05-05,Assembly,"AB 519 Berman Assembly Third Reading",74,0,0,5,79
1964706,1596785,2025-06-30,Senate,"Do pass as amended",6,0,0,5,11
1964706,1600894,2025-09-03,Senate,"Assembly 3rd Reading AB519 Berman et al. By Umberg",31,2,0,7,40
1964706,1601323,2025-09-08,Assembly,"AB 519 Berman Concurrence in Senate Amendments",73,0,0,7,80
1964708,1533528,2025-04-01,Assembly,"Do pass and be re-referred to the Committee on [Judiciary] with recommendation: To Consent Calendar",17,0,0,1,18
1964708,1540800,2025-04-08,Assembly,"Do pass and be re-referred to the Committee on [Appropriations] with recommendation: To Consent Calendar",12,0,0,0,12
1964708,1556067,2025-04-23,Assembly,"Do pass. To Consent Calendar",15,0,0,0,15
1964708,1564194,2025-05-01,Assembly,"AB 521 Carrillo Consent Calendar Second Day Regular Session",76,0,0,3,79
1964708,1586926,2025-06-09,Senate,"Do pass, but first be re-referred to the Committee on [Judiciary] with the recommendation: To Consent Calendar",8,0,0,3,11
1964708,1595130,2025-06-24,Senate,"Do pass, but first be re-referred to the Committee on [Appropriations] with the recommendation: To Consent Calendar",12,0,0,1,13
1964708,1600041,2025-08-25,Senate,"Consent Calendar 2nd AB521 Carrillo",37,0,0,3,40
1964710,1564171,2025-04-30,Assembly,"Do pass as amended",8,1,0,1,10
1964710,1569929,2025-05-12,Assembly,"AB 523 Irwin Assembly Third Reading",70,4,0,5,79
1964710,1592583,2025-06-18,Senate,"Do pass",6,1,0,0,7
1964710,1600988,2025-09-03,Senate,"Assembly 3rd Reading AB523 Irwin By Stern",35,1,0,4,40
1964711,1562806,2025-04-30,Assembly,"Do pass and be re-referred to the Committee on [Appropriations]",8,0,0,0,8
1964711,1577669,2025-05-23,Assembly,"Do pass",14,0,0,1,15
1964711,1583432,2025-06-02,Assembly,"AB 524 Wilson Assembly Third Reading",76,0,0,3,79
1964711,1594692,2025-06-24,Senate,"Do pass, but first be re-referred to the Committee on [Agriculture]",6,1,0,0,7
1964711,1598375,2025-07-15,Senate,"Do pass, but first be re-referred to the Committee on [Appropriations]",4,0,0,1,5
1964711,1600025,2025-08-25,Senate,"Placed on suspense file",6,0,0,1,7
1964711,1600658,2025-08-29,Senate,"Do pass as amended",6,1,0,0,7
1964711,1601637,2025-09-09,Senate,"Assembly 3rd Reading AB524 Wilson et al. By Hurtado",31,5,0,4,40
1964712,1561034,2025-04-28,Assembly,"Do pass and be re-referred to the Committee on [Appropriations] with recommendation: To Consent Calendar",16,0,0,0,16
1964712,1571551,2025-05-14,Assembly,"Do pass. To Consent Calendar",15,0,0,0,15
1964712,1577405,2025-05-23,Assembly,"AB 525 Lackey Assembly Third Reading",71,0,0,8,79
1964712,1594598,2025-06-24,Senate,"Do pass, but first be re-referred to the Committee on [Appropriations] with the recommendation: To Consent Calendar",14,0,0,1,15
1964712,1598179,2025-07-10,Senate,"Consent Calendar 2nd AB525 Lackey",37,0,0,3,40
1964713,1535127,2025-04-02,Assembly,"Do pass as amended, and be re-referred to the Committee on [Natural Resources] with recommendation: To Consent Calendar",18,0,0,0,18
1964713,1558730,2025-04-21,Assembly,"Do pass and be re-referred to the Committee on [Appropriations] with recommendation: To Consent Calendar",14,0,0,0,14
1964714,1559495,2025-04-28,Assembly,"Do pass as amended and be re-referred to the Committee on [Appropriations]",14,0,0,0,14
1964714,1571557,2025-05-14,Assembly,"Do pass",15,0,0,0,15
1964714,1579266,2025-05-27,Assembly,"AB 527 Papan Assembly Third Reading",76,0,0,3,79
1964714,1597439,2025-07-02,Senate,"Do pass as amended, but first amend, and re-refer to the Committee on [Natural Resources and Water]",6,1,0,1,8
1964714,1598619,2025-07-16,Senate,"Do pass as amended, but first amend, and re-refer to the Committee on [Appropriations]",7,0,0,0,7
1964714,1599459,2025-08-18,Senate,"Placed on suspense file",7,0,0,0,7
1964714,1600551,2025-08-29,Senate,"Do pass",7,0,0,0,7
1964714,1601625,2025-09-09,Senate,"Assembly 3rd Reading AB527 Papan et al. By Limón",36,0,0,4,40
1964715,1492780,2025-02-18,Assembly,"Be adopted. To third reading",10,0,0,1,11
1964715,1599988,2025-08-25,Senate,"Assembly 3rd Reading ACR30 Jackson et al",37,0,0,3,40
1964716,1528244,2025-03-26,Senate,"Do pass, but first be re-referred to the Committee on [Military and Veterans Affairs]",5,0,0,0,5
1964716,1559383,2025-04-28,Senate,"Do pass, but first be re-referred to the Committee on [Appropriations] with the recommendation: To Consent Calendar",4,0,0,1,5
1964716,1569795,2025-05-12,Senate,"Placed on suspense file",7,0,0,0,7
1964716,1577730,2025-05-23,Senate,"Do pass",6,0,0,1,7
1964716,1581711,2025-05-29,Senate,"Special Consent SB296 Archuleta et al",38,0,0,2,40
1964716,1597225,2025-07-01,Assembly,"Do pass as amended, and be re-referred to the Committee on [Revenue and Taxation] with recommendation: To Consent Calendar",8,0,0,0,8
1964717,1544974,2025-04-09,Senate,"Do pass as amended, but first amend, and re-refer to the Committee on [Judiciary]",10,0,0,1,11
1964717,1563008,2025-04-29,Senate,"Do pass, but first be re-referred to the Committee on [Appropriations]",12,0,0,1,13
1964717,1569855,2025-05-12,Senate,"Placed on suspense file",7,0,0,0,7
1964717,1577606,2025-05-23,Senate,"Do pass",6,0,0,1,7
1964717,1580481,2025-05-28,Senate,"Senate 3rd Reading SB297 Hurtado",37,0,0,3,40
1964717,1597253,2025-07-01,Assembly,"Do pass and be re-referred to the Committee on [Judiciary]",14,0,0,2,16
1964717,1598494,2025-07-15,Assembly,"Do pass and be re-referred to the Committee on [Appropriations]",12,0,0,0,12
1964718,1538982,2025-04-07,Senate,"Do pass as amended, but first amend, and re-refer to the Committee on [Environmental Quality]",14,0,0,3,17
1964718,1562903,2025-04-30,Senate,"Do pass, but first be re-referred to the Committee on [Appropriations]",8,0,0,0,8
1964718,1569791,2025-05-12,Senate,"Placed on suspense file",7,0,0,0,7
1964718,1577400,2025-05-23,Senate,"Do pass",6,0,0,1,7
1964718,1586393,2025-06-02,Senate,"Senate 3rd Reading SB298 Caballero et al",34,0,0,6,40
1964718,1597651,2025-07-07,Assembly,"Do pass and be re-referred to the Committee on [Natural Resources] with recommendation: To Consent Calendar",16,0,0,0,16
1964718,1598275,2025-07-14,Assembly,"Do pass and be re-referred to the Committee on [Appropriations]",12,0,0,2,14
1964718,1600629,2025-08-29,Assembly,"Do pass",15,0,0,0,15
1964718,1601542,2025-09-09,Assembly,"SB 298 Caballero Senate Third Reading By Ransom",80,0,0,0,80
1964718,1601923,2025-09-11,Senate,"Unfinished Business SB298 Caballero et al. Concurrence",38,0,0,2,40
1964719,1555930,2025-04-23,Senate,"Do pass, but first be re-referred to the Committee on [Environmental Quality]",4,3,0,0,7
1964719,1563020,2025-04-30,Senate,"Do pass as amended",6,1,0,1,8
1964721,1562761,2025-04-30,Senate,"Do pass",5,0,0,0,5
1964721,1580511,2025-05-28,Senate,"Senate 3rd Reading SB301 Grayson",32,1,0,7,40
1964721,1595226,2025-06-25,Assembly,"Do pass",7,0,0,0,7
1964721,1600207,2025-08-28,Assembly,"SB 301 Grayson Senate Third Reading By McKinnor",69,3,0,7,79
1964721,1601650,2025-09-09,Senate,"Unfinished Business SB301 Grayson Concurrence",37,1,0,2,40
1964722,1528297,2025-03-26,Senate,"Do pass as amended, but first amend, and re-refer to the Committee on [Appropriations]",5,0,0,0,5
1964722,1538920,2025-04-07,Senate,"Placed on suspense file",7,0,0,0,7
1964722,1577563,2025-05-23,Senate,"Do pass",6,0,0,1,7
1964722,1581725,2025-05-29,Senate,"Special Consent SB302 Padilla et al",38,0,0,2,40
1964722,1598429,2025-07-14,Assembly,"Do pass as amended and be re-referred to the Committee on [Appropriations]",7,0,0,0,7
1964722,1600612,2025-08-29,Assembly,"Do pass",15,0,0,0,15
1964722,1601985,2025-09-11,Senate,"Unfinished Business SB302 Padilla et al. Concurrence",40,0,0,0,40
1964723,1556075,2025-04-22,Senate,"Do pass, but first be re-referred to the Committee on [Public Safety]",11,2,0,0,13
1964723,1562991,2025-04-29,Senate,"Do pass as amended",5,1,0,0,6
1964723,1580534,2025-05-28,Senate,"Senate 3rd Reading SB303 Smallwood-Cuevas",28,10,0,2,40
1964723,1597887,2025-07-08,Assembly,"Do pass",11,0,0,1,12
1964723,1600228,2025-08-28,Assembly,"SB 303 Smallwood-Cuevas Senate Third Reading By Mark González",72,0,0,7,79
1964723,1600840,2025-09-02,Senate,"Unfinished Business SB303 Smallwood-Cuevas Concurrence",36,0,0,4,40
1964724,1554594,2025-04-22,Senate,"Do pass as amended, but first amend, and re-refer to the Committee on [Appropriations]",6,0,0,1,7
1964724,1569886,2025-05-12,Senate,"Placed on suspense file",7,0,0,0,7
1964724,1577719,2025-05-23,Senate,"Do pass",6,0,0,1,7
1964724,1581720,2025-05-29,Senate,"Special Consent SB304 Arreguín",38,0,0,2,40
1964724,1598256,2025-07-14,Assembly,"Do pass and be re-referred to the Committee on [Appropriations]",13,0,0,1,14
1964724,1599759,2025-08-20,Assembly,"Do pass",15,0,0,0,15
1964724,1601578,2025-09-09,Assembly,"SB 304 Arreguín Senate Third Reading By Bonta",80,0,0,0,80
1964724,1601780,2025-09-10,Senate,"Unfinished Business SB304 Arreguín et al. Concurrence",37,1,0,2,40
1964725,1556200,2025-04-23,Senate,"Do pass, but first be re-referred to the Committee on [Appropriations]",7,0,0,0,7
1964725,1565330,2025-05-05,Senate,"Placed on suspense file",7,0,0,0,7
1964726,1557495,2025-04-23,Senate,"Do pass as amended, but first amend, and re-refer to the Committee on [Appropriations]",10,0,0,1,11
1964726,1569805,2025-05-12,Senate,"Placed on suspense file",7,0,0,0,7
1964726,1577763,2025-05-23,Senate,"Do pass",6,0,0,1,7
1964726,1580494,2025-05-28,Senate,"Senate 3rd Reading SB306 Becker",37,0,0,3,40
1964726,1598391,2025-07-15,Assembly,"Do pass as amended and be re-referred to the Committee on [Appropriations]",16,0,0,0,16
1964726,1600674,2025-08-29,Assembly,"Do pass as amended",11,0,0,4,15
1964726,1601353,2025-09-08,Assembly,"SB 306 Becker Senate Third Reading By Harabedian",76,1,0,3,80
1964726,1601644,2025-09-09,Senate,"Unfinished Business SB306 Becker Concurrence",40,0,0,0,40
1964727,1556054,2025-04-23,Senate,"Do pass, but first be re-referred to the Committee on [Judiciary]",6,1,0,0,7
1964727,1562902,2025-04-29,Senate,"Do pass, but first be re-referred to the Committee on [Appropriations]",12,0,0,1,13
1964727,1586445,2025-06-02,Senate,"Senate 3rd Reading SB307 Cervantes",30,3,0,7,40
1964727,1594595,2025-06-24,Assembly,"Do pass as amended and be re-referred to the Committee on [Judiciary]",7,2,0,1,10
1964727,1597157,2025-07-01,Assembly,"Do pass and be re-referred to the Committee on [Appropriations]",9,2,0,1,12
1964727,1598673,2025-07-16,Assembly,"Do pass",9,4,0,2,15
1964727,1601589,2025-09-09,Assembly,"SB 307 Cervantes Senate Third Reading By Fong",60,8,0,12,80
1964727,1601915,2025-09-11,Senate,"Unfinished Business SB307 Cervantes Concurrence",30,7,0,3,40
1964730,1542827,2025-04-09,Senate,"Do pass, but first be re-referred to the Committee on [Judiciary]",4,1,0,0,5
1964730,1555949,2025-04-22,Senate,"Do pass, but first be re-referred to the Committee on [Appropriations]",10,2,0,1,13
1964730,1565335,2025-05-05,Senate,"Placed on suspense file",7,0,0,0,7
1964730,1577320,2025-05-23,Senate,"Do pass",5,1,0,1,7
1964731,1562745,2025-04-29,Senate,"Do pass, but first be re-referred to the Committee on [Appropriations]",1,4,0,1,6
1964731,1562746,2025-04-29,Senate,"[First] hearing set for [04-30-2025]: Failed passage in Committee. Reconsideration granted",6,0,0,0,6
1964732,1538972,2025-04-07,Senate,"Do pass, but first be re-referred to the Committee on [Agriculture]",10,0,0,1,11
1964732,1561150,2025-04-29,Senate,"Do pass as amended, but first amend, and re-refer to the Committee on [Appropriations]",4,0,0,1,5
1964732,1573552,2025-05-19,Senate,"Placed on suspense file",5,0,0,2,7
1964732,1577820,2025-05-23,Senate,"Do pass",6,0,0,1,7
1964732,1580498,2025-05-28,Senate,"Senate 3rd Reading SB312 Umberg et al",38,0,0,2,40
1964732,1594661,2025-06-24,Assembly,"Do pass and be re-referred to the Committee on [Agriculture]",16,0,0,2,18
1964732,1597541,2025-07-02,Assembly,"Do pass and be re-referred to the Committee on [Appropriations]",8,0,0,0,8
1964732,1600549,2025-08-29,Assembly,"Do pass as amended",11,0,0,4,15
1964732,1601354,2025-09-08,Assembly,"SB 312 Umberg Senate Third Reading By Bennett",78,0,0,2,80
1964732,1601747,2025-09-10,Senate,"Unfinished Business SB312 Umberg et al. Concurrence",40,0,0,0,40
1964733,1557576,2025-04-23,Senate,"Do pass, but first be re-referred to the Committee on [Judiciary]",9,2,0,0,11
1964733,1562807,2025-04-29,Senate,"Do pass as amended, but first amend, and re-refer to the Committee on [Appropriations]",11,1,0,1,13
1964733,1569862,2025-05-12,Senate,"Placed on suspense file",7,0,0,0,7
1964733,1577716,2025-05-23,Senate,"Do pass",5,1,0,1,7
1964733,1586368,2025-06-02,Senate,"Senate 3rd Reading SB313 Cervantes et al",28,10,0,2,40
1964733,1597143,2025-07-01,Assembly,"Do pass and be re-referred to the Committee on [Judiciary]",12,1,0,3,16
1964733,1597943,2025-07-08,Assembly,"Do pass and be re-referred to the Committee on [Appropriations]",9,3,0,0,12
1964733,1600389,2025-08-29,Assembly,"Do pass",11,3,0,1,15
1964733,1601875,2025-09-11,Senate,"Unfinished Business SB313 Cervantes et al. Concurrence",29,10,0,1,40
1964734,1559458,2025-04-28,Senate,"Do pass, but first be re-referred to the Committee on [Appropriations]",10,0,0,1,11
1964734,1569892,2025-05-12,Senate,"Placed on suspense file",7,0,0,0,7
1964736,1501951,2025-02-27,Senate,"Senate 3rd Reading SCR20 Ochoa Bogh et al",35,0,0,4,39
1964736,1519120,2025-03-17,Assembly,"Be adopted. To Consent Calendar",10,0,0,1,11
1964736,1523574,2025-03-20,Assembly,"SCR 20 Ochoa Bogh Consent Calendar Second Day Regular Session",67,0,0,13,80
1965842,1526888,2025-03-25,Assembly,"Do pass and be re-referred to the Committee on [Appropriations]",9,0,0,0,9
1965842,1577182,2025-05-23,Assembly,"Do pass",14,0,0,1,15
1965842,1583562,2025-06-02,Assembly,"AB 528 Alanis Assembly Third Reading",76,0,0,3,79
1965842,1597245,2025-07-01,Senate,"Do pass as amended, but first amend, and re-refer to the Committee on [Appropriations]",6,0,0,0,6
1965842,1599510,2025-08-18,Senate,"Placed on suspense file",7,0,0,0,7
1965843,1533490,2025-04-01,Assembly,"Do pass and be re-referred to the Committee on [Appropriations] with recommendation: To Consent Calendar",17,0,0,1,18
1965843,1556125,2025-04-23,Assembly,"Do pass. To Consent Calendar",15,0,0,0,15
1965843,1564148,2025-05-01,Assembly,"AB 529 Ahrens Consent Calendar Second Day Regular Session",76,0,0,3,79
1965843,1586927,2025-06-09,Senate,"Do pass, but first be re-referred to the Committee on [Appropriations] with the recommendation: To Consent Calendar",8,0,0,3,11
1965843,1597609,2025-07-03,Senate,"Consent Calendar 2nd AB529 Ahrens",35,0,0,5,40
1965844,1522006,2025-03-18,Assembly,"Do pass and be re-referred to the Committee on [Appropriations]",9,0,0,1,10
1965845,1535000,2025-04-02,Assembly,"Do pass and be re-referred to the Committee on [Appropriations] with recommendation: To Consent Calendar",18,0,0,0,18
1965845,1537459,2025-04-02,Assembly,"Do pass and be re-referred to the Committee on [Natural Resources] with recommendation: To Consent Calendar",18,0,0,0,18
1965845,1558729,2025-04-21,Assembly,"Do pass and be re-referred to the Committee on [Appropriations] with recommendation: To Consent Calendar",14,0,0,0,14
1965845,1577837,2025-05-23,Assembly,"Do pass",13,0,0,2,15
1965845,1583549,2025-06-02,Assembly,"AB 531 Rogers Assembly Third Reading",79,0,0,0,79
1965845,1597153,2025-07-01,Senate,"Do pass as amended, but first amend, and re-refer to the Committee on [Environmental Quality]",16,0,0,1,17
1965845,1598754,2025-07-16,Senate,"Do pass, but first be re-referred to the Committee on [Appropriations]",6,1,0,1,8
1965845,1599513,2025-08-18,Senate,"Placed on suspense file",7,0,0,0,7
1965845,1600323,2025-08-29,Senate,"Do pass",6,1,0,0,7
1965845,1601935,2025-09-11,Senate,"Assembly 3rd Reading AB531 Rogers et al. By Becker",37,1,0,2,40
1965845,1602336,2025-09-12,Assembly,"AB 531 Rogers Concurrence in Senate Amendments",69,4,0,7,80
1965846,1561083,2025-04-29,Assembly,"Do pass and be re-referred to the Committee on [Utilities and Energy]",7,0,0,0,7
1965846,1564161,2025-04-30,Assembly,"Do pass as amended, and be re-referred to the Committee on [Appropriations] with recommendation: To Consent Calendar",18,0,0,0,18
1965846,1577385,2025-05-23,Assembly,"Do pass as amended",11,0,0,4,15
1965846,1584424,2025-06-03,Assembly,"AB 532 Ransom Assembly Third Reading",78,0,0,1,79
1965846,1597402,2025-07-02,Senate,"Do pass, but first be re-referred to the Committee on [Local Government] with the recommendation: To Consent Calendar",8,0,0,0,8
1965846,1598764,2025-07-16,Senate,"Do pass as amended, but first amend, and re-refer to the Committee on [Appropriations] with the recommendation: To Consent Calendar",7,0,0,0,7
1965846,1599425,2025-08-18,Senate,"Placed on suspense file",7,0,0,0,7
1965847,1528252,2025-03-26,Assembly,"Do pass and be re-referred to the Committee on [Appropriations]",8,0,0,2,10
1965847,1542852,2025-04-09,Assembly,"Do pass",14,0,0,1,15
1965847,1557519,2025-04-24,Assembly,"AB 533 Flora Assembly Third Reading",73,0,0,6,79
1965847,1592562,2025-06-18,Senate,"Do pass, but first be re-referred to the Committee on [Appropriations] with the recommendation: To Consent Calendar",7,0,0,0,7
1965847,1597590,2025-07-03,Senate,"Consent Calendar 2nd AB533 Flora",35,0,0,5,40
1965848,1526960,2025-03-25,Assembly,"Do pass and be re-referred to the Committee on [Appropriations]",7,0,0,0,7
1965848,1577467,2025-05-23,Assembly,"Do pass as amended",11,0,0,4,15
1965848,1583415,2025-06-02,Assembly,"AB 534 Schiavo Assembly Third Reading",79,0,0,0,79
1965848,1597655,2025-07-07,Senate,"Do pass, but first be re-referred to the Committee on [Appropriations] with the recommendation: To Consent Calendar",5,0,0,0,5
1965848,1599374,2025-08-18,Senate,"Placed on suspense file",7,0,0,0,7
1965849,1526950,2025-03-25,Assembly,"Do pass and be re-referred to the Committee on [Appropriations] with recommendation: To Consent Calendar",9,0,0,0,9
1965849,1577228,2025-05-23,Assembly,"Do pass",14,0,0,1,15
1965849,1583369,2025-06-02,Assembly,"AB 535 Schiavo Assembly Third Reading",79,0,0,0,79
1965849,1594564,2025-06-24,Senate,"Do pass, but first be re-referred to the Committee on [Appropriations] with the recommendation: To Consent Calendar",6,0,0,0,6
1965849,1597686,2025-07-07,Senate,"Placed on suspense file",6,0,0,1,7
1965849,1600256,2025-08-29,Senate,"Do pass",7,0,0,0,7
1965849,1601248,2025-09-08,Senate,"Assembly 3rd Reading AB535 Schiavo et al. By Cervantes",39,0,0,1,40
1965850,1540978,2025-04-08,Assembly,"Do pass and be re-referred to the Committee on [Appropriations]",15,0,0,0,15
1965850,1555996,2025-04-23,Assembly,"Do pass",15,0,0,0,15
1965850,1565358,2025-05-05,Assembly,"AB 536 Patterson Assembly Third Reading",74,0,0,5,79
1965850,1595687,2025-06-25,Senate,"Do pass, but first be re-referred to the Committee on [Appropriations]",8,1,0,2,11
1965850,1598208,2025-07-14,Senate,"Placed on suspense file",7,0,0,0,7
1965851,1556117,2025-04-22,Assembly,"Do pass and be re-referred to the Committee on [Appropriations]",9,0,0,1,10
1965851,1577340,2025-05-23,Assembly,"Do pass as amended",11,0,0,4,15
1965851,1583372,2025-06-02,Assembly,"AB 537 Ahrens Assembly Third Reading",79,0,0,0,79
1965851,1595174,2025-06-25,Senate,"Do pass as amended, but first amend, and re-refer to the Committee on [Appropriations]",6,1,0,0,7
1965851,1598219,2025-07-14,Senate,"Placed on suspense file",7,0,0,0,7
1965852,1521955,2025-03-19,Assembly,"Do pass and be re-referred to the Committee on [Appropriations]",6,0,0,1,7
1965852,1577191,2025-05-23,Assembly,"Do pass as amended",11,0,0,4,15
1965852,1584297,2025-06-03,Assembly,"AB 538 Berman Assembly Third Reading",65,3,0,11,79
1965852,1595154,2025-06-25,Senate,"Do pass, but first be re-referred to the Committee on [Appropriations]",4,1,0,0,5
1965852,1597769,2025-07-07,Senate,"Placed on suspense file",6,0,0,1,7
1965852,1600535,2025-08-29,Senate,"Do pass",6,1,0,0,7
1965852,1601740,2025-09-10,Senate,"Assembly 3rd Reading AB538 Berman By Durazo",30,9,0,1,40
1965853,1555973,2025-04-22,Assembly,"Do pass as amended and be re-referred to the Committee on [Appropriations]",12,0,0,4,16
1965853,1567874,2025-05-07,Assembly,"Do pass",11,0,0,4,15
1965853,1569898,2025-05-12,Assembly,"AB 539 Schiavo Assembly Third Reading",64,2,0,13,79
1965854,1526929,2025-03-25,Assembly,"Do pass. To Consent Calendar",12,0,0,0,12
1965854,1533485,2025-04-01,Assembly,"AB 540 Connolly Consent Calendar Second Day Regular Session",76,0,0,4,80
1965854,1597528,2025-07-01,Senate,"Do pass and be ordered to the Consent Calendar",13,0,0,0,13
1965855,1540912,2025-04-08,Assembly,"Do pass and be re-referred to the Committee on [Appropriations]",12,0,0,0,12
1965856,1564219,2025-04-30,Assembly,"Do pass and be re-referred to the Committee on [Appropriations] with recommendation: To Consent Calendar",9,0,0,0,9
1965856,1577195,2025-05-23,Assembly,"Do pass as amended",11,0,0,4,15
1965856,1585106,2025-06-04,Assembly,"AB 542 Celeste Rodriguez Assembly Third Reading",79,0,0,0,79
1965856,1597526,2025-07-02,Senate,"Do pass, but first be re-referred to the Committee on [Appropriations] with the recommendation: To Consent Calendar",7,0,0,0,7
1965856,1598203,2025-07-14,Senate,"Placed on suspense file",7,0,0,0,7
1965856,1600257,2025-08-29,Senate,"Do pass",7,0,0,0,7
1965856,1601109,2025-09-04,Senate,"Special Consent AB542 Celeste Rodriguez",39,0,0,1,40
1965856,1601324,2025-09-08,Assembly,"AB 542 Celeste Rodriguez Concurrence in Senate Amendments By LOWENTHAL",79,0,0,1,80
1965857,1555998,2025-04-22,Assembly,"Do pass and be re-referred to the Committee on [Appropriations]",16,0,0,0,16
1965857,1577813,2025-05-23,Assembly,"Do pass",13,0,0,2,15
1965857,1583592,2025-06-02,Assembly,"AB 543 Mark González Assembly Third Reading",78,0,0,1,79
1965857,1592563,2025-06-18,Senate,"Do pass as amended, but first amend, and re-refer to the Committee on [Appropriations]",10,0,0,1,11
1965857,1597743,2025-07-07,Senate,"Placed on suspense file",6,0,0,1,7
1965857,1600378,2025-08-29,Senate,"Do pass as amended",7,0,0,0,7
1965857,1601575,2025-09-09,Senate,"Assembly 3rd Reading AB543 Mark González et al. By Rubio",40,0,0,0,40
1965858,1538901,2025-04-07,Assembly,"Do pass and be re-referred to the Committee on [Appropriations] with recommendation: To Consent Calendar",16,0,0,0,16
1965858,1563084,2025-04-30,Assembly,"Do pass. To Consent Calendar",14,0,0,1,15
1965858,1568653,2025-05-08,Assembly,"AB 544 Davies Consent Calendar Second Day Regular Session",69,0,0,10,79
1965858,1588091,2025-06-10,Senate,"Do pass, but first be re-referred to the Committee on [Appropriations] with the recommendation: To Consent Calendar",13,0,0,2,15
1965858,1597589,2025-07-03,Senate,"Consent Calendar 2nd AB544 Davies",35,0,0,5,40
1965859,1538927,2025-04-07,Assembly,"Do pass and be re-referred to the Committee on [Appropriations] with recommendation: To Consent Calendar",16,0,0,0,16
1965859,1562897,2025-04-30,Assembly,"Do pass. To Consent Calendar",14,0,0,1,15
1965859,1568662,2025-05-08,Assembly,"AB 545 Davies Consent Calendar Second Day Regular Session",69,0,0,10,79
1965859,1588059,2025-06-10,Senate,"Do pass, but first be re-referred to the Committee on [Appropriations] with the recommendation: To Consent Calendar",13,0,0,2,15
1965859,1597601,2025-07-03,Senate,"Consent Calendar 2nd AB545 Davies",35,0,0,5,40
1965860,1562778,2025-04-29,Assembly,"Do pass as amended and be re-referred to the Committee on [Appropriations]",14,0,0,2,16
1965860,1575485,2025-05-21,Assembly,"Do pass",11,0,0,4,15
1965860,1579261,2025-05-27,Assembly,"AB 546 Caloza Third Reading Urgency",67,0,0,12,79
1965860,1597441,2025-07-02,Senate,"Do pass as amended, but first amend, and re-refer to the Committee on [Appropriations]",9,0,0,2,11
1965860,1599581,2025-08-18,Senate,"Placed on suspense file",7,0,0,0,7
1965860,1600446,2025-08-29,Senate,"Do pass as amended",5,0,0,2,7
1965860,1601225,2025-09-08,Senate,"Assembly 3rd Reading AB546 Caloza et al. By Limón Urgency Clause",29,3,0,8,40
1965860,1601505,2025-09-09,Assembly,"AB 546 Caloza Concurrence in Senate Amendments",67,0,0,13,80
1965861,1566735,2025-05-05,Assembly,"Do pass as amended and be re-referred to the Committee on [Appropriations]",5,1,0,1,7
1965862,1562884,2025-04-29,Assembly,"Do pass and be re-referred to the Committee on [Appropriations]",5,2,0,0,7
1965863,1540918,2025-04-07,Assembly,"Do pass and be re-referred to the Committee on [Arts, Entertainment, Sports, and Tourism]",7,0,0,0,7
1965863,1554443,2025-04-22,Assembly,"Do pass as amended and be re-referred to the Committee on [Appropriations]",8,0,0,1,9
1965864,1562814,2025-04-29,Assembly,"Do pass as amended and be re-referred to the Committee on [Appropriations]",13,0,0,0,13
1965864,1577731,2025-05-23,Assembly,"Do pass",14,0,0,1,15
1965864,1583522,2025-06-02,Assembly,"AB 550 Petrie-Norris Assembly Third Reading",76,0,0,3,79
1965865,1540868,2025-04-08,Assembly,"Do pass as amended and be re-referred to the Committee on [Appropriations]",12,1,0,2,15
1965866,1536846,2025-04-02,Assembly,"Do pass and be re-referred to the Committee on [Appropriations]",6,0,0,1,7
1965867,1526898,2025-03-25,Assembly,"Do pass and be re-referred to the Committee on [Appropriations] with recommendation: To Consent Calendar",7,0,0,0,7
1965867,1542894,2025-04-09,Assembly,"Do pass. To Consent Calendar",14,0,0,1,15
1965867,1557485,2025-04-24,Assembly,"AB 553 Caloza Consent Calendar Second Day Regular Session",75,0,0,4,79
1965867,1591148,2025-06-16,Senate,"Do pass, but first be re-referred to the Committee on [Appropriations] with the recommendation: To Consent Calendar",5,0,0,0,5
1965867,1597584,2025-07-03,Senate,"Consent Calendar 2nd AB553 Caloza et al",35,0,0,5,40
1965868,1562787,2025-04-29,Assembly,"Do pass and be re-referred to the Committee on [Appropriations]",14,0,0,2,16
1965868,1577789,2025-05-23,Assembly,"Do pass as amended",11,0,0,4,15
1965868,1584300,2025-06-03,Assembly,"AB 554 Mark González Assembly Third Reading",68,1,0,10,79
1965868,1598889,2025-07-16,Senate,"Do pass as amended, but first amend, and re-refer to the Committee on [Appropriations]",9,0,0,2,11
1965868,1599519,2025-08-18,Senate,"Placed on suspense file",7,0,0,0,7
1965868,1600571,2025-08-29,Senate,"Do pass",6,0,0,1,7
1965868,1601485,2025-09-09,Senate,"Assembly 3rd Reading AB554 Mark González et al. By Cabaldon",31,0,0,9,40
1965869,1492767,2025-02-18,Assembly,"Be adopted. To third reading",10,0,0,1,11
1965871,1521964,2025-03-19,Senate,"Do pass, but first be re-referred to the Committee on [Elections and Constitutional Amendments]",5,1,0,1,7
1965871,1561018,2025-04-29,Senate,"Do pass as amended, but first amend, and re-refer to the Committee on [Appropriations]",4,1,0,0,5
1965871,1569809,2025-05-12,Senate,"Placed on suspense file",7,0,0,0,7
1965871,1577248,2025-05-23,Senate,"Do pass",5,1,0,1,7
1965871,1584302,2025-06-03,Senate,"Senate 3rd Reading SB316 Reyes By Allen",28,9,0,3,40
1965871,1597383,2025-07-02,Assembly,"Do pass and be re-referred to the Committee on [Elections]",9,0,0,0,9
1965871,1598545,2025-07-16,Assembly,"Do pass as amended and be re-referred to the Committee on [Appropriations]",5,1,0,1,7
1965872,1557549,2025-04-23,Senate,"Do pass as amended, but first amend, and re-refer to the Committee on [Appropriations] with the recommendation: To Consent Calendar",11,0,0,0,11
1965872,1569869,2025-05-12,Senate,"Placed on suspense file",7,0,0,0,7
1965872,1577211,2025-05-23,Senate,"Do pass",6,0,0,1,7
1965872,1581781,2025-05-29,Senate,"Special Consent SB317 Hurtado et al",38,0,0,2,40
1965872,1591846,2025-06-17,Assembly,"Do pass as amended, and be re-referred to the Committee on [Environmental Safety and Toxic Materials] with recommendation: To Consent Calendar",15,0,0,1,16
1965872,1597276,2025-07-01,Assembly,"Do pass and be re-referred to the Committee on [Appropriations] with recommendation: To Consent Calendar",7,0,0,0,7
1965872,1600463,2025-08-29,Assembly,"Do pass as amended",11,0,0,4,15
1965872,1601355,2025-09-08,Assembly,"SB 317 Hurtado Senate Third Reading By Michelle Rodriguez",79,0,0,1,80
1965872,1601966,2025-09-11,Senate,"Unfinished Business SB317 Hurtado et al. Concurrence",40,0,0,0,40
1965873,1555950,2025-04-23,Senate,"Do pass as amended, but first amend, and re-refer to the Committee on [Appropriations]",5,3,0,0,8
1965873,1565302,2025-05-05,Senate,"Placed on suspense file",7,0,0,0,7
1965874,1554625,2025-04-22,Senate,"Do pass as amended, but first amend, and re-refer to the Committee on [Appropriations]",5,0,0,1,6
1965874,1565357,2025-05-05,Senate,"Placed on suspense file",7,0,0,0,7
1965875,1526915,2025-03-25,Senate,"Do pass as amended, but first amend, and re-refer to the Committee on [Judiciary]",5,1,0,0,6
1965875,1555917,2025-04-22,Senate,"Do pass, but first be re-referred to the Committee on [Appropriations]",11,2,0,0,13
1965875,1565319,2025-05-05,Senate,"Placed on suspense file",7,0,0,0,7
1965876,1561168,2025-04-29,Senate,"Do pass, but first be re-referred to the Committee on [Appropriations]",5,0,0,0,5
1965876,1569823,2025-05-12,Senate,"Placed on suspense file",7,0,0,0,7
1965877,1555935,2025-04-23,Senate,"Do pass, but first be re-referred to the Committee on [Appropriations] with the recommendation: To Consent Calendar",7,0,0,0,7
1965877,1572452,2025-05-15,Senate,"Consent Calendar 2nd SB322 Menjivar",34,0,0,6,40
1965877,1597611,2025-07-02,Assembly,"Do pass and be re-referred to the Committee on [Appropriations]",9,0,0,1,10
1965878,1556033,2025-04-23,Senate,"Do pass, but first be re-referred to the Committee on [Appropriations]",6,0,0,1,7
1965878,1565243,2025-05-05,Senate,"Placed on suspense file",7,0,0,0,7
1965878,1577240,2025-05-23,Senate,"Do pass",5,0,0,2,7
1965878,1586396,2025-06-02,Senate,"Senate 3rd Reading SB323 Pérez",31,1,0,8,40
1965878,1597828,2025-07-08,Assembly,"Do pass as amended and be re-referred to the Committee on [Appropriations]",8,2,0,0,10
1965879,1535037,2025-04-02,Senate,"Do pass as amended, but first amend, and re-refer to the Committee on [Appropriations]",11,0,0,0,11
1965879,1552944,2025-04-21,Senate,"Placed on suspense file",6,0,0,1,7
1965879,1577681,2025-05-23,Senate,"Do pass",6,0,0,1,7
1965879,1579270,2025-05-27,Senate,"Senate 3rd Reading SB324 Menjivar et al",39,0,0,1,40
1965879,1597155,2025-07-01,Assembly,"Do pass as amended and be re-referred to the Committee on [Appropriations]",15,0,0,1,16
1965881,1526978,2025-03-25,Senate,"Do pass, but first be re-referred to the Committee on [Natural Resources and Water] with the recommendation: To Consent Calendar",13,0,0,2,15
1965881,1554507,2025-04-22,Senate,"Do pass, but first be re-referred to the Committee on [Appropriations] with the recommendation: To Consent Calendar",6,0,0,1,7
1965881,1565265,2025-05-05,Senate,"Placed on suspense file",7,0,0,0,7
1965881,1577417,2025-05-23,Senate,"Do pass",6,0,0,1,7
1965881,1584330,2025-06-03,Senate,"Senate 3rd Reading SB326 Becker et al",39,0,0,1,40
1965881,1597161,2025-06-30,Assembly,"Do pass and be re-referred to the Committee on [Natural Resources]",5,0,0,2,7
1965881,1597660,2025-07-07,Assembly,"Do pass as amended and be re-referred to the Committee on [Appropriations]",14,0,0,0,14
1965881,1600725,2025-08-29,Assembly,"Do pass as amended",11,0,0,4,15
1965881,1602179,2025-09-12,Senate,"Unfinished Business SB326 Becker et al. Concurrence",37,0,0,3,40
1965881,1602180,2025-09-12,Assembly,"SB 326 Becker Senate Third Reading By Bryan",79,0,0,1,80
1965883,1536782,2025-04-02,Senate,"Do pass as amended, but first amend, and re-refer to the Committee on [Revenue and Taxation]",8,0,0,0,8
1965883,1556102,2025-04-23,Senate,"Do pass as amended, but first amend, and re-refer to the Committee on [Appropriations]",5,0,0,0,5
1965883,1569802,2025-05-12,Senate,"Placed on suspense file",7,0,0,0,7
1965883,1577557,2025-05-23,Senate,"Do pass as amended",5,0,0,2,7
1965883,1581707,2025-05-29,Senate,"Senate 3rd Reading SB328 Grayson",38,0,0,2,40
1965883,1597115,2025-07-01,Assembly,"Do pass and be re-referred to the Committee on [Revenue and Taxation]",7,0,0,0,7
1965883,1598437,2025-07-14,Assembly,"Do pass and be re-referred to the Committee on [Appropriations]",7,0,0,0,7
1965884,1528308,2025-03-26,Senate,"Do pass as amended, but first amend, and re-refer to the Committee on [Appropriations]",10,0,0,1,11
1965884,1552937,2025-04-21,Senate,"Placed on suspense file",6,0,0,1,7
1965884,1577550,2025-05-23,Senate,"Do pass",6,0,0,1,7
1965884,1581705,2025-05-29,Senate,"Special Consent SB329 Blakespear et al",38,0,0,2,40
1965884,1594656,2025-06-24,Assembly,"Do pass and be re-referred to the Committee on [Appropriations] with recommendation: To Consent Calendar",15,0,0,1,16
1965885,1498289,2025-02-24,Senate,"Senate 3rd Reading SCR21 Smallwood-Cuevas",37,0,0,2,39
1965885,1519136,2025-03-17,Assembly,"Be adopted. To Consent Calendar",10,0,0,1,11
1965885,1523438,2025-03-20,Assembly,"SCR 21 Smallwood-Cuevas Consent Calendar Second Day Regular Session",66,0,0,14,80
1965886,1495961,2025-02-20,Senate,"Senate 3rd Reading SR16 Caballero et al",36,0,0,3,39
1968196,1559391,2025-04-28,Assembly,"Do pass and be re-referred to the Committee on [Appropriations] with recommendation: To Consent Calendar",14,0,0,0,14
1968197,1522021,2025-03-18,Assembly,"Do pass and be re-referred to the Committee on [Military and Veterans Affairs]",8,0,0,2,10
1968197,1545004,2025-04-08,Assembly,"Do pass and be re-referred to the Committee on [Appropriations]",6,0,0,2,8
1968198,1558354,2025-04-24,Assembly,"Do pass and be re-referred to the Committee on [Local Government]",11,0,0,1,12
1968198,1577611,2025-05-23,Assembly,"Do pass",13,0,0,2,15
1968198,1583378,2025-06-02,Assembly,"AB 557 McKinnor Assembly Third Reading",76,0,0,3,79
1968200,1533464,2025-04-01,Assembly,"Do pass and be re-referred to the Committee on [Judiciary] with recommendation: To Consent Calendar",17,0,0,1,18
1968200,1540930,2025-04-08,Assembly,"Do pass and be re-referred to the Committee on [Appropriations] with recommendation: To Consent Calendar",12,0,0,0,12
1968200,1556159,2025-04-23,Assembly,"Do pass. To Consent Calendar",15,0,0,0,15
1968200,1564298,2025-05-01,Assembly,"AB 559 Berman Consent Calendar Second Day Regular Session",76,0,0,3,79
1968200,1596805,2025-06-30,Senate,"Do pass, but first be re-referred to the Committee on [Judiciary]",10,0,0,1,11
1968200,1597940,2025-07-08,Senate,"Do pass, but first be re-referred to the Committee on [Appropriations]",13,0,0,0,13
1968200,1600035,2025-08-25,Senate,"Placed on suspense file",6,0,0,1,7
1968200,1600559,2025-08-29,Senate,"Do pass",7,0,0,0,7
1968201,1564181,2025-04-30,Assembly,"Do pass and be re-referred to the Committee on [Appropriations]",9,0,0,0,9
1968201,1577375,2025-05-23,Assembly,"Do pass",14,0,0,1,15
1968201,1583399,2025-06-02,Assembly,"AB 560 Addis Assembly Third Reading",79,0,0,0,79
1968201,1598125,2025-07-09,Senate,"Do pass, but first be re-referred to the Committee on [Appropriations]",7,0,0,0,7
1968201,1599373,2025-08-18,Senate,"Placed on suspense file",7,0,0,0,7
1968201,1600326,2025-08-29,Senate,"Do pass as amended",6,1,0,0,7
1968201,1601249,2025-09-08,Senate,"Assembly 3rd Reading AB560 Addis et al. By Cortese",36,0,0,4,40
1968201,1601462,2025-09-09,Assembly,"AB 560 Addis Concurrence in Senate Amendments",79,0,0,1,80
1968202,1526927,2025-03-25,Assembly,"Do pass and be re-referred to the Committee on [Appropriations] with recommendation: To Consent Calendar",12,0,0,0,12
1968202,1577803,2025-05-23,Assembly,"Do pass",14,0,0,1,15
1968202,1583442,2025-06-02,Assembly,"AB 561 Quirk-Silva Assembly Third Reading",79,0,0,0,79
1968202,1597947,2025-07-08,Senate,"Do pass as amended, but first amend, and re-refer to the Committee on [Appropriations] with the recommendation: To Consent Calendar",13,0,0,0,13
1968202,1600031,2025-08-25,Senate,"Placed on suspense file",6,0,0,1,7
1968202,1600771,2025-08-29,Senate,"Do pass",7,0,0,0,7
1968202,1601588,2025-09-09,Senate,"Assembly 3rd Reading AB561 Quirk-Silva By Allen",40,0,0,0,40
1968203,1526949,2025-03-25,Assembly,"Do pass and be re-referred to the Committee on [Appropriations]",7,0,0,0,7
1968203,1542800,2025-04-09,Assembly,"Do pass",14,0,0,1,15
1968203,1569780,2025-05-12,Assembly,"AB 562 Solache Assembly Third Reading",78,0,0,1,79
1968203,1591149,2025-06-16,Senate,"Do pass, but first be re-referred to the Committee on [Appropriations] with the recommendation: To Consent Calendar",5,0,0,0,5
1968203,1596794,2025-06-30,Senate,"Placed on suspense file",6,0,0,1,7
1968203,1600622,2025-08-29,Senate,"Do pass as amended",7,0,0,0,7
1968203,1601894,2025-09-11,Senate,"Special Consent AB562 Solache et al. By Smallwood-Cuevas",40,0,0,0,40
1968203,1602170,2025-09-12,Assembly,"AB 562 Solache Concurrence in Senate Amendments",80,0,0,0,80
1968204,1540804,2025-04-08,Assembly,"Do pass as amended and be re-referred to the Committee on [Education]",6,0,0,0,6
1968204,1564174,2025-04-30,Assembly,"Do pass and be re-referred to the Committee on [Appropriations] with recommendation: To Consent Calendar",9,0,0,0,9
1968204,1577214,2025-05-23,Assembly,"Do pass",14,0,0,1,15
1968204,1583568,2025-06-02,Assembly,"AB 563 Jackson Assembly Third Reading",79,0,0,0,79
1968204,1597193,2025-06-30,Senate,"Do pass, but first be re-referred to the Committee on [Education] with the recommendation: To Consent Calendar",5,0,0,0,5
1968204,1598129,2025-07-09,Senate,"Do pass, but first be re-referred to the Committee on [Appropriations] with the recommendation: To Consent Calendar",7,0,0,0,7
1968204,1599650,2025-08-18,Senate,"Placed on suspense file",7,0,0,0,7
1968204,1600300,2025-08-29,Senate,"Do pass",7,0,0,0,7
1968204,1601185,2025-09-04,Senate,"Special Consent AB563 Jackson",39,0,0,1,40
1968205,1554556,2025-04-22,Assembly,"Do pass and be re-referred to the Committee on [Revenue and Taxation]",15,0,0,3,18
1968205,1566722,2025-05-05,Assembly,"Do pass as amended and be re-referred to the Committee on [Appropriations]",6,0,0,1,7
1968205,1577332,2025-05-23,Assembly,"Do pass",13,0,0,2,15
1968205,1583584,2025-06-02,Assembly,"AB 564 Haney Assembly Third Reading",74,0,0,5,79
1968205,1598044,2025-07-09,Senate,"Do pass as amended, but first amend, and re-refer to the Committee on [Appropriations]",5,0,0,0,5
1968205,1599504,2025-08-18,Senate,"Placed on suspense file",7,0,0,0,7
1968205,1600774,2025-08-29,Senate,"Do pass as amended",7,0,0,0,7
1968205,1601742,2025-09-10,Senate,"Assembly 3rd Reading AB564 Haney et al. By Cabaldon",39,1,0,0,40
1968206,1526907,2025-03-25,Assembly,"Do pass as amended. To Consent Calendar",12,0,0,0,12
1968206,1536806,2025-04-03,Assembly,"AB 565 Dixon Consent Calendar Second Day",74,0,0,5,79
1968206,1591907,2025-06-17,Senate,"Do pass and be ordered to the Consent Calendar",12,0,0,1,13
1968206,1594074,2025-06-23,Senate,"Consent Calendar 2nd AB565 Dixon",37,0,0,3,40
1968207,1535134,2025-04-01,Assembly,"Do pass as amended and be re-referred to the Committee on [Appropriations]",9,0,0,6,15
1968207,1555903,2025-04-23,Assembly,"Do pass",11,0,0,4,15
1968207,1585794,2025-06-05,Assembly,"AB 566 Lowenthal Assembly Third Reading",53,1,0,25,79
1968207,1597363,2025-07-01,Senate,"Do pass, but first be re-referred to the Committee on [Appropriations]",11,0,0,2,13
1968207,1601763,2025-09-10,Senate,"Assembly 3rd Reading AB566 Lowenthal et al. By Stern",31,7,0,2,40
1968209,1527012,2025-03-25,Assembly,"Do pass as amended and be re-referred to the Committee on [Appropriations]",9,0,0,0,9
1968209,1577632,2025-05-23,Assembly,"Do pass as amended",11,0,0,4,15
1968209,1585085,2025-06-04,Assembly,"AB 568 Lackey Assembly Third Reading",72,0,0,7,79
1968209,1598605,2025-07-16,Senate,"Do pass as amended, but first amend, and re-refer to the Committee on [Appropriations]",7,0,0,0,7
1968209,1601177,2025-09-04,Senate,"Assembly 3rd Reading AB568 Macedo By Grove",39,0,0,1,40
1968209,1601803,2025-09-10,Assembly,"With recommendation: That Senate amendments be concurred in",13,0,0,0,13
1968210,1556073,2025-04-23,Assembly,"Do pass as amended",7,0,0,0,7
1968211,1535001,2025-04-02,Assembly,"Do pass and be re-referred to the Committee on [Appropriations] with recommendation: To Consent Calendar",17,0,0,0,17
1968211,1556023,2025-04-23,Assembly,"Do pass. To Consent Calendar",15,0,0,0,15
1968211,1564152,2025-05-01,Assembly,"AB 570 Calderon Consent Calendar Second Day Regular Session",76,0,0,3,79
1968212,1538976,2025-04-07,Assembly,"Do pass as amended and be re-referred to the Committee on [Military and Veterans Affairs]",14,0,0,0,14
1968212,1561152,2025-04-29,Assembly,"Do pass and be re-referred to the Committee on [Appropriations]",8,0,0,0,8
1968212,1567852,2025-05-07,Assembly,"Do pass",15,0,0,0,15
1968212,1573503,2025-05-19,Assembly,"AB 571 Quirk-Silva Third Reading Urgency",75,0,0,4,79
1968212,1592580,2025-06-18,Senate,"Do pass as amended, but first amend, and re-refer to the Committee on [Military and Veterans Affairs] with the recommendation: To Consent Calendar",6,0,0,2,8
1968212,1598228,2025-07-14,Senate,"Do pass, but first be re-referred to the Committee on [Appropriations]",5,0,0,0,5
1968212,1600831,2025-09-02,Senate,"Assembly 3rd Reading AB571 Quirk-Silva et al. By Archuleta Urgency Clause",40,0,0,0,40
1968212,1600878,2025-09-03,Assembly,"AB 571 Quirk-Silva Concurrence in Senate Amendments",79,0,0,0,79
1968213,1526969,2025-03-25,Assembly,"Do pass as amended and be re-referred to the Committee on [Appropriations]",5,2,0,2,9
1968213,1542788,2025-04-09,Assembly,"Do pass",10,4,0,1,15
1968213,1585053,2025-06-04,Assembly,"AB 572 Kalra Assembly Third Reading",44,22,0,13,79
1968213,1597975,2025-07-08,Senate,"Do pass, but first be re-referred to the Committee on [Appropriations]",5,1,0,0,6
1968213,1602195,2025-09-12,Senate,"Assembly 3rd Reading AB572 Kalra et al. By Cortese",22,10,0,8,40
1968213,1602196,2025-09-13,Assembly,"AB 572 Kalra Concurrence in Senate Amendments",42,22,0,16,80
1968214,1556208,2025-04-22,Assembly,"Do pass and be re-referred to the Committee on [Appropriations]",13,0,0,3,16
1968214,1577186,2025-05-23,Assembly,"Do pass",11,0,0,4,15
1968214,1584303,2025-06-03,Assembly,"AB 573 Rogers Assembly Third Reading",63,1,0,15,79
1968214,1597469,2025-07-02,Senate,"Do pass, but first be re-referred to the Committee on [Revenue and Taxation]",9,0,0,2,11
1968214,1598108,2025-07-09,Senate,"Do pass, but first be re-referred to the Committee on [Appropriations]",4,0,0,1,5
1968214,1599392,2025-08-18,Senate,"Placed on suspense file",7,0,0,0,7
1968214,1600587,2025-08-29,Senate,"Do pass",5,0,0,2,7
1968214,1601587,2025-09-09,Senate,"Assembly 3rd Reading AB573 Rogers et al. By Rubio",33,0,0,7,40
1968215,1555883,2025-04-22,Assembly,"Do pass and be re-referred to the Committee on [Appropriations]",16,0,0,0,16
1968215,1562867,2025-04-30,Assembly,"Do pass",14,0,0,1,15
1968215,1569866,2025-05-12,Assembly,"AB 574 Mark González Assembly Third Reading",73,1,0,5,79
1968215,1589106,2025-06-11,Senate,"Do pass as amended, but first amend, and re-refer to the Committee on [Appropriations]",7,0,0,4,11
1968215,1600851,2025-09-02,Senate,"Assembly 3rd Reading AB574 Mark González et al. By Wiener",39,0,0,1,40
1968215,1600944,2025-09-03,Assembly,"AB 574 Mark González Concurrence in Senate Amendments",76,1,0,2,79
1968217,1564218,2025-05-01,Assembly,"Do pass and be re-referred to the Committee on [Appropriations]",13,0,0,2,15
1968218,1563041,2025-04-29,Assembly,"Do pass as amended and be re-referred to the Committee on [Appropriations]",12,0,0,4,16
1968219,1520442,2025-03-18,Assembly,"Do pass as amended",14,0,0,1,15
1968219,1573580,2025-05-19,Assembly,"AB 578 Bauer-Kahan Assembly Third Reading",63,2,0,14,79
1968219,1597547,2025-07-01,Senate,"Do pass as amended, but first amend, and re-refer to the Committee on [Business, Professions and Economic Development]",11,0,0,2,13
1968219,1598278,2025-07-14,Senate,"Do pass as amended",7,1,0,3,11
1968219,1600904,2025-09-03,Senate,"Assembly 3rd Reading AB578 Bauer-Kahan By Durazo",28,6,0,6,40
1968219,1601172,2025-09-04,Assembly,"AB 578 Bauer-Kahan Concurrence in Senate Amendments",66,0,0,13,79
1968221,1525458,2025-03-24,Assembly,"Do pass as amended and be re-referred to the Committee on [Water, Parks, and Wildlife]",13,0,0,1,14
1968221,1563031,2025-04-29,Assembly,"Do pass and be re-referred to the Committee on [Appropriations] with recommendation: To Consent Calendar",13,0,0,0,13
1968221,1571611,2025-05-14,Assembly,"Do pass. To Consent Calendar",15,0,0,0,15
1968221,1577592,2025-05-23,Assembly,"AB 580 Wallis Consent Calendar Second Day Regular Session",71,0,0,8,79
1968221,1598582,2025-07-16,Senate,"Do pass as amended, but first amend, and re-refer to the Committee on [Appropriations] with the recommendation: To Consent Calendar",7,0,0,0,7
1968221,1600046,2025-08-25,Senate,"Consent Calendar 2nd AB580 Wallis",37,0,0,3,40
1968221,1600242,2025-08-28,Assembly,"AB 580 Wallis Concurrence in Senate Amendments",75,0,0,4,79
1968222,1526900,2025-03-25,Assembly,"Do pass. To Consent Calendar",13,0,0,0,13
1968222,1530382,2025-03-28,Assembly,"AB 581 Bennett Consent Calendar Second Day Regular Session",61,0,0,19,80
1968222,1588084,2025-06-10,Senate,"Do pass",13,0,0,2,15
1968222,1600804,2025-09-02,Senate,"Assembly 3rd Reading AB581 Bennett By Ochoa Bogh",40,0,0,0,40
1968224,1533529,2025-04-01,Assembly,"Do pass as amended and be re-referred to the Committee on [Appropriations]",15,0,0,0,15
1968224,1555997,2025-04-23,Assembly,"Do pass",15,0,0,0,15
1968224,1568607,2025-05-08,Assembly,"AB 583 Pellerin Assembly Third Reading",72,0,0,7,79
1968224,1589131,2025-06-11,Senate,"Do pass, but first be re-referred to the Committee on [Appropriations] with the recommendation: To Consent Calendar",9,0,0,2,11
1968224,1600855,2025-09-02,Senate,"Assembly 3rd Reading AB583 Pellerin By Menjivar",40,0,0,0,40
1968224,1601008,2025-09-03,Assembly,"AB 583 Pellerin Concurrence in Senate Amendments",79,0,0,0,79
1968225,1526930,2025-03-25,Assembly,"Do pass and be re-referred to the Committee on [Appropriations] with recommendation: To Consent Calendar",9,0,0,0,9
1968225,1542679,2025-04-09,Assembly,"Do pass. To Consent Calendar",14,0,0,1,15
1968225,1557513,2025-04-24,Assembly,"AB 584 Hadwick Consent Calendar Second Day Regular Session",75,0,0,4,79
1968225,1588083,2025-06-10,Senate,"Do pass, but first be re-referred to the Committee on [Appropriations] with the recommendation: To Consent Calendar",6,0,0,0,6
1968225,1596004,2025-06-27,Senate,"Consent Calendar 2nd AB584 Hadwick",38,0,0,2,40
1968226,1563005,2025-04-29,Assembly,"Do pass and be re-referred to the Committee on [Appropriations] with recommendation: To Consent Calendar",16,0,0,0,16
1968227,1533467,2025-04-01,Assembly,"Do pass and be re-referred to the Committee on [Judiciary] with recommendation: To Consent Calendar",17,0,0,1,18
1968227,1554636,2025-04-22,Assembly,"Do pass and be re-referred to the Committee on [Appropriations] with recommendation: To Consent Calendar",12,0,0,0,12
1968227,1577522,2025-05-23,Assembly,"Do pass",14,0,0,1,15
1968227,1583390,2025-06-02,Assembly,"AB 586 Flora Assembly Third Reading",77,0,0,2,79
1968227,1597711,2025-07-07,Senate,"Do pass as amended, but first amend, and re-refer to the Committee on [Judiciary]",10,0,0,1,11
1968227,1598649,2025-07-15,Senate,"Do pass, but first be re-referred to the Committee on [Appropriations] with the recommendation: To Consent Calendar",13,0,0,0,13
1968227,1600019,2025-08-25,Senate,"Placed on suspense file",6,0,0,1,7
1968228,1556211,2025-04-22,Assembly,"Do pass and be re-referred to the Committee on [Appropriations]",10,0,0,0,10
1968228,1567886,2025-05-07,Assembly,"Do pass",15,0,0,0,15
1968228,1577449,2025-05-23,Assembly,"AB 587 Davies Assembly Third Reading",72,0,0,7,79
1968228,1592619,2025-06-18,Senate,"Do pass, but first be re-referred to the Committee on [Military and Veterans Affairs]",6,0,0,1,7
1968228,1598209,2025-07-14,Senate,"Do pass, but first be re-referred to the Committee on [Appropriations] with the recommendation: To Consent Calendar",5,0,0,0,5
1968228,1601775,2025-09-10,Senate,"Assembly 3rd Reading AB587 Davies By Seyarto",40,0,0,0,40
1968228,1602360,2025-09-12,Assembly,"AB 587 Davies Concurrence in Senate Amendments",79,0,0,1,80
1968229,1561170,2025-04-28,Assembly,"Do pass and be re-referred to the Committee on [Appropriations] with recommendation: To Consent Calendar",7,0,0,0,7
1968232,1561010,2025-04-28,Assembly,"Do pass and be re-referred to the Committee on [Appropriations]",7,0,0,0,7
1968233,1535063,2025-04-02,Assembly,"Do pass as amended and be re-referred to the Committee on [Health]",18,0,0,4,22
1968233,1556210,2025-04-22,Assembly,"Do pass and be re-referred to the Committee on [Appropriations]",16,0,0,0,16
1968233,1563097,2025-04-30,Assembly,"Do pass",14,0,0,1,15
1968233,1572443,2025-05-15,Assembly,"AB 592 Gabriel Assembly Third Reading",73,0,0,6,79
1968233,1594647,2025-06-24,Senate,"Do pass as amended, but first amend, and re-refer to the Committee on [Health]",15,0,0,0,15
1968233,1598898,2025-07-16,Senate,"Do pass as amended, but first amend, and re-refer to the Committee on [Appropriations]",10,0,0,1,11
1968233,1601166,2025-09-04,Senate,"Assembly 3rd Reading AB592 Gabriel et al. By Rubio",39,0,0,1,40
1968233,1601325,2025-09-08,Assembly,"AB 592 Gabriel Concurrence in Senate Amendments",78,0,0,2,80
1968234,1562916,2025-04-29,Assembly,"Do pass as amended and be re-referred to the Committee on [Appropriations]",7,0,0,0,7
1968234,1571626,2025-05-14,Assembly,"Do pass",15,0,0,0,15
1968234,1583392,2025-06-02,Assembly,"AB 593 Wicks Assembly Third Reading",79,0,0,0,79
1968234,1597717,2025-07-07,Senate,"Do pass, but first be re-referred to the Committee on [Judiciary]",5,0,0,0,5
1968234,1598731,2025-07-15,Senate,"Do pass, but first be re-referred to the Committee on [Appropriations]",13,0,0,0,13
1968234,1600956,2025-09-03,Senate,"Assembly 3rd Reading AB593 Wicks By Arreguín",40,0,0,0,40
1968234,1601090,2025-09-04,Assembly,"AB 593 Wicks Concurrence in Senate Amendments",77,0,0,2,79
1968235,1540913,2025-04-08,Assembly,"Do pass and be re-referred to the Committee on [Appropriations]",15,0,0,0,15
1968235,1556017,2025-04-23,Assembly,"Do pass",15,0,0,0,15
1968235,1568615,2025-05-08,Assembly,"AB 594 Solache Assembly Third Reading",73,0,0,6,79
1968235,1592591,2025-06-18,Senate,"Do pass as amended, but first amend, and re-refer to the Committee on [Judiciary] with the recommendation: To Consent Calendar",10,0,0,1,11
1968235,1598887,2025-07-17,Senate,"Consent Calendar 2nd AB594 Solache et al",35,0,0,5,40
1968235,1600011,2025-08-25,Assembly,"AB 594 Solache Concurrence in Senate Amendments",76,0,0,3,79
1968236,1530394,2025-03-28,Assembly,"Be adopted. To third reading",7,0,0,4,11
1968236,1572447,2025-05-15,Senate,"Special Consent ACR31 Hadwick et al",34,0,0,6,40
1968237,1561141,2025-04-29,Senate,"Do pass, but first be re-referred to the Committee on [Environmental Quality]",13,3,0,1,17
1968237,1562976,2025-04-30,Senate,"Do pass, but first be re-referred to the Committee on [Appropriations]",6,2,0,0,8
1968237,1569818,2025-05-12,Senate,"Placed on suspense file",7,0,0,0,7
1968237,1577682,2025-05-23,Senate,"Do pass",5,1,0,1,7
1968237,1584298,2025-06-03,Senate,"Senate 3rd Reading SB330 Padilla",28,10,0,2,40
1968238,1544998,2025-04-09,Senate,"Do pass as amended, but first amend, and re-refer to the Committee on [Judiciary]",8,0,0,3,11
1968238,1563014,2025-04-29,Senate,"Do pass as amended, but first amend, and re-refer to the Committee on [Appropriations]",10,0,0,3,13
1968238,1569910,2025-05-12,Senate,"Placed on suspense file",7,0,0,0,7
1968238,1577286,2025-05-23,Senate,"Do pass as amended",5,0,0,2,7
1968238,1585080,2025-06-04,Senate,"Senate 3rd Reading SB331 Menjivar",27,0,0,13,40
1968239,1554554,2025-04-21,Senate,"Do pass, but first be re-referred to the Committee on [Judiciary]",12,4,0,1,17
1968239,1565333,2025-05-05,Senate,"Placed on suspense file",7,0,0,0,7
1968239,1577343,2025-05-23,Senate,"Do pass as amended",5,0,0,2,7
1968239,1586397,2025-06-02,Senate,"Senate 3rd Reading SB332 Wahab",25,10,0,5,40
1968239,1598053,2025-07-09,Assembly,"Do pass as amended and be re-referred to the Committee on [Appropriations]",11,5,0,2,18
1968240,1521989,2025-03-19,Senate,"Do pass, but first be re-referred to the Committee on [Revenue and Taxation]",5,2,0,0,7
1968240,1542715,2025-04-09,Senate,"Do pass",4,1,0,0,5
1968240,1581780,2025-05-29,Senate,"Senate 3rd Reading SB333 Laird et al",28,10,0,2,40
1968240,1592589,2025-06-18,Assembly,"Do pass and be re-referred to the Committee on [Revenue and Taxation]",7,2,0,1,10
1968240,1597946,2025-07-07,Assembly,"Do pass as amended",5,2,0,0,7
1968240,1601482,2025-09-09,Assembly,"SB 333 Laird Senate Third Reading By Addis",54,19,0,7,80
1968240,1601795,2025-09-10,Senate,"Unfinished Business SB333 Laird et al. Concurrence",30,10,0,0,40
1968241,1535027,2025-04-02,Senate,"Do pass, but first be re-referred to the Committee on [Judiciary]",6,0,0,1,7
1968241,1565279,2025-05-05,Senate,"Placed on suspense file",7,0,0,0,7
1968241,1577807,2025-05-23,Senate,"Do pass as amended",6,0,0,1,7
1968241,1580549,2025-05-28,Senate,"Senate 3rd Reading SB334 Reyes",36,0,0,4,40
1968241,1597537,2025-07-02,Assembly,"Do pass as amended and be re-referred to the Committee on [Appropriations]",9,0,0,0,9
1968242,1561203,2025-04-29,Senate,"Do pass, but first be re-referred to the Committee on [Appropriations]",1,4,0,0,5
1968242,1561204,2025-04-29,Senate,"[First] hearing set for [04-29-2025]: Failed passage in Committee. Reconsideration granted",5,0,0,0,5
1968243,1571562,2025-05-14,Senate,"Do pass, but first be re-referred to the Committee on [Appropriations]",5,0,0,0,5
1968243,1573498,2025-05-19,Senate,"Placed on suspense file",5,0,0,2,7
1968244,1562760,2025-04-29,Senate,"Do pass, but first be re-referred to the Committee on [Appropriations]",6,0,0,0,6
1968244,1569768,2025-05-12,Senate,"Placed on suspense file",7,0,0,0,7
1968244,1577920,2025-05-23,Senate,"Do pass as amended",6,0,0,1,7
1968244,1580531,2025-05-28,Senate,"Senate 3rd Reading SB337 Menjivar",38,0,0,2,40
1968244,1591863,2025-06-17,Assembly,"Do pass and be re-referred to the Committee on [Appropriations]",9,0,0,0,9
1968245,1557500,2025-04-23,Senate,"Do pass as amended, but first amend, and re-refer to the Committee on [Appropriations] with the recommendation: To Consent Calendar",11,0,0,0,11
1968245,1569835,2025-05-12,Senate,"Placed on suspense file",7,0,0,0,7
1968245,1577434,2025-05-23,Senate,"Do pass",6,0,0,1,7
1968245,1581765,2025-05-29,Senate,"Special Consent SB338 Becker et al",38,0,0,2,40
1968245,1597142,2025-07-01,Assembly,"Do pass as amended, and be re-referred to the Committee on [Appropriations] with recommendation: To Consent Calendar",15,0,0,1,16
1968245,1600425,2025-08-29,Assembly,"Do pass",15,0,0,0,15
1968245,1601491,2025-09-09,Assembly,"SB 338 Becker Senate Third Reading By Michelle Rodriguez",80,0,0,0,80
1968245,1601784,2025-09-10,Senate,"Unfinished Business SB338 Becker et al. Concurrence",40,0,0,0,40
1968246,1557569,2025-04-23,Senate,"Do pass, but first be re-referred to the Committee on [Judiciary]",11,0,0,0,11
1968246,1563121,2025-04-29,Senate,"Do pass, but first be re-referred to the Committee on [Appropriations] with the recommendation: To Consent Calendar",13,0,0,0,13
1968246,1569779,2025-05-12,Senate,"Placed on suspense file",7,0,0,0,7
1968247,1533544,2025-04-01,Senate,"Do pass, but first be re-referred to the Committee on [Appropriations]",11,0,0,0,11
1968247,1579299,2025-05-27,Senate,"Senate 3rd Reading SB340 Laird",39,0,0,1,40
1968247,1597459,2025-07-02,Assembly,"Do pass and be re-referred to the Committee on [Local Government]",11,0,0,1,12
1968247,1598864,2025-07-16,Assembly,"Do pass. To Consent Calendar",10,0,0,0,10
1968247,1599029,2025-07-16,Assembly,"Do pass and be re-referred to the Committee on [Appropriations] with recommendation: To Consent Calendar",10,0,0,0,10
1968247,1599728,2025-08-20,Assembly,"Do pass. To Consent Calendar",15,0,0,0,15
1968247,1601356,2025-09-08,Assembly,"SB 340 Laird Senate Third Reading By Ávila Farías",74,4,0,2,80
1968247,1601489,2025-09-09,Senate,"Unfinished Business SB340 Laird et al. Concurrence",40,0,0,0,40
1968248,1522019,2025-03-19,Senate,"Do pass as amended, but first amend, and re-refer to the Committee on [Agriculture]",6,0,0,1,7
1968248,1561078,2025-04-29,Senate,"Do pass, but first be re-referred to the Committee on [Appropriations] with the recommendation: To Consent Calendar",4,0,0,1,5
1968248,1569903,2025-05-12,Senate,"Placed on suspense file",7,0,0,0,7
1968251,1559397,2025-04-28,Senate,"Do pass, but first be re-referred to the Committee on [Appropriations] with the recommendation: To Consent Calendar",11,0,0,0,11
1968251,1572376,2025-05-15,Senate,"Consent Calendar 2nd SB344 Weber Pierson",34,0,0,6,40
1968251,1597206,2025-07-01,Assembly,"Do pass and be re-referred to the Committee on [Appropriations] with recommendation: To Consent Calendar",17,0,0,1,18
1968251,1598728,2025-07-16,Assembly,"Do pass. To Consent Calendar",13,0,0,2,15
1968252,1526953,2025-03-25,Senate,"Do pass, but first be re-referred to the Committee on [Appropriations] with the recommendation: To Consent Calendar",13,0,0,2,15
1968252,1538971,2025-04-07,Senate,"Placed on suspense file",7,0,0,0,7
1968252,1577762,2025-05-23,Senate,"Do pass",6,0,0,1,7
1968252,1581729,2025-05-29,Senate,"Special Consent SB345 Hurtado",38,0,0,2,40
1968252,1597132,2025-06-30,Assembly,"Do pass and be re-referred to the Committee on [Appropriations] with recommendation: To Consent Calendar",7,0,0,0,7
1968252,1600697,2025-08-29,Assembly,"Do pass",15,0,0,0,15
1968252,1601357,2025-09-08,Assembly,"SB 345 Hurtado Senate Third Reading By Irwin",79,0,0,1,80
1968253,1521960,2025-03-19,Senate,"Do pass as amended, but first amend, and re-refer to the Committee on [Judiciary]",7,0,0,0,7
1968253,1567879,2025-05-06,Senate,"Do pass as amended",12,0,0,1,13
1968253,1579278,2025-05-27,Senate,"Senate 3rd Reading SB346 Durazo et al",38,0,0,2,40
1968253,1597563,2025-07-02,Assembly,"Do pass as amended and be re-referred to the Committee on [Judiciary]",9,0,0,1,10
1968253,1598446,2025-07-15,Assembly,"Do pass",11,0,0,1,12
1968253,1600308,2025-08-29,Assembly,"SB 346 Durazo Senate Third Reading By Bauer-Kahan",64,0,0,15,79
1968253,1600850,2025-09-02,Senate,"Unfinished Business SB346 Durazo et al. Concurrence",40,0,0,0,40
1968255,1562846,2025-04-30,Senate,"Do pass as amended, but first amend, and re-refer to the Committee on [Appropriations]",6,0,0,2,8
1968255,1573604,2025-05-19,Senate,"Placed on suspense file",5,0,0,2,7
1968256,1526923,2025-03-25,Senate,"Do pass, but first be re-referred to the Committee on [Public Safety] with the recommendation: To Consent Calendar",14,0,0,1,15
1968256,1554463,2025-04-22,Senate,"Do pass, but first be re-referred to the Committee on [Appropriations] with the recommendation: To Consent Calendar",6,0,0,0,6
1968256,1565337,2025-05-05,Senate,"Placed on suspense file",7,0,0,0,7
1968257,1522014,2025-03-19,Senate,"Do pass as amended, but first amend, and re-refer to the Committee on [Energy, Utilities and Communications]",6,1,0,1,8
1968257,1554502,2025-04-21,Senate,"Do pass as amended, but first amend, and re-refer to the Committee on [Appropriations]",13,3,0,1,17
1968257,1569900,2025-05-12,Senate,"Placed on suspense file",7,0,0,0,7
1968258,1552901,2025-04-21,Senate,"Do pass, but first be re-referred to the Committee on [Judiciary]",9,1,0,1,11
1968258,1562810,2025-04-29,Senate,"Do pass, but first be re-referred to the Committee on [Appropriations]",11,2,0,0,13
1968258,1569796,2025-05-12,Senate,"Placed on suspense file",7,0,0,0,7
1968258,1577873,2025-05-23,Senate,"Do pass",5,1,0,1,7
1968258,1580529,2025-05-28,Senate,"Senate 3rd Reading SB351 Cabaldon",30,6,0,4,40
1968258,1594583,2025-06-24,Assembly,"Do pass and be re-referred to the Committee on [Judiciary]",16,0,0,2,18
1968258,1597127,2025-07-01,Assembly,"Do pass and be re-referred to the Committee on [Appropriations]",12,0,0,0,12
1968258,1598740,2025-07-16,Assembly,"Do pass",13,0,0,2,15
1968258,1600392,2025-08-29,Assembly,"SB 351 Cabaldon Senate Third Reading By Patel",72,0,0,7,79
1968258,1602239,2025-09-12,Senate,"Unfinished Business SB351 Cabaldon et al. Concurrence",32,3,0,5,40
1968258,1602240,2025-09-12,Assembly,"SB 351 Cabaldon Senate Third Reading By Patel",80,0,0,0,80
1968259,1540843,2025-04-07,Senate,"Do pass, but first be re-referred to the Committee on [Governmental Organization] with the recommendation: To Consent Calendar",5,0,0,0,5
1968259,1554466,2025-04-22,Senate,"Do pass, but first be re-referred to the Committee on [Appropriations] with the recommendation: To Consent Calendar",14,0,0,1,15
1968259,1565250,2025-05-05,Senate,"Placed on suspense file",7,0,0,0,7
1968259,1577505,2025-05-23,Senate,"Do pass",6,0,0,1,7
1968259,1581716,2025-05-29,Senate,"Special Consent SB352 Reyes",38,0,0,2,40
1968259,1594591,2025-06-24,Assembly,"Do pass and be re-referred to the Committee on [Emergency Management] with recommendation: To Consent Calendar",7,0,0,0,7
1968259,1598479,2025-07-14,Assembly,"Do pass and be re-referred to the Committee on [Appropriations] with recommendation: To Consent Calendar",7,0,0,0,7
1968259,1600555,2025-08-29,Assembly,"Do pass as amended",11,0,0,4,15
1968259,1602035,2025-09-12,Assembly,"Do pass",10,4,0,0,14
1968259,1602325,2025-09-12,Senate,"W/O REF. TO FILE SB352 Reyes",29,6,0,5,40
1968259,1602326,2025-09-13,Assembly,"SB 352 Reyes Senate Third Reading By BRYAN",55,19,0,6,80
1968260,1571556,2025-05-14,Senate,"Do pass, but first be re-referred to the Committee on [Appropriations]",5,0,0,0,5
1968260,1573609,2025-05-19,Senate,"Placed on suspense file",5,0,0,2,7
1968260,1577949,2025-05-23,Senate,"Do pass",6,0,0,1,7
1968260,1581677,2025-05-29,Senate,"Special Consent SB353 Alvarado-Gil et al",38,0,0,2,40
1968261,1542760,2025-04-09,Senate,"Do pass, but first be re-referred to the Committee on [Judiciary]",5,2,0,0,7
1968261,1563002,2025-04-29,Senate,"Do pass as amended, but first amend, and re-refer to the Committee on [Appropriations]",11,2,0,0,13
1968261,1569751,2025-05-12,Senate,"Placed on suspense file",7,0,0,0,7
1968261,1577927,2025-05-23,Senate,"Do pass as amended",5,1,0,1,7
1968261,1585126,2025-06-04,Senate,"Senate 3rd Reading SB354 Limón",28,10,0,2,40
1968262,1542841,2025-04-09,Senate,"Do pass, but first be re-referred to the Committee on [Rules]",5,0,0,0,5
1968262,1562775,2025-04-29,Senate,"Do pass, but first be re-referred to the Committee on [Appropriations] with the recommendation: To Consent Calendar",13,0,0,0,13
1968262,1569870,2025-05-12,Senate,"Placed on suspense file",7,0,0,0,7
1968262,1577395,2025-05-23,Senate,"Do pass",6,0,0,1,7
1968262,1581754,2025-05-29,Senate,"Special Consent SB355 Pérez et al",38,0,0,2,40
1968262,1595671,2025-06-25,Assembly,"Do pass and be re-referred to the Committee on [Judiciary] with recommendation: To Consent Calendar",7,0,0,0,7
1968262,1600769,2025-08-29,Assembly,"Do pass",15,0,0,0,15
1968262,1601358,2025-09-08,Assembly,"SB 355 Pérez Senate Third Reading By Ortega",79,0,0,1,80
1968262,1601579,2025-09-09,Senate,"Unfinished Business SB355 Pérez et al. Concurrence",40,0,0,0,40
1968263,1540835,2025-04-08,Senate,"Do pass as amended, but first amend, and re-refer to the Committee on [Appropriations]",4,2,0,0,6
1968263,1559454,2025-04-28,Senate,"Placed on suspense file",7,0,0,0,7
1968263,1577232,2025-05-23,Senate,"Do pass",6,0,0,1,7
1968263,1585000,2025-06-04,Senate,"Senate 3rd Reading SB356 Jones",26,9,0,5,40
1968264,1562824,2025-04-29,Senate,"Do pass",4,1,0,1,6
1968264,1585090,2025-06-04,Senate,"Senate 3rd Reading SB357 Menjivar et al",25,6,0,9,40
1968264,1598722,2025-07-15,Assembly,"Do pass as amended",5,1,0,3,9
1968265,1563033,2025-04-30,Senate,"Do pass as amended, but first amend, and re-refer to the Committee on [Appropriations]",5,2,0,0,7
1968265,1586353,2025-06-02,Senate,"Senate 3rd Reading SB358 Becker",27,11,0,2,40
1968265,1597576,2025-07-02,Assembly,"Do pass as amended and be re-referred to the Committee on [Appropriations]",9,0,0,1,10
1968265,1599761,2025-08-20,Assembly,"Do pass",11,2,0,2,15
1968265,1600947,2025-09-03,Assembly,"SB 358 Becker Senate Third Reading By Ward",53,14,0,12,79
1968265,1601272,2025-09-08,Senate,"Unfinished Business SB358 Becker Concurrence",28,9,0,3,40
1968266,1533493,2025-04-01,Senate,"Senate 3rd Reading SCR22 Alvarado-Gil",39,0,0,1,40
1968266,1552885,2025-04-21,Assembly,"Be adopted. To Consent Calendar",10,0,0,1,11
1968266,1557564,2025-04-24,Assembly,"SCR 22 Alvarado-Gil Consent Calendar Second Day Regular Session",75,0,0,4,79
1968267,1565253,2025-05-05,Senate,"Senate 3rd Reading SCR23 Umberg",38,0,0,2,40
1968267,1573584,2025-05-19,Assembly,"Be adopted. To Consent Calendar",6,0,0,5,11
1968267,1577185,2025-05-23,Assembly,"SCR 23 Umberg Consent Calendar Second Day Regular Session",71,0,0,8,79
1970383,1563009,2025-04-30,Assembly,"Do pass as amended and be re-referred to the Committee on [Appropriations]",9,1,0,2,12
1970384,1522015,2025-03-19,Assembly,"Do pass and be re-referred to the Committee on [Appropriations]",6,0,0,1,7
1970384,1556137,2025-04-23,Assembly,"Do pass",11,2,0,2,15
1970384,1559420,2025-04-28,Assembly,"AB 596 McKinnor Assembly Third Reading",63,10,0,6,79
1970384,1589129,2025-06-11,Senate,"Do pass as amended, but first amend, and re-refer to the Committee on [Appropriations]",5,0,0,0,5
1970384,1601791,2025-09-10,Senate,"Do pass, but first be re-referred to the Committee on [Appropriations]",4,1,0,0,5
1970384,1601880,2025-09-11,Senate,"Do pass",4,2,0,1,7
1970384,1602362,2025-09-12,Senate,"Assembly 2nd Reading AB596 Ortega By Cervantes",26,9,0,5,40
1970384,1602363,2025-09-13,Assembly,"AB 596 ORTEGA Concurrence in Senate Amendments",37,22,0,21,80
1970385,1521977,2025-03-19,Assembly,"Do pass and be re-referred to the Committee on [Appropriations]",17,0,0,0,17
1970385,1521978,2025-03-19,Assembly,"Do pass as amended",15,0,0,0,15
1970385,1533465,2025-04-01,Assembly,"AB 597 Harabedian Third Reading Urgency",77,0,0,3,80
1970385,1598094,2025-07-09,Senate,"Do pass as amended, but first amend, and re-refer to the Committee on [Appropriations]",6,0,0,1,7
1970385,1599625,2025-08-18,Senate,"Placed on suspense file",7,0,0,0,7
1970386,1529535,2025-03-26,Assembly,"Do pass and be re-referred to the Committee on [Emergency Management] with recommendation: To Consent Calendar",9,0,0,0,9
1970386,1561201,2025-04-28,Assembly,"Do pass and be re-referred to the Committee on [Appropriations]",7,0,0,0,7
1970386,1577381,2025-05-23,Assembly,"Do pass",14,0,0,1,15
1970386,1584324,2025-06-03,Assembly,"AB 598 Gipson Assembly Third Reading",79,0,0,0,79
1970386,1597396,2025-07-02,Senate,"Do pass, but first be re-referred to the Committee on [Governmental Organization] with the recommendation: To Consent Calendar",7,0,0,0,7
1970386,1597951,2025-07-08,Senate,"Do pass as amended, but first amend, and re-refer to the Committee on [Appropriations]",15,0,0,0,15
1970386,1599601,2025-08-18,Senate,"Placed on suspense file",7,0,0,0,7
1970387,1528305,2025-03-25,Assembly,"Do pass and be re-referred to the Committee on [Appropriations] with recommendation: To Consent Calendar",7,0,0,0,7
1970387,1577476,2025-05-23,Assembly,"Do pass",14,0,0,1,15
1970387,1583548,2025-06-02,Assembly,"AB 599 Connolly Assembly Third Reading",79,0,0,0,79
1970389,1540807,2025-04-08,Assembly,"Do pass as amended and be re-referred to the Committee on [Public Safety]",6,0,0,0,6
1970389,1577625,2025-05-23,Assembly,"Do pass",14,0,0,1,15
1970389,1583422,2025-06-02,Assembly,"AB 601 Jackson Assembly Third Reading",79,0,0,0,79
1970389,1597710,2025-07-07,Senate,"Do pass, but first be re-referred to the Committee on [Public Safety]",5,0,0,0,5
1970389,1598492,2025-07-15,Senate,"Do pass, but first be re-referred to the Committee on [Appropriations] with the recommendation: To Consent Calendar",6,0,0,0,6
1970389,1599587,2025-08-18,Senate,"Placed on suspense file",7,0,0,0,7
1970390,1561163,2025-04-29,Assembly,"Do pass as amended and be re-referred to the Committee on [Appropriations]",6,3,0,1,10
1970390,1577750,2025-05-23,Assembly,"Do pass as amended",12,2,0,1,15
1970390,1583450,2025-06-02,Assembly,"AB 602 Haney Assembly Third Reading",59,13,0,7,79
1970390,1597498,2025-07-02,Senate,"Do pass, but first be re-referred to the Committee on [Appropriations]",6,1,0,0,7
1970390,1600953,2025-09-03,Senate,"Assembly 3rd Reading AB602 Haney By Weber Pierson",32,6,0,2,40
1970390,1601190,2025-09-04,Assembly,"AB 602 Haney Concurrence in Senate Amendments",60,12,0,7,79
1970392,1528240,2025-03-26,Assembly,"Do pass. To Consent Calendar",7,0,0,0,7
1970392,1533483,2025-04-01,Assembly,"AB 604 Berman Consent Calendar Second Day Regular Session",75,1,0,4,80
1970392,1599698,2025-08-19,Senate,"Do pass, but first be re-referred to the Committee on [Appropriations]",4,1,0,0,5
1970392,1599717,2025-08-20,Senate,"Do pass",5,2,0,0,7
1970392,1599875,2025-08-21,Senate,"Assembly 3rd Reading AB604 Aguiar-Curry et al. By Gonzalez Urgency Clause",30,9,0,1,40
1970392,1599876,2025-08-21,Assembly,"AB 604 AGUIAR-CURRY Concurrence - Urgency Added",56,20,0,3,79
1970393,1554623,2025-04-21,Assembly,"Do pass and be re-referred to the Committee on [Natural Resources]",15,0,0,1,16
1970393,1559502,2025-04-28,Assembly,"Do pass and be re-referred to the Committee on [Appropriations] with recommendation: To Consent Calendar",14,0,0,0,14
1970393,1577354,2025-05-23,Assembly,"Do pass",14,0,0,1,15
1970393,1585060,2025-06-04,Assembly,"AB 605 Muratsuchi Assembly Third Reading",78,0,0,1,79
1970394,1544960,2025-04-09,Assembly,"Do pass and be re-referred to the Committee on [Appropriations] with recommendation: To Consent Calendar",9,0,0,0,9
1970394,1563069,2025-04-30,Assembly,"Do pass. To Consent Calendar",14,0,0,1,15
1970394,1568648,2025-05-08,Assembly,"AB 606 Quirk-Silva Consent Calendar Second Day Regular Session",69,0,0,10,79
1970394,1589098,2025-06-11,Senate,"Do pass, but first be re-referred to the Committee on [Appropriations] with the recommendation: To Consent Calendar",6,0,0,1,7
1970394,1594042,2025-06-23,Senate,"Placed on suspense file",7,0,0,0,7
1970394,1600295,2025-08-29,Senate,"Do pass",7,0,0,0,7
1970394,1601475,2025-09-09,Senate,"Assembly 3rd Reading AB606 Quirk-Silva By Cortese",40,0,0,0,40
1970395,1526934,2025-03-25,Assembly,"Do pass and be re-referred to the Committee on [Appropriations] with recommendation: To Consent Calendar",7,0,0,0,7
1970395,1577871,2025-05-23,Assembly,"Do pass",14,0,0,1,15
1970395,1583423,2025-06-02,Assembly,"AB 607 Celeste Rodriguez Assembly Third Reading",79,0,0,0,79
1970395,1597749,2025-07-07,Senate,"Do pass, but first be re-referred to the Committee on [Appropriations] with the recommendation: To Consent Calendar",5,0,0,0,5
1970395,1599384,2025-08-18,Senate,"Placed on suspense file",7,0,0,0,7
1970395,1600642,2025-08-29,Senate,"Do pass as amended",7,0,0,0,7
1970395,1601957,2025-09-11,Senate,"Special Consent AB607 Celeste Rodriguez By Ashby",40,0,0,0,40
1970395,1602128,2025-09-12,Assembly,"AB 607 Celeste Rodriguez Concurrence in Senate Amendments",80,0,0,0,80
1970397,1558704,2025-04-21,Assembly,"Do pass as amended and be re-referred to the Committee on [Housing and Community Development]",12,0,0,2,14
1970397,1562998,2025-04-30,Assembly,"Do pass as amended and be re-referred to the Committee on [Appropriations]",11,0,0,1,12
1970397,1571602,2025-05-14,Assembly,"Do pass",15,0,0,0,15
1970397,1573531,2025-05-19,Assembly,"AB 609 Wicks Assembly Third Reading",67,0,0,12,79
1970398,1558370,2025-04-24,Assembly,"Do pass and be re-referred to the Committee on [Local Government]",11,0,0,1,12
1970398,1564146,2025-04-30,Assembly,"Do pass and be re-referred to the Committee on [Appropriations]",10,0,0,0,10
1970398,1577636,2025-05-23,Assembly,"Do pass",13,0,0,2,15
1970398,1585818,2025-06-05,Assembly,"AB 610 Alvarez Assembly Third Reading",72,1,0,6,79
1970398,1597416,2025-07-01,Senate,"Do pass as amended, but first amend, and re-refer to the Committee on [Local Government]",7,0,0,4,11
1970398,1598650,2025-07-16,Senate,"Do pass as amended, but first amend, and re-refer to the Committee on [Appropriations]",5,0,0,2,7
1970398,1599634,2025-08-18,Senate,"Placed on suspense file",7,0,0,0,7
1970398,1600276,2025-08-29,Senate,"Do pass",7,0,0,0,7
1970398,1601806,2025-09-10,Senate,"Assembly 3rd Reading AB610 Alvarez By Grayson",39,0,0,1,40
1970399,1557570,2025-04-23,Assembly,"Do pass and be re-referred to the Committee on [Judiciary]",5,0,0,2,7
1970399,1561127,2025-04-29,Assembly,"Do pass",7,3,0,2,12
1970399,1568645,2025-05-08,Assembly,"AB 611 Lee Assembly Third Reading",41,14,0,24,79
1970400,1525429,2025-03-24,Assembly,"Do pass and be re-referred to the Committee on [Appropriations]",16,0,0,0,16
1970401,1566703,2025-05-05,Assembly,"Do pass as amended and be re-referred to the Committee on [Appropriations]",6,0,0,1,7
1970402,1526940,2025-03-25,Assembly,"Do pass as amended and be re-referred to the Committee on [Appropriations]",11,0,0,1,12
1970403,1540822,2025-04-07,Assembly,"Do pass and be re-referred to the Committee on [Utilities and Energy]",7,0,0,0,7
1970403,1564207,2025-04-30,Assembly,"Do pass as amended, and be re-referred to the Committee on [Appropriations] with recommendation: To Consent Calendar",18,0,0,0,18
1970403,1575473,2025-05-21,Assembly,"Do pass. To Consent Calendar",15,0,0,0,15
1970403,1579298,2025-05-27,Assembly,"AB 615 Davies Consent Calendar Second Day Regular Session",76,0,0,3,79
1970403,1597663,2025-07-07,Senate,"Do pass as amended, but first amend, and re-refer to the Committee on [Appropriations]",16,0,0,1,17
1970403,1600893,2025-09-03,Senate,"Assembly 3rd Reading AB615 Davies et al. By Laird",40,0,0,0,40
1970403,1601133,2025-09-04,Assembly,"AB 615 Davies Concurrence in Senate Amendments",77,0,0,2,79
1970404,1526887,2025-03-25,Assembly,"Do pass and be re-referred to the Committee on [Appropriations]",13,0,0,0,13
1970404,1577337,2025-05-23,Assembly,"Do pass as amended",11,0,0,4,15
1970404,1584255,2025-06-03,Assembly,"AB 616 Caloza Assembly Third Reading",79,0,0,0,79
1970404,1597859,2025-07-08,Senate,"Do pass, but first be re-referred to the Committee on [Appropriations] with the recommendation: To Consent Calendar",7,0,0,0,7
1970404,1599489,2025-08-18,Senate,"Placed on suspense file",7,0,0,0,7
1970405,1562968,2025-04-29,Assembly,"Do pass and be re-referred to the Committee on [Appropriations]",5,1,0,1,7
1970406,1533486,2025-04-01,Assembly,"Do pass and be re-referred to the Committee on [Appropriations] with recommendation: To Consent Calendar",15,0,0,0,15
1970406,1577480,2025-05-23,Assembly,"Do pass as amended",11,0,0,4,15
1970406,1583528,2025-06-02,Assembly,"AB 618 Krell Assembly Third Reading",79,0,0,0,79
1970406,1592587,2025-06-18,Senate,"Do pass as amended, but first amend, and re-refer to the Committee on [Appropriations] with the recommendation: To Consent Calendar",10,0,0,1,11
1970406,1597765,2025-07-07,Senate,"Placed on suspense file",6,0,0,1,7
1970407,1538936,2025-04-07,Assembly,"Do pass and be re-referred to the Committee on [Public Safety]",14,0,0,0,14
1970407,1562777,2025-04-29,Assembly,"Do pass and be re-referred to the Committee on [Appropriations] with recommendation: To Consent Calendar",9,0,0,0,9
1970408,1525441,2025-03-24,Assembly,"Do pass and be re-referred to the Committee on [Appropriations] with recommendation: To Consent Calendar",16,0,0,0,16
1970408,1577664,2025-05-23,Assembly,"Do pass",14,0,0,1,15
1970408,1583543,2025-06-02,Assembly,"AB 620 Jackson Assembly Third Reading",79,0,0,0,79
1970408,1597411,2025-07-02,Senate,"Do pass, but first be re-referred to the Committee on [Transportation] with the recommendation: To Consent Calendar",8,0,0,0,8
1970408,1597856,2025-07-08,Senate,"Do pass, but first be re-referred to the Committee on [Appropriations] with the recommendation: To Consent Calendar",15,0,0,0,15
1970408,1599483,2025-08-18,Senate,"Placed on suspense file",7,0,0,0,7
1970408,1600386,2025-08-29,Senate,"Do pass",7,0,0,0,7
1970408,1601094,2025-09-04,Senate,"Special Consent AB620 Jackson",39,0,0,1,40
1970409,1520450,2025-03-18,Assembly,"Do pass as amended and be re-referred to the Committee on [Judiciary]",15,0,0,0,15
1970409,1540797,2025-04-08,Assembly,"Do pass as amended, and be re-referred to the Committee on [Appropriations] with recommendation: To Consent Calendar",12,0,0,0,12
1970409,1577624,2025-05-23,Assembly,"Do pass",14,0,0,1,15
1970409,1583561,2025-06-02,Assembly,"AB 621 Bauer-Kahan Assembly Third Reading",78,0,0,1,79
1970409,1598577,2025-07-15,Senate,"Do pass, but first be re-referred to the Committee on [Appropriations]",13,0,0,0,13
1970409,1599560,2025-08-18,Senate,"Placed on suspense file",7,0,0,0,7
1970409,1600615,2025-08-29,Senate,"Do pass",7,0,0,0,7
1970409,1601659,2025-09-09,Senate,"Assembly 3rd Reading AB621 Bauer-Kahan et al. By Ashby",40,0,0,0,40
1970410,1542799,2025-04-08,Assembly,"Do pass and be re-referred to the Committee on [Appropriations]",5,0,0,4,9
1970410,1555896,2025-04-23,Assembly,"Do pass",10,4,0,1,15
1970414,1542807,2025-04-08,Assembly,"Do pass as amended and be re-referred to the Committee on [Appropriations]",7,0,0,0,7
1970415,1533491,2025-04-01,Assembly,"Do pass as amended, and be re-referred to the Committee on [Appropriations] with recommendation: To Consent Calendar",15,0,0,0,15
1970415,1556182,2025-04-23,Assembly,"Do pass. To Consent Calendar",15,0,0,0,15
1970415,1564244,2025-05-01,Assembly,"AB 627 Stefani Consent Calendar Second Day Regular Session",76,0,0,3,79
1970415,1589117,2025-06-11,Senate,"Do pass, but first be re-referred to the Committee on [Appropriations] with the recommendation: To Consent Calendar",9,0,0,2,11
1970415,1600843,2025-09-02,Senate,"Assembly 3rd Reading AB627 Stefani et al. By Richardson",40,0,0,0,40
1970415,1601160,2025-09-04,Assembly,"AB 627 Stefani Concurrence in Senate Amendments",78,0,0,1,79
1970416,1526904,2025-03-25,Assembly,"Do pass as amended",9,1,0,2,12
1970416,1538905,2025-04-07,Assembly,"AB 628 McKinnor Assembly Third Reading",54,10,0,15,79
1970416,1595186,2025-06-24,Senate,"Do pass",11,1,0,1,13
1970416,1601730,2025-09-10,Senate,"Assembly 3rd Reading AB628 McKinnor By Wiener",25,11,0,4,40
1970417,1529515,2025-03-26,Assembly,"Do pass and be re-referred to the Committee on [Appropriations] with recommendation: To Consent Calendar",9,0,0,0,9
1970417,1577396,2025-05-23,Assembly,"Do pass",14,0,0,1,15
1970417,1583539,2025-06-02,Assembly,"AB 629 Ward Assembly Third Reading",79,0,0,0,79
1970417,1595173,2025-06-25,Senate,"Do pass, but first be re-referred to the Committee on [Appropriations] with the recommendation: To Consent Calendar",7,0,0,0,7
1970417,1598149,2025-07-10,Senate,"Consent Calendar 2nd AB629 Ward",37,0,0,3,40
1970418,1561102,2025-04-28,Assembly,"Do pass as amended and be re-referred to the Committee on [Appropriations]",15,0,0,1,16
1970418,1571597,2025-05-14,Assembly,"Do pass",15,0,0,0,15
1970418,1577220,2025-05-23,Assembly,"AB 630 Mark González Assembly Third Reading",70,0,0,9,79
1970418,1594596,2025-06-24,Senate,"Do pass as amended, but first amend, and re-refer to the Committee on [Appropriations]",6,0,0,0,6
1970418,1597719,2025-07-07,Senate,"Placed on suspense file",6,0,0,1,7
1970418,1600545,2025-08-29,Senate,"Do pass as amended",6,1,0,0,7
1970418,1601895,2025-09-11,Senate,"Assembly 3rd Reading AB630 Mark González et al. By Arreguín",37,0,0,3,40
1970418,1602301,2025-09-12,Assembly,"AB 630 Mark González Concurrence in Senate Amendments",76,0,0,4,80
1970419,1533487,2025-04-01,Assembly,"Do pass as amended and be re-referred to the Committee on [Appropriations]",17,0,0,1,18
1970419,1556068,2025-04-23,Assembly,"Do pass",15,0,0,0,15
1970419,1559480,2025-04-28,Assembly,"AB 631 Lee Assembly Third Reading",72,0,0,7,79
1970419,1598274,2025-07-14,Senate,"Do pass, but first be re-referred to the Committee on [Appropriations]",11,0,0,0,11
1970419,1599418,2025-08-18,Senate,"Placed on suspense file",7,0,0,0,7
1970420,1542804,2025-04-09,Assembly,"Do pass as amended and be re-referred to the Committee on [Judiciary]",8,0,0,2,10
1970420,1566691,2025-05-06,Assembly,"Do pass as amended",9,0,0,3,12
1970420,1572399,2025-05-15,Assembly,"AB 632 Hart Assembly Third Reading",57,7,0,15,79
1970420,1597515,2025-07-02,Senate,"Do pass, but first be re-referred to the Committee on [Judiciary]",5,2,0,0,7
1970420,1598680,2025-07-15,Senate,"Do pass as amended",10,2,0,1,13
1970420,1601777,2025-09-10,Senate,"Assembly 3rd Reading AB632 Hart et al. By Arreguín",28,9,0,3,40
1970423,1542716,2025-04-09,Assembly,"Do pass and be re-referred to the Committee on [Judiciary]",9,1,0,2,12
1970423,1561187,2025-04-29,Assembly,"Do pass and be re-referred to the Committee on [Appropriations]",8,2,0,2,12
1970423,1577276,2025-05-23,Assembly,"Do pass",11,2,0,2,15
1970423,1584433,2025-06-03,Assembly,"AB 635 Ahrens Assembly Third Reading",56,11,0,12,79
1970423,1594588,2025-06-24,Senate,"Do pass, but first be re-referred to the Committee on [Judiciary]",8,2,0,1,11
1970424,1533555,2025-04-01,Assembly,"Do pass and be re-referred to the Committee on [Appropriations]",15,0,0,0,15
1970426,1528271,2025-03-25,Assembly,"Do pass and be re-referred to the Committee on [Appropriations]",7,0,0,0,7
1970426,1577773,2025-05-23,Assembly,"Do pass as amended",11,0,0,4,15
1970426,1583491,2025-06-02,Assembly,"AB 638 Celeste Rodriguez Assembly Third Reading",79,0,0,0,79
1970426,1597521,2025-07-02,Senate,"Do pass as amended, but first amend, and re-refer to the Committee on [Natural Resources and Water] with the recommendation: To Consent Calendar",8,0,0,0,8
1970426,1598624,2025-07-16,Senate,"Do pass, but first be re-referred to the Committee on [Appropriations] with the recommendation: To Consent Calendar",7,0,0,0,7
1970426,1599627,2025-08-18,Senate,"Placed on suspense file",7,0,0,0,7
1970427,1526943,2025-03-25,Assembly,"Do pass as amended and be re-referred to the Committee on [Appropriations]",13,0,0,0,13
1970427,1542682,2025-04-09,Assembly,"Do pass",14,0,0,1,15
1970427,1552835,2025-04-21,Assembly,"AB 639 Soria Assembly Third Reading",73,0,0,6,79
1970427,1588062,2025-06-10,Senate,"Do pass as amended, but first amend, and re-refer to the Committee on [Appropriations]",7,0,0,0,7
1970427,1600925,2025-09-03,Senate,"Assembly 3rd Reading AB639 Soria By Caballero",38,1,0,1,40
1970427,1601089,2025-09-04,Assembly,"AB 639 Soria Concurrence in Senate Amendments",78,0,0,1,79
1970428,1545014,2025-04-09,Assembly,"Do pass and be re-referred to the Committee on [Appropriations]",7,0,0,2,9
1970428,1577663,2025-05-23,Assembly,"Do pass",13,0,0,2,15
1970428,1585117,2025-06-04,Assembly,"AB 640 Muratsuchi Assembly Third Reading",74,0,0,5,79
1970428,1598142,2025-07-09,Senate,"Do pass, but first be re-referred to the Committee on [Appropriations]",7,0,0,0,7
1970428,1599475,2025-08-18,Senate,"Placed on suspense file",7,0,0,0,7
1970428,1600391,2025-08-29,Senate,"Do pass as amended",7,0,0,0,7
1970428,1601534,2025-09-09,Senate,"Assembly 3rd Reading AB640 Muratsuchi et al. By Pérez",39,0,0,1,40
1970429,1540976,2025-04-08,Assembly,"Do pass as amended, and be re-referred to the Committee on [Appropriations] with recommendation: To Consent Calendar",15,0,0,0,15
1970430,1529532,2025-03-26,Assembly,"Do pass as amended, and be re-referred to the Committee on [Appropriations] with recommendation: To Consent Calendar",9,0,0,0,9
1970430,1577181,2025-05-23,Assembly,"Do pass as amended",11,0,0,4,15
1970430,1585098,2025-06-04,Assembly,"AB 642 Muratsuchi Third Reading Urgency",79,0,0,0,79
1970430,1597454,2025-07-02,Senate,"Do pass and be ordered to the Consent Calendar",7,0,0,0,7
1970430,1598159,2025-07-10,Senate,"Consent Calendar 2nd AB642 Muratsuchi Urgency Clause",37,0,0,3,40
1970430,1598876,2025-07-17,Assembly,"AB 642 Muratsuchi Concurrence in Senate Amendments",74,0,0,5,79
1970432,1554514,2025-04-22,Assembly,"Do pass and be re-referred to the Committee on [Appropriations] with recommendation: To Consent Calendar",8,0,0,1,9
1970432,1577847,2025-05-23,Assembly,"Do pass as amended",11,0,0,4,15
1970432,1583452,2025-06-02,Assembly,"AB 644 Gabriel Assembly Third Reading",79,0,0,0,79
1970432,1594593,2025-06-24,Senate,"Do pass, but first be re-referred to the Committee on [Governmental Organization] with the recommendation: To Consent Calendar",7,0,0,0,7
1970432,1597956,2025-07-08,Senate,"Do pass, but first be re-referred to the Committee on [Appropriations] with the recommendation: To Consent Calendar",15,0,0,0,15
1970432,1599533,2025-08-18,Senate,"Placed on suspense file",7,0,0,0,7
1970432,1600554,2025-08-29,Senate,"Do pass",7,0,0,0,7
1970433,1556092,2025-04-22,Assembly,"Do pass and be re-referred to the Committee on [Emergency Management]",13,0,0,3,16
1970433,1561081,2025-04-28,Assembly,"Do pass and be re-referred to the Committee on [Appropriations]",6,0,0,1,7
1970433,1571587,2025-05-14,Assembly,"Do pass",15,0,0,0,15
1970433,1573636,2025-05-19,Assembly,"AB 645 Carrillo Assembly Third Reading",70,0,0,9,79
1970433,1598873,2025-07-16,Senate,"Do pass as amended, but first amend, and re-refer to the Committee on [Appropriations] with the recommendation: To Consent Calendar",10,0,0,1,11
1970433,1599367,2025-08-18,Senate,"Placed on suspense file",7,0,0,0,7
1970433,1600759,2025-08-29,Senate,"Do pass",7,0,0,0,7
1970433,1601107,2025-09-04,Senate,"Special Consent AB645 Carrillo et al",39,0,0,1,40
1970433,1601326,2025-09-08,Assembly,"AB 645 Carrillo Concurrence in Senate Amendments",79,0,0,1,80
1970434,1563032,2025-04-30,Assembly,"Do pass and be re-referred to the Committee on [Appropriations]",15,0,0,2,17
1970435,1558363,2025-04-24,Assembly,"Do pass and be re-referred to the Committee on [Local Government]",8,2,0,2,12
1970436,1521961,2025-03-18,Assembly,"Do pass and be re-referred to the Committee on [Local Government]",7,3,0,0,10
1970436,1564238,2025-04-30,Assembly,"Do pass as amended",9,0,0,1,10
1970436,1579280,2025-05-27,Assembly,"AB 648 Zbur Assembly Third Reading",63,5,0,11,79
1970436,1592625,2025-06-18,Senate,"Do pass, but first be re-referred to the Committee on [Local Government]",6,1,0,0,7
1970436,1598763,2025-07-16,Senate,"Do pass as amended",5,2,0,0,7
1970436,1601271,2025-09-08,Senate,"Assembly 3rd Reading AB648 Zbur et al. By Arreguín",31,5,0,4,40
1970437,1566723,2025-05-06,Assembly,"Do pass as amended",12,0,0,0,12
1970437,1577583,2025-05-23,Assembly,"Do pass",14,0,0,1,15
1970437,1583411,2025-06-02,Assembly,"AB 649 Lowenthal Assembly Third Reading",78,0,0,1,79
1970438,1558355,2025-04-24,Assembly,"Do pass and be re-referred to the Committee on [Local Government]",11,0,0,1,12
1970438,1564154,2025-04-30,Assembly,"Do pass and be re-referred to the Committee on [Appropriations]",9,0,0,1,10
1970438,1577747,2025-05-23,Assembly,"Do pass",14,0,0,1,15
1970438,1583361,2025-06-02,Assembly,"AB 650 Papan Assembly Third Reading",79,0,0,0,79
1970438,1597427,2025-07-01,Senate,"Do pass, but first be re-referred to the Committee on [Appropriations] with the recommendation: To Consent Calendar",11,0,0,0,11
1970438,1598285,2025-07-14,Senate,"Placed on suspense file",7,0,0,0,7
1970438,1600371,2025-08-29,Senate,"Do pass as amended",7,0,0,0,7
1970438,1601750,2025-09-10,Senate,"Assembly 3rd Reading AB650 Papan et al. By Becker",40,0,0,0,40
1970439,1542937,2025-04-08,Assembly,"Do pass and be re-referred to the Committee on [Judiciary] with recommendation: To Consent Calendar",9,0,0,0,9
1970439,1554472,2025-04-22,Assembly,"Do pass and be re-referred to the Committee on [Appropriations] with recommendation: To Consent Calendar",12,0,0,0,12
1970439,1577312,2025-05-23,Assembly,"Do pass",14,0,0,1,15
1970439,1584430,2025-06-03,Assembly,"AB 651 Bryan Assembly Third Reading",79,0,0,0,79
1970439,1597241,2025-07-01,Senate,"Do pass, but first be re-referred to the Committee on [Judiciary] with the recommendation: To Consent Calendar",6,0,0,0,6
1970439,1597872,2025-07-08,Senate,"Do pass, but first be re-referred to the Committee on [Appropriations] with the recommendation: To Consent Calendar",13,0,0,0,13
1970439,1599385,2025-08-18,Senate,"Placed on suspense file",7,0,0,0,7
1970439,1600445,2025-08-29,Senate,"Do pass",7,0,0,0,7
1970439,1601180,2025-09-04,Senate,"Special Consent AB651 Bryan et al",39,0,0,1,40
1970440,1538945,2025-04-07,Assembly,"Do pass",13,0,0,1,14
1970440,1552875,2025-04-21,Assembly,"AB 652 Alvarez Assembly Third Reading",63,2,0,14,79
1970440,1597514,2025-07-02,Senate,"Do pass, but first be re-referred to the Committee on [Local Government]",7,0,0,1,8
1970440,1598727,2025-07-16,Senate,"Do pass as amended",7,0,0,0,7
1970440,1600848,2025-09-02,Senate,"Assembly 3rd Reading AB652 Alvarez By Laird",40,0,0,0,40
1970440,1600959,2025-09-03,Assembly,"AB 652 Alvarez Concurrence in Senate Amendments",75,0,0,4,79
1970441,1554591,2025-04-22,Assembly,"Do pass and be re-referred to the Committee on [Appropriations] with recommendation: To Consent Calendar",9,0,0,0,9
1970441,1577230,2025-05-23,Assembly,"Do pass as amended",14,0,0,1,15
1970441,1585078,2025-06-04,Assembly,"AB 653 Lackey Assembly Third Reading",77,0,0,2,79
1970441,1597170,2025-07-01,Senate,"Do pass, but first be re-referred to the Committee on [Appropriations] with the recommendation: To Consent Calendar",6,0,0,0,6
1970441,1598237,2025-07-14,Senate,"Placed on suspense file",7,0,0,0,7
1970441,1600427,2025-08-29,Senate,"Do pass as amended",7,0,0,0,7
1970441,1601867,2025-09-11,Senate,"Special Consent AB653 Lackey et al. By Grove",40,0,0,0,40
1970441,1602055,2025-09-13,Assembly,"AB 653 Lackey Concurrence in Senate Amendments",75,0,0,5,80
1970442,1558356,2025-04-24,Assembly,"Do pass and be re-referred to the Committee on [Communications and Conveyance]",11,0,0,1,12
1970442,1562908,2025-04-30,Assembly,"Do pass and be re-referred to the Committee on [Appropriations]",8,2,0,0,10
1970442,1577889,2025-05-23,Assembly,"Do pass",12,2,0,1,15
1970442,1584224,2025-06-03,Assembly,"AB 654 Caloza Assembly Third Reading",61,14,0,4,79
1970442,1597263,2025-06-30,Senate,"Do pass, but first be re-referred to the Committee on [Local Government]",4,1,0,0,5
1970442,1598729,2025-07-16,Senate,"Do pass, but first be re-referred to the Committee on [Appropriations]",5,2,0,0,7
1970442,1599417,2025-08-18,Senate,"Placed on suspense file",7,0,0,0,7
1970443,1554611,2025-04-22,Assembly,"Do pass and be re-referred to the Committee on [Appropriations] with recommendation: To Consent Calendar",8,0,0,0,8
1970443,1567880,2025-05-07,Assembly,"Do pass. To Consent Calendar",15,0,0,0,15
1970443,1572371,2025-05-15,Assembly,"AB 655 Alvarez Consent Calendar Second Day Regular Session",69,0,0,10,79
1970443,1586928,2025-06-09,Senate,"Do pass, but first be re-referred to the Committee on [Appropriations] with the recommendation: To Consent Calendar",8,0,0,3,11
1970443,1596019,2025-06-27,Senate,"Consent Calendar 2nd AB655 Alvarez",38,0,0,2,40
1970444,1566704,2025-05-06,Assembly,"Do pass as amended",14,0,0,1,15
1970444,1573480,2025-05-19,Assembly,"AB 656 Schiavo Assembly Third Reading",71,0,0,8,79
1970444,1597502,2025-07-01,Senate,"Do pass",13,0,0,0,13
1970444,1601502,2025-09-09,Senate,"Assembly 3rd Reading AB656 Schiavo et al. By Ashby",40,0,0,0,40
1970445,1555959,2025-04-22,Assembly,"Be adopted and re-referred to the Committee on [Judiciary]",6,3,0,1,10
1970445,1566706,2025-05-06,Assembly,"Be adopted as amended, and re-refer to the Committee on [Appropriations]",9,3,0,0,12
1970446,1517615,2025-03-13,Assembly,"Be adopted. To Consent Calendar",9,0,0,2,11
1970446,1523710,2025-03-20,Assembly,"ACR 32 Carrillo Consent Calendar Second Day Regular Session",67,0,0,13,80
1970447,1498282,2025-02-24,Assembly,"Be adopted. To third reading",11,0,0,0,11
1970448,1571630,2025-05-14,Senate,"Do pass, but first be re-referred to the Committee on [Appropriations] with the recommendation: To Consent Calendar",5,0,0,0,5
1970448,1573519,2025-05-19,Senate,"Placed on suspense file",5,0,0,2,7
1970448,1577568,2025-05-23,Senate,"Do pass",6,0,0,1,7
1970448,1581690,2025-05-29,Senate,"Special Consent SB359 Niello",38,0,0,2,40
1970448,1598378,2025-07-14,Assembly,"Do pass and be re-referred to the Committee on [Appropriations]",7,0,0,0,7
1970448,1600639,2025-08-29,Assembly,"Do pass",15,0,0,0,15
1970448,1601359,2025-09-08,Assembly,"SB 359 Niello Senate Third Reading By Patterson",78,0,0,2,80
1970448,1601714,2025-09-10,Senate,"Unfinished Business SB359 Niello Concurrence",40,0,0,0,40
1970449,1527008,2025-03-25,Senate,"Do pass, but first be re-referred to the Committee on [Appropriations]",6,0,0,1,7
1970449,1538997,2025-04-07,Senate,"Placed on suspense file",7,0,0,0,7
1970449,1577565,2025-05-23,Senate,"Do pass as amended",5,0,0,2,7
1970449,1580482,2025-05-28,Senate,"Senate 3rd Reading SB360 Rubio",37,0,0,3,40
1970450,1535006,2025-04-01,Senate,"Do pass, but first be re-referred to the Committee on [Appropriations] with the recommendation: To Consent Calendar",13,0,0,0,13
1970450,1557578,2025-04-24,Senate,"Consent Calendar 2nd SB361 Becker",37,0,0,3,40
1970450,1594565,2025-06-24,Assembly,"Do pass as amended, and be re-referred to the Committee on [Appropriations] with recommendation: To Consent Calendar",15,0,0,0,15
1970450,1598089,2025-07-09,Assembly,"Do pass. To Consent Calendar",15,0,0,0,15
1970450,1601999,2025-09-11,Senate,"Unfinished Business SB361 Becker Concurrence",40,0,0,0,40
1970451,1534998,2025-04-02,Senate,"Do pass, but first be re-referred to the Committee on [Rules]",7,0,0,0,7
1970451,1556027,2025-04-22,Senate,"Do pass, but first be re-referred to the Committee on [Appropriations]",13,0,0,0,13
1970451,1565348,2025-05-05,Senate,"Placed on suspense file",7,0,0,0,7
1970451,1577774,2025-05-23,Senate,"Do pass as amended",6,0,0,1,7
1970451,1586424,2025-06-02,Senate,"Senate 3rd Reading SB362 Grayson",38,0,0,2,40
1970451,1597658,2025-07-07,Assembly,"Do pass and be re-referred to the Committee on [Judiciary]",9,0,0,0,9
1970451,1598515,2025-07-15,Assembly,"Do pass and be re-referred to the Committee on [Appropriations]",12,0,0,0,12
1970451,1599758,2025-08-20,Assembly,"Do pass",15,0,0,0,15
1970451,1600938,2025-09-03,Assembly,"SB 362 Grayson Senate Third Reading By Blanca Rubio",79,0,0,0,79
1970451,1601233,2025-09-08,Senate,"Unfinished Business SB362 Grayson Concurrence",39,0,0,1,40
1970452,1544967,2025-04-09,Senate,"Do pass as amended, but first amend, and re-refer to the Committee on [Appropriations]",9,2,0,0,11
1970452,1559389,2025-04-28,Senate,"Placed on suspense file",7,0,0,0,7
1970452,1577705,2025-05-23,Senate,"Do pass as amended",5,1,0,1,7
1970452,1580530,2025-05-28,Senate,"Senate 3rd Reading SB363 Wiener et al",29,8,0,3,40
1970452,1598435,2025-07-15,Assembly,"Do pass as amended and be re-referred to the Committee on [Appropriations]",13,0,0,3,16
1970453,1561118,2025-04-28,Senate,"Do pass, but first be re-referred to the Committee on [Appropriations] with the recommendation: To Consent Calendar",15,0,0,0,15
1970453,1569793,2025-05-12,Senate,"Placed on suspense file",7,0,0,0,7
1970453,1577448,2025-05-23,Senate,"Do pass",6,0,0,1,7
1970453,1581719,2025-05-29,Senate,"Special Consent SB364 Strickland",38,0,0,2,40
1970453,1598113,2025-07-09,Assembly,"Do pass as amended and be re-referred to the Committee on [Appropriations]",22,0,0,0,22
1970453,1600331,2025-08-29,Assembly,"Do pass as amended",15,0,0,0,15
1970453,1602075,2025-09-12,Senate,"Unfinished Business SB364 Strickland et al. Concurrence",38,0,0,2,40
1970455,1540984,2025-04-08,Senate,"Do pass as amended, but first amend, and re-refer to the Committee on [Labor, Public Employment and Retirement ]",13,0,0,2,15
1970455,1562945,2025-04-30,Senate,"Do pass, but first be re-referred to the Committee on [Appropriations]",4,1,0,0,5
1970455,1569853,2025-05-12,Senate,"Placed on suspense file",7,0,0,0,7
1970456,1544964,2025-04-09,Senate,"Do pass as amended, but first amend, and re-refer to the Committee on [Judiciary]",11,0,0,0,11
1970456,1562848,2025-04-29,Senate,"Do pass as amended, but first amend, and re-refer to the Committee on [Appropriations]",12,1,0,0,13
1970456,1569856,2025-05-12,Senate,"Placed on suspense file",7,0,0,0,7
1970457,1554568,2025-04-22,Senate,"Do pass as amended, but first amend, and re-refer to the Committee on [Appropriations] with the recommendation: To Consent Calendar",6,0,0,0,6
1970457,1565338,2025-05-05,Senate,"Placed on suspense file",7,0,0,0,7
1970458,1526935,2025-03-25,Senate,"Do pass, but first be re-referred to the Committee on [Governmental Organization]",6,0,0,1,7
1970458,1552912,2025-04-21,Senate,"Placed on suspense file",6,0,0,1,7
1970458,1577844,2025-05-23,Senate,"Do pass",5,0,0,2,7
1970458,1586425,2025-06-02,Senate,"Senate 3rd Reading SB369 Padilla",33,2,0,5,40
1970458,1597208,2025-07-01,Assembly,"Do pass and be re-referred to the Committee on [Labor and Employment]",12,0,0,1,13
1970458,1598137,2025-07-09,Assembly,"Do pass and be re-referred to the Committee on [Appropriations]",6,0,0,1,7
1970458,1600585,2025-08-29,Assembly,"Do pass as amended",13,1,0,1,15
1970458,1601360,2025-09-08,Assembly,"SB 369 Padilla Senate Third Reading By Ortega",69,5,0,6,80
1970458,1601739,2025-09-10,Senate,"Unfinished Business SB369 Padilla Concurrence",39,0,0,1,40
1970459,1559396,2025-04-28,Senate,"Do pass, but first be re-referred to the Committee on [Appropriations]",10,0,0,1,11
1970459,1569915,2025-05-12,Senate,"Placed on suspense file",7,0,0,0,7
1970460,1554586,2025-04-21,Senate,"Do pass, but first be re-referred to the Committee on [Rules]",16,0,0,1,17
1970460,1561143,2025-04-28,Senate,"Do pass as amended, but first amend, and re-refer to the Committee on [Appropriations]",15,0,0,0,15
1970460,1579253,2025-05-27,Senate,"Senate 3rd Reading SB371 Cabaldon",39,0,0,1,40
1970460,1598621,2025-07-16,Assembly,"Do pass and be re-referred to the Committee on [Communications and Conveyance]",16,0,0,1,17
1970460,1598622,2025-07-16,Assembly,"Do pass as amended and be re-referred to the Committee on [Appropriations]",9,0,0,0,9
1970460,1600360,2025-08-29,Assembly,"Do pass as amended",11,0,0,4,15
1970460,1601361,2025-09-08,Assembly,"SB 371 Cabaldon Senate Third Reading By Valencia",77,0,0,3,80
1970460,1601584,2025-09-09,Senate,"That the Assembly amendments be concurred in",7,0,0,0,7
1970460,1601789,2025-09-10,Senate,"Unfinished Business SB371 Cabaldon et al. Concurrence",39,0,0,1,40
1970461,1552856,2025-04-21,Senate,"Do pass, but first be re-referred to the Committee on [Education]",11,0,0,0,11
1970461,1563105,2025-04-30,Senate,"Do pass as amended, but first amend, and re-refer to the Committee on [Appropriations]",7,0,0,0,7
1970461,1573493,2025-05-19,Senate,"Placed on suspense file",5,0,0,2,7
1970462,1542740,2025-04-09,Senate,"Do pass, but first be re-referred to the Committee on [Appropriations] with the recommendation: To Consent Calendar",7,0,0,0,7
1970462,1552845,2025-04-21,Senate,"Placed on suspense file",6,0,0,1,7
1970462,1577439,2025-05-23,Senate,"Do pass",6,0,0,1,7
1970462,1581797,2025-05-29,Senate,"Special Consent SB373 Grove et al",38,0,0,2,40
1970462,1598711,2025-07-16,Assembly,"Do pass as amended and be re-referred to the Committee on [Appropriations]",9,0,0,0,9
1970462,1600342,2025-08-29,Assembly,"Do pass as amended",15,0,0,0,15
1970462,1601362,2025-09-08,Assembly,"SB 373 Grove Senate Third Reading By Jeff Gonzalez",78,0,0,2,80
1970462,1601922,2025-09-11,Senate,"Unfinished Business SB373 Grove et al. Concurrence",40,0,0,0,40
1970463,1542746,2025-04-09,Senate,"Do pass, but first be re-referred to the Committee on [Appropriations] with the recommendation: To Consent Calendar",7,0,0,0,7
1970463,1557548,2025-04-24,Senate,"Consent Calendar 2nd SB374 Archuleta",37,0,0,3,40
1970463,1598779,2025-07-16,Assembly,"Do pass and be re-referred to the Committee on [Appropriations] with recommendation: To Consent Calendar",9,0,0,0,9
1970463,1599763,2025-08-20,Assembly,"Do pass. To Consent Calendar",15,0,0,0,15
1970463,1600244,2025-08-28,Assembly,"SB 374 Archuleta Consent Calendar Second Day Regular Session",74,0,0,5,79
1970465,1571530,2025-05-14,Senate,"Do pass, but first be re-referred to the Committee on [Appropriations]",5,0,0,0,5
1970465,1586373,2025-06-02,Senate,"Senate 3rd Reading SB376 Valladares",38,0,0,2,40
1970465,1597830,2025-07-07,Assembly,"Do pass as amended and be re-referred to the Committee on [Appropriations]",7,0,0,0,7
1970465,1601907,2025-09-11,Senate,"Unfinished Business SB376 Valladares Concurrence",40,0,0,0,40
1970467,1563018,2025-04-29,Senate,"Do pass as amended, but first amend, and re-refer to the Committee on [Appropriations]",13,0,0,0,13
1970467,1569808,2025-05-12,Senate,"Placed on suspense file",7,0,0,0,7
1970467,1577142,2025-05-23,Senate,"Do pass as amended",6,0,0,1,7
1970467,1584280,2025-06-03,Senate,"Senate 3rd Reading SB378 Wiener",37,0,0,3,40
1970467,1597260,2025-07-01,Assembly,"Do pass and be re-referred to the Committee on [Privacy and Consumer Protection]",16,0,0,2,18
1970467,1597818,2025-07-08,Assembly,"Do pass and be re-referred to the Committee on [Judiciary]",13,0,0,2,15
1970467,1598461,2025-07-15,Assembly,"Do pass and be re-referred to the Committee on [Appropriations]",11,0,0,1,12
1970467,1600565,2025-08-29,Assembly,"Do pass as amended",11,0,0,4,15
1970467,1602261,2025-09-12,Senate,"Unfinished Business SB378 Wiener Concurrence",32,0,0,8,40
1970467,1602262,2025-09-12,Assembly,"SB 378 Wiener Senate Third Reading By Aguiar-Curry",76,0,0,4,80
1970468,1533478,2025-04-01,Senate,"Do pass, but first be re-referred to the Committee on [Appropriations]",6,0,0,0,6
1970468,1552871,2025-04-21,Senate,"Placed on suspense file",6,0,0,1,7
1970468,1577845,2025-05-23,Senate,"Do pass",6,0,0,1,7
1970468,1584287,2025-06-03,Senate,"Senate 3rd Reading SB379 Jones Urgency Clause",39,0,0,1,40
1970468,1591843,2025-06-17,Assembly,"Do pass and be re-referred to the Committee on [Appropriations]",8,0,0,1,9
1970469,1526988,2025-03-25,Senate,"Do pass, but first be re-referred to the Committee on [Appropriations]",6,0,0,0,6
1970469,1538877,2025-04-07,Senate,"Placed on suspense file",7,0,0,0,7
1970469,1577295,2025-05-23,Senate,"Do pass as amended",6,0,0,1,7
1970469,1585073,2025-06-04,Senate,"Special Consent SB380 Jones Urgency Clause",39,0,0,1,40
1970469,1597125,2025-07-01,Assembly,"Do pass and be re-referred to the Committee on [Appropriations] with recommendation: To Consent Calendar",9,0,0,0,9
1970469,1600415,2025-08-29,Assembly,"Do pass",15,0,0,0,15
1970469,1601363,2025-09-08,Assembly,"SB 380 Jones Third Reading Urgency By Alanis",77,0,0,3,80
1970470,1559494,2025-04-28,Senate,"Senate 3rd Reading SCR24 Alvarado-Gil",39,0,0,1,40
1970470,1573523,2025-05-19,Assembly,"Be adopted. To Consent Calendar",6,0,0,5,11
1970470,1577746,2025-05-23,Assembly,"SCR 24 Alvarado-Gil Consent Calendar Second Day Regular Session",71,0,0,8,79
1971689,1533468,2025-04-01,Assembly,"Do pass and be re-referred to the Committee on [Appropriations] with recommendation: To Consent Calendar",17,0,0,1,18
1971690,1556051,2025-04-23,Assembly,"Do pass as amended and be re-referred to the Committee on [Housing and Community Development]",10,0,0,0,10
1971690,1562975,2025-04-30,Assembly,"Do pass and be re-referred to the Committee on [Appropriations]",11,0,0,1,12
1971690,1577350,2025-05-23,Assembly,"Do pass",14,0,0,1,15
1971690,1585111,2025-06-04,Assembly,"AB 660 Wilson Assembly Third Reading",76,0,0,3,79
1971690,1597505,2025-07-02,Senate,"Do pass as amended, but first amend, and re-refer to the Committee on [Housing]",6,0,0,1,7
1971690,1598455,2025-07-15,Senate,"Do pass as amended, but first amend, and re-refer to the Committee on [Appropriations]",9,0,0,2,11
1971690,1599603,2025-08-18,Senate,"Placed on suspense file",7,0,0,0,7
1971691,1526977,2025-03-25,Assembly,"Do pass and be re-referred to the Committee on [Appropriations]",5,2,0,0,7
1971692,1561119,2025-04-29,Assembly,"Do pass as amended and be re-referred to the Committee on [Appropriations]",9,0,0,1,10
1971692,1577521,2025-05-23,Assembly,"Do pass",14,0,0,1,15
1971692,1584391,2025-06-03,Assembly,"AB 662 Alvarez Assembly Third Reading",79,0,0,0,79
1971692,1598082,2025-07-09,Senate,"Do pass, but first be re-referred to the Committee on [Appropriations]",7,0,0,0,7
1971692,1599553,2025-08-18,Senate,"Placed on suspense file",7,0,0,0,7
1971692,1600544,2025-08-29,Senate,"Do pass",7,0,0,0,7
1971692,1601242,2025-09-08,Senate,"Assembly 3rd Reading AB662 Alvarez By Padilla",39,0,0,1,40
1971693,1538926,2025-04-07,Assembly,"Do pass and be re-referred to the Committee on [Appropriations] with recommendation: To Consent Calendar",14,0,0,0,14
1971693,1555934,2025-04-23,Assembly,"Do pass. To Consent Calendar",15,0,0,0,15
1971693,1569819,2025-05-12,Assembly,"AB 663 McKinnor Third Reading Urgency",77,0,0,2,79
1971693,1592593,2025-06-18,Senate,"Do pass, but first be re-referred to the Committee on [Appropriations] with the recommendation: To Consent Calendar",6,0,0,2,8
1971693,1600952,2025-09-03,Senate,"Assembly 3rd Reading AB663 McKinnor By Rubio Urgency Clause",40,0,0,0,40
1971693,1601192,2025-09-04,Assembly,"AB 663 McKinnor Concurrence in Senate Amendments",78,0,0,1,79
1971695,1559426,2025-04-28,Assembly,"Do pass and be re-referred to the Committee on [Appropriations]",9,0,0,0,9
1971695,1571571,2025-05-14,Assembly,"Do pass",15,0,0,0,15
1971695,1579242,2025-05-27,Assembly,"AB 665 Chen Assembly Third Reading",76,0,0,3,79
1971695,1597594,2025-07-02,Senate,"Do pass, but first be re-referred to the Committee on [Appropriations] with the recommendation: To Consent Calendar",7,0,0,0,7
1971695,1600044,2025-08-25,Senate,"Consent Calendar 2nd AB665 Chen",37,0,0,3,40
1971697,1540814,2025-04-08,Assembly,"Do pass as amended and be re-referred to the Committee on [Health]",15,0,0,3,18
1971697,1577180,2025-05-23,Assembly,"Do pass",13,1,0,1,15
1971697,1584229,2025-06-03,Assembly,"AB 667 Solache Assembly Third Reading",71,1,0,7,79
1971697,1598284,2025-07-14,Senate,"Do pass, but first be re-referred to the Committee on [Appropriations]",8,1,0,2,11
1971697,1600002,2025-08-25,Senate,"Placed on suspense file",6,0,0,1,7
1971697,1600780,2025-08-29,Senate,"Do pass as amended",5,2,0,0,7
1971698,1534995,2025-04-02,Assembly,"Do pass and be re-referred to the Committee on [Appropriations]",20,0,0,2,22
1971698,1556203,2025-04-23,Assembly,"Do pass",15,0,0,0,15
1971698,1569797,2025-05-12,Assembly,"AB 668 Lowenthal Assembly Third Reading",77,0,0,2,79
1971698,1597925,2025-07-08,Senate,"Do pass as amended, but first amend, and re-refer to the Committee on [Judiciary]",15,0,0,0,15
1971698,1598610,2025-07-15,Senate,"Do pass, but first be re-referred to the Committee on [Appropriations]",13,0,0,0,13
1971698,1599604,2025-08-18,Senate,"Placed on suspense file",7,0,0,0,7
1971699,1556070,2025-04-22,Assembly,"Do pass as amended and be re-referred to the Committee on [Appropriations]",13,0,0,3,16
1971699,1577235,2025-05-23,Assembly,"Do pass",11,1,0,3,15
1971699,1584337,2025-06-03,Assembly,"AB 669 Haney Assembly Third Reading",64,5,0,10,79
1971699,1598050,2025-07-09,Senate,"Do pass as amended, but first amend, and re-refer to the Committee on [Appropriations]",10,1,0,0,11
1971699,1599363,2025-08-18,Senate,"Placed on suspense file",7,0,0,0,7
1971700,1528245,2025-03-26,Assembly,"Do pass as amended and be re-referred to the Committee on [Local Government]",10,0,0,1,11
1971700,1542842,2025-04-09,Assembly,"Do pass and be re-referred to the Committee on [Appropriations]",10,0,0,0,10
1971700,1577709,2025-05-23,Assembly,"Do pass",12,0,0,3,15
1971700,1584334,2025-06-03,Assembly,"AB 670 Quirk-Silva Assembly Third Reading",74,0,0,5,79
1971700,1597428,2025-07-01,Senate,"Do pass, but first be re-referred to the Committee on [Appropriations]",11,0,0,0,11
1971700,1598266,2025-07-14,Senate,"Placed on suspense file",7,0,0,0,7
1971700,1600592,2025-08-29,Senate,"Do pass as amended",7,0,0,0,7
1971700,1601871,2025-09-11,Senate,"Special Consent AB670 Quirk-Silva By Grayson",40,0,0,0,40
1971700,1602192,2025-09-12,Assembly,"AB 670 Quirk-Silva Concurrence in Senate Amendments",77,0,0,3,80
1971701,1556050,2025-04-23,Assembly,"Do pass as amended and be re-referred to the Committee on [Business and Professions]",10,0,0,0,10
1971701,1561038,2025-04-29,Assembly,"Do pass and be re-referred to the Committee on [Appropriations]",17,0,0,1,18
1971701,1575465,2025-05-21,Assembly,"Do pass as amended",15,0,0,0,15
1971701,1582227,2025-05-29,Assembly,"AB 671 Wicks Assembly Third Reading",72,0,0,7,79
1971701,1598056,2025-07-09,Senate,"Do pass, but first be re-referred to the Committee on [Business, Professions and Economic Development]",7,0,0,0,7
1971701,1598211,2025-07-14,Senate,"Do pass as amended, but first amend, and re-refer to the Committee on [Appropriations]",11,0,0,0,11
1971701,1600857,2025-09-02,Senate,"Assembly 3rd Reading AB671 Wicks et al. By Grayson",40,0,0,0,40
1971701,1601576,2025-09-09,Assembly,"AB 671 Wicks Concurrence in Senate Amendments",80,0,0,0,80
1971702,1521947,2025-03-19,Assembly,"Do pass and be re-referred to the Committee on [Judiciary]",6,0,0,1,7
1971702,1540874,2025-04-08,Assembly,"Do pass and be re-referred to the Committee on [Appropriations]",9,0,0,3,12
1971702,1567920,2025-05-07,Assembly,"Do pass",11,0,0,4,15
1971702,1572393,2025-05-15,Assembly,"AB 672 Caloza Assembly Third Reading",62,4,0,13,79
1971702,1595199,2025-06-25,Senate,"Do pass, but first be re-referred to the Committee on [Judiciary]",4,1,0,0,5
1971702,1598560,2025-07-15,Senate,"Do pass, but first be re-referred to the Committee on [Appropriations]",11,2,0,0,13
1971704,1538935,2025-04-07,Assembly,"Do pass and be re-referred to the Committee on [Natural Resources]",15,0,0,1,16
1971704,1558718,2025-04-21,Assembly,"Do pass and be re-referred to the Committee on [Appropriations] with recommendation: To Consent Calendar",14,0,0,0,14
1971705,1562755,2025-04-30,Assembly,"Do pass and be re-referred to the Committee on [Appropriations]",8,0,0,0,8
1971705,1577617,2025-05-23,Assembly,"Do pass",14,0,0,1,15
1971705,1583464,2025-06-02,Assembly,"AB 675 Aguiar-Curry Assembly Third Reading",79,0,0,0,79
1971705,1597174,2025-07-01,Senate,"Do pass, but first be re-referred to the Committee on [Appropriations] with the recommendation: To Consent Calendar",5,0,0,0,5
1971705,1598243,2025-07-14,Senate,"Placed on suspense file",7,0,0,0,7
1971706,1555921,2025-04-22,Assembly,"Do pass and be re-referred to the Committee on [Appropriations] with recommendation: To Consent Calendar",16,0,0,0,16
1971707,1529524,2025-03-26,Assembly,"Do pass",9,0,0,0,9
1971707,1545011,2025-04-10,Assembly,"AB 677 Bryan Assembly Third Reading",74,0,0,5,79
1971707,1589121,2025-06-11,Senate,"Do pass as amended, but first amend, and re-refer to the Committee on [Judiciary] with the recommendation: To Consent Calendar",6,0,0,1,7
1971707,1595197,2025-06-24,Senate,"Do pass and be ordered to the Consent Calendar",12,0,0,1,13
1971707,1601229,2025-09-08,Senate,"Assembly 3rd Reading AB677 Bryan et al. By Durazo",39,0,0,1,40
1971707,1601562,2025-09-09,Assembly,"AB 677 Bryan Concurrence in Senate Amendments",80,0,0,0,80
1971708,1558366,2025-04-24,Assembly,"Do pass and be re-referred to the Committee on [Appropriations]",10,0,0,2,12
1971708,1577326,2025-05-23,Assembly,"Do pass",11,0,0,4,15
1971708,1583410,2025-06-02,Assembly,"AB 678 Lee Assembly Third Reading",67,0,0,12,79
1971708,1597134,2025-06-30,Senate,"Do pass, but first be re-referred to the Committee on [Housing]",5,0,0,0,5
1971708,1598395,2025-07-15,Senate,"Do pass, but first be re-referred to the Committee on [Appropriations]",10,0,0,1,11
1971708,1599635,2025-08-18,Senate,"Placed on suspense file",7,0,0,0,7
1971708,1600653,2025-08-29,Senate,"Do pass",7,0,0,0,7
1971708,1601785,2025-09-10,Senate,"Assembly 3rd Reading AB678 Lee et al. By Arreguín",40,0,0,0,40
1971709,1526884,2025-03-25,Assembly,"Do pass as amended and be re-referred to the Committee on [Appropriations]",10,3,0,0,13
1971709,1542805,2025-04-09,Assembly,"Do pass",10,4,0,1,15
1971709,1565274,2025-05-05,Assembly,"AB 679 Pellerin Assembly Third Reading",57,13,0,9,79
1971709,1598654,2025-07-16,Senate,"Do pass as amended, but first amend, and re-refer to the Committee on [Appropriations]",5,2,0,0,7
1971709,1601582,2025-09-09,Senate,"Assembly 3rd Reading AB679 Pellerin et al. By Allen",30,10,0,0,40
1971710,1526982,2025-03-25,Assembly,"Do pass and be re-referred to the Committee on [Appropriations] with recommendation: To Consent Calendar",7,0,0,0,7
1971711,1522009,2025-03-18,Assembly,"Do pass and be re-referred to the Committee on [Appropriations]",8,2,0,0,10
1971711,1542801,2025-04-09,Assembly,"Do pass",10,4,0,1,15
1971711,1565239,2025-05-05,Assembly,"AB 681 Elhawary Assembly Third Reading",61,10,0,8,79
1971711,1589089,2025-06-11,Senate,"Do pass, but first be re-referred to the Committee on [Appropriations]",5,1,0,1,7
1971711,1594046,2025-06-23,Senate,"Placed on suspense file",7,0,0,0,7
1971711,1600339,2025-08-29,Senate,"Do pass",5,2,0,0,7
1971711,1601167,2025-09-04,Senate,"Assembly 3rd Reading AB681 Elhawary By Pérez",30,9,0,1,40
1971712,1562786,2025-04-29,Assembly,"Do pass and be re-referred to the Committee on [Appropriations] with recommendation: To Consent Calendar",16,0,0,0,16
1971712,1575464,2025-05-21,Assembly,"Do pass. To Consent Calendar",15,0,0,0,15
1971712,1579292,2025-05-27,Assembly,"AB 682 Ortega Consent Calendar Second Day Regular Session",76,0,0,3,79
1971712,1598854,2025-07-16,Senate,"Do pass as amended, but first amend, and re-refer to the Committee on [Appropriations]",9,0,0,2,11
1971712,1599397,2025-08-18,Senate,"Placed on suspense file",7,0,0,0,7
1971712,1600453,2025-08-29,Senate,"Do pass",6,0,0,1,7
1971712,1601515,2025-09-09,Senate,"Assembly 3rd Reading AB682 Ortega et al. By Cortese",31,3,0,6,40
1971714,1542866,2025-04-08,Assembly,"Do pass and be re-referred to the Committee on [Governmental Organization]",10,0,0,0,10
1971714,1556134,2025-04-23,Assembly,"Do pass and be re-referred to the Committee on [Appropriations]",22,0,0,0,22
1971716,1533535,2025-04-01,Assembly,"Do pass and be re-referred to the Committee on [Appropriations] with recommendation: To Consent Calendar",17,0,0,1,18
1971716,1575476,2025-05-21,Assembly,"Do pass. To Consent Calendar",15,0,0,0,15
1971716,1579276,2025-05-27,Assembly,"AB 686 Berman Consent Calendar Second Day Regular Session",76,0,0,3,79
1971716,1596790,2025-06-30,Senate,"Do pass, but first be re-referred to the Committee on [Appropriations]",9,0,0,2,11
1971717,1538992,2025-04-07,Assembly,"Do pass as amended and be re-referred to the Committee on [Appropriations]",10,2,0,2,14
1971717,1577686,2025-05-23,Assembly,"Do pass as amended",11,0,0,4,15
1971717,1585817,2025-06-05,Assembly,"AB 687 Patterson Assembly Third Reading",56,3,0,20,79
1971718,1526924,2025-03-25,Assembly,"Do pass and be re-referred to the Committee on [Appropriations] with recommendation: To Consent Calendar",15,0,0,0,15
1971718,1577954,2025-05-23,Assembly,"Do pass",14,0,0,1,15
1971718,1583407,2025-06-02,Assembly,"AB 688 Mark González Assembly Third Reading",79,0,0,0,79
1971718,1597426,2025-07-02,Senate,"Do pass as amended, but first amend, and re-refer to the Committee on [Appropriations] with the recommendation: To Consent Calendar",11,0,0,0,11
1971718,1600054,2025-08-25,Senate,"Consent Calendar 2nd AB688 Mark González et al",37,0,0,3,40
1971718,1600247,2025-08-28,Assembly,"AB 688 Mark González Concurrence in Senate Amendments",75,0,0,4,79
1971719,1526913,2025-03-25,Assembly,"Do pass and be re-referred to the Committee on [Appropriations] with recommendation: To Consent Calendar",7,0,0,0,7
1971719,1577898,2025-05-23,Assembly,"Do pass",14,0,0,1,15
1971719,1583582,2025-06-02,Assembly,"AB 689 Blanca Rubio Assembly Third Reading",79,0,0,0,79
1971719,1597275,2025-06-30,Senate,"Do pass, but first be re-referred to the Committee on [Appropriations] with the recommendation: To Consent Calendar",5,0,0,0,5
1971719,1598247,2025-07-14,Senate,"Placed on suspense file",7,0,0,0,7
1971719,1600347,2025-08-29,Senate,"Do pass as amended",7,0,0,0,7
1971719,1600989,2025-09-03,Senate,"Assembly 3rd Reading AB689 Blanca Rubio By Cabaldon",40,0,0,0,40
1971719,1601093,2025-09-04,Assembly,"AB 689 Blanca Rubio Concurrence in Senate Amendments",78,0,0,1,79
1971720,1526986,2025-03-25,Assembly,"Do pass as amended and be re-referred to the Committee on [Appropriations]",9,0,0,0,9
1971720,1577654,2025-05-23,Assembly,"Do pass as amended",12,2,0,1,15
1971720,1583391,2025-06-02,Assembly,"AB 690 Schultz Assembly Third Reading",64,9,0,6,79
1971720,1594696,2025-06-24,Senate,"Do pass, but first be re-referred to the Committee on [Appropriations]",4,1,0,1,6
1971720,1598222,2025-07-14,Senate,"Placed on suspense file",7,0,0,0,7
1971722,1536792,2025-04-02,Assembly,"Do pass and be re-referred to the Committee on [Judiciary]",5,0,0,2,7
1971722,1554633,2025-04-22,Assembly,"Do pass and be re-referred to the Committee on [Appropriations]",7,3,0,2,12
1971722,1577458,2025-05-23,Assembly,"Do pass as amended",10,3,0,2,15
1971722,1585812,2025-06-05,Assembly,"AB 692 Kalra Assembly Third Reading",47,21,0,11,79
1971722,1595170,2025-06-25,Senate,"Do pass as amended, but first amend, and re-refer to the Committee on [Judiciary]",4,1,0,0,5
1971722,1598775,2025-07-15,Senate,"Do pass as amended, but first amend, and re-refer to the Committee on [Appropriations]",11,2,0,0,13
1971722,1599521,2025-08-18,Senate,"Placed on suspense file",7,0,0,0,7
1971722,1600729,2025-08-29,Senate,"Do pass as amended",5,2,0,0,7
1971722,1601772,2025-09-10,Senate,"Assembly 3rd Reading AB692 Kalra et al. By Pérez",25,11,0,4,40
1971723,1542759,2025-04-09,Assembly,"Do pass and be re-referred to the Committee on [Appropriations]",9,1,0,0,10
1971724,1536760,2025-04-02,Assembly,"Do pass and be re-referred to the Committee on [Higher Education] with recommendation: To Consent Calendar",7,0,0,0,7
1971724,1561088,2025-04-29,Assembly,"Do pass and be re-referred to the Committee on [Appropriations]",9,0,0,1,10
1971724,1577363,2025-05-23,Assembly,"Do pass",14,0,0,1,15
1971724,1583575,2025-06-02,Assembly,"AB 694 McKinnor Assembly Third Reading",76,1,0,2,79
1971724,1592597,2025-06-18,Senate,"Do pass, but first be re-referred to the Committee on [Education]",4,1,0,0,5
1971724,1597524,2025-07-02,Senate,"Do pass, but first be re-referred to the Committee on [Appropriations]",6,1,0,0,7
1971724,1598271,2025-07-14,Senate,"Placed on suspense file",7,0,0,0,7
1971725,1556064,2025-04-22,Assembly,"Do pass and be re-referred to the Committee on [Appropriations]",7,3,0,0,10
1971725,1577514,2025-05-23,Assembly,"Do pass",11,3,0,1,15
1971725,1584411,2025-06-03,Assembly,"AB 695 Fong Assembly Third Reading",60,16,0,3,79
1971725,1598608,2025-07-16,Senate,"Do pass as amended, but first amend, and re-refer to the Committee on [Appropriations]",6,1,0,0,7
1971725,1599994,2025-08-25,Senate,"Placed on suspense file",6,0,0,1,7
1971725,1600374,2025-08-29,Senate,"Do pass as amended",5,2,0,0,7
1971725,1602321,2025-09-12,Senate,"Assembly 3rd Reading AB695 Fong et al. By Rubio Urgency Clause",30,8,0,2,40
1971725,1602322,2025-09-13,Assembly,"AB 695 Fong Concurrence - Urgency Added",60,16,0,4,80
1971726,1528315,2025-03-25,Assembly,"Do pass and be re-referred to the Committee on [Appropriations] with recommendation: To Consent Calendar",7,0,0,0,7
1971726,1577791,2025-05-23,Assembly,"Do pass as amended",11,0,0,4,15
1971726,1585094,2025-06-04,Assembly,"AB 696 Ransom Assembly Third Reading",79,0,0,0,79
1971726,1597959,2025-07-08,Senate,"Do pass, but first be re-referred to the Committee on [Environmental Quality] with the recommendation: To Consent Calendar",15,0,0,0,15
1971726,1598592,2025-07-16,Senate,"Do pass, but first be re-referred to the Committee on [Appropriations] with the recommendation: To Consent Calendar",8,0,0,0,8
1971726,1600842,2025-09-02,Senate,"Assembly 3rd Reading AB696 Ransom et al. By Stern",40,0,0,0,40
1971726,1600946,2025-09-03,Assembly,"AB 696 Ransom Concurrence in Senate Amendments",79,0,0,0,79
1971727,1562997,2025-04-29,Assembly,"Do pass as amended and be re-referred to the Committee on [Appropriations]",12,0,0,1,13
1971727,1571570,2025-05-14,Assembly,"Do pass",15,0,0,0,15
1971727,1584235,2025-06-03,Assembly,"AB 697 Wilson Assembly Third Reading",70,0,0,9,79
1971727,1597909,2025-07-08,Senate,"Do pass, but first be re-referred to the Committee on [Appropriations]",6,0,0,1,7
1971727,1601135,2025-09-04,Senate,"Assembly 3rd Reading AB697 Wilson By Cabaldon",36,0,0,4,40
1971728,1564301,2025-04-30,Assembly,"Do pass as amended",10,0,0,0,10
1971728,1585793,2025-06-05,Assembly,"AB 698 Wicks Assembly Third Reading",68,0,0,11,79
1971729,1563128,2025-04-30,Assembly,"Do pass as amended and be re-referred to the Committee on [Appropriations]",4,2,0,1,7
1971729,1577401,2025-05-23,Assembly,"Do pass",11,3,0,1,15
1971729,1585795,2025-06-05,Assembly,"AB 699 Stefani Assembly Third Reading",54,20,0,5,79
1971729,1597481,2025-07-02,Senate,"Do pass as amended, but first amend, and re-refer to the Committee on [Elections and Constitutional Amendments]",5,2,0,0,7
1971729,1598428,2025-07-15,Senate,"Do pass, but first be re-referred to the Committee on [Appropriations]",4,1,0,0,5
1971729,1599592,2025-08-18,Senate,"Placed on suspense file",7,0,0,0,7
1971729,1600561,2025-08-29,Senate,"Do pass",5,2,0,0,7
1971729,1601982,2025-09-11,Senate,"Assembly 3rd Reading AB699 Stefani By Wiener",24,13,0,3,40
1971729,1602141,2025-09-13,Assembly,"AB 699 Stefani Concurrence in Senate Amendments",55,21,0,4,80
1971731,1526919,2025-03-25,Assembly,"Do pass and be re-referred to the Committee on [Appropriations]",8,0,0,1,9
1971733,1542717,2025-04-07,Assembly,"Do pass as amended and be re-referred to the Committee on [Appropriations]",6,0,0,1,7
1971733,1562789,2025-04-30,Assembly,"Do pass",14,0,0,1,15
1971733,1565315,2025-05-05,Assembly,"AB 703 Lee Assembly Third Reading",76,0,0,3,79
1971733,1595192,2025-06-25,Senate,"Do pass, but first be re-referred to the Committee on [Appropriations] with the recommendation: To Consent Calendar",5,0,0,0,5
1971733,1598160,2025-07-10,Senate,"Consent Calendar 2nd AB703 Lee",37,0,0,3,40
1971734,1526910,2025-03-25,Assembly,"Do pass and be re-referred to the Committee on [Appropriations]",7,0,0,2,9
1971734,1577862,2025-05-23,Assembly,"Do pass",11,3,0,1,15
1971734,1585116,2025-06-04,Assembly,"AB 704 Lowenthal Assembly Third Reading",47,17,0,15,79
1971734,1597882,2025-07-08,Senate,"Do pass, but first be re-referred to the Committee on [Appropriations]",5,1,0,0,6
1971734,1599511,2025-08-18,Senate,"Placed on suspense file",7,0,0,0,7
1971735,1556072,2025-04-23,Assembly,"Do pass and be re-referred to the Committee on [Appropriations] with recommendation: To Consent Calendar",18,0,0,0,18
1971735,1577287,2025-05-23,Assembly,"Do pass",14,0,0,1,15
1971735,1583466,2025-06-02,Assembly,"AB 705 Boerner Assembly Third Reading",79,0,0,0,79
1971735,1598415,2025-07-15,Senate,"Do pass, but first be re-referred to the Committee on [Appropriations]",15,1,0,1,17
1971735,1599555,2025-08-18,Senate,"Placed on suspense file",7,0,0,0,7
1971736,1558703,2025-04-21,Assembly,"Do pass as amended and be re-referred to the Committee on [Utilities and Energy]",13,0,0,1,14
1971736,1564166,2025-04-30,Assembly,"Do pass and be re-referred to the Committee on [Appropriations]",18,0,0,0,18
1971736,1577646,2025-05-23,Assembly,"Do pass as amended",11,0,0,4,15
1971736,1583440,2025-06-02,Assembly,"AB 706 Aguiar-Curry Assembly Third Reading",75,0,0,4,79
1971738,1520443,2025-03-18,Assembly,"Do pass and be re-referred to the Committee on [Judiciary]",9,0,0,0,9
1971738,1526909,2025-03-25,Assembly,"Do pass as amended. To Consent Calendar",12,0,0,0,12
1971738,1536825,2025-04-03,Assembly,"AB 708 Valencia Consent Calendar Second Day Regular Session",74,0,0,5,79
1971738,1589101,2025-06-11,Senate,"Do pass, but first be re-referred to the Committee on [Judiciary] with the recommendation: To Consent Calendar",9,0,0,2,11
1971738,1595147,2025-06-24,Senate,"Do pass, but first be re-referred to the Committee on [Appropriations] with the recommendation: To Consent Calendar",12,0,0,1,13
1971739,1562793,2025-04-29,Assembly,"Do pass. To Consent Calendar",13,0,0,0,13
1971739,1568660,2025-05-08,Assembly,"AB 709 Jeff Gonzalez Consent Calendar Second Day Regular Session",69,0,0,10,79
1971739,1588070,2025-06-10,Senate,"Do pass",7,0,0,0,7
1971739,1601864,2025-09-11,Senate,"Assembly 3rd Reading AB709 Jeff Gonzalez By Seyarto",40,0,0,0,40
1971741,1526993,2025-03-25,Assembly,"Do pass",12,0,0,0,12
1971741,1572427,2025-05-15,Assembly,"AB 711 Chen Assembly Third Reading",70,0,0,9,79
1971741,1595158,2025-06-24,Senate,"Do pass and be ordered to the Consent Calendar",12,0,0,1,13
1971741,1597588,2025-07-03,Senate,"Consent Calendar 2nd AB711 Chen",35,0,0,5,40
1971742,1542776,2025-04-09,Assembly,"Do pass and be re-referred to the Committee on [Judiciary]",11,0,0,1,12
1971742,1554638,2025-04-22,Assembly,"Do pass and be re-referred to the Committee on [Appropriations]",9,0,0,3,12
1971742,1563028,2025-04-30,Assembly,"Do pass",12,0,0,3,15
1971742,1569833,2025-05-12,Assembly,"AB 712 Wicks Assembly Third Reading",64,2,0,13,79
1971742,1597414,2025-07-01,Senate,"Do pass as amended, but first amend, and re-refer to the Committee on [Judiciary]",10,1,0,0,11
1971742,1598770,2025-07-15,Senate,"Do pass, but first be re-referred to the Committee on [Appropriations]",13,0,0,0,13
1971742,1600935,2025-09-03,Senate,"Assembly 3rd Reading AB712 Wicks By Caballero",35,2,0,3,40
1971742,1601077,2025-09-04,Assembly,"AB 712 Wicks Concurrence in Senate Amendments",64,2,0,13,79
1971744,1542753,2025-04-08,Assembly,"Do pass and be re-referred to the Committee on [Business and Professions]",9,0,0,1,10
1971744,1561186,2025-04-29,Assembly,"Do pass and be re-referred to the Committee on [Appropriations]",17,0,0,1,18
1971745,1571601,2025-05-14,Assembly,"Do pass and be re-referred to the Committee on [Appropriations]",9,0,0,0,9
1971745,1577668,2025-05-23,Assembly,"Do pass",14,0,0,1,15
1971745,1582254,2025-05-29,Assembly,"AB 715 Zbur Assembly Third Reading",68,0,0,11,79
1971745,1601960,2025-09-10,Senate,"Do pass, but first be re-referred to the Committee on [Judiciary]",6,0,0,1,7
1971745,1601961,2025-09-11,Senate,"Do pass",4,1,0,2,7
1971745,1602318,2025-09-12,Senate,"Assembly 2nd Reading AB715 Zbur et al. By Wiener",35,0,0,5,40
1971745,1602319,2025-09-13,Assembly,"AB 715 ZBUR Concurrence in Senate Amendments",71,0,0,9,80
1971746,1561132,2025-04-28,Assembly,"Do pass and be re-referred to the Committee on [Utilities and Energy]",7,0,0,0,7
1971746,1564286,2025-04-30,Assembly,"Do pass and be re-referred to the Committee on [Appropriations] with recommendation: To Consent Calendar",18,0,0,0,18
1971746,1577815,2025-05-23,Assembly,"Do pass",14,0,0,1,15
1971746,1583546,2025-06-02,Assembly,"AB 716 Carrillo Assembly Third Reading",79,0,0,0,79
1971746,1597840,2025-07-08,Senate,"Do pass as amended, but first amend, and re-refer to the Committee on [Appropriations]",12,0,0,3,15
1971746,1599472,2025-08-18,Senate,"Placed on suspense file",7,0,0,0,7
1971747,1540924,2025-04-08,Assembly,"Do pass and be re-referred to the Committee on [Appropriations] with recommendation: To Consent Calendar",13,0,0,0,13
1971748,1555931,2025-04-22,Assembly,"Do pass as amended, and be re-referred to the Committee on [Appropriations] with recommendation: To Consent Calendar",10,0,0,0,10
1971750,1521979,2025-03-19,Assembly,"Do pass and be re-referred to the Committee on [Appropriations] with recommendation: To Consent Calendar",19,0,0,3,22
1971750,1542734,2025-04-09,Assembly,"Do pass. To Consent Calendar",14,0,0,1,15
1971750,1557593,2025-04-24,Assembly,"AB 720 Rogers Consent Calendar Second Day Regular Session",75,0,0,4,79
1971750,1597842,2025-07-08,Senate,"Do pass, but first be re-referred to the Committee on [Appropriations]",15,0,0,0,15
1971750,1601586,2025-09-09,Senate,"That the measure be returned to Senate Floor for consideration. Ordered to third reading",7,0,0,1,8
1971750,1601909,2025-09-11,Senate,"Assembly 3rd Reading AB720 Rogers By Cabaldon",40,0,0,0,40
1971750,1602229,2025-09-13,Assembly,"AB 720 Rogers Concurrence in Senate Amendments",80,0,0,0,80
1971751,1558733,2025-04-21,Assembly,"Do pass as amended and be re-referred to the Committee on [Appropriations]",14,0,0,0,14
1971752,1563064,2025-04-30,Assembly,"Do pass and be re-referred to the Committee on [Appropriations]",9,0,0,3,12
1971753,1535149,2025-04-01,Assembly,"Do pass as amended and be re-referred to the Committee on [Appropriations]",14,0,0,1,15
1971753,1577427,2025-05-23,Assembly,"Do pass",13,0,0,2,15
1971753,1584226,2025-06-03,Assembly,"AB 723 Pellerin Assembly Third Reading",66,2,0,11,79
1971753,1597700,2025-07-07,Senate,"Do pass, but first be re-referred to the Committee on [Judiciary]",8,3,0,0,11
1971753,1598611,2025-07-15,Senate,"Do pass, but first be re-referred to the Committee on [Appropriations]",11,2,0,0,13
1971753,1599399,2025-08-18,Senate,"Placed on suspense file",7,0,0,0,7
1971753,1600284,2025-08-29,Senate,"Do pass",5,2,0,0,7
1971753,1601647,2025-09-09,Senate,"Assembly 3rd Reading AB723 Pellerin By Wahab",29,10,0,1,40
1971755,1492770,2025-02-18,Assembly,"Be adopted. To third reading",10,0,0,1,11
1971755,1517827,2025-03-13,Senate,"Special Consent ACR33 Zbur et al",36,0,0,4,40
1971756,1498302,2025-02-24,Assembly,"Be adopted. To third reading",11,0,0,0,11
1971760,1556022,2025-04-22,Senate,"Do pass as amended, but first amend, and re-refer to the Committee on [Appropriations]",11,2,0,0,13
1971760,1565295,2025-05-05,Senate,"Placed on suspense file",7,0,0,0,7
1971760,1577341,2025-05-23,Senate,"Do pass",5,1,0,1,7
1971760,1584232,2025-06-03,Senate,"Senate 3rd Reading SB384 Wahab",28,10,0,2,40
1971760,1597152,2025-07-01,Assembly,"Do pass and be re-referred to the Committee on [Privacy and Consumer Protection]",9,2,0,1,12
1971760,1598635,2025-07-16,Assembly,"Do pass as amended and be re-referred to the Committee on [Appropriations]",9,4,0,2,15
1971761,1526996,2025-03-25,Senate,"Do pass, but first be re-referred to the Committee on [Appropriations]",6,0,0,0,6
1971761,1581756,2025-05-29,Senate,"Senate 3rd Reading SB385 Seyarto et al. Urgency Clause",38,0,0,2,40
1971761,1591858,2025-06-17,Assembly,"Do pass and be re-referred to the Committee on [Appropriations] with recommendation: To Consent Calendar",9,0,0,0,9
1971761,1598075,2025-07-09,Assembly,"Do pass. To Consent Calendar",15,0,0,0,15
1971762,1535010,2025-04-02,Senate,"Do pass as amended, but first amend, and re-refer to the Committee on [Appropriations]",11,0,0,0,11
1971762,1586400,2025-06-02,Senate,"Senate 3rd Reading SB386 Limón",38,0,0,2,40
1971762,1591880,2025-06-17,Assembly,"Do pass and be re-referred to the Committee on [Appropriations] with recommendation: To Consent Calendar",15,0,0,1,16
1971762,1597415,2025-07-02,Assembly,"Do pass. To Consent Calendar",14,0,0,1,15
1971762,1601364,2025-09-08,Assembly,"SB 386 Limón Senate Third Reading By Sharp-Collins",79,0,0,1,80
1971762,1601672,2025-09-09,Senate,"Unfinished Business SB386 Limón Concurrence",40,0,0,0,40
1971763,1538878,2025-04-07,Senate,"Do pass, but first be re-referred to the Committee on [Appropriations]",10,0,0,1,11
1971763,1584377,2025-06-03,Senate,"Senate 3rd Reading SB387 Rubio",39,0,0,1,40
1971763,1594663,2025-06-24,Assembly,"Do pass and be re-referred to the Committee on [Appropriations] with recommendation: To Consent Calendar",16,0,0,2,18
1971763,1598055,2025-07-09,Assembly,"Do pass. To Consent Calendar",15,0,0,0,15
1971763,1598881,2025-07-17,Assembly,"SB 387 Rubio Consent Calendar Second Day Regular Session",75,0,0,4,79
1971763,1599990,2025-08-25,Senate,"Special Consent SB387 Rubio",37,0,0,3,40
1971764,1526965,2025-03-25,Senate,"Do pass, but first be re-referred to the Committee on [Appropriations]",11,2,0,2,15
1971764,1538874,2025-04-07,Senate,"Placed on suspense file",7,0,0,0,7
1971764,1577247,2025-05-23,Senate,"Do pass",5,1,0,1,7
1971764,1586406,2025-06-02,Senate,"Senate 3rd Reading SB388 Padilla et al",30,8,0,2,40
1971764,1595233,2025-06-25,Assembly,"Do pass and be re-referred to the Committee on [Appropriations]",20,1,0,1,22
1971764,1600575,2025-08-29,Assembly,"Do pass as amended",11,2,0,2,15
1971764,1601365,2025-09-08,Assembly,"SB 388 Padilla Senate Third Reading By Carrillo",62,9,0,9,80
1971764,1601733,2025-09-10,Senate,"Unfinished Business SB388 Padilla et al. Concurrence",32,8,0,0,40
1971765,1528325,2025-03-26,Senate,"Do pass, but first be re-referred to the Committee on [Business, Professions and Economic Development] with the recommendation: To Consent Calendar",7,0,0,0,7
1971765,1559368,2025-04-28,Senate,"Do pass, but first be re-referred to the Committee on [Appropriations] with the recommendation: To Consent Calendar",11,0,0,0,11
1971765,1572406,2025-05-15,Senate,"Consent Calendar 2nd SB389 Ochoa Bogh et al",34,0,0,6,40
1971765,1597538,2025-07-02,Assembly,"Do pass and be re-referred to the Committee on [Business and Professions] with recommendation: To Consent Calendar",9,0,0,0,9
1971765,1597937,2025-07-08,Assembly,"Do pass and be re-referred to the Committee on [Appropriations] with recommendation: To Consent Calendar",17,0,0,1,18
1971765,1599773,2025-08-20,Assembly,"Do pass. To Consent Calendar",15,0,0,0,15
1971765,1600215,2025-08-28,Assembly,"SB 389 Ochoa Bogh Consent Calendar Second Day Regular Session",74,0,0,5,79
1971766,1567914,2025-05-07,Senate,"Do pass",7,0,0,0,7
1971766,1579279,2025-05-27,Senate,"Senate 3rd Reading SB390 Becker",39,0,0,1,40
1971766,1592624,2025-06-18,Assembly,"Do pass",9,0,0,1,10
1971766,1600220,2025-08-28,Assembly,"SB 390 Becker Senate Third Reading By Stefani",74,1,0,4,79
1971766,1600979,2025-09-03,Senate,"Unfinished Business SB390 Becker et al. Concurrence",40,0,0,0,40
1971767,1535059,2025-04-02,Senate,"Do pass as amended, but first amend, and re-refer to the Committee on [Appropriations]",7,0,0,0,7
1971767,1552915,2025-04-21,Senate,"Placed on suspense file",6,0,0,1,7
1971767,1577947,2025-05-23,Senate,"Do pass",6,0,0,1,7
1971767,1581713,2025-05-29,Senate,"Special Consent SB391 Laird",38,0,0,2,40
1971767,1594660,2025-06-24,Assembly,"Do pass as amended and be re-referred to the Committee on [Appropriations]",8,0,0,2,10
1971767,1597525,2025-07-02,Assembly,"Do pass",12,0,0,3,15
1971767,1600214,2025-08-28,Assembly,"SB 391 Laird Senate Third Reading By Fong",72,1,0,6,79
1971767,1600806,2025-09-02,Senate,"Unfinished Business SB391 Laird Concurrence",40,0,0,0,40
1971768,1562874,2025-04-30,Senate,"Do pass, but first be re-referred to the Committee on [Appropriations] with the recommendation: To Consent Calendar",7,0,0,0,7
1971768,1572370,2025-05-15,Senate,"Consent Calendar 2nd SB392 Grayson et al",34,0,0,6,40
1971768,1597573,2025-07-02,Assembly,"Do pass and be re-referred to the Committee on [Appropriations] with recommendation: To Consent Calendar",10,0,0,0,10
1971768,1598645,2025-07-16,Assembly,"Do pass. To Consent Calendar",13,0,0,2,15
1971768,1599860,2025-08-21,Assembly,"SB 392 Grayson Consent Calendar Second Day Regular Session",77,0,0,2,79
1971768,1600409,2025-08-29,Senate,"Special Consent SB392 Grayson et al",37,0,0,3,40
1971770,1521990,2025-03-19,Senate,"Do pass, but first be re-referred to the Committee on [Judiciary]",7,0,0,0,7
1971770,1535061,2025-04-01,Senate,"Do pass, but first be re-referred to the Committee on [Appropriations] with the recommendation: To Consent Calendar",13,0,0,0,13
1971770,1579307,2025-05-27,Senate,"Senate 3rd Reading SB394 Allen",39,0,0,1,40
1971770,1592616,2025-06-18,Assembly,"Do pass and be re-referred to the Committee on [Judiciary]",10,0,0,0,10
1971770,1597126,2025-07-01,Assembly,"Do pass as amended. To Consent Calendar",12,0,0,0,12
1971770,1598154,2025-07-10,Assembly,"SB 394 Allen Consent Calendar Second Day Regular Session",72,0,0,7,79
1971770,1600056,2025-08-25,Senate,"Special Consent SB394 Allen et al",37,0,0,3,40
1971771,1540895,2025-04-08,Senate,"Do pass, but first be re-referred to the Committee on [Appropriations]",15,0,0,0,15
1971771,1579250,2025-05-27,Senate,"Senate 3rd Reading SB395 Wiener",39,0,0,1,40
1971771,1598031,2025-07-09,Assembly,"Do pass and be re-referred to the Committee on [Appropriations]",22,0,0,0,22
1971771,1599719,2025-08-20,Assembly,"Do pass",15,0,0,0,15
1971771,1600199,2025-08-28,Assembly,"SB 395 Wiener Senate Third Reading By Haney",74,0,0,5,79
1971771,1600847,2025-09-02,Senate,"Unfinished Business SB395 Wiener et al. Concurrence",40,0,0,0,40
1971772,1540890,2025-04-08,Senate,"Do pass, but first be re-referred to the Committee on [Appropriations]",6,0,0,0,6
1971772,1552897,2025-04-21,Senate,"Placed on suspense file",6,0,0,1,7
1971774,1533489,2025-04-01,Senate,"Do pass, but first be re-referred to the Committee on [Public Safety]",5,0,0,0,5
1971774,1554464,2025-04-22,Senate,"Do pass, but first be re-referred to the Committee on [Appropriations]",6,0,0,0,6
1971774,1565224,2025-05-05,Senate,"Placed on suspense file",7,0,0,0,7
1971774,1577814,2025-05-23,Senate,"Do pass",6,0,0,1,7
1971774,1581751,2025-05-29,Senate,"Senate 3rd Reading SB398 Umberg et al",38,0,0,2,40
1971774,1597522,2025-07-02,Assembly,"Do pass as amended and be re-referred to the Committee on [Public Safety]",7,0,0,0,7
1971774,1598693,2025-07-15,Assembly,"Do pass and be re-referred to the Committee on [Appropriations]",9,0,0,0,9
1971774,1600336,2025-08-29,Assembly,"Do pass",15,0,0,0,15
1971774,1601367,2025-09-08,Assembly,"SB 398 Umberg Senate Third Reading By Berman",79,0,0,1,80
1971774,1601760,2025-09-10,Senate,"Unfinished Business SB398 Umberg et al. Concurrence",40,0,0,0,40
1971775,1521995,2025-03-19,Senate,"Do pass as amended, but first amend, and re-refer to the Committee on [Judiciary]",6,0,0,1,7
1971775,1562949,2025-04-29,Senate,"Do pass, but first be re-referred to the Committee on [Appropriations]",11,1,0,1,13
1971775,1569865,2025-05-12,Senate,"Placed on suspense file",7,0,0,0,7
1971776,1554621,2025-04-22,Senate,"Do pass, but first be re-referred to the Committee on [Appropriations] with the recommendation: To Consent Calendar",15,0,0,0,15
1971776,1568670,2025-05-08,Senate,"Consent Calendar 2nd SB400 Cortese",36,0,0,4,40
1971776,1598084,2025-07-09,Assembly,"Do pass and be re-referred to the Committee on [Appropriations] with recommendation: To Consent Calendar",7,0,0,0,7
1971776,1599730,2025-08-20,Assembly,"Do pass as amended. To Consent Calendar",15,0,0,0,15
1971776,1600192,2025-08-28,Assembly,"SB 400 Cortese Consent Calendar Second Day Regular Session",74,0,0,5,79
1971776,1602267,2025-09-12,Senate,"Unfinished Business SB400 Cortese Urgency Clause Concurrence",38,0,0,2,40
1971778,1552851,2025-04-21,Senate,"Do pass",11,0,0,0,11
1971778,1584357,2025-06-03,Senate,"Senate 3rd Reading SB402 Valladares",39,0,0,1,40
1971778,1597173,2025-07-01,Assembly,"Do pass and be re-referred to the Committee on [Health]",17,0,0,1,18
1971778,1598403,2025-07-15,Assembly,"Do pass",15,0,0,1,16
1971778,1601638,2025-09-09,Assembly,"SB 402 Valladares Senate Third Reading By Nguyen",77,0,0,3,80
1971778,1601858,2025-09-11,Senate,"Unfinished Business SB402 Valladares Concurrence",40,0,0,0,40
1971779,1557595,2025-04-23,Senate,"Do pass, but first be re-referred to the Committee on [Judiciary]",9,2,0,0,11
1971779,1563012,2025-04-29,Senate,"Do pass as amended, but first amend, and re-refer to the Committee on [Appropriations]",10,1,0,2,13
1971779,1569926,2025-05-12,Senate,"Placed on suspense file",7,0,0,0,7
1971779,1577372,2025-05-23,Senate,"Do pass",5,1,0,1,7
1971779,1585016,2025-06-04,Senate,"Senate 3rd Reading SB403 Blakespear",26,6,0,8,40
1971779,1598141,2025-07-08,Assembly,"Do pass and be re-referred to the Committee on [Judiciary]",13,2,0,1,16
1971779,1598469,2025-07-15,Assembly,"Do pass and be re-referred to the Committee on [Appropriations]",10,2,0,0,12
1971779,1600733,2025-08-29,Assembly,"Do pass as amended",12,3,0,0,15
1971779,1602102,2025-09-12,Senate,"Unfinished Business SB403 Blakespear Concurrence",25,9,0,6,40
1971780,1536811,2025-04-02,Senate,"Do pass, but first be re-referred to the Committee on [Judiciary]",7,0,0,1,8
1971780,1565244,2025-05-05,Senate,"Placed on suspense file",7,0,0,0,7
1971780,1577934,2025-05-23,Senate,"Do pass as amended",6,0,0,1,7
1971780,1581698,2025-05-29,Senate,"Senate 3rd Reading SB404 Caballero et al",36,0,0,4,40
1971780,1598768,2025-07-15,Assembly,"Do pass as amended and be re-referred to the Committee on [Appropriations]",6,1,0,0,7
1971780,1600701,2025-08-29,Assembly,"Do pass as amended",11,0,0,4,15
1971780,1602153,2025-09-12,Senate,"Unfinished Business SB404 Caballero et al. Concurrence",35,0,0,5,40
1971780,1602154,2025-09-12,Assembly,"SB 404 Caballero Senate Third Reading By Blanca Rubio",65,1,0,14,80
1971784,1561159,2025-04-29,Senate,"Do pass, but first be re-referred to the Committee on [Appropriations] with the recommendation: To Consent Calendar",5,0,0,0,5
1971784,1569893,2025-05-12,Senate,"Placed on suspense file",7,0,0,0,7
1971784,1577143,2025-05-23,Senate,"Do pass",6,0,0,1,7
1971784,1581769,2025-05-29,Senate,"Special Consent SB408 Choi et al",38,0,0,2,40
1971784,1597546,2025-07-02,Assembly,"Do pass and be re-referred to the Committee on [Appropriations]",6,0,0,1,7
1971785,1567892,2025-05-07,Senate,"Do pass",7,0,0,0,7
1971785,1580555,2025-05-28,Senate,"Senate 3rd Reading SB409 Archuleta",38,0,0,2,40
1971785,1592610,2025-06-18,Assembly,"Do pass. To Consent Calendar",10,0,0,0,10
1971785,1595989,2025-06-27,Assembly,"SB 409 Archuleta Consent Calendar Second Day Regular Session",75,0,0,4,79
1971786,1556185,2025-04-22,Senate,"Do pass, but first be re-referred to the Committee on [Judiciary] with the recommendation: To Consent Calendar",11,0,0,0,11
1971786,1567923,2025-05-06,Senate,"Do pass as amended, and be ordered to the Consent Calendar",12,0,0,1,13
1971786,1572423,2025-05-15,Senate,"Consent Calendar 2nd SB410 Grayson",34,0,0,6,40
1971786,1592598,2025-06-18,Assembly,"Do pass and be re-referred to the Committee on [Judiciary] with recommendation: To Consent Calendar",11,0,0,1,12
1971786,1597838,2025-07-08,Assembly,"Do pass as amended. To Consent Calendar",12,0,0,0,12
1971786,1601368,2025-09-08,Assembly,"SB 410 Grayson Senate Third Reading By Quirk-Silva",79,0,0,1,80
1971786,1601794,2025-09-10,Senate,"Unfinished Business SB410 Grayson Concurrence",40,0,0,0,40
1971787,1535004,2025-04-02,Senate,"Do pass, but first be re-referred to the Committee on [Human Services]",7,0,0,0,7
1971787,1552848,2025-04-21,Senate,"Do pass, but first be re-referred to the Committee on [Appropriations]",5,0,0,0,5
1971787,1565282,2025-05-05,Senate,"Placed on suspense file",7,0,0,0,7
1971787,1577849,2025-05-23,Senate,"Do pass as amended",6,0,0,1,7
1971787,1580520,2025-05-28,Senate,"Senate 3rd Reading SB411 Pérez",38,0,0,2,40
1971787,1597518,2025-07-02,Assembly,"Do pass as amended, and be re-referred to the Committee on [Human Services] with recommendation: To Consent Calendar",9,0,0,0,9
1971787,1598442,2025-07-15,Assembly,"Do pass and be re-referred to the Committee on [Appropriations] with recommendation: To Consent Calendar",7,0,0,0,7
1971787,1600619,2025-08-29,Assembly,"Do pass as amended",11,0,0,4,15
1971787,1601369,2025-09-08,Assembly,"SB 411 Pérez Senate Third Reading By Lee",79,0,0,1,80
1971787,1601610,2025-09-09,Senate,"Unfinished Business SB411 Pérez et al. Concurrence",40,0,0,0,40
1971788,1552951,2025-04-21,Senate,"Do pass, but first be re-referred to the Committee on [Appropriations] with the recommendation: To Consent Calendar",5,0,0,0,5
1971788,1568635,2025-05-08,Senate,"Consent Calendar 2nd SB412 Limón",36,0,0,4,40
1971788,1591859,2025-06-17,Assembly,"Do pass as amended and be re-referred to the Committee on [Appropriations]",7,0,0,0,7
1971788,1597403,2025-07-02,Assembly,"Do pass",14,0,0,1,15
1971788,1600233,2025-08-28,Assembly,"SB 412 Limón Senate Third Reading By Stefani",76,0,0,3,79
1971788,1601140,2025-09-04,Senate,"Unfinished Business SB412 Limón et al. Concurrence",39,0,0,1,40
1971789,1542729,2025-04-08,Senate,"Do pass, but first be re-referred to the Committee on [Appropriations] with the recommendation: To Consent Calendar",13,0,0,0,13
1971789,1557586,2025-04-24,Senate,"Consent Calendar 2nd SB413 Allen",37,0,0,3,40
1971789,1594655,2025-06-24,Assembly,"Do pass as amended and be re-referred to the Committee on [Appropriations]",11,1,0,0,12
1971789,1598703,2025-07-16,Assembly,"Do pass",12,0,0,3,15
1971789,1601511,2025-09-09,Assembly,"SB 413 Allen Senate Third Reading By McKinnor",79,0,0,1,80
1971789,1601786,2025-09-10,Senate,"Unfinished Business SB413 Allen Concurrence",40,0,0,0,40
1971790,1556004,2025-04-23,Senate,"Do pass, but first be re-referred to the Committee on [Judiciary]",6,0,0,1,7
1971790,1563019,2025-04-29,Senate,"Do pass as amended, but first amend, and re-refer to the Committee on [Appropriations]",11,0,0,2,13
1971790,1573620,2025-05-19,Senate,"Placed on suspense file",5,0,0,2,7
1971790,1577465,2025-05-23,Senate,"Do pass",5,0,0,2,7
1971790,1586413,2025-06-02,Senate,"Senate 3rd Reading SB414 Ashby",30,1,0,9,40
1971790,1598644,2025-07-16,Assembly,"Do pass as amended and be re-referred to the Committee on [Appropriations]",8,1,0,0,9
1971790,1600275,2025-08-29,Assembly,"Do pass as amended",11,0,0,4,15
1971790,1602053,2025-09-12,Senate,"Unfinished Business SB414 Ashby Concurrence",24,0,0,16,40
1971790,1602054,2025-09-13,Assembly,"SB 414 Ashby Senate Third Reading By Bauer-Kahan",55,3,0,22,80
1971791,1563042,2025-04-30,Senate,"Do pass, but first be re-referred to the Committee on [Appropriations]",7,0,0,0,7
1971791,1584301,2025-06-03,Senate,"Senate 3rd Reading SB415 Reyes et al. By Durazo",38,0,0,2,40
1971791,1598892,2025-07-16,Assembly,"Do pass and be re-referred to the Committee on [Appropriations]",7,0,0,3,10
1971791,1599720,2025-08-20,Assembly,"Do pass",11,1,0,3,15
1971791,1601951,2025-09-11,Assembly,"Do pass",10,0,0,0,10
1971791,1602352,2025-09-12,Senate,"Unfinished Business SB415 Reyes et al. Concurrence",36,0,0,4,40
1971791,1602353,2025-09-12,Assembly,"SB 415 Reyes Senate Third Reading By CARRILLO",62,3,0,15,80
1971792,1555909,2025-04-23,Senate,"Do pass, but first be re-referred to the Committee on [Appropriations] with the recommendation: To Consent Calendar",7,0,0,0,7
1971792,1565304,2025-05-05,Senate,"Placed on suspense file",7,0,0,0,7
1974442,1563010,2025-04-29,Assembly,"Do pass as amended, and be re-referred to the Committee on [Appropriations] with recommendation: To Consent Calendar",16,0,0,0,16
1974443,1528282,2025-03-26,Assembly,"Do pass and be re-referred to the Committee on [Local Government] with recommendation: To Consent Calendar",10,0,0,1,11
1974443,1542718,2025-04-09,Assembly,"Do pass and be re-referred to the Committee on [Appropriations] with recommendation: To Consent Calendar",10,0,0,0,10
1974443,1577766,2025-05-23,Assembly,"Do pass",14,0,0,1,15
1974443,1583425,2025-06-02,Assembly,"AB 726 Ávila Farías Assembly Third Reading",79,0,0,0,79
1974443,1598393,2025-07-15,Senate,"Do pass, but first be re-referred to the Committee on [Appropriations] with the recommendation: To Consent Calendar",10,0,0,1,11
1974443,1599442,2025-08-18,Senate,"Placed on suspense file",7,0,0,0,7
1974443,1600618,2025-08-29,Senate,"Do pass as amended",7,0,0,0,7
1974443,1601928,2025-09-11,Senate,"Special Consent AB726 Ávila Farías By Wiener",40,0,0,0,40
1974443,1602314,2025-09-12,Assembly,"AB 726 Ávila Farías Concurrence in Senate Amendments",80,0,0,0,80
1974444,1545033,2025-04-09,Assembly,"Do pass as amended and be re-referred to the Committee on [Appropriations]",7,2,0,0,9
1974444,1577566,2025-05-23,Assembly,"Do pass",11,3,0,1,15
1974444,1584381,2025-06-03,Assembly,"AB 727 Mark González Assembly Third Reading",59,13,0,7,79
1974444,1598132,2025-07-09,Senate,"Do pass, but first be re-referred to the Committee on [Appropriations]",5,2,0,0,7
1974444,1599430,2025-08-18,Senate,"Placed on suspense file",7,0,0,0,7
1974444,1600528,2025-08-29,Senate,"Do pass",5,2,0,0,7
1974444,1601635,2025-09-09,Senate,"Assembly 3rd Reading AB727 Mark González et al. By Pérez",30,10,0,0,40
1974445,1561117,2025-04-29,Assembly,"Do pass and be re-referred to the Committee on [Appropriations]",4,2,0,1,7
1974446,1555982,2025-04-23,Assembly,"Do pass and be re-referred to the Committee on [Natural Resources] with recommendation: To Consent Calendar",18,0,0,0,18
1974446,1559472,2025-04-28,Assembly,"Do pass and be re-referred to the Committee on [Appropriations] with recommendation: To Consent Calendar",14,0,0,0,14
1974446,1571631,2025-05-14,Assembly,"Do pass. To Consent Calendar",15,0,0,0,15
1974446,1577858,2025-05-23,Assembly,"AB 729 Zbur Consent Calendar Second Day Regular Session",71,0,0,8,79
1974447,1561125,2025-04-29,Assembly,"Do pass and be re-referred to the Committee on [Appropriations]",9,0,0,1,10
1974448,1542690,2025-04-08,Assembly,"Do pass and be re-referred to the Committee on [Education]",9,0,0,1,10
1974448,1564234,2025-04-30,Assembly,"Do pass as amended, and be re-referred to the Committee on [Appropriations] with recommendation: To Consent Calendar",9,0,0,0,9
1974448,1577808,2025-05-23,Assembly,"Do pass",14,0,0,1,15
1974448,1583436,2025-06-02,Assembly,"AB 731 Fong Assembly Third Reading",79,0,0,0,79
1974448,1595212,2025-06-25,Senate,"Do pass, but first be re-referred to the Committee on [Appropriations] with the recommendation: To Consent Calendar",7,0,0,0,7
1974448,1597671,2025-07-07,Senate,"Placed on suspense file",6,0,0,1,7
1974449,1542835,2025-04-09,Assembly,"Do pass and be re-referred to the Committee on [Judiciary]",8,0,0,0,8
1974449,1554627,2025-04-22,Assembly,"Do pass and be re-referred to the Committee on [Appropriations] with recommendation: To Consent Calendar",12,0,0,0,12
1974449,1563108,2025-04-30,Assembly,"Do pass. To Consent Calendar",14,0,0,1,15
1974449,1568629,2025-05-08,Assembly,"AB 732 Macedo Consent Calendar Second Day Regular Session",69,0,0,10,79
1974449,1597237,2025-07-01,Senate,"Do pass, but first be re-referred to the Committee on [Judiciary]",5,0,0,0,5
1974449,1598749,2025-07-15,Senate,"Do pass, but first be re-referred to the Committee on [Appropriations]",13,0,0,0,13
1974449,1602209,2025-09-12,Senate,"Assembly 3rd Reading AB732 Macedo By McNerney",37,0,0,3,40
1974449,1602210,2025-09-13,Assembly,"AB 732 MACEDO Concurrence in Senate Amendments",72,0,0,8,80
1974451,1562863,2025-04-29,Assembly,"Do pass and be re-referred to the Committee on [Appropriations]",8,3,0,2,13
1974451,1577227,2025-05-23,Assembly,"Do pass",11,3,0,1,15
1974451,1583365,2025-06-02,Assembly,"AB 734 Schultz Assembly Third Reading",61,15,0,3,79
1974451,1597226,2025-07-01,Senate,"Do pass, but first be re-referred to the Committee on [Natural Resources and Water]",14,2,0,1,17
1974451,1597936,2025-07-08,Senate,"Do pass, but first be re-referred to the Committee on [Appropriations]",5,1,0,1,7
1974451,1599470,2025-08-18,Senate,"Placed on suspense file",7,0,0,0,7
1974451,1600356,2025-08-29,Senate,"Do pass",5,2,0,0,7
1974451,1600980,2025-09-03,Senate,"Assembly 3rd Reading AB734 Schultz et al. By Allen",31,9,0,0,40
1974452,1564223,2025-04-30,Assembly,"Do pass and be re-referred to the Committee on [Appropriations]",8,0,0,2,10
1974452,1571568,2025-05-14,Assembly,"Do pass",11,1,0,3,15
1974452,1585099,2025-06-04,Assembly,"AB 735 Carrillo Assembly Third Reading",61,4,0,14,79
1974452,1598067,2025-07-09,Senate,"Do pass, but first be re-referred to the Committee on [Judiciary]",5,0,0,2,7
1974452,1598657,2025-07-15,Senate,"Do pass, but first be re-referred to the Committee on [Appropriations]",13,0,0,0,13
1974452,1601811,2025-09-10,Senate,"That the measure be returned to Senate Floor for consideration. Ordered to third reading",5,0,0,2,7
1974453,1542813,2025-04-09,Assembly,"Do pass as amended and be re-referred to the Committee on [Appropriations]",10,1,0,1,12
1974453,1577958,2025-05-23,Assembly,"Do pass",11,2,0,2,15
1974453,1584239,2025-06-03,Assembly,"AB 736 Wicks Third Reading Urgency",65,11,0,3,79
1974454,1534984,2025-04-02,Assembly,"Do pass and be re-referred to the Committee on [Appropriations] with recommendation: To Consent Calendar",18,0,0,0,18
1974454,1562952,2025-04-30,Assembly,"Do pass. To Consent Calendar",14,0,0,1,15
1974454,1568626,2025-05-08,Assembly,"AB 737 Quirk-Silva Consent Calendar Second Day Regular Session",69,0,0,10,79
1974454,1597198,2025-07-01,Senate,"Do pass as amended, but first amend, and re-refer to the Committee on [Appropriations]",15,1,0,1,17
1974454,1601593,2025-09-09,Senate,"Assembly 3rd Reading AB737 Quirk-Silva By Caballero",35,1,0,4,40
1974455,1538893,2025-04-07,Assembly,"Do pass as amended and be re-referred to the Committee on [Appropriations]",10,1,0,3,14
1974455,1555913,2025-04-23,Assembly,"Do pass",14,0,0,1,15
1974455,1573545,2025-05-19,Assembly,"AB 738 Tangipa Assembly Third Reading",56,3,0,20,79
1974455,1597715,2025-07-07,Senate,"Do pass, but first be re-referred to the Committee on [Appropriations]",14,1,0,2,17
1974455,1601868,2025-09-11,Senate,"Assembly 3rd Reading AB738 Tangipa et al. By Grove",34,3,0,3,40
1974457,1555951,2025-04-23,Assembly,"Do pass as amended, and be re-referred to the Committee on [Appropriations] with recommendation: To Consent Calendar",18,0,0,0,18
1974457,1577293,2025-05-23,Assembly,"Do pass",14,0,0,1,15
1974457,1583572,2025-06-02,Assembly,"AB 740 Harabedian Assembly Third Reading",79,0,0,0,79
1974457,1598426,2025-07-15,Senate,"Do pass, but first be re-referred to the Committee on [Appropriations]",16,0,0,1,17
1974457,1600061,2025-08-25,Senate,"Placed on suspense file",6,0,0,1,7
1974457,1600437,2025-08-29,Senate,"Do pass as amended",7,0,0,0,7
1974457,1601774,2025-09-10,Senate,"Assembly 3rd Reading AB740 Harabedian et al. By Stern",39,1,0,0,40
1974458,1526912,2025-03-25,Assembly,"Do pass and be re-referred to the Committee on [Appropriations] with recommendation: To Consent Calendar",9,0,0,0,9
1974458,1542697,2025-04-09,Assembly,"Do pass. To Consent Calendar",14,0,0,1,15
1974458,1557528,2025-04-24,Assembly,"AB 741 Ransom Consent Calendar Second Day Regular Session",75,0,0,4,79
1974458,1588067,2025-06-10,Senate,"Do pass as amended, but first amend, and re-refer to the Committee on [Appropriations] with the recommendation: To Consent Calendar",6,0,0,0,6
1974458,1596008,2025-06-27,Senate,"Consent Calendar 2nd AB741 Ransom",38,0,0,2,40
1974458,1601853,2025-09-11,Senate,"Assembly 3rd Reading AB741 Ransom By Ashby",40,0,0,0,40
1974458,1602047,2025-09-13,Assembly,"AB 741 Ransom Concurrence in Senate Amendments",79,0,0,1,80
1974459,1540970,2025-04-08,Assembly,"Do pass and be re-referred to the Committee on [Judiciary]",12,2,0,4,18
1974459,1561014,2025-04-29,Assembly,"Do pass and be re-referred to the Committee on [Appropriations]",8,2,0,2,12
1974459,1577321,2025-05-23,Assembly,"Do pass",11,3,0,1,15
1974459,1584375,2025-06-03,Assembly,"AB 742 Elhawary Assembly Third Reading",57,14,0,8,79
1974459,1597682,2025-07-07,Senate,"Do pass, but first be re-referred to the Committee on [Judiciary]",8,2,0,1,11
1974459,1598648,2025-07-15,Senate,"Do pass, but first be re-referred to the Committee on [Appropriations]",11,1,0,1,13
1974459,1599544,2025-08-18,Senate,"Placed on suspense file",7,0,0,0,7
1974459,1600262,2025-08-29,Senate,"Do pass",5,2,0,0,7
1974459,1601483,2025-09-09,Senate,"Assembly 3rd Reading AB742 Elhawary et al. By Weber Pierson",30,9,0,1,40
1974460,1559482,2025-04-28,Assembly,"Do pass as amended and be re-referred to the Committee on [Appropriations]",9,0,0,0,9
1974460,1577438,2025-05-23,Assembly,"Do pass",14,0,0,1,15
1974460,1583506,2025-06-02,Assembly,"AB 743 Michelle Rodriguez Assembly Third Reading",79,0,0,0,79
1974461,1535030,2025-04-02,Assembly,"Do pass and be re-referred to the Committee on [Appropriations] with recommendation: To Consent Calendar",21,0,0,1,22
1974461,1562820,2025-04-30,Assembly,"Do pass. To Consent Calendar",14,0,0,1,15
1974461,1568613,2025-05-08,Assembly,"AB 744 Michelle Rodriguez Consent Calendar Second Day Regular Session",69,0,0,10,79
1974462,1564209,2025-04-30,Assembly,"Do pass and be re-referred to the Committee on [Appropriations]",11,4,0,3,18
1974462,1577546,2025-05-23,Assembly,"Do pass as amended",10,3,0,2,15
1974462,1584247,2025-06-03,Assembly,"Do pass",18,0,0,0,18
1974462,1585792,2025-06-05,Assembly,"AB 745 Irwin Assembly Third Reading",68,0,0,11,79
1974462,1598380,2025-07-15,Senate,"Do pass, but first be re-referred to the Committee on [Appropriations]",16,0,0,1,17
1974462,1599396,2025-08-18,Senate,"Placed on suspense file",7,0,0,0,7
1974462,1600344,2025-08-29,Senate,"Do pass",7,0,0,0,7
1974463,1557480,2025-04-23,Assembly,"Do pass and be re-referred to the Committee on [Public Safety]",6,0,0,1,7
1974463,1563106,2025-04-29,Assembly,"Do pass and be re-referred to the Committee on [Appropriations]",8,0,0,1,9
1974464,1540910,2025-04-08,Assembly,"Do pass and be re-referred to the Committee on [Appropriations]",9,0,0,3,12
1974464,1577324,2025-05-23,Assembly,"Do pass as amended",11,1,0,3,15
1974464,1585067,2025-06-04,Assembly,"AB 747 Kalra Assembly Third Reading",59,13,0,7,79
1974464,1598584,2025-07-15,Senate,"Do pass, but first be re-referred to the Committee on [Appropriations]",11,1,0,1,13
1974464,1600018,2025-08-25,Senate,"Placed on suspense file",6,0,0,1,7
1974464,1600293,2025-08-29,Senate,"Do pass",5,2,0,0,7
1974464,1601558,2025-09-09,Senate,"Assembly 3rd Reading AB747 Kalra By Umberg",30,10,0,0,40
1974466,1554518,2025-04-22,Assembly,"Do pass and be re-referred to the Committee on [Appropriations]",7,0,0,2,9
1974466,1577503,2025-05-23,Assembly,"Do pass as amended",11,0,0,4,15
1974466,1583576,2025-06-02,Assembly,"AB 749 McKinnor Assembly Third Reading",62,3,0,14,79
1974466,1598021,2025-07-09,Senate,"Do pass as amended, but first amend, and re-refer to the Committee on [Appropriations]",9,2,0,0,11
1974466,1599377,2025-08-18,Senate,"Placed on suspense file",7,0,0,0,7
1974466,1600743,2025-08-29,Senate,"Do pass",5,2,0,0,7
1974466,1601236,2025-09-08,Senate,"Assembly 3rd Reading AB749 McKinnor et al. By Durazo",29,10,0,1,40
1974467,1528269,2025-03-26,Assembly,"Do pass and be re-referred to the Committee on [Judiciary]",10,0,0,1,11
1974467,1540898,2025-04-08,Assembly,"Do pass as amended and be re-referred to the Committee on [Appropriations]",10,0,0,2,12
1974467,1562904,2025-04-30,Assembly,"Do pass",13,0,0,2,15
1974467,1573628,2025-05-19,Assembly,"AB 750 Quirk-Silva Assembly Third Reading",67,1,0,11,79
1974467,1594609,2025-06-24,Senate,"Do pass, but first be re-referred to the Committee on [Judiciary]",9,1,0,1,11
1974468,1536788,2025-04-02,Assembly,"Do pass and be re-referred to the Committee on [Appropriations] with recommendation: To Consent Calendar",7,0,0,0,7
1974468,1563082,2025-04-30,Assembly,"Do pass. To Consent Calendar",14,0,0,1,15
1974468,1568643,2025-05-08,Assembly,"AB 751 Gipson Consent Calendar Second Day Regular Session",69,0,0,10,79
1974468,1589108,2025-06-11,Senate,"Do pass, but first be re-referred to the Committee on [Appropriations] with the recommendation: To Consent Calendar",5,0,0,0,5
1974468,1595957,2025-06-27,Senate,"Consent Calendar 2nd AB751 Gipson",38,0,0,2,40
1974469,1563007,2025-04-29,Assembly,"Do pass",7,0,0,0,7
1974469,1572374,2025-05-15,Assembly,"AB 752 Ávila Farías Assembly Third Reading",72,1,0,6,79
1974469,1591157,2025-06-16,Senate,"Do pass, but first be re-referred to the Committee on [Local Government] with the recommendation: To Consent Calendar",5,0,0,0,5
1974469,1598667,2025-07-16,Senate,"Do pass as amended",7,0,0,0,7
1974469,1601629,2025-09-09,Senate,"Assembly 3rd Reading AB752 Ávila Farías By Arreguín",40,0,0,0,40
1974470,1540885,2025-04-08,Assembly,"Do pass as amended and be re-referred to the Committee on [Education]",6,0,0,0,6
1974470,1564257,2025-04-30,Assembly,"Do pass and be re-referred to the Committee on [Appropriations] with recommendation: To Consent Calendar",9,0,0,0,9
1974470,1571633,2025-05-14,Assembly,"Do pass. To Consent Calendar",15,0,0,0,15
1974470,1577886,2025-05-23,Assembly,"AB 753 Garcia Consent Calendar Second Day Regular Session",71,0,0,8,79
1974470,1592553,2025-06-18,Senate,"Do pass, but first be re-referred to the Committee on [Human Services]",7,0,0,0,7
1974470,1597708,2025-07-07,Senate,"Do pass, but first be re-referred to the Committee on [Appropriations] with the recommendation: To Consent Calendar",5,0,0,0,5
1974470,1599998,2025-08-25,Senate,"Placed on suspense file",6,0,0,1,7
1974470,1600307,2025-08-29,Senate,"Do pass",7,0,0,0,7
1974470,1601573,2025-09-09,Senate,"Assembly 3rd Reading AB753 Garcia By Reyes Urgency Clause",40,0,0,0,40
1974471,1561116,2025-04-29,Assembly,"Do pass. To Consent Calendar",7,0,0,0,7
1974471,1568661,2025-05-08,Assembly,"AB 754 Connolly Consent Calendar Second Day Regular Session",69,0,0,10,79
1974471,1598695,2025-07-15,Senate,"Do pass, but first be re-referred to the Committee on [Appropriations]",13,0,0,0,13
1974471,1600888,2025-09-03,Senate,"Assembly 3rd Reading AB754 Connolly By Umberg",38,0,0,2,40
1974471,1601235,2025-09-08,Assembly,"With recommendation: That Senate amendments be concurred in",7,0,0,5,12
1974471,1601597,2025-09-09,Assembly,"AB 754 Connolly Concurrence in Senate Amendments",66,0,0,14,80
1974475,1558714,2025-04-21,Assembly,"Do pass as amended and be re-referred to the Committee on [Emergency Management]",4,2,0,8,14
1974476,1554457,2025-04-22,Assembly,"Do pass as amended and be re-referred to the Committee on [Appropriations]",18,0,0,0,18
1974476,1577602,2025-05-23,Assembly,"Do pass",14,0,0,1,15
1974476,1583533,2025-06-02,Assembly,"AB 759 Valencia Assembly Third Reading",79,0,0,0,79
1974476,1598214,2025-07-14,Senate,"Do pass as amended, but first amend, and re-refer to the Committee on [Appropriations]",11,0,0,0,11
1974476,1599548,2025-08-18,Senate,"Placed on suspense file",7,0,0,0,7
1974476,1600706,2025-08-29,Senate,"Do pass",7,0,0,0,7
1974476,1601105,2025-09-04,Senate,"Special Consent AB759 Valencia By Ashby",39,0,0,1,40
1974476,1601327,2025-09-08,Assembly,"AB 759 Valencia Concurrence in Senate Amendments",79,0,0,1,80
1974477,1567925,2025-05-07,Assembly,"Do pass as amended",11,0,0,1,12
1974477,1572426,2025-05-15,Assembly,"AB 760 Ta Assembly Third Reading",69,0,0,10,79
1974478,1542795,2025-04-09,Assembly,"Do pass and be re-referred to the Committee on [Revenue and Taxation]",8,2,0,0,10
1974478,1561114,2025-04-28,Assembly,"Do pass as amended",5,2,0,0,7
1974478,1573536,2025-05-19,Assembly,"AB 761 Addis Assembly Third Reading",56,14,0,9,79
1974478,1594599,2025-06-24,Senate,"Do pass, but first be re-referred to the Committee on [Revenue and Taxation]",11,3,0,1,15
1974478,1598097,2025-07-09,Senate,"Do pass",4,1,0,0,5
1974478,1601496,2025-09-09,Senate,"Assembly 3rd Reading AB761 Addis By Laird",30,10,0,0,40
1974479,1542893,2025-04-08,Assembly,"Do pass and be re-referred to the Committee on [Business and Professions]",4,1,0,2,7
1974481,1526966,2025-03-25,Assembly,"Do pass and be re-referred to the Committee on [Appropriations]",13,0,0,0,13
1974481,1542803,2025-04-09,Assembly,"Do pass",14,0,0,1,15
1974481,1557540,2025-04-24,Assembly,"AB 764 Jeff Gonzalez Assembly Third Reading",73,0,0,6,79
1974481,1594640,2025-06-24,Senate,"Do pass as amended, but first amend, and re-refer to the Committee on [Appropriations] with the recommendation: To Consent Calendar",7,0,0,0,7
1974481,1597692,2025-07-07,Senate,"Placed on suspense file",6,0,0,1,7
1974481,1600779,2025-08-29,Senate,"Do pass",7,0,0,0,7
1974481,1601291,2025-09-08,Senate,"Assembly 3rd Reading AB764 Jeff Gonzalez By Cortese",39,0,0,1,40
1974481,1602145,2025-09-13,Assembly,"AB 764 Jeff Gonzalez Concurrence in Senate Amendments",72,0,0,8,80
1974482,1536762,2025-04-02,Assembly,"Do pass and be re-referred to the Committee on [Insurance] with recommendation: To Consent Calendar",7,0,0,0,7
1974483,1562970,2025-04-30,Assembly,"Do pass and be re-referred to the Committee on [Appropriations]",15,5,0,2,22
1974483,1577824,2025-05-23,Assembly,"Do pass as amended",11,3,0,1,15
1974483,1584387,2025-06-03,Assembly,"AB 766 Sharp-Collins Assembly Third Reading",60,17,0,2,79
1974483,1597893,2025-07-08,Senate,"Do pass as amended, but first amend, and re-refer to the Committee on [Appropriations]",11,1,0,3,15
1974483,1599432,2025-08-18,Senate,"Placed on suspense file",7,0,0,0,7
1974483,1600314,2025-08-29,Senate,"Do pass as amended",5,2,0,0,7
1974483,1601719,2025-09-10,Senate,"Assembly 3rd Reading AB766 Sharp-Collins et al. By Weber Pierson",30,9,0,1,40
1974485,1562943,2025-04-30,Assembly,"Do pass and be re-referred to the Committee on [Judiciary]",7,2,0,3,12
1974486,1564163,2025-04-30,Assembly,"Do pass as amended",10,0,0,0,10
1974486,1569906,2025-05-12,Assembly,"AB 769 Wilson Assembly Third Reading",78,0,0,1,79
1974486,1598602,2025-07-16,Senate,"Do pass as amended",7,0,0,0,7
1974486,1601003,2025-09-03,Senate,"Assembly 3rd Reading AB769 Wilson By Arreguín",40,0,0,0,40
1974486,1601328,2025-09-08,Assembly,"AB 769 Wilson Concurrence in Senate Amendments",79,0,0,1,80
1974487,1535069,2025-04-02,Assembly,"Do pass and be re-referred to the Committee on [Appropriations]",20,0,0,2,22
1974487,1577962,2025-05-23,Assembly,"Do pass",14,0,0,1,15
1974487,1583512,2025-06-02,Assembly,"AB 770 Mark González Assembly Third Reading",73,0,0,6,79
1974487,1594653,2025-06-24,Senate,"Do pass, but first be re-referred to the Committee on [Rules]",11,2,0,2,15
1974487,1597824,2025-07-08,Senate,"Do pass, but first be re-referred to the Committee on [Appropriations]",11,1,0,1,13
1974487,1599360,2025-08-18,Senate,"Placed on suspense file",7,0,0,0,7
1974487,1600340,2025-08-29,Senate,"Do pass",5,2,0,0,7
1974487,1601533,2025-09-09,Senate,"Assembly 3rd Reading AB770 Mark González et al. By Durazo Urgency Clause",34,4,0,2,40
1974487,1601968,2025-09-11,Assembly,"With recommendation: That Senate amendments be concurred in",19,0,0,3,22
1974487,1602147,2025-09-12,Assembly,"AB 770 Mark González Concurrence - Urgency Added",73,0,0,7,80
1974488,1565300,2025-05-05,Assembly,"Do pass",9,0,0,0,9
1974488,1569901,2025-05-12,Assembly,"AB 771 Macedo Assembly Third Reading",75,0,0,4,79
1974488,1591857,2025-06-17,Senate,"Do pass and be ordered to the Consent Calendar",12,0,0,1,13
1974488,1594058,2025-06-23,Senate,"Consent Calendar 2nd AB771 Macedo",37,0,0,3,40
1974489,1544953,2025-04-09,Assembly,"Do pass as amended and be re-referred to the Committee on [Appropriations]",9,0,0,0,9
1974489,1577892,2025-05-23,Assembly,"Do pass",14,0,0,1,15
1974489,1583498,2025-06-02,Assembly,"AB 772 Lowenthal Assembly Third Reading",79,0,0,0,79
1974489,1595139,2025-06-25,Senate,"Do pass as amended, but first amend, and re-refer to the Committee on [Appropriations]",6,1,0,0,7
1974489,1598234,2025-07-14,Senate,"Placed on suspense file",7,0,0,0,7
1974489,1600578,2025-08-29,Senate,"Do pass as amended",5,1,0,1,7
1974489,1601251,2025-09-08,Senate,"Assembly 3rd Reading AB772 Lowenthal et al. By Ashby",30,7,0,3,40
1974489,1601540,2025-09-09,Assembly,"AB 772 Lowenthal Concurrence in Senate Amendments By ORTEGA",79,1,0,0,80
1974490,1561020,2025-04-29,Assembly,"Do pass and be re-referred to the Committee on [Appropriations]",7,0,0,0,7
1974491,1566697,2025-05-06,Assembly,"Do pass. To Consent Calendar",12,0,0,0,12
1974491,1569890,2025-05-12,Assembly,"AB 774 Bauer-Kahan Consent Calendar Second Day Regular Session",77,0,0,2,79
1974491,1597846,2025-07-08,Senate,"Do pass, but first be re-referred to the Committee on [Appropriations] with the recommendation: To Consent Calendar",13,0,0,0,13
1974491,1599602,2025-08-18,Senate,"Placed on suspense file",7,0,0,0,7
1974491,1600630,2025-08-29,Senate,"Do pass",7,0,0,0,7
1974491,1601126,2025-09-04,Senate,"Special Consent AB774 Bauer-Kahan",39,0,0,1,40
1974491,1601329,2025-09-08,Assembly,"AB 774 Bauer-Kahan Concurrence in Senate Amendments",79,0,0,1,80
1974492,1528255,2025-03-26,Assembly,"Do pass as amended and be re-referred to the Committee on [Appropriations]",7,0,0,0,7
1974492,1577241,2025-05-23,Assembly,"Do pass",14,0,0,1,15
1974492,1584376,2025-06-03,Assembly,"AB 775 Fong Assembly Third Reading",79,0,0,0,79
1974492,1597123,2025-07-01,Senate,"Do pass, but first be re-referred to the Committee on [Appropriations]",5,0,0,0,5
1974492,1598246,2025-07-14,Senate,"Placed on suspense file",7,0,0,0,7
1974494,1556204,2025-04-23,Assembly,"Do pass and be re-referred to the Committee on [Human Services] with recommendation: To Consent Calendar",18,0,0,0,18
1974494,1562966,2025-04-29,Assembly,"Do pass as amended, and be re-referred to the Committee on [Appropriations] with recommendation: To Consent Calendar",7,0,0,0,7
1974494,1571542,2025-05-14,Assembly,"Do pass. To Consent Calendar",15,0,0,0,15
1974494,1577256,2025-05-23,Assembly,"AB 777 Celeste Rodriguez Consent Calendar Second Day Regular Session",71,0,0,8,79
1974494,1597149,2025-07-01,Senate,"Do pass, but first be re-referred to the Committee on [Human Services]",16,0,0,1,17
1974494,1597701,2025-07-07,Senate,"Do pass, but first be re-referred to the Committee on [Appropriations]",5,0,0,0,5
1974494,1599987,2025-08-25,Senate,"Placed on suspense file",6,0,0,1,7
1974494,1600600,2025-08-29,Senate,"Do pass",7,0,0,0,7
1974494,1601745,2025-09-10,Senate,"Assembly 3rd Reading AB777 Celeste Rodriguez By Stern",40,0,0,0,40
1974496,1564278,2025-05-01,Assembly,"Do pass as amended",6,0,0,1,7
1974496,1571596,2025-05-14,Assembly,"Do pass",15,0,0,0,15
1974496,1577888,2025-05-23,Assembly,"AB 779 Lackey Assembly Third Reading",73,0,0,6,79
1974496,1597220,2025-06-30,Senate,"Do pass, but first be re-referred to the Committee on [Appropriations]",5,0,0,0,5
1974496,1601079,2025-09-04,Senate,"Assembly 3rd Reading AB779 Lackey et al. By Valladares",39,0,0,1,40
1974496,1602339,2025-09-12,Assembly,"AB 779 Lackey Concurrence in Senate Amendments",79,0,0,1,80
1974499,1564226,2025-04-30,Assembly,"Do pass as amended",10,0,0,0,10
1974499,1577136,2025-05-23,Assembly,"Do pass",14,0,0,1,15
1974499,1583366,2025-06-02,Assembly,"AB 782 Quirk-Silva Assembly Third Reading",79,0,0,0,79
1974499,1597517,2025-07-02,Senate,"Do pass as amended, but first amend, and re-refer to the Committee on [Business, Professions and Economic Development]",7,0,0,0,7
1974499,1598258,2025-07-14,Senate,"Do pass as amended, but first amend, and re-refer to the Committee on [Appropriations]",10,1,0,0,11
1974499,1599447,2025-08-18,Senate,"Do pass",7,0,0,0,7
1974500,1535151,2025-04-02,Assembly,"Do pass as amended and be re-referred to the Committee on [Emergency Management]",16,3,0,3,22
1974500,1561123,2025-04-28,Assembly,"Do pass as amended and be re-referred to the Committee on [Appropriations]",5,1,0,1,7
1974500,1562960,2025-04-28,Assembly,"Amendments (Committee's)",5,1,0,1,7
1974501,1564215,2025-04-30,Assembly,"Do pass and be re-referred to the Committee on [Appropriations] with recommendation: To Consent Calendar",9,0,0,0,9
1974501,1571648,2025-05-14,Assembly,"Do pass. To Consent Calendar",15,0,0,0,15
1974501,1577217,2025-05-23,Assembly,"AB 784 Hoover Consent Calendar Second Day Regular Session",71,0,0,8,79
1974501,1592552,2025-06-18,Senate,"Do pass, but first be re-referred to the Committee on [Appropriations] with the recommendation: To Consent Calendar",7,0,0,0,7
1974501,1597572,2025-07-03,Senate,"Consent Calendar 2nd AB784 Hoover",35,0,0,5,40
1974502,1526899,2025-03-25,Assembly,"Do pass and be re-referred to the Committee on [Health]",8,0,0,1,9
1974502,1556168,2025-04-22,Assembly,"Do pass and be re-referred to the Committee on [Appropriations]",13,0,0,3,16
1974502,1577868,2025-05-23,Assembly,"Do pass",11,2,0,2,15
1974502,1583387,2025-06-02,Assembly,"AB 785 Sharp-Collins Assembly Third Reading",64,4,0,11,79
1974502,1594616,2025-06-24,Senate,"Do pass, but first be re-referred to the Committee on [Health]",5,1,0,0,6
1974502,1598052,2025-07-09,Senate,"Do pass, but first be re-referred to the Committee on [Appropriations]",9,1,0,1,11
1974502,1599463,2025-08-18,Senate,"Placed on suspense file",7,0,0,0,7
1974503,1552829,2025-04-21,Assembly,"Do pass. To Consent Calendar",9,0,0,0,9
1974503,1567890,2025-05-07,Assembly,"Do pass. To Consent Calendar",15,0,0,0,15
1974503,1572430,2025-05-15,Assembly,"AB 786 Solache Consent Calendar Second Day Regular Session",69,0,0,10,79
1974503,1586924,2025-06-09,Senate,"Do pass, but first be re-referred to the Committee on [Appropriations] with the recommendation: To Consent Calendar",8,0,0,3,11
1974503,1596022,2025-06-27,Senate,"Consent Calendar 2nd AB786 Solache",38,0,0,2,40
1974503,1601474,2025-09-09,Senate,"Assembly 3rd Reading AB786 Solache By Gonzalez",40,0,0,0,40
1974504,1533470,2025-04-01,Assembly,"Do pass as amended and be re-referred to the Committee on [Appropriations]",15,0,0,0,15
1974504,1555927,2025-04-23,Assembly,"Do pass",15,0,0,0,15
1974504,1565329,2025-05-05,Assembly,"AB 787 Papan Assembly Third Reading",77,0,0,2,79
1974504,1592594,2025-06-18,Senate,"Do pass as amended, but first amend, and re-refer to the Committee on [Appropriations]",8,0,0,3,11
1974504,1597703,2025-07-07,Senate,"Placed on suspense file",6,0,0,1,7
1974505,1535139,2025-04-01,Assembly,"Do pass as amended, and be re-referred to the Committee on [Appropriations] with recommendation: To Consent Calendar",9,0,0,0,9
1974505,1577823,2025-05-23,Assembly,"Do pass as amended",11,0,0,4,15
1974505,1584394,2025-06-03,Assembly,"AB 788 Quirk-Silva Assembly Third Reading",77,1,0,1,79
1974505,1597945,2025-07-08,Senate,"Do pass, but first be re-referred to the Committee on [Appropriations]",6,0,0,0,6
1974505,1599494,2025-08-18,Senate,"Placed on suspense file",7,0,0,0,7
1974506,1533517,2025-04-01,Assembly,"Do pass",13,0,0,2,15
1974506,1552963,2025-04-21,Assembly,"AB 789 Bonta Assembly Third Reading",59,4,0,16,79
1974506,1598454,2025-07-15,Senate,"Do pass",4,0,0,1,5
1974506,1602230,2025-09-12,Senate,"Assembly 3rd Reading AB789 Bonta et al. By Cabaldon",31,4,0,5,40
1974506,1602231,2025-09-13,Assembly,"AB 789 Bonta Concurrence in Senate Amendments",65,6,0,9,80
1974507,1563096,2025-04-30,Assembly,"Do pass and be re-referred to the Committee on [Human Services] with recommendation: To Consent Calendar",10,0,0,2,12
1974507,1564290,2025-05-01,Assembly,"Do pass as amended",7,0,0,0,7
1974507,1577411,2025-05-23,Assembly,"Do pass",14,0,0,1,15
1974507,1583455,2025-06-02,Assembly,"AB 790 Ávila Farías Assembly Third Reading",79,0,0,0,79
1974507,1597249,2025-06-30,Senate,"Do pass, but first be re-referred to the Committee on [Housing] with the recommendation: To Consent Calendar",5,0,0,0,5
1974507,1598501,2025-07-15,Senate,"Do pass, but first be re-referred to the Committee on [Appropriations] with the recommendation: To Consent Calendar",10,0,0,1,11
1974507,1599590,2025-08-18,Senate,"Placed on suspense file",7,0,0,0,7
1974507,1600607,2025-08-29,Senate,"Do pass",7,0,0,0,7
1974507,1601139,2025-09-04,Senate,"Special Consent AB790 Ávila Farías et al",39,0,0,1,40
1974508,1556015,2025-04-22,Assembly,"Do pass as amended and be re-referred to the Committee on [Appropriations]",10,0,0,0,10
1974509,1535096,2025-04-02,Assembly,"Do pass and be re-referred to the Committee on [Appropriations]",5,0,0,2,7
1974509,1556059,2025-04-23,Assembly,"Do pass",11,1,0,3,15
1974509,1559401,2025-04-28,Assembly,"AB 792 Lee Assembly Third Reading",61,5,0,13,79
1974509,1595129,2025-06-24,Senate,"Do pass, but first be re-referred to the Committee on [Labor, Public Employment and Retirement ]",11,0,0,2,13
1974509,1598025,2025-07-09,Senate,"Do pass, but first be re-referred to the Committee on [Appropriations]",4,1,0,0,5
1974509,1600987,2025-09-03,Senate,"Assembly 3rd Reading AB792 Lee By Durazo",30,6,0,4,40
1974509,1601155,2025-09-04,Assembly,"AB 792 Lee Concurrence in Senate Amendments",64,1,0,14,79
1974510,1540956,2025-04-08,Assembly,"Do pass as amended",12,0,0,0,12
1974510,1557534,2025-04-24,Assembly,"AB 793 Schultz Assembly Third Reading",68,0,0,11,79
1974510,1598620,2025-07-15,Senate,"Do pass as amended, but first amend, and re-refer to the Committee on [Appropriations]",9,0,0,4,13
1974510,1599466,2025-08-18,Senate,"Placed on suspense file",7,0,0,0,7
1974511,1542687,2025-04-08,Assembly,"Do pass as amended and be re-referred to the Committee on [Appropriations]",5,2,0,0,7
1974511,1577398,2025-05-23,Assembly,"Do pass",11,3,0,1,15
1974512,1556056,2025-04-23,Assembly,"Do pass and be re-referred to the Committee on [Appropriations]",22,0,0,0,22
1974513,1556101,2025-04-22,Assembly,"Do pass and be re-referred to the Committee on [Revenue and Taxation]",8,4,0,3,15
1974514,1554630,2025-04-22,Assembly,"Do pass and be re-referred to the Committee on [Appropriations]",7,0,0,1,8
1974514,1577317,2025-05-23,Assembly,"Do pass",11,1,0,3,15
1974514,1583434,2025-06-02,Assembly,"AB 797 Harabedian Third Reading Urgency",69,3,0,7,79
1974514,1596763,2025-06-30,Senate,"Do pass, but first be re-referred to the Committee on [Judiciary]",8,3,0,0,11
1974514,1598716,2025-07-15,Senate,"Do pass as amended, but first amend, and re-refer to the Committee on [Appropriations]",10,2,0,1,13
1974514,1599376,2025-08-18,Senate,"Placed on suspense file",7,0,0,0,7
1974514,1600462,2025-08-29,Senate,"Do pass as amended",5,2,0,0,7
1974514,1601275,2025-09-08,Senate,"Assembly 3rd Reading AB797 Harabedian By Ashby Urgency Clause",29,9,0,2,40
1974514,1601630,2025-09-09,Assembly,"AB 797 Harabedian Concurrence in Senate Amendments",69,5,0,6,80
1974515,1563063,2025-04-29,Assembly,"Do pass and be re-referred to the Committee on [Appropriations] with recommendation: To Consent Calendar",7,0,0,0,7
1974515,1577676,2025-05-23,Assembly,"Do pass",14,0,0,1,15
1974515,1584310,2025-06-03,Assembly,"AB 798 Calderon Assembly Third Reading",78,0,0,1,79
1974515,1597232,2025-06-30,Senate,"Do pass, but first be re-referred to the Committee on [Appropriations] with the recommendation: To Consent Calendar",5,0,0,0,5
1974515,1598261,2025-07-14,Senate,"Placed on suspense file",7,0,0,0,7
1974515,1600447,2025-08-29,Senate,"Do pass as amended",7,0,0,0,7
1974515,1601737,2025-09-10,Senate,"Assembly 3rd Reading AB798 Calderon et al. By Limón",40,0,0,0,40
1974516,1526901,2025-03-25,Assembly,"Do pass and be re-referred to the Committee on [Appropriations] with recommendation: To Consent Calendar",9,0,0,0,9
1974516,1556116,2025-04-23,Assembly,"Do pass. To Consent Calendar",15,0,0,0,15
1974516,1564186,2025-05-01,Assembly,"AB 799 Celeste Rodriguez Consent Calendar Second Day Regular Session",76,0,0,3,79
1974516,1588073,2025-06-10,Senate,"Do pass, but first be re-referred to the Committee on [Appropriations] with the recommendation: To Consent Calendar",6,0,0,0,6
1974516,1594038,2025-06-23,Senate,"Placed on suspense file",7,0,0,0,7
1974516,1600472,2025-08-29,Senate,"Do pass as amended",7,0,0,0,7
1974516,1601971,2025-09-11,Senate,"Special Consent AB799 Celeste Rodriguez By Smallwood-Cuevas",40,0,0,0,40
1974516,1602208,2025-09-12,Assembly,"AB 799 Celeste Rodriguez Concurrence in Senate Amendments",80,0,0,0,80
1974517,1527010,2025-03-25,Assembly,"Do pass and be re-referred to the Committee on [Appropriations]",6,1,0,2,9
1974518,1559415,2025-04-28,Assembly,"Do pass as amended and be re-referred to the Committee on [Appropriations]",5,1,0,3,9
1974518,1577534,2025-05-23,Assembly,"Do pass as amended",11,2,0,2,15
1974518,1584413,2025-06-03,Assembly,"AB 801 Bonta Assembly Third Reading",45,15,0,19,79
1974519,1534988,2025-04-01,Assembly,"Do pass and be re-referred to the Committee on [Appropriations] with recommendation: To Consent Calendar",9,0,0,0,9
1974520,1559427,2025-04-28,Assembly,"Do pass as amended, and be re-referred to the Committee on [Appropriations] with recommendation: To Consent Calendar",14,0,0,0,14
1974520,1577733,2025-05-23,Assembly,"Do pass",14,0,0,1,15
1974520,1583405,2025-06-02,Assembly,"AB 803 Garcia Assembly Third Reading",79,0,0,0,79
1974520,1594658,2025-06-24,Senate,"Do pass, but first be re-referred to the Committee on [Appropriations] with the recommendation: To Consent Calendar",7,0,0,0,7
1974520,1597690,2025-07-07,Senate,"Placed on suspense file",6,0,0,1,7
1974521,1540836,2025-04-08,Assembly,"Do pass and be re-referred to the Committee on [Appropriations]",13,1,0,1,15
1974523,1562978,2025-04-30,Assembly,"Do pass and be re-referred to the Committee on [Judiciary]",9,0,0,3,12
1974523,1566701,2025-05-06,Assembly,"Do pass",9,0,0,3,12
1974523,1572398,2025-05-15,Assembly,"AB 806 Connolly Assembly Third Reading",61,0,0,18,79
1974523,1597879,2025-07-08,Senate,"Do pass, but first be re-referred to the Committee on [Appropriations]",10,1,0,2,13
1974523,1599655,2025-08-18,Senate,"Placed on suspense file",7,0,0,0,7
1974523,1600335,2025-08-29,Senate,"Do pass as amended",5,0,0,2,7
1974523,1600905,2025-09-03,Senate,"Assembly 3rd Reading AB806 Connolly et al. By Allen",40,0,0,0,40
1974523,1601330,2025-09-08,Assembly,"AB 806 Connolly Concurrence in Senate Amendments",75,0,0,5,80
1974525,1525462,2025-03-24,Assembly,"Be adopted. To third reading",11,0,0,0,11
1974525,1545012,2025-04-10,Assembly,"ACR 34 Ta Assembly Third Reading",61,2,0,16,79
1974525,1572404,2025-05-15,Senate,"Special Consent ACR34 Ta et al. By Umberg",34,0,0,6,40
1974526,1511496,2025-03-10,Assembly,"Be adopted. To third reading",9,0,0,2,11
1974526,1557573,2025-04-24,Senate,"Special Consent ACR35 Papan et al",37,0,0,3,40
1974528,1544942,2025-04-09,Senate,"Do pass, but first be re-referred to the Committee on [Judiciary]",9,0,0,2,11
1974528,1555938,2025-04-22,Senate,"Do pass as amended, but first amend, and re-refer to the Committee on [Appropriations]",11,1,0,1,13
1974528,1580490,2025-05-28,Senate,"Senate 3rd Reading SB418 Menjivar",28,10,0,2,40
1974528,1597147,2025-07-01,Assembly,"Do pass and be re-referred to the Committee on [Business and Professions]",12,2,0,2,16
1974528,1597939,2025-07-08,Assembly,"Do pass as amended and be re-referred to the Committee on [Appropriations]",12,5,0,1,18
1974528,1600411,2025-08-29,Assembly,"Do pass",11,4,0,0,15
1974528,1601973,2025-09-11,Senate,"Unfinished Business SB418 Menjivar et al. Urgency Clause Concurrence",29,10,0,1,40
1974529,1571541,2025-05-14,Senate,"Do pass, but first be re-referred to the Committee on [Appropriations]",5,0,0,0,5
1974529,1573507,2025-05-19,Senate,"Placed on suspense file",5,0,0,2,7
1974529,1577761,2025-05-23,Senate,"Do pass",5,0,0,2,7
1974529,1586416,2025-06-02,Senate,"Senate 3rd Reading SB419 Caballero et al",36,0,0,4,40
1974529,1598486,2025-07-14,Assembly,"Do pass and be re-referred to the Committee on [Appropriations]",7,0,0,0,7
1974529,1600570,2025-08-29,Assembly,"Do pass as amended",11,0,0,4,15
1974529,1601370,2025-09-08,Assembly,"SB 419 Caballero Senate Third Reading By Gipson",70,0,0,10,80
1974529,1601471,2025-09-09,Senate,"Unfinished Business SB419 Caballero et al. Concurrence",37,3,0,0,40
1974530,1542781,2025-04-08,Senate,"Do pass, but first be re-referred to the Committee on [Governmental Organization]",11,1,0,1,13
1974530,1554430,2025-04-22,Senate,"Do pass, but first be re-referred to the Committee on [Appropriations]",10,4,0,1,15
1974530,1565269,2025-05-05,Senate,"Placed on suspense file",7,0,0,0,7
1974530,1577212,2025-05-23,Senate,"Do pass as amended",4,1,0,2,7
1974530,1586410,2025-06-02,Senate,"Senate 3rd Reading SB420 Padilla",26,9,0,5,40
1974531,1533558,2025-04-01,Senate,"Do pass, but first be re-referred to the Committee on [Appropriations]",2,3,0,1,6
1974531,1533559,2025-04-01,Senate,"[First] hearing set for [04-01-2025]: Failed passage in Committee. Reconsideration granted",6,0,0,0,6
1974532,1528283,2025-03-26,Senate,"Do pass, but first be re-referred to the Committee on [Human Services] with the recommendation: To Consent Calendar",5,0,0,0,5
1974532,1552819,2025-04-21,Senate,"Do pass, but first be re-referred to the Committee on [Appropriations] with the recommendation: To Consent Calendar",5,0,0,0,5
1974532,1565259,2025-05-05,Senate,"Placed on suspense file",7,0,0,0,7
1974533,1554452,2025-04-22,Senate,"Do pass, but first be re-referred to the Committee on [Natural Resources and Water]",5,1,0,0,6
1974533,1562889,2025-04-30,Senate,"Do pass as amended, but first amend, and re-refer to the Committee on [Appropriations]",7,0,0,0,7
1974533,1569905,2025-05-12,Senate,"Placed on suspense file",7,0,0,0,7
1974533,1577595,2025-05-23,Senate,"Do pass as amended",6,0,0,1,7
1974533,1585074,2025-06-04,Senate,"Senate 3rd Reading SB423 Smallwood-Cuevas",39,0,0,1,40
1974533,1597172,2025-07-01,Assembly,"Do pass and be re-referred to the Committee on [Natural Resources] with recommendation: To Consent Calendar",9,0,0,0,9
1974533,1598281,2025-07-14,Assembly,"Do pass and be re-referred to the Committee on [Appropriations] with recommendation: To Consent Calendar",13,0,0,1,14
1974533,1600694,2025-08-29,Assembly,"Do pass as amended",11,0,0,4,15
1974537,1540945,2025-04-08,Senate,"Do pass, but first be re-referred to the Committee on [Appropriations]",6,0,0,1,7
1974537,1552960,2025-04-21,Senate,"Placed on suspense file",6,0,0,1,7
1974537,1577459,2025-05-23,Senate,"Do pass as amended",6,0,0,1,7
1974537,1586394,2025-06-02,Senate,"Senate 3rd Reading SB427 Blakespear et al",38,0,0,2,40
1974537,1598421,2025-07-15,Assembly,"Do pass and be re-referred to the Committee on [Appropriations]",11,0,0,2,13
1974537,1600421,2025-08-29,Assembly,"Do pass",14,1,0,0,15
1974537,1601603,2025-09-09,Assembly,"SB 427 Blakespear Senate Third Reading By Connolly",78,0,0,2,80
1974538,1526902,2025-03-25,Senate,"Do pass, but first be re-referred to the Committee on [Appropriations] with the recommendation: To Consent Calendar",13,0,0,2,15
1974538,1538962,2025-04-07,Senate,"Placed on suspense file",7,0,0,0,7
1974538,1577198,2025-05-23,Senate,"Do pass",6,0,0,1,7
1974538,1581717,2025-05-29,Senate,"Special Consent SB428 Laird et al",38,0,0,2,40
1974538,1595214,2025-06-25,Assembly,"Do pass and be re-referred to the Committee on [Appropriations] with recommendation: To Consent Calendar",22,0,0,0,22
1974538,1598027,2025-07-09,Assembly,"Do pass. To Consent Calendar",15,0,0,0,15
1974538,1598877,2025-07-17,Assembly,"SB 428 Laird Consent Calendar Second Day Regular Session",75,0,0,4,79
1974539,1555995,2025-04-23,Senate,"Do pass, but first be re-referred to the Committee on [Appropriations] with the recommendation: To Consent Calendar",7,0,0,0,7
1974539,1565294,2025-05-05,Senate,"Placed on suspense file",7,0,0,0,7
1974539,1577329,2025-05-23,Senate,"Do pass",6,0,0,1,7
1974539,1584289,2025-06-03,Senate,"Senate 3rd Reading SB429 Cortese",39,0,0,1,40
1974539,1598121,2025-07-09,Assembly,"Do pass and be re-referred to the Committee on [Emergency Management]",15,0,0,2,17
1974539,1598489,2025-07-14,Assembly,"Do pass as amended and be re-referred to the Committee on [Appropriations]",7,0,0,0,7
1974539,1600652,2025-08-29,Assembly,"Do pass as amended",11,0,0,4,15
1974539,1602079,2025-09-12,Senate,"Unfinished Business SB429 Cortese et al. Concurrence",34,0,0,6,40
1974539,1602080,2025-09-13,Assembly,"SB 429 Cortese Senate Third Reading By Alvarez",79,0,0,1,80
1974541,1533545,2025-04-01,Senate,"Do pass, but first be re-referred to the Committee on [Appropriations]",6,0,0,0,6
1974541,1552876,2025-04-21,Senate,"Placed on suspense file",6,0,0,1,7
1974541,1577559,2025-05-23,Senate,"Do pass as amended",6,0,0,1,7
1974541,1586382,2025-06-02,Senate,"Senate 3rd Reading SB431 Arreguín",38,0,0,2,40
1974541,1597277,2025-07-01,Assembly,"Do pass as amended and be re-referred to the Committee on [Appropriations]",9,0,0,0,9
1974542,1533568,2025-04-01,Senate,"Do pass as amended, but first amend, and re-refer to the Committee on [Appropriations]",6,0,0,0,6
1974542,1569801,2025-05-12,Senate,"Placed on suspense file",7,0,0,0,7
1974543,1540824,2025-04-07,Senate,"Do pass, but first be re-referred to the Committee on [Appropriations]",5,0,0,0,5
1974543,1552867,2025-04-21,Senate,"Placed on suspense file",6,0,0,1,7
1974543,1577497,2025-05-23,Senate,"Do pass",5,1,0,1,7
1974543,1585047,2025-06-04,Senate,"Senate 3rd Reading SB433 Wahab et al",32,5,0,3,40
1974543,1594629,2025-06-24,Assembly,"Do pass and be re-referred to the Committee on [Human Services]",5,1,0,1,7
1974543,1598465,2025-07-15,Assembly,"Do pass as amended and be re-referred to the Committee on [Appropriations]",5,0,0,2,7
1974544,1540854,2025-04-07,Senate,"Do pass, but first be re-referred to the Committee on [Judiciary]",4,1,0,0,5
1974544,1556144,2025-04-22,Senate,"Do pass, but first be re-referred to the Committee on [Appropriations]",11,2,0,0,13
1974544,1565296,2025-05-05,Senate,"Placed on suspense file",7,0,0,0,7
1974545,1552898,2025-04-21,Senate,"Do pass as amended, but first amend, and re-refer to the Committee on [Appropriations]",5,0,0,0,5
1974545,1565226,2025-05-05,Senate,"Placed on suspense file",7,0,0,0,7
1974545,1577923,2025-05-23,Senate,"Do pass",6,0,0,1,7
1974545,1585035,2025-06-04,Senate,"Senate 3rd Reading SB435 Wahab et al",39,0,0,1,40
1974545,1598724,2025-07-16,Assembly,"Do pass as amended and be re-referred to the Committee on [Appropriations]",7,5,0,3,15
1974546,1562784,2025-04-29,Senate,"Do pass as amended, but first amend, and re-refer to the Committee on [Appropriations]",10,2,0,1,13
1974546,1586442,2025-06-02,Senate,"Senate 3rd Reading SB436 Wahab et al",26,10,0,4,40
1974546,1594633,2025-06-24,Assembly,"Do pass",6,4,0,2,12
1974546,1594634,2025-06-24,Assembly,Reconsideration,9,0,0,3,12
1974547,1528279,2025-03-26,Senate,"Do pass, but first be re-referred to the Committee on [Judiciary]",5,2,0,0,7
1974547,1556153,2025-04-22,Senate,"Do pass, but first be re-referred to the Committee on [Appropriations]",11,2,0,0,13
1974547,1565318,2025-05-05,Senate,"Placed on suspense file",7,0,0,0,7
1974547,1577891,2025-05-23,Senate,"Do pass as amended",5,1,0,1,7
1974547,1586386,2025-06-02,Senate,"Senate 3rd Reading SB437 Weber Pierson et al",28,10,0,2,40
1974547,1594668,2025-06-24,Assembly,"Do pass as amended and be re-referred to the Committee on [Judiciary]",7,3,0,0,10
1974547,1597122,2025-07-01,Assembly,"Do pass and be re-referred to the Committee on [Appropriations]",9,3,0,0,12
1974547,1600510,2025-08-29,Assembly,"Do pass",11,4,0,0,15
1974547,1601371,2025-09-08,Assembly,"SB 437 Weber Pierson Senate Third Reading By JACKSON",61,17,0,2,80
1974547,1601494,2025-09-09,Senate,"Unfinished Business SB437 Weber Pierson et al. Concurrence",30,10,0,0,40
1974548,1528260,2025-03-26,Senate,"Do pass, but first be re-referred to the Committee on [Appropriations]",7,0,0,0,7
1974548,1538960,2025-04-07,Senate,"Placed on suspense file",7,0,0,0,7
1974549,1545070,2025-04-09,Senate,"Do pass as amended, but first amend, and re-refer to the Committee on [Appropriations] with the recommendation: To Consent Calendar",11,0,0,0,11
1974549,1559462,2025-04-28,Senate,"Placed on suspense file",7,0,0,0,7
1974549,1577504,2025-05-23,Senate,"Do pass",6,0,0,1,7
1974549,1586405,2025-06-02,Senate,"Senate 3rd Reading SB439 Weber Pierson",38,0,0,2,40
1974549,1591862,2025-06-17,Assembly,"Do pass and be re-referred to the Committee on [Appropriations]",15,0,0,1,16
1974549,1600370,2025-08-29,Assembly,"Do pass",13,0,0,2,15
1974549,1600891,2025-09-03,Assembly,"SB 439 Weber Pierson Senate Third Reading By Flora",75,1,0,3,79
1974550,1567878,2025-05-06,Senate,"Do pass and be ordered to the Consent Calendar",12,0,0,1,13
1974550,1572405,2025-05-15,Senate,"Consent Calendar 2nd SB440 Ochoa Bogh et al",34,0,0,6,40
1974550,1598410,2025-07-15,Assembly,"Do pass. To Consent Calendar",12,0,0,0,12
1974550,1599852,2025-08-21,Assembly,"SB 440 Ochoa Bogh Consent Calendar Second Day Regular Session",77,0,0,2,79
1974550,1600467,2025-08-29,Senate,"Special Consent SB440 Ochoa Bogh et al",37,0,0,3,40
1974551,1556176,2025-04-23,Senate,"Do pass as amended, but first amend, and re-refer to the Committee on [Appropriations]",3,0,0,5,8
1974551,1556177,2025-04-23,Senate,"[First] hearing set for [04-23-2025]: Failed passage in Committee. Reconsideration granted",8,0,0,0,8
1974552,1528311,2025-03-26,Senate,"Do pass as amended, but first amend, and re-refer to the Committee on [Judiciary]",4,1,0,0,5
1974552,1565365,2025-05-05,Senate,"Placed on suspense file",7,0,0,0,7
1974552,1577325,2025-05-23,Senate,"Do pass",5,1,0,1,7
1974552,1586411,2025-06-02,Senate,"Senate 3rd Reading SB442 Smallwood-Cuevas",26,10,0,4,40
1974552,1595656,2025-06-25,Assembly,"Do pass and be re-referred to the Committee on [Appropriations]",5,0,0,2,7
1974553,1528259,2025-03-26,Senate,"Do pass as amended, but first amend, and re-refer to the Committee on [Appropriations]",5,0,0,0,5
1974553,1584340,2025-06-03,Senate,"Senate 3rd Reading SB443 Rubio",39,0,0,1,40
1974553,1595203,2025-06-25,Assembly,"Do pass and be re-referred to the Committee on [Appropriations]",7,0,0,0,7
1974553,1597395,2025-07-02,Assembly,"Do pass",14,0,0,1,15
1974553,1600835,2025-09-02,Assembly,"SB 443 Rubio Senate Third Reading By Harabedian",76,1,0,2,79
1974553,1601189,2025-09-04,Senate,"Unfinished Business SB443 Rubio Concurrence",39,0,0,1,40
1974554,1540881,2025-04-07,Senate,"Do pass, but first be re-referred to the Committee on [Appropriations]",5,0,0,0,5
1974554,1552938,2025-04-21,Senate,"Placed on suspense file",6,0,0,1,7
1974554,1577699,2025-05-23,Senate,"Do pass",6,0,0,1,7
1974554,1581701,2025-05-29,Senate,"Special Consent SB444 Hurtado",38,0,0,2,40
1974554,1597259,2025-07-01,Assembly,"Do pass as amended, and be re-referred to the Committee on [Appropriations] with recommendation: To Consent Calendar",7,0,0,0,7
1974555,1554523,2025-04-22,Senate,"Do pass, but first be re-referred to the Committee on [Local Government]",13,0,0,2,15
1974555,1580536,2025-05-28,Senate,"Senate 3rd Reading SB445 Wiener et al",34,1,0,5,40
1974555,1598473,2025-07-14,Assembly,"Do pass and be re-referred to the Committee on [Local Government]",10,3,0,3,16
1974555,1598574,2025-07-16,Assembly,"Do pass as amended and be re-referred to the Committee on [Appropriations]",10,4,0,4,18
1974555,1598905,2025-07-16,Assembly,"Do pass and be re-referred to the Committee on [Utilities and Energy]",8,2,0,0,10
1974556,1534989,2025-04-01,Senate,"Do pass as amended, but first amend, and re-refer to the Committee on [Appropriations]",12,0,0,1,13
1974556,1580545,2025-05-28,Senate,"Senate 3rd Reading SB446 Hurtado",39,0,0,1,40
1974556,1594667,2025-06-24,Assembly,"Do pass and be re-referred to the Committee on [Judiciary] with recommendation: To Consent Calendar",15,0,0,0,15
1974556,1597819,2025-07-08,Assembly,"Do pass and be re-referred to the Committee on [Appropriations] with recommendation: To Consent Calendar",12,0,0,0,12
1974556,1599724,2025-08-20,Assembly,"Do pass. To Consent Calendar",15,0,0,0,15
1974556,1600196,2025-08-28,Assembly,"SB 446 Hurtado Consent Calendar Second Day Regular Session",74,0,0,5,79
1974557,1528275,2025-03-26,Senate,"Do pass, but first be re-referred to the Committee on [Appropriations]",5,0,0,0,5
1974557,1538911,2025-04-07,Senate,"Placed on suspense file",7,0,0,0,7
1974557,1577652,2025-05-23,Senate,"Do pass",6,0,0,1,7
1974557,1581687,2025-05-29,Senate,"Special Consent SB447 Umberg",38,0,0,2,40
1974557,1598748,2025-07-16,Assembly,"Do pass and be re-referred to the Committee on [Appropriations] with recommendation: To Consent Calendar",17,0,0,0,17
1974557,1599723,2025-08-20,Assembly,"Do pass. To Consent Calendar",15,0,0,0,15
1974557,1600206,2025-08-28,Assembly,"SB 447 Umberg Consent Calendar Second Day Regular Session",74,0,0,5,79
1974557,1601986,2025-09-11,Senate,"Special Consent SB447 Umberg et al",40,0,0,0,40
1974558,1540883,2025-04-08,Senate,"Do pass as amended, but first amend, and re-refer to the Committee on [Judiciary]",6,0,0,0,6
1974558,1562798,2025-04-29,Senate,"Do pass, but first be re-referred to the Committee on [Appropriations]",13,0,0,0,13
1974558,1569845,2025-05-12,Senate,"Placed on suspense file",7,0,0,0,7
1974560,1535047,2025-04-01,Senate,"Do pass, but first be re-referred to the Committee on [Appropriations]",11,0,0,2,13
1974560,1552919,2025-04-21,Senate,"Placed on suspense file",6,0,0,1,7
1974560,1577612,2025-05-23,Senate,"Do pass",5,1,0,1,7
1974560,1581681,2025-05-29,Senate,"Senate 3rd Reading SB450 Menjivar",28,8,0,4,40
1974560,1591839,2025-06-17,Assembly,"Do pass and be re-referred to the Committee on [Appropriations]",9,2,0,1,12
1974560,1597491,2025-07-02,Assembly,"Do pass",10,2,0,3,15
1974560,1601954,2025-09-11,Senate,"Unfinished Business SB450 Menjivar et al. Concurrence",30,10,0,0,40
1974561,1540871,2025-04-08,Senate,"Do pass, but first be re-referred to the Committee on [Public Safety] with the recommendation: To Consent Calendar",15,0,0,0,15
1974561,1552838,2025-04-21,Senate,"Placed on suspense file",6,0,0,1,7
1974561,1577207,2025-05-23,Senate,"Do pass as amended",6,0,0,1,7
1974561,1585029,2025-06-04,Senate,"Special Consent SB451 Archuleta",39,0,0,1,40
1974561,1595182,2025-06-25,Assembly,"Do pass and be re-referred to the Committee on [Appropriations] with recommendation: To Consent Calendar",22,0,0,0,22
1974561,1600362,2025-08-29,Assembly,"Do pass",15,0,0,0,15
1974561,1601972,2025-09-11,Assembly,"Do pass",20,0,0,2,22
1974561,1602265,2025-09-12,Senate,"Unfinished Business SB451 Archuleta et al. Concurrence",37,0,0,3,40
1974561,1602266,2025-09-12,Assembly,"SB 451 Archuleta Senate Third Reading By AHRENS",79,0,0,1,80
1974562,1540827,2025-04-07,Senate,"Do pass, but first be re-referred to the Committee on [Judiciary]",5,0,0,0,5
1974562,1556029,2025-04-22,Senate,"Do pass, but first be re-referred to the Committee on [Appropriations] with the recommendation: To Consent Calendar",13,0,0,0,13
1974562,1565280,2025-05-05,Senate,"Placed on suspense file",7,0,0,0,7
1974562,1577748,2025-05-23,Senate,"Do pass",6,0,0,1,7
1974562,1581678,2025-05-29,Senate,"Special Consent SB452 Weber Pierson",38,0,0,2,40
1976395,1542917,2025-04-09,Assembly,"Do pass as amended, and be re-referred to the Committee on [Appropriations] with recommendation: To Consent Calendar",7,0,0,0,7
1976395,1562805,2025-04-30,Assembly,"Do pass. To Consent Calendar",14,0,0,1,15
1976395,1568619,2025-05-08,Assembly,"AB 808 Addis Consent Calendar Second Day Regular Session",69,0,0,10,79
1976395,1598485,2025-07-15,Senate,"Do pass, but first be re-referred to the Committee on [Appropriations]",5,0,0,0,5
1976395,1602158,2025-09-12,Senate,"Assembly 3rd Reading AB808 Addis By Weber Pierson",38,0,0,2,40
1976395,1602159,2025-09-13,Assembly,"AB 808 Addis Concurrence in Senate Amendments",79,0,0,1,80
1976396,1526893,2025-03-25,Assembly,"Do pass as amended, and be re-referred to the Committee on [Appropriations] with recommendation: To Consent Calendar",9,0,0,0,9
1976397,1542870,2025-04-09,Assembly,"Do pass as amended and be re-referred to the Committee on [Privacy and Consumer Protection]",9,1,0,0,10
1976397,1556202,2025-04-22,Assembly,"Do pass and be re-referred to the Committee on [Appropriations]",12,0,0,3,15
1976398,1545055,2025-04-09,Assembly,"Do pass and be re-referred to the Committee on [Appropriations] with recommendation: To Consent Calendar",9,0,0,0,9
1976399,1526925,2025-03-25,Assembly,"Do pass as amended and be re-referred to the Committee on [Appropriations]",8,0,0,1,9
1976399,1577753,2025-05-23,Assembly,"Do pass as amended",11,1,0,3,15
1976399,1585077,2025-06-04,Assembly,"AB 812 Lowenthal Assembly Third Reading",57,4,0,18,79
1976399,1597962,2025-07-08,Senate,"Do pass as amended, but first amend, and re-refer to the Committee on [Appropriations]",5,1,0,0,6
1976399,1599547,2025-08-18,Senate,"Placed on suspense file",7,0,0,0,7
1976399,1600366,2025-08-29,Senate,"Do pass as amended",5,2,0,0,7
1976399,1601654,2025-09-09,Senate,"Assembly 3rd Reading AB812 Lowenthal et al. By Arreguín",30,10,0,0,40
1976402,1556184,2025-04-23,Assembly,"Do pass and be re-referred to the Committee on [Appropriations]",17,0,0,0,17
1976402,1571649,2025-05-14,Assembly,"Do pass",15,0,0,0,15
1976402,1577519,2025-05-23,Assembly,"AB 815 Ortega Assembly Third Reading",72,0,0,7,79
1976402,1598036,2025-07-09,Senate,"Do pass, but first be re-referred to the Committee on [Appropriations] with the recommendation: To Consent Calendar",7,0,0,0,7
1976402,1600029,2025-08-25,Senate,"Consent Calendar 2nd AB815 Ortega",37,0,0,3,40
1976402,1600205,2025-08-28,Assembly,"AB 815 Ortega Concurrence in Senate Amendments",76,0,0,3,79
1976404,1535099,2025-04-02,Assembly,"Do pass and be re-referred to the Committee on [Appropriations] with recommendation: To Consent Calendar",21,0,0,1,22
1976404,1563103,2025-04-30,Assembly,"Do pass. To Consent Calendar",14,0,0,1,15
1976404,1568631,2025-05-08,Assembly,"AB 817 Nguyen Consent Calendar Second Day Regular Session",69,0,0,10,79
1976405,1555985,2025-04-23,Assembly,"Do pass as amended and be re-referred to the Committee on [Housing and Community Development]",10,0,0,0,10
1976405,1562811,2025-04-30,Assembly,"Do pass and be re-referred to the Committee on [Appropriations] with recommendation: To Consent Calendar",10,0,0,2,12
1976405,1571640,2025-05-14,Assembly,"Do pass. To Consent Calendar",15,0,0,0,15
1976405,1577544,2025-05-23,Assembly,"AB 818 Ávila Farías Consent Calendar Second Day Regular Session",71,0,0,8,79
1976405,1597473,2025-07-02,Senate,"Do pass, but first be re-referred to the Committee on [Housing]",7,0,0,0,7
1976405,1598478,2025-07-15,Senate,"Do pass as amended, but first amend, and re-refer to the Committee on [Appropriations]",10,0,0,1,11
1976405,1601656,2025-09-09,Senate,"Assembly 3rd Reading AB818 Ávila Farías et al. By Cabaldon",40,0,0,0,40
1976408,1545039,2025-04-09,Assembly,"Do pass and be re-referred to the Committee on [Appropriations] with recommendation: To Consent Calendar",9,0,0,0,9
1976408,1577209,2025-05-23,Assembly,"Do pass",14,0,0,1,15
1976408,1584415,2025-06-03,Assembly,"AB 821 Gipson Assembly Third Reading",79,0,0,0,79
1976408,1597390,2025-07-02,Senate,"Do pass, but first be re-referred to the Committee on [Appropriations] with the recommendation: To Consent Calendar",7,0,0,0,7
1976408,1598869,2025-07-17,Senate,"Consent Calendar 2nd AB821 Gipson",35,0,0,5,40
1976408,1600975,2025-09-03,Senate,"Assembly 3rd Reading AB821 Gipson By Pérez",40,0,0,0,40
1976408,1601149,2025-09-04,Assembly,"AB 821 Gipson Concurrence in Senate Amendments",76,0,0,3,79
1976409,1540791,2025-04-08,Assembly,"Do pass and be re-referred to the Committee on [Appropriations]",5,0,0,1,6
1976409,1577183,2025-05-23,Assembly,"Do pass",11,1,0,3,15
1976409,1583503,2025-06-02,Assembly,"AB 822 Elhawary Assembly Third Reading",65,3,0,11,79
1976409,1594635,2025-06-24,Senate,"Do pass, but first be re-referred to the Committee on [Judiciary]",15,0,0,0,15
1976409,1597532,2025-07-01,Senate,"Do pass, but first be re-referred to the Committee on [Appropriations]",13,0,0,0,13
1976409,1599640,2025-08-18,Senate,"Placed on suspense file",7,0,0,0,7
1976409,1600469,2025-08-29,Senate,"Do pass",7,0,0,0,7
1976409,1601256,2025-09-08,Senate,"Assembly 3rd Reading AB822 Elhawary By Cabaldon",39,0,0,1,40
1976410,1538871,2025-04-07,Assembly,"Do pass as amended and be re-referred to the Committee on [Environmental Safety and Toxic Materials]",10,4,0,0,14
1976410,1561093,2025-04-29,Assembly,"Do pass and be re-referred to the Committee on [Appropriations]",6,0,0,1,7
1976410,1577616,2025-05-23,Assembly,"Do pass as amended",11,1,0,3,15
1976410,1583565,2025-06-02,Assembly,"AB 823 Boerner Assembly Third Reading",63,10,0,6,79
1976410,1597545,2025-07-02,Senate,"Do pass, but first be re-referred to the Committee on [Judiciary]",7,0,0,1,8
1976410,1597848,2025-07-08,Senate,"Do pass, but first be re-referred to the Committee on [Appropriations]",13,0,0,0,13
1976410,1600997,2025-09-03,Senate,"Assembly 3rd Reading AB823 Boerner et al. By Gonzalez",40,0,0,0,40
1976411,1535067,2025-04-01,Assembly,"Do pass and be re-referred to the Committee on [Judiciary] with recommendation: To Consent Calendar",9,0,0,0,9
1976411,1540793,2025-04-08,Assembly,"Do pass and be re-referred to the Committee on [Appropriations] with recommendation: To Consent Calendar",12,0,0,0,12
1976411,1577537,2025-05-23,Assembly,"Do pass",14,0,0,1,15
1976411,1584431,2025-06-03,Assembly,"AB 824 Stefani Assembly Third Reading",78,0,0,1,79
1976411,1597179,2025-07-01,Senate,"Do pass, but first be re-referred to the Committee on [Judiciary] with the recommendation: To Consent Calendar",6,0,0,0,6
1976411,1597890,2025-07-08,Senate,"Do pass, but first be re-referred to the Committee on [Appropriations] with the recommendation: To Consent Calendar",13,0,0,0,13
1976411,1599488,2025-08-18,Senate,"Placed on suspense file",7,0,0,0,7
1976412,1564208,2025-04-30,Assembly,"Do pass and be re-referred to the Committee on [Appropriations]",18,0,0,0,18
1976412,1577352,2025-05-23,Assembly,"Do pass as amended",11,0,0,4,15
1976412,1584325,2025-06-03,Assembly,"Do pass",13,0,0,5,18
1976412,1585807,2025-06-05,Assembly,"AB 825 Petrie-Norris Assembly Third Reading",57,5,0,17,79
1976412,1598241,2025-07-14,Senate,"Do pass, but first be re-referred to the Committee on [Energy, Utilities and Communications]",8,3,0,0,11
1976412,1598382,2025-07-15,Senate,"Do pass, but first be re-referred to the Committee on [Appropriations]",12,1,0,4,17
1976412,1599589,2025-08-18,Senate,"Placed on suspense file",7,0,0,0,7
1976412,1600316,2025-08-29,Senate,"Do pass",5,2,0,0,7
1976412,1601952,2025-09-11,Senate,"Do pass",12,0,0,5,17
1976412,1602292,2025-09-12,Senate,"Assembly 2nd Reading AB825 Petrie-Norris et al. By Becker",34,0,0,6,40
1976412,1602293,2025-09-13,Assembly,"AB 825 PETRIE-NORRIS Concurrence in Senate Amendments",74,1,0,5,80
1976413,1545030,2025-04-08,Assembly,"Do pass and be re-referred to the Committee on [Judiciary]",8,0,0,0,8
1976414,1563083,2025-04-30,Assembly,"Do pass and be re-referred to the Committee on [Appropriations]",4,0,0,3,7
1976414,1577839,2025-05-23,Assembly,"Do pass",11,0,0,4,15
1976414,1583469,2025-06-02,Assembly,"AB 827 Berman Assembly Third Reading",62,3,0,14,79
1976414,1597118,2025-07-01,Senate,"Do pass as amended, but first amend, and re-refer to the Committee on [Appropriations]",5,0,0,0,5
1976414,1598206,2025-07-14,Senate,"Placed on suspense file",7,0,0,0,7
1976414,1600649,2025-08-29,Senate,"Do pass",5,0,0,2,7
1976414,1601530,2025-09-09,Senate,"Assembly 3rd Reading AB827 Berman et al. By Cervantes",30,5,0,5,40
1976415,1556081,2025-04-23,Assembly,"Do pass as amended and be re-referred to the Committee on [Appropriations]",22,0,0,0,22
1976415,1571526,2025-05-14,Assembly,"Do pass",15,0,0,0,15
1976415,1573598,2025-05-19,Assembly,"AB 828 Mark González Assembly Third Reading",75,0,0,4,79
1976415,1594561,2025-06-24,Senate,"Do pass as amended, but first amend, and re-refer to the Committee on [Appropriations]",15,0,0,0,15
1976415,1601286,2025-09-08,Senate,"Assembly 3rd Reading AB828 Mark González By Durazo",39,0,0,1,40
1976415,1601523,2025-09-09,Assembly,"AB 828 Mark González Concurrence in Senate Amendments",80,0,0,0,80
1976416,1540833,2025-04-08,Assembly,"Do pass and be re-referred to the Committee on [Revenue and Taxation] with recommendation: To Consent Calendar",15,0,0,0,15
1976416,1561082,2025-04-28,Assembly,"Do pass as amended and be re-referred to the Committee on [Appropriations]",7,0,0,0,7
1976416,1577745,2025-05-23,Assembly,"Do pass as amended",11,0,0,4,15
1976416,1583554,2025-06-02,Assembly,"AB 829 Sharp-Collins Assembly Third Reading",79,0,0,0,79
1976416,1595223,2025-06-25,Senate,"Do pass, but first be re-referred to the Committee on [Appropriations] with the recommendation: To Consent Calendar",5,0,0,0,5
1976416,1598164,2025-07-10,Senate,"Consent Calendar 2nd AB829 Sharp-Collins",37,0,0,3,40
1976416,1599656,2025-08-18,Assembly,"AB 829 Sharp-Collins Concurrence in Senate Amendments",76,0,0,3,79
1976417,1554604,2025-04-21,Assembly,"Do pass and be re-referred to the Committee on [Appropriations] with recommendation: To Consent Calendar",15,0,0,1,16
1976417,1577713,2025-05-23,Assembly,"Do pass as amended",11,0,0,4,15
1976417,1585104,2025-06-04,Assembly,"AB 830 Rogers Assembly Third Reading",79,0,0,0,79
1976417,1597904,2025-07-08,Senate,"Do pass, but first be re-referred to the Committee on [Appropriations]",15,0,0,0,15
1976417,1599443,2025-08-18,Senate,"Placed on suspense file",7,0,0,0,7
1976417,1600502,2025-08-29,Senate,"Do pass as amended",7,0,0,0,7
1976417,1601124,2025-09-04,Senate,"Assembly 3rd Reading AB830 Rogers By Grove",39,0,0,1,40
1976417,1601331,2025-09-08,Assembly,"AB 830 Rogers Concurrence in Senate Amendments",79,0,0,1,80
1976418,1534993,2025-04-02,Assembly,"Do pass and be re-referred to the Committee on [Appropriations] with recommendation: To Consent Calendar",21,0,0,1,22
1976418,1565312,2025-05-05,Assembly,"AB 831 Ramos Assembly Third Reading",77,0,0,2,79
1976418,1588090,2025-06-10,Senate,"Do pass and be ordered to the Consent Calendar",14,0,0,1,15
1976418,1597869,2025-07-08,Senate,"Do pass, but first be re-referred to the Committee on [Public Safety]",15,0,0,0,15
1976418,1598453,2025-07-15,Senate,"Do pass as amended, but first amend, and re-refer to the Committee on [Appropriations]",6,0,0,0,6
1976418,1599457,2025-08-18,Senate,"Placed on suspense file",7,0,0,0,7
1976418,1600722,2025-08-29,Senate,"Do pass",7,0,0,0,7
1976418,1601245,2025-09-08,Senate,"Assembly 3rd Reading AB831 Valencia By Cervantes",36,0,0,4,40
1976418,1601885,2025-09-11,Assembly,"With recommendation: That Senate amendments be concurred in",20,0,0,2,22
1976418,1602288,2025-09-12,Assembly,"AB 831 Valencia Concurrence in Senate Amendments",79,0,0,1,80
1976420,1529549,2025-03-26,Assembly,"Do pass and be re-referred to the Committee on [Appropriations]",9,0,0,0,9
1976420,1577335,2025-05-23,Assembly,"Do pass",14,0,0,1,15
1976420,1583395,2025-06-02,Assembly,"AB 833 Alvarez Assembly Third Reading",77,1,0,1,79
1976420,1595179,2025-06-25,Senate,"Do pass, but first be re-referred to the Committee on [Appropriations]",7,0,0,0,7
1976420,1597684,2025-07-07,Senate,"Placed on suspense file",6,0,0,1,7
1976420,1600683,2025-08-29,Senate,"Do pass",7,0,0,0,7
1976420,1601116,2025-09-04,Senate,"Assembly 3rd Reading AB833 Alvarez By Caballero",39,0,0,1,40
1976422,1556179,2025-04-22,Assembly,"Do pass and be re-referred to the Committee on [Appropriations]",16,0,0,0,16
1976423,1540864,2025-04-08,Assembly,"Do pass and be re-referred to the Committee on [Appropriations]",15,0,0,0,15
1976423,1577489,2025-05-23,Assembly,"Do pass",13,0,0,2,15
1976423,1583585,2025-06-02,Assembly,"AB 836 Stefani Assembly Third Reading",73,2,0,4,79
1976423,1598852,2025-07-16,Senate,"Do pass, but first be re-referred to the Committee on [Appropriations]",10,0,0,1,11
1976423,1599479,2025-08-18,Senate,"Placed on suspense file",7,0,0,0,7
1976423,1600306,2025-08-29,Senate,"Do pass",7,0,0,0,7
1976423,1601263,2025-09-08,Senate,"Assembly 3rd Reading AB836 Stefani et al. By Caballero",39,0,0,1,40
1976423,1601643,2025-09-09,Assembly,"AB 836 Stefani Concurrence in Senate Amendments",72,1,0,7,80
1976424,1526954,2025-03-25,Assembly,"Do pass as amended and be re-referred to the Committee on [Appropriations]",8,0,0,1,9
1976426,1558734,2025-04-21,Assembly,"Do pass and be re-referred to the Committee on [Judiciary]",14,0,0,0,14
1976426,1561025,2025-04-29,Assembly,"Do pass and be re-referred to the Committee on [Appropriations]",11,0,0,1,12
1976426,1571632,2025-05-14,Assembly,"Do pass",15,0,0,0,15
1976426,1577166,2025-05-23,Assembly,"AB 839 Blanca Rubio Assembly Third Reading",71,0,0,8,79
1976428,1540882,2025-04-07,Assembly,"Do pass and be re-referred to the Committee on [Labor and Employment]",7,0,0,0,7
1976428,1557515,2025-04-23,Assembly,"Do pass and be re-referred to the Committee on [Appropriations] with recommendation: To Consent Calendar",7,0,0,0,7
1976428,1577424,2025-05-23,Assembly,"Do pass",14,0,0,1,15
1976428,1583467,2025-06-02,Assembly,"AB 841 Patel Assembly Third Reading",79,0,0,0,79
1976428,1597841,2025-07-08,Senate,"Do pass, but first be re-referred to the Committee on [Appropriations] with the recommendation: To Consent Calendar",15,0,0,0,15
1976428,1599542,2025-08-18,Senate,"Placed on suspense file",7,0,0,0,7
1976428,1600358,2025-08-29,Senate,"Do pass as amended",7,0,0,0,7
1976428,1601990,2025-09-11,Senate,"Special Consent AB841 Patel et al. By Laird",40,0,0,0,40
1976428,1602279,2025-09-12,Assembly,"AB 841 Patel Concurrence in Senate Amendments",80,0,0,0,80
1976430,1526991,2025-03-25,Assembly,"Do pass and be re-referred to the Committee on [Appropriations]",13,0,0,2,15
1976430,1577944,2025-05-23,Assembly,"Do pass",12,0,0,3,15
1976430,1583459,2025-06-02,Assembly,"AB 843 Garcia Assembly Third Reading",66,1,0,12,79
1976430,1597482,2025-07-02,Senate,"Do pass as amended, but first amend, and re-refer to the Committee on [Judiciary]",11,0,0,0,11
1976430,1599441,2025-08-18,Senate,"Placed on suspense file",7,0,0,0,7
1976430,1600681,2025-08-29,Senate,"Do pass",5,0,0,2,7
1976430,1601666,2025-09-09,Senate,"Assembly 3rd Reading AB843 Garcia By Menjivar",34,1,0,5,40
1976431,1533495,2025-04-01,Assembly,"Do pass and be re-referred to the Committee on [Education]",2,6,0,1,9
1976432,1557498,2025-04-23,Assembly,"Do pass and be re-referred to the Committee on [Appropriations]",7,0,0,0,7
1976432,1577554,2025-05-23,Assembly,"Do pass",14,0,0,1,15
1976432,1584321,2025-06-03,Assembly,"AB 845 Arambula Assembly Third Reading",79,0,0,0,79
1976432,1595148,2025-06-25,Senate,"Do pass, but first be re-referred to the Committee on [Appropriations] with the recommendation: To Consent Calendar",5,0,0,0,5
1976432,1597683,2025-07-07,Senate,"Placed on suspense file",6,0,0,1,7
1976432,1600597,2025-08-29,Senate,"Do pass as amended",7,0,0,0,7
1976432,1601547,2025-09-09,Senate,"Assembly 3rd Reading AB845 Arambula By Hurtado",40,0,0,0,40
1976433,1540957,2025-04-08,Assembly,"Do pass and be re-referred to the Committee on [Natural Resources]",13,0,0,0,13
1976433,1558722,2025-04-21,Assembly,"Do pass and be re-referred to the Committee on [Appropriations] with recommendation: To Consent Calendar",14,0,0,0,14
1976433,1577518,2025-05-23,Assembly,"Do pass as amended",11,0,0,4,15
1976433,1583449,2025-06-02,Assembly,"AB 846 Connolly Assembly Third Reading",78,0,0,1,79
1976433,1594619,2025-06-24,Senate,"Do pass as amended, but first amend, and re-refer to the Committee on [Appropriations]",7,0,0,0,7
1976433,1598260,2025-07-14,Senate,"Placed on suspense file",7,0,0,0,7
1976434,1563118,2025-04-29,Assembly,"Do pass as amended",5,0,0,4,9
1976434,1583475,2025-06-02,Assembly,"AB 847 Sharp-Collins Assembly Third Reading",53,15,0,11,79
1976434,1597964,2025-07-08,Senate,"Do pass",5,1,0,0,6
1976434,1602323,2025-09-12,Senate,"Assembly 3rd Reading AB847 Sharp-Collins et al. By Arreguín",23,10,0,7,40
1976434,1602324,2025-09-13,Assembly,"AB 847 Sharp-Collins Concurrence in Senate Amendments",50,16,0,14,80
1976435,1554528,2025-04-22,Assembly,"Do pass as amended and be re-referred to the Committee on [Appropriations]",9,0,0,0,9
1976435,1577319,2025-05-23,Assembly,"Do pass",14,0,0,1,15
1976435,1583547,2025-06-02,Assembly,"AB 848 Soria Assembly Third Reading",77,0,0,2,79
1976435,1594643,2025-06-24,Senate,"Do pass as amended, but first amend, and re-refer to the Committee on [Appropriations]",6,0,0,0,6
1976435,1597689,2025-07-07,Senate,"Placed on suspense file",6,0,0,1,7
1976435,1600715,2025-08-29,Senate,"Do pass",7,0,0,0,7
1976435,1601141,2025-09-04,Senate,"Special Consent AB848 Soria",39,0,0,1,40
1976435,1601332,2025-09-08,Assembly,"AB 848 Soria Concurrence in Senate Amendments",78,0,0,2,80
1976436,1562906,2025-04-29,Assembly,"Do pass and be re-referred to the Committee on [Appropriations]",12,1,0,3,16
1976436,1577426,2025-05-23,Assembly,"Do pass as amended",11,0,0,4,15
1976436,1583403,2025-06-02,Assembly,"AB 849 Soria Assembly Third Reading",64,1,0,14,79
1976436,1598831,2025-07-16,Senate,"Do pass as amended, but first amend, and re-refer to the Committee on [Appropriations]",8,0,0,3,11
1976436,1599401,2025-08-18,Senate,"Placed on suspense file",7,0,0,0,7
1976436,1600690,2025-08-29,Senate,"Do pass as amended",5,0,0,2,7
1976436,1601979,2025-09-11,Senate,"Assembly 3rd Reading AB849 Soria et al. By Caballero",37,0,0,3,40
1976436,1602238,2025-09-12,Assembly,"AB 849 Soria Concurrence in Senate Amendments",78,0,0,2,80
1976437,1556195,2025-04-22,Assembly,"Do pass and be re-referred to the Committee on [Appropriations]",6,1,0,3,10
1976438,1526914,2025-03-25,Assembly,"Do pass as amended and be re-referred to the Committee on [Appropriations]",12,0,0,0,12
1976438,1577479,2025-05-23,Assembly,"Do pass",12,0,0,3,15
1976438,1583526,2025-06-02,Assembly,"AB 851 McKinnor Third Reading Urgency",67,6,0,6,79
1976438,1597393,2025-07-01,Senate,"Do pass as amended, but first amend, and re-refer to the Committee on [Public Safety]",11,2,0,0,13
1976438,1597933,2025-07-08,Senate,"Do pass, but first be re-referred to the Committee on [Appropriations]",5,1,0,0,6
1976438,1599582,2025-08-18,Senate,"Placed on suspense file",7,0,0,0,7
1976438,1600763,2025-08-29,Senate,"Do pass as amended",5,2,0,0,7
1976438,1601736,2025-09-10,Senate,"Assembly 3rd Reading AB851 McKinnor By Pérez Urgency Clause",30,8,0,2,40
1976440,1556150,2025-04-22,Assembly,"Do pass and be re-referred to the Committee on [Judiciary]",11,1,0,3,15
1976440,1561162,2025-04-29,Assembly,"Do pass and be re-referred to the Committee on [Appropriations]",9,0,0,3,12
1976440,1577897,2025-05-23,Assembly,"Do pass as amended",11,0,0,4,15
1976440,1583579,2025-06-02,Assembly,"AB 853 Wicks Assembly Third Reading",58,2,0,19,79
1976440,1598615,2025-07-15,Senate,"Do pass as amended, but first amend, and re-refer to the Committee on [Appropriations]",11,0,0,2,13
1976440,1599503,2025-08-18,Senate,"Placed on suspense file",7,0,0,0,7
1976440,1600522,2025-08-29,Senate,"Do pass",5,2,0,0,7
1976440,1601886,2025-09-11,Senate,"Assembly 3rd Reading AB853 Wicks et al. By Becker",30,6,0,4,40
1976440,1602289,2025-09-12,Assembly,"AB 853 Wicks Concurrence in Senate Amendments",60,4,0,16,80
1976442,1561146,2025-04-28,Assembly,"Do pass and be re-referred to the Committee on [Appropriations] with recommendation: To Consent Calendar",7,0,0,0,7
1976444,1529534,2025-03-26,Assembly,"Do pass as amended and be re-referred to the Committee on [Appropriations]",7,2,0,0,9
1976445,1557474,2025-04-23,Assembly,"Do pass and be re-referred to the Committee on [Appropriations]",5,1,0,1,7
1976445,1577155,2025-05-23,Assembly,"Do pass",10,3,0,2,15
1976445,1584370,2025-06-03,Assembly,"AB 858 Lee Assembly Third Reading",52,19,0,8,79
1976445,1598068,2025-07-09,Senate,"Do pass, but first be re-referred to the Committee on [Appropriations]",4,1,0,0,5
1976445,1599492,2025-08-18,Senate,"Placed on suspense file",7,0,0,0,7
1976445,1600740,2025-08-29,Senate,"Do pass as amended",5,2,0,0,7
1976445,1601757,2025-09-10,Senate,"Assembly 3rd Reading AB858 Lee et al. By Durazo",29,10,0,1,40
1976446,1540951,2025-04-08,Assembly,"Do pass. To Consent Calendar",12,0,0,0,12
1976446,1552854,2025-04-21,Assembly,"AB 859 Macedo Consent Calendar Second Day Regular Session",73,0,0,6,79
1976446,1595143,2025-06-24,Senate,"Do pass, but first be re-referred to the Committee on [Appropriations] with the recommendation: To Consent Calendar",12,0,0,1,13
1976446,1597712,2025-07-07,Senate,"Placed on suspense file",6,0,0,1,7
1976447,1545000,2025-04-09,Assembly,"Do pass as amended and be re-referred to the Committee on [Appropriations]",9,0,0,0,9
1976448,1556112,2025-04-22,Assembly,"Do pass as amended and be re-referred to the Committee on [Transportation]",7,1,0,2,10
1976449,1529546,2025-03-26,Assembly,"Do pass as amended and be re-referred to the Committee on [Appropriations]",7,2,0,0,9
1976450,1566709,2025-05-06,Assembly,"Do pass",8,3,0,1,12
1976450,1584435,2025-06-03,Assembly,"AB 863 Kalra Assembly Third Reading",50,17,0,12,79
1976450,1598616,2025-07-15,Senate,"Do pass, but first be re-referred to the Committee on [Appropriations]",11,2,0,0,13
1976450,1600932,2025-09-03,Senate,"Assembly 3rd Reading AB863 Kalra et al. By Pérez",38,0,0,2,40
1976450,1601191,2025-09-04,Assembly,"AB 863 Kalra Concurrence in Senate Amendments",70,1,0,8,79
1976451,1561024,2025-04-29,Assembly,"Do pass and be re-referred to the Committee on [Appropriations]",7,0,0,0,7
1976451,1577775,2025-05-23,Assembly,"Do pass",14,0,0,1,15
1976451,1583420,2025-06-02,Assembly,"AB 864 Ward Assembly Third Reading",79,0,0,0,79
1976451,1598636,2025-07-16,Senate,"Do pass as amended, but first amend, and re-refer to the Committee on [Appropriations]",8,0,0,0,8
1976451,1599364,2025-08-18,Senate,"Placed on suspense file",7,0,0,0,7
1976451,1600393,2025-08-29,Senate,"Do pass",7,0,0,0,7
1976452,1529509,2025-03-26,Assembly,"Do pass as amended and be re-referred to the Committee on [Appropriations]",9,0,0,0,9
1976453,1540969,2025-04-08,Assembly,"Do pass and be re-referred to the Committee on [Banking and Finance]",12,0,0,0,12
1976453,1559471,2025-04-28,Assembly,"Do pass and be re-referred to the Committee on [Appropriations]",9,0,0,0,9
1976453,1577460,2025-05-23,Assembly,"Do pass",14,0,0,1,15
1976453,1583518,2025-06-02,Assembly,"AB 866 Ortega Assembly Third Reading",79,0,0,0,79
1976453,1597603,2025-07-02,Senate,"Do pass, but first be re-referred to the Committee on [Judiciary] with the recommendation: To Consent Calendar",7,0,0,0,7
1976453,1598683,2025-07-15,Senate,"Do pass, but first be re-referred to the Committee on [Appropriations] with the recommendation: To Consent Calendar",13,0,0,0,13
1976453,1599631,2025-08-18,Senate,"Placed on suspense file",7,0,0,0,7
1976454,1533527,2025-04-01,Assembly,"Do pass and be re-referred to the Committee on [Appropriations]",13,0,0,5,18
1976454,1556060,2025-04-23,Assembly,"Do pass",11,0,0,4,15
1976454,1559388,2025-04-28,Assembly,"AB 867 Lee Assembly Third Reading",72,0,0,7,79
1976454,1594062,2025-06-23,Senate,"Do pass, but first be re-referred to the Committee on [Appropriations]",10,0,0,1,11
1976454,1601259,2025-09-08,Senate,"Assembly 3rd Reading AB867 Lee et al. By Arreguín",36,0,0,4,40
1976454,1601529,2025-09-09,Assembly,"AB 867 Lee Concurrence in Senate Amendments",74,0,0,6,80
1976456,1535068,2025-04-01,Assembly,"Do pass and be re-referred to the Committee on [Appropriations] with recommendation: To Consent Calendar",15,0,0,0,15
1976456,1577338,2025-05-23,Assembly,"Do pass",14,0,0,1,15
1976456,1583536,2025-06-02,Assembly,"AB 869 Irwin Assembly Third Reading",78,0,0,1,79
1976456,1597832,2025-07-08,Senate,"Do pass, but first be re-referred to the Committee on [Appropriations] with the recommendation: To Consent Calendar",15,0,0,0,15
1976456,1599600,2025-08-18,Senate,"Placed on suspense file",7,0,0,0,7
1976457,1555933,2025-04-22,Assembly,"Do pass. To Consent Calendar",16,0,0,0,16
1976457,1564212,2025-05-01,Assembly,"AB 870 Hadwick Consent Calendar Second Day",76,0,0,3,79
1976457,1589114,2025-06-11,Senate,"Do pass and be ordered to the Consent Calendar",9,0,0,2,11
1976457,1601870,2025-09-11,Senate,"Do pass",6,0,0,1,7
1976457,1602113,2025-09-12,Senate,"Assembly 2nd Reading AB870 Hadwick By Seyarto",38,0,0,2,40
1976457,1602114,2025-09-13,Assembly,"AB 870 Hadwick Concurrence in Senate Amendments",73,0,0,7,80
1976460,1540929,2025-04-08,Assembly,"Do pass as amended and be re-referred to the Committee on [Appropriations]",17,0,0,1,18
1976460,1577960,2025-05-23,Assembly,"Do pass",14,0,0,1,15
1976460,1583360,2025-06-02,Assembly,"AB 873 Alanis Third Reading Urgency",78,0,0,1,79
1976462,1561140,2025-04-28,Assembly,"Do pass and be re-referred to the Committee on [Appropriations] with recommendation: To Consent Calendar",16,0,0,0,16
1976462,1571540,2025-05-14,Assembly,"Do pass. To Consent Calendar",15,0,0,0,15
1976462,1577315,2025-05-23,Assembly,"AB 875 Muratsuchi Consent Calendar Second Day Regular Session",71,0,0,8,79
1976462,1594623,2025-06-24,Senate,"Do pass, but first be re-referred to the Committee on [Transportation] with the recommendation: To Consent Calendar",6,0,0,0,6
1976462,1597811,2025-07-08,Senate,"Do pass as amended, but first amend, and re-refer to the Committee on [Appropriations] with the recommendation: To Consent Calendar",15,0,0,0,15
1976462,1599999,2025-08-25,Senate,"Consent Calendar 2nd AB875 Muratsuchi et al",37,0,0,3,40
1976462,1600239,2025-08-28,Assembly,"AB 875 Muratsuchi Concurrence in Senate Amendments",75,0,0,4,79
1976463,1554484,2025-04-22,Assembly,"Do pass as amended and be re-referred to the Committee on [Appropriations]",15,1,0,2,18
1976463,1567932,2025-05-07,Assembly,"Do pass",14,0,0,1,15
1976463,1572414,2025-05-15,Assembly,"AB 876 Flora Assembly Third Reading",61,1,0,17,79
1976463,1598236,2025-07-14,Senate,"Do pass, but first be re-referred to the Committee on [Appropriations]",9,0,0,2,11
1976463,1601004,2025-09-03,Senate,"Assembly 3rd Reading AB876 Flora By Ashby",33,0,0,7,40
1976463,1601005,2025-09-03,Senate,"Assembly 3rd Reading AB876 Flora By Ashby Reconsider",40,0,0,0,40
1976463,1601006,2025-09-03,Senate,"Assembly 3rd Reading AB876 Flora By Ashby",38,0,0,2,40
1976463,1601082,2025-09-04,Assembly,"AB 876 Flora Concurrence in Senate Amendments",70,1,0,8,79
1976465,1526903,2025-03-25,Assembly,"Do pass",9,1,0,2,12
1976465,1585032,2025-06-04,Assembly,"AB 878 Kalra Assembly Third Reading",60,3,0,16,79
1976465,1598723,2025-07-15,Senate,"Do pass as amended, but first amend, and re-refer to the Committee on [Appropriations]",11,0,0,2,13
1976465,1599429,2025-08-18,Senate,"Placed on suspense file",7,0,0,0,7
1976466,1554576,2025-04-22,Assembly,"Do pass and be re-referred to the Committee on [Appropriations] with recommendation: To Consent Calendar",9,0,0,0,9
1976466,1562751,2025-04-30,Assembly,"Do pass. To Consent Calendar",14,0,0,1,15
1976466,1568625,2025-05-08,Assembly,"AB 879 Patterson Consent Calendar Second Day Regular Session",69,0,0,10,79
1976466,1588113,2025-06-10,Senate,"Do pass as amended, but first amend, and re-refer to the Committee on [Appropriations] with the recommendation: To Consent Calendar",6,0,0,0,6
1976466,1594053,2025-06-23,Senate,"Placed on suspense file",7,0,0,0,7
1976467,1535002,2025-04-02,Assembly,"Do pass and be re-referred to the Committee on [Appropriations]",21,0,0,1,22
1976467,1577588,2025-05-23,Assembly,"Do pass",14,0,0,1,15
1976467,1583429,2025-06-02,Assembly,"AB 880 Bennett Assembly Third Reading",79,0,0,0,79
1976467,1594611,2025-06-24,Senate,"Do pass, but first be re-referred to the Committee on [Appropriations] with the recommendation: To Consent Calendar",15,0,0,0,15
1976468,1556106,2025-04-23,Assembly,"Do pass and be re-referred to the Committee on [Natural Resources]",17,0,0,1,18
1976468,1559428,2025-04-28,Assembly,"Do pass as amended and be re-referred to the Committee on [Appropriations]",13,0,0,1,14
1976468,1571588,2025-05-14,Assembly,"Do pass",15,0,0,0,15
1976468,1573515,2025-05-19,Assembly,"AB 881 Petrie-Norris Assembly Third Reading",72,0,0,7,79
1976468,1588064,2025-06-10,Senate,"Do pass, but first be re-referred to the Committee on [Environmental Quality]",14,0,0,1,15
1976468,1598573,2025-07-16,Senate,"Do pass as amended, but first amend, and re-refer to the Committee on [Appropriations]",8,0,0,0,8
1976468,1602098,2025-09-12,Senate,"Assembly 3rd Reading AB881 Petrie-Norris et al. By Stern",38,0,0,2,40
1976469,1540948,2025-04-08,Assembly,"Do pass as amended and be re-referred to the Committee on [Appropriations]",8,0,0,4,12
1976469,1577798,2025-05-23,Assembly,"Do pass",11,1,0,3,15
1976469,1585003,2025-06-04,Assembly,"AB 882 Papan Assembly Third Reading",62,4,0,13,79
1976472,1561040,2025-04-29,Assembly,"Do pass and be re-referred to the Committee on [Appropriations]",10,0,0,0,10
1976473,1562819,2025-04-29,Assembly,"Do pass and be re-referred to the Committee on [Appropriations] with recommendation: To Consent Calendar",16,0,0,0,16
1976474,1529541,2025-03-26,Assembly,"Do pass and be re-referred to the Committee on [Appropriations]",9,0,0,0,9
1976474,1577607,2025-05-23,Assembly,"Do pass",14,0,0,1,15
1976474,1583540,2025-06-02,Assembly,"AB 887 Berman Assembly Third Reading",77,0,0,2,79
1976474,1598575,2025-07-16,Senate,"Do pass as amended, but first amend, and re-refer to the Committee on [Appropriations]",7,0,0,0,7
1976474,1599522,2025-08-18,Senate,"Placed on suspense file",7,0,0,0,7
1976475,1562977,2025-04-30,Assembly,"Do pass and be re-referred to the Committee on [Appropriations]",16,0,0,1,17
1976475,1577879,2025-05-23,Assembly,"Do pass",14,0,0,1,15
1976475,1584246,2025-06-03,Assembly,"AB 888 Calderon Assembly Third Reading",79,0,0,0,79
1976475,1598143,2025-07-09,Senate,"Do pass, but first be re-referred to the Committee on [Appropriations] with the recommendation: To Consent Calendar",7,0,0,0,7
1976475,1599619,2025-08-18,Senate,"Placed on suspense file",7,0,0,0,7
1976475,1600320,2025-08-29,Senate,"Do pass",7,0,0,0,7
1976475,1602077,2025-09-12,Senate,"Assembly 3rd Reading AB888 Calderon et al. By Grayson",37,0,0,3,40
1976476,1536805,2025-04-02,Assembly,"Do pass and be re-referred to the Committee on [Appropriations] with recommendation: To Consent Calendar",7,0,0,0,7
1976476,1563022,2025-04-30,Assembly,"Do pass. To Consent Calendar",14,0,0,1,15
1976476,1568630,2025-05-08,Assembly,"AB 889 Hadwick Consent Calendar Second Day Regular Session",69,0,0,10,79
1976476,1598128,2025-07-09,Senate,"Do pass, but first be re-referred to the Committee on [Appropriations]",4,0,0,1,5
1976476,1601809,2025-09-10,Senate,"Assembly 3rd Reading AB889 Hadwick et al. By Limón",36,0,0,4,40
1976476,1602064,2025-09-13,Assembly,"AB 889 Hadwick Concurrence in Senate Amendments",77,1,0,2,80
1976477,1540837,2025-04-08,Assembly,"Do pass",6,0,0,0,6
1976477,1552842,2025-04-21,Assembly,"AB 890 Lee Assembly Third Reading",74,0,0,5,79
1976477,1597672,2025-07-07,Senate,"Do pass, but first be re-referred to the Committee on [Judiciary] with the recommendation: To Consent Calendar",5,0,0,0,5
1976477,1598674,2025-07-15,Senate,"Do pass, but first be re-referred to the Committee on [Appropriations] with the recommendation: To Consent Calendar",13,0,0,0,13
1976477,1599610,2025-08-18,Senate,"Placed on suspense file",7,0,0,0,7
1976477,1600377,2025-08-29,Senate,"Do pass",7,0,0,0,7
1976477,1601238,2025-09-08,Senate,"Assembly 3rd Reading AB890 Lee et al. By Ochoa Bogh",39,0,0,1,40
1976477,1601577,2025-09-09,Assembly,"AB 890 Lee Concurrence in Senate Amendments",80,0,0,0,80
1976478,1538932,2025-04-07,Assembly,"Do pass and be re-referred to the Committee on [Appropriations]",12,4,0,0,16
1976478,1577399,2025-05-23,Assembly,"Do pass",11,3,0,1,15
1976478,1585076,2025-06-04,Assembly,"AB 891 Zbur Assembly Third Reading",61,17,0,1,79
1976478,1597944,2025-07-08,Senate,"Do pass, but first be re-referred to the Committee on [Appropriations]",11,4,0,0,15
1976478,1600000,2025-08-25,Senate,"Placed on suspense file",6,0,0,1,7
1976480,1542826,2025-04-09,Assembly,"Do pass and be re-referred to the Committee on [Local Government]",10,1,0,1,12
1976480,1564247,2025-04-30,Assembly,"Do pass and be re-referred to the Committee on [Appropriations]",9,0,0,1,10
1976480,1571523,2025-05-14,Assembly,"Do pass",10,0,0,5,15
1976480,1583545,2025-06-02,Assembly,"AB 893 Fong Assembly Third Reading",65,5,0,9,79
1976480,1597435,2025-07-01,Senate,"Do pass as amended, but first amend, and re-refer to the Committee on [Local Government]",9,1,0,1,11
1976480,1598742,2025-07-16,Senate,"Do pass, but first be re-referred to the Committee on [Appropriations]",5,2,0,0,7
1976480,1600973,2025-09-03,Senate,"Assembly 3rd Reading AB893 Fong et al. By Cabaldon",31,9,0,0,40
1976480,1601333,2025-09-08,Assembly,"AB 893 Fong Concurrence in Senate Amendments",62,5,0,13,80
1976481,1556126,2025-04-22,Assembly,"Do pass as amended, and be re-referred to the Committee on [Appropriations] with recommendation: To Consent Calendar",16,0,0,0,16
1976481,1571525,2025-05-14,Assembly,"Do pass. To Consent Calendar",15,0,0,0,15
1976481,1577788,2025-05-23,Assembly,"AB 894 Carrillo Consent Calendar Second Day Regular Session",71,0,0,8,79
1976481,1592577,2025-06-18,Senate,"Do pass, but first be re-referred to the Committee on [Judiciary] with the recommendation: To Consent Calendar",10,0,0,1,11
1976481,1597458,2025-07-01,Senate,"Do pass, but first be re-referred to the Committee on [Appropriations]",13,0,0,0,13
1976481,1600945,2025-09-03,Senate,"Assembly 3rd Reading AB894 Carrillo et al. By Rubio",40,0,0,0,40
1976481,1601074,2025-09-04,Assembly,"AB 894 Carrillo Concurrence in Senate Amendments",77,0,0,2,79
1976483,1562842,2025-04-29,Assembly,"Do pass and be re-referred to the Committee on [Appropriations] with recommendation: To Consent Calendar",7,0,0,0,7
1976483,1567872,2025-05-07,Assembly,"Do pass. To Consent Calendar",15,0,0,0,15
1976483,1572420,2025-05-15,Assembly,"AB 896 Elhawary Consent Calendar Second Day Regular Session",69,0,0,10,79
1976483,1591163,2025-06-16,Senate,"Do pass, but first be re-referred to the Committee on [Appropriations] with the recommendation: To Consent Calendar",5,0,0,0,5
1976483,1596814,2025-06-30,Senate,"Placed on suspense file",6,0,0,1,7
1976483,1600781,2025-08-29,Senate,"Do pass as amended",7,0,0,0,7
1976483,1601913,2025-09-11,Senate,"Special Consent AB896 Elhawary et al. By Ashby",40,0,0,0,40
1976483,1602342,2025-09-12,Assembly,"AB 896 Elhawary Concurrence in Senate Amendments",79,0,0,1,80
1976484,1554607,2025-04-22,Assembly,"Do pass and be re-referred to the Committee on [Appropriations]",2,3,0,4,9
1976485,1526963,2025-03-25,Assembly,"Do pass and be re-referred to the Committee on [Appropriations] with recommendation: To Consent Calendar",7,0,0,0,7
1976485,1555965,2025-04-23,Assembly,"Do pass. To Consent Calendar",15,0,0,0,15
1976485,1568672,2025-05-08,Assembly,"AB 898 Bryan Assembly Third Reading",73,0,0,6,79
1976485,1591167,2025-06-16,Senate,"Do pass, but first be re-referred to the Committee on [Appropriations] with the recommendation: To Consent Calendar",5,0,0,0,5
1976485,1597606,2025-07-03,Senate,"Consent Calendar 2nd AB898 Bryan",35,0,0,5,40
1976485,1601627,2025-09-09,Senate,"Assembly 3rd Reading AB898 Bryan By Menjivar",40,0,0,0,40
1976486,1558731,2025-04-21,Assembly,"Do pass and be re-referred to the Committee on [Appropriations]",14,0,0,0,14
1976486,1577461,2025-05-23,Assembly,"Do pass as amended",11,0,0,4,15
1976486,1584401,2025-06-03,Assembly,"AB 899 Ransom Assembly Third Reading",79,0,0,0,79
1976486,1598737,2025-07-16,Senate,"Do pass, but first be re-referred to the Committee on [Appropriations] with the recommendation: To Consent Calendar",8,0,0,0,8
1976486,1600047,2025-08-25,Senate,"Placed on suspense file",6,0,0,1,7
1976486,1600325,2025-08-29,Senate,"Do pass",7,0,0,0,7
1976486,1601220,2025-09-08,Senate,"Assembly 3rd Reading AB899 Ransom By Caballero",39,0,0,1,40
1976486,1601646,2025-09-09,Assembly,"AB 899 Ransom Concurrence in Senate Amendments",80,0,0,0,80
1976487,1538964,2025-04-07,Assembly,"Do pass and be re-referred to the Committee on [Appropriations]",14,0,0,0,14
1976487,1577782,2025-05-23,Assembly,"Do pass as amended",11,0,0,4,15
1976487,1583553,2025-06-02,Assembly,"AB 900 Papan Assembly Third Reading",77,0,0,2,79
1976487,1594600,2025-06-24,Senate,"Do pass as amended, but first amend, and re-refer to the Committee on [Appropriations]",7,0,0,0,7
1976487,1597704,2025-07-07,Senate,"Placed on suspense file",6,0,0,1,7
1976487,1600609,2025-08-29,Senate,"Do pass as amended",5,0,0,2,7
1976487,1601014,2025-09-03,Senate,"Assembly 3rd Reading AB900 Papan By Grove",37,0,0,3,40
1976487,1601168,2025-09-04,Assembly,"AB 900 Papan Concurrence in Senate Amendments",77,0,0,2,79
1976489,1554441,2025-04-21,Assembly,"Do pass as amended and be re-referred to the Committee on [Local Government]",11,2,0,3,16
1976489,1577179,2025-05-23,Assembly,"Do pass as amended",11,2,0,2,15
1976489,1583373,2025-06-02,Assembly,"AB 902 Schultz Assembly Third Reading",56,14,0,9,79
1976489,1594570,2025-06-24,Senate,"Do pass, but first be re-referred to the Committee on [Natural Resources and Water]",12,2,0,1,15
1976489,1597823,2025-07-08,Senate,"Do pass as amended, but first amend, and re-refer to the Committee on [Appropriations]",5,2,0,0,7
1976489,1599622,2025-08-18,Senate,"Placed on suspense file",7,0,0,0,7
1976490,1529519,2025-03-26,Assembly,"Do pass as amended and be re-referred to the Committee on [Appropriations]",9,0,0,0,9
1976491,1562971,2025-04-29,Assembly,"Do pass and be re-referred to the Committee on [Appropriations]",5,1,0,1,7
1976491,1571578,2025-05-14,Assembly,"Do pass",12,2,0,1,15
1976491,1573492,2025-05-19,Assembly,"AB 904 Aguiar-Curry Assembly Third Reading",62,4,0,13,79
1976491,1591146,2025-06-16,Senate,"Do pass, but first be re-referred to the Committee on [Appropriations]",4,0,0,1,5
1976492,1556189,2025-04-23,Assembly,"Do pass and be re-referred to the Committee on [Appropriations] with recommendation: To Consent Calendar",22,0,0,0,22
1976493,1562941,2025-04-30,Assembly,"Do pass and be re-referred to the Committee on [Local Government]",9,1,0,2,12
1976493,1564291,2025-04-30,Assembly,"Do pass and be re-referred to the Committee on [Appropriations]",8,0,0,2,10
1976493,1577231,2025-05-23,Assembly,"Do pass",11,2,0,2,15
1976493,1584333,2025-06-03,Assembly,"AB 906 Mark González Assembly Third Reading",56,13,0,10,79
1976493,1597494,2025-07-01,Senate,"Do pass, but first be re-referred to the Committee on [Appropriations]",9,2,0,0,11
1976494,1538919,2025-04-07,Assembly,"Do pass and be re-referred to the Committee on [Appropriations] with recommendation: To Consent Calendar",14,0,0,0,14
1976494,1577366,2025-05-23,Assembly,"Do pass",14,0,0,1,15
1976494,1584312,2025-06-03,Assembly,"AB 907 Chen Assembly Third Reading",49,6,0,24,79
1976495,1544991,2025-04-09,Assembly,"Do pass as amended and be re-referred to the Committee on [Appropriations]",7,2,0,0,9
1976495,1577739,2025-05-23,Assembly,"Do pass",11,2,0,2,15
1976495,1583476,2025-06-02,Assembly,"AB 908 Solache Assembly Third Reading",62,15,0,2,79
1976495,1598757,2025-07-16,Senate,"Do pass, but first be re-referred to the Committee on [Appropriations]",5,2,0,0,7
1976495,1599394,2025-08-18,Senate,"Placed on suspense file",7,0,0,0,7
1976495,1600735,2025-08-29,Senate,"Do pass",5,2,0,0,7
1976497,1556053,2025-04-22,Assembly,"Do pass and be re-referred to the Committee on [Appropriations]",13,0,0,3,16
1976498,1561172,2025-04-28,Assembly,"Do pass and be re-referred to the Committee on [Appropriations]",14,0,0,2,16
1976498,1577884,2025-05-23,Assembly,"Do pass",13,0,0,2,15
1976498,1583413,2025-06-02,Assembly,"AB 911 Carrillo Assembly Third Reading",75,1,0,3,79
1976499,1555907,2025-04-23,Assembly,"Do pass and be re-referred to the Committee on [Appropriations] with recommendation: To Consent Calendar",7,0,0,0,7
1976499,1577296,2025-05-23,Assembly,"Do pass",14,0,0,1,15
1976499,1584383,2025-06-03,Assembly,"AB 912 Wilson Assembly Third Reading",79,0,0,0,79
1976500,1562972,2025-04-30,Assembly,"Do pass and be re-referred to the Committee on [Appropriations]",9,0,0,3,12
1976500,1577491,2025-05-23,Assembly,"Do pass",11,0,0,4,15
1976500,1583426,2025-06-02,Assembly,"AB 913 Celeste Rodriguez Assembly Third Reading",78,0,0,1,79
1976500,1594581,2025-06-24,Senate,"Do pass, but first be re-referred to the Committee on [Appropriations] with the recommendation: To Consent Calendar",11,0,0,0,11
1976500,1597668,2025-07-07,Senate,"Placed on suspense file",6,0,0,1,7
1976501,1559376,2025-04-28,Assembly,"Do pass and be re-referred to the Committee on [Appropriations]",10,4,0,0,14
1976501,1577840,2025-05-23,Assembly,"Do pass as amended",11,3,0,1,15
1976502,1564265,2025-04-30,Assembly,"Do pass and be re-referred to the Committee on [Appropriations] with recommendation: To Consent Calendar",18,0,0,0,18
1976502,1577297,2025-05-23,Assembly,"Do pass as amended",11,0,0,4,15
1976502,1583472,2025-06-02,Assembly,"AB 915 Petrie-Norris Assembly Third Reading",78,0,0,1,79
1976502,1598743,2025-07-16,Senate,"Do pass as amended, but first amend, and re-refer to the Committee on [Appropriations]",7,0,0,0,7
1976502,1601887,2025-09-11,Senate,"Assembly 3rd Reading AB915 Petrie-Norris By Grove",40,0,0,0,40
1976502,1602027,2025-09-12,Assembly,"With recommendation: That Senate amendments be concurred in",13,0,0,0,13
1976502,1602091,2025-09-13,Assembly,"AB 915 Petrie-Norris Concurrence in Senate Amendments",77,0,0,3,80
1976503,1528313,2025-03-25,Assembly,"Do pass and be re-referred to the Committee on [Health]",5,2,0,0,7
1976504,1529511,2025-03-26,Assembly,"Do pass",6,2,0,1,9
1976504,1584365,2025-06-03,Assembly,"AB 917 Ávila Farías Assembly Third Reading",49,18,0,12,79
1976504,1597409,2025-07-02,Senate,"Do pass as amended, but first amend, and re-refer to the Committee on [Appropriations]",3,2,0,2,7
1976504,1597410,2025-07-02,Senate,"[First] hearing set for [07-02-2025]: Failed passage in Committee. Reconsideration granted",7,0,0,0,7
1976506,1542750,2025-04-09,Assembly,"Do pass and be re-referred to the Committee on [Appropriations]",7,0,0,0,7
1976507,1556174,2025-04-23,Assembly,"Do pass as amended and be re-referred to the Committee on [Housing and Community Development]",10,0,0,0,10
1976507,1562799,2025-04-30,Assembly,"Do pass and be re-referred to the Committee on [Appropriations] with recommendation: To Consent Calendar",10,0,0,2,12
1976507,1571598,2025-05-14,Assembly,"Do pass",15,0,0,0,15
1976507,1573608,2025-05-19,Assembly,"AB 920 Caloza Assembly Third Reading",75,0,0,4,79
1976507,1597436,2025-07-02,Senate,"Do pass, but first be re-referred to the Committee on [Housing] with the recommendation: To Consent Calendar",7,0,0,0,7
1976507,1598488,2025-07-15,Senate,"Do pass, but first be re-referred to the Committee on [Appropriations] with the recommendation: To Consent Calendar",10,0,0,1,11
1976507,1600043,2025-08-25,Senate,"Consent Calendar 2nd AB920 Caloza et al",37,0,0,3,40
1976507,1600234,2025-08-28,Assembly,"AB 920 Caloza Concurrence in Senate Amendments",76,0,0,3,79
1976509,1542885,2025-04-08,Assembly,"Do pass and be re-referred to the Committee on [Public Safety]",10,0,0,0,10
1976509,1563049,2025-04-29,Assembly,"Do pass as amended and be re-referred to the Committee on [Appropriations]",9,0,0,0,9
1976509,1571604,2025-05-14,Assembly,"Do pass",15,0,0,0,15
1976509,1577722,2025-05-23,Assembly,"AB 922 Hoover Assembly Third Reading",70,0,0,9,79
1976509,1592565,2025-06-18,Senate,"Do pass, but first be re-referred to the Committee on [Public Safety]",7,0,0,0,7
1976509,1597920,2025-07-08,Senate,"Do pass as amended, but first amend, and re-refer to the Committee on [Appropriations] with the recommendation: To Consent Calendar",6,0,0,0,6
1976509,1599554,2025-08-18,Senate,"Placed on suspense file",7,0,0,0,7
1976510,1542859,2025-04-08,Assembly,"Do pass and be re-referred to the Committee on [Appropriations]",6,0,0,3,9
1976512,1542884,2025-04-09,Assembly,"Do pass and be re-referred to the Committee on [Appropriations]",8,2,0,2,12
1976513,1526908,2025-03-25,Assembly,"Do pass and be re-referred to the Committee on [Human Services]",9,0,0,3,12
1976513,1540863,2025-04-08,Assembly,"Do pass and be re-referred to the Committee on [Appropriations]",6,0,0,0,6
1976514,1529526,2025-03-26,Assembly,"Do pass as amended, and be re-referred to the Committee on [Appropriations] with recommendation: To Consent Calendar",9,0,0,0,9
1976514,1556099,2025-04-23,Assembly,"Do pass. To Consent Calendar",15,0,0,0,15
1976514,1564193,2025-05-01,Assembly,"AB 927 Sharp-Collins Consent Calendar Second Day Regular Session",76,0,0,3,79
1976514,1589102,2025-06-11,Senate,"Do pass as amended, but first amend, and re-refer to the Committee on [Appropriations] with the recommendation: To Consent Calendar",6,0,0,1,7
1976514,1595959,2025-06-27,Senate,"Consent Calendar 2nd AB927 Sharp-Collins Urgency Clause",38,0,0,2,40
1976514,1596801,2025-06-30,Assembly,"AB 927 Sharp-Collins Concurrence in Senate Amendments",78,0,0,1,79
1976515,1528257,2025-03-26,Assembly,"Do pass and be re-referred to the Committee on [Judiciary]",6,1,0,1,8
1976515,1540892,2025-04-08,Assembly,"Do pass as amended and be re-referred to the Committee on [Appropriations]",10,1,0,1,12
1976515,1577437,2025-05-23,Assembly,"Do pass",9,2,0,4,15
1976515,1585046,2025-06-04,Assembly,"AB 928 Rogers Assembly Third Reading",46,15,0,18,79
1976516,1562888,2025-04-29,Assembly,"Do pass as amended and be re-referred to the Committee on [Appropriations]",9,3,0,1,13
1976516,1571606,2025-05-14,Assembly,"Do pass",11,4,0,0,15
1976516,1582243,2025-05-29,Assembly,"AB 929 Connolly Assembly Third Reading",45,16,0,18,79
1976516,1594582,2025-06-24,Senate,"Do pass as amended, but first amend, and re-refer to the Committee on [Appropriations]",4,3,0,0,7
1976517,1562757,2025-04-30,Assembly,"Do pass as amended and be re-referred to the Committee on [Appropriations]",5,2,0,0,7
1976517,1571565,2025-05-14,Assembly,"Do pass",11,4,0,0,15
1976517,1573551,2025-05-19,Assembly,"AB 930 Ward Assembly Third Reading",59,16,0,4,79
1976517,1597124,2025-07-01,Senate,"Do pass, but first be re-referred to the Committee on [Appropriations]",4,1,0,0,5
1976517,1601287,2025-09-08,Senate,"Assembly 3rd Reading AB930 Ward By Cervantes",29,10,0,1,40
1976517,1601451,2025-09-09,Assembly,"AB 930 Ward Concurrence in Senate Amendments",59,19,0,2,80
1976518,1540813,2025-04-08,Assembly,"Do pass as amended",12,0,0,0,12
1976518,1552945,2025-04-21,Assembly,"AB 931 Kalra Assembly Third Reading",59,0,0,20,79
1976518,1597549,2025-07-01,Senate,"Do pass as amended",11,2,0,0,13
1976518,1601097,2025-09-04,Senate,"Assembly 3rd Reading AB931 Kalra By Umberg",29,10,0,1,40
1976518,1601334,2025-09-08,Assembly,"AB 931 Kalra Concurrence in Senate Amendments",60,16,0,4,80
1976519,1540790,2025-04-08,Assembly,"Do pass as amended and be re-referred to the Committee on [Judiciary]",6,0,0,3,9
1976519,1561124,2025-04-29,Assembly,"Do pass and be re-referred to the Committee on [Appropriations]",11,0,0,1,12
1976519,1577721,2025-05-23,Assembly,"Do pass",13,0,0,2,15
1976519,1583428,2025-06-02,Assembly,"AB 932 Irwin Assembly Third Reading",65,1,0,13,79
1976519,1597466,2025-07-01,Senate,"Do pass, but first be re-referred to the Committee on [Education]",11,0,0,2,13
1976519,1598679,2025-07-16,Senate,"Do pass, but first be re-referred to the Committee on [Appropriations]",5,1,0,1,7
1976519,1599588,2025-08-18,Senate,"Placed on suspense file",7,0,0,0,7
1976519,1600533,2025-08-29,Senate,"Do pass",5,2,0,0,7
1976519,1600887,2025-09-03,Senate,"Assembly 3rd Reading AB932 Irwin et al. By Cabaldon",30,7,0,3,40
1976519,1601146,2025-09-04,Assembly,"AB 932 Irwin Concurrence in Senate Amendments",62,1,0,16,79
1976521,1555955,2025-04-22,Assembly,"Do pass and be re-referred to the Committee on [Appropriations] with recommendation: To Consent Calendar",10,0,0,0,10
1976522,1540947,2025-04-08,Assembly,"Do pass and be re-referred to the Committee on [Education]",9,1,0,2,12
1976522,1564179,2025-04-30,Assembly,"Do pass as amended and be re-referred to the Committee on [Appropriations]",7,0,0,2,9
1976522,1577878,2025-05-23,Assembly,"Do pass",11,2,0,2,15
1976522,1584338,2025-06-03,Assembly,"AB 935 Ransom Assembly Third Reading",62,10,0,7,79
1976522,1597476,2025-07-01,Senate,"Do pass as amended, but first amend, and re-refer to the Committee on [Education]",11,1,0,1,13
1976522,1598744,2025-07-16,Senate,"Do pass, but first be re-referred to the Committee on [Appropriations]",5,1,0,1,7
1976522,1599515,2025-08-18,Senate,"Placed on suspense file",7,0,0,0,7
1976522,1600451,2025-08-29,Senate,"Do pass as amended",5,2,0,0,7
1976522,1601457,2025-09-09,Senate,"Assembly 3rd Reading AB935 Ransom et al. By Weber Pierson",30,9,0,1,40
1976523,1526892,2025-03-25,Assembly,"Do pass and be re-referred to the Committee on [Appropriations] with recommendation: To Consent Calendar",7,0,0,0,7
1976524,1528265,2025-03-26,Assembly,"Do pass and be re-referred to the Committee on [Appropriations]",8,0,0,0,8
1976525,1526916,2025-03-25,Assembly,"Do pass as amended and be re-referred to the Committee on [Appropriations]",7,1,0,1,9
1976525,1577810,2025-05-23,Assembly,"Do pass",11,3,0,1,15
1976525,1583461,2025-06-02,Assembly,"AB 938 Bonta Assembly Third Reading",48,21,0,10,79
1976525,1597957,2025-07-08,Senate,"Do pass as amended, but first amend, and re-refer to the Committee on [Appropriations]",4,1,0,1,6
1976525,1599449,2025-08-18,Senate,"Placed on suspense file",7,0,0,0,7
1976527,1554480,2025-04-22,Assembly,"Do pass and be re-referred to the Committee on [Appropriations]",8,0,0,0,8
1976527,1571616,2025-05-14,Assembly,"Do pass",15,0,0,0,15
1976527,1579295,2025-05-27,Assembly,"AB 940 Wicks Assembly Third Reading",77,0,0,2,79
1976527,1594080,2025-06-23,Senate,"Do pass, but first be re-referred to the Committee on [Local Government]",10,0,0,1,11
1976527,1601781,2025-09-10,Senate,"Do pass, but first be re-referred to the Committee on [Appropriations]",9,0,0,2,11
1976527,1601897,2025-09-11,Senate,"Do pass",5,0,0,2,7
1976527,1602048,2025-09-12,Senate,"Assembly 2nd Reading AB940 Wicks et al. By Grayson",37,0,0,3,40
1976527,1602049,2025-09-13,Assembly,"AB 940 WICKS Concurrence in Senate Amendments",76,0,0,4,80
1976528,1535038,2025-04-02,Assembly,"Do pass and be re-referred to the Committee on [Natural Resources]",17,0,0,1,18
1976528,1558706,2025-04-21,Assembly,"Do pass as amended and be re-referred to the Committee on [Appropriations]",14,0,0,0,14
1976529,1564250,2025-04-30,Assembly,"Do pass as amended and be re-referred to the Committee on [Appropriations]",10,5,0,3,18
1976529,1575470,2025-05-21,Assembly,"Do pass",9,1,0,5,15
1976529,1584379,2025-06-03,Assembly,"AB 942 Calderon Assembly Third Reading",46,14,0,19,79
1976529,1598408,2025-07-15,Senate,"Do pass as amended, but first amend, and re-refer to the Committee on [Appropriations]",9,4,0,4,17
1976529,1599518,2025-08-18,Senate,"Placed on suspense file",7,0,0,0,7
1976529,1600441,2025-08-29,Senate,"Do pass, but first be re-referred to the Committee on [Rules]",5,2,0,0,7
1976530,1534987,2025-04-02,Assembly,"Do pass as amended and be re-referred to the Committee on [Appropriations]",17,0,0,0,17
1976530,1562882,2025-04-30,Assembly,"Do pass",14,0,0,1,15
1976530,1569782,2025-05-12,Assembly,"AB 943 Michelle Rodriguez Assembly Third Reading",74,0,0,5,79
1976530,1595183,2025-06-25,Senate,"Do pass, but first be re-referred to the Committee on [Appropriations]",7,0,0,0,7
1976530,1600883,2025-09-03,Senate,"Assembly 3rd Reading AB943 Michelle Rodriguez By Hurtado",40,0,0,0,40
1976530,1600884,2025-09-03,Senate,"Assembly 3rd Reading AB943 Michelle Rodriguez By Hurtado Reconsider",39,0,0,1,40
1976530,1601869,2025-09-11,Senate,"Assembly 3rd Reading AB943 Michelle Rodriguez By Hurtado",40,0,0,0,40
1976530,1602335,2025-09-13,Assembly,"AB 943 Michelle Rodriguez Concurrence in Senate Amendments",76,0,0,4,80
1976531,1561128,2025-04-28,Assembly,"Do pass and be re-referred to the Committee on [Appropriations] with recommendation: To Consent Calendar",7,0,0,0,7
1976533,1519114,2025-03-17,Assembly,"Be adopted. To Consent Calendar",10,0,0,1,11
1976533,1523625,2025-03-20,Assembly,"HR 15 Aguiar-Curry Consent Calendar Second Day Regular Session",67,0,0,13,80
1976534,1559416,2025-04-28,Assembly,"Be adopted. To third reading",9,0,0,2,11
1976535,1563001,2025-04-29,Senate,"Do pass as amended, but first amend, and re-refer to the Committee on [Appropriations]",16,0,0,1,17
1976535,1573619,2025-05-19,Senate,"Placed on suspense file",5,0,0,2,7
1976535,1577582,2025-05-23,Senate,"Do pass as amended",6,0,0,1,7
1976535,1585007,2025-06-04,Senate,"Senate 3rd Reading SB453 Stern",39,0,0,1,40
1976535,1598686,2025-07-16,Assembly,"Do pass as amended and be re-referred to the Committee on [Appropriations]",18,0,0,0,18
1976535,1599754,2025-08-20,Assembly,"Do pass",15,0,0,0,15
1976536,1536815,2025-04-02,Senate,"Do pass as amended, but first amend, and re-refer to the Committee on [Appropriations] with the recommendation: To Consent Calendar",8,0,0,0,8
1976536,1552863,2025-04-21,Senate,"Placed on suspense file",6,0,0,1,7
1976536,1577603,2025-05-23,Senate,"Do pass as amended",6,0,0,1,7
1976536,1580500,2025-05-28,Senate,"Senate 3rd Reading SB454 McNerney et al",37,0,0,3,40
1976536,1591901,2025-06-17,Assembly,"Do pass and be re-referred to the Committee on [Appropriations] with recommendation: To Consent Calendar",7,0,0,0,7
1976536,1600403,2025-08-29,Assembly,"Do pass",15,0,0,0,15
1976536,1601372,2025-09-08,Assembly,"SB 454 McNerney Senate Third Reading By Connolly",79,0,0,1,80
1976536,1601662,2025-09-09,Senate,"Unfinished Business SB454 McNerney et al. Concurrence",40,0,0,0,40
1976537,1561133,2025-04-28,Senate,"Do pass, but first be re-referred to the Committee on [Appropriations]",15,0,0,0,15
1976537,1569918,2025-05-12,Senate,"Placed on suspense file",7,0,0,0,7
1976538,1538929,2025-04-07,Senate,"Do pass, but first be re-referred to the Committee on [Appropriations]",10,0,0,1,11
1976538,1586401,2025-06-02,Senate,"Senate 3rd Reading SB456 Ashby et al",38,0,0,2,40
1976538,1594607,2025-06-24,Assembly,"Do pass and be re-referred to the Committee on [Business and Professions]",9,0,0,0,9
1976538,1597954,2025-07-08,Assembly,"Do pass and be re-referred to the Committee on [Appropriations]",17,0,0,1,18
1976538,1599732,2025-08-20,Assembly,"Do pass",15,0,0,0,15
1976538,1601186,2025-09-04,Assembly,"SB 456 Ashby Senate Third Reading By Jackson",78,0,0,1,79
1976539,1562981,2025-04-29,Senate,"Do pass",1,2,0,8,11
1976539,1562982,2025-04-29,Senate,"[First] hearing set for [04-30-2025]: Failed passage in Committee. Reconsideration granted",11,0,0,0,11
1976540,1533575,2025-04-01,Senate,"Do pass as amended, but first amend, and re-refer to the Committee on [Appropriations]",5,0,0,0,5
1976540,1552916,2025-04-21,Senate,"Placed on suspense file",6,0,0,1,7
1976541,1533549,2025-04-01,Senate,"Do pass, but first be re-referred to the Committee on [Judiciary] with the recommendation: To Consent Calendar",6,0,0,0,6
1976541,1567922,2025-05-06,Senate,"Do pass as amended, and be ordered to the Consent Calendar",12,0,0,1,13
1976541,1572382,2025-05-15,Senate,"Consent Calendar 2nd SB459 Grayson",34,0,0,6,40
1976541,1591886,2025-06-17,Assembly,"Do pass as amended, and be re-referred to the Committee on [Judiciary] with recommendation: To Consent Calendar",9,0,0,0,9
1976541,1597171,2025-07-01,Assembly,"Do pass. To Consent Calendar",12,0,0,0,12
1976541,1598153,2025-07-10,Assembly,"SB 459 Grayson Consent Calendar Second Day Regular Session",72,0,0,7,79
1976541,1600009,2025-08-25,Senate,"Special Consent SB459 Grayson",37,0,0,3,40
1976543,1540828,2025-04-08,Senate,"Do pass, but first be re-referred to the Committee on [Local Government] with the recommendation: To Consent Calendar",15,0,0,0,15
1976543,1552830,2025-04-21,Senate,"Placed on suspense file",6,0,0,1,7
1976543,1577393,2025-05-23,Senate,"Do pass",6,0,0,1,7
1976543,1581755,2025-05-29,Senate,"Special Consent SB461 Padilla",38,0,0,2,40
1976543,1595159,2025-06-25,Assembly,"Do pass and be re-referred to the Committee on [Appropriations] with recommendation: To Consent Calendar",22,0,0,0,22
1976543,1600486,2025-08-29,Assembly,"Do pass as amended",11,0,0,4,15
1976543,1602171,2025-09-12,Senate,"Unfinished Business SB461 Padilla Concurrence",37,0,0,3,40
1976543,1602172,2025-09-12,Assembly,"SB 461 Padilla Senate Third Reading By Blanca Rubio",79,0,0,1,80
1976544,1540849,2025-04-08,Senate,"Do pass, but first be re-referred to the Committee on [Appropriations]",6,0,0,1,7
1976544,1552818,2025-04-21,Senate,"Placed on suspense file",6,0,0,1,7
1976545,1540795,2025-04-08,Senate,"Do pass as amended, but first amend, and re-refer to the Committee on [Local Government] with the recommendation: To Consent Calendar",6,0,0,1,7
1976545,1565238,2025-05-05,Senate,"Placed on suspense file",7,0,0,0,7
1976546,1556093,2025-04-23,Senate,"Do pass, but first be re-referred to the Committee on [Judiciary]",4,1,0,0,5
1976546,1563068,2025-04-29,Senate,"Do pass as amended, but first amend, and re-refer to the Committee on [Appropriations]",11,0,0,2,13
1976546,1573544,2025-05-19,Senate,"Placed on suspense file",5,0,0,2,7
1976546,1577435,2025-05-23,Senate,"Do pass",5,1,0,1,7
1976546,1586440,2025-06-02,Senate,"Senate 3rd Reading SB464 Smallwood-Cuevas",27,9,0,4,40
1976546,1595659,2025-06-25,Assembly,"Do pass and be re-referred to the Committee on [Judiciary]",7,0,0,0,7
1976546,1597889,2025-07-08,Assembly,"Do pass as amended and be re-referred to the Committee on [Appropriations]",10,2,0,0,12
1976546,1600577,2025-08-29,Assembly,"Do pass as amended",11,1,0,3,15
1976546,1601513,2025-09-09,Assembly,"SB 464 Smallwood-Cuevas Senate Third Reading By McKinnor",64,7,0,9,80
1976546,1601735,2025-09-10,Senate,"Unfinished Business SB464 Smallwood-Cuevas Concurrence",30,10,0,0,40
1976547,1554612,2025-04-22,Senate,"Do pass, but first be re-referred to the Committee on [Appropriations]",14,0,0,1,15
1976547,1565275,2025-05-05,Senate,"Placed on suspense file",7,0,0,0,7
1976548,1556164,2025-04-23,Senate,"Do pass, but first be re-referred to the Committee on [Judiciary] with the recommendation: To Consent Calendar",8,0,0,0,8
1976548,1562833,2025-04-29,Senate,"Do pass as amended, but first amend, and re-refer to the Committee on [Appropriations]",13,0,0,0,13
1976548,1580523,2025-05-28,Senate,"Senate 3rd Reading SB466 Caballero",37,0,0,3,40
1976548,1597148,2025-07-01,Assembly,"Do pass and be re-referred to the Committee on [Judiciary]",7,0,0,0,7
1976548,1598490,2025-07-15,Assembly,"Do pass as amended and be re-referred to the Committee on [Appropriations]",12,0,0,0,12
1976548,1599731,2025-08-20,Assembly,"Do pass",15,0,0,0,15
1976548,1600802,2025-09-02,Assembly,"SB 466 Caballero Senate Third Reading By Soria",77,0,0,2,79
1976548,1601910,2025-09-11,Senate,"Special Consent SB466 Caballero et al",40,0,0,0,40
1976549,1526961,2025-03-25,Senate,"Do pass as amended, but first amend, and re-refer to the Committee on [Appropriations]",11,3,0,1,15
1976549,1538875,2025-04-07,Senate,"Placed on suspense file",7,0,0,0,7
1976550,1555963,2025-04-22,Senate,"Do pass, but first be re-referred to the Committee on [Appropriations]",11,0,0,2,13
1976550,1565241,2025-05-05,Senate,"Placed on suspense file",7,0,0,0,7
1976551,1562923,2025-04-30,Senate,"Do pass, but first be re-referred to the Committee on [Appropriations]",4,1,0,0,5
1976552,1526995,2025-03-25,Senate,"Do pass, but first be re-referred to the Committee on [Judiciary]",9,1,0,5,15
1976552,1542910,2025-04-08,Senate,"Do pass as amended, but first amend, and re-refer to the Committee on [Appropriations]",10,1,0,2,13
1976552,1586447,2025-06-02,Senate,"Senate 3rd Reading SB470 Laird",28,5,0,7,40
1976552,1598107,2025-07-09,Assembly,"Do pass and be re-referred to the Committee on [Appropriations]",17,5,0,0,22
1976552,1599750,2025-08-20,Assembly,"Do pass",12,2,0,1,15
1976552,1601373,2025-09-08,Assembly,"SB 470 Laird Senate Third Reading By Hart",57,13,0,10,80
1976553,1540954,2025-04-07,Senate,"Do pass, but first be re-referred to the Committee on [Judiciary] with the recommendation: To Consent Calendar",5,0,0,0,5
1976553,1555904,2025-04-22,Senate,"Do pass, but first be re-referred to the Committee on [Appropriations] with the recommendation: To Consent Calendar",13,0,0,0,13
1976553,1565261,2025-05-05,Senate,"Placed on suspense file",7,0,0,0,7
1976553,1577266,2025-05-23,Senate,"Do pass as amended",6,0,0,1,7
1976553,1585063,2025-06-04,Senate,"Special Consent SB471 Menjivar",39,0,0,1,40
1976553,1597262,2025-07-01,Assembly,"Do pass and be re-referred to the Committee on [Judiciary] with recommendation: To Consent Calendar",7,0,0,0,7
1976553,1597851,2025-07-08,Assembly,"Do pass as amended, and be re-referred to the Committee on [Appropriations] with recommendation: To Consent Calendar",12,0,0,0,12
1976553,1600731,2025-08-29,Assembly,"Do pass as amended",11,0,0,4,15
1976553,1601498,2025-09-09,Assembly,"SB 471 Menjivar Third Reading Urgency By Jeff Gonzalez",80,0,0,0,80
1976553,1601782,2025-09-10,Senate,"Unfinished Business SB471 Menjivar Urgency Clause Concurrence",40,0,0,0,40
1976554,1563026,2025-04-30,Senate,"Do pass as amended, but first amend, and re-refer to the Committee on [Appropriations]",7,0,0,0,7
1976554,1573596,2025-05-19,Senate,"Placed on suspense file",5,0,0,2,7
1976554,1577842,2025-05-23,Senate,"Do pass",6,0,0,1,7
1976554,1585038,2025-06-04,Senate,"Senate 3rd Reading SB472 Stern et al",39,0,0,1,40
1976554,1597493,2025-07-02,Assembly,"Do pass and be re-referred to the Committee on [Appropriations]",9,0,0,0,9
1976554,1600457,2025-08-29,Assembly,"Do pass",15,0,0,0,15
1976555,1538986,2025-04-07,Senate,"Do pass as amended, but first amend, and re-refer to the Committee on [Appropriations]",15,0,0,2,17
1976555,1565368,2025-05-05,Senate,"Placed on suspense file",7,0,0,0,7
1976555,1577851,2025-05-23,Senate,"Do pass",5,0,0,2,7
1976555,1584254,2025-06-03,Senate,"Senate 3rd Reading SB473 Padilla",37,0,0,3,40
1976555,1598777,2025-07-16,Assembly,"Do pass and be re-referred to the Committee on [Appropriations]",15,0,0,3,18
1976556,1563122,2025-04-30,Senate,"Do pass, but first be re-referred to the Committee on [Appropriations]",3,5,0,0,8
1976556,1563123,2025-04-30,Senate,"[First] hearing set for [04-30-2025]: Failed passage in Committee. Reconsideration granted",8,0,0,0,8
1976559,1556057,2025-04-22,Senate,"Do pass, but first be re-referred to the Committee on [Appropriations]",11,2,0,0,13
1976559,1565297,2025-05-05,Senate,"Placed on suspense file",7,0,0,0,7
1976559,1577558,2025-05-23,Senate,"Do pass",5,1,0,1,7
1976559,1580513,2025-05-28,Senate,"Senate 3rd Reading SB477 Blakespear",28,10,0,2,40
1976559,1591860,2025-06-17,Assembly,"Do pass and be re-referred to the Committee on [Appropriations]",9,2,0,1,12
1976559,1597394,2025-07-02,Assembly,"Do pass",10,4,0,1,15
1976559,1601546,2025-09-09,Assembly,"SB 477 Blakespear Senate Third Reading By Bryan",59,19,0,2,80
1976560,1542873,2025-04-09,Senate,"Do pass, but first be re-referred to the Committee on [Appropriations] with the recommendation: To Consent Calendar",7,0,0,0,7
1976560,1552837,2025-04-21,Senate,"Placed on suspense file",6,0,0,1,7
1976562,1526894,2025-03-25,Senate,"Do pass, but first be re-referred to the Committee on [Appropriations]",14,0,0,1,15
1976562,1579269,2025-05-27,Senate,"Senate 3rd Reading SB480 Archuleta",39,0,0,1,40
1976562,1597657,2025-07-07,Assembly,"Do pass and be re-referred to the Committee on [Communications and Conveyance] with recommendation: To Consent Calendar",16,0,0,0,16
1976562,1598656,2025-07-16,Assembly,"Do pass and be re-referred to the Committee on [Appropriations] with recommendation: To Consent Calendar",9,0,0,0,9
1976562,1599760,2025-08-20,Assembly,"Do pass. To Consent Calendar",15,0,0,0,15
1976562,1600208,2025-08-28,Assembly,"SB 480 Archuleta Consent Calendar Second Day Regular Session",74,0,0,5,79
1976562,1600906,2025-09-03,Senate,"Unfinished Business SB480 Archuleta Concurrence",40,0,0,0,40
1976564,1556039,2025-04-23,Senate,"Do pass, but first be re-referred to the Committee on [Elections and Constitutional Amendments] with the recommendation: To Consent Calendar",7,0,0,0,7
1976564,1561029,2025-04-29,Senate,"Do pass, but first be re-referred to the Committee on [Appropriations] with the recommendation: To Consent Calendar",5,0,0,0,5
1976564,1572411,2025-05-15,Senate,"Consent Calendar 2nd SB482 Weber Pierson",34,0,0,6,40
1976564,1597593,2025-07-02,Assembly,"Do pass and be re-referred to the Committee on [Appropriations] with recommendation: To Consent Calendar",10,0,0,0,10
1976564,1598623,2025-07-16,Assembly,"Do pass. To Consent Calendar",13,0,0,2,15
1976564,1601658,2025-09-09,Assembly,"SB 482 Weber Pierson Senate Third Reading By Ta",80,0,0,0,80
1976564,1601817,2025-09-10,Senate,"Unfinished Business SB482 Weber Pierson Concurrence",40,0,0,0,40
1976565,1526948,2025-03-25,Senate,"Do pass, but first be re-referred to the Committee on [Appropriations]",6,0,0,0,6
1976565,1538917,2025-04-07,Senate,"Placed on suspense file",7,0,0,0,7
1976565,1577149,2025-05-23,Senate,"Do pass as amended",6,0,0,1,7
1976565,1584997,2025-06-04,Senate,"Senate 3rd Reading SB483 Stern",38,0,0,2,40
1976565,1598634,2025-07-15,Assembly,"Do pass and be re-referred to the Committee on [Appropriations] with recommendation: To Consent Calendar",9,0,0,0,9
1976566,1540859,2025-04-08,Senate,"Do pass, but first be re-referred to the Committee on [Housing]",6,0,0,1,7
1976566,1562840,2025-04-29,Senate,"Do pass as amended, but first amend, and re-refer to the Committee on [Appropriations]",11,0,0,0,11
1976566,1573621,2025-05-19,Senate,"Placed on suspense file",5,0,0,2,7
1976566,1577223,2025-05-23,Senate,"Do pass as amended",6,0,0,1,7
1976566,1580497,2025-05-28,Senate,"Senate 3rd Reading SB484 Laird",37,0,0,3,40
1976566,1594067,2025-06-23,Assembly,"Do pass as amended, and be re-referred to the Committee on [Housing and Community Development] with recommendation: To Consent Calendar",14,0,0,0,14
1976566,1598704,2025-07-16,Assembly,"Do pass and be re-referred to the Committee on [Appropriations] with recommendation: To Consent Calendar",12,0,0,0,12
1976566,1600562,2025-08-29,Assembly,"Do pass",15,0,0,0,15
1976566,1601112,2025-09-04,Assembly,"SB 484 Laird Senate Third Reading By Haney",76,0,0,3,79
1976566,1601293,2025-09-08,Senate,"Unfinished Business SB484 Laird Concurrence",39,0,0,1,40
1976567,1536800,2025-04-02,Senate,"Do pass as amended, but first amend, and re-refer to the Committee on [Public Safety] with the recommendation: To Consent Calendar",7,0,0,0,7
1976567,1554506,2025-04-22,Senate,"Do pass, but first be re-referred to the Committee on [Appropriations] with the recommendation: To Consent Calendar",6,0,0,0,6
1976567,1568678,2025-05-08,Senate,"Consent Calendar 2nd SB485 Reyes",36,0,0,4,40
1976567,1597602,2025-07-02,Assembly,"Do pass and be re-referred to the Committee on [Public Safety]",7,1,0,2,10
1976567,1598594,2025-07-15,Assembly,"Do pass and be re-referred to the Committee on [Appropriations]",7,0,0,2,9
1976567,1600337,2025-08-29,Assembly,"Do pass",12,2,0,1,15
1976567,1601583,2025-09-09,Assembly,"SB 485 Reyes Senate Third Reading By Schultz",62,12,0,6,80
1976567,1601932,2025-09-11,Senate,"Unfinished Business SB485 Reyes Concurrence",40,0,0,0,40
1976568,1533502,2025-04-01,Senate,"Do pass as amended, but first amend, and re-refer to the Committee on [Environmental Quality]",11,0,0,0,11
1976568,1562873,2025-04-30,Senate,"Do pass, but first be re-referred to the Committee on [Appropriations]",8,0,0,0,8
1976568,1579265,2025-05-27,Senate,"Senate 3rd Reading SB486 Cabaldon",39,0,0,1,40
1976568,1592614,2025-06-18,Assembly,"Do pass and be re-referred to the Committee on [Natural Resources]",11,0,0,1,12
1976568,1598280,2025-07-14,Assembly,"Do pass as amended and be re-referred to the Committee on [Appropriations]",13,0,0,1,14
1976568,1599756,2025-08-20,Assembly,"Do pass",15,0,0,0,15
1976568,1601465,2025-09-09,Assembly,"SB 486 Cabaldon Senate Third Reading By Fong",79,0,0,1,80
1976568,1601729,2025-09-10,Senate,"Unfinished Business SB486 Cabaldon Concurrence",38,0,0,2,40
1976569,1562804,2025-04-30,Senate,"Do pass, but first be re-referred to the Committee on [Appropriations]",5,0,0,0,5
1976569,1573633,2025-05-19,Senate,"Placed on suspense file",5,0,0,2,7
1976569,1577423,2025-05-23,Senate,"Do pass",6,0,0,1,7
1976569,1580509,2025-05-28,Senate,"Senate 3rd Reading SB487 Grayson",37,0,0,3,40
1976569,1598590,2025-07-16,Assembly,"Do pass and be re-referred to the Committee on [Appropriations]",16,0,0,1,17
1976569,1600718,2025-08-29,Assembly,"Do pass as amended",11,0,0,4,15
1976569,1602269,2025-09-12,Senate,"Unfinished Business SB487 Grayson et al. Concurrence",37,0,0,3,40
1976569,1602270,2025-09-12,Assembly,"SB 487 Grayson Senate Third Reading By Gipson",72,0,0,8,80
1976571,1556155,2025-04-23,Senate,"Do pass, but first be re-referred to the Committee on [Housing]",6,1,0,0,7
1976571,1562803,2025-04-29,Senate,"Do pass, but first be re-referred to the Committee on [Appropriations]",11,0,0,0,11
1976571,1579277,2025-05-27,Senate,"Senate 3rd Reading SB489 Arreguín",39,0,0,1,40
1976571,1592582,2025-06-18,Assembly,"Do pass and be re-referred to the Committee on [Housing and Community Development]",10,0,0,0,10
1976571,1598583,2025-07-16,Assembly,"Do pass as amended, and be re-referred to the Committee on [Appropriations] with recommendation: To Consent Calendar",12,0,0,0,12
1976571,1599772,2025-08-20,Assembly,"Do pass. To Consent Calendar",15,0,0,0,15
1976571,1601010,2025-09-03,Assembly,"SB 489 Arreguín Senate Third Reading By Alvarez",78,0,0,1,79
1976571,1601161,2025-09-04,Senate,"Unfinished Business SB489 Arreguín Concurrence",39,0,0,1,40
1976573,1525461,2025-03-24,Senate,"Do pass, but first be re-referred to the Committee on [Appropriations]",16,0,0,1,17
1976573,1579240,2025-05-27,Senate,"Senate 3rd Reading SB491 Laird et al",39,0,0,1,40
1976573,1595204,2025-06-25,Assembly,"Do pass and be re-referred to the Committee on [Appropriations] with recommendation: To Consent Calendar",18,0,0,0,18
1976575,1561096,2025-04-29,Senate,"Do pass, but first be re-referred to the Committee on [Appropriations]",4,0,0,1,5
1976575,1569912,2025-05-12,Senate,"Placed on suspense file",7,0,0,0,7
1976575,1577893,2025-05-23,Senate,"Do pass as amended",6,0,0,1,7
1976575,1581685,2025-05-29,Senate,"Senate 3rd Reading SB493 Becker et al",38,0,0,2,40
1976575,1597520,2025-07-02,Assembly,"Do pass and be re-referred to the Committee on [Appropriations]",8,0,0,0,8
1976575,1599768,2025-08-20,Assembly,"Do pass",15,0,0,0,15
1976575,1600246,2025-08-28,Assembly,"SB 493 Becker Senate Third Reading By Wilson",75,1,0,3,79
1976576,1528289,2025-03-26,Senate,"Do pass, but first be re-referred to the Committee on [Education]",4,1,0,0,5
1976576,1555988,2025-04-23,Senate,"Do pass, but first be re-referred to the Committee on [Appropriations]",5,2,0,0,7
1976576,1565327,2025-05-05,Senate,"Placed on suspense file",7,0,0,0,7
1976576,1577939,2025-05-23,Senate,"Do pass",5,1,0,1,7
1976576,1586437,2025-06-02,Senate,"Senate 3rd Reading SB494 Cortese",27,10,0,3,40
1976576,1595189,2025-06-25,Assembly,"Do pass and be re-referred to the Committee on [Higher Education]",5,0,0,2,7
1976576,1597884,2025-07-08,Assembly,"Do pass as amended and be re-referred to the Committee on [Appropriations]",6,3,0,1,10
1976576,1600651,2025-08-29,Assembly,"Do pass",11,3,0,1,15
1976577,1556105,2025-04-23,Senate,"Do pass, but first be re-referred to the Committee on [Judiciary]",5,2,0,0,7
1976577,1563109,2025-04-29,Senate,"Do pass, but first be re-referred to the Committee on [Appropriations]",11,2,0,0,13
1976577,1569896,2025-05-12,Senate,"Placed on suspense file",7,0,0,0,7
1976577,1577331,2025-05-23,Senate,"Do pass",5,1,0,1,7
1976577,1584336,2025-06-03,Senate,"Senate 3rd Reading SB495 Allen",28,10,0,2,40
1976577,1598116,2025-07-09,Assembly,"Do pass as amended and be re-referred to the Committee on [Judiciary]",15,0,0,2,17
1976577,1598471,2025-07-15,Assembly,"Do pass as amended and be re-referred to the Committee on [Appropriations]",12,0,0,0,12
1976577,1600659,2025-08-29,Assembly,"Do pass",14,0,0,1,15
1976577,1602136,2025-09-12,Senate,"Unfinished Business SB495 Allen et al. Concurrence",28,6,0,6,40
1976577,1602137,2025-09-13,Assembly,"SB 495 Allen Senate Third Reading By Harabedian",78,0,0,2,80
1976578,1536859,2025-04-02,Senate,"Do pass as amended, but first amend, and re-refer to the Committee on [Transportation]",8,0,0,0,8
1976578,1554544,2025-04-22,Senate,"Do pass, but first be re-referred to the Committee on [Appropriations]",15,0,0,0,15
1976578,1565361,2025-05-05,Senate,"Placed on suspense file",7,0,0,0,7
1976579,1542768,2025-04-08,Senate,"Do pass, but first be re-referred to the Committee on [Public Safety]",11,2,0,0,13
1976579,1562808,2025-04-29,Senate,"Do pass, but first be re-referred to the Committee on [Appropriations]",5,1,0,0,6
1976579,1569771,2025-05-12,Senate,"Placed on suspense file",7,0,0,0,7
1976579,1577244,2025-05-23,Senate,"Do pass as amended",5,1,0,1,7
1976579,1586422,2025-06-02,Senate,"Senate 3rd Reading SB497 Wiener et al. Urgency Clause",28,10,0,2,40
1976579,1591874,2025-06-17,Assembly,"Do pass and be re-referred to the Committee on [Public Safety]",9,2,0,1,12
1976579,1598576,2025-07-15,Assembly,"Do pass and be re-referred to the Committee on [Appropriations]",7,1,0,1,9
1976579,1600764,2025-08-29,Assembly,"Do pass",11,4,0,0,15
1976579,1601580,2025-09-09,Assembly,"SB 497 Wiener Third Reading Urgency By Ward",61,17,0,2,80
1976579,1601787,2025-09-10,Senate,"Unfinished Business SB497 Wiener et al. Urgency Clause Concurrence",30,10,0,0,40
1976580,1526981,2025-03-25,Senate,"Do pass, but first be re-referred to the Committee on [Appropriations]",5,0,0,1,6
1976580,1538872,2025-04-07,Senate,"Placed on suspense file",7,0,0,0,7
1976580,1577425,2025-05-23,Senate,"Do pass as amended",6,0,0,1,7
1976580,1585089,2025-06-04,Senate,"Senate 3rd Reading SB498 Becker",39,0,0,1,40
1976581,1567894,2025-05-07,Senate,"Do pass as amended",6,1,0,0,7
1976581,1580488,2025-05-28,Senate,"Senate 3rd Reading SB499 Stern",29,1,0,10,40
1976581,1597591,2025-07-02,Assembly,"Do pass as amended",7,0,0,3,10
1976581,1600909,2025-09-03,Assembly,"SB 499 Stern Senate Third Reading By Ransom",46,12,0,21,79
1976581,1601720,2025-09-10,Senate,"Unfinished Business SB499 Stern Concurrence",31,1,0,8,40
1976582,1563024,2025-04-29,Senate,"Do pass as amended, but first amend, and re-refer to the Committee on [Appropriations]",13,3,0,1,17
1976582,1573611,2025-05-19,Senate,"Placed on suspense file",5,0,0,2,7
1976582,1577548,2025-05-23,Senate,"Do pass as amended",5,1,0,1,7
1976582,1585093,2025-06-04,Senate,"Senate 3rd Reading SB500 Stern",29,10,0,1,40
1976582,1598134,2025-07-09,Assembly,"Do pass and be re-referred to the Committee on [Appropriations] with recommendation: To Consent Calendar",18,0,0,0,18
1976582,1600732,2025-08-29,Assembly,"Do pass",15,0,0,0,15
1976582,1601896,2025-09-11,Senate,"That the Assembly amendments be concurred in",12,0,0,5,17
1976582,1602161,2025-09-12,Senate,"Unfinished Business SB500 Stern Concurrence",34,0,0,6,40
1976583,1536758,2025-04-02,Senate,"Do pass as amended, but first amend, and re-refer to the Committee on [Judiciary]",6,0,0,2,8
1976583,1555946,2025-04-22,Senate,"Do pass, but first be re-referred to the Committee on [Appropriations]",11,0,0,2,13
1976583,1565235,2025-05-05,Senate,"Placed on suspense file",7,0,0,0,7
1976584,1555911,2025-04-22,Senate,"Do pass as amended, but first amend, and re-refer to the Committee on [Education]",9,1,0,1,11
1976584,1569812,2025-05-12,Senate,"Placed on suspense file",7,0,0,0,7
1976585,1545037,2025-04-09,Senate,"Do pass as amended, but first amend, and re-refer to the Committee on [Governmental Organization]",10,0,0,1,11
1976585,1562901,2025-04-29,Senate,"Do pass, but first be re-referred to the Committee on [Appropriations]",13,0,0,0,13
1976585,1569761,2025-05-12,Senate,"Placed on suspense file",7,0,0,0,7
1976585,1577677,2025-05-23,Senate,"Do pass",6,0,0,1,7
1976585,1581762,2025-05-29,Senate,"Special Consent SB503 Weber Pierson et al",38,0,0,2,40
1976585,1598140,2025-07-08,Assembly,"Do pass as amended and be re-referred to the Committee on [Privacy and Consumer Protection]",16,0,0,0,16
1976585,1598630,2025-07-16,Assembly,"Do pass as amended and be re-referred to the Committee on [Appropriations]",13,0,0,2,15
1976585,1600294,2025-08-29,Assembly,"Do pass",15,0,0,0,15
1976586,1528281,2025-03-26,Senate,"Do pass as amended, but first amend, and re-refer to the Committee on [Judiciary] with the recommendation: To Consent Calendar",10,0,0,1,11
1976586,1556045,2025-04-22,Senate,"Do pass as amended, but first amend, and re-refer to the Committee on [Appropriations] with the recommendation: To Consent Calendar",13,0,0,0,13
1976586,1568616,2025-05-08,Senate,"Consent Calendar 2nd SB504 Laird et al",36,0,0,4,40
1976586,1594624,2025-06-24,Assembly,"Do pass as amended and be re-referred to the Committee on [Privacy and Consumer Protection]",15,0,0,1,16
1976586,1598588,2025-07-16,Assembly,"Do pass and be re-referred to the Committee on [Appropriations] with recommendation: To Consent Calendar",15,0,0,0,15
1976586,1599733,2025-08-20,Assembly,"Do pass. To Consent Calendar",15,0,0,0,15
1976586,1601376,2025-09-08,Assembly,"SB 504 Laird Senate Third Reading By Mark González",79,0,0,1,80
1976586,1601526,2025-09-09,Senate,"Unfinished Business SB504 Laird et al. Concurrence",40,0,0,0,40
1976588,1542844,2025-04-08,Senate,"Do pass, but first be re-referred to the Committee on [Appropriations] with the recommendation: To Consent Calendar",15,0,0,0,15
1976588,1557494,2025-04-24,Senate,"Consent Calendar 2nd SB506 TRANS. (Cortese)",37,0,0,3,40
1976588,1598409,2025-07-14,Assembly,"Do pass and be re-referred to the Committee on [Appropriations] with recommendation: To Consent Calendar",16,0,0,0,16
1976588,1599751,2025-08-20,Assembly,"Do pass. To Consent Calendar",15,0,0,0,15
1976588,1600213,2025-08-28,Assembly,"SB 506 Transportation Consent Calendar Second Day Regular Session",74,0,0,5,79
1976588,1601978,2025-09-11,Senate,"Special Consent SB506 TRANS. (Cortese)",40,0,0,0,40
1976589,1563102,2025-04-29,Senate,"Do pass as amended, but first amend, and re-refer to the Committee on [Appropriations]",11,0,0,0,11
1976589,1586438,2025-06-02,Senate,"Senate 3rd Reading SB507 Limón",38,0,0,2,40
1976589,1597530,2025-07-02,Assembly,"Do pass and be re-referred to the Committee on [Local Government] with recommendation: To Consent Calendar",12,0,0,0,12
1976589,1598886,2025-07-16,Assembly,"Do pass and be re-referred to the Committee on [Appropriations] with recommendation: To Consent Calendar",10,0,0,0,10
1976589,1599729,2025-08-20,Assembly,"Do pass. To Consent Calendar",15,0,0,0,15
1976589,1600201,2025-08-28,Assembly,"SB 507 Limón Consent Calendar Second Day Regular Session",74,0,0,5,79
1976589,1601002,2025-09-03,Senate,"Unfinished Business SB507 Limón Concurrence",40,0,0,0,40
1976590,1538994,2025-04-07,Senate,"Do pass, but first be re-referred to the Committee on [Appropriations]",10,0,0,1,11
1976590,1579246,2025-05-27,Senate,"Senate 3rd Reading SB508 Valladares et al",39,0,0,1,40
1976591,1533518,2025-04-01,Senate,"Do pass, but first be re-referred to the Committee on [Governmental Organization]",6,0,0,0,6
1976591,1540963,2025-04-08,Senate,"Do pass, but first be re-referred to the Committee on [Appropriations]",15,0,0,0,15
1976591,1552902,2025-04-21,Senate,"Placed on suspense file",6,0,0,1,7
1976591,1577151,2025-05-23,Senate,"Do pass",6,0,0,1,7
1976591,1584408,2025-06-03,Senate,"Senate 3rd Reading SB509 Caballero et al",38,0,0,2,40
1976591,1598452,2025-07-14,Assembly,"Do pass as amended and be re-referred to the Committee on [Appropriations]",5,0,0,2,7
1976591,1600748,2025-08-29,Assembly,"Do pass",12,0,0,3,15
1976591,1601898,2025-09-11,Senate,"Unfinished Business SB509 Caballero et al. Concurrence",40,0,0,0,40
1976592,1562834,2025-04-30,Senate,"Do pass, but first be re-referred to the Committee on [Appropriations]",7,0,0,0,7
1976592,1579247,2025-05-27,Senate,"Senate 3rd Reading SB510 Richardson et al",39,0,0,1,40
1976592,1597417,2025-07-02,Assembly,"Do pass and be re-referred to the Committee on [Appropriations] with recommendation: To Consent Calendar",9,0,0,0,9
1976592,1598651,2025-07-16,Assembly,"Do pass. To Consent Calendar",13,0,0,2,15
1976592,1599864,2025-08-21,Assembly,"SB 510 Richardson Consent Calendar Second Day Regular Session",77,0,0,2,79
1976594,1526897,2025-03-25,Senate,"Do pass, but first be re-referred to the Committee on [Appropriations] with the recommendation: To Consent Calendar",13,0,0,2,15
1976594,1545024,2025-04-10,Senate,"Consent Calendar 2nd SB512 McGuire",35,0,0,5,40
1976594,1598629,2025-07-16,Assembly,"Do pass as amended and be re-referred to the Committee on [Appropriations]",5,2,0,0,7
1976594,1599776,2025-08-20,Assembly,"Do pass",11,4,0,0,15
1976594,1601148,2025-09-04,Assembly,"SB 512 Pérez Senate Third Reading By Wicks",50,19,0,10,79
1976594,1601624,2025-09-09,Senate,"That the Assembly amendments be concurred in",3,1,0,1,5
1976594,1601863,2025-09-11,Senate,"Unfinished Business SB512 Pérez et al. Concurrence",30,10,0,0,40
1976595,1528247,2025-03-26,Senate,"Do pass, but first be re-referred to the Committee on [Appropriations]",4,1,0,0,5
1976595,1580526,2025-05-28,Senate,"Senate 3rd Reading SB513 Durazo et al",29,9,0,2,40
1976595,1598034,2025-07-09,Assembly,"Do pass and be re-referred to the Committee on [Appropriations]",7,0,0,0,7
1976595,1599734,2025-08-20,Assembly,"Do pass",14,0,0,1,15
1976595,1600923,2025-09-03,Assembly,"SB 513 Durazo Senate Third Reading By Kalra",78,0,0,1,79
1976596,1540936,2025-04-08,Senate,"Do pass as amended, but first amend, and re-refer to the Committee on [Appropriations] with the recommendation: To Consent Calendar",6,0,0,1,7
1976596,1559501,2025-04-28,Senate,"Placed on suspense file",7,0,0,0,7
1976596,1577202,2025-05-23,Senate,"Do pass",6,0,0,1,7
1976596,1581686,2025-05-29,Senate,"Special Consent SB514 Cabaldon",38,0,0,2,40
1976596,1597721,2025-07-07,Assembly,"Do pass and be re-referred to the Committee on [Appropriations] with recommendation: To Consent Calendar",14,0,0,0,14
1976596,1600666,2025-08-29,Assembly,"Do pass as amended",11,0,0,4,15
1976596,1601377,2025-09-08,Assembly,"SB 514 Cabaldon Senate Third Reading By Bryan",79,0,0,1,80
1976596,1601461,2025-09-09,Senate,"Unfinished Business SB514 Cabaldon Concurrence",40,0,0,0,40
1976597,1536776,2025-04-02,Senate,"Do pass as amended, but first amend, and re-refer to the Committee on [Appropriations]",5,2,0,0,7
1976597,1552900,2025-04-21,Senate,"Placed on suspense file",6,0,0,1,7
1976597,1577549,2025-05-23,Senate,"Do pass",5,1,0,1,7
1976597,1581767,2025-05-29,Senate,"Senate 3rd Reading SB515 Richardson",28,10,0,2,40
1976597,1597561,2025-07-02,Assembly,"Do pass and be re-referred to the Committee on [Appropriations]",8,0,0,2,10
1976597,1600550,2025-08-29,Assembly,"Do pass",11,3,0,1,15
1976598,1567881,2025-05-07,Senate,"Do pass",6,0,0,1,7
1976598,1584237,2025-06-03,Senate,"Senate 3rd Reading SB516 Ashby",38,0,0,2,40
1976598,1598835,2025-07-16,Assembly,"Do pass as amended",10,0,0,0,10
1976598,1601378,2025-09-08,Assembly,"SB 516 Ashby Senate Third Reading By Haney",79,0,0,1,80
1976598,1601716,2025-09-10,Senate,"Unfinished Business SB516 Ashby Concurrence",40,0,0,0,40
1976599,1552817,2025-04-21,Senate,"Do pass, but first be re-referred to the Committee on [Judiciary]",11,0,0,0,11
1976599,1562831,2025-04-29,Senate,"Do pass as amended, but first amend, and re-refer to the Committee on [Appropriations] with the recommendation: To Consent Calendar",13,0,0,0,13
1976599,1572462,2025-05-15,Senate,"Consent Calendar 2nd SB517 Niello",34,0,0,6,40
1976599,1594691,2025-06-24,Assembly,"Do pass and be re-referred to the Committee on [Judiciary] with recommendation: To Consent Calendar",16,0,0,2,18
1976599,1597895,2025-07-08,Assembly,"Do pass and be re-referred to the Committee on [Appropriations] with recommendation: To Consent Calendar",12,0,0,0,12
1976599,1598653,2025-07-16,Assembly,"Do pass. To Consent Calendar",13,0,0,2,15
1976599,1601379,2025-09-08,Assembly,"SB 517 Niello Senate Third Reading By Hoover",78,0,0,2,80
1976599,1601904,2025-09-11,Senate,"Unfinished Business SB517 Niello Concurrence",40,0,0,0,40
1976600,1556089,2025-04-22,Senate,"Do pass as amended, but first amend, and re-refer to the Committee on [Appropriations]",11,2,0,0,13
1976600,1565256,2025-05-05,Senate,"Placed on suspense file",7,0,0,0,7
1976600,1577263,2025-05-23,Senate,"Do pass as amended",5,1,0,1,7
1976600,1586392,2025-06-02,Senate,"Senate 3rd Reading SB518 Weber Pierson et al",28,10,0,2,40
1976600,1597186,2025-07-01,Assembly,"Do pass as amended and be re-referred to the Committee on [Appropriations]",9,3,0,0,12
1976600,1600404,2025-08-29,Assembly,"Do pass as amended",11,4,0,0,15
1976600,1601569,2025-09-09,Assembly,"SB 518 Weber Pierson Senate Third Reading By Jackson",60,17,0,3,80
1976600,1601798,2025-09-10,Senate,"Unfinished Business SB518 Weber Pierson et al. Concurrence",30,10,0,0,40
1976601,1559365,2025-04-28,Senate,"Do pass, but first be re-referred to the Committee on [Appropriations] with the recommendation: To Consent Calendar",4,0,0,1,5
1976602,1564165,2025-04-30,Senate,"Do pass, but first be re-referred to the Committee on [Appropriations] with the recommendation: To Consent Calendar",11,0,0,0,11
1976602,1569789,2025-05-12,Senate,"Placed on suspense file",7,0,0,0,7
1976602,1577391,2025-05-23,Senate,"Do pass",6,0,0,1,7
1976602,1581771,2025-05-29,Senate,"Special Consent SB520 Caballero et al",38,0,0,2,40
1976602,1594684,2025-06-24,Assembly,"Do pass and be re-referred to the Committee on [Higher Education] with recommendation: To Consent Calendar",15,0,0,1,16
1976602,1597810,2025-07-08,Assembly,"Do pass and be re-referred to the Committee on [Appropriations]",9,0,0,1,10
1976602,1600645,2025-08-29,Assembly,"Do pass",15,0,0,0,15
1976602,1601380,2025-09-08,Assembly,"SB 520 Caballero Senate Third Reading By Bonta",79,0,0,1,80
1976603,1556166,2025-04-23,Senate,"Do pass as amended, but first amend, and re-refer to the Committee on [Appropriations] with the recommendation: To Consent Calendar",5,0,0,0,5
1976603,1568597,2025-05-08,Senate,"Consent Calendar 2nd SB521 Gonzalez",36,0,0,4,40
1976603,1595168,2025-06-25,Assembly,"Do pass and be re-referred to the Committee on [Appropriations] with recommendation: To Consent Calendar",7,0,0,0,7
1976603,1597462,2025-07-02,Assembly,"Do pass. To Consent Calendar",14,0,0,1,15
1976603,1598223,2025-07-14,Assembly,"SB 521 Gonzalez Consent Calendar Second Day Regular Session",77,0,0,2,79
1976604,1542696,2025-04-08,Senate,"Do pass, but first be re-referred to the Committee on [Local Government]",10,2,0,1,13
1976604,1584349,2025-06-03,Senate,"Senate 3rd Reading SB522 Wahab et al",27,10,0,3,40
1976604,1598042,2025-07-09,Assembly,"Do pass and be re-referred to the Committee on [Judiciary]",7,5,0,0,12
1976604,1598516,2025-07-15,Assembly,"Do pass",8,3,0,1,12
1976606,1525417,2025-03-24,Senate,"Be adopted as amended",16,0,0,1,17
1976606,1538979,2025-04-07,Senate,"Senate 3rd Reading SCR25 Blakespear et al",36,0,0,4,40
1976606,1595138,2025-06-25,Assembly,"Be adopted as amended. To Consent Calendar",18,0,0,0,18
1976606,1597571,2025-07-03,Assembly,"SCR 25 Blakespear Consent Calendar Second Day",74,0,0,5,79
1976606,1599991,2025-08-25,Senate,"Special Consent SCR25 Blakespear et al",37,0,0,3,40
1976607,1501955,2025-02-27,Senate,"Senate 3rd Reading SR17 Rubio et al",36,0,0,3,39
1976608,1501952,2025-02-27,Senate,"Senate 3rd Reading SR18 Richardson",36,0,0,3,39
1978537,1554521,2025-04-22,Assembly,"Do pass and be re-referred to the Committee on [Judiciary]",17,0,0,1,18
1978537,1561050,2025-04-29,Assembly,"Do pass and be re-referred to the Committee on [Appropriations]",10,0,0,2,12
1978537,1577883,2025-05-23,Assembly,"Do pass",13,0,0,2,15
1978537,1583479,2025-06-02,Assembly,"AB 1002 Gabriel Assembly Third Reading",74,1,0,4,79
1978537,1597764,2025-07-07,Senate,"Do pass, but first be re-referred to the Committee on [Judiciary]",10,1,0,0,11
1978537,1598587,2025-07-15,Senate,"Do pass, but first be re-referred to the Committee on [Appropriations]",11,2,0,0,13
1978537,1599608,2025-08-18,Senate,"Placed on suspense file",7,0,0,0,7
1978537,1600285,2025-08-29,Senate,"Do pass",7,0,0,0,7
1978537,1601159,2025-09-04,Senate,"Assembly 3rd Reading AB1002 Gabriel et al. By Durazo",34,2,0,4,40
1978537,1601298,2025-09-08,Assembly,"AB 1002 Gabriel Concurrence in Senate Amendments",73,2,0,5,80
1978538,1540950,2025-04-08,Assembly,"Do pass and be re-referred to the Committee on [Emergency Management] with recommendation: To Consent Calendar",15,0,0,0,15
1978538,1561063,2025-04-28,Assembly,"Do pass and be re-referred to the Committee on [Appropriations] with recommendation: To Consent Calendar",7,0,0,0,7
1978538,1577776,2025-05-23,Assembly,"Do pass as amended",11,0,0,4,15
1978538,1584233,2025-06-03,Assembly,"AB 1003 Calderon Assembly Third Reading",79,0,0,0,79
1978538,1597391,2025-07-02,Senate,"Do pass, but first be re-referred to the Committee on [Governmental Organization] with the recommendation: To Consent Calendar",11,0,0,0,11
1978538,1597965,2025-07-08,Senate,"Do pass, but first be re-referred to the Committee on [Appropriations] with the recommendation: To Consent Calendar",15,0,0,0,15
1978538,1600915,2025-09-03,Senate,"Assembly 3rd Reading AB1003 Calderon By Smallwood-Cuevas",40,0,0,0,40
1978538,1601194,2025-09-04,Assembly,"AB 1003 Calderon Concurrence in Senate Amendments",75,0,0,4,79
1978539,1540967,2025-04-08,Assembly,"Do pass as amended, and be re-referred to the Committee on [Appropriations] with recommendation: To Consent Calendar",12,0,0,0,12
1978539,1555972,2025-04-23,Assembly,"Do pass. To Consent Calendar",15,0,0,0,15
1978539,1564285,2025-05-01,Assembly,"AB 1004 Wallis Consent Calendar Second Day Regular Session",76,0,0,3,79
1978539,1591900,2025-06-17,Senate,"Do pass, but first be re-referred to the Committee on [Appropriations]",12,0,0,1,13
1978539,1600982,2025-09-03,Senate,"Assembly 3rd Reading AB1004 Wallis By Allen",40,0,0,0,40
1978539,1601114,2025-09-04,Assembly,"AB 1004 Wallis Concurrence in Senate Amendments",77,0,0,2,79
1978540,1545020,2025-04-09,Assembly,"Do pass as amended and be re-referred to the Committee on [Appropriations]",9,0,0,0,9
1978540,1577896,2025-05-23,Assembly,"Do pass as amended",14,0,0,1,15
1978540,1584294,2025-06-03,Assembly,"AB 1005 Davies Assembly Third Reading",77,0,0,2,79
1978540,1598076,2025-07-09,Senate,"Do pass, but first be re-referred to the Committee on [Health]",7,0,0,0,7
1978540,1598832,2025-07-16,Senate,"Do pass as amended, but first amend, and re-refer to the Committee on [Appropriations] with the recommendation: To Consent Calendar",10,0,0,1,11
1978540,1599368,2025-08-18,Senate,"Placed on suspense file",7,0,0,0,7
1978540,1600450,2025-08-29,Senate,"Do pass as amended",7,0,0,0,7
1978540,1601890,2025-09-11,Senate,"Special Consent AB1005 Davies et al. By Blakespear",40,0,0,0,40
1978540,1602185,2025-09-12,Assembly,"AB 1005 Davies Concurrence in Senate Amendments",79,0,0,1,80
1978541,1542850,2025-04-08,Assembly,"Do pass as amended and be re-referred to the Committee on [Appropriations]",9,0,0,0,9
1978542,1542711,2025-04-09,Assembly,"Do pass and be re-referred to the Committee on [Housing and Community Development]",10,0,0,0,10
1978542,1563003,2025-04-30,Assembly,"Do pass and be re-referred to the Committee on [Appropriations] with recommendation: To Consent Calendar",10,0,0,2,12
1978542,1571603,2025-05-14,Assembly,"Do pass. To Consent Calendar",15,0,0,0,15
1978542,1577302,2025-05-23,Assembly,"AB 1007 Blanca Rubio Consent Calendar Second Day Regular Session",71,0,0,8,79
1978542,1597404,2025-07-02,Senate,"Do pass, but first be re-referred to the Committee on [Appropriations] with the recommendation: To Consent Calendar",7,0,0,0,7
1978542,1598230,2025-07-14,Senate,"Placed on suspense file",7,0,0,0,7
1978542,1600539,2025-08-29,Senate,"Do pass as amended",7,0,0,0,7
1978542,1601884,2025-09-11,Senate,"Special Consent AB1007 Blanca Rubio et al. By Ashby",40,0,0,0,40
1978542,1602169,2025-09-12,Assembly,"AB 1007 Blanca Rubio Concurrence in Senate Amendments",80,0,0,0,80
1978543,1556012,2025-04-23,Assembly,"Do pass and be re-referred to the Committee on [Appropriations]",21,0,0,1,22
1978543,1567851,2025-05-07,Assembly,"Do pass",15,0,0,0,15
1978543,1569772,2025-05-12,Assembly,"AB 1008 Addis Assembly Third Reading",78,0,0,1,79
1978543,1588063,2025-06-10,Senate,"Do pass, but first be re-referred to the Committee on [Appropriations]",14,0,0,1,15
1978543,1600816,2025-09-02,Senate,"Assembly 3rd Reading AB1008 Addis By Laird",40,0,0,0,40
1978543,1600927,2025-09-03,Assembly,"AB 1008 Addis Concurrence in Senate Amendments",79,0,0,0,79
1978544,1545018,2025-04-09,Assembly,"Do pass and be re-referred to the Committee on [Appropriations] with recommendation: To Consent Calendar",9,0,0,0,9
1978544,1563099,2025-04-30,Assembly,"Do pass. To Consent Calendar",14,0,0,1,15
1978544,1568646,2025-05-08,Assembly,"AB 1009 Blanca Rubio Consent Calendar Second Day Regular Session",69,0,0,10,79
1978544,1589113,2025-06-11,Senate,"Do pass, but first be re-referred to the Committee on [Appropriations]",6,0,0,1,7
1978544,1594056,2025-06-23,Senate,"Placed on suspense file",7,0,0,0,7
1978544,1600755,2025-08-29,Senate,"Do pass as amended",7,0,0,0,7
1978544,1601912,2025-09-11,Senate,"Special Consent AB1009 Blanca Rubio By Ashby",40,0,0,0,40
1978544,1602257,2025-09-12,Assembly,"AB 1009 Blanca Rubio Concurrence in Senate Amendments",80,0,0,0,80
1978546,1542786,2025-04-08,Assembly,"Do pass as amended and be re-referred to the Committee on [Appropriations]",9,0,0,0,9
1978546,1577196,2025-05-23,Assembly,"Do pass",14,0,0,1,15
1978546,1583560,2025-06-02,Assembly,"AB 1011 Hoover Assembly Third Reading",74,0,0,5,79
1978546,1597167,2025-07-01,Senate,"Do pass, but first be re-referred to the Committee on [Appropriations]",5,0,0,1,6
1978546,1598272,2025-07-14,Senate,"Placed on suspense file",7,0,0,0,7
1978548,1535107,2025-04-01,Assembly,"Do pass and be re-referred to the Committee on [Appropriations] with recommendation: To Consent Calendar",9,0,0,0,9
1978549,1554597,2025-04-21,Assembly,"Do pass and be re-referred to the Committee on [Appropriations]",14,1,0,1,16
1978549,1571609,2025-05-14,Assembly,"Do pass",12,1,0,2,15
1978549,1577327,2025-05-23,Assembly,"AB 1014 Rogers Assembly Third Reading",67,0,0,12,79
1978549,1594563,2025-06-24,Senate,"Do pass, but first be re-referred to the Committee on [Appropriations]",13,1,0,1,15
1978549,1600967,2025-09-03,Senate,"Assembly 3rd Reading AB1014 Rogers By Seyarto",37,1,0,2,40
1978551,1555937,2025-04-23,Assembly,"Do pass and be re-referred to the Committee on [Natural Resources]",15,0,0,3,18
1978551,1564294,2025-05-01,Assembly,"Do pass as amended and be re-referred to the Committee on [Appropriations]",14,0,0,0,14
1978551,1571532,2025-05-14,Assembly,"Do pass",15,0,0,0,15
1978551,1577406,2025-05-23,Assembly,"AB 1016 Jeff Gonzalez Assembly Third Reading",69,1,0,9,79
1978552,1556123,2025-04-23,Assembly,"Do pass and be re-referred to the Committee on [Appropriations] with recommendation: To Consent Calendar",18,0,0,0,18
1978552,1571636,2025-05-14,Assembly,"Do pass. To Consent Calendar",15,0,0,0,15
1978552,1577723,2025-05-23,Assembly,"AB 1017 Boerner Consent Calendar Second Day Regular Session",71,0,0,8,79
1978552,1591876,2025-06-17,Senate,"Do pass, but first be re-referred to the Committee on [Appropriations]",14,0,0,3,17
1978552,1600926,2025-09-03,Senate,"Assembly 3rd Reading AB1017 Boerner By Becker",40,0,0,0,40
1978553,1556161,2025-04-22,Assembly,"Do pass and be re-referred to the Committee on [Judiciary]",9,3,0,3,15
1978553,1561043,2025-04-29,Assembly,"Do pass as amended and be re-referred to the Committee on [Appropriations]",8,3,0,1,12
1978553,1577597,2025-05-23,Assembly,"Do pass",10,3,0,2,15
1978553,1583386,2025-06-02,Assembly,"AB 1018 Bauer-Kahan Assembly Third Reading",50,16,0,13,79
1978553,1598578,2025-07-15,Senate,"Do pass as amended, but first amend, and re-refer to the Committee on [Appropriations]",11,2,0,0,13
1978553,1599568,2025-08-18,Senate,"Placed on suspense file",7,0,0,0,7
1978553,1600724,2025-08-29,Senate,"Do pass",5,2,0,0,7
1978555,1556074,2025-04-23,Assembly,"Do pass and be re-referred to the Committee on [Appropriations]",15,2,0,1,18
1978555,1577251,2025-05-23,Assembly,"Do pass",11,3,0,1,15
1978555,1584328,2025-06-03,Assembly,"AB 1020 Schiavo Assembly Third Reading",60,9,0,10,79
1978555,1598373,2025-07-15,Senate,"Do pass, but first be re-referred to the Committee on [Appropriations]",12,3,0,2,17
1978555,1599585,2025-08-18,Senate,"Placed on suspense file",7,0,0,0,7
1978556,1542829,2025-04-09,Assembly,"Do pass and be re-referred to the Committee on [Local Government]",8,1,0,3,12
1978556,1564203,2025-04-30,Assembly,"Do pass as amended and be re-referred to the Committee on [Appropriations]",9,0,0,1,10
1978556,1571579,2025-05-14,Assembly,"Do pass",11,2,0,2,15
1978556,1579248,2025-05-27,Assembly,"AB 1021 Wicks Assembly Third Reading",62,3,0,14,79
1978556,1597389,2025-07-02,Senate,"Do pass as amended, but first amend, and re-refer to the Committee on [Housing]",6,1,0,0,7
1978556,1598418,2025-07-15,Senate,"Do pass as amended, but first amend, and re-refer to the Committee on [Appropriations]",9,1,0,1,11
1978556,1600902,2025-09-03,Senate,"Assembly 3rd Reading AB1021 Wicks et al. By Limón",32,6,0,2,40
1978556,1601299,2025-09-08,Assembly,"AB 1021 Wicks Concurrence in Senate Amendments",63,7,0,10,80
1978557,1554491,2025-04-21,Assembly,"Do pass and be re-referred to the Committee on [Appropriations]",10,3,0,3,16
1978559,1540812,2025-04-08,Assembly,"Do pass and be re-referred to the Committee on [Appropriations]",13,0,0,0,13
1978560,1561080,2025-04-29,Assembly,"Do pass as amended and be re-referred to the Committee on [Appropriations]",11,0,0,1,12
1978561,1542692,2025-04-09,Assembly,"Do pass and be re-referred to the Committee on [Utilities and Energy]",11,0,0,1,12
1978561,1567858,2025-05-07,Assembly,"Do pass as amended",15,0,0,3,18
1978561,1575472,2025-05-21,Assembly,"Do pass",15,0,0,0,15
1978561,1582246,2025-05-29,Assembly,"AB 1026 Wilson Assembly Third Reading",71,0,0,8,79
1978561,1597240,2025-07-01,Senate,"Do pass as amended, but first amend, and re-refer to the Committee on [Housing]",17,0,0,0,17
1978561,1600961,2025-09-03,Senate,"Assembly 3rd Reading AB1026 Wilson et al. By Becker",39,0,0,1,40
1978561,1601099,2025-09-04,Assembly,"AB 1026 Wilson Concurrence in Senate Amendments",76,0,0,3,79
1978562,1561174,2025-04-29,Assembly,"Do pass and be re-referred to the Committee on [Appropriations]",17,0,0,1,18
1978562,1577402,2025-05-23,Assembly,"Do pass",14,0,0,1,15
1978562,1583509,2025-06-02,Assembly,"AB 1027 Sharp-Collins Assembly Third Reading",79,0,0,0,79
1978562,1598316,2025-07-14,Senate,"Do pass, but first be re-referred to the Committee on [Appropriations]",11,0,0,0,11
1978562,1599499,2025-08-18,Senate,"Placed on suspense file",7,0,0,0,7
1978563,1561091,2025-04-29,Assembly,"Do pass and be re-referred to the Committee on [Appropriations]",7,2,0,1,10
1978563,1577508,2025-05-23,Assembly,"Do pass as amended",11,2,0,2,15
1978563,1584372,2025-06-03,Assembly,"AB 1028 Fong Assembly Third Reading",71,5,0,3,79
1978563,1598045,2025-07-09,Senate,"Do pass, but first be re-referred to the Committee on [Appropriations]",7,0,0,0,7
1978563,1599458,2025-08-18,Senate,"Placed on suspense file",7,0,0,0,7
1978563,1600531,2025-08-29,Senate,"Do pass",5,2,0,0,7
1978563,1601469,2025-09-09,Senate,"Assembly 3rd Reading AB1028 Fong et al. By Cortese",31,5,0,4,40
1978564,1542752,2025-04-09,Assembly,"Do pass and be re-referred to the Committee on [Appropriations] with recommendation: To Consent Calendar",7,0,0,0,7
1978564,1563047,2025-04-30,Assembly,"Do pass. To Consent Calendar",14,0,0,1,15
1978564,1568663,2025-05-08,Assembly,"AB 1029 Valencia Consent Calendar Second Day Regular Session",69,0,0,10,79
1978564,1597160,2025-07-01,Senate,"Do pass, but first be re-referred to the Committee on [Appropriations] with the recommendation: To Consent Calendar",5,0,0,0,5
1978564,1598838,2025-07-17,Senate,"Consent Calendar 2nd AB1029 Valencia et al",35,0,0,5,40
1978565,1528295,2025-03-26,Assembly,"Do pass. To Consent Calendar",8,0,0,2,10
1978565,1533548,2025-04-01,Assembly,"AB 1030 Papan Consent Calendar Second Day Regular Session",76,0,0,4,80
1978566,1561039,2025-04-29,Assembly,"Do pass and be re-referred to the Committee on [Appropriations]",6,0,0,1,7
1978567,1562853,2025-04-29,Assembly,"Do pass as amended and be re-referred to the Committee on [Appropriations]",16,0,0,0,16
1978567,1577500,2025-05-23,Assembly,"Do pass",13,0,0,2,15
1978567,1583551,2025-06-02,Assembly,"AB 1032 Harabedian Third Reading Urgency",74,1,0,4,79
1978567,1598119,2025-07-09,Senate,"Do pass as amended, but first amend, and re-refer to the Committee on [Appropriations]",8,0,0,3,11
1978567,1599583,2025-08-18,Senate,"Placed on suspense file",7,0,0,0,7
1978567,1600668,2025-08-29,Senate,"Do pass as amended",4,1,0,2,7
1978567,1601841,2025-09-11,Senate,"Assembly 3rd Reading AB1032 Harabedian et al. By Pérez Urgency Clause",32,1,0,7,40
1978567,1602188,2025-09-12,Assembly,"AB 1032 Harabedian Concurrence in Senate Amendments",77,0,0,3,80
1978568,1554476,2025-04-22,Assembly,"Do pass and be re-referred to the Committee on [Appropriations] with recommendation: To Consent Calendar",12,0,0,0,12
1978568,1577662,2025-05-23,Assembly,"Do pass as amended",14,0,0,1,15
1978568,1585012,2025-06-04,Assembly,"AB 1033 Lackey Assembly Third Reading",78,0,0,1,79
1978568,1597897,2025-07-08,Senate,"Do pass, but first be re-referred to the Committee on [Appropriations] with the recommendation: To Consent Calendar",13,0,0,0,13
1978568,1599652,2025-08-18,Senate,"Placed on suspense file",7,0,0,0,7
1978569,1564183,2025-04-30,Assembly,"Do pass and be re-referred to the Committee on [Appropriations] with recommendation: To Consent Calendar",9,0,0,0,9
1978569,1571623,2025-05-14,Assembly,"Do pass. To Consent Calendar",15,0,0,0,15
1978569,1577693,2025-05-23,Assembly,"AB 1034 Ávila Farías Consent Calendar Second Day Regular Session",71,0,0,8,79
1978569,1592585,2025-06-18,Senate,"Do pass, but first be re-referred to the Committee on [Appropriations] with the recommendation: To Consent Calendar",7,0,0,0,7
1978569,1597568,2025-07-03,Senate,"Consent Calendar 2nd AB1034 Ávila Farías",35,0,0,5,40
1978570,1542713,2025-04-08,Assembly,"Do pass and be re-referred to the Committee on [Appropriations]",8,2,0,0,10
1978571,1535123,2025-04-01,Assembly,"Do pass and be re-referred to the Committee on [Appropriations]",7,0,0,2,9
1978571,1577561,2025-05-23,Assembly,"Do pass as amended",12,2,0,1,15
1978571,1583419,2025-06-02,Assembly,"AB 1036 Schultz Assembly Third Reading",53,13,0,13,79
1978571,1597214,2025-07-01,Senate,"Do pass as amended, but first amend, and re-refer to the Committee on [Appropriations]",5,1,0,0,6
1978571,1599578,2025-08-18,Senate,"Placed on suspense file",7,0,0,0,7
1978571,1600475,2025-08-29,Senate,"Do pass as amended",5,2,0,0,7
1978571,1602348,2025-09-12,Senate,"Assembly 3rd Reading AB1036 Schultz By Arreguín",28,9,0,3,40
1978571,1602349,2025-09-13,Assembly,"AB 1036 Schultz Concurrence in Senate Amendments",54,18,0,8,80
1978572,1540932,2025-04-08,Assembly,"Do pass as amended and be re-referred to the Committee on [Judiciary]",11,3,0,1,15
1978572,1561042,2025-04-29,Assembly,"Do pass and be re-referred to the Committee on [Appropriations]",8,3,0,1,12
1978572,1577316,2025-05-23,Assembly,"Do pass",11,3,0,1,15
1978572,1585796,2025-06-05,Assembly,"AB 1037 Elhawary Assembly Third Reading",55,19,0,5,79
1978572,1597425,2025-07-02,Senate,"Do pass as amended, but first amend, and re-refer to the Committee on [Judiciary]",9,0,0,2,11
1978572,1598666,2025-07-15,Senate,"Do pass, but first be re-referred to the Committee on [Appropriations]",11,1,0,1,13
1978572,1599451,2025-08-18,Senate,"Placed on suspense file",7,0,0,0,7
1978572,1600474,2025-08-29,Senate,"Do pass as amended",5,2,0,0,7
1978572,1601620,2025-09-09,Senate,"Assembly 3rd Reading AB1037 Elhawary By Menjivar",30,10,0,0,40
1978573,1562822,2025-04-29,Assembly,"Do pass and be re-referred to the Committee on [Appropriations]",6,4,0,3,13
1978573,1562823,2025-04-29,Assembly,Reconsideration,11,0,0,2,13
1978574,1556087,2025-04-23,Assembly,"Do pass and be re-referred to the Committee on [Appropriations]",22,0,0,0,22
1978574,1577416,2025-05-23,Assembly,"Do pass",14,0,0,1,15
1978574,1583453,2025-06-02,Assembly,"AB 1039 Hart Assembly Third Reading",79,0,0,0,79
1978574,1597836,2025-07-08,Senate,"Do pass, but first be re-referred to the Committee on [Appropriations] with the recommendation: To Consent Calendar",15,0,0,0,15
1978576,1533474,2025-04-01,Assembly,"Do pass as amended and be re-referred to the Committee on [Appropriations]",12,0,0,3,15
1978576,1577446,2025-05-23,Assembly,"Do pass as amended",11,0,0,4,15
1978576,1584265,2025-06-03,Assembly,"AB 1041 Bennett Assembly Third Reading",61,2,0,16,79
1978576,1597465,2025-07-02,Senate,"Do pass as amended, but first amend, and re-refer to the Committee on [Appropriations]",10,0,0,1,11
1978576,1599372,2025-08-18,Senate,"Placed on suspense file",7,0,0,0,7
1978576,1600727,2025-08-29,Senate,"Do pass as amended",5,0,0,2,7
1978576,1601244,2025-09-08,Senate,"Assembly 3rd Reading AB1041 Bennett et al. By Menjivar",30,1,0,9,40
1978576,1601497,2025-09-09,Assembly,"AB 1041 Bennett Concurrence in Senate Amendments",67,2,0,11,80
1978577,1542703,2025-04-09,Assembly,"Do pass and be re-referred to the Committee on [Appropriations]",8,0,0,0,8
1978577,1577380,2025-05-23,Assembly,"Do pass as amended",11,0,0,4,15
1978577,1583482,2025-06-02,Assembly,"AB 1042 Ransom Assembly Third Reading",79,0,0,0,79
1978577,1598460,2025-07-15,Senate,"Do pass, but first be re-referred to the Committee on [Appropriations]",5,0,0,0,5
1978577,1599460,2025-08-18,Senate,"Placed on suspense file",7,0,0,0,7
1978577,1600765,2025-08-29,Senate,"Do pass as amended",6,0,0,1,7
1978577,1601011,2025-09-03,Senate,"Assembly 3rd Reading AB1042 Ransom et al. By Hurtado",39,0,0,1,40
1978577,1601142,2025-09-04,Assembly,"AB 1042 Ransom Concurrence in Senate Amendments",78,0,0,1,79
1978578,1556028,2025-04-22,Assembly,"Do pass and be re-referred to the Committee on [Judiciary]",13,0,0,2,15
1978578,1561121,2025-04-29,Assembly,"Do pass and be re-referred to the Committee on [Appropriations]",12,0,0,0,12
1978578,1577294,2025-05-23,Assembly,"Do pass as amended",11,0,0,4,15
1978578,1583468,2025-06-02,Assembly,"AB 1043 Wicks Assembly Third Reading",76,0,0,3,79
1978578,1598715,2025-07-15,Senate,"Do pass as amended, but first amend, and re-refer to the Committee on [Appropriations]",12,0,0,1,13
1978578,1599398,2025-08-18,Senate,"Placed on suspense file",7,0,0,0,7
1978578,1600398,2025-08-29,Senate,"Do pass",7,0,0,0,7
1978578,1602263,2025-09-12,Senate,"Assembly 3rd Reading AB1043 Wicks et al. By Umberg",38,0,0,2,40
1978578,1602264,2025-09-13,Assembly,"AB 1043 WICKS Concurrence in Senate Amendments",77,0,0,3,80
1978579,1540925,2025-04-08,Assembly,"Do pass and be re-referred to the Committee on [Local Government]",13,0,0,0,13
1978579,1564279,2025-04-30,Assembly,"Do pass and be re-referred to the Committee on [Appropriations]",10,0,0,0,10
1978579,1571554,2025-05-14,Assembly,"Do pass",15,0,0,0,15
1978580,1561077,2025-04-29,Assembly,"Do pass and be re-referred to the Committee on [Appropriations]",7,2,0,1,10
1978580,1577447,2025-05-23,Assembly,"Do pass as amended",11,2,0,2,15
1978580,1583394,2025-06-02,Assembly,"AB 1045 Ávila Farías Assembly Third Reading",73,4,0,2,79
1978580,1595231,2025-06-25,Senate,"Do pass, but first be re-referred to the Committee on [Appropriations]",7,0,0,0,7
1978580,1597736,2025-07-07,Senate,"Placed on suspense file",6,0,0,1,7
1978581,1538876,2025-04-07,Assembly,"Do pass as amended",14,0,0,0,14
1978581,1577869,2025-05-23,Assembly,"Do pass",14,0,0,1,15
1978581,1583430,2025-06-02,Assembly,"AB 1046 Bains Assembly Third Reading",79,0,0,0,79
1978581,1597487,2025-07-02,Senate,"Do pass, but first be re-referred to the Committee on [Appropriations] with the recommendation: To Consent Calendar",8,0,0,0,8
1978581,1598314,2025-07-14,Senate,"Placed on suspense file",7,0,0,0,7
1978581,1600530,2025-08-29,Senate,"Do pass",7,0,0,0,7
1978581,1601174,2025-09-04,Senate,"Special Consent AB1046 Bains",39,0,0,1,40
1978583,1556071,2025-04-23,Assembly,"Do pass and be re-referred to the Committee on [Appropriations]",17,0,0,0,17
1978583,1577278,2025-05-23,Assembly,"Do pass",12,0,0,3,15
1978583,1585069,2025-06-04,Assembly,"AB 1048 Chen Assembly Third Reading",76,0,0,3,79
1978583,1598074,2025-07-09,Senate,"Do pass, but first be re-referred to the Committee on [Appropriations]",5,0,0,0,5
1978584,1540931,2025-04-08,Assembly,"Do pass and be re-referred to the Committee on [Appropriations]",5,1,0,0,6
1978585,1527001,2025-03-25,Assembly,"Do pass as amended and be re-referred to the Committee on [Appropriations]",9,1,0,2,12
1978585,1577283,2025-05-23,Assembly,"Do pass",11,2,0,2,15
1978585,1583557,2025-06-02,Assembly,"AB 1050 Schultz Assembly Third Reading",60,12,0,7,79
1978585,1597429,2025-07-01,Senate,"Do pass as amended, but first amend, and re-refer to the Committee on [Housing]",11,2,0,0,13
1978585,1598464,2025-07-15,Senate,"Do pass, but first be re-referred to the Committee on [Appropriations]",8,2,0,1,11
1978585,1599362,2025-08-18,Senate,"Placed on suspense file",7,0,0,0,7
1978585,1600346,2025-08-29,Senate,"Do pass",6,1,0,0,7
1978585,1600940,2025-09-03,Senate,"Assembly 3rd Reading AB1050 Schultz et al. By Grayson",31,9,0,0,40
1978585,1601779,2025-09-10,Senate,"Assembly 3rd Reading AB1050 Schultz et al. By Grayson",31,9,0,0,40
1978586,1561148,2025-04-28,Assembly,"Do pass and be re-referred to the Committee on [Appropriations] with recommendation: To Consent Calendar",16,0,0,0,16
1978586,1577710,2025-05-23,Assembly,"Do pass",14,0,0,1,15
1978586,1583389,2025-06-02,Assembly,"AB 1051 Davies Assembly Third Reading",78,0,0,1,79
1978586,1594602,2025-06-24,Senate,"Do pass, but first be re-referred to the Committee on [Appropriations] with the recommendation: To Consent Calendar",14,0,0,1,15
1978586,1598162,2025-07-10,Senate,"Consent Calendar 2nd AB1051 Davies",37,0,0,3,40
1978586,1598861,2025-07-17,Assembly,"AB 1051 Davies Concurrence in Senate Amendments",72,0,0,7,79
1978587,1552873,2025-04-21,Assembly,"Do pass and be re-referred to the Committee on [Elections]",9,0,0,0,9
1978587,1577925,2025-05-23,Assembly,"Do pass as amended",11,0,0,4,15
1978587,1584380,2025-06-03,Assembly,"AB 1052 Valencia Assembly Third Reading",78,0,0,1,79
1978587,1597392,2025-07-01,Senate,"Do pass as amended, but first amend, and re-refer to the Committee on [Banking and Financial Institutions]",13,0,0,0,13
1978587,1599444,2025-08-18,Senate,"Placed on suspense file",7,0,0,0,7
1978588,1564180,2025-04-30,Assembly,"Do pass and be re-referred to the Committee on [Appropriations]",7,1,0,1,9
1978591,1563051,2025-04-29,Assembly,"Do pass as amended and be re-referred to the Committee on [Appropriations]",9,2,0,2,13
1978591,1575477,2025-05-21,Assembly,"Do pass",11,4,0,0,15
1978591,1579285,2025-05-27,Assembly,"AB 1056 Bennett Assembly Third Reading",51,17,0,11,79
1978591,1594626,2025-06-24,Senate,"Do pass, but first be re-referred to the Committee on [Appropriations]",5,2,0,0,7
1978591,1601893,2025-09-11,Senate,"Assembly 3rd Reading AB1056 Bennett By Laird",29,10,0,1,40
1978594,1554486,2025-04-21,Assembly,"Do pass and be re-referred to the Committee on [Appropriations] with recommendation: To Consent Calendar",15,0,0,1,16
1978596,1528290,2025-03-26,Assembly,"Do pass as amended and be re-referred to the Committee on [Local Government]",8,2,0,1,11
1978596,1556197,2025-04-23,Assembly,"Do pass and be re-referred to the Committee on [Appropriations]",9,1,0,0,10
1978596,1563077,2025-04-30,Assembly,"Do pass",10,3,0,2,15
1978596,1573618,2025-05-19,Assembly,"AB 1061 Quirk-Silva Assembly Third Reading",45,14,0,20,79
1978596,1591856,2025-06-17,Senate,"Do pass, but first be re-referred to the Committee on [Local Government]",7,2,0,2,11
1978596,1598131,2025-07-09,Senate,"Do pass as amended, but first amend, and re-refer to the Committee on [Appropriations]",5,2,0,0,7
1978596,1600931,2025-09-03,Senate,"Assembly 3rd Reading AB1061 Quirk-Silva et al. By Wiener",24,10,0,6,40
1978596,1601300,2025-09-08,Assembly,"AB 1061 Quirk-Silva Concurrence in Senate Amendments",46,18,0,16,80
1978597,1564228,2025-04-30,Assembly,"Do pass and be re-referred to the Committee on [Appropriations]",2,4,0,3,9
1978597,1564229,2025-04-30,Assembly,Reconsideration,9,0,0,0,9
1978599,1555954,2025-04-22,Assembly,"Do pass and be re-referred to the Committee on [Judiciary]",10,3,0,2,15
1978599,1561185,2025-04-29,Assembly,"Do pass as amended and be re-referred to the Committee on [Appropriations]",9,3,0,0,12
1978599,1577203,2025-05-23,Assembly,"Do pass as amended",11,3,0,1,15
1978599,1583454,2025-06-02,Assembly,"AB 1064 Bauer-Kahan Assembly Third Reading",59,12,0,8,79
1978599,1598678,2025-07-15,Senate,"Do pass as amended, but first amend, and re-refer to the Committee on [Appropriations]",11,1,0,1,13
1978599,1599649,2025-08-18,Senate,"Placed on suspense file",7,0,0,0,7
1978599,1600686,2025-08-29,Senate,"Do pass as amended",5,2,0,0,7
1978599,1601731,2025-09-10,Senate,"Assembly 3rd Reading AB1064 Bauer-Kahan et al. By Ashby",31,6,0,3,40
1978600,1540842,2025-04-08,Assembly,"Do pass as amended and be re-referred to the Committee on [Banking and Finance]",7,3,0,2,12
1978600,1552955,2025-04-21,Assembly,"Do pass",0,6,0,3,9
1978600,1552956,2025-04-21,Assembly,Reconsideration,7,2,0,0,9
1978601,1564145,2025-05-01,Assembly,"Do pass and be re-referred to the Committee on [Judiciary]",2,2,0,3,7
1978602,1556143,2025-04-23,Assembly,"Do pass as amended and be re-referred to the Committee on [Appropriations]",7,0,0,0,7
1978602,1577433,2025-05-23,Assembly,"Do pass as amended",11,0,0,4,15
1978602,1584423,2025-06-03,Assembly,"AB 1067 Quirk-Silva Assembly Third Reading",79,0,0,0,79
1978602,1598118,2025-07-09,Senate,"Do pass as amended, but first amend, and re-refer to the Committee on [Appropriations] with the recommendation: To Consent Calendar",5,0,0,0,5
1978602,1599571,2025-08-18,Senate,"Placed on suspense file",7,0,0,0,7
1978602,1600635,2025-08-29,Senate,"Do pass",7,0,0,0,7
1978602,1601073,2025-09-04,Senate,"Special Consent AB1067 Quirk-Silva",39,0,0,1,40
1978602,1601301,2025-09-08,Assembly,"AB 1067 Quirk-Silva Concurrence in Senate Amendments",79,0,0,1,80
1978603,1554547,2025-04-22,Assembly,"Do pass and be re-referred to the Committee on [Emergency Management]",6,0,0,1,7
1978603,1561209,2025-04-28,Assembly,"Do pass and be re-referred to the Committee on [Appropriations] with recommendation: To Consent Calendar",7,0,0,0,7
1978603,1577859,2025-05-23,Assembly,"Do pass",14,0,0,1,15
1978603,1583480,2025-06-02,Assembly,"AB 1068 Bains Assembly Third Reading",79,0,0,0,79
1978603,1597192,2025-06-30,Senate,"Do pass, but first be re-referred to the Committee on [Governmental Organization] with the recommendation: To Consent Calendar",5,0,0,0,5
1978603,1597926,2025-07-08,Senate,"Do pass, but first be re-referred to the Committee on [Appropriations] with the recommendation: To Consent Calendar",15,0,0,0,15
1978603,1599638,2025-08-18,Senate,"Placed on suspense file",7,0,0,0,7
1978604,1554494,2025-04-22,Assembly,"Do pass and be re-referred to the Committee on [Emergency Management]",6,0,0,1,7
1978604,1561109,2025-04-28,Assembly,"Do pass and be re-referred to the Committee on [Appropriations] with recommendation: To Consent Calendar",7,0,0,0,7
1978604,1577280,2025-05-23,Assembly,"Do pass as amended",11,0,0,4,15
1978604,1583402,2025-06-02,Assembly,"AB 1069 Bains Assembly Third Reading",78,0,0,1,79
1978604,1597140,2025-06-30,Senate,"Do pass, but first be re-referred to the Committee on [Governmental Organization] with the recommendation: To Consent Calendar",5,0,0,0,5
1978604,1597912,2025-07-08,Senate,"Do pass, but first be re-referred to the Committee on [Appropriations] with the recommendation: To Consent Calendar",15,0,0,0,15
1978604,1601753,2025-09-10,Senate,"Assembly 3rd Reading AB1069 Bains et al. By Limón",40,0,0,0,40
1978606,1554455,2025-04-22,Assembly,"Do pass",7,2,0,0,9
1978606,1573555,2025-05-19,Assembly,"AB 1071 Kalra Assembly Third Reading",48,16,0,15,79
1978606,1594617,2025-06-24,Senate,"Do pass as amended, but first amend, and re-refer to the Committee on [Appropriations]",4,1,0,1,6
1978606,1598306,2025-07-14,Senate,"Placed on suspense file",7,0,0,0,7
1978606,1600594,2025-08-29,Senate,"Do pass as amended",5,2,0,0,7
1978606,1601943,2025-09-11,Senate,"Assembly 3rd Reading AB1071 Kalra By Arreguín",25,11,0,4,40
1978606,1602345,2025-09-13,Assembly,"AB 1071 Kalra Concurrence in Senate Amendments",42,21,0,17,80
1978607,1542882,2025-04-09,Assembly,"Do pass and be re-referred to the Committee on [Appropriations] with recommendation: To Consent Calendar",7,0,0,0,7
1978607,1556002,2025-04-23,Assembly,"Do pass. To Consent Calendar",15,0,0,0,15
1978607,1564243,2025-05-01,Assembly,"AB 1072 Pellerin Consent Calendar Second Day Regular Session",76,0,0,3,79
1978607,1597138,2025-07-01,Senate,"Do pass, but first be re-referred to the Committee on [Appropriations] with the recommendation: To Consent Calendar",5,0,0,0,5
1978607,1598305,2025-07-14,Senate,"Placed on suspense file",7,0,0,0,7
1978607,1600685,2025-08-29,Senate,"Do pass",7,0,0,0,7
1978607,1601128,2025-09-04,Senate,"Special Consent AB1072 Pellerin",39,0,0,1,40
1978609,1540840,2025-04-08,Assembly,"Do pass and be re-referred to the Committee on [Appropriations]",5,1,0,0,6
1978609,1577152,2025-05-23,Assembly,"Do pass as amended",11,3,0,1,15
1978609,1585056,2025-06-04,Assembly,"AB 1074 Patel Assembly Third Reading",61,13,0,5,79
1978609,1597720,2025-07-07,Senate,"Do pass, but first be re-referred to the Committee on [Appropriations]",5,0,0,0,5
1978609,1599361,2025-08-18,Senate,"Placed on suspense file",7,0,0,0,7
1978609,1600322,2025-08-29,Senate,"Do pass as amended",5,0,0,2,7
1978609,1601605,2025-09-09,Senate,"Assembly 3rd Reading AB1074 Patel By Limón",34,4,0,2,40
1978610,1540803,2025-04-07,Assembly,"Do pass and be re-referred to the Committee on [Natural Resources]",6,1,0,0,7
1978610,1558711,2025-04-21,Assembly,"Do pass as amended and be re-referred to the Committee on [Appropriations]",14,0,0,0,14
1978610,1567860,2025-05-07,Assembly,"Do pass",15,0,0,0,15
1978610,1569762,2025-05-12,Assembly,"AB 1075 Bryan Assembly Third Reading",75,2,0,2,79
1978610,1588056,2025-06-10,Senate,"Do pass, but first be re-referred to the Committee on [Natural Resources and Water]",14,0,0,1,15
1978610,1598756,2025-07-16,Senate,"Do pass, but first be re-referred to the Committee on [Appropriations]",7,0,0,0,7
1978610,1601247,2025-09-08,Senate,"Assembly 3rd Reading AB1075 Bryan et al. By Cervantes",39,0,0,1,40
1978610,1601653,2025-09-09,Assembly,"AB 1075 Bryan Concurrence in Senate Amendments",78,2,0,0,80
1978611,1542880,2025-04-07,Assembly,"Do pass and be re-referred to the Committee on [Appropriations]",6,0,0,1,7
1978611,1577633,2025-05-23,Assembly,"Do pass as amended",11,0,0,4,15
1978611,1584332,2025-06-03,Assembly,"AB 1076 Addis Assembly Third Reading",79,0,0,0,79
1978611,1597265,2025-06-30,Senate,"Do pass, but first be re-referred to the Committee on [Revenue and Taxation]",5,0,0,0,5
1978611,1598123,2025-07-09,Senate,"Do pass, but first be re-referred to the Committee on [Appropriations] with the recommendation: To Consent Calendar",5,0,0,0,5
1978611,1599379,2025-08-18,Senate,"Placed on suspense file",7,0,0,0,7
1978611,1600563,2025-08-29,Senate,"Do pass",7,0,0,0,7
1978611,1601085,2025-09-04,Senate,"Special Consent AB1076 Addis",39,0,0,1,40
1978611,1601302,2025-09-08,Assembly,"AB 1076 Addis Concurrence in Senate Amendments",79,0,0,1,80
1978613,1542686,2025-04-08,Assembly,"Do pass and be re-referred to the Committee on [Appropriations]",6,2,0,1,9
1978613,1577513,2025-05-23,Assembly,"Do pass",10,3,0,2,15
1978613,1583577,2025-06-02,Assembly,"AB 1078 Berman Assembly Third Reading",57,19,0,3,79
1978613,1597863,2025-07-08,Senate,"Do pass, but first be re-referred to the Committee on [Appropriations]",5,1,0,0,6
1978613,1599496,2025-08-18,Senate,"Placed on suspense file",7,0,0,0,7
1978613,1600395,2025-08-29,Senate,"Do pass as amended",5,2,0,0,7
1978613,1601537,2025-09-09,Senate,"Assembly 3rd Reading AB1078 Berman et al. By Blakespear",29,10,0,1,40
1978614,1526944,2025-03-25,Assembly,"Do pass and be re-referred to the Committee on [Elections]",7,3,0,2,12
1978614,1562841,2025-04-30,Assembly,"Do pass as amended",4,2,0,1,7
1978614,1585109,2025-06-04,Assembly,"AB 1079 Ávila Farías Assembly Third Reading",55,16,0,8,79
1978614,1597431,2025-07-01,Senate,"Do pass as amended, but first amend, and re-refer to the Committee on [Elections and Constitutional Amendments]",10,1,0,2,13
1978614,1598379,2025-07-15,Senate,"Do pass",4,1,0,0,5
1978614,1602108,2025-09-12,Senate,"Assembly 3rd Reading AB1079 Ávila Farías By Arreguín",25,13,0,2,40
1978614,1602109,2025-09-13,Assembly,"AB 1079 Ávila Farías Concurrence in Senate Amendments",56,17,0,7,80
1978615,1562984,2025-04-29,Assembly,"Do pass and be re-referred to the Committee on [Appropriations]",7,0,0,0,7
1978617,1533481,2025-04-01,Assembly,"Do pass and be re-referred to the Committee on [Appropriations]",14,0,0,4,18
1978619,1526918,2025-03-25,Assembly,"Do pass and be re-referred to the Committee on [Health]",9,1,0,2,12
1978619,1563035,2025-04-29,Assembly,"Do pass as amended and be re-referred to the Committee on [Appropriations]",12,2,0,2,16
1978619,1577683,2025-05-23,Assembly,"Do pass as amended",12,1,0,2,15
1978619,1585040,2025-06-04,Assembly,"AB 1084 Zbur Third Reading Urgency",60,13,0,6,79
1978619,1597407,2025-07-01,Senate,"Do pass, but first be re-referred to the Committee on [Health]",11,1,0,1,13
1978619,1598878,2025-07-16,Senate,"Do pass, but first be re-referred to the Committee on [Appropriations]",9,0,0,2,11
1978619,1599428,2025-08-18,Senate,"Placed on suspense file",7,0,0,0,7
1978619,1600359,2025-08-29,Senate,"Do pass",5,2,0,0,7
1978619,1602357,2025-09-12,Senate,"Assembly 3rd Reading AB1084 Zbur et al. By Wiener",29,7,0,4,40
1978619,1602358,2025-09-13,Assembly,"AB 1084 Zbur Concurrence in Senate Amendments",58,16,0,6,80
1978620,1554616,2025-04-21,Assembly,"Do pass and be re-referred to the Committee on [Appropriations] with recommendation: To Consent Calendar",15,0,0,1,16
1978620,1567857,2025-05-07,Assembly,"Do pass. To Consent Calendar",15,0,0,0,15
1978620,1572418,2025-05-15,Assembly,"AB 1085 Stefani Consent Calendar Second Day Regular Session",69,0,0,10,79
1978620,1588079,2025-06-10,Senate,"Do pass as amended, but first amend, and re-refer to the Committee on [Public Safety] with the recommendation: To Consent Calendar",13,0,0,2,15
1978620,1597238,2025-07-01,Senate,"Do pass, but first be re-referred to the Committee on [Appropriations] with the recommendation: To Consent Calendar",6,0,0,0,6
1978620,1598853,2025-07-17,Senate,"Consent Calendar 2nd AB1085 Stefani",35,0,0,5,40
1978620,1600051,2025-08-25,Assembly,"AB 1085 Stefani Concurrence in Senate Amendments",76,0,0,3,79
1978621,1558710,2025-04-21,Assembly,"Do pass as amended and be re-referred to the Committee on [Water, Parks, and Wildlife]",13,0,0,1,14
1978621,1562756,2025-04-29,Assembly,"Do pass as amended and be re-referred to the Committee on [Appropriations]",11,0,0,2,13
1978622,1554615,2025-04-22,Assembly,"Do pass as amended, and be re-referred to the Committee on [Appropriations] with recommendation: To Consent Calendar",9,0,0,0,9
1978622,1577764,2025-05-23,Assembly,"Do pass",14,0,0,1,15
1978622,1585820,2025-06-05,Assembly,"AB 1087 Patterson Assembly Third Reading",78,0,0,1,79
1978622,1597812,2025-07-08,Senate,"Do pass, but first be re-referred to the Committee on [Appropriations] with the recommendation: To Consent Calendar",6,0,0,0,6
1978622,1599557,2025-08-18,Senate,"Placed on suspense file",7,0,0,0,7
1978622,1600354,2025-08-29,Senate,"Do pass",7,0,0,0,7
1978622,1601121,2025-09-04,Senate,"Special Consent AB1087 Patterson By Niello",39,0,0,1,40
1978623,1555983,2025-04-22,Assembly,"Do pass and be re-referred to the Committee on [Environmental Safety and Toxic Materials]",16,0,0,0,16
1978623,1561100,2025-04-29,Assembly,"Do pass and be re-referred to the Committee on [Appropriations]",7,0,0,0,7
1978623,1577895,2025-05-23,Assembly,"Do pass",14,0,0,1,15
1978623,1583541,2025-06-02,Assembly,"AB 1088 Bains Assembly Third Reading",76,0,0,3,79
1978624,1540806,2025-04-08,Assembly,"Do pass and be re-referred to the Committee on [Appropriations]",11,0,0,2,13
1978624,1556058,2025-04-23,Assembly,"Do pass",15,0,0,0,15
1978624,1559452,2025-04-28,Assembly,"AB 1089 Carrillo Assembly Third Reading",65,0,0,14,79
1978624,1598714,2025-07-16,Senate,"Do pass as amended, but first amend, and re-refer to the Committee on [Appropriations]",6,0,0,1,7
1978624,1599584,2025-08-18,Senate,"Placed on suspense file",7,0,0,0,7
1978624,1600708,2025-08-29,Senate,"Do pass",7,0,0,0,7
1978624,1601879,2025-09-11,Senate,"Assembly 3rd Reading AB1089 Carrillo By Laird",40,0,0,0,40
1978624,1602194,2025-09-12,Assembly,"AB 1089 Carrillo Concurrence in Senate Amendments",76,0,0,4,80
1978627,1535009,2025-04-01,Assembly,"Do pass",2,4,0,3,9
1978627,1542869,2025-04-08,Assembly,Reconsideration,7,1,0,1,9
1978628,1542847,2025-04-08,Assembly,"Do pass and be re-referred to the Committee on [Appropriations]",7,1,0,2,10
1978628,1577801,2025-05-23,Assembly,"Do pass",11,3,0,1,15
1978628,1583493,2025-06-02,Assembly,"AB 1093 Solache Assembly Third Reading",62,8,0,9,79
1978629,1535043,2025-04-01,Assembly,"Do pass as amended and be re-referred to the Committee on [Appropriations]",9,0,0,0,9
1978629,1577210,2025-05-23,Assembly,"Do pass as amended",11,0,0,4,15
1978629,1583409,2025-06-02,Assembly,"AB 1094 Bains Assembly Third Reading",74,0,0,5,79
1978629,1597154,2025-07-01,Senate,"Do pass, but first be re-referred to the Committee on [Appropriations]",6,0,0,0,6
1978629,1598262,2025-07-14,Senate,"Placed on suspense file",7,0,0,0,7
1978629,1600567,2025-08-29,Senate,"Do pass as amended",7,0,0,0,7
1978629,1601663,2025-09-09,Senate,"Assembly 3rd Reading AB1094 Bains et al. By Archuleta",39,0,0,1,40
1978630,1556065,2025-04-23,Assembly,"Do pass and be re-referred to the Committee on [Natural Resources] with recommendation: To Consent Calendar",18,0,0,0,18
1978630,1559433,2025-04-28,Assembly,"Do pass and be re-referred to the Committee on [Appropriations] with recommendation: To Consent Calendar",14,0,0,0,14
1978631,1561108,2025-04-29,Assembly,"Do pass and be re-referred to the Committee on [Appropriations] with recommendation: To Consent Calendar",7,0,0,0,7
1978631,1577526,2025-05-23,Assembly,"Do pass",14,0,0,1,15
1978631,1583451,2025-06-02,Assembly,"AB 1096 Connolly Assembly Third Reading",79,0,0,0,79
1978631,1598607,2025-07-16,Senate,"Do pass, but first be re-referred to the Committee on [Appropriations] with the recommendation: To Consent Calendar",8,0,0,0,8
1978631,1599576,2025-08-18,Senate,"Placed on suspense file",7,0,0,0,7
1978631,1600442,2025-08-29,Senate,"Do pass",7,0,0,0,7
1978631,1601657,2025-09-09,Senate,"Assembly 3rd Reading AB1096 Connolly By Menjivar",39,0,0,1,40
1978633,1542694,2025-04-08,Assembly,"Do pass as amended, and be re-referred to the Committee on [Judiciary] with recommendation: To Consent Calendar",10,0,0,0,10
1978633,1554588,2025-04-22,Assembly,"Do pass and be re-referred to the Committee on [Appropriations] with recommendation: To Consent Calendar",12,0,0,0,12
1978633,1577833,2025-05-23,Assembly,"Do pass",14,0,0,1,15
1978633,1583439,2025-06-02,Assembly,"AB 1098 Fong Assembly Third Reading",79,0,0,0,79
1978633,1595185,2025-06-25,Senate,"Do pass, but first be re-referred to the Committee on [Judiciary] with the recommendation: To Consent Calendar",7,0,0,0,7
1978633,1598781,2025-07-15,Senate,"Do pass, but first be re-referred to the Committee on [Appropriations] with the recommendation: To Consent Calendar",13,0,0,0,13
1978633,1599580,2025-08-18,Senate,"Placed on suspense file",7,0,0,0,7
1978633,1600524,2025-08-29,Senate,"Do pass",7,0,0,0,7
1978633,1601679,2025-09-09,Senate,"Do pass, but first be re-referred to the Committee on [Appropriations]",5,0,0,2,7
1978633,1601838,2025-09-11,Senate,"Do pass",5,0,0,2,7
1978633,1602248,2025-09-12,Senate,"Assembly 2nd Reading AB1098 Fong et al. By Padilla",38,0,0,2,40
1978633,1602249,2025-09-13,Assembly,"AB 1098 Fong Concurrence in Senate Amendments",78,0,0,2,80
1978634,1562791,2025-04-29,Assembly,"Do pass and be re-referred to the Committee on [Appropriations] with recommendation: To Consent Calendar",7,0,0,0,7
1978634,1577909,2025-05-23,Assembly,"Do pass",14,0,0,1,15
1978634,1584230,2025-06-03,Assembly,"AB 1099 Bryan Assembly Third Reading",79,0,0,0,79
1978634,1597137,2025-06-30,Senate,"Do pass, but first be re-referred to the Committee on [Appropriations] with the recommendation: To Consent Calendar",5,0,0,0,5
1978634,1598248,2025-07-14,Senate,"Placed on suspense file",7,0,0,0,7
1978635,1542745,2025-04-08,Assembly,"Do pass and be re-referred to the Committee on [Appropriations]",5,0,0,4,9
1978636,1554492,2025-04-22,Assembly,"Do pass and be re-referred to the Committee on [Appropriations] with recommendation: To Consent Calendar",18,0,0,0,18
1978637,1561207,2025-04-29,Assembly,"Do pass and be re-referred to the Committee on [Appropriations] with recommendation: To Consent Calendar",7,0,0,0,7
1978638,1562774,2025-04-29,Assembly,"Do pass as amended and be re-referred to the Committee on [Appropriations]",16,0,0,0,16
1978638,1571549,2025-05-14,Assembly,"Do pass",15,0,0,0,15
1978638,1573524,2025-05-19,Assembly,"AB 1103 Ward Assembly Third Reading",75,0,0,4,79
1978638,1595674,2025-06-25,Senate,"Do pass as amended, but first amend, and re-refer to the Committee on [Judiciary]",11,0,0,0,11
1978638,1597942,2025-07-08,Senate,"Do pass as amended, but first amend, and re-refer to the Committee on [Appropriations]",12,0,0,1,13
1978638,1601276,2025-09-08,Senate,"Assembly 3rd Reading AB1103 Ward By Padilla",39,0,0,1,40
1978638,1601652,2025-09-09,Assembly,"AB 1103 Ward Concurrence in Senate Amendments",79,0,0,1,80
1978639,1557575,2025-04-23,Assembly,"Do pass and be re-referred to the Committee on [Utilities and Energy]",6,0,0,1,7
1978639,1564178,2025-04-30,Assembly,"Do pass as amended, and be re-referred to the Committee on [Appropriations] with recommendation: To Consent Calendar",18,0,0,0,18
1978639,1575467,2025-05-21,Assembly,"Do pass. To Consent Calendar",15,0,0,0,15
1978639,1579301,2025-05-27,Assembly,"AB 1104 Pellerin Consent Calendar Second Day Regular Session",76,0,0,3,79
1978639,1589122,2025-06-11,Senate,"Do pass, but first be re-referred to the Committee on [Energy, Utilities and Communications]",5,0,0,0,5
1978639,1597745,2025-07-07,Senate,"Do pass, but first be re-referred to the Committee on [Appropriations] with the recommendation: To Consent Calendar",16,0,0,1,17
1978639,1601608,2025-09-09,Senate,"Assembly 3rd Reading AB1104 Pellerin By Becker",40,0,0,0,40
1978640,1540946,2025-04-08,Assembly,"Do pass. To Consent Calendar",12,0,0,0,12
1978640,1552947,2025-04-21,Assembly,"AB 1105 Quirk-Silva Consent Calendar Second Day Regular Session",73,0,0,6,79
1978640,1597470,2025-07-01,Senate,"Do pass as amended, but first amend, and re-refer to the Committee on [Rules]",13,0,0,0,13
1978640,1597767,2025-07-07,Senate,"Do pass, but first be re-referred to the Committee on [Appropriations] with the recommendation: To Consent Calendar",5,0,0,0,5
1978640,1599531,2025-08-18,Senate,"Placed on suspense file",7,0,0,0,7
1978641,1559374,2025-04-28,Assembly,"Do pass and be re-referred to the Committee on [Appropriations]",14,0,0,0,14
1978642,1540979,2025-04-08,Assembly,"Do pass and be re-referred to the Committee on [Public Safety] with recommendation: To Consent Calendar",17,0,0,1,18
1978642,1562995,2025-04-29,Assembly,"Do pass and be re-referred to the Committee on [Appropriations]",7,0,0,2,9
1978643,1542775,2025-04-08,Assembly,"Do pass as amended and be re-referred to the Committee on [Local Government]",8,0,0,1,9
1978643,1564206,2025-04-30,Assembly,"Do pass and be re-referred to the Committee on [Appropriations]",10,0,0,0,10
1978643,1577281,2025-05-23,Assembly,"Do pass as amended",11,0,0,4,15
1978643,1584238,2025-06-03,Assembly,"AB 1108 Hart Assembly Third Reading",72,0,0,7,79
1978643,1597235,2025-07-01,Senate,"Do pass, but first be re-referred to the Committee on [Local Government]",5,1,0,0,6
1978643,1598597,2025-07-16,Senate,"Do pass as amended, but first amend, and re-refer to the Committee on [Appropriations]",5,2,0,0,7
1978643,1599402,2025-08-18,Senate,"Placed on suspense file",7,0,0,0,7
1978643,1600261,2025-08-29,Senate,"Do pass",5,2,0,0,7
1978643,1602273,2025-09-12,Senate,"Assembly 3rd Reading AB1108 Hart et al. By Limón",29,9,0,2,40
1978643,1602274,2025-09-13,Assembly,"AB 1108 Hart Concurrence in Senate Amendments",71,0,0,9,80
1978644,1540866,2025-04-08,Assembly,"Do pass",9,0,0,3,12
1978644,1569753,2025-05-12,Assembly,"AB 1109 Kalra Assembly Third Reading",59,6,0,14,79
1978644,1597533,2025-07-01,Senate,"Do pass, but first be re-referred to the Committee on [Appropriations]",10,2,0,1,13
1978644,1598290,2025-07-14,Senate,"Placed on suspense file",7,0,0,0,7
1978645,1536763,2025-04-02,Assembly,"Do pass and be re-referred to the Committee on [Appropriations]",6,0,0,1,7
1978646,1545032,2025-04-09,Assembly,"Do pass as amended and be re-referred to the Committee on [Transportation]",8,1,0,0,9
1978646,1561036,2025-04-28,Assembly,"Do pass as amended and be re-referred to the Committee on [Appropriations]",16,0,0,0,16
1978646,1577809,2025-05-23,Assembly,"Do pass",14,0,0,1,15
1978646,1584388,2025-06-03,Assembly,"AB 1111 Soria Assembly Third Reading",73,0,0,6,79
1978646,1597442,2025-07-02,Senate,"Do pass, but first be re-referred to the Committee on [Environmental Quality]",6,0,0,1,7
1978646,1598677,2025-07-16,Senate,"Do pass as amended, but first amend, and re-refer to the Committee on [Appropriations]",8,0,0,0,8
1978646,1599525,2025-08-18,Senate,"Placed on suspense file",7,0,0,0,7
1978647,1564245,2025-04-30,Assembly,"Do pass as amended and be re-referred to the Committee on [Appropriations]",10,0,0,0,10
1978647,1571592,2025-05-14,Assembly,"Do pass",15,0,0,0,15
1978647,1579245,2025-05-27,Assembly,"AB 1112 Wallis Assembly Third Reading",75,0,0,4,79
1978647,1598552,2025-07-16,Senate,"Do pass, but first be re-referred to the Committee on [Appropriations]",7,0,0,0,7
1978648,1562951,2025-04-29,Assembly,"Do pass as amended and be re-referred to the Committee on [Appropriations]",11,1,0,4,16
1978649,1561049,2025-04-28,Assembly,"Do pass and be re-referred to the Committee on [Appropriations] with recommendation: To Consent Calendar",16,0,0,0,16
1978649,1571563,2025-05-14,Assembly,"Do pass. To Consent Calendar",15,0,0,0,15
1978649,1577356,2025-05-23,Assembly,"AB 1114 Ávila Farías Consent Calendar Second Day Regular Session",71,0,0,8,79
1978649,1594571,2025-06-24,Senate,"Do pass and be ordered to the Consent Calendar",14,0,0,1,15
1978649,1597579,2025-07-03,Senate,"Consent Calendar 2nd AB1114 Ávila Farías",35,0,0,5,40
1978649,1598890,2025-07-17,Assembly,"AB 1114 Ávila Farías Concurrence in Senate Amendments",75,0,0,4,79
1978651,1542867,2025-04-09,Assembly,"Do pass as amended and be re-referred to the Committee on [Appropriations]",5,2,0,0,7
1978651,1577653,2025-05-23,Assembly,"Do pass",11,3,0,1,15
1978651,1584402,2025-06-03,Assembly,"AB 1116 Berman Assembly Third Reading",60,18,0,1,79
1978652,1535057,2025-04-02,Assembly,"Do pass as amended and be re-referred to the Committee on [Appropriations]",14,0,0,4,18
1978652,1577135,2025-05-23,Assembly,"Do pass",11,0,0,4,15
1978652,1583397,2025-06-02,Assembly,"AB 1117 Schultz Assembly Third Reading",53,4,0,22,79
1978652,1598480,2025-07-15,Senate,"Do pass as amended, but first amend, and re-refer to the Committee on [Appropriations]",10,3,0,4,17
1978652,1599598,2025-08-18,Senate,"Placed on suspense file",7,0,0,0,7
1978654,1529558,2025-03-26,Assembly,"Do pass as amended and be re-referred to the Committee on [Appropriations]",9,0,0,0,9
1978654,1577422,2025-05-23,Assembly,"Do pass",14,0,0,1,15
1978654,1585033,2025-06-04,Assembly,"AB 1119 Patel Assembly Third Reading",79,0,0,0,79
1978654,1598136,2025-07-09,Senate,"Do pass, but first be re-referred to the Committee on [Appropriations] with the recommendation: To Consent Calendar",7,0,0,0,7
1978654,1599992,2025-08-25,Senate,"Consent Calendar 2nd AB1119 Patel",37,0,0,3,40
1978654,1600761,2025-08-29,Assembly,"AB 1119 Patel Concurrence in Senate Amendments",70,0,0,9,79
1978655,1540959,2025-04-08,Assembly,"Do pass and be re-referred to the Committee on [Appropriations] with recommendation: To Consent Calendar",6,0,0,0,6
1978655,1577706,2025-05-23,Assembly,"Do pass",14,0,0,1,15
1978655,1584273,2025-06-03,Assembly,"AB 1120 Elhawary Assembly Third Reading",79,0,0,0,79
1978655,1597120,2025-06-30,Senate,"Do pass, but first be re-referred to the Committee on [Appropriations] with the recommendation: To Consent Calendar",5,0,0,0,5
1978655,1598267,2025-07-14,Senate,"Placed on suspense file",7,0,0,0,7
1978657,1542901,2025-04-08,Assembly,"Do pass as amended and be re-referred to the Committee on [Education]",9,0,0,1,10
1978658,1544968,2025-04-09,Assembly,"Do pass as amended and be re-referred to the Committee on [Appropriations]",9,0,0,0,9
1978658,1562967,2025-04-30,Assembly,"Do pass",14,0,0,1,15
1978658,1568610,2025-05-08,Assembly,"AB 1123 Muratsuchi Assembly Third Reading",72,0,0,7,79
1978658,1592600,2025-06-18,Senate,"Do pass, but first be re-referred to the Committee on [Appropriations]",6,0,0,1,7
1978658,1601227,2025-09-08,Senate,"Assembly 3rd Reading AB1123 Muratsuchi By Limón",37,0,0,3,40
1978658,1601476,2025-09-09,Assembly,"AB 1123 Muratsuchi Concurrence in Senate Amendments",78,0,0,2,80
1978660,1556018,2025-04-23,Assembly,"Do pass and be re-referred to the Committee on [Appropriations] with recommendation: To Consent Calendar",17,0,0,0,17
1978660,1571618,2025-05-14,Assembly,"Do pass. To Consent Calendar",15,0,0,0,15
1978660,1577740,2025-05-23,Assembly,"AB 1125 Nguyen Consent Calendar Second Day Regular Session",71,0,0,8,79
1978660,1589088,2025-06-11,Senate,"Do pass, but first be re-referred to the Committee on [Appropriations] with the recommendation: To Consent Calendar",5,0,0,0,5
1978660,1601544,2025-09-09,Senate,"Assembly 3rd Reading AB1125 Nguyen By Durazo",40,0,0,0,40
1978662,1542838,2025-04-08,Assembly,"Do pass as amended and be re-referred to the Committee on [Judiciary]",7,1,0,1,9
1978662,1554458,2025-04-22,Assembly,"Do pass and be re-referred to the Committee on [Appropriations]",9,2,0,1,12
1978662,1577455,2025-05-23,Assembly,"Do pass",11,2,0,2,15
1978662,1584327,2025-06-03,Assembly,"AB 1127 Gabriel Assembly Third Reading",58,17,0,4,79
1978662,1597164,2025-07-01,Senate,"Do pass as amended, but first amend, and re-refer to the Committee on [Judiciary]",4,1,0,1,6
1978662,1598632,2025-07-15,Senate,"Do pass, but first be re-referred to the Committee on [Appropriations]",11,2,0,0,13
1978662,1599370,2025-08-18,Senate,"Placed on suspense file",7,0,0,0,7
1978662,1600497,2025-08-29,Senate,"Do pass as amended",5,2,0,0,7
1978662,1602340,2025-09-12,Senate,"Assembly 3rd Reading AB1127 Gabriel et al. By Blakespear",29,9,0,2,40
1978662,1602341,2025-09-13,Assembly,"AB 1127 GABRIEL Concurrence in Senate Amendments",54,16,0,10,80
1978663,1529544,2025-03-26,Assembly,"Do pass and be re-referred to the Committee on [Appropriations] with recommendation: To Consent Calendar",9,0,0,0,9
1978663,1577918,2025-05-23,Assembly,"Do pass",14,0,0,1,15
1978663,1583538,2025-06-02,Assembly,"AB 1128 Muratsuchi Assembly Third Reading",79,0,0,0,79
1978664,1563085,2025-04-29,Assembly,"Do pass and be re-referred to the Committee on [Appropriations]",13,0,0,3,16
1978664,1575482,2025-05-21,Assembly,"Do pass",12,0,0,3,15
1978664,1585815,2025-06-05,Assembly,"AB 1129 Celeste Rodriguez Assembly Third Reading",77,0,0,2,79
1978664,1598083,2025-07-09,Senate,"Do pass, but first be re-referred to the Committee on [Judiciary] with the recommendation: To Consent Calendar",11,0,0,0,11
1978664,1598572,2025-07-15,Senate,"Do pass as amended, and be ordered to the Consent Calendar",13,0,0,0,13
1978665,1554533,2025-04-22,Assembly,"Do pass and be re-referred to the Committee on [Appropriations] with recommendation: To Consent Calendar",18,0,0,0,18
1978665,1575488,2025-05-21,Assembly,"Do pass. To Consent Calendar",15,0,0,0,15
1978665,1579284,2025-05-27,Assembly,"AB 1130 Berman Consent Calendar Second Day Regular Session",76,0,0,3,79
1978665,1596757,2025-06-30,Senate,"Do pass, but first be re-referred to the Committee on [Appropriations]",9,0,0,2,11
1978665,1599500,2025-08-18,Senate,"Placed on suspense file",7,0,0,0,7
1978665,1600519,2025-08-29,Senate,"Do pass",7,0,0,0,7
1978666,1542876,2025-04-09,Assembly,"Do pass and be re-referred to the Committee on [Local Government] with recommendation: To Consent Calendar",12,0,0,0,12
1978666,1556083,2025-04-23,Assembly,"Do pass and be re-referred to the Committee on [Appropriations] with recommendation: To Consent Calendar",10,0,0,0,10
1978666,1577831,2025-05-23,Assembly,"Do pass",14,0,0,1,15
1978666,1584291,2025-06-03,Assembly,"AB 1131 Ta Assembly Third Reading",77,0,0,2,79
1978666,1597464,2025-07-01,Senate,"Do pass, but first be re-referred to the Committee on [Appropriations] with the recommendation: To Consent Calendar",11,0,0,0,11
1978666,1598242,2025-07-14,Senate,"Placed on suspense file",7,0,0,0,7
1978667,1554580,2025-04-21,Assembly,"Do pass and be re-referred to the Committee on [Appropriations]",12,1,0,3,16
1978669,1542834,2025-04-08,Assembly,"Do pass and be re-referred to the Committee on [Judiciary]",8,0,0,1,9
1978669,1554543,2025-04-22,Assembly,"Do pass as amended",12,0,0,0,12
1978669,1577770,2025-05-23,Assembly,"Do pass",14,0,0,1,15
1978669,1583396,2025-06-02,Assembly,"AB 1134 Bains Assembly Third Reading",79,0,0,0,79
1978669,1595219,2025-06-24,Senate,"Do pass, but first be re-referred to the Committee on [Public Safety] with the recommendation: To Consent Calendar",12,0,0,1,13
1978669,1597973,2025-07-08,Senate,"Do pass, but first be re-referred to the Committee on [Appropriations] with the recommendation: To Consent Calendar",6,0,0,0,6
1978669,1599641,2025-08-18,Senate,"Placed on suspense file",7,0,0,0,7
1978669,1600734,2025-08-29,Senate,"Do pass",7,0,0,0,7
1978669,1601154,2025-09-04,Senate,"Special Consent AB1134 Bains et al",39,0,0,1,40
1978671,1536841,2025-04-02,Assembly,"Do pass and be re-referred to the Committee on [Appropriations]",6,0,0,1,7
1978671,1577785,2025-05-23,Assembly,"Do pass",12,0,0,3,15
1978671,1584339,2025-06-03,Assembly,"AB 1136 Ortega Assembly Third Reading",68,2,0,9,79
1978671,1598080,2025-07-09,Senate,"Do pass, but first be re-referred to the Committee on [Judiciary]",4,1,0,0,5
1978671,1598626,2025-07-15,Senate,"Do pass as amended, but first amend, and re-refer to the Committee on [Appropriations]",11,2,0,0,13
1978671,1600066,2025-08-25,Senate,"Placed on suspense file",6,0,0,1,7
1978671,1600460,2025-08-29,Senate,"Do pass",5,2,0,0,7
1978671,1601104,2025-09-04,Senate,"Assembly 3rd Reading AB1136 Ortega et al. By Durazo",29,10,0,1,40
1978671,1601799,2025-09-10,Assembly,"With recommendation: That Senate amendments be concurred in",5,0,0,2,7
1978672,1556046,2025-04-22,Assembly,"Do pass and be re-referred to the Committee on [Judiciary]",13,0,0,2,15
1978672,1561188,2025-04-29,Assembly,"Do pass and be re-referred to the Committee on [Appropriations]",11,0,0,1,12
1978673,1554511,2025-04-22,Assembly,"Do pass and be re-referred to the Committee on [Revenue and Taxation]",8,0,0,1,9
1978673,1561167,2025-04-28,Assembly,"Do pass and be re-referred to the Committee on [Appropriations]",6,1,0,0,7
1978673,1577783,2025-05-23,Assembly,"Do pass as amended",13,0,0,2,15
1978673,1584285,2025-06-03,Assembly,"AB 1138 Zbur Assembly Third Reading",73,1,0,5,79
1978673,1595660,2025-06-26,Senate,"Do pass, but first be re-referred to the Committee on [Appropriations]",5,0,0,0,5
1978673,1596759,2025-06-30,Senate,"Do pass",6,0,0,1,7
1978673,1597599,2025-07-03,Senate,"Assembly 3rd Reading AB1138 Zbur et al. By Allen Urgency Clause",32,2,0,6,40
1978673,1597600,2025-07-03,Assembly,"AB 1138 ZBUR Concurrence - Urgency Added",69,1,0,9,79
1978674,1538937,2025-04-07,Assembly,"Do pass as amended and be re-referred to the Committee on [Water, Parks, and Wildlife]",13,0,0,1,14
1978674,1562920,2025-04-29,Assembly,"Do pass and be re-referred to the Committee on [Appropriations]",12,0,0,1,13
1978674,1571536,2025-05-14,Assembly,"Do pass",15,0,0,0,15
1978674,1577796,2025-05-23,Assembly,"AB 1139 Rogers Assembly Third Reading",70,0,0,9,79
1978674,1597467,2025-07-02,Senate,"Do pass as amended, but first amend, and re-refer to the Committee on [Natural Resources and Water]",8,0,0,0,8
1978674,1598766,2025-07-16,Senate,"Do pass, but first be re-referred to the Committee on [Appropriations] with the recommendation: To Consent Calendar",7,0,0,0,7
1978674,1600030,2025-08-25,Senate,"Consent Calendar 2nd AB1139 Rogers",37,0,0,3,40
1978674,1600248,2025-08-28,Assembly,"AB 1139 Rogers Concurrence in Senate Amendments",76,0,0,3,79
1978675,1542685,2025-04-08,Assembly,"Do pass and be re-referred to the Committee on [Appropriations] with recommendation: To Consent Calendar",9,0,0,0,9
1978675,1577573,2025-05-23,Assembly,"Do pass",14,0,0,1,15
1978675,1583462,2025-06-02,Assembly,"AB 1140 Connolly Assembly Third Reading",77,1,0,1,79
1978675,1597139,2025-07-01,Senate,"Do pass as amended, but first amend, and re-refer to the Committee on [Appropriations]",6,0,0,0,6
1978675,1599606,2025-08-18,Senate,"Placed on suspense file",7,0,0,0,7
1978676,1542719,2025-04-09,Assembly,"Do pass and be re-referred to the Committee on [Transportation] with recommendation: To Consent Calendar",10,0,0,0,10
1978676,1561008,2025-04-28,Assembly,"Do pass and be re-referred to the Committee on [Appropriations] with recommendation: To Consent Calendar",16,0,0,0,16
1978676,1571553,2025-05-14,Assembly,"Do pass. To Consent Calendar",15,0,0,0,15
1978676,1577257,2025-05-23,Assembly,"AB 1141 Lee Consent Calendar Second Day Regular Session",71,0,0,8,79
1978676,1594671,2025-06-24,Senate,"Do pass, but first be re-referred to the Committee on [Appropriations] with the recommendation: To Consent Calendar",14,0,0,1,15
1978676,1598156,2025-07-10,Senate,"Consent Calendar 2nd AB1141 Lee",37,0,0,3,40
1978677,1528262,2025-03-26,Assembly,"Do pass and be re-referred to the Committee on [Appropriations]",8,0,0,0,8
1978677,1542723,2025-04-09,Assembly,"Do pass",14,0,0,1,15
1978677,1572381,2025-05-15,Assembly,"AB 1142 Hoover Assembly Third Reading",70,0,0,9,79
1978677,1597224,2025-07-01,Senate,"Do pass, but first be re-referred to the Committee on [Appropriations] with the recommendation: To Consent Calendar",5,0,0,0,5
1978677,1600399,2025-08-29,Senate,"Consent Calendar 2nd AB1142 Hoover",37,0,0,3,40
1978677,1601144,2025-09-04,Assembly,"AB 1142 Hoover Concurrence in Senate Amendments",77,0,0,2,79
1978678,1540943,2025-04-07,Assembly,"Do pass and be re-referred to the Committee on [Natural Resources]",7,0,0,0,7
1978678,1558712,2025-04-21,Assembly,"Do pass as amended, and be re-referred to the Committee on [Appropriations] with recommendation: To Consent Calendar",14,0,0,0,14
1978678,1577495,2025-05-23,Assembly,"Do pass",11,0,0,4,15
1978678,1583537,2025-06-02,Assembly,"AB 1143 Bennett Assembly Third Reading",79,0,0,0,79
1978678,1594695,2025-06-24,Senate,"Do pass, but first be re-referred to the Committee on [Natural Resources and Water] with the recommendation: To Consent Calendar",15,0,0,0,15
1978678,1597885,2025-07-08,Senate,"Do pass, but first be re-referred to the Committee on [Appropriations] with the recommendation: To Consent Calendar",7,0,0,0,7
1978678,1599386,2025-08-18,Senate,"Placed on suspense file",7,0,0,0,7
1978678,1600492,2025-08-29,Senate,"Do pass",7,0,0,0,7
1978678,1602258,2025-09-12,Senate,"Assembly 3rd Reading AB1143 Bennett By Limón",38,0,0,2,40
1978678,1602259,2025-09-13,Assembly,"AB 1143 Bennett Concurrence in Senate Amendments",79,0,0,1,80
1978679,1542783,2025-04-08,Assembly,"Do pass as amended and be re-referred to the Committee on [Appropriations]",5,0,0,4,9
1978680,1561053,2025-04-28,Assembly,"Do pass and be re-referred to the Committee on [Appropriations] with recommendation: To Consent Calendar",16,0,0,0,16
1978680,1577177,2025-05-23,Assembly,"Do pass as amended",14,0,0,1,15
1978680,1584406,2025-06-03,Assembly,"AB 1145 Jeff Gonzalez Assembly Third Reading",78,0,0,1,79
1978681,1562796,2025-04-29,Assembly,"Do pass as amended and be re-referred to the Committee on [Appropriations]",8,3,0,2,13
1978681,1577262,2025-05-23,Assembly,"Do pass",11,3,0,1,15
1978681,1585813,2025-06-05,Assembly,"AB 1146 Papan Assembly Third Reading",55,17,0,7,79
1978681,1597971,2025-07-08,Senate,"Do pass, but first be re-referred to the Committee on [Judiciary]",7,0,0,0,7
1978681,1598637,2025-07-15,Senate,"Do pass, but first be re-referred to the Committee on [Appropriations]",12,1,0,0,13
1978681,1599577,2025-08-18,Senate,"Placed on suspense file",7,0,0,0,7
1978683,1542839,2025-04-08,Assembly,"Do pass and be re-referred to the Committee on [Judiciary]",5,2,0,0,7
1978683,1554561,2025-04-22,Assembly,"Do pass as amended and be re-referred to the Committee on [Appropriations]",9,2,0,1,12
1978683,1577587,2025-05-23,Assembly,"Do pass",11,3,0,1,15
1978683,1583457,2025-06-02,Assembly,"AB 1148 Sharp-Collins Assembly Third Reading",55,11,0,13,79
1978684,1538949,2025-04-07,Assembly,"Do pass. To Consent Calendar",16,0,0,0,16
1978684,1552841,2025-04-21,Assembly,"AB 1149 Davies Consent Calendar Second Day",73,0,0,6,79
1978684,1588089,2025-06-10,Senate,"Do pass and be ordered to the Consent Calendar",13,0,0,2,15
1978685,1535114,2025-04-01,Assembly,"Do pass",12,1,0,2,15
1978685,1545027,2025-04-10,Assembly,"AB 1150 Schultz Assembly Third Reading",66,1,0,12,79
1978685,1591848,2025-06-17,Senate,"Do pass",11,0,0,2,13
1978685,1600807,2025-09-02,Senate,"Assembly 3rd Reading AB1150 Schultz By Cortese",36,0,0,4,40
1978685,1600908,2025-09-03,Assembly,"AB 1150 Schultz Concurrence in Senate Amendments",72,1,0,6,79
1978686,1554632,2025-04-21,Assembly,"Do pass and be re-referred to the Committee on [Appropriations] with recommendation: To Consent Calendar",15,0,0,1,16
1978687,1558371,2025-04-24,Assembly,"Do pass and be re-referred to the Committee on [Local Government] with recommendation: To Consent Calendar",11,0,0,1,12
1978687,1564168,2025-04-30,Assembly,"Do pass",10,0,0,0,10
1978687,1568642,2025-05-08,Assembly,"AB 1152 Patterson Assembly Third Reading",68,0,0,11,79
1978687,1598430,2025-07-15,Senate,"Do pass, but first be re-referred to the Committee on [Appropriations] with the recommendation: To Consent Calendar",6,0,0,0,6
1978687,1601727,2025-09-10,Senate,"Assembly 3rd Reading AB1152 Patterson By Valladares",39,1,0,0,40
1978687,1602028,2025-09-12,Assembly,"With recommendation: That Senate amendments be concurred in",9,0,0,0,9
1978687,1602110,2025-09-13,Assembly,"AB 1152 Patterson Concurrence in Senate Amendments",74,0,0,6,80
1978688,1538957,2025-04-07,Assembly,"Do pass as amended and be re-referred to the Committee on [Appropriations]",14,0,0,0,14
1978689,1528246,2025-03-26,Assembly,"Do pass and be re-referred to the Committee on [Local Government] with recommendation: To Consent Calendar",10,0,0,1,11
1978689,1542712,2025-04-09,Assembly,"Do pass and be re-referred to the Committee on [Appropriations]",10,0,0,0,10
1978689,1556034,2025-04-23,Assembly,"Do pass",15,0,0,0,15
1978689,1559385,2025-04-28,Assembly,"AB 1154 Carrillo Assembly Third Reading",70,1,0,8,79
1978689,1597447,2025-07-01,Senate,"Do pass as amended, but first amend, and re-refer to the Committee on [Local Government]",11,0,0,0,11
1978689,1598112,2025-07-09,Senate,"Do pass, but first be re-referred to the Committee on [Appropriations]",7,0,0,0,7
1978689,1600858,2025-09-02,Senate,"Assembly 3rd Reading AB1154 Carrillo By Arreguín",40,0,0,0,40
1978689,1601013,2025-09-03,Assembly,"AB 1154 Carrillo Concurrence in Senate Amendments",75,1,0,3,79
1978690,1555902,2025-04-22,Assembly,"Do pass and be re-referred to the Committee on [Judiciary]",9,0,0,1,10
1978690,1561046,2025-04-29,Assembly,"Do pass and be re-referred to the Committee on [Appropriations] with recommendation: To Consent Calendar",12,0,0,0,12
1978690,1571593,2025-05-14,Assembly,"Do pass. To Consent Calendar",15,0,0,0,15
1978690,1577827,2025-05-23,Assembly,"AB 1155 Fong Consent Calendar Second Day Regular Session",71,0,0,8,79
1978690,1592590,2025-06-18,Senate,"Do pass, but first be re-referred to the Committee on [Judiciary] with the recommendation: To Consent Calendar",7,0,0,0,7
1978690,1597850,2025-07-08,Senate,"Do pass, but first be re-referred to the Committee on [Appropriations] with the recommendation: To Consent Calendar",13,0,0,0,13
1978690,1599996,2025-08-25,Senate,"Consent Calendar 2nd AB1155 Fong By Umberg",37,0,0,3,40
1978691,1555900,2025-04-23,Assembly,"Do pass and be re-referred to the Committee on [Utilities and Energy]",9,0,0,1,10
1978691,1555901,2025-04-23,Assembly,"Do pass and be re-referred to the Committee on [Agriculture]",16,0,0,2,18
1978691,1562871,2025-04-30,Assembly,"Do pass as amended and be re-referred to the Committee on [Appropriations]",6,1,0,1,8
1978691,1577552,2025-05-23,Assembly,"Do pass as amended",11,1,0,3,15
1978691,1584278,2025-06-03,Assembly,"AB 1156 Wicks Assembly Third Reading",66,5,0,8,79
1978691,1598064,2025-07-09,Senate,"Do pass, but first be re-referred to the Committee on [Environmental Quality]",5,0,0,2,7
1978691,1598752,2025-07-16,Senate,"Do pass as amended, but first amend, and re-refer to the Committee on [Appropriations]",5,0,0,3,8
1978691,1599461,2025-08-18,Senate,"Placed on suspense file",7,0,0,0,7
1978691,1600477,2025-08-29,Senate,"Do pass",5,1,0,1,7
1978691,1602178,2025-09-12,Senate,"Assembly 3rd Reading AB1156 Wicks By Laird",25,8,0,7,40
1978692,1557580,2025-04-24,Assembly,"Do pass and be re-referred to the Committee on [Judiciary]",7,5,0,0,12
1978693,1554641,2025-04-22,Assembly,"Do pass and be re-referred to the Committee on [Appropriations] with recommendation: To Consent Calendar",12,0,0,0,12
1978695,1542709,2025-04-08,Assembly,"Do pass and be re-referred to the Committee on [Privacy and Consumer Protection]",8,0,0,1,9
1978695,1564204,2025-05-01,Assembly,"Do pass as amended and be re-referred to the Committee on [Appropriations]",13,0,0,2,15
1978696,1540831,2025-04-08,Assembly,"Do pass as amended and be re-referred to the Committee on [Health]",6,0,0,0,6
1978696,1563023,2025-04-29,Assembly,"Do pass as amended, and be re-referred to the Committee on [Appropriations] with recommendation: To Consent Calendar",16,0,0,0,16
1978697,1566716,2025-05-06,Assembly,"Do pass. To Consent Calendar",12,0,0,0,12
1978697,1569884,2025-05-12,Assembly,"AB 1162 Bonta Consent Calendar Second Day Regular Session",77,0,0,2,79
1978697,1595144,2025-06-24,Senate,"Do pass, but first be re-referred to the Committee on [Appropriations] with the recommendation: To Consent Calendar",12,0,0,1,13
1978697,1597759,2025-07-07,Senate,"Placed on suspense file",6,0,0,1,7
1978699,1528291,2025-03-26,Assembly,"Do pass and be re-referred to the Committee on [Appropriations]",8,0,0,0,8
1978699,1577538,2025-05-23,Assembly,"Do pass",14,0,0,1,15
1978699,1583438,2025-06-02,Assembly,"AB 947 Connolly Assembly Third Reading",78,0,0,1,79
1978699,1597257,2025-07-01,Senate,"Do pass, but first be re-referred to the Committee on [Appropriations]",4,0,0,1,5
1978699,1598293,2025-07-14,Senate,"Placed on suspense file",7,0,0,0,7
1978699,1600568,2025-08-29,Senate,"Do pass",7,0,0,0,7
1978699,1600889,2025-09-03,Senate,"Assembly 3rd Reading AB947 Connolly et al",39,0,0,1,40
1978700,1544976,2025-04-09,Assembly,"Do pass as amended",9,0,0,0,9
1978700,1585017,2025-06-04,Assembly,"AB 948 Flora Assembly Third Reading",77,1,0,1,79
1978701,1554609,2025-04-22,Assembly,"Do pass and be re-referred to the Committee on [Appropriations]",7,0,0,1,8
1978702,1562983,2025-04-30,Assembly,"Do pass and be re-referred to the Committee on [Appropriations] with recommendation: To Consent Calendar",7,0,0,0,7
1978702,1571594,2025-05-14,Assembly,"Do pass. To Consent Calendar",15,0,0,0,15
1978702,1577334,2025-05-23,Assembly,"AB 950 Solache Consent Calendar Second Day Regular Session",71,0,0,8,79
1978702,1598520,2025-07-15,Senate,"Do pass, but first be re-referred to the Committee on [Appropriations]",5,0,0,0,5
1978702,1599445,2025-08-18,Senate,"Placed on suspense file",7,0,0,0,7
1978703,1526957,2025-03-25,Assembly,"Do pass and be re-referred to the Committee on [Appropriations] with recommendation: To Consent Calendar",15,0,0,0,15
1978703,1542707,2025-04-09,Assembly,"Do pass. To Consent Calendar",14,0,0,1,15
1978703,1557518,2025-04-24,Assembly,"AB 951 Ta Consent Calendar Second Day Regular Session",75,0,0,4,79
1978703,1592575,2025-06-18,Senate,"Do pass as amended, but first amend, and re-refer to the Committee on [Appropriations] with the recommendation: To Consent Calendar",10,0,0,1,11
1978703,1598171,2025-07-10,Senate,"Consent Calendar 2nd AB951 Ta et al",37,0,0,3,40
1978703,1598231,2025-07-14,Assembly,"AB 951 Ta Concurrence in Senate Amendments",77,0,0,2,79
1978704,1535003,2025-04-01,Assembly,"Do pass and be re-referred to the Committee on [Appropriations] with recommendation: To Consent Calendar",9,0,0,0,9
1978704,1556172,2025-04-23,Assembly,"Do pass. To Consent Calendar",15,0,0,0,15
1978704,1564258,2025-05-01,Assembly,"AB 952 Elhawary Consent Calendar Second Day Regular Session",76,0,0,3,79
1978704,1588106,2025-06-10,Senate,"Do pass, but first be re-referred to the Committee on [Appropriations]",6,0,0,0,6
1978704,1601234,2025-09-08,Senate,"Assembly 3rd Reading AB952 Elhawary By Seyarto",39,0,0,1,40
1978705,1562979,2025-04-30,Assembly,"Do pass as amended, and be re-referred to the Committee on [Appropriations] with recommendation: To Consent Calendar",7,0,0,0,7
1978705,1571600,2025-05-14,Assembly,"Do pass. To Consent Calendar",15,0,0,0,15
1978705,1577728,2025-05-23,Assembly,"AB 953 Pacheco Consent Calendar Second Day Regular Session",71,0,0,8,79
1978705,1597247,2025-07-01,Senate,"Do pass as amended, but first amend, and re-refer to the Committee on [Appropriations] with the recommendation: To Consent Calendar",5,0,0,0,5
1978705,1601288,2025-09-08,Senate,"Assembly 3rd Reading AB953 Pacheco et al. By Umberg",39,0,0,1,40
1978705,1601613,2025-09-09,Assembly,"AB 953 Pacheco Concurrence in Senate Amendments",80,0,0,0,80
1978706,1538948,2025-04-07,Assembly,"Do pass and be re-referred to the Committee on [Appropriations]",12,4,0,0,16
1978706,1577273,2025-05-23,Assembly,"Do pass",11,3,0,1,15
1978706,1583496,2025-06-02,Assembly,"AB 954 Bennett Assembly Third Reading",59,19,0,1,79
1978706,1597835,2025-07-08,Senate,"Do pass, but first be re-referred to the Committee on [Appropriations]",11,4,0,0,15
1978707,1556175,2025-04-22,Assembly,"Do pass as amended and be re-referred to the Committee on [Appropriations]",16,0,0,0,16
1978708,1558379,2025-04-24,Assembly,"Do pass and be re-referred to the Committee on [Local Government]",11,0,0,1,12
1978708,1564269,2025-04-30,Assembly,"Do pass and be re-referred to the Committee on [Appropriations]",9,0,0,1,10
1978708,1571586,2025-05-14,Assembly,"Do pass",12,2,0,1,15
1978708,1577172,2025-05-23,Assembly,"AB 956 Quirk-Silva Assembly Third Reading",58,4,0,17,79
1978709,1540971,2025-04-08,Assembly,"Do pass and be re-referred to the Committee on [Governmental Organization]",12,0,0,6,18
1978709,1556120,2025-04-23,Assembly,"Do pass as amended and be re-referred to the Committee on [Appropriations]",17,1,0,4,22
1978709,1577328,2025-05-23,Assembly,"Do pass",13,1,0,1,15
1978709,1583507,2025-06-02,Assembly,"AB 957 Ortega Assembly Third Reading",64,4,0,11,79
1978709,1596752,2025-06-30,Senate,"Do pass, but first be re-referred to the Committee on [Revenue and Taxation]",5,3,0,3,11
1978709,1597678,2025-07-07,Senate,"[07-07-2025] hearing: Motion to Reconsider. [Reconsideration Granted.]",10,1,0,0,11
1978710,1561032,2025-04-29,Assembly,"Do pass as amended and be re-referred to the Committee on [Appropriations]",8,0,0,2,10
1978710,1577885,2025-05-23,Assembly,"Do pass",11,0,0,4,15
1978711,1529510,2025-03-26,Assembly,"Do pass and be re-referred to the Committee on [Appropriations] with recommendation: To Consent Calendar",9,0,0,0,9
1978711,1577348,2025-05-23,Assembly,"Do pass",14,0,0,1,15
1978711,1583501,2025-06-02,Assembly,"AB 959 Hadwick Assembly Third Reading",78,0,0,1,79
1978711,1595188,2025-06-25,Senate,"Do pass, but first be re-referred to the Committee on [Appropriations] with the recommendation: To Consent Calendar",7,0,0,0,7
1978711,1597735,2025-07-07,Senate,"Placed on suspense file",6,0,0,1,7
1978711,1600633,2025-08-29,Senate,"Do pass as amended",7,0,0,0,7
1978711,1601883,2025-09-11,Senate,"Special Consent AB959 Hadwick By Rubio",40,0,0,0,40
1978711,1602282,2025-09-13,Assembly,"AB 959 Hadwick Concurrence in Senate Amendments",73,0,0,7,80
1978712,1556127,2025-04-22,Assembly,"Do pass as amended, and be re-referred to the Committee on [Appropriations] with recommendation: To Consent Calendar",16,0,0,0,16
1978712,1577429,2025-05-23,Assembly,"Do pass",14,0,0,1,15
1978712,1583374,2025-06-02,Assembly,"AB 960 Garcia Assembly Third Reading",79,0,0,0,79
1978712,1595661,2025-06-25,Senate,"Do pass, but first be re-referred to the Committee on [Appropriations] with the recommendation: To Consent Calendar",11,0,0,0,11
1978712,1598263,2025-07-14,Senate,"Do pass",7,0,0,0,7
1978712,1600951,2025-09-03,Senate,"Assembly 3rd Reading AB960 Garcia et al. By Limón",40,0,0,0,40
1978712,1601087,2025-09-04,Assembly,"AB 960 Garcia Concurrence in Senate Amendments",78,0,0,1,79
1978713,1528322,2025-03-25,Assembly,"Do pass and be re-referred to the Committee on [Appropriations] with recommendation: To Consent Calendar",7,0,0,0,7
1978713,1577307,2025-05-23,Assembly,"Do pass",14,0,0,1,15
1978713,1583490,2025-06-02,Assembly,"AB 961 Ávila Farías Assembly Third Reading",79,0,0,0,79
1978713,1597511,2025-07-02,Senate,"Do pass, but first be re-referred to the Committee on [Judiciary] with the recommendation: To Consent Calendar",8,0,0,0,8
1978713,1597878,2025-07-08,Senate,"Do pass, but first be re-referred to the Committee on [Appropriations] with the recommendation: To Consent Calendar",13,0,0,0,13
1978713,1599594,2025-08-18,Senate,"Placed on suspense file",7,0,0,0,7
1978713,1600640,2025-08-29,Senate,"Do pass",7,0,0,0,7
1978713,1601805,2025-09-10,Senate,"Assembly 3rd Reading AB961 Ávila Farías et al. By Grayson",40,0,0,0,40
1978714,1545021,2025-04-09,Assembly,"Do pass. To Consent Calendar",9,0,0,0,9
1978714,1557546,2025-04-24,Assembly,"AB 962 Hoover Consent Calendar Second Day Regular Session",75,0,0,4,79
1978714,1589118,2025-06-11,Senate,"Do pass as amended",6,0,0,1,7
1978714,1602337,2025-09-12,Senate,"Assembly 3rd Reading AB962 Hoover By Allen",38,0,0,2,40
1978714,1602338,2025-09-13,Assembly,"AB 962 Hoover Concurrence in Senate Amendments",74,0,0,6,80
1978715,1557488,2025-04-23,Assembly,"Do pass and be re-referred to the Committee on [Appropriations]",7,0,0,0,7
1978715,1577403,2025-05-23,Assembly,"Do pass",12,2,0,1,15
1978715,1583424,2025-06-02,Assembly,"AB 963 Petrie-Norris Assembly Third Reading",69,4,0,6,79
1978715,1598104,2025-07-09,Senate,"Do pass, but first be re-referred to the Committee on [Judiciary]",4,1,0,0,5
1978715,1598707,2025-07-15,Senate,"Do pass as amended, but first amend, and re-refer to the Committee on [Appropriations]",11,2,0,0,13
1978715,1599468,2025-08-18,Senate,"Placed on suspense file",7,0,0,0,7
1978715,1600572,2025-08-29,Senate,"Do pass",6,1,0,0,7
1978715,1602251,2025-09-12,Senate,"Assembly 3rd Reading AB963 Petrie-Norris By Durazo",29,8,0,3,40
1978715,1602252,2025-09-13,Assembly,"AB 963 Petrie-Norris Concurrence in Senate Amendments",66,6,0,8,80
1978716,1556110,2025-04-23,Assembly,"Do pass and be re-referred to the Committee on [Education]",10,0,0,0,10
1978716,1564295,2025-04-30,Assembly,"Do pass and be re-referred to the Committee on [Appropriations] with recommendation: To Consent Calendar",9,0,0,0,9
1978717,1561009,2025-04-28,Assembly,"Do pass and be re-referred to the Committee on [Appropriations] with recommendation: To Consent Calendar",16,0,0,0,16
1978717,1571555,2025-05-14,Assembly,"Do pass. To Consent Calendar",15,0,0,0,15
1978717,1577605,2025-05-23,Assembly,"AB 965 Dixon Consent Calendar Second Day Regular Session",71,0,0,8,79
1978717,1594562,2025-06-24,Senate,"Do pass, but first be re-referred to the Committee on [Appropriations] with the recommendation: To Consent Calendar",14,0,0,1,15
1978717,1598178,2025-07-10,Senate,"Consent Calendar 2nd AB965 Dixon",37,0,0,3,40
1978719,1554531,2025-04-22,Assembly,"Do pass as amended and be re-referred to the Committee on [Appropriations]",17,0,0,1,18
1978719,1575469,2025-05-21,Assembly,"Do pass",15,0,0,0,15
1978719,1579262,2025-05-27,Assembly,"AB 967 Valencia Assembly Third Reading",76,0,0,3,79
1978720,1561155,2025-04-29,Assembly,"Do pass and be re-referred to the Committee on [Appropriations]",17,0,0,1,18
1978720,1575463,2025-05-21,Assembly,"Do pass",15,0,0,0,15
1978720,1579290,2025-05-27,Assembly,"AB 968 Boerner Assembly Third Reading",77,0,0,2,79
1978720,1598202,2025-07-14,Senate,"Do pass, but first be re-referred to the Committee on [Appropriations]",11,0,0,0,11
1978721,1540942,2025-04-08,Assembly,"Do pass as amended and be re-referred to the Committee on [Appropriations]",6,0,0,0,6
1978721,1577254,2025-05-23,Assembly,"Do pass as amended",11,0,0,4,15
1978721,1583521,2025-06-02,Assembly,"AB 969 Celeste Rodriguez Assembly Third Reading",79,0,0,0,79
1978721,1597773,2025-07-07,Senate,"Do pass, but first be re-referred to the Committee on [Appropriations] with the recommendation: To Consent Calendar",5,0,0,0,5
1978721,1599453,2025-08-18,Senate,"Placed on suspense file",7,0,0,0,7
1978721,1600263,2025-08-29,Senate,"Do pass as amended",7,0,0,0,7
1978721,1601969,2025-09-11,Senate,"Special Consent AB969 Celeste Rodriguez By Durazo",40,0,0,0,40
1978721,1602361,2025-09-12,Assembly,"AB 969 Celeste Rodriguez Concurrence in Senate Amendments",80,0,0,0,80
1978722,1540968,2025-04-08,Assembly,"Do pass as amended and be re-referred to the Committee on [Public Safety]",6,0,0,0,6
1978723,1562797,2025-04-30,Assembly,"Do pass and be re-referred to the Committee on [Appropriations]",19,0,0,3,22
1978724,1555984,2025-04-22,Assembly,"Do pass as amended and be re-referred to the Committee on [Judiciary]",7,1,0,2,10
1978724,1566719,2025-05-06,Assembly,"Do pass",9,2,0,1,12
1978724,1572428,2025-05-15,Assembly,"AB 972 Wilson Assembly Third Reading",58,8,0,13,79
1978725,1538977,2025-04-07,Assembly,"Do pass as amended and be re-referred to the Committee on [Judiciary]",14,0,0,0,14
1978725,1561079,2025-04-29,Assembly,"Do pass and be re-referred to the Committee on [Appropriations]",9,0,0,3,12
1978726,1555929,2025-04-22,Assembly,"Do pass and be re-referred to the Committee on [Appropriations]",15,0,0,1,16
1978727,1562827,2025-04-29,Assembly,"Do pass as amended and be re-referred to the Committee on [Appropriations]",13,0,0,0,13
1978727,1571610,2025-05-14,Assembly,"Do pass",15,0,0,0,15
1978727,1577456,2025-05-23,Assembly,"AB 975 Gallagher Assembly Third Reading",72,0,0,7,79
1978727,1598702,2025-07-16,Senate,"Do pass as amended, but first amend, and re-refer to the Committee on [Appropriations] with the recommendation: To Consent Calendar",7,0,0,0,7
1978727,1601472,2025-09-09,Senate,"Assembly 3rd Reading AB975 Gallagher By Niello",40,0,0,0,40
1978727,1602287,2025-09-13,Assembly,"AB 975 Gallagher Concurrence in Senate Amendments",73,0,0,7,80
1978729,1542741,2025-04-08,Assembly,"Do pass and be re-referred to the Committee on [Appropriations]",10,0,0,0,10
1978729,1577689,2025-05-23,Assembly,"Do pass as amended",11,0,0,4,15
1978729,1583516,2025-06-02,Assembly,"AB 977 Ramos Assembly Third Reading",79,0,0,0,79
1978729,1598600,2025-07-16,Senate,"Do pass, but first be re-referred to the Committee on [Appropriations] with the recommendation: To Consent Calendar",7,0,0,0,7
1978729,1600021,2025-08-25,Senate,"Consent Calendar 2nd AB977 Ramos et al",37,0,0,3,40
1978729,1600815,2025-09-02,Assembly,"AB 977 Ramos Concurrence in Senate Amendments",78,0,0,1,79
1978730,1538889,2025-04-07,Assembly,"Do pass and be re-referred to the Committee on [Appropriations] with recommendation: To Consent Calendar",16,0,0,0,16
1978730,1562898,2025-04-30,Assembly,"Do pass. To Consent Calendar",14,0,0,1,15
1978730,1568651,2025-05-08,Assembly,"AB 978 Hoover Consent Calendar Second Day Regular Session",69,0,0,10,79
1978730,1588111,2025-06-10,Senate,"Do pass, but first be re-referred to the Committee on [Appropriations]",13,0,0,2,15
1978730,1601606,2025-09-09,Senate,"Assembly 3rd Reading AB978 Hoover By Strickland",40,0,0,0,40
1978730,1602268,2025-09-12,Assembly,"AB 978 Hoover Concurrence in Senate Amendments",79,0,0,1,80
1978731,1564210,2025-05-01,Assembly,"Do pass and be re-referred to the Committee on [Appropriations] with recommendation: To Consent Calendar",13,0,0,2,15
1978731,1577164,2025-05-23,Assembly,"Do pass",14,0,0,1,15
1978731,1583441,2025-06-02,Assembly,"AB 979 Irwin Assembly Third Reading",78,0,0,1,79
1978731,1594618,2025-06-24,Senate,"Do pass, but first be re-referred to the Committee on [Judiciary] with the recommendation: To Consent Calendar",15,0,0,0,15
1978731,1597550,2025-07-01,Senate,"Do pass, but first be re-referred to the Committee on [Appropriations] with the recommendation: To Consent Calendar",13,0,0,0,13
1978731,1599415,2025-08-18,Senate,"Placed on suspense file",7,0,0,0,7
1978731,1600751,2025-08-29,Senate,"Do pass as amended",7,0,0,0,7
1978731,1601901,2025-09-11,Senate,"Special Consent AB979 Irwin et al. By McNerney",40,0,0,0,40
1978731,1602118,2025-09-12,Assembly,"AB 979 Irwin Concurrence in Senate Amendments",79,0,0,1,80
1978733,1554548,2025-04-22,Assembly,"Do pass as amended and be re-referred to the Committee on [Appropriations]",9,0,0,0,9
1978734,1558713,2025-04-21,Assembly,"Do pass and be re-referred to the Committee on [Appropriations] with recommendation: To Consent Calendar",14,0,0,0,14
1978734,1577200,2025-05-23,Assembly,"Do pass",14,0,0,1,15
1978734,1583376,2025-06-02,Assembly,"AB 982 Carrillo Assembly Third Reading",78,1,0,0,79
1978734,1598628,2025-07-16,Senate,"Do pass as amended, but first amend, and re-refer to the Committee on [Appropriations] with the recommendation: To Consent Calendar",7,0,0,0,7
1978734,1599574,2025-08-18,Senate,"Placed on suspense file",7,0,0,0,7
1978734,1600365,2025-08-29,Senate,"Do pass as amended",7,0,0,0,7
1978736,1566729,2025-05-05,Assembly,"Do pass and be re-referred to the Committee on [Appropriations]",7,0,0,0,7
1978737,1554461,2025-04-22,Assembly,"Do pass and be re-referred to the Committee on [Appropriations]",17,0,0,1,18
1978737,1567877,2025-05-07,Assembly,"Do pass",15,0,0,0,15
1978737,1584271,2025-06-03,Assembly,"AB 985 Ahrens Assembly Third Reading",64,1,0,14,79
1978737,1598106,2025-07-09,Senate,"Do pass, but first be re-referred to the Committee on [Banking and Financial Institutions]",3,0,0,2,5
1978737,1599623,2025-08-18,Senate,"Placed on suspense file",7,0,0,0,7
1978737,1600632,2025-08-29,Senate,"Do pass as amended",7,0,0,0,7
1978737,1601860,2025-09-11,Senate,"Assembly 3rd Reading AB985 Schiavo et al. By Blakespear Urgency Clause",39,0,0,1,40
1978737,1602193,2025-09-13,Assembly,"AB 985 Schiavo Concurrence - Urgency Added",78,0,0,2,80
1978738,1561175,2025-04-28,Assembly,"Do pass and be re-referred to the Committee on [Appropriations]",6,0,0,1,7
1978738,1577945,2025-05-23,Assembly,"Do pass as amended",11,0,0,4,15
1978738,1584403,2025-06-03,Assembly,"AB 986 Muratsuchi Assembly Third Reading",79,0,0,0,79
1978738,1597876,2025-07-08,Senate,"Do pass, but first be re-referred to the Committee on [Appropriations] with the recommendation: To Consent Calendar",15,0,0,0,15
1978738,1599569,2025-08-18,Senate,"Placed on suspense file",7,0,0,0,7
1978738,1600604,2025-08-29,Senate,"Do pass as amended",7,0,0,0,7
1978738,1601989,2025-09-11,Senate,"Special Consent AB986 Muratsuchi et al. By Allen",40,0,0,0,40
1978738,1602204,2025-09-12,Assembly,"AB 986 Muratsuchi Concurrence in Senate Amendments",80,0,0,0,80
1978739,1561061,2025-04-28,Assembly,"Do pass and be re-referred to the Committee on [Appropriations]",16,0,0,0,16
1978739,1571569,2025-05-14,Assembly,"Do pass",15,0,0,0,15
1978739,1573638,2025-05-19,Assembly,"AB 987 Sharp-Collins Assembly Third Reading",75,0,0,4,79
1978739,1594676,2025-06-24,Senate,"Do pass, but first be re-referred to the Committee on [Judiciary] with the recommendation: To Consent Calendar",14,0,0,1,15
1978739,1597918,2025-07-08,Senate,"Do pass, but first be re-referred to the Committee on [Appropriations] with the recommendation: To Consent Calendar",13,0,0,0,13
1978739,1601007,2025-09-03,Senate,"Assembly 3rd Reading AB987 Sharp-Collins et al. By Wahab",40,0,0,0,40
1978739,1601335,2025-09-08,Assembly,"AB 987 Sharp-Collins Concurrence in Senate Amendments",79,0,0,1,80
1978740,1542819,2025-04-08,Assembly,"Do pass as amended and be re-referred to the Committee on [Education]",8,0,0,2,10
1978740,1564255,2025-04-30,Assembly,"Do pass as amended, and be re-referred to the Committee on [Appropriations] with recommendation: To Consent Calendar",9,0,0,0,9
1978741,1535025,2025-04-02,Assembly,"Do pass and be re-referred to the Committee on [Public Employment and Retirement]",20,0,0,2,22
1978741,1556048,2025-04-23,Assembly,"Do pass and be re-referred to the Committee on [Appropriations]",7,0,0,0,7
1978742,1542762,2025-04-08,Assembly,"Do pass. To Consent Calendar",7,0,0,0,7
1978742,1557482,2025-04-24,Assembly,"AB 990 Hadwick Consent Calendar Second Day Regular Session",75,0,0,4,79
1978742,1592559,2025-06-18,Senate,"Do pass and be ordered to the Consent Calendar",6,0,0,2,8
1978744,1554577,2025-04-22,Assembly,"Do pass as amended, and be re-referred to the Committee on [Appropriations] with recommendation: To Consent Calendar",9,0,0,0,9
1978744,1567897,2025-05-07,Assembly,"Do pass. To Consent Calendar",15,0,0,0,15
1978744,1572395,2025-05-15,Assembly,"AB 992 Irwin Consent Calendar Second Day Regular Session",69,0,0,10,79
1978744,1594560,2025-06-24,Senate,"Do pass as amended, but first amend, and re-refer to the Committee on [Appropriations]",6,0,0,0,6
1978744,1597669,2025-07-07,Senate,"Placed on suspense file",6,0,0,1,7
1978744,1600501,2025-08-29,Senate,"Do pass as amended",7,0,0,0,7
1978744,1601554,2025-09-09,Senate,"Assembly 3rd Reading AB992 Irwin By Seyarto",40,0,0,0,40
1978745,1542919,2025-04-08,Assembly,"Do pass and be re-referred to the Committee on [Appropriations] with recommendation: To Consent Calendar",7,0,0,0,7
1978745,1577357,2025-05-23,Assembly,"Do pass as amended",14,0,0,1,15
1978745,1585018,2025-06-04,Assembly,"AB 993 Hadwick Assembly Third Reading",78,0,0,1,79
1978745,1598555,2025-07-16,Senate,"Do pass, but first be re-referred to the Committee on [Appropriations] with the recommendation: To Consent Calendar",8,0,0,0,8
1978745,1599498,2025-08-18,Senate,"Placed on suspense file",7,0,0,0,7
1978745,1600296,2025-08-29,Senate,"Do pass",7,0,0,0,7
1978745,1601110,2025-09-04,Senate,"Special Consent AB993 Hadwick",39,0,0,1,40
1978746,1554613,2025-04-22,Assembly,"Do pass as amended, and be re-referred to the Committee on [Appropriations] with recommendation: To Consent Calendar",9,0,0,0,9
1978747,1564162,2025-05-01,Assembly,"Do pass as amended, and be re-referred to the Committee on [Appropriations] with recommendation: To Consent Calendar",13,0,0,2,15
1978748,1559371,2025-04-28,Assembly,"Do pass as amended, and be re-referred to the Committee on [Appropriations] with recommendation: To Consent Calendar",14,0,0,0,14
1978748,1577392,2025-05-23,Assembly,"Do pass as amended",11,0,0,4,15
1978748,1583519,2025-06-02,Assembly,"AB 996 Pellerin Assembly Third Reading",75,0,0,4,79
1978748,1594645,2025-06-24,Senate,"Do pass, but first be re-referred to the Committee on [Appropriations] with the recommendation: To Consent Calendar",7,0,0,0,7
1978748,1597750,2025-07-07,Senate,"Placed on suspense file",6,0,0,1,7
1978748,1600598,2025-08-29,Senate,"Do pass",7,0,0,0,7
1978748,1601169,2025-09-04,Senate,"Special Consent AB996 Pellerin",39,0,0,1,40
1978749,1540869,2025-04-08,Assembly,"Do pass and be re-referred to the Committee on [Transportation] with recommendation: To Consent Calendar",6,0,0,0,6
1978749,1561060,2025-04-28,Assembly,"Do pass and be re-referred to the Committee on [Appropriations] with recommendation: To Consent Calendar",16,0,0,0,16
1978750,1561157,2025-04-29,Assembly,"Do pass and be re-referred to the Committee on [Appropriations]",7,0,0,0,7
1978750,1577304,2025-05-23,Assembly,"Do pass as amended",14,0,0,1,15
1978750,1585115,2025-06-04,Assembly,"AB 998 Hadwick Assembly Third Reading",77,0,0,2,79
1978750,1598566,2025-07-16,Senate,"Do pass as amended, but first amend, and re-refer to the Committee on [Appropriations] with the recommendation: To Consent Calendar",8,0,0,0,8
1978750,1599626,2025-08-18,Senate,"Placed on suspense file",7,0,0,0,7
1978752,1598772,2025-07-16,Assembly,"Be adopted and re-referred to the Committee on [Appropriations]",4,2,0,1,7
1978752,1599697,2025-08-19,Assembly,"Be adopted and re-referred to the Committee on [Appropriations]",5,2,0,0,7
1978752,1599742,2025-08-20,Assembly,"Be adopted",11,4,0,0,15
1978752,1599877,2025-08-21,Senate,"Assembly 3rd Reading ACA8 Rivas et al. By McGuire",30,8,0,2,40
1978752,1599878,2025-08-21,Assembly,"ACA 8 RIVAS Assembly Third Reading By BERMAN",57,20,0,2,79
1978753,1565231,2025-05-05,Assembly,"Be adopted. To Consent Calendar",9,0,0,2,11
1978753,1568618,2025-05-08,Assembly,"ACR 36 Carrillo Consent Calendar Second Day Regular Session",69,0,0,10,79
1978753,1593178,2025-06-19,Senate,"Special Consent ACR36 Carrillo et al",35,0,0,5,40
1978754,1561183,2025-04-28,Assembly,"Be adopted. To Consent Calendar",16,0,0,0,16
1978754,1564205,2025-05-01,Assembly,"ACR 37 Wallis Consent Calendar Second Day Regular Session",76,0,0,3,79
1978754,1588097,2025-06-10,Senate,"Be adopted, but first be re-referred to the Committee on [Appropriations] with recommendation: To Consent Calendar",13,0,0,2,15
1978754,1595958,2025-06-27,Senate,"Consent Calendar 2nd ACR37 Wallis et al",38,0,0,2,40
1978757,1540880,2025-04-08,Senate,"Do pass, but first be re-referred to the Committee on [Appropriations]",5,1,0,0,6
1978757,1552827,2025-04-21,Senate,"Placed on suspense file",6,0,0,1,7
1978757,1577658,2025-05-23,Senate,"Do pass as amended",5,1,0,1,7
1978757,1584267,2025-06-03,Senate,"Senate 3rd Reading SB524 Arreguín",28,10,0,2,40
1978757,1597176,2025-07-01,Assembly,"Do pass and be re-referred to the Committee on [Privacy and Consumer Protection]",6,0,0,3,9
1978757,1598776,2025-07-16,Assembly,"Do pass as amended and be re-referred to the Committee on [Appropriations]",12,2,0,1,15
1978757,1600483,2025-08-29,Assembly,"Do pass as amended",11,3,0,1,15
1978757,1601381,2025-09-08,Assembly,"SB 524 Arreguín Senate Third Reading By Schultz",50,17,0,13,80
1978757,1601734,2025-09-10,Senate,"Unfinished Business SB524 Arreguín et al. Concurrence",28,10,0,2,40
1978758,1555976,2025-04-23,Senate,"Do pass",4,0,0,3,7
1978758,1586347,2025-06-02,Senate,"Senate 3rd Reading SB525 Jones",37,0,0,3,40
1978758,1598043,2025-07-09,Assembly,"Do pass and be re-referred to the Committee on [Appropriations]",15,0,0,2,17
1978758,1600730,2025-08-29,Assembly,"Do pass",15,0,0,0,15
1978758,1601382,2025-09-08,Assembly,"SB 525 Jones Senate Third Reading By Wallis",79,0,0,1,80
1978759,1555894,2025-04-23,Senate,"Do pass as amended, but first amend, and re-refer to the Committee on [Appropriations]",6,1,0,1,8
1978759,1569889,2025-05-12,Senate,"Placed on suspense file",7,0,0,0,7
1978759,1577330,2025-05-23,Senate,"Do pass",5,1,0,1,7
1978759,1585058,2025-06-04,Senate,"Senate 3rd Reading SB526 Menjivar et al",26,10,0,4,40
1978761,1564211,2025-04-30,Senate,"Do pass as amended, but first amend, and re-refer to the Committee on [Appropriations]",8,2,0,1,11
1978761,1573578,2025-05-19,Senate,"Placed on suspense file",5,0,0,2,7
1978762,1571621,2025-05-14,Senate,"Do pass, but first be re-referred to the Committee on [Appropriations]",2,0,0,3,5
1978762,1571622,2025-05-14,Senate,"[First] hearing set for [05-14-2025]: Failed passage in Committee. Reconsideration granted",5,0,0,0,5
1978763,1544983,2025-04-09,Senate,"Do pass as amended, but first amend, and re-refer to the Committee on [Appropriations]",9,0,0,2,11
1978763,1559402,2025-04-28,Senate,"Placed on suspense file",7,0,0,0,7
1978763,1577134,2025-05-23,Senate,"Do pass as amended",5,1,0,1,7
1978763,1581683,2025-05-29,Senate,"Senate 3rd Reading SB530 Richardson",28,7,0,5,40
1978763,1598500,2025-07-15,Assembly,"Do pass and be re-referred to the Committee on [Appropriations]",15,0,0,1,16
1978763,1600350,2025-08-29,Assembly,"Do pass",14,0,0,1,15
1978763,1601458,2025-09-09,Assembly,"SB 530 Richardson Senate Third Reading By Patel",78,1,0,1,80
1978763,1601721,2025-09-10,Senate,"Unfinished Business SB530 Richardson et al. Concurrence",32,6,0,2,40
1978764,1562854,2025-04-30,Senate,"Do pass, but first be re-referred to the Committee on [Appropriations]",0,2,0,5,7
1978764,1562855,2025-04-30,Senate,"[Second] hearing set for [04-30-2025]: Failed passage in Committee. Reconsideration granted",7,0,0,0,7
1978766,1525423,2025-03-24,Senate,"Do pass as amended, but first amend, and re-refer to the Committee on [Transportation]",16,0,0,1,17
1978766,1542749,2025-04-08,Senate,"Do pass and be ordered to the Consent Calendar",15,0,0,0,15
1978766,1557557,2025-04-24,Senate,"Consent Calendar 2nd SB533 Richardson",37,0,0,3,40
1978766,1597679,2025-07-07,Assembly,"Do pass and be re-referred to the Committee on [Utilities and Energy]",15,0,0,1,16
1978766,1598054,2025-07-09,Assembly,"Do pass as amended, and be re-referred to the Committee on [Appropriations] with recommendation: To Consent Calendar",18,0,0,0,18
1978766,1601604,2025-09-09,Assembly,"SB 533 Richardson Senate Third Reading By Wilson",80,0,0,0,80
1978766,1601845,2025-09-11,Senate,"Unfinished Business SB533 Richardson Concurrence",40,0,0,0,40
1978767,1538921,2025-04-07,Senate,"Do pass, but first be re-referred to the Committee on [Local Government]",10,0,0,1,11
1978767,1567893,2025-05-07,Senate,"Do pass as amended, and be ordered to the Consent Calendar",7,0,0,0,7
1978767,1572375,2025-05-15,Senate,"Consent Calendar 2nd SB534 Padilla",34,0,0,6,40
1978768,1564160,2025-04-30,Senate,"Do pass, but first be re-referred to the Committee on [Appropriations]",8,0,0,3,11
1978768,1569747,2025-05-12,Senate,"Placed on suspense file",7,0,0,0,7
1978768,1577516,2025-05-23,Senate,"Do pass",5,0,0,2,7
1978768,1580541,2025-05-28,Senate,"Senate 3rd Reading SB535 Richardson",28,3,0,9,40
1978768,1598383,2025-07-15,Assembly,"Do pass as amended and be re-referred to the Committee on [Appropriations]",14,0,0,2,16
1978769,1555884,2025-04-23,Senate,"Do pass as amended, but first amend, and re-refer to the Committee on [Appropriations]",5,0,0,0,5
1978769,1569757,2025-05-12,Senate,"Placed on suspense file",7,0,0,0,7
1978769,1577415,2025-05-23,Senate,"Do pass as amended",6,0,0,1,7
1978769,1585114,2025-06-04,Senate,"Senate 3rd Reading SB536 Archuleta",39,0,0,1,40
1978770,1554477,2025-04-22,Senate,"Do pass as amended, but first amend, and re-refer to the Committee on [Appropriations]",5,0,0,1,6
1978770,1565284,2025-05-05,Senate,"Placed on suspense file",7,0,0,0,7
1978772,1542751,2025-04-09,Senate,"Do pass as amended, but first amend, and re-refer to the Committee on [Appropriations]",7,0,0,0,7
1978772,1559453,2025-04-28,Senate,"Placed on suspense file",7,0,0,0,7
1978773,1554450,2025-04-21,Senate,"Do pass, but first be re-referred to the Committee on [Judiciary]",17,0,0,0,17
1978773,1562933,2025-04-29,Senate,"Do pass as amended, but first amend, and re-refer to the Committee on [Appropriations]",11,0,0,2,13
1978773,1573548,2025-05-19,Senate,"Placed on suspense file",5,0,0,2,7
1978773,1577604,2025-05-23,Senate,"Do pass as amended",4,1,0,2,7
1978773,1585013,2025-06-04,Senate,"Senate 3rd Reading SB540 Becker et al",33,1,0,6,40
1978773,1585014,2025-06-04,Senate,"Senate 3rd Reading SB540 Becker et al. Reconsider",39,0,0,1,40
1978773,1585015,2025-06-04,Senate,"Senate 3rd Reading SB540 Becker et al",36,0,0,4,40
1978774,1554459,2025-04-21,Senate,"Do pass as amended, but first amend, and re-refer to the Committee on [Appropriations]",13,4,0,0,17
1978774,1569749,2025-05-12,Senate,"Placed on suspense file",7,0,0,0,7
1978774,1577614,2025-05-23,Senate,"Do pass as amended",5,1,0,1,7
1978774,1584290,2025-06-03,Senate,"Senate 3rd Reading SB541 Becker et al",27,10,0,3,40
1978774,1598664,2025-07-16,Assembly,"Do pass as amended and be re-referred to the Committee on [Appropriations]",13,2,0,3,18
1978774,1600272,2025-08-29,Assembly,"Do pass as amended",11,4,0,0,15
1978774,1602133,2025-09-12,Senate,"Unfinished Business SB541 Becker et al. Concurrence",29,8,0,3,40
1978774,1602134,2025-09-12,Assembly,"SB 541 Becker Senate Third Reading By Schultz",57,15,0,8,80
1978775,1554439,2025-04-22,Senate,"Do pass as amended, but first amend, and re-refer to the Committee on [Appropriations]",4,2,0,1,7
1978775,1569787,2025-05-12,Senate,"Placed on suspense file",7,0,0,0,7
1978775,1577431,2025-05-23,Senate,"Do pass as amended",5,1,0,1,7
1978775,1584373,2025-06-03,Senate,"Senate 3rd Reading SB542 Limón",28,11,0,1,40
1978775,1597730,2025-07-07,Assembly,"Do pass and be re-referred to the Committee on [Emergency Management]",8,3,0,3,14
1978775,1598522,2025-07-14,Assembly,"Do pass and be re-referred to the Committee on [Appropriations]",5,2,0,0,7
1978775,1600400,2025-08-29,Assembly,"Do pass as amended",11,4,0,0,15
1978776,1556094,2025-04-22,Senate,"Do pass, but first be re-referred to the Committee on [Local Government]",11,0,0,0,11
1978776,1563091,2025-04-30,Senate,"Do pass, but first be re-referred to the Committee on [Appropriations]",7,0,0,0,7
1978776,1579274,2025-05-27,Senate,"Senate 3rd Reading SB543 McNerney",39,0,0,1,40
1978776,1592612,2025-06-18,Assembly,"Do pass as amended and be re-referred to the Committee on [Local Government]",11,0,0,1,12
1978776,1598897,2025-07-16,Assembly,"Do pass and be re-referred to the Committee on [Appropriations]",10,0,0,0,10
1978776,1599771,2025-08-20,Assembly,"Do pass",15,0,0,0,15
1978776,1600224,2025-08-28,Assembly,"SB 543 McNerney Senate Third Reading By Carrillo",75,0,0,4,79
1978776,1600854,2025-09-02,Senate,"Unfinished Business SB543 McNerney et al. Concurrence",40,0,0,0,40
1978777,1525459,2025-03-24,Senate,"Do pass, but first be re-referred to the Committee on [Transportation]",16,0,0,1,17
1978777,1542851,2025-04-08,Senate,"Do pass, but first be re-referred to the Committee on [Appropriations] with the recommendation: To Consent Calendar",15,0,0,0,15
1978777,1564293,2025-05-01,Senate,"Consent Calendar 2nd SB544 Laird",37,0,0,3,40
1978777,1598126,2025-07-09,Assembly,"Do pass as amended, and be re-referred to the Committee on [Appropriations] with recommendation: To Consent Calendar",18,0,0,0,18
1978777,1599741,2025-08-20,Assembly,"Do pass. To Consent Calendar",15,0,0,0,15
1978777,1600229,2025-08-28,Assembly,"SB 544 Laird Consent Calendar Second Day Regular Session",74,0,0,5,79
1978777,1600811,2025-09-02,Senate,"Unfinished Business SB544 Laird Concurrence",40,0,0,0,40
1978778,1542725,2025-04-08,Senate,"Do pass, but first be re-referred to the Committee on [Local Government]",11,1,0,3,15
1978778,1562794,2025-04-30,Senate,"Do pass as amended, but first amend, and re-refer to the Committee on [Appropriations]",5,2,0,0,7
1978778,1573501,2025-05-19,Senate,"Placed on suspense file",5,0,0,2,7
1978778,1577630,2025-05-23,Senate,"Do pass as amended",5,1,0,1,7
1978778,1586414,2025-06-02,Senate,"Senate 3rd Reading SB545 Cortese et al",27,9,0,4,40
1978778,1597722,2025-07-07,Assembly,"Do pass and be re-referred to the Committee on [Local Government]",10,3,0,3,16
1978778,1598879,2025-07-16,Assembly,"Do pass and be re-referred to the Committee on [Appropriations]",8,1,0,1,10
1978780,1556100,2025-04-23,Senate,"Do pass, but first be re-referred to the Committee on [Appropriations]",6,0,0,1,7
1978780,1584412,2025-06-03,Senate,"Senate 3rd Reading SB547 Pérez et al",39,0,0,1,40
1978780,1598549,2025-07-16,Assembly,"Do pass as amended and be re-referred to the Committee on [Appropriations]",17,0,0,0,17
1978780,1599737,2025-08-20,Assembly,"Do pass",15,0,0,0,15
1978780,1602244,2025-09-12,Senate,"Unfinished Business SB547 Pérez et al. Concurrence",36,0,0,4,40
1978780,1602245,2025-09-13,Assembly,"SB 547 Pérez Senate Third Reading By Calderon",79,0,0,1,80
1978781,1564195,2025-04-30,Senate,"Do pass as amended, but first amend, and re-refer to the Committee on [Appropriations] with the recommendation: To Consent Calendar",11,0,0,0,11
1978781,1573521,2025-05-19,Senate,"Placed on suspense file",5,0,0,2,7
1978782,1567870,2025-05-07,Senate,"Do pass",5,2,0,0,7
1978782,1581710,2025-05-29,Senate,"Senate 3rd Reading SB549 Allen",28,10,0,2,40
1978782,1598848,2025-07-16,Assembly,"Do pass",4,1,0,5,10
1978783,1556149,2025-04-23,Senate,"Do pass, but first be re-referred to the Committee on [Judiciary]",5,1,0,1,7
1978783,1562973,2025-04-29,Senate,"Do pass as amended, but first amend, and re-refer to the Committee on [Appropriations]",10,1,0,2,13
1978783,1573537,2025-05-19,Senate,"Placed on suspense file",5,0,0,2,7
1978783,1577517,2025-05-23,Senate,"Do pass as amended",5,0,0,2,7
1978783,1586387,2025-06-02,Senate,"Senate 3rd Reading SB550 Cortese",29,6,0,5,40
1978783,1597961,2025-07-08,Assembly,"Do pass and be re-referred to the Committee on [Judiciary]",7,3,0,0,10
1978783,1598449,2025-07-15,Assembly,"Do pass and be re-referred to the Committee on [Appropriations]",8,2,0,2,12
1978784,1554481,2025-04-22,Senate,"Do pass, but first be re-referred to the Committee on [Appropriations]",5,1,0,0,6
1978784,1580510,2025-05-28,Senate,"Senate 3rd Reading SB551 Cortese et al",28,10,0,2,40
1978784,1591893,2025-06-17,Assembly,"Do pass and be re-referred to the Committee on [Appropriations]",7,2,0,0,9
1978784,1600439,2025-08-29,Assembly,"Do pass",11,4,0,0,15
1978784,1600941,2025-09-03,Assembly,"SB 551 Cortese Senate Third Reading By Schultz",57,20,0,2,79
1978784,1601527,2025-09-09,Senate,"Unfinished Business SB551 Cortese et al. Concurrence",30,9,0,1,40
1978785,1533496,2025-04-01,Senate,"Do pass, but first be re-referred to the Committee on [Appropriations] with the recommendation: To Consent Calendar",6,0,0,0,6
1978785,1552896,2025-04-21,Senate,"Placed on suspense file",6,0,0,1,7
1978786,1533538,2025-04-01,Senate,"Do pass, but first be re-referred to the Committee on [Appropriations] with the recommendation: To Consent Calendar",6,0,0,0,6
1978786,1552925,2025-04-21,Senate,"Placed on suspense file",6,0,0,1,7
1978786,1577184,2025-05-23,Senate,"Do pass",6,0,0,1,7
1978786,1581732,2025-05-29,Senate,"Special Consent SB553 Cortese",38,0,0,2,40
1978786,1591847,2025-06-17,Assembly,"Do pass and be re-referred to the Committee on [Appropriations] with recommendation: To Consent Calendar",9,0,0,0,9
1978786,1600327,2025-08-29,Assembly,"Do pass as amended",11,0,0,4,15
1978786,1602333,2025-09-12,Senate,"Unfinished Business SB553 Cortese Concurrence",37,0,0,3,40
1978786,1602334,2025-09-12,Assembly,"SB 553 Cortese Senate Third Reading By Sharp-Collins",80,0,0,0,80
1978787,1563087,2025-04-29,Senate,"Do pass, but first be re-referred to the Committee on [Local Government]",1,5,0,0,6
1978788,1542862,2025-04-09,Senate,"Do pass, but first be re-referred to the Committee on [Appropriations]",4,1,0,0,5
1978788,1565364,2025-05-05,Senate,"Placed on suspense file",7,0,0,0,7
1978789,1540934,2025-04-08,Senate,"Do pass as amended, but first amend, and re-refer to the Committee on [Appropriations]",6,0,0,1,7
1978789,1559496,2025-04-28,Senate,"Placed on suspense file",7,0,0,0,7
1978789,1577374,2025-05-23,Senate,"Do pass as amended",6,0,0,1,7
1978789,1585082,2025-06-04,Senate,"Special Consent SB556 Hurtado",39,0,0,1,40
1978789,1598374,2025-07-15,Assembly,"Do pass as amended and be re-referred to the Committee on [Appropriations]",13,0,0,0,13
1978791,1567876,2025-05-07,Senate,"Do pass and be ordered to the Consent Calendar",7,0,0,0,7
1978791,1572444,2025-05-15,Senate,"Consent Calendar 2nd SB558 Padilla",34,0,0,6,40
1978791,1592618,2025-06-18,Assembly,"Do pass. To Consent Calendar",10,0,0,0,10
1978791,1595977,2025-06-27,Assembly,"SB 558 Padilla Consent Calendar Second Day Regular Session",75,0,0,4,79
1978792,1525450,2025-03-24,Senate,"Do pass as amended, but first amend, and re-refer to the Committee on [Appropriations]",13,0,0,4,17
1978792,1565271,2025-05-05,Senate,"Placed on suspense file",7,0,0,0,7
1978793,1540887,2025-04-07,Senate,"Do pass, but first be re-referred to the Committee on [Public Safety]",4,0,0,1,5
1978793,1554501,2025-04-22,Senate,"Do pass, but first be re-referred to the Committee on [Appropriations]",5,1,0,0,6
1978793,1565322,2025-05-05,Senate,"Placed on suspense file",7,0,0,0,7
1978794,1536786,2025-04-02,Senate,"Do pass as amended, but first amend, and re-refer to the Committee on [Judiciary]",8,0,0,0,8
1978794,1556171,2025-04-22,Senate,"Do pass, but first be re-referred to the Committee on [Appropriations]",13,0,0,0,13
1978794,1565229,2025-05-05,Senate,"Placed on suspense file",7,0,0,0,7
1978794,1577462,2025-05-23,Senate,"Do pass",6,0,0,1,7
1978794,1586407,2025-06-02,Senate,"Senate 3rd Reading SB561 Blakespear",38,0,0,2,40
1978795,1554660,2025-04-22,Senate,"Do pass as amended, but first amend, and re-refer to the Committee on [Appropriations]",4,1,0,1,6
1978795,1565345,2025-05-05,Senate,"Placed on suspense file",7,0,0,0,7
1978795,1577743,2025-05-23,Senate,"Do pass as amended",5,1,0,1,7
1978795,1585021,2025-06-04,Senate,"Senate 3rd Reading SB562 Ashby",25,11,0,4,40
1978796,1554614,2025-04-22,Senate,"Do pass, but first be re-referred to the Committee on [Appropriations] with the recommendation: To Consent Calendar",6,0,0,1,7
1978796,1565346,2025-05-05,Senate,"Placed on suspense file",7,0,0,0,7
1978796,1577150,2025-05-23,Senate,"Do pass",6,0,0,1,7
1978796,1581746,2025-05-29,Senate,"Special Consent SB563 Valladares",38,0,0,2,40
1978796,1591867,2025-06-17,Assembly,"Do pass and be re-referred to the Committee on [Appropriations] with recommendation: To Consent Calendar",10,0,0,3,13
1978799,1571645,2025-05-14,Senate,"Do pass, but first be re-referred to the Committee on [Appropriations]",1,1,0,3,5
1978799,1571646,2025-05-14,Senate,"[First] hearing set for [05-14-2025]: Failed passage in Committee. Reconsideration granted",5,0,0,0,5
1978800,1526926,2025-03-25,Senate,"Do pass as amended, but first amend, and re-refer to the Committee on [Environmental Quality]",7,0,0,0,7
1978800,1563056,2025-04-30,Senate,"Do pass, but first be re-referred to the Committee on [Appropriations]",8,0,0,0,8
1978800,1569813,2025-05-12,Senate,"Placed on suspense file",7,0,0,0,7
1978800,1577771,2025-05-23,Senate,"Do pass as amended",5,0,0,2,7
1978800,1584407,2025-06-03,Senate,"Senate 3rd Reading SB567 Limón",33,1,0,6,40
1978800,1594055,2025-06-23,Assembly,"Do pass and be re-referred to the Committee on [Appropriations]",14,0,0,0,14
1978800,1600532,2025-08-29,Assembly,"Do pass as amended",11,0,0,4,15
1978800,1601384,2025-09-08,Assembly,"SB 567 Limón Senate Third Reading By Bryan",79,0,0,1,80
1978800,1601631,2025-09-09,Senate,"Unfinished Business SB567 Limón Concurrence",37,1,0,2,40
1978801,1542702,2025-04-09,Senate,"Do pass as amended, but first amend, and re-refer to the Committee on [Appropriations] with the recommendation: To Consent Calendar",7,0,0,0,7
1978801,1559417,2025-04-28,Senate,"Placed on suspense file",7,0,0,0,7
1978801,1577428,2025-05-23,Senate,"Do pass",6,0,0,1,7
1978801,1581688,2025-05-29,Senate,"Special Consent SB568 Niello",38,0,0,2,40
1978801,1598670,2025-07-16,Assembly,"Do pass as amended and be re-referred to the Committee on [Appropriations]",8,0,0,1,9
1978801,1600438,2025-08-29,Assembly,"Do pass",15,0,0,0,15
1978801,1601385,2025-09-08,Assembly,"SB 568 Niello Senate Third Reading By Wallis",76,1,0,3,80
1978801,1602063,2025-09-12,Senate,"Unfinished Business SB568 Niello Concurrence",37,0,0,3,40
1978802,1554505,2025-04-22,Senate,"Do pass, but first be re-referred to the Committee on [Appropriations]",15,0,0,0,15
1978802,1565267,2025-05-05,Senate,"Placed on suspense file",7,0,0,0,7
1978802,1577637,2025-05-23,Senate,"Do pass",5,1,0,1,7
1978802,1585091,2025-06-04,Senate,"Senate 3rd Reading SB569 Blakespear et al",38,0,0,2,40
1978804,1554545,2025-04-22,Senate,"Do pass, but first be re-referred to the Committee on [Appropriations]",6,0,0,0,6
1978804,1565305,2025-05-05,Senate,"Placed on suspense file",7,0,0,0,7
1978804,1577532,2025-05-23,Senate,"Do pass as amended",6,0,0,1,7
1978804,1584277,2025-06-03,Senate,"Senate 3rd Reading SB571 Archuleta et al",39,0,0,1,40
1978804,1598712,2025-07-15,Assembly,"Do pass as amended and be re-referred to the Committee on [Appropriations]",9,0,0,0,9
1978804,1600662,2025-08-29,Assembly,"Do pass as amended",11,0,0,4,15
1978804,1601609,2025-09-09,Assembly,"SB 571 Archuleta Senate Third Reading By Gabriel",76,0,0,4,80
1978804,1601921,2025-09-11,Senate,"Unfinished Business SB571 Archuleta et al. Concurrence",40,0,0,0,40
1978805,1554487,2025-04-22,Senate,"Do pass, but first be re-referred to the Committee on [Judiciary]",11,1,0,3,15
1978805,1562781,2025-04-29,Senate,"Do pass as amended, but first amend, and re-refer to the Committee on [Appropriations]",12,0,0,1,13
1978805,1573527,2025-05-19,Senate,"Placed on suspense file",5,0,0,2,7
1978805,1577661,2025-05-23,Senate,"Do pass as amended",5,1,0,1,7
1978805,1580546,2025-05-28,Senate,"Senate 3rd Reading SB572 Gonzalez",27,6,0,7,40
1978805,1580547,2025-05-28,Senate,"Senate 3rd Reading SB572 Gonzalez Reconsider",36,0,0,4,40
1978805,1580548,2025-05-28,Senate,"Senate 3rd Reading SB572 Gonzalez",29,5,0,6,40
1978805,1597129,2025-07-01,Assembly,"Do pass as amended and be re-referred to the Committee on [Transportation]",11,0,0,1,12
1978805,1598405,2025-07-14,Assembly,"Do pass and be re-referred to the Committee on [Appropriations]",14,1,0,1,16
1978809,1559461,2025-04-28,Senate,"Do pass",11,0,0,0,11
1978809,1580554,2025-05-28,Senate,"Senate 3rd Reading SB576 Umberg et al",38,0,0,2,40
1978809,1594580,2025-06-24,Assembly,"Do pass",14,0,0,1,15
1978809,1601179,2025-09-04,Assembly,"SB 576 Umberg Senate Third Reading By Lowenthal",71,0,0,8,79
1978809,1601808,2025-09-10,Senate,"Unfinished Business SB576 Umberg et al. Concurrence",40,0,0,0,40
1978810,1556162,2025-04-22,Senate,"Do pass as amended, but first amend, and re-refer to the Committee on [Appropriations]",13,0,0,0,13
1978810,1569860,2025-05-12,Senate,"Placed on suspense file",7,0,0,0,7
1978810,1577581,2025-05-23,Senate,"Do pass",5,0,0,2,7
1978810,1580539,2025-05-28,Senate,"Senate 3rd Reading SB577 Laird et al",35,0,0,5,40
1978810,1598451,2025-07-15,Assembly,"Do pass and be re-referred to the Committee on [Appropriations]",11,1,0,0,12
1978810,1600481,2025-08-29,Assembly,"Do pass",14,1,0,0,15
1978811,1528266,2025-03-26,Senate,"Do pass, but first be re-referred to the Committee on [Appropriations]",4,1,0,0,5
1978811,1538930,2025-04-07,Senate,"Placed on suspense file",7,0,0,0,7
1978811,1577368,2025-05-23,Senate,"Do pass as amended",5,1,0,1,7
1978811,1586412,2025-06-02,Senate,"Senate 3rd Reading SB578 Smallwood-Cuevas",28,10,0,2,40
1978811,1598124,2025-07-09,Assembly,"Do pass and be re-referred to the Committee on [Appropriations]",6,0,0,1,7
1978811,1600416,2025-08-29,Assembly,"Do pass",11,3,0,1,15
1978811,1601944,2025-09-11,Senate,"Unfinished Business SB578 Smallwood-Cuevas Concurrence",30,10,0,0,40
1978812,1527011,2025-03-25,Senate,"Do pass as amended, but first amend, and re-refer to the Committee on [Appropriations]",12,0,0,3,15
1978812,1552822,2025-04-21,Senate,"Placed on suspense file",6,0,0,1,7
1978813,1556063,2025-04-22,Senate,"Do pass, but first be re-referred to the Committee on [Local Government]",11,1,0,1,13
1978813,1562744,2025-04-30,Senate,"Do pass, but first be re-referred to the Committee on [Appropriations]",5,2,0,0,7
1978813,1569859,2025-05-12,Senate,"Placed on suspense file",7,0,0,0,7
1978813,1577536,2025-05-23,Senate,"Do pass as amended",5,1,0,1,7
1978813,1586415,2025-06-02,Senate,"Senate 3rd Reading SB580 Durazo",28,10,0,2,40
1978813,1594575,2025-06-24,Assembly,"Do pass and be re-referred to the Committee on [Appropriations]",9,3,0,0,12
1978813,1600675,2025-08-29,Assembly,"Do pass as amended",11,4,0,0,15
1978813,1601453,2025-09-09,Assembly,"SB 580 Durazo Senate Third Reading By Bryan",58,19,0,3,80
1978813,1601770,2025-09-10,Senate,"Unfinished Business SB580 Durazo Concurrence",30,10,0,0,40
1978814,1562858,2025-04-30,Senate,"Do pass, but first be re-referred to the Committee on [Appropriations] with the recommendation: To Consent Calendar",5,0,0,0,5
1978814,1569826,2025-05-12,Senate,"Placed on suspense file",7,0,0,0,7
1978814,1577756,2025-05-23,Senate,"Do pass",6,0,0,1,7
1978814,1584270,2025-06-03,Senate,"Senate 3rd Reading SB581 McGuire et al",39,0,0,1,40
1978814,1595228,2025-06-25,Assembly,"Do pass and be re-referred to the Committee on [Natural Resources] with recommendation: To Consent Calendar",7,0,0,0,7
1978814,1598298,2025-07-14,Assembly,"Do pass and be re-referred to the Committee on [Appropriations] with recommendation: To Consent Calendar",13,0,0,1,14
1978814,1600456,2025-08-29,Assembly,"Do pass",15,0,0,0,15
1978815,1552926,2025-04-21,Senate,"Do pass, but first be re-referred to the Committee on [Health] with the recommendation: To Consent Calendar",5,0,0,0,5
1978815,1564266,2025-04-30,Senate,"Do pass as amended, but first amend, and re-refer to the Committee on [Appropriations] with the recommendation: To Consent Calendar",11,0,0,0,11
1978815,1573634,2025-05-19,Senate,"Placed on suspense file",5,0,0,2,7
1978815,1577725,2025-05-23,Senate,"Do pass",6,0,0,1,7
1978815,1584293,2025-06-03,Senate,"Senate 3rd Reading SB582 Stern et al. By Cervantes",39,0,0,1,40
1978815,1594584,2025-06-24,Assembly,"Do pass as amended and be re-referred to the Committee on [Health]",7,0,0,0,7
1978815,1598467,2025-07-15,Assembly,"Do pass and be re-referred to the Committee on [Appropriations] with recommendation: To Consent Calendar",16,0,0,0,16
1978815,1600282,2025-08-29,Assembly,"Do pass",15,0,0,0,15
1978815,1601386,2025-09-08,Assembly,"SB 582 Stern Senate Third Reading By Lee",79,0,0,1,80
1978815,1601728,2025-09-10,Senate,"Unfinished Business SB582 Stern et al. Concurrence",40,0,0,0,40
1978816,1542881,2025-04-09,Senate,"Do pass, but first be re-referred to the Committee on [Appropriations] with the recommendation: To Consent Calendar",7,0,0,0,7
1978816,1557514,2025-04-24,Senate,"Consent Calendar 2nd SB583 Rubio",37,0,0,3,40
1978817,1562878,2025-04-30,Senate,"Do pass, but first be re-referred to the Committee on [Appropriations]",6,0,0,1,7
1978817,1569783,2025-05-12,Senate,"Placed on suspense file",7,0,0,0,7
1978819,1542909,2025-04-08,Senate,"Do pass, but first be re-referred to the Committee on [Natural Resources and Water]",14,0,0,1,15
1978819,1554534,2025-04-22,Senate,"Do pass as amended, but first amend, and re-refer to the Committee on [Appropriations]",6,0,0,1,7
1978819,1569850,2025-05-12,Senate,"Placed on suspense file",7,0,0,0,7
1978819,1577145,2025-05-23,Senate,"Do pass as amended",6,0,0,1,7
1978819,1585075,2025-06-04,Senate,"Senate 3rd Reading SB586 Jones",38,0,0,2,40
1978819,1597656,2025-07-07,Assembly,"Do pass and be re-referred to the Committee on [Water, Parks, and Wildlife] with recommendation: To Consent Calendar",16,0,0,0,16
1978819,1598436,2025-07-15,Assembly,"Do pass as amended and be re-referred to the Committee on [Appropriations]",11,0,0,2,13
1978819,1599774,2025-08-20,Assembly,"Do pass",15,0,0,0,15
1978819,1601510,2025-09-09,Assembly,"SB 586 Jones Senate Third Reading By Jeff Gonzalez",79,0,0,1,80
1978819,1601843,2025-09-11,Senate,"Unfinished Business SB586 Jones et al. Concurrence",40,0,0,0,40
1978820,1571628,2025-05-14,Senate,"Do pass, but first be re-referred to the Committee on [Appropriations]",5,0,0,0,5
1978820,1573508,2025-05-19,Senate,"Placed on suspense file",5,0,0,2,7
1978820,1577148,2025-05-23,Senate,"Do pass as amended",6,0,0,1,7
1978820,1586366,2025-06-02,Senate,"Senate 3rd Reading SB587 Grayson",38,0,0,2,40
1978820,1598399,2025-07-14,Assembly,"Do pass and be re-referred to the Committee on [Appropriations]",7,0,0,0,7
1978823,1542923,2025-04-09,Senate,"Do pass, but first be re-referred to the Committee on [Appropriations]",5,0,0,0,5
1978823,1552852,2025-04-21,Senate,"Placed on suspense file",6,0,0,1,7
1978823,1577345,2025-05-23,Senate,"Do pass",6,0,0,1,7
1978823,1580477,2025-05-28,Senate,"Senate 3rd Reading SB590 Durazo et al",38,0,0,2,40
1978823,1598127,2025-07-09,Assembly,"Do pass and be re-referred to the Committee on [Appropriations]",14,0,0,3,17
1978823,1600485,2025-08-29,Assembly,"Do pass",14,1,0,0,15
1978823,1601509,2025-09-09,Assembly,"SB 590 Durazo Senate Third Reading By Wicks",76,0,0,4,80
1978823,1601715,2025-09-10,Senate,"Unfinished Business SB590 Durazo et al. Concurrence",40,0,0,0,40
1978824,1556114,2025-04-23,Senate,"Do pass, but first be re-referred to the Committee on [Appropriations]",5,0,0,0,5
1978824,1565277,2025-05-05,Senate,"Placed on suspense file",7,0,0,0,7
1978824,1577715,2025-05-23,Senate,"Do pass",6,0,0,1,7
1978824,1581741,2025-05-29,Senate,"Special Consent SB591 Valladares et al",38,0,0,2,40
1978824,1598513,2025-07-14,Assembly,"Do pass as amended and be re-referred to the Committee on [Appropriations]",6,0,0,1,7
1978825,1555994,2025-04-23,Senate,"Do pass, but first be re-referred to the Committee on [Judiciary]",4,0,0,1,5
1978825,1565303,2025-05-05,Senate,"Placed on suspense file",7,0,0,0,7
1978826,1538888,2025-04-07,Senate,"Do pass as amended, but first amend, and re-refer to the Committee on [Judiciary]",13,3,0,1,17
1978826,1581680,2025-05-29,Senate,"Senate 3rd Reading SB593 Hurtado",38,0,0,2,40
1978826,1595167,2025-06-25,Assembly,"Do pass as amended, and be re-referred to the Committee on [Appropriations] with recommendation: To Consent Calendar",18,0,0,0,18
1978826,1600397,2025-08-29,Assembly,"Do pass as amended",11,0,0,4,15
1978826,1601387,2025-09-08,Assembly,"SB 593 Hurtado Senate Third Reading By Bains",78,0,0,2,80
1978826,1601726,2025-09-10,Senate,"Unfinished Business SB593 Hurtado Concurrence",40,0,0,0,40
1978827,1536794,2025-04-02,Senate,"Do pass, but first be re-referred to the Committee on [Appropriations]",5,0,0,3,8
1978827,1586360,2025-06-02,Senate,"Senate 3rd Reading SB594 Padilla",27,9,0,4,40
1978828,1562865,2025-04-30,Senate,"Do pass, but first be re-referred to the Committee on [Appropriations] with the recommendation: To Consent Calendar",7,0,0,0,7
1978828,1569786,2025-05-12,Senate,"Placed on suspense file",7,0,0,0,7
1978828,1577591,2025-05-23,Senate,"Do pass as amended",6,0,0,1,7
1978828,1585079,2025-06-04,Senate,"Special Consent SB595 Choi",39,0,0,1,40
1978828,1597564,2025-07-02,Assembly,"Do pass and be re-referred to the Committee on [Appropriations] with recommendation: To Consent Calendar",10,0,0,0,10
1978828,1598558,2025-07-16,Assembly,"Do pass. To Consent Calendar",13,0,0,2,15
1978828,1601388,2025-09-08,Assembly,"SB 595 Choi Senate Third Reading By Hoover",78,0,0,2,80
1978828,1601851,2025-09-11,Senate,"Unfinished Business SB595 Choi Concurrence",40,0,0,0,40
1978829,1557508,2025-04-23,Senate,"Do pass as amended, but first amend, and re-refer to the Committee on [Appropriations]",8,2,0,1,11
1978829,1569821,2025-05-12,Senate,"Placed on suspense file",7,0,0,0,7
1978829,1577339,2025-05-23,Senate,"Do pass",5,1,0,1,7
1978829,1585023,2025-06-04,Senate,"Senate 3rd Reading SB596 Menjivar",24,10,0,6,40
1978829,1598526,2025-07-15,Assembly,"Do pass and be re-referred to the Committee on [Appropriations]",12,2,0,2,16
1978829,1600321,2025-08-29,Assembly,"Do pass as amended",10,4,0,1,15
1978829,1602214,2025-09-12,Senate,"Unfinished Business SB596 Menjivar Concurrence",21,10,0,9,40
1978830,1542782,2025-04-09,Senate,"Do pass, but first be re-referred to the Committee on [Judiciary]",5,0,0,0,5
1978830,1555918,2025-04-22,Senate,"Do pass, but first be re-referred to the Committee on [Appropriations] with the recommendation: To Consent Calendar",13,0,0,0,13
1978830,1565270,2025-05-05,Senate,"Placed on suspense file",7,0,0,0,7
1978830,1577576,2025-05-23,Senate,"Do pass",6,0,0,1,7
1978830,1581721,2025-05-29,Senate,"Special Consent SB597 Cortese",38,0,0,2,40
1978830,1598026,2025-07-09,Assembly,"Do pass and be re-referred to the Committee on [Judiciary] with recommendation: To Consent Calendar",7,0,0,0,7
1978830,1598483,2025-07-15,Assembly,"Do pass and be re-referred to the Committee on [Appropriations] with recommendation: To Consent Calendar",12,0,0,0,12
1978830,1600302,2025-08-29,Assembly,"Do pass as amended",11,0,0,4,15
1978830,1601389,2025-09-08,Assembly,"SB 597 Cortese Senate Third Reading By Kalra",79,0,0,1,80
1978830,1601524,2025-09-09,Senate,"Unfinished Business SB597 Cortese Concurrence",40,0,0,0,40
1978831,1555895,2025-04-23,Senate,"Do pass, but first be re-referred to the Committee on [Appropriations] with the recommendation: To Consent Calendar",7,0,0,0,7
1978831,1568603,2025-05-08,Senate,"Consent Calendar 2nd SB598 Durazo",36,0,0,4,40
1978831,1597612,2025-07-02,Assembly,"Do pass as amended, and be re-referred to the Committee on [Appropriations] with recommendation: To Consent Calendar",10,0,0,0,10
1978831,1598562,2025-07-16,Assembly,"Do pass. To Consent Calendar",13,0,0,2,15
1978831,1599863,2025-08-21,Assembly,"SB 598 Durazo Consent Calendar Second Day Regular Session",77,0,0,2,79
1978831,1600443,2025-08-29,Senate,"Special Consent SB598 Durazo",37,0,0,3,40
1978832,1554465,2025-04-22,Senate,"Do pass as amended, but first amend, and re-refer to the Committee on [Appropriations] with the recommendation: To Consent Calendar",6,0,0,1,7
1978832,1565285,2025-05-05,Senate,"Placed on suspense file",7,0,0,0,7
1978832,1577613,2025-05-23,Senate,"Do pass",6,0,0,1,7
1978832,1581726,2025-05-29,Senate,"Special Consent SB599 Caballero",38,0,0,2,40
1978832,1597201,2025-07-01,Assembly,"Do pass and be re-referred to the Committee on [Appropriations] with recommendation: To Consent Calendar",12,0,0,1,13
1978832,1600484,2025-08-29,Assembly,"Do pass",15,0,0,0,15
1978833,1542845,2025-04-09,Senate,"Do pass, but first be re-referred to the Committee on [Appropriations]",4,1,0,0,5
1978833,1552953,2025-04-21,Senate,"Placed on suspense file",6,0,0,1,7
1978834,1536774,2025-04-02,Senate,"Do pass as amended, but first amend, and re-refer to the Committee on [Judiciary]",5,3,0,0,8
1978834,1562780,2025-04-29,Senate,"Do pass as amended, but first amend, and re-refer to the Committee on [Appropriations]",10,3,0,0,13
1978834,1573591,2025-05-19,Senate,"Placed on suspense file",5,0,0,2,7
1978834,1577914,2025-05-23,Senate,"Do pass as amended",5,1,0,1,7
1978834,1585061,2025-06-04,Senate,"Senate 3rd Reading SB601 Allen et al",23,12,0,5,40
1978834,1597211,2025-07-01,Assembly,"Do pass and be re-referred to the Committee on [Environmental Safety and Toxic Materials]",8,2,0,2,12
1978834,1598551,2025-07-15,Assembly,"Do pass and be re-referred to the Committee on [Appropriations]",5,2,0,0,7
1978835,1552965,2025-04-21,Senate,"Do pass, but first be re-referred to the Committee on [Appropriations] with the recommendation: To Consent Calendar",11,0,0,0,11
1978835,1568677,2025-05-08,Senate,"Consent Calendar 2nd SB602 Cortese",36,0,0,4,40
1978835,1594621,2025-06-24,Assembly,"Do pass and be re-referred to the Committee on [Appropriations] with recommendation: To Consent Calendar",16,0,0,2,18
1978835,1598115,2025-07-09,Assembly,"Do pass. To Consent Calendar",15,0,0,0,15
1978835,1598847,2025-07-17,Assembly,"SB 602 Cortese Consent Calendar Second Day Regular Session",75,0,0,4,79
1978835,1600042,2025-08-25,Senate,"Special Consent SB602 Cortese",37,0,0,3,40
1978836,1571552,2025-05-14,Senate,"Do pass, but first be re-referred to the Committee on [Appropriations]",5,0,0,0,5
1978836,1573500,2025-05-19,Senate,"Placed on suspense file",5,0,0,2,7
1978836,1577545,2025-05-23,Senate,"Do pass",6,0,0,1,7
1978836,1581704,2025-05-29,Senate,"Special Consent SB603 Niello",38,0,0,2,40
1978836,1598508,2025-07-14,Assembly,"Do pass as amended and be re-referred to the Committee on [Appropriations]",7,0,0,0,7
1978838,1528301,2025-03-26,Senate,"Do pass, but first be re-referred to the Committee on [Appropriations]",4,1,0,0,5
1978838,1538958,2025-04-07,Senate,"Placed on suspense file",7,0,0,0,7
1978839,1552892,2025-04-21,Senate,"Do pass as amended, but first amend, and re-refer to the Committee on [Housing]",5,0,0,0,5
1978839,1562818,2025-04-29,Senate,"Do pass, but first be re-referred to the Committee on [Appropriations]",11,0,0,0,11
1978839,1569830,2025-05-12,Senate,"Placed on suspense file",7,0,0,0,7
1978839,1577843,2025-05-23,Senate,"Do pass as amended",6,0,0,1,7
1978839,1586391,2025-06-02,Senate,"Senate 3rd Reading SB606 Becker",38,0,0,2,40
1978839,1597477,2025-07-02,Assembly,"Do pass and be re-referred to the Committee on [Human Services]",10,0,0,2,12
1978839,1598440,2025-07-15,Assembly,"Do pass as amended and be re-referred to the Committee on [Appropriations]",7,0,0,0,7
1978840,1555897,2025-04-23,Senate,"Do pass, but first be re-referred to the Committee on [Local Government]",6,0,0,2,8
1978840,1562924,2025-04-30,Senate,"Do pass as amended, but first amend, and re-refer to the Committee on [Appropriations]",5,1,0,1,7
1978840,1573505,2025-05-19,Senate,"Placed on suspense file",5,0,0,2,7
1978840,1577361,2025-05-23,Senate,"Do pass as amended",4,0,0,3,7
1978841,1535035,2025-04-02,Senate,"Do pass, but first be re-referred to the Committee on [Health]",5,2,0,0,7
1978841,1545028,2025-04-09,Senate,"Do pass, but first be re-referred to the Committee on [Appropriations]",8,0,0,3,11
1978841,1559437,2025-04-28,Senate,"Placed on suspense file",7,0,0,0,7
1978842,1526885,2025-03-25,Senate,"Do pass as amended, but first amend, and re-refer to the Committee on [Judiciary] with the recommendation: To Consent Calendar",7,0,0,0,7
1978842,1542935,2025-04-08,Senate,"Do pass, but first be re-referred to the Committee on [Appropriations] with the recommendation: To Consent Calendar",13,0,0,0,13
1978842,1552828,2025-04-21,Senate,"Placed on suspense file",6,0,0,1,7
1978842,1577853,2025-05-23,Senate,"Do pass as amended",6,0,0,1,7
1978842,1580508,2025-05-28,Senate,"Senate 3rd Reading SB609 Laird",38,0,0,2,40
1978842,1597180,2025-07-01,Assembly,"Do pass and be re-referred to the Committee on [Judiciary] with recommendation: To Consent Calendar",12,0,0,1,13
1978842,1597858,2025-07-08,Assembly,"Do pass and be re-referred to the Committee on [Appropriations] with recommendation: To Consent Calendar",12,0,0,0,12
1978842,1599718,2025-08-20,Assembly,"Do pass. To Consent Calendar",15,0,0,0,15
1978842,1600198,2025-08-28,Assembly,"SB 609 Laird Consent Calendar Second Day Regular Session",74,0,0,5,79
1978843,1562767,2025-04-29,Senate,"Do pass, but first be re-referred to the Committee on [Appropriations]",11,1,0,1,13
1978843,1569775,2025-05-12,Senate,"Placed on suspense file",7,0,0,0,7
1978843,1577735,2025-05-23,Senate,"Do pass",5,1,0,1,7
1978843,1584272,2025-06-03,Senate,"Senate 3rd Reading SB610 Pérez et al",28,10,0,2,40
1978843,1597499,2025-07-02,Assembly,"Do pass as amended and be re-referred to the Committee on [Judiciary]",8,1,0,3,12
1978843,1598499,2025-07-15,Assembly,"Do pass and be re-referred to the Committee on [Appropriations]",9,1,0,2,12
1978843,1600576,2025-08-29,Assembly,"Do pass as amended",11,1,0,3,15
1978843,1601479,2025-09-09,Assembly,"SB 610 Pérez Senate Third Reading By Harabedian",59,11,0,10,80
1978843,1601762,2025-09-10,Senate,"Unfinished Business SB610 Pérez et al. Concurrence",30,10,0,0,40
1978844,1536764,2025-04-02,Senate,"Do pass as amended, but first amend, and re-refer to the Committee on [Judiciary]",7,0,0,0,7
1978844,1567899,2025-05-06,Senate,"Do pass",12,0,0,1,13
1978844,1579268,2025-05-27,Senate,"Senate 3rd Reading SB611 Richardson Urgency Clause",39,0,0,1,40
1978844,1592572,2025-06-18,Assembly,"Do pass and be re-referred to the Committee on [Judiciary]",10,0,0,0,10
1978844,1597234,2025-07-01,Assembly,"Do pass",12,0,0,0,12
1978844,1598837,2025-07-17,Assembly,"SB 611 Richardson Third Reading Urgency By Zbur",74,0,0,5,79
1978844,1600394,2025-08-29,Senate,"Special Consent SB611 Richardson et al. Urgency Clause",37,0,0,3,40
1978845,1562812,2025-04-30,Senate,"Do pass, but first be re-referred to the Committee on [Appropriations]",2,5,0,0,7
1978845,1562813,2025-04-30,Senate,"[First] hearing set for [04-30-2025]: Failed passage in Committee. Reconsideration granted",7,0,0,0,7
1978846,1536799,2025-04-02,Senate,"Do pass, but first be re-referred to the Committee on [Energy, Utilities and Communications]",6,1,0,1,8
1978846,1554557,2025-04-21,Senate,"Do pass as amended, but first amend, and re-refer to the Committee on [Appropriations]",13,3,0,1,17
1978846,1554558,2025-04-21,Senate,"[04-22-2025] set for [First] hearing: Reconsideration of favorable vote granted",17,0,0,0,17
1978846,1554559,2025-04-21,Senate,"Do pass as amended, but first amend, and re-refer to the Committee on [Appropriations]",15,0,0,2,17
1978846,1569897,2025-05-12,Senate,"Placed on suspense file",7,0,0,0,7
1978846,1577933,2025-05-23,Senate,"Do pass as amended",5,0,0,2,7
1978846,1585103,2025-06-04,Senate,"Senate 3rd Reading SB613 Stern",37,0,0,3,40
1978846,1597766,2025-07-07,Assembly,"Do pass and be re-referred to the Committee on [Utilities and Energy]",11,1,0,2,14
1978846,1598139,2025-07-09,Assembly,"Do pass and be re-referred to the Committee on [Appropriations]",15,2,0,1,18
1978846,1600278,2025-08-29,Assembly,"Do pass",11,3,0,1,15
1978846,1602280,2025-09-12,Senate,"Unfinished Business SB613 Stern et al. Concurrence",37,0,0,3,40
1978846,1602281,2025-09-12,Assembly,"SB 613 Stern Senate Third Reading By Zbur",54,14,0,12,80
1978847,1554446,2025-04-22,Senate,"Do pass as amended, but first amend, and re-refer to the Committee on [Environmental Quality]",11,2,0,2,15
1978847,1562957,2025-04-30,Senate,"Do pass as amended, but first amend, and re-refer to the Committee on [Appropriations]",7,0,0,1,8
1978847,1573564,2025-05-19,Senate,"Placed on suspense file",5,0,0,2,7
1978847,1577245,2025-05-23,Senate,"Do pass",6,0,0,1,7
1978847,1585048,2025-06-04,Senate,"Senate 3rd Reading SB614 Stern et al",38,0,0,2,40
1978847,1598110,2025-07-09,Assembly,"Do pass and be re-referred to the Committee on [Natural Resources]",17,0,0,1,18
1978847,1598212,2025-07-14,Assembly,"Do pass and be re-referred to the Committee on [Appropriations]",12,0,0,2,14
1978847,1600557,2025-08-29,Assembly,"Do pass as amended",11,0,0,4,15
1978847,1602222,2025-09-12,Senate,"Unfinished Business SB614 Stern et al. Concurrence",37,0,0,3,40
1978847,1602223,2025-09-12,Assembly,"SB 614 Stern Senate Third Reading By Petrie-Norris",74,0,0,6,80
1978848,1536770,2025-04-02,Senate,"Do pass as amended, but first amend, and re-refer to the Committee on [Transportation]",6,0,0,2,8
1978848,1554593,2025-04-22,Senate,"Do pass, but first be re-referred to the Committee on [Appropriations]",11,2,0,2,15
1978848,1565313,2025-05-05,Senate,"Placed on suspense file",7,0,0,0,7
1978848,1577860,2025-05-23,Senate,"Do pass as amended",5,1,0,1,7
1978848,1581742,2025-05-29,Senate,"Senate 3rd Reading SB615 Allen",28,6,0,6,40
1978848,1591889,2025-06-17,Assembly,"Do pass and be re-referred to the Committee on [Natural Resources]",5,1,0,1,7
1978848,1598291,2025-07-14,Assembly,"Do pass and be re-referred to the Committee on [Appropriations]",10,1,0,3,14
1978848,1600283,2025-08-29,Assembly,"Do pass as amended",11,3,0,1,15
1978849,1542902,2025-04-09,Senate,"Do pass, but first be re-referred to the Committee on [Judiciary]",7,0,0,0,7
1978849,1556069,2025-04-22,Senate,"Do pass, but first be re-referred to the Committee on [Appropriations] with the recommendation: To Consent Calendar",13,0,0,0,13
1978849,1565366,2025-05-05,Senate,"Placed on suspense file",7,0,0,0,7
1978849,1577741,2025-05-23,Senate,"Do pass",6,0,0,1,7
1978849,1584364,2025-06-03,Senate,"Senate 3rd Reading SB616 Rubio et al",39,0,0,1,40
1978849,1598487,2025-07-14,Assembly,"Do pass and be re-referred to the Committee on [Insurance]",5,1,0,1,7
1978849,1598569,2025-07-16,Assembly,"Do pass and be re-referred to the Committee on [Appropriations]",13,2,0,2,17
1978849,1600758,2025-08-29,Assembly,"Do pass",12,0,0,3,15
1978849,1602143,2025-09-12,Senate,"Unfinished Business SB616 Rubio et al. Concurrence",34,0,0,6,40
1978849,1602144,2025-09-13,Assembly,"SB 616 Rubio Senate Third Reading By Aguiar-Curry",66,4,0,10,80
1978850,1563013,2025-04-30,Senate,"Do pass, but first be re-referred to the Committee on [Appropriations]",5,0,0,0,5
1978850,1580493,2025-05-28,Senate,"Senate 3rd Reading SB617 Arreguín",36,0,0,4,40
1978850,1598133,2025-07-09,Assembly,"Do pass and be re-referred to the Committee on [Appropriations] with recommendation: To Consent Calendar",7,0,0,0,7
1978850,1599736,2025-08-20,Assembly,"Do pass. To Consent Calendar",15,0,0,0,15
1978850,1600856,2025-09-02,Assembly,"SB 617 Arreguín Senate Third Reading By Ortega",77,0,0,2,79
1978850,1601083,2025-09-04,Senate,"Unfinished Business SB617 Arreguín Concurrence",38,0,0,2,40
1978851,1563036,2025-04-29,Senate,"Do pass as amended, but first amend, and re-refer to the Committee on [Appropriations]",14,2,0,1,17
1978851,1573533,2025-05-19,Senate,"Placed on suspense file",5,0,0,2,7
1978852,1542874,2025-04-09,Senate,"Do pass, but first be re-referred to the Committee on [Appropriations] with the recommendation: To Consent Calendar",7,0,0,0,7
1978852,1557556,2025-04-24,Senate,"Consent Calendar 2nd SB619 ED. (Pérez)",37,0,0,3,40
1978852,1594665,2025-06-24,Assembly,"Do pass and be re-referred to the Committee on [Appropriations] with recommendation: To Consent Calendar",10,0,0,0,10
1978852,1597432,2025-07-02,Assembly,"Do pass. To Consent Calendar",14,0,0,1,15
1978852,1598170,2025-07-10,Assembly,"SB 619 Education Consent Calendar Second Day Regular Session",72,0,0,7,79
1978854,1559432,2025-04-28,Senate,"Do pass, but first be re-referred to the Committee on [Elections and Constitutional Amendments] with the recommendation: To Consent Calendar",4,0,0,1,5
1978854,1561177,2025-04-29,Senate,"Do pass and be ordered to the Consent Calendar",5,0,0,0,5
1978854,1565328,2025-05-05,Senate,"Consent Calendar 2nd SB621 Grove",38,0,0,2,40
1978854,1597388,2025-07-02,Assembly,"Do pass and be re-referred to the Committee on [Military and Veterans Affairs] with recommendation: To Consent Calendar",7,0,0,0,7
1978854,1598514,2025-07-15,Assembly,"Do pass. To Consent Calendar",8,0,0,0,8
1978854,1599854,2025-08-21,Assembly,"SB 621 Grove Consent Calendar Second Day Regular Session",77,0,0,2,79
1978857,1540825,2025-04-07,Senate,"Do pass, but first be re-referred to the Committee on [Appropriations] with the recommendation: To Consent Calendar",5,0,0,0,5
1978857,1552908,2025-04-21,Senate,"Placed on suspense file",6,0,0,1,7
1978857,1577641,2025-05-23,Senate,"Do pass as amended",6,0,0,1,7
1978857,1580514,2025-05-28,Senate,"Senate 3rd Reading SB624 Caballero et al",38,0,0,2,40
1978857,1597279,2025-07-01,Assembly,"Do pass as amended and be re-referred to the Committee on [Appropriations]",7,0,0,0,7
1978857,1598761,2025-07-16,Assembly,"Do pass",13,0,0,2,15
1978857,1600820,2025-09-02,Assembly,"SB 624 Caballero Senate Third Reading By Quirk-Silva",78,0,0,1,79
1978857,1601967,2025-09-11,Senate,"Special Consent SB624 Caballero et al",40,0,0,0,40
1978858,1556173,2025-04-22,Senate,"Do pass, but first be re-referred to the Committee on [Judiciary]",11,0,0,0,11
1978858,1562989,2025-04-29,Senate,"Do pass, but first be re-referred to the Committee on [Appropriations]",13,0,0,0,13
1978858,1584257,2025-06-03,Senate,"Senate 3rd Reading SB625 Wahab et al",39,0,0,1,40
1978858,1597506,2025-07-02,Assembly,"Do pass and be re-referred to the Committee on [Judiciary]",12,0,0,0,12
1978858,1598498,2025-07-15,Assembly,"Do pass as amended and be re-referred to the Committee on [Appropriations]",12,0,0,0,12
1978858,1599757,2025-08-20,Assembly,"Do pass",15,0,0,0,15
1978858,1601390,2025-09-08,Assembly,"SB 625 Wahab Senate Third Reading By Irwin",78,0,0,2,80
1978858,1601487,2025-09-09,Senate,"Unfinished Business SB625 Wahab et al. Concurrence",40,0,0,0,40
1978859,1564150,2025-04-30,Senate,"Do pass as amended, but first amend, and re-refer to the Committee on [Appropriations]",11,0,0,0,11
1978859,1573499,2025-05-19,Senate,"Placed on suspense file",5,0,0,2,7
1978859,1577826,2025-05-23,Senate,"Do pass",6,0,0,1,7
1978859,1586384,2025-06-02,Senate,"Senate 3rd Reading SB626 Smallwood-Cuevas",38,0,0,2,40
1978859,1598525,2025-07-15,Assembly,"Do pass as amended, and be re-referred to the Committee on [Appropriations] with recommendation: To Consent Calendar",16,0,0,0,16
1978859,1599735,2025-08-20,Assembly,"Do pass. To Consent Calendar",15,0,0,0,15
1978859,1600211,2025-08-28,Assembly,"SB 626 Smallwood-Cuevas Consent Calendar Second Day Regular Session",74,0,0,5,79
1978860,1536780,2025-04-02,Senate,"Do pass, but first be re-referred to the Committee on [Housing] with the recommendation: To Consent Calendar",7,0,0,0,7
1978860,1562935,2025-04-29,Senate,"Do pass and be ordered to the Consent Calendar",11,0,0,0,11
1978860,1568669,2025-05-08,Senate,"Consent Calendar 2nd SB627 McGuire",36,0,0,4,40
1978860,1598550,2025-07-15,Assembly,"Do pass as amended and be re-referred to the Committee on [Appropriations]",5,2,0,2,9
1978860,1599766,2025-08-20,Assembly,"Do pass as amended",10,3,0,2,15
1978860,1601634,2025-09-09,Assembly,"SB 627 Wiener Senate Third Reading By Carrillo",45,23,0,12,80
1978860,1601936,2025-09-11,Senate,"That the Assembly amendments be concurred in",5,1,0,0,6
1978860,1601937,2025-09-11,Senate,"Unfinished Business SB627 Wiener et al. Concurrence",27,10,0,3,40
1978860,1601938,2025-09-11,Senate,"Unfinished Business SB627 Wiener et al. Concurrence Reconsider",30,10,0,0,40
1978860,1601939,2025-09-11,Senate,"Unfinished Business SB627 Wiener et al. Concurrence",28,11,0,1,40
1978861,1556041,2025-04-23,Senate,"Do pass, but first be re-referred to the Committee on [Appropriations]",1,4,0,0,5
1978861,1556042,2025-04-23,Senate,"[First] hearing set for [04-23-2025]: Failed passage in Committee. Reconsideration granted",5,0,0,0,5
1978862,1554610,2025-04-22,Senate,"Do pass, but first be re-referred to the Committee on [Local Government]",11,1,0,3,15
1978862,1563045,2025-04-30,Senate,"Do pass as amended, but first amend, and re-refer to the Committee on [Appropriations]",5,0,0,2,7
1978862,1573526,2025-05-19,Senate,"Placed on suspense file",5,0,0,2,7
1978862,1577475,2025-05-23,Senate,"Do pass",5,0,0,2,7
1978862,1584242,2025-06-03,Senate,"Senate 3rd Reading SB629 Durazo et al",29,3,0,8,40
1978862,1597190,2025-06-30,Assembly,"Do pass as amended and be re-referred to the Committee on [Natural Resources]",5,2,0,0,7
1978862,1598265,2025-07-14,Assembly,"Do pass as amended and be re-referred to the Committee on [Appropriations]",9,4,0,1,14
1978862,1600444,2025-08-29,Assembly,"Do pass as amended",11,4,0,0,15
1978862,1602104,2025-09-12,Senate,"Unfinished Business SB629 Durazo et al. Concurrence",29,3,0,8,40
1978862,1602105,2025-09-12,Assembly,"SB 629 Durazo Senate Third Reading By Zbur",59,18,0,3,80
1978863,1555966,2025-04-23,Senate,"Do pass, but first be re-referred to the Committee on [Appropriations]",5,0,0,0,5
1978863,1565247,2025-05-05,Senate,"Placed on suspense file",7,0,0,0,7
1978863,1577828,2025-05-23,Senate,"Do pass as amended",5,1,0,1,7
1978863,1584253,2025-06-03,Senate,"Senate 3rd Reading SB630 Allen et al",34,1,0,5,40
1978863,1598468,2025-07-15,Assembly,"Do pass as amended and be re-referred to the Committee on [Appropriations]",10,3,0,0,13
1978863,1599767,2025-08-20,Assembly,"Do pass",11,4,0,0,15
1978863,1602037,2025-09-12,Senate,"That the Assembly amendments be concurred in",4,1,0,2,7
1978863,1602351,2025-09-12,Senate,"Unfinished Business SB630 Allen et al. Concurrence",28,7,0,5,40
1978864,1562830,2025-04-30,Senate,"Do pass, but first be re-referred to the Committee on [Appropriations] with the recommendation: To Consent Calendar",7,0,0,0,7
1978864,1569784,2025-05-12,Senate,"Placed on suspense file",7,0,0,0,7
1978864,1577525,2025-05-23,Senate,"Do pass",5,1,0,1,7
1978864,1580484,2025-05-28,Senate,"Senate 3rd Reading SB631 Richardson",38,0,0,2,40
1978864,1597468,2025-07-02,Assembly,"Do pass as amended and be re-referred to the Committee on [Appropriations]",9,0,0,0,9
1978864,1600413,2025-08-29,Assembly,"Do pass",15,0,0,0,15
1978864,1601581,2025-09-09,Assembly,"SB 631 Richardson Senate Third Reading By Patel",78,0,0,2,80
1978864,1601773,2025-09-10,Senate,"Unfinished Business SB631 Richardson Concurrence",40,0,0,0,40
1978865,1542857,2025-04-09,Senate,"Do pass as amended, but first amend, and re-refer to the Committee on [Appropriations]",4,1,0,0,5
1978865,1559456,2025-04-28,Senate,"Placed on suspense file",7,0,0,0,7
1978865,1577703,2025-05-23,Senate,"Do pass",5,1,0,1,7
1978865,1585020,2025-06-04,Senate,"Senate 3rd Reading SB632 Arreguín",22,10,0,8,40
1978866,1536804,2025-04-02,Senate,"Do pass as amended, but first amend, and re-refer to the Committee on [Appropriations]",6,1,0,1,8
1978866,1552930,2025-04-21,Senate,"Placed on suspense file",6,0,0,1,7
1978866,1577915,2025-05-23,Senate,"Do pass as amended",5,1,0,1,7
1978866,1584998,2025-06-04,Senate,"Senate 3rd Reading SB633 Blakespear",27,10,0,3,40
1978866,1598244,2025-07-14,Assembly,"Do pass as amended and be re-referred to the Committee on [Appropriations]",9,4,0,1,14
1978867,1555945,2025-04-23,Senate,"Do pass, but first be re-referred to the Committee on [Judiciary]",4,2,0,1,7
1978867,1584389,2025-06-03,Senate,"Senate 3rd Reading SB634 Pérez",23,11,0,6,40
1978867,1597587,2025-07-02,Assembly,"Do pass and be re-referred to the Committee on [Housing and Community Development]",6,2,0,2,10
1978867,1598599,2025-07-16,Assembly,"Do pass",9,3,0,0,12
1978867,1601602,2025-09-09,Assembly,"SB 634 Pérez Senate Third Reading By Bryan",55,20,0,5,80
1978867,1601796,2025-09-10,Senate,"Unfinished Business SB634 Pérez et al. Concurrence",22,16,0,2,40
1978868,1536834,2025-04-02,Senate,"Do pass as amended, but first amend, and re-refer to the Committee on [Public Safety]",5,2,0,0,7
1978868,1563107,2025-04-29,Senate,"Do pass as amended, but first amend, and re-refer to the Committee on [Appropriations]",5,1,0,0,6
1978868,1584361,2025-06-03,Senate,"Senate 3rd Reading SB635 Durazo et al",28,10,0,2,40
1978868,1597604,2025-07-02,Assembly,"Do pass and be re-referred to the Committee on [Public Safety]",8,1,0,1,10
1978868,1598725,2025-07-15,Assembly,"Do pass and be re-referred to the Committee on [Appropriations]",7,0,0,2,9
1978868,1600650,2025-08-29,Assembly,"Do pass as amended",11,4,0,0,15
1978868,1602329,2025-09-12,Senate,"Unfinished Business SB635 Durazo et al. Concurrence",29,8,0,3,40
1978868,1602330,2025-09-12,Assembly,"SB 635 Durazo Senate Third Reading By Carrillo",58,15,0,7,80
1978869,1538879,2025-04-07,Senate,"Do pass as amended, but first amend, and re-refer to the Committee on [Appropriations]",13,3,0,1,17
1978869,1559463,2025-04-28,Senate,"Placed on suspense file",7,0,0,0,7
1978871,1562809,2025-04-30,Senate,"Do pass, but first be re-referred to the Committee on [Appropriations]",7,0,0,0,7
1978871,1569882,2025-05-12,Senate,"Placed on suspense file",7,0,0,0,7
1978871,1577649,2025-05-23,Senate,"Do pass as amended",5,0,0,2,7
1978871,1585081,2025-06-04,Senate,"Senate 3rd Reading SB638 Padilla et al",30,3,0,7,40
1978871,1597385,2025-07-02,Assembly,"Do pass as amended and be re-referred to the Committee on [Higher Education]",7,0,0,2,9
1978871,1598884,2025-07-17,Assembly,"Do pass and be re-referred to the Committee on [Appropriations]",6,3,0,1,10
1978871,1600634,2025-08-29,Assembly,"Do pass",11,4,0,0,15
1978871,1602162,2025-09-12,Senate,"Unfinished Business SB638 Padilla et al. Concurrence",37,0,0,3,40
1978871,1602163,2025-09-12,Assembly,"SB 638 Padilla Senate Third Reading By Fong",72,6,0,2,80
1978872,1540857,2025-04-08,Senate,"Do pass, but first be re-referred to the Committee on [Local Government]",6,0,0,1,7
1978872,1563006,2025-04-30,Senate,"Do pass, but first be re-referred to the Committee on [Appropriations] with the recommendation: To Consent Calendar",7,0,0,0,7
1978872,1572424,2025-05-15,Senate,"Consent Calendar 2nd SB639 Ashby",34,0,0,6,40
1978872,1598385,2025-07-15,Assembly,"Do pass as amended and be re-referred to the Committee on [Appropriations]",11,0,0,2,13
1978872,1600552,2025-08-29,Assembly,"Do pass",15,0,0,0,15
1978872,1600907,2025-09-03,Assembly,"SB 639 Ashby Senate Third Reading By Gallagher",79,0,0,0,79
1978872,1601253,2025-09-08,Senate,"Unfinished Business SB639 Ashby Concurrence",39,0,0,1,40
1978873,1563101,2025-04-30,Senate,"Do pass as amended, but first amend, and re-refer to the Committee on [Appropriations]",7,0,0,0,7
1978873,1573511,2025-05-19,Senate,"Placed on suspense file",5,0,0,2,7
1978873,1577236,2025-05-23,Senate,"Do pass as amended",6,0,0,1,7
1978873,1580512,2025-05-28,Senate,"Senate 3rd Reading SB640 Cabaldon et al",37,0,0,3,40
1978873,1597903,2025-07-08,Assembly,"Do pass and be re-referred to the Committee on [Appropriations]",10,0,0,0,10
1978873,1600379,2025-08-29,Assembly,"Do pass as amended",11,0,0,4,15
1978873,1601592,2025-09-09,Assembly,"SB 640 Cabaldon Senate Third Reading By Aguiar-Curry",80,0,0,0,80
1978873,1601767,2025-09-10,Senate,"Unfinished Business SB640 Cabaldon et al. Concurrence",40,0,0,0,40
1978874,1538882,2025-04-07,Senate,"Do pass as amended, but first amend, and re-refer to the Committee on [Public Safety]",10,0,0,1,11
1978874,1562930,2025-04-29,Senate,"Do pass, but first be re-referred to the Committee on [Appropriations] with the recommendation: To Consent Calendar",6,0,0,0,6
1978874,1569878,2025-05-12,Senate,"Placed on suspense file",7,0,0,0,7
1978874,1577527,2025-05-23,Senate,"Do pass",6,0,0,1,7
1978874,1584359,2025-06-03,Senate,"Senate 3rd Reading SB641 Ashby et al. Urgency Clause",39,0,0,1,40
1978874,1597820,2025-07-08,Assembly,"Do pass and be re-referred to the Committee on [Appropriations]",17,0,0,1,18
1978874,1600637,2025-08-29,Assembly,"Do pass as amended",11,0,0,4,15
1978874,1602315,2025-09-12,Senate,"Unfinished Business SB641 Ashby et al. Urgency Clause Concurrence",37,0,0,3,40
1978874,1602316,2025-09-12,Assembly,"SB 641 Ashby Third Reading Urgency By Nguyen",80,0,0,0,80
1978875,1556095,2025-04-23,Senate,"Do pass, but first be re-referred to the Committee on [Judiciary]",4,1,0,0,5
1978875,1562852,2025-04-29,Senate,"Do pass as amended, but first amend, and re-refer to the Committee on [Appropriations]",11,2,0,0,13
1978875,1573601,2025-05-19,Senate,"Placed on suspense file",5,0,0,2,7
1978875,1577946,2025-05-23,Senate,"Do pass as amended",5,1,0,1,7
1978875,1584281,2025-06-03,Senate,"Senate 3rd Reading SB642 Limón",28,10,0,2,40
1978875,1595679,2025-06-25,Assembly,"Do pass and be re-referred to the Committee on [Judiciary]",5,0,0,2,7
1978875,1597969,2025-07-08,Assembly,"Do pass and be re-referred to the Committee on [Appropriations]",9,3,0,0,12
1978875,1600266,2025-08-29,Assembly,"Do pass as amended",11,4,0,0,15
1978875,1601391,2025-09-08,Assembly,"SB 642 Limón Senate Third Reading By Kalra",58,15,0,7,80
1978875,1601570,2025-09-09,Senate,"Unfinished Business SB642 Limón et al. Concurrence",30,10,0,0,40
1978876,1562847,2025-04-30,Senate,"Do pass as amended, but first amend, and re-refer to the Committee on [Appropriations]",7,0,0,1,8
1978876,1573639,2025-05-19,Senate,"Placed on suspense file",5,0,0,2,7
1978876,1577259,2025-05-23,Senate,"Do pass",6,0,0,1,7
1978876,1584369,2025-06-03,Senate,"Senate 3rd Reading SB643 Caballero et al",37,0,0,3,40
1978876,1597737,2025-07-07,Assembly,"Do pass and be re-referred to the Committee on [Utilities and Energy]",12,0,0,2,14
1978876,1598698,2025-07-16,Assembly,"Do pass and be re-referred to the Committee on [Appropriations]",18,0,0,0,18
1978876,1600273,2025-08-29,Assembly,"Do pass",15,0,0,0,15
1978876,1602146,2025-09-12,Senate,"Unfinished Business SB643 Caballero et al. Concurrence",37,0,0,3,40
1978877,1561087,2025-04-29,Senate,"Do pass, but first be re-referred to the Committee on [Education]",4,1,0,0,5
1978877,1562845,2025-04-30,Senate,"Do pass as amended, but first amend, and re-refer to the Committee on [Appropriations]",6,1,0,0,7
1978877,1569913,2025-05-12,Senate,"Placed on suspense file",7,0,0,0,7
1978878,1542822,2025-04-08,Senate,"Do pass, but first be re-referred to the Committee on [Appropriations]",11,0,0,2,13
1978878,1585086,2025-06-04,Senate,"Senate 3rd Reading SB645 Umberg",39,0,0,1,40
1978878,1597867,2025-07-08,Assembly,"Do pass and be re-referred to the Committee on [Appropriations]",12,0,0,0,12
1978878,1600466,2025-08-29,Assembly,"Do pass",15,0,0,0,15
1978878,1602216,2025-09-12,Senate,"Unfinished Business SB645 Umberg Concurrence",37,0,0,3,40
1978879,1535019,2025-04-02,Senate,"Do pass, but first be re-referred to the Committee on [Environmental Quality]",11,0,0,0,11
1978879,1562990,2025-04-30,Senate,"Do pass, but first be re-referred to the Committee on [Appropriations]",8,0,0,0,8
1978879,1569773,2025-05-12,Senate,"Placed on suspense file",7,0,0,0,7
1978879,1577515,2025-05-23,Senate,"Do pass",6,0,0,1,7
1978879,1580504,2025-05-28,Senate,"Senate 3rd Reading SB646 Weber Pierson",38,0,0,2,40
1978879,1597196,2025-07-01,Assembly,"Do pass as amended and be re-referred to the Committee on [Environmental Safety and Toxic Materials]",15,0,0,1,16
1978879,1598559,2025-07-15,Assembly,"Do pass and be re-referred to the Committee on [Appropriations]",5,0,0,2,7
1978879,1600646,2025-08-29,Assembly,"Do pass",15,0,0,0,15
1978879,1602150,2025-09-12,Senate,"Unfinished Business SB646 Weber Pierson Concurrence",34,0,0,6,40
1978879,1602151,2025-09-13,Assembly,"SB 646 Weber Pierson Senate Third Reading By Papan",77,0,0,3,80
1978880,1562870,2025-04-29,Senate,"Do pass as amended, but first amend, and re-refer to the Committee on [Appropriations]",13,1,0,3,17
1978880,1573576,2025-05-19,Senate,"Placed on suspense file",5,0,0,2,7
1978880,1577660,2025-05-23,Senate,"Do pass as amended",5,1,0,1,7
1978880,1581733,2025-05-29,Senate,"Senate 3rd Reading SB647 Hurtado",28,7,0,5,40
1978880,1598092,2025-07-09,Assembly,"Do pass as amended and be re-referred to the Committee on [Appropriations]",13,2,0,3,18
1978880,1600655,2025-08-29,Assembly,"Do pass as amended",11,3,0,1,15
1978880,1602060,2025-09-12,Senate,"Unfinished Business SB647 Hurtado Concurrence",29,7,0,4,40
1978880,1602061,2025-09-12,Assembly,"SB 647 Hurtado Senate Third Reading By Arambula",61,18,0,1,80
1978881,1542765,2025-04-09,Senate,"Do pass, but first be re-referred to the Committee on [Judiciary]",5,0,0,0,5
1978881,1556136,2025-04-22,Senate,"Do pass, but first be re-referred to the Committee on [Appropriations] with the recommendation: To Consent Calendar",13,0,0,0,13
1978881,1565248,2025-05-05,Senate,"Placed on suspense file",7,0,0,0,7
1978881,1577523,2025-05-23,Senate,"Do pass",6,0,0,1,7
1978881,1581709,2025-05-29,Senate,"Special Consent SB648 Smallwood-Cuevas",38,0,0,2,40
1978881,1595665,2025-06-25,Assembly,"Do pass and be re-referred to the Committee on [Judiciary] with recommendation: To Consent Calendar",7,0,0,0,7
1978881,1597131,2025-07-01,Assembly,"Do pass and be re-referred to the Committee on [Appropriations] with recommendation: To Consent Calendar",12,0,0,0,12
1978881,1598085,2025-07-09,Assembly,"Do pass. To Consent Calendar",15,0,0,0,15
1978881,1598883,2025-07-17,Assembly,"SB 648 Smallwood-Cuevas Consent Calendar Second Day Regular Session",75,0,0,4,79
1978883,1540826,2025-04-08,Senate,"Do pass as amended, but first amend, and re-refer to the Committee on [Judiciary] with the recommendation: To Consent Calendar",6,0,0,1,7
1978883,1562925,2025-04-29,Senate,"Do pass, but first be re-referred to the Committee on [Appropriations] with the recommendation: To Consent Calendar",13,0,0,0,13
1978883,1572432,2025-05-15,Senate,"Consent Calendar 2nd SB650 Cabaldon",34,0,0,6,40
1978883,1591896,2025-06-17,Assembly,"Do pass and be re-referred to the Committee on [Judiciary]",10,0,0,3,13
1978883,1597248,2025-07-01,Assembly,"Do pass and be re-referred to the Committee on [Appropriations] with recommendation: To Consent Calendar",12,0,0,0,12
1978883,1598567,2025-07-16,Assembly,"Do pass. To Consent Calendar",13,0,0,2,15
1978883,1600222,2025-08-28,Assembly,"SB 650 Cabaldon Senate Third Reading By Flora",75,0,0,4,79
1978883,1600960,2025-09-03,Senate,"Unfinished Business SB650 Cabaldon Concurrence",40,0,0,0,40
1978885,1552964,2025-04-21,Senate,"Do pass, but first be re-referred to the Committee on [Appropriations] with the recommendation: To Consent Calendar",11,0,0,0,11
1978885,1568623,2025-05-08,Senate,"Consent Calendar 2nd SB652 Richardson",36,0,0,4,40
1978885,1597223,2025-07-01,Assembly,"Do pass and be re-referred to the Committee on [Appropriations] with recommendation: To Consent Calendar",17,0,0,1,18
1978885,1598072,2025-07-09,Assembly,"Do pass. To Consent Calendar",15,0,0,0,15
1978885,1598855,2025-07-17,Assembly,"SB 652 Richardson Consent Calendar Second Day Regular Session",75,0,0,4,79
1978886,1554535,2025-04-22,Senate,"Do pass, but first be re-referred to the Committee on [Appropriations]",5,0,0,2,7
1978886,1565350,2025-05-05,Senate,"Placed on suspense file",7,0,0,0,7
1978886,1577551,2025-05-23,Senate,"Do pass as amended",5,0,0,2,7
1978886,1581699,2025-05-29,Senate,"Senate 3rd Reading SB653 Cortese",36,0,0,4,40
1978886,1594086,2025-06-23,Assembly,"Do pass as amended",13,0,0,1,14
1978886,1600464,2025-08-29,Assembly,"Do pass",14,0,0,1,15
1978886,1600934,2025-09-03,Assembly,"SB 653 Cortese Senate Third Reading By Pellerin",71,1,0,7,79
1978886,1601252,2025-09-08,Senate,"Unfinished Business SB653 Cortese et al. Concurrence",37,0,0,3,40
1978887,1536791,2025-04-02,Senate,"Do pass, but first be re-referred to the Committee on [Appropriations]",6,0,0,2,8
1978887,1552850,2025-04-21,Senate,"Placed on suspense file",6,0,0,1,7
1978888,1562939,2025-04-29,Senate,"Do pass, but first be re-referred to the Committee on [Appropriations]",10,0,0,1,11
1978888,1569766,2025-05-12,Senate,"Placed on suspense file",7,0,0,0,7
1978888,1577445,2025-05-23,Senate,"Do pass as amended",6,0,0,1,7
1978888,1585062,2025-06-04,Senate,"Senate 3rd Reading SB655 Stern",39,0,0,1,40
1978888,1598690,2025-07-16,Assembly,"Do pass as amended and be re-referred to the Committee on [Appropriations]",10,0,0,2,12
1978888,1600627,2025-08-29,Assembly,"Do pass as amended",11,0,0,4,15
1978888,1601463,2025-09-09,Assembly,"SB 655 Stern Senate Third Reading By Haney",66,5,0,9,80
1978888,1601874,2025-09-11,Senate,"Unfinished Business SB655 Stern et al. Concurrence",31,8,0,1,40
1978889,1554637,2025-04-22,Senate,"Do pass, but first be re-referred to the Committee on [Business, Professions and Economic Development]",12,0,0,3,15
1978889,1559422,2025-04-28,Senate,"Do pass, but first be re-referred to the Committee on [Appropriations]",11,0,0,0,11
1978889,1569754,2025-05-12,Senate,"Placed on suspense file",7,0,0,0,7
1978890,1571559,2025-05-14,Senate,"Do pass, but first be re-referred to the Committee on [Appropriations]",4,0,0,1,5
1978890,1573606,2025-05-19,Senate,"Placed on suspense file",5,0,0,2,7
1978891,1556007,2025-04-22,Senate,"Do pass, but first be re-referred to the Committee on [Local Government]",13,0,0,0,13
1978891,1563081,2025-04-30,Senate,"Do pass, but first be re-referred to the Committee on [Appropriations] with the recommendation: To Consent Calendar",7,0,0,0,7
1978891,1569760,2025-05-12,Senate,"Placed on suspense file",7,0,0,0,7
1978892,1556193,2025-04-22,Senate,"Do pass, but first be re-referred to the Committee on [Appropriations]",12,1,0,0,13
1978892,1565354,2025-05-05,Senate,"Placed on suspense file",7,0,0,0,7
1978893,1564280,2025-04-30,Senate,"Do pass, but first be re-referred to the Committee on [Appropriations]",7,0,0,4,11
1978893,1569904,2025-05-12,Senate,"Placed on suspense file",7,0,0,0,7
1978893,1577556,2025-05-23,Senate,"Do pass",5,0,0,2,7
1978893,1586429,2025-06-02,Senate,"Senate 3rd Reading SB660 Menjivar",28,2,0,10,40
1978893,1597213,2025-07-01,Assembly,"Do pass and be re-referred to the Committee on [Privacy and Consumer Protection]",14,0,0,2,16
1978893,1598750,2025-07-16,Assembly,"Do pass as amended and be re-referred to the Committee on [Appropriations]",12,0,0,3,15
1978893,1600408,2025-08-29,Assembly,"Do pass as amended",11,0,0,4,15
1978893,1601499,2025-09-09,Assembly,"SB 660 Menjivar Senate Third Reading By Bonta",57,5,0,18,80
1978893,1601759,2025-09-10,Senate,"Unfinished Business SB660 Menjivar et al. Concurrence",30,5,0,5,40
1978894,1554478,2025-04-22,Senate,"Do pass, but first be re-referred to the Committee on [Revenue and Taxation]",14,0,0,1,15
1978894,1556119,2025-04-23,Senate,"Do pass, but first be re-referred to the Committee on [Appropriations]",5,0,0,0,5
1978894,1565362,2025-05-05,Senate,"Placed on suspense file",7,0,0,0,7
1978894,1577246,2025-05-23,Senate,"Do pass",5,0,0,2,7
1978894,1585024,2025-06-04,Senate,"Senate 3rd Reading SB661 Hurtado",39,0,0,1,40
1978894,1597714,2025-07-07,Assembly,"Do pass and be re-referred to the Committee on [Revenue and Taxation]",15,0,0,1,16
1978895,1540873,2025-04-08,Senate,"Do pass, but first be re-referred to the Committee on [Appropriations] with the recommendation: To Consent Calendar",6,0,0,1,7
1978895,1552864,2025-04-21,Senate,"Placed on suspense file",6,0,0,1,7
1978896,1542865,2025-04-09,Senate,"Do pass, but first be re-referred to the Committee on [Appropriations]",5,0,0,0,5
1978896,1552914,2025-04-21,Senate,"Placed on suspense file",6,0,0,1,7
1978896,1577477,2025-05-23,Senate,"Do pass",6,0,0,1,7
1978896,1584420,2025-06-03,Senate,"Senate 3rd Reading SB663 Allen et al. Urgency Clause",39,0,0,1,40
1978896,1598447,2025-07-14,Assembly,"Do pass as amended and be re-referred to the Committee on [Appropriations]",5,0,0,2,7
1978896,1600620,2025-08-29,Assembly,"Do pass",15,0,0,0,15
1978896,1601501,2025-09-09,Assembly,"SB 663 Allen Third Reading Urgency By Irwin",80,0,0,0,80
1978896,1601997,2025-09-11,Senate,"That the Assembly amendments be concurred in",5,0,0,0,5
1978896,1601998,2025-09-11,Senate,"Unfinished Business SB663 Allen et al. Urgency Clause Concurrence",40,0,0,0,40
1978898,1571538,2025-05-14,Senate,"Do pass, but first be re-referred to the Committee on [Appropriations]",1,4,0,0,5
1978898,1571539,2025-05-14,Senate,"[First] hearing set for [05-14-2025]: Failed passage in Committee. Reconsideration granted",5,0,0,0,5
1978899,1571573,2025-05-14,Senate,"Do pass, but first be re-referred to the Committee on [Appropriations]",1,4,0,0,5
1978899,1571574,2025-05-14,Senate,"[First] hearing set for [05-14-2025]: Failed passage in Committee. Reconsideration granted",5,0,0,0,5
1978900,1554447,2025-04-21,Senate,"Do pass, but first be re-referred to the Committee on [Transportation]",12,4,0,1,17
1978901,1556191,2025-04-23,Senate,"Do pass as amended, but first amend, and re-refer to the Committee on [Appropriations]",4,0,0,1,5
1978901,1565249,2025-05-05,Senate,"Placed on suspense file",7,0,0,0,7
1978902,1545042,2025-04-09,Senate,"Do pass as amended, but first amend, and re-refer to the Committee on [Appropriations] with the recommendation: To Consent Calendar",11,0,0,0,11
1978902,1559384,2025-04-28,Senate,"Placed on suspense file",7,0,0,0,7
1978902,1577144,2025-05-23,Senate,"Do pass",6,0,0,1,7
1978902,1581747,2025-05-29,Senate,"Special Consent SB669 McGuire et al",38,0,0,2,40
1978902,1597229,2025-07-01,Assembly,"Do pass as amended, and be re-referred to the Committee on [Appropriations] with recommendation: To Consent Calendar",15,0,0,1,16
1978902,1600329,2025-08-29,Assembly,"Do pass",15,0,0,0,15
1978902,1601454,2025-09-09,Assembly,"SB 669 McGuire Senate Third Reading By Bonta",80,0,0,0,80
1978902,1601900,2025-09-11,Senate,"Unfinished Business SB669 McGuire et al. Concurrence",40,0,0,0,40
1978903,1556107,2025-04-23,Senate,"Do pass, but first be re-referred to the Committee on [Appropriations]",7,0,0,0,7
1978903,1586377,2025-06-02,Senate,"Senate 3rd Reading SB670 Cervantes",37,0,0,3,40
1978903,1594682,2025-06-24,Assembly,"Do pass and be re-referred to the Committee on [Education]",9,0,0,1,10
1978903,1598665,2025-07-16,Assembly,"Do pass and be re-referred to the Committee on [Appropriations] with recommendation: To Consent Calendar",9,0,0,0,9
1978903,1599775,2025-08-20,Assembly,"Do pass",15,0,0,0,15
1978903,1601392,2025-09-08,Assembly,"SB 670 Cervantes Senate Third Reading By Pacheco",78,0,0,2,80
1978904,1542811,2025-04-08,Senate,"Do pass, but first be re-referred to the Committee on [Appropriations] with the recommendation: To Consent Calendar",15,0,0,0,15
1978904,1557511,2025-04-24,Senate,"Consent Calendar 2nd SB671 Cervantes",37,0,0,3,40
1978904,1598377,2025-07-14,Assembly,"Do pass and be re-referred to the Committee on [Appropriations] with recommendation: To Consent Calendar",16,0,0,0,16
1978904,1599755,2025-08-20,Assembly,"Do pass. To Consent Calendar",15,0,0,0,15
1978904,1600231,2025-08-28,Assembly,"SB 671 Cervantes Consent Calendar Second Day Regular Session",74,0,0,5,79
1978906,1508041,2025-03-06,Senate,"Senate 3rd Reading SCR26 Weber Pierson By Senator Becker",34,0,0,5,39
1978906,1552952,2025-04-21,Assembly,"Be adopted. To Consent Calendar",10,0,0,1,11
1978906,1557539,2025-04-24,Assembly,"SCR 26 Weber Pierson Consent Calendar Second Day Regular Session",75,0,0,4,79
1980060,1557587,2025-04-23,Assembly,"Do pass and be re-referred to the Committee on [Education]",5,0,0,2,7
1980060,1564147,2025-04-30,Assembly,"Do pass as amended and be re-referred to the Committee on [Appropriations]",9,0,0,0,9
1980061,1542798,2025-04-09,Assembly,"Do pass as amended and be re-referred to the Committee on [Appropriations]",7,0,0,0,7
1980061,1577657,2025-05-23,Assembly,"Do pass",14,0,0,1,15
1980061,1583446,2025-06-02,Assembly,"AB 1164 Ransom Assembly Third Reading",78,0,0,1,79
1980061,1598419,2025-07-15,Senate,"Do pass as amended, but first amend, and re-refer to the Committee on [Appropriations]",5,0,0,0,5
1980061,1599505,2025-08-18,Senate,"Placed on suspense file",7,0,0,0,7
1980062,1563040,2025-04-30,Assembly,"Do pass and be re-referred to the Committee on [Appropriations]",9,1,0,2,12
1980063,1565276,2025-05-05,Assembly,"Do pass",9,0,0,0,9
1980063,1572446,2025-05-15,Assembly,"AB 1166 Valencia Assembly Third Reading",73,0,0,6,79
1980063,1597592,2025-07-02,Senate,"Do pass as amended, but first amend, and re-refer to the Committee on [Judiciary]",5,2,0,0,7
1980063,1598758,2025-07-15,Senate,"Do pass, but first be re-referred to the Committee on [Appropriations]",11,1,0,1,13
1980063,1599378,2025-08-18,Senate,"Placed on suspense file",7,0,0,0,7
1980064,1564282,2025-04-30,Assembly,"Do pass as amended and be re-referred to the Committee on [Appropriations]",13,0,0,5,18
1980064,1577590,2025-05-23,Assembly,"Do pass as amended",10,0,0,5,15
1980064,1583418,2025-06-02,Assembly,"AB 1167 Berman Assembly Third Reading",52,1,0,26,79
1980064,1597136,2025-07-01,Senate,"Do pass as amended, but first amend, and re-refer to the Committee on [Judiciary]",13,4,0,0,17
1980064,1599595,2025-08-18,Senate,"Placed on suspense file",7,0,0,0,7
1980064,1600665,2025-08-29,Senate,"Do pass as amended",5,2,0,0,7
1980064,1601532,2025-09-09,Senate,"Assembly 3rd Reading AB1167 Berman et al. By McNerney",29,10,0,1,40
1980066,1540821,2025-04-08,Assembly,"Do pass and be re-referred to the Committee on [Appropriations] with recommendation: To Consent Calendar",13,0,0,0,13
1980066,1577197,2025-05-23,Assembly,"Do pass as amended",14,0,0,1,15
1980066,1584331,2025-06-03,Assembly,"AB 1169 Jeff Gonzalez Assembly Third Reading",78,0,0,1,79
1980066,1598564,2025-07-16,Senate,"Do pass as amended, but first amend, and re-refer to the Committee on [Appropriations] with the recommendation: To Consent Calendar",7,0,0,0,7
1980066,1599375,2025-08-18,Senate,"Placed on suspense file",7,0,0,0,7
1980067,1526936,2025-03-25,Assembly,"Do pass. To Consent Calendar",12,0,0,0,12
1980067,1533576,2025-04-01,Assembly,"AB 1170 Dixon Consent Calendar Second Day Regular Session",76,0,0,4,80
1980067,1597452,2025-07-01,Senate,"Do pass and be ordered to the Consent Calendar",13,0,0,0,13
1980067,1598163,2025-07-10,Senate,"Consent Calendar 2nd AB1170 Dixon",37,0,0,3,40
1980069,1540805,2025-04-08,Assembly,"Do pass as amended and be re-referred to the Committee on [Judiciary]",6,0,0,0,6
1980069,1554493,2025-04-22,Assembly,"Do pass as amended, and be re-referred to the Committee on [Appropriations] with recommendation: To Consent Calendar",12,0,0,0,12
1980069,1577535,2025-05-23,Assembly,"Do pass",14,0,0,1,15
1980069,1585011,2025-06-04,Assembly,"AB 1172 Nguyen Assembly Third Reading",79,0,0,0,79
1980069,1597271,2025-06-30,Senate,"Do pass, but first be re-referred to the Committee on [Judiciary] with the recommendation: To Consent Calendar",5,0,0,0,5
1980069,1598717,2025-07-15,Senate,"Do pass as amended, but first amend, and re-refer to the Committee on [Appropriations] with the recommendation: To Consent Calendar",13,0,0,0,13
1980069,1599563,2025-08-18,Senate,"Placed on suspense file",7,0,0,0,7
1980069,1600515,2025-08-29,Senate,"Do pass",7,0,0,0,7
1980069,1601746,2025-09-10,Senate,"Assembly 3rd Reading AB1172 Nguyen et al. By Grayson",40,0,0,0,40
1980070,1564270,2025-04-30,Assembly,"Do pass as amended and be re-referred to the Committee on [Appropriations]",18,0,0,0,18
1980072,1540788,2025-04-08,Assembly,"Do pass as amended and be re-referred to the Committee on [Appropriations]",17,0,0,1,18
1980072,1556091,2025-04-23,Assembly,"Do pass",15,0,0,0,15
1980072,1565349,2025-05-05,Assembly,"AB 1175 Irwin Assembly Third Reading",77,0,0,2,79
1980072,1598252,2025-07-14,Senate,"Do pass, but first be re-referred to the Committee on [Appropriations]",11,0,0,0,11
1980072,1600823,2025-09-02,Senate,"Assembly 3rd Reading AB1175 Irwin By Weber Pierson",40,0,0,0,40
1980074,1555890,2025-04-23,Assembly,"Do pass and be re-referred to the Committee on [Appropriations] with recommendation: To Consent Calendar",22,0,0,0,22
1980074,1567865,2025-05-07,Assembly,"Do pass. To Consent Calendar",15,0,0,0,15
1980074,1572392,2025-05-15,Assembly,"AB 1177 Connolly Consent Calendar Second Day Regular Session",69,0,0,10,79
1980074,1588076,2025-06-10,Senate,"Do pass, but first be re-referred to the Committee on [Appropriations] with the recommendation: To Consent Calendar",14,0,0,1,15
1980074,1596028,2025-06-27,Senate,"Consent Calendar 2nd AB1177 Connolly",38,0,0,2,40
1980075,1554550,2025-04-22,Assembly,"Do pass as amended and be re-referred to the Committee on [Appropriations]",9,0,0,0,9
1980075,1568675,2025-05-08,Assembly,"AB 1178 Pacheco Assembly Third Reading",60,2,0,17,79
1980075,1588095,2025-06-10,Senate,"Do pass as amended, but first amend, and re-refer to the Committee on [Appropriations]",5,0,0,1,6
1980075,1596753,2025-06-30,Senate,"Placed on suspense file",6,0,0,1,7
1980075,1600428,2025-08-29,Senate,"Do pass as amended",7,0,0,0,7
1980075,1602068,2025-09-12,Senate,"Assembly 3rd Reading AB1178 Pacheco et al. By Archuleta",29,2,0,9,40
1980075,1602069,2025-09-13,Assembly,"AB 1178 PACHECO Concurrence in Senate Amendments",67,0,0,13,80
1980077,1552940,2025-04-21,Assembly,"Do pass as amended and be re-referred to the Committee on [Appropriations]",9,0,0,0,9
1980077,1577629,2025-05-23,Assembly,"Do pass",14,0,0,1,15
1980077,1583477,2025-06-02,Assembly,"AB 1180 Valencia Assembly Third Reading",78,0,0,1,79
1980077,1597607,2025-07-02,Senate,"Do pass as amended, but first amend, and re-refer to the Committee on [Judiciary] with the recommendation: To Consent Calendar",7,0,0,0,7
1980077,1598595,2025-07-15,Senate,"Do pass, but first be re-referred to the Committee on [Appropriations] with the recommendation: To Consent Calendar",13,0,0,0,13
1980077,1599536,2025-08-18,Senate,"Placed on suspense file",7,0,0,0,7
1980078,1536783,2025-04-02,Assembly,"Do pass and be re-referred to the Committee on [Appropriations]",7,0,0,0,7
1980078,1577943,2025-05-23,Assembly,"Do pass as amended",11,0,0,4,15
1980078,1583544,2025-06-02,Assembly,"AB 1181 Haney Assembly Third Reading",78,0,0,1,79
1980078,1592567,2025-06-18,Senate,"Do pass, but first be re-referred to the Committee on [Appropriations] with the recommendation: To Consent Calendar",5,0,0,0,5
1980078,1596778,2025-06-30,Senate,"Placed on suspense file",6,0,0,1,7
1980078,1600489,2025-08-29,Senate,"Do pass as amended",7,0,0,0,7
1980078,1601854,2025-09-11,Senate,"Special Consent AB1181 Haney et al. By Allen",40,0,0,0,40
1980078,1602186,2025-09-12,Assembly,"AB 1181 Haney Concurrence in Senate Amendments",79,0,0,1,80
1980079,1556132,2025-04-23,Assembly,"Do pass and be re-referred to the Committee on [Appropriations] with recommendation: To Consent Calendar",18,0,0,0,18
1980083,1540917,2025-04-08,Assembly,"Do pass and be re-referred to the Committee on [Appropriations] with recommendation: To Consent Calendar",12,0,0,0,12
1980084,1542722,2025-04-08,Assembly,"Do pass as amended and be re-referred to the Committee on [Appropriations]",6,2,0,1,9
1980085,1562994,2025-04-30,Assembly,"Do pass as amended and be re-referred to the Committee on [Appropriations]",4,1,0,2,7
1980087,1561048,2025-04-28,Assembly,"Do pass and be re-referred to the Committee on [Appropriations]",15,0,0,1,16
1980087,1571647,2025-05-14,Assembly,"Do pass",14,1,0,0,15
1980087,1573613,2025-05-19,Assembly,"AB 1190 Haney Assembly Third Reading",73,1,0,5,79
1980087,1597914,2025-07-08,Senate,"Do pass, but first be re-referred to the Committee on [Appropriations]",13,0,0,2,15
1980087,1599532,2025-08-18,Senate,"Placed on suspense file",7,0,0,0,7
1980089,1540911,2025-04-08,Assembly,"Do pass and be re-referred to the Committee on [Public Safety] with recommendation: To Consent Calendar",6,0,0,0,6
1980089,1562912,2025-04-29,Assembly,"Do pass and be re-referred to the Committee on [Appropriations] with recommendation: To Consent Calendar",9,0,0,0,9
1980092,1542693,2025-04-08,Assembly,"Do pass and be re-referred to the Committee on [Human Services] with recommendation: To Consent Calendar",9,0,0,0,9
1980092,1562892,2025-04-29,Assembly,"Do pass as amended, and be re-referred to the Committee on [Appropriations] with recommendation: To Consent Calendar",7,0,0,0,7
1980092,1577452,2025-05-23,Assembly,"Do pass",14,0,0,1,15
1980092,1583444,2025-06-02,Assembly,"AB 1195 Quirk-Silva Assembly Third Reading",79,0,0,0,79
1980092,1594637,2025-06-24,Senate,"Do pass, but first be re-referred to the Committee on [Human Services] with the recommendation: To Consent Calendar",6,0,0,0,6
1980092,1597762,2025-07-07,Senate,"Do pass, but first be re-referred to the Committee on [Appropriations] with the recommendation: To Consent Calendar",5,0,0,0,5
1980092,1599611,2025-08-18,Senate,"Placed on suspense file",7,0,0,0,7
1980092,1600745,2025-08-29,Senate,"Do pass",7,0,0,0,7
1980092,1601678,2025-09-09,Senate,"Assembly 3rd Reading AB1195 Quirk-Silva By Arreguín",40,0,0,0,40
1980093,1563119,2025-04-29,Assembly,"Do pass as amended and be re-referred to the Committee on [Appropriations]",16,0,0,0,16
1980094,1561030,2025-04-29,Assembly,"Do pass and be re-referred to the Committee on [Privacy and Consumer Protection]",11,0,0,1,12
1980094,1566693,2025-05-06,Assembly,"Do pass as amended",14,0,0,1,15
1980094,1577271,2025-05-23,Assembly,"AB 1197 Calderon Assembly Third Reading",73,0,0,6,79
1980094,1595225,2025-06-24,Senate,"Do pass as amended, but first amend, and re-refer to the Committee on [Public Safety]",11,1,0,1,13
1980094,1598495,2025-07-15,Senate,"Do pass",6,0,0,0,6
1980094,1601504,2025-09-09,Senate,"Assembly 3rd Reading AB1197 Calderon By Grayson",39,0,0,1,40
1980095,1536848,2025-04-02,Assembly,"Do pass and be re-referred to the Committee on [Appropriations]",7,0,0,0,7
1980096,1563052,2025-04-29,Assembly,"Do pass as amended, and be re-referred to the Committee on [Appropriations] with recommendation: To Consent Calendar",16,0,0,0,16
1980096,1575466,2025-05-21,Assembly,"Do pass. To Consent Calendar",15,0,0,0,15
1980096,1579257,2025-05-27,Assembly,"AB 1199 Patterson Consent Calendar Second Day Regular Session",76,0,0,3,79
1980097,1561022,2025-04-28,Assembly,"Do pass and be re-referred to the Committee on [Appropriations]",7,0,0,0,7
1980097,1577787,2025-05-23,Assembly,"Do pass as amended",11,0,0,4,15
1980097,1583406,2025-06-02,Assembly,"AB 1200 Caloza Assembly Third Reading",79,0,0,0,79
1980097,1597898,2025-07-08,Senate,"Do pass, but first be re-referred to the Committee on [Appropriations] with the recommendation: To Consent Calendar",15,0,0,0,15
1980097,1599406,2025-08-18,Senate,"Placed on suspense file",7,0,0,0,7
1980097,1600297,2025-08-29,Senate,"Do pass",7,0,0,0,7
1980097,1601103,2025-09-04,Senate,"Special Consent AB1200 Caloza",39,0,0,1,40
1980098,1526974,2025-03-25,Assembly,"Do pass as amended and be re-referred to the Committee on [Human Services]",9,3,0,0,12
1980098,1563059,2025-04-29,Assembly,"Do pass and be re-referred to the Committee on [Appropriations]",6,1,0,0,7
1980098,1577288,2025-05-23,Assembly,"Do pass",11,3,0,1,15
1980098,1584371,2025-06-03,Assembly,"AB 1201 Jackson Assembly Third Reading",55,15,0,9,79
1980101,1564217,2025-04-30,Assembly,"Do pass as amended and be re-referred to the Committee on [Appropriations]",8,0,0,1,9
1980103,1528254,2025-03-26,Assembly,"Do pass as amended and be re-referred to the Committee on [Local Government]",11,0,0,0,11
1980103,1542863,2025-04-09,Assembly,"Do pass and be re-referred to the Committee on [Appropriations]",10,0,0,0,10
1980103,1556115,2025-04-23,Assembly,"Do pass",12,0,0,3,15
1980103,1568673,2025-05-08,Assembly,"AB 1206 Harabedian Assembly Third Reading",66,1,0,12,79
1980103,1592570,2025-06-18,Senate,"Do pass as amended, but first amend, and re-refer to the Committee on [Housing]",5,2,0,0,7
1980103,1598368,2025-07-15,Senate,"Do pass as amended, but first amend, and re-refer to the Committee on [Appropriations]",8,2,0,1,11
1980103,1600039,2025-08-25,Senate,"Placed on suspense file",6,0,0,1,7
1980104,1559393,2025-04-28,Assembly,"Do pass and be re-referred to the Committee on [Appropriations]",11,0,0,3,14
1980104,1567859,2025-05-07,Assembly,"Do pass",11,0,0,4,15
1980104,1579258,2025-05-27,Assembly,"AB 1207 Irwin Assembly Third Reading",60,2,0,17,79
1980104,1598647,2025-07-16,Senate,"Do pass, but first be re-referred to the Committee on [Appropriations]",7,0,0,1,8
1980104,1601984,2025-09-11,Senate,"Do pass",5,1,0,2,8
1980104,1602096,2025-09-12,Senate,"Assembly 2nd Reading AB1207 Irwin et al. By Limón Urgency Clause",29,6,0,5,40
1980104,1602097,2025-09-13,Assembly,"AB 1207 IRWIN Concurrence - Urgency Added",58,10,0,12,80
1980105,1562792,2025-04-29,Assembly,"Do pass as amended and be re-referred to the Committee on [Appropriations]",7,0,0,0,7
1980105,1577362,2025-05-23,Assembly,"Do pass",14,0,0,1,15
1980105,1583460,2025-06-02,Assembly,"AB 1208 Addis Assembly Third Reading",79,0,0,0,79
1980105,1597177,2025-06-30,Senate,"Do pass, but first be re-referred to the Committee on [Appropriations]",5,0,0,0,5
1980105,1598279,2025-07-14,Senate,"Placed on suspense file",7,0,0,0,7
1980106,1535130,2025-04-02,Assembly,"Do pass and be re-referred to the Committee on [Business and Professions]",15,2,0,0,17
1980107,1542853,2025-04-08,Assembly,"Do pass and be re-referred to the Committee on [Appropriations] with recommendation: To Consent Calendar",9,0,0,0,9
1980107,1577804,2025-05-23,Assembly,"Do pass",14,0,0,1,15
1980107,1585042,2025-06-04,Assembly,"AB 1210 Lackey Assembly Third Reading",78,0,0,1,79
1980107,1597854,2025-07-08,Senate,"Do pass, but first be re-referred to the Committee on [Appropriations] with the recommendation: To Consent Calendar",6,0,0,0,6
1980107,1599556,2025-08-18,Senate,"Placed on suspense file",7,0,0,0,7
1980107,1600436,2025-08-29,Senate,"Do pass as amended",7,0,0,0,7
1980107,1601862,2025-09-11,Senate,"Special Consent AB1210 Lackey By Seyarto",40,0,0,0,40
1980107,1602189,2025-09-13,Assembly,"AB 1210 Lackey Concurrence in Senate Amendments",73,1,0,6,80
1980108,1540964,2025-04-08,Assembly,"Do pass and be re-referred to the Committee on [Appropriations]",5,1,0,0,6
1980109,1542908,2025-04-08,Assembly,"Do pass and be re-referred to the Committee on [Housing and Community Development]",8,1,0,1,10
1980110,1542887,2025-04-08,Assembly,"Do pass and be re-referred to the Committee on [Appropriations] with recommendation: To Consent Calendar",9,0,0,0,9
1980110,1555978,2025-04-23,Assembly,"Do pass. To Consent Calendar",15,0,0,0,15
1980110,1564276,2025-05-01,Assembly,"AB 1213 Stefani Consent Calendar Second Day Regular Session",76,0,0,3,79
1980110,1588081,2025-06-10,Senate,"Do pass, but first be re-referred to the Committee on [Appropriations] with the recommendation: To Consent Calendar",6,0,0,0,6
1980110,1600849,2025-09-02,Senate,"Assembly 3rd Reading AB1213 Stefani By Caballero",40,0,0,0,40
1980110,1601165,2025-09-04,Assembly,"AB 1213 Stefani Concurrence in Senate Amendments",78,0,0,1,79
1980111,1542891,2025-04-09,Assembly,"Do pass and be re-referred to the Committee on [Appropriations]",2,4,0,1,7
1980111,1542892,2025-04-09,Assembly,Reconsideration,7,0,0,0,7
1980111,1563130,2025-04-30,Assembly,"Do pass and be re-referred to the Committee on [Appropriations] with recommendation: To Consent Calendar",7,0,0,0,7
1980111,1571627,2025-05-14,Assembly,"Do pass. To Consent Calendar",15,0,0,0,15
1980111,1577498,2025-05-23,Assembly,"AB 1214 Patterson Consent Calendar Second Day Regular Session",71,0,0,8,79
1980111,1598402,2025-07-15,Senate,"Do pass, but first be re-referred to the Committee on [Appropriations] with the recommendation: To Consent Calendar",5,0,0,0,5
1980113,1529528,2025-03-26,Assembly,"Do pass and be re-referred to the Committee on [Appropriations] with recommendation: To Consent Calendar",9,0,0,0,9
1980113,1542871,2025-04-09,Assembly,"Do pass. To Consent Calendar",14,0,0,1,15
1980113,1557584,2025-04-24,Assembly,"AB 1216 Education Consent Calendar Second Day Regular Session",75,0,0,4,79
1980113,1589105,2025-06-11,Senate,"Do pass, but first be re-referred to the Committee on [Appropriations] with the recommendation: To Consent Calendar",6,0,0,1,7
1980113,1595990,2025-06-27,Senate,"Consent Calendar 2nd AB1216 ED. (Muratsuchi)",38,0,0,2,40
1980113,1598210,2025-07-14,Assembly,"AB 1216 Education Concurrence in Senate Amendments By MURATSUCHI",78,0,0,1,79
1980114,1542912,2025-04-08,Assembly,"Do pass as amended and be re-referred to the Committee on [Education]",8,0,0,2,10
1980114,1564284,2025-04-30,Assembly,"Do pass and be re-referred to the Committee on [Appropriations]",9,0,0,0,9
1980117,1563000,2025-04-29,Assembly,"Do pass and be re-referred to the Committee on [Appropriations]",7,0,0,0,7
1980117,1571533,2025-05-14,Assembly,"Do pass",15,0,0,0,15
1980117,1573567,2025-05-19,Assembly,"AB 1220 Arambula Assembly Third Reading",75,0,0,4,79
1980117,1591159,2025-06-16,Senate,"Do pass as amended, but first amend, and re-refer to the Committee on [Appropriations]",5,0,0,0,5
1980117,1596786,2025-06-30,Senate,"Placed on suspense file",6,0,0,1,7
1980118,1536781,2025-04-02,Assembly,"Do pass and be re-referred to the Committee on [Privacy and Consumer Protection]",5,0,0,2,7
1980118,1564281,2025-05-01,Assembly,"Do pass as amended and be re-referred to the Committee on [Appropriations]",10,1,0,4,15
1980119,1556151,2025-04-23,Assembly,"Do pass and be re-referred to the Committee on [Judiciary]",12,3,0,3,18
1980119,1561011,2025-04-29,Assembly,"Do pass and be re-referred to the Committee on [Appropriations]",9,3,0,0,12
1980120,1556113,2025-04-23,Assembly,"Do pass as amended and be re-referred to the Committee on [Transportation]",7,1,0,2,10
1980120,1561184,2025-04-28,Assembly,"Do pass as amended and be re-referred to the Committee on [Appropriations]",12,4,0,0,16
1980120,1573513,2025-05-19,Assembly,"AB 1223 Nguyen Assembly Third Reading",52,15,0,12,79
1980120,1594636,2025-06-24,Senate,"Do pass, but first be re-referred to the Committee on [Revenue and Taxation]",11,3,0,1,15
1980120,1598096,2025-07-09,Senate,"Do pass as amended",4,1,0,0,5
1980120,1600958,2025-09-03,Senate,"Assembly 3rd Reading AB1223 Nguyen et al. By Cortese",28,11,0,1,40
1980120,1601120,2025-09-04,Assembly,"AB 1223 Nguyen Concurrence in Senate Amendments",54,17,0,8,79
1980121,1529551,2025-03-26,Assembly,"Do pass and be re-referred to the Committee on [Appropriations]",9,0,0,0,9
1980121,1542793,2025-04-09,Assembly,"Do pass",14,0,0,1,15
1980121,1565293,2025-05-05,Assembly,"AB 1224 Valencia Assembly Third Reading",77,0,0,2,79
1980121,1597424,2025-07-02,Senate,"Do pass as amended, but first amend, and re-refer to the Committee on [Appropriations]",7,0,0,0,7
1980121,1599558,2025-08-18,Senate,"Placed on suspense file",7,0,0,0,7
1980121,1600303,2025-08-29,Senate,"Do pass",7,0,0,0,7
1980121,1601506,2025-09-09,Senate,"Assembly 3rd Reading AB1224 Valencia et al. By Limón",38,1,0,1,40
1980122,1562893,2025-04-29,Assembly,"Do pass as amended and be re-referred to the Committee on [Appropriations]",13,0,0,0,13
1980122,1577865,2025-05-23,Assembly,"Do pass",14,0,0,1,15
1980122,1583414,2025-06-02,Assembly,"AB 1225 Bennett Assembly Third Reading",79,0,0,0,79
1980122,1594590,2025-06-24,Senate,"Do pass, but first be re-referred to the Committee on [Appropriations] with the recommendation: To Consent Calendar",7,0,0,0,7
1980122,1597771,2025-07-07,Senate,"Placed on suspense file",6,0,0,1,7
1980122,1600332,2025-08-29,Senate,"Do pass",7,0,0,0,7
1980122,1601132,2025-09-04,Senate,"Special Consent AB1225 Bennett et al. By Niello",39,0,0,1,40
1980124,1559372,2025-04-28,Assembly,"Do pass as amended and be re-referred to the Committee on [Appropriations]",14,0,0,0,14
1980124,1577512,2025-05-23,Assembly,"Do pass",14,0,0,1,15
1980124,1585037,2025-06-04,Assembly,"AB 1227 Ellis Assembly Third Reading",76,0,0,3,79
1980124,1597434,2025-07-02,Senate,"Do pass, but first be re-referred to the Committee on [Natural Resources and Water] with the recommendation: To Consent Calendar",8,0,0,0,8
1980124,1598746,2025-07-16,Senate,"Do pass as amended, but first amend, and re-refer to the Committee on [Appropriations] with the recommendation: To Consent Calendar",7,0,0,0,7
1980124,1600065,2025-08-25,Senate,"Placed on suspense file",6,0,0,1,7
1980126,1528285,2025-03-26,Assembly,"Do pass and be re-referred to the Committee on [Public Safety]",8,0,0,3,11
1980126,1554488,2025-04-22,Assembly,"Do pass and be re-referred to the Committee on [Appropriations]",8,0,0,1,9
1980126,1577929,2025-05-23,Assembly,"Do pass",11,2,0,2,15
1980126,1583383,2025-06-02,Assembly,"AB 1229 Schultz Assembly Third Reading",62,10,0,7,79
1980126,1597519,2025-07-01,Senate,"Do pass, but first be re-referred to the Committee on [Public Safety]",10,1,0,0,11
1980126,1598420,2025-07-15,Senate,"Do pass, but first be re-referred to the Committee on [Appropriations]",5,1,0,0,6
1980126,1599381,2025-08-18,Senate,"Placed on suspense file",7,0,0,0,7
1980126,1600688,2025-08-29,Senate,"Do pass as amended",5,2,0,0,7
1980127,1544994,2025-04-09,Assembly,"Do pass as amended and be re-referred to the Committee on [Appropriations]",9,0,0,0,9
1980127,1577655,2025-05-23,Assembly,"Do pass",14,0,0,1,15
1980127,1583435,2025-06-02,Assembly,"AB 1230 Bonta Assembly Third Reading",77,0,0,2,79
1980127,1597508,2025-07-02,Senate,"Do pass as amended, but first amend, and re-refer to the Committee on [Appropriations]",7,0,0,0,7
1980127,1599654,2025-08-18,Senate,"Placed on suspense file",7,0,0,0,7
1980127,1600355,2025-08-29,Senate,"Do pass",7,0,0,0,7
1980127,1600978,2025-09-03,Senate,"Assembly 3rd Reading AB1230 Bonta et al. By Ochoa Bogh",40,0,0,0,40
1980127,1601164,2025-09-04,Assembly,"AB 1230 Bonta Concurrence in Senate Amendments",78,0,0,1,79
1980128,1542767,2025-04-08,Assembly,"Do pass as amended and be re-referred to the Committee on [Appropriations]",5,2,0,2,9
1980128,1577384,2025-05-23,Assembly,"Do pass as amended",11,3,0,1,15
1980128,1583371,2025-06-02,Assembly,"AB 1231 Elhawary Assembly Third Reading",42,25,0,12,79
1980128,1598432,2025-07-15,Senate,"Do pass, but first be re-referred to the Committee on [Appropriations]",4,1,0,1,6
1980128,1599648,2025-08-18,Senate,"Placed on suspense file",7,0,0,0,7
1980128,1600684,2025-08-29,Senate,"Do pass as amended",5,2,0,0,7
1980128,1602176,2025-09-12,Senate,"Assembly 3rd Reading AB1231 Elhawary et al. By Cortese",21,16,0,3,40
1980128,1602177,2025-09-13,Assembly,"AB 1231 ELHAWARY Concurrence in Senate Amendments",34,27,0,19,80
1980129,1554575,2025-04-22,Assembly,"Do pass and be re-referred to the Committee on [Judiciary] with recommendation: To Consent Calendar",8,0,0,0,8
1980129,1561073,2025-04-29,Assembly,"Do pass and be re-referred to the Committee on [Appropriations] with recommendation: To Consent Calendar",12,0,0,0,12
1980130,1555961,2025-04-23,Assembly,"Do pass and be re-referred to the Committee on [Education]",7,0,0,0,7
1980130,1564232,2025-04-30,Assembly,"Do pass as amended, and be re-referred to the Committee on [Appropriations] with recommendation: To Consent Calendar",9,0,0,0,9
1980131,1536756,2025-04-02,Assembly,"Do pass and be re-referred to the Committee on [Judiciary]",4,0,0,3,7
1980131,1554600,2025-04-22,Assembly,"Do pass as amended and be re-referred to the Committee on [Appropriations]",8,2,0,2,12
1980131,1577882,2025-05-23,Assembly,"Do pass as amended",11,1,0,3,15
1980131,1585026,2025-06-04,Assembly,"AB 1234 Ortega Assembly Third Reading",50,14,0,15,79
1980131,1595224,2025-06-25,Senate,"Do pass, but first be re-referred to the Committee on [Judiciary]",4,1,0,0,5
1980131,1598633,2025-07-15,Senate,"Do pass as amended, but first amend, and re-refer to the Committee on [Appropriations]",11,2,0,0,13
1980131,1599541,2025-08-18,Senate,"Placed on suspense file",7,0,0,0,7
1980131,1600778,2025-08-29,Senate,"Do pass",5,2,0,0,7
1980132,1536845,2025-04-02,Assembly,"Do pass and be re-referred to the Committee on [Higher Education]",7,0,0,0,7
1980132,1561067,2025-04-29,Assembly,"Do pass and be re-referred to the Committee on [Appropriations]",8,0,0,2,10
1980133,1556062,2025-04-23,Assembly,"Do pass and be re-referred to the Committee on [Appropriations]",17,0,0,0,17
1980134,1538978,2025-04-07,Assembly,"Do pass and be re-referred to the Committee on [Arts, Entertainment, Sports, and Tourism]",12,3,0,1,16
1980134,1554462,2025-04-22,Assembly,"Do pass as amended",6,1,0,2,9
1980134,1573530,2025-05-19,Assembly,"AB 1237 McKinnor Third Reading Urgency",57,16,0,6,79
1980136,1562749,2025-04-29,Assembly,"Do pass and be re-referred to the Committee on [Appropriations] with recommendation: To Consent Calendar",9,0,0,0,9
1980136,1577483,2025-05-23,Assembly,"Do pass",14,0,0,1,15
1980136,1584308,2025-06-03,Assembly,"AB 1239 Dixon Assembly Third Reading",78,0,0,1,79
1980136,1597209,2025-07-01,Senate,"Do pass, but first be re-referred to the Committee on [Appropriations] with the recommendation: To Consent Calendar",6,0,0,0,6
1980136,1598309,2025-07-14,Senate,"Placed on suspense file",7,0,0,0,7
1980136,1600611,2025-08-29,Senate,"Do pass",7,0,0,0,7
1980136,1601096,2025-09-04,Senate,"Special Consent AB1239 Dixon et al",39,0,0,1,40
1980136,1601514,2025-09-09,Assembly,"AB 1239 Dixon Concurrence in Senate Amendments",79,0,0,1,80
1980137,1526952,2025-03-25,Assembly,"Do pass and be re-referred to the Committee on [Appropriations]",9,1,0,2,12
1980137,1577696,2025-05-23,Assembly,"Do pass",11,2,0,2,15
1980137,1584421,2025-06-03,Assembly,"AB 1240 Lee Assembly Third Reading",42,18,0,19,79
1980139,1555948,2025-04-22,Assembly,"Do pass and be re-referred to the Committee on [Human Services]",16,0,0,0,16
1980139,1563055,2025-04-29,Assembly,"Do pass and be re-referred to the Committee on [Appropriations]",6,0,0,1,7
1980139,1577349,2025-05-23,Assembly,"Do pass as amended",11,1,0,3,15
1980139,1584358,2025-06-03,Assembly,"AB 1242 Nguyen Assembly Third Reading",72,3,0,4,79
1980139,1597413,2025-07-02,Senate,"Do pass, but first be re-referred to the Committee on [Governmental Organization]",10,0,0,1,11
1980139,1597855,2025-07-08,Senate,"Do pass as amended, but first amend, and re-refer to the Committee on [Appropriations]",11,0,0,4,15
1980139,1599455,2025-08-18,Senate,"Placed on suspense file",7,0,0,0,7
1980140,1558717,2025-04-21,Assembly,"Do pass and be re-referred to the Committee on [Judiciary]",9,4,0,1,14
1980141,1558707,2025-04-21,Assembly,"Do pass as amended and be re-referred to the Committee on [Housing and Community Development]",14,0,0,0,14
1980141,1562891,2025-04-30,Assembly,"Do pass and be re-referred to the Committee on [Appropriations]",9,0,0,3,12
1980141,1577854,2025-05-23,Assembly,"Do pass",14,0,0,1,15
1980141,1583531,2025-06-02,Assembly,"AB 1244 Wicks Assembly Third Reading",76,0,0,3,79
1980143,1555920,2025-04-23,Assembly,"Do pass and be re-referred to the Committee on [Appropriations]",22,0,0,0,22
1980143,1567869,2025-05-07,Assembly,"Do pass",15,0,0,0,15
1980143,1569816,2025-05-12,Assembly,"AB 1246 Hoover Assembly Third Reading",76,0,0,3,79
1980143,1597949,2025-07-08,Senate,"Do pass, but first be re-referred to the Committee on [Appropriations]",15,0,0,0,15
1980143,1599653,2025-08-18,Senate,"Placed on suspense file",7,0,0,0,7
1980143,1600406,2025-08-29,Senate,"Do pass as amended",7,0,0,0,7
1980143,1601877,2025-09-11,Senate,"Assembly 3rd Reading AB1246 Hoover By Valladares",40,0,0,0,40
1980143,1602032,2025-09-12,Assembly,"With recommendation: That Senate amendments be concurred in",17,0,0,5,22
1980143,1602205,2025-09-13,Assembly,"AB 1246 Hoover Concurrence in Senate Amendments",73,1,0,6,80
1980144,1535039,2025-04-02,Assembly,"Do pass and be re-referred to the Committee on [Higher Education]",5,0,0,2,7
1980144,1561072,2025-04-29,Assembly,"Do pass and be re-referred to the Committee on [Appropriations]",7,2,0,1,10
1980145,1554440,2025-04-22,Assembly,"Do pass",8,3,0,1,12
1980146,1542784,2025-04-09,Assembly,"Do pass as amended and be re-referred to the Committee on [Appropriations]",5,2,0,0,7
1980146,1577784,2025-05-23,Assembly,"Do pass",11,3,0,1,15
1980146,1585084,2025-06-04,Assembly,"AB 1249 Wilson Assembly Third Reading",60,19,0,0,79
1980146,1598387,2025-07-15,Senate,"Do pass as amended, but first amend, and re-refer to the Committee on [Appropriations]",4,1,0,0,5
1980146,1599586,2025-08-18,Senate,"Placed on suspense file",7,0,0,0,7
1980146,1600388,2025-08-29,Senate,"Do pass",5,2,0,0,7
1980146,1601555,2025-09-09,Senate,"Assembly 3rd Reading AB1249 Wilson By Limón",30,10,0,0,40
1980147,1561026,2025-04-28,Assembly,"Do pass and be re-referred to the Committee on [Appropriations] with recommendation: To Consent Calendar",16,0,0,0,16
1980147,1571535,2025-05-14,Assembly,"Do pass. To Consent Calendar",15,0,0,0,15
1980147,1577880,2025-05-23,Assembly,"AB 1250 Papan Consent Calendar Second Day Regular Session",71,0,0,8,79
1980147,1597873,2025-07-08,Senate,"Do pass, but first be re-referred to the Committee on [Appropriations]",15,0,0,0,15
1980147,1600920,2025-09-03,Senate,"Assembly 3rd Reading AB1250 Papan By Strickland",40,0,0,0,40
1980147,1601535,2025-09-09,Senate,"Assembly 3rd Reading AB1250 Papan By Strickland",40,0,0,0,40
1980148,1536801,2025-04-02,Assembly,"Do pass and be re-referred to the Committee on [Privacy and Consumer Protection]",7,0,0,0,7
1980148,1577507,2025-05-23,Assembly,"Do pass as amended",11,2,0,2,15
1980148,1583573,2025-06-02,Assembly,"AB 1251 Berman Assembly Third Reading",62,9,0,8,79
1980148,1592576,2025-06-18,Senate,"Do pass, but first be re-referred to the Committee on [Judiciary]",4,1,0,0,5
1980148,1598232,2025-07-14,Senate,"Placed on suspense file",7,0,0,0,7
1980150,1561144,2025-04-28,Assembly,"Do pass as amended and be re-referred to the Committee on [Appropriations]",7,0,0,0,7
1980151,1554432,2025-04-22,Assembly,"Do pass and be re-referred to the Committee on [Appropriations] with recommendation: To Consent Calendar",8,0,0,0,8
1980152,1564263,2025-04-30,Assembly,"Do pass as amended, and be re-referred to the Committee on [Appropriations] with recommendation: To Consent Calendar",9,0,0,0,9
1980152,1577622,2025-05-23,Assembly,"Do pass as amended",11,0,0,4,15
1980152,1583525,2025-06-02,Assembly,"AB 1255 Education Third Reading Urgency By MURATSUCHI",76,0,0,3,79
1980152,1595220,2025-06-25,Senate,"Do pass, but first be re-referred to the Committee on [Appropriations] with the recommendation: To Consent Calendar",7,0,0,0,7
1980152,1598182,2025-07-10,Senate,"Consent Calendar 2nd AB1255 ED. (Muratsuchi) Urgency Clause",37,0,0,3,40
1980152,1600827,2025-09-02,Senate,"Assembly 3rd Reading AB1255 ED. (Muratsuchi) By Pérez Urgency Clause",40,0,0,0,40
1980152,1601088,2025-09-04,Assembly,"AB 1255 Education Concurrence in Senate Amendments By MURATSUCHI",76,0,0,3,79
1980155,1542714,2025-04-08,Assembly,"Do pass and be re-referred to the Committee on [Appropriations]",7,0,0,2,9
1980155,1577530,2025-05-23,Assembly,"Do pass",11,1,0,3,15
1980155,1583448,2025-06-02,Assembly,"AB 1258 Kalra Assembly Third Reading",61,13,0,5,79
1980155,1594672,2025-06-24,Senate,"Do pass, but first be re-referred to the Committee on [Appropriations]",5,1,0,0,6
1980155,1600895,2025-09-03,Senate,"Assembly 3rd Reading AB1258 Kalra By Cortese",32,8,0,0,40
1980155,1601134,2025-09-04,Assembly,"AB 1258 Kalra Concurrence in Senate Amendments",61,13,0,5,79
1980157,1556037,2025-04-23,Assembly,"Do pass as amended and be re-referred to the Committee on [Appropriations]",13,1,0,4,18
1980158,1554648,2025-04-22,Assembly,"Do pass as amended and be re-referred to the Committee on [Appropriations]",9,2,0,1,12
1980158,1577299,2025-05-23,Assembly,"Do pass",11,2,0,2,15
1980158,1584307,2025-06-03,Assembly,"AB 1261 Bonta Assembly Third Reading",63,8,0,8,79
1980158,1597485,2025-07-01,Senate,"Do pass, but first be re-referred to the Committee on [Human Services]",12,1,0,0,13
1980158,1597752,2025-07-07,Senate,"Do pass, but first be re-referred to the Committee on [Appropriations]",4,0,0,1,5
1980158,1599591,2025-08-18,Senate,"Placed on suspense file",7,0,0,0,7
1980158,1600503,2025-08-29,Senate,"Do pass",5,2,0,0,7
1980158,1601512,2025-09-09,Senate,"Assembly 3rd Reading AB1261 Bonta et al. By Arreguín",30,8,0,2,40
1980160,1542684,2025-04-08,Assembly,"Do pass and be re-referred to the Committee on [Judiciary]",7,0,0,2,9
1980160,1554524,2025-04-22,Assembly,"Do pass and be re-referred to the Committee on [Appropriations]",10,1,0,1,12
1980160,1577684,2025-05-23,Assembly,"Do pass",11,2,0,2,15
1980160,1584360,2025-06-03,Assembly,"AB 1263 Gipson Assembly Third Reading",63,10,0,6,79
1980160,1597191,2025-07-01,Senate,"Do pass, but first be re-referred to the Committee on [Judiciary]",5,1,0,0,6
1980160,1598672,2025-07-15,Senate,"Do pass, but first be re-referred to the Committee on [Appropriations]",11,1,0,1,13
1980160,1599450,2025-08-18,Senate,"Placed on suspense file",7,0,0,0,7
1980160,1600613,2025-08-29,Senate,"Do pass",5,2,0,0,7
1980160,1601872,2025-09-11,Senate,"Assembly 3rd Reading AB1263 Gipson et al. By Blakespear",30,10,0,0,40
1980160,1602328,2025-09-12,Assembly,"AB 1263 Gipson Concurrence in Senate Amendments",62,13,0,5,80
1980161,1545031,2025-04-09,Assembly,"Do pass as amended and be re-referred to the Committee on [Environmental Safety and Toxic Materials]",8,0,0,1,9
1980161,1561059,2025-04-29,Assembly,"Do pass and be re-referred to the Committee on [Appropriations]",6,0,0,1,7
1980161,1577802,2025-05-23,Assembly,"Do pass",12,0,0,3,15
1980161,1584276,2025-06-03,Assembly,"AB 1264 Gabriel Assembly Third Reading",65,1,0,13,79
1980161,1597472,2025-07-02,Senate,"Do pass, but first be re-referred to the Committee on [Environmental Quality]",7,0,0,0,7
1980161,1598681,2025-07-16,Senate,"Do pass as amended, but first amend, and re-refer to the Committee on [Appropriations]",7,0,0,1,8
1980161,1599566,2025-08-18,Senate,"Placed on suspense file",7,0,0,0,7
1980161,1600527,2025-08-29,Senate,"Do pass",5,0,0,2,7
1980161,1601639,2025-09-09,Senate,"That the measure be returned to Senate Floor for consideration. Ordered to third reading",10,0,0,1,11
1980161,1601906,2025-09-11,Senate,"Assembly 3rd Reading AB1264 Gabriel et al. By Weber Pierson",40,0,0,0,40
1980161,1602056,2025-09-12,Assembly,"AB 1264 Gabriel Concurrence in Senate Amendments",79,1,0,0,80
1980162,1542700,2025-04-09,Assembly,"Do pass and be re-referred to the Committee on [Revenue and Taxation] with recommendation: To Consent Calendar",12,0,0,0,12
1980164,1555942,2025-04-22,Assembly,"Do pass as amended and be re-referred to the Committee on [Appropriations]",13,1,0,2,16
1980164,1577216,2025-05-23,Assembly,"Do pass",12,1,0,2,15
1980164,1583364,2025-06-02,Assembly,"AB 1267 Pellerin Assembly Third Reading",66,8,0,5,79
1980164,1597534,2025-07-02,Senate,"Do pass, but first be re-referred to the Committee on [Appropriations]",10,0,0,1,11
1980164,1598283,2025-07-14,Senate,"Placed on suspense file",7,0,0,0,7
1980164,1600711,2025-08-29,Senate,"Do pass",7,0,0,0,7
1980166,1542875,2025-04-08,Assembly,"Do pass and be re-referred to the Committee on [Appropriations]",7,0,0,2,9
1980166,1577369,2025-05-23,Assembly,"Do pass as amended",11,0,0,4,15
1980166,1584227,2025-06-03,Assembly,"AB 1269 Bryan Assembly Third Reading",78,0,0,1,79
1980166,1597814,2025-07-08,Senate,"Do pass, but first be re-referred to the Committee on [Appropriations]",6,0,0,0,6
1980166,1601284,2025-09-08,Senate,"Assembly 3rd Reading AB1269 Bryan et al. By Smallwood-Cuevas Urgency Clause",39,0,0,1,40
1980166,1601607,2025-09-09,Assembly,"AB 1269 Bryan Concurrence - Urgency Added",78,0,0,2,80
1980168,1542831,2025-04-09,Assembly,"Do pass as amended and be re-referred to the Committee on [Business and Professions]",9,0,0,1,10
1980168,1561179,2025-04-29,Assembly,"Do pass as amended and be re-referred to the Committee on [Appropriations]",13,2,0,3,18
1980169,1538985,2025-04-07,Assembly,"Do pass and be re-referred to the Committee on [Appropriations] with recommendation: To Consent Calendar",16,0,0,0,16
1980169,1575484,2025-05-21,Assembly,"Do pass. To Consent Calendar",15,0,0,0,15
1980169,1579302,2025-05-27,Assembly,"AB 1272 Dixon Consent Calendar Second Day Regular Session",76,0,0,3,79
1980169,1594627,2025-06-24,Senate,"Do pass, but first be re-referred to the Committee on [Appropriations] with the recommendation: To Consent Calendar",14,0,0,1,15
1980169,1598177,2025-07-10,Senate,"Consent Calendar 2nd AB1272 Dixon",37,0,0,3,40
1980170,1535106,2025-04-02,Assembly,"Do pass as amended, and be re-referred to the Committee on [Appropriations] with recommendation: To Consent Calendar",18,0,0,0,18
1980170,1562985,2025-04-30,Assembly,"Do pass. To Consent Calendar",14,0,0,1,15
1980170,1568634,2025-05-08,Assembly,"AB 1273 Patterson Consent Calendar Second Day Regular Session",69,0,0,10,79
1980170,1598512,2025-07-15,Senate,"Do pass as amended, but first amend, and re-refer to the Committee on [Appropriations]",15,0,0,2,17
1980170,1599502,2025-08-18,Senate,"Placed on suspense file",7,0,0,0,7
1980170,1600420,2025-08-29,Senate,"Do pass",7,0,0,0,7
1980170,1602311,2025-09-12,Senate,"Assembly 3rd Reading AB1273 Patterson By Becker",37,0,0,3,40
1980170,1602312,2025-09-13,Assembly,"AB 1273 Patterson Concurrence in Senate Amendments",73,0,0,7,80
1980172,1558365,2025-04-24,Assembly,"Do pass and be re-referred to the Committee on [Local Government] with recommendation: To Consent Calendar",11,0,0,1,12
1980172,1564305,2025-04-30,Assembly,"Do pass and be re-referred to the Committee on [Appropriations] with recommendation: To Consent Calendar",10,0,0,0,10
1980172,1571637,2025-05-14,Assembly,"Do pass. To Consent Calendar",15,0,0,0,15
1980172,1577690,2025-05-23,Assembly,"AB 1275 Elhawary Consent Calendar Second Day Regular Session",71,0,0,8,79
1980172,1597381,2025-07-01,Senate,"Do pass, but first be re-referred to the Committee on [Appropriations] with the recommendation: To Consent Calendar",11,0,0,0,11
1980172,1601564,2025-09-09,Senate,"Assembly 3rd Reading AB1275 Elhawary By Durazo",40,0,0,0,40
1980173,1542704,2025-04-09,Assembly,"Do pass and be re-referred to the Committee on [Local Government] with recommendation: To Consent Calendar",12,0,0,0,12
1980173,1564289,2025-04-30,Assembly,"Do pass and be re-referred to the Committee on [Appropriations] with recommendation: To Consent Calendar",10,0,0,0,10
1980173,1571585,2025-05-14,Assembly,"Do pass. To Consent Calendar",15,0,0,0,15
1980173,1577769,2025-05-23,Assembly,"AB 1276 Carrillo Consent Calendar Second Day Regular Session",71,0,0,8,79
1980173,1597423,2025-07-01,Senate,"Do pass, but first be re-referred to the Committee on [Local Government]",11,0,0,0,11
1980173,1598040,2025-07-09,Senate,"Do pass as amended, but first amend, and re-refer to the Committee on [Appropriations]",7,0,0,0,7
1980173,1600059,2025-08-25,Senate,"Placed on suspense file",6,0,0,1,7
1980176,1542794,2025-04-08,Assembly,"Do pass as amended and be re-referred to the Committee on [Appropriations]",5,1,0,3,9
1980176,1577760,2025-05-23,Assembly,"Do pass",9,3,0,3,15
1980177,1535120,2025-04-02,Assembly,"Do pass and be re-referred to the Committee on [Natural Resources]",17,0,0,1,18
1980177,1559424,2025-04-28,Assembly,"Do pass and be re-referred to the Committee on [Appropriations]",13,0,0,1,14
1980177,1577866,2025-05-23,Assembly,"Do pass",14,0,0,1,15
1980177,1585002,2025-06-04,Assembly,"AB 1280 Garcia Assembly Third Reading",72,1,0,6,79
1980177,1597760,2025-07-07,Senate,"Do pass, but first be re-referred to the Committee on [Energy, Utilities and Communications]",10,0,0,1,11
1980177,1598476,2025-07-15,Senate,"Do pass as amended, but first amend, and re-refer to the Committee on [Appropriations]",13,0,0,4,17
1980177,1599419,2025-08-18,Senate,"Placed on suspense file",7,0,0,0,7
1980177,1600277,2025-08-29,Senate,"Do pass",5,0,0,2,7
1980177,1601671,2025-09-09,Senate,"Assembly 3rd Reading AB1280 Garcia et al. By Becker",37,0,0,3,40
1980181,1540879,2025-04-07,Assembly,"Do pass and be re-referred to the Committee on [Appropriations]",7,0,0,0,7
1980182,1540802,2025-04-07,Assembly,"Do pass and be re-referred to the Committee on [Appropriations]",7,0,0,0,7
1980182,1577600,2025-05-23,Assembly,"Do pass",14,0,0,1,15
1980182,1585128,2025-06-04,Assembly,"AB 1285 Emergency Management Assembly Third Reading By RANSOM",79,0,0,0,79
1980182,1597844,2025-07-08,Senate,"Do pass, but first be re-referred to the Committee on [Appropriations] with the recommendation: To Consent Calendar",15,0,0,0,15
1980182,1599535,2025-08-18,Senate,"Placed on suspense file",7,0,0,0,7
1980182,1600298,2025-08-29,Senate,"Do pass",7,0,0,0,7
1980182,1601086,2025-09-04,Senate,"Special Consent AB1285 E.M. (Ransom)",39,0,0,1,40
1980183,1542888,2025-04-09,Assembly,"Do pass as amended and be re-referred to the Committee on [Appropriations]",7,0,0,0,7
1980183,1562762,2025-04-30,Assembly,"Do pass",14,0,0,1,15
1980183,1565251,2025-05-05,Assembly,"AB 1286 Boerner Assembly Third Reading",77,0,0,2,79
1980183,1597165,2025-07-01,Senate,"Do pass as amended, but first amend, and re-refer to the Committee on [Appropriations] with the recommendation: To Consent Calendar",5,0,0,0,5
1980183,1598849,2025-07-17,Senate,"Consent Calendar 2nd AB1286 Boerner",35,0,0,5,40
1980183,1599986,2025-08-25,Assembly,"AB 1286 Boerner Concurrence in Senate Amendments",76,0,0,3,79
1980184,1535005,2025-04-02,Assembly,"Do pass and be re-referred to the Committee on [Appropriations] with recommendation: To Consent Calendar",21,0,0,1,22
1980184,1555990,2025-04-23,Assembly,"Do pass. To Consent Calendar",15,0,0,0,15
1980184,1564288,2025-05-01,Assembly,"AB 1287 Fong Consent Calendar Second Day Regular Session",76,0,0,3,79
1980185,1556103,2025-04-22,Assembly,"Do pass and be re-referred to the Committee on [Appropriations] with recommendation: To Consent Calendar",16,0,0,0,16
1980185,1577213,2025-05-23,Assembly,"Do pass",14,0,0,1,15
1980185,1584422,2025-06-03,Assembly,"AB 1288 Addis Assembly Third Reading",79,0,0,0,79
1980185,1597450,2025-07-02,Senate,"Do pass, but first be re-referred to the Committee on [Appropriations] with the recommendation: To Consent Calendar",11,0,0,0,11
1980185,1598289,2025-07-14,Senate,"Placed on suspense file",7,0,0,0,7
1980185,1600422,2025-08-29,Senate,"Do pass as amended",7,0,0,0,7
1980185,1601865,2025-09-11,Senate,"Special Consent AB1288 Addis et al. By Pérez",40,0,0,0,40
1980185,1602307,2025-09-12,Assembly,"AB 1288 Addis Concurrence in Senate Amendments",80,0,0,0,80
1980188,1554644,2025-04-22,Assembly,"Do pass as amended and be re-referred to the Committee on [Privacy and Consumer Protection]",6,1,0,2,9
1980188,1564303,2025-05-01,Assembly,"Do pass and be re-referred to the Committee on [Appropriations]",8,3,0,4,15
1980190,1556196,2025-04-23,Assembly,"Do pass and be re-referred to the Committee on [Appropriations] with recommendation: To Consent Calendar",17,0,0,0,17
1980190,1577376,2025-05-23,Assembly,"Do pass",14,0,0,1,15
1980190,1583492,2025-06-02,Assembly,"AB 1293 Wallis Assembly Third Reading",78,0,0,1,79
1980190,1592605,2025-06-18,Senate,"Do pass, but first be re-referred to the Committee on [Appropriations] with the recommendation: To Consent Calendar",5,0,0,0,5
1980190,1596750,2025-06-30,Senate,"Placed on suspense file",6,0,0,1,7
1980190,1600628,2025-08-29,Senate,"Do pass as amended",7,0,0,0,7
1980190,1601933,2025-09-11,Senate,"Special Consent AB1293 Wallis By Strickland",40,0,0,0,40
1980190,1602327,2025-09-12,Assembly,"AB 1293 Wallis Concurrence in Senate Amendments",79,0,0,1,80
1980191,1542922,2025-04-09,Assembly,"Do pass and be re-referred to the Committee on [Local Government] with recommendation: To Consent Calendar",12,0,0,0,12
1980191,1564153,2025-04-30,Assembly,"Do pass and be re-referred to the Committee on [Appropriations]",10,0,0,0,10
1980191,1577370,2025-05-23,Assembly,"Do pass",14,0,0,1,15
1980191,1583416,2025-06-02,Assembly,"AB 1294 Haney Assembly Third Reading",78,0,0,1,79
1980191,1597496,2025-07-01,Senate,"Do pass as amended, but first amend, and re-refer to the Committee on [Local Government]",10,0,0,1,11
1980192,1564176,2025-04-30,Assembly,"Do pass and be re-referred to the Committee on [Appropriations] with recommendation: To Consent Calendar",18,0,0,0,18
1980193,1558364,2025-04-24,Assembly,"Do pass and be re-referred to the Committee on [Education]",10,0,0,2,12
1980193,1564196,2025-04-30,Assembly,"Do pass and be re-referred to the Committee on [Appropriations]",9,0,0,0,9
1980193,1577767,2025-05-23,Assembly,"Do pass as amended",11,2,0,2,15
1980193,1583377,2025-06-02,Assembly,"AB 1296 Bonta Assembly Third Reading",67,5,0,7,79
1980193,1591845,2025-06-17,Senate,"Do pass, but first be re-referred to the Committee on [Appropriations]",7,2,0,2,11
1980193,1596806,2025-06-30,Senate,"Placed on suspense file",6,0,0,1,7
1980193,1600569,2025-08-29,Senate,"Do pass as amended",5,2,0,0,7
1980193,1601289,2025-09-08,Senate,"Assembly 3rd Reading AB1296 Bonta et al. By Cabaldon",30,8,0,2,40
1980193,1601481,2025-09-09,Assembly,"AB 1296 Bonta Concurrence in Senate Amendments",66,8,0,6,80
1980194,1527000,2025-03-25,Assembly,"Do pass. To Consent Calendar",12,0,0,0,12
1980194,1533463,2025-04-01,Assembly,"AB 1297 Stefani Consent Calendar Second Day Regular Session",76,0,0,4,80
1980194,1591851,2025-06-17,Senate,"Do pass and be ordered to the Consent Calendar",12,0,0,1,13
1980194,1594069,2025-06-23,Senate,"Consent Calendar 2nd AB1297 Stefani",37,0,0,3,40
1980196,1538974,2025-04-07,Assembly,"Do pass and be re-referred to the Committee on [Appropriations] with recommendation: To Consent Calendar",16,0,0,0,16
1980196,1575483,2025-05-21,Assembly,"Do pass. To Consent Calendar",15,0,0,0,15
1980196,1579297,2025-05-27,Assembly,"AB 1299 Bryan Consent Calendar Second Day Regular Session",75,1,0,3,79
1980196,1594694,2025-06-24,Senate,"Do pass, but first be re-referred to the Committee on [Appropriations]",13,0,0,2,15
1980196,1601080,2025-09-04,Senate,"Assembly 3rd Reading AB1299 Bryan et al. By Cortese",39,0,0,1,40
1980198,1567888,2025-05-07,Assembly,"Do pass. To Consent Calendar",15,0,0,3,18
1980198,1572434,2025-05-15,Assembly,"AB 1301 Petrie-Norris Consent Calendar Second Day Regular Session",69,0,0,10,79
1980200,1542820,2025-04-09,Assembly,"Do pass and be re-referred to the Committee on [Judiciary]",8,2,0,0,10
1980200,1561154,2025-04-29,Assembly,"Do pass as amended and be re-referred to the Committee on [Appropriations]",8,3,0,1,12
1980200,1571625,2025-05-14,Assembly,"Do pass",11,4,0,0,15
1980200,1573602,2025-05-19,Assembly,"AB 1303 Valencia Assembly Third Reading",61,12,0,6,79
1980200,1591873,2025-06-17,Senate,"Do pass as amended, but first amend, and re-refer to the Committee on [Judiciary]",11,1,0,5,17
1980200,1597938,2025-07-08,Senate,"Do pass as amended, but first amend, and re-refer to the Committee on [Appropriations]",11,1,0,1,13
1980200,1601243,2025-09-08,Senate,"Assembly 3rd Reading AB1303 Valencia et al. By Gonzalez",29,9,0,2,40
1980200,1601619,2025-09-09,Assembly,"AB 1303 Valencia Concurrence in Senate Amendments",61,14,0,5,80
1980201,1558732,2025-04-21,Assembly,"Do pass and be re-referred to the Committee on [Appropriations]",13,1,0,0,14
1980202,1558724,2025-04-21,Assembly,"Do pass as amended and be re-referred to the Committee on [Appropriations]",9,4,0,1,14
1980203,1545013,2025-04-09,Assembly,"Do pass as amended, and be re-referred to the Committee on [Appropriations] with recommendation: To Consent Calendar",9,0,0,0,9
1980203,1563078,2025-04-30,Assembly,"Do pass. To Consent Calendar",14,0,0,1,15
1980203,1568652,2025-05-08,Assembly,"AB 1306 Muratsuchi Consent Calendar Second Day Regular Session",69,0,0,10,79
1980203,1589092,2025-06-11,Senate,"Do pass, but first be re-referred to the Committee on [Appropriations]",6,0,0,1,7
1980203,1594065,2025-06-23,Senate,"Placed on suspense file",7,0,0,0,7
1980203,1600412,2025-08-29,Senate,"Do pass",7,0,0,0,7
1980203,1601181,2025-09-04,Senate,"Special Consent AB1306 Muratsuchi",39,0,0,1,40
1980204,1533522,2025-04-01,Assembly,"Do pass as amended and be re-referred to the Committee on [Appropriations]",17,0,0,1,18
1980204,1577930,2025-05-23,Assembly,"Do pass",13,1,0,1,15
1980204,1583580,2025-06-02,Assembly,"AB 1307 Ávila Farías Assembly Third Reading",72,4,0,3,79
1980205,1556194,2025-04-23,Assembly,"Do pass as amended and be re-referred to the Committee on [Housing and Community Development]",10,0,0,0,10
1980205,1562962,2025-04-30,Assembly,"Do pass and be re-referred to the Committee on [Appropriations] with recommendation: To Consent Calendar",10,0,0,2,12
1980205,1571639,2025-05-14,Assembly,"Do pass. To Consent Calendar",15,0,0,0,15
1980205,1577688,2025-05-23,Assembly,"AB 1308 Hoover Consent Calendar Second Day Regular Session",71,0,0,8,79
1980205,1598065,2025-07-09,Senate,"Do pass as amended, but first amend, and re-refer to the Committee on [Housing]",7,0,0,0,7
1980205,1598400,2025-07-15,Senate,"Do pass, but first be re-referred to the Committee on [Appropriations] with the recommendation: To Consent Calendar",10,0,0,1,11
1980205,1600007,2025-08-25,Senate,"Consent Calendar 2nd AB1308 Hoover et al",37,0,0,3,40
1980205,1601561,2025-09-09,Senate,"Assembly 3rd Reading AB1308 Hoover et al. By Jones",40,0,0,0,40
1980206,1535146,2025-04-02,Assembly,"Do pass and be re-referred to the Committee on [Appropriations]",7,0,0,0,7
1980206,1577571,2025-05-23,Assembly,"Do pass",14,0,0,1,15
1980206,1584262,2025-06-03,Assembly,"AB 1309 Flora Assembly Third Reading",77,1,0,1,79
1980206,1595180,2025-06-25,Senate,"Do pass, but first be re-referred to the Committee on [Appropriations] with the recommendation: To Consent Calendar",5,0,0,0,5
1980206,1597696,2025-07-07,Senate,"Placed on suspense file",6,0,0,1,7
1980206,1600407,2025-08-29,Senate,"Do pass",7,0,0,0,7
1980206,1601150,2025-09-04,Senate,"Special Consent AB1309 Flora By Cabaldon",39,0,0,1,40
1980208,1559370,2025-04-28,Assembly,"Do pass and be re-referred to the Committee on [Appropriations] with recommendation: To Consent Calendar",14,0,0,0,14
1980209,1563038,2025-04-29,Assembly,"Do pass as amended and be re-referred to the Committee on [Appropriations]",12,3,0,1,16
1980209,1577864,2025-05-23,Assembly,"Do pass",11,3,0,1,15
1980209,1583558,2025-06-02,Assembly,"AB 1312 Schiavo Assembly Third Reading",51,16,0,12,79
1980209,1598856,2025-07-16,Senate,"Do pass as amended, but first amend, and re-refer to the Committee on [Appropriations]",8,0,0,3,11
1980209,1599501,2025-08-18,Senate,"Placed on suspense file",7,0,0,0,7
1980209,1600689,2025-08-29,Senate,"Do pass",5,2,0,0,7
1980209,1601279,2025-09-08,Senate,"Assembly 3rd Reading AB1312 Schiavo By Pérez",27,8,0,5,40
1980209,1601466,2025-09-09,Assembly,"AB 1312 Schiavo Concurrence in Senate Amendments",62,16,0,2,80
1980210,1561064,2025-04-29,Assembly,"Do pass and be re-referred to the Committee on [Appropriations]",5,2,0,0,7
1980210,1577754,2025-05-23,Assembly,"Do pass",11,3,0,1,15
1980211,1540792,2025-04-08,Assembly,"Do pass and be re-referred to the Committee on [Appropriations] with recommendation: To Consent Calendar",6,0,0,0,6
1980211,1577601,2025-05-23,Assembly,"Do pass",14,0,0,1,15
1980211,1583555,2025-06-02,Assembly,"AB 1314 Ahrens Assembly Third Reading",78,1,0,0,79
1980211,1597732,2025-07-07,Senate,"Do pass, but first be re-referred to the Committee on [Appropriations]",4,0,0,1,5
1980211,1599400,2025-08-18,Senate,"Placed on suspense file",7,0,0,0,7
1980211,1600440,2025-08-29,Senate,"Do pass as amended",5,2,0,0,7
1980211,1601113,2025-09-04,Senate,"Assembly 3rd Reading AB1314 Ahrens By Arreguín",32,0,0,8,40
1980211,1601303,2025-09-08,Assembly,"AB 1314 Ahrens Concurrence in Senate Amendments",68,4,0,8,80
1980213,1563037,2025-04-29,Assembly,"Do pass and be re-referred to the Committee on [Appropriations]",8,3,0,2,13
1980215,1563127,2025-04-29,Assembly,"Do pass as amended and be re-referred to the Committee on [Appropriations]",5,2,0,0,7
1980215,1571583,2025-05-14,Assembly,"Do pass",11,4,0,0,15
1980215,1579249,2025-05-27,Assembly,"AB 1318 Bonta Third Reading Urgency",61,13,0,5,79
1980215,1597725,2025-07-07,Senate,"Do pass, but first be re-referred to the Committee on [Appropriations]",4,0,0,1,5
1980215,1601264,2025-09-08,Senate,"Assembly 3rd Reading AB1318 Bonta et al. By McNerney Urgency Clause",29,10,0,1,40
1980215,1601541,2025-09-09,Assembly,"AB 1318 Bonta Concurrence in Senate Amendments",60,19,0,1,80
1980216,1562932,2025-04-29,Assembly,"Do pass as amended and be re-referred to the Committee on [Appropriations]",8,3,0,2,13
1980216,1577208,2025-05-23,Assembly,"Do pass as amended",11,3,0,1,15
1980216,1583367,2025-06-02,Assembly,"AB 1319 Schultz Assembly Third Reading",54,18,0,7,79
1980216,1597921,2025-07-08,Senate,"Do pass as amended, but first amend, and re-refer to the Committee on [Appropriations]",4,3,0,0,7
1980216,1599529,2025-08-18,Senate,"Placed on suspense file",7,0,0,0,7
1980216,1600267,2025-08-29,Senate,"Do pass as amended",5,2,0,0,7
1980216,1601758,2025-09-10,Senate,"Assembly 3rd Reading AB1319 Schultz et al. By Limón",25,10,0,5,40
1980217,1562758,2025-04-29,Assembly,"Do pass and be re-referred to the Committee on [Appropriations]",4,3,0,9,16
1980217,1562759,2025-04-29,Assembly,Reconsideration,16,0,0,0,16
1980219,1562948,2025-04-30,Assembly,"Do pass and be re-referred to the Committee on [Appropriations] with recommendation: To Consent Calendar",8,0,0,0,8
1980219,1571584,2025-05-14,Assembly,"Do pass. To Consent Calendar",15,0,0,0,15
1980219,1577237,2025-05-23,Assembly,"AB 1322 Agriculture Consent Calendar Second Day Regular Session",71,0,0,8,79
1980219,1597156,2025-07-01,Senate,"Do pass, but first be re-referred to the Committee on [Appropriations] with the recommendation: To Consent Calendar",5,0,0,0,5
1980219,1600999,2025-09-03,Senate,"Assembly 3rd Reading AB1322 AGRI. (Soria) By Caballero",40,0,0,0,40
1980219,1601115,2025-09-04,Assembly,"AB 1322 Agriculture Concurrence in Senate Amendments By SORIA",78,0,0,1,79
1980221,1562752,2025-04-29,Assembly,"Do pass and be re-referred to the Committee on [Appropriations]",5,2,0,0,7
1980221,1577414,2025-05-23,Assembly,"Do pass",11,2,0,2,15
1980221,1584384,2025-06-03,Assembly,"AB 1324 Sharp-Collins Assembly Third Reading",60,14,0,5,79
1980221,1597729,2025-07-07,Senate,"Do pass, but first be re-referred to the Committee on [Appropriations]",4,1,0,0,5
1980221,1599599,2025-08-18,Senate,"Placed on suspense file",7,0,0,0,7
1980221,1600682,2025-08-29,Senate,"Do pass as amended",5,2,0,0,7
1980221,1601801,2025-09-10,Senate,"Assembly 3rd Reading AB1324 Sharp-Collins et al. By Limón",30,10,0,0,40
1980223,1563053,2025-04-29,Assembly,"Do pass",14,2,0,0,16
1980223,1568604,2025-05-08,Assembly,"AB 1326 Ahrens Assembly Third Reading",58,2,0,19,79
1980223,1592561,2025-06-18,Senate,"Do pass, but first be re-referred to the Committee on [Judiciary]",8,0,0,3,11
1980223,1598604,2025-07-15,Senate,"Do pass as amended",11,0,0,2,13
1980223,1601277,2025-09-08,Senate,"Assembly 3rd Reading AB1326 Ahrens By Becker",28,1,0,11,40
1980223,1601655,2025-09-09,Assembly,"AB 1326 Ahrens Concurrence in Senate Amendments",66,3,0,11,80
1980224,1535041,2025-04-01,Assembly,"Do pass as amended and be re-referred to the Committee on [Judiciary]",14,0,0,1,15
1980224,1554647,2025-04-22,Assembly,"Do pass and be re-referred to the Committee on [Appropriations] with recommendation: To Consent Calendar",12,0,0,0,12
1980224,1562899,2025-04-30,Assembly,"Do pass. To Consent Calendar",14,0,0,1,15
1980224,1568624,2025-05-08,Assembly,"AB 1327 Aguiar-Curry Consent Calendar Second Day Regular Session",69,0,0,10,79
1980224,1597397,2025-07-01,Senate,"Do pass, but first be re-referred to the Committee on [Appropriations] with the recommendation: To Consent Calendar",13,0,0,0,13
1980224,1601946,2025-09-11,Senate,"Assembly 3rd Reading AB1327 Aguiar-Curry By Durazo",40,0,0,0,40
1980224,1602090,2025-09-12,Assembly,"AB 1327 Aguiar-Curry Concurrence in Senate Amendments",80,0,0,0,80
1980225,1555893,2025-04-22,Assembly,"Do pass as amended and be re-referred to the Committee on [Appropriations]",16,0,0,0,16
1980225,1577379,2025-05-23,Assembly,"Do pass as amended",11,0,0,4,15
1980225,1583473,2025-06-02,Assembly,"AB 1328 Michelle Rodriguez Assembly Third Reading",78,0,0,1,79
1980225,1598844,2025-07-16,Senate,"Do pass as amended, but first amend, and re-refer to the Committee on [Appropriations] with the recommendation: To Consent Calendar",10,0,0,1,11
1980225,1599389,2025-08-18,Senate,"Placed on suspense file",7,0,0,0,7
1980226,1555928,2025-04-23,Assembly,"Do pass and be re-referred to the Committee on [Appropriations]",14,0,0,3,17
1980226,1577819,2025-05-23,Assembly,"Do pass",11,0,0,4,15
1980226,1584260,2025-06-03,Assembly,"AB 1329 Ortega Assembly Third Reading",63,1,0,15,79
1980226,1598079,2025-07-09,Senate,"Do pass, but first be re-referred to the Committee on [Appropriations]",4,1,0,0,5
1980226,1599411,2025-08-18,Senate,"Placed on suspense file",7,0,0,0,7
1980226,1600433,2025-08-29,Senate,"Do pass as amended",5,2,0,0,7
1980226,1601273,2025-09-08,Senate,"Assembly 3rd Reading AB1329 Ortega By Caballero",29,10,0,1,40
1980228,1536761,2025-04-02,Assembly,"Do pass and be re-referred to the Committee on [Privacy and Consumer Protection]",5,0,0,2,7
1980228,1555999,2025-04-22,Assembly,"Do pass as amended and be re-referred to the Committee on [Judiciary]",10,3,0,2,15
1980228,1577173,2025-05-23,Assembly,"Do pass as amended",11,3,0,1,15
1980228,1585798,2025-06-05,Assembly,"AB 1331 Elhawary Assembly Third Reading",55,15,0,9,79
1980228,1595150,2025-06-25,Senate,"Do pass, but first be re-referred to the Committee on [Judiciary]",4,1,0,0,5
1980228,1598603,2025-07-15,Senate,"Do pass as amended, but first amend, and re-refer to the Committee on [Appropriations]",9,2,0,2,13
1980228,1599637,2025-08-18,Senate,"Placed on suspense file",7,0,0,0,7
1980228,1600583,2025-08-29,Senate,"Do pass as amended",5,2,0,0,7
1980229,1561017,2025-04-29,Assembly,"Do pass and be re-referred to the Committee on [Appropriations]",17,0,0,1,18
1980229,1575468,2025-05-21,Assembly,"Do pass",14,0,0,1,15
1980229,1582232,2025-05-29,Assembly,"AB 1332 Ahrens Assembly Third Reading",69,0,0,10,79
1980229,1597665,2025-07-07,Senate,"Do pass, but first be re-referred to the Committee on [Local Government]",10,0,0,1,11
1980229,1598760,2025-07-16,Senate,"Do pass as amended, but first amend, and re-refer to the Committee on [Appropriations]",7,0,0,0,7
1980229,1599490,2025-08-18,Senate,"Placed on suspense file",7,0,0,0,7
1980229,1600313,2025-08-29,Senate,"Do pass as amended",7,0,0,0,7
1980229,1601752,2025-09-10,Senate,"Assembly 3rd Reading AB1332 Ahrens By Stern",39,0,0,1,40
1980231,1567900,2025-05-07,Assembly,"Do pass as amended. To Consent Calendar",15,0,0,3,18
1980231,1572397,2025-05-15,Assembly,"AB 1334 Wallis Consent Calendar Second Day Regular Session",66,0,0,13,79
1980232,1564267,2025-05-01,Assembly,"Do pass and be re-referred to the Committee on [Appropriations]",2,1,0,4,7
1980232,1564268,2025-05-01,Assembly,Reconsideration,0,2,0,5,7
1980233,1556036,2025-04-23,Assembly,"Do pass and be re-referred to the Committee on [Appropriations]",12,4,0,1,17
1980233,1577919,2025-05-23,Assembly,"Do pass",11,3,0,1,15
1980233,1584346,2025-06-03,Assembly,"AB 1336 Addis Assembly Third Reading",61,16,0,2,79
1980233,1595229,2025-06-25,Senate,"Do pass, but first be re-referred to the Committee on [Appropriations]",4,1,0,0,5
1980233,1597753,2025-07-07,Senate,"Placed on suspense file",6,0,0,1,7
1980233,1600776,2025-08-29,Senate,"Do pass as amended",5,2,0,0,7
1980233,1601455,2025-09-09,Senate,"Assembly 3rd Reading AB1336 Addis By Durazo",30,10,0,0,40
1980234,1534997,2025-04-01,Assembly,"Do pass as amended and be re-referred to the Committee on [Appropriations]",12,0,0,3,15
1980234,1577471,2025-05-23,Assembly,"Do pass as amended",11,1,0,3,15
1980234,1583382,2025-06-02,Assembly,"AB 1337 Ward Assembly Third Reading",64,0,0,15,79
1980234,1598738,2025-07-15,Senate,"Do pass as amended, but first amend, and re-refer to the Committee on [Appropriations]",6,2,0,5,13
1980234,1598739,2025-07-15,Senate,"[First] hearing set for [07-16-2025]: Failed passage in Committee. Reconsideration granted",13,0,0,0,13
1980235,1542744,2025-04-08,Assembly,"Do pass and be re-referred to the Committee on [Appropriations]",7,0,0,0,7
1980235,1555923,2025-04-23,Assembly,"Do pass",15,0,0,0,15
1980235,1579291,2025-05-27,Assembly,"AB 1338 Solache Assembly Third Reading",74,3,0,2,79
1980236,1562788,2025-04-30,Assembly,"Do pass as amended and be re-referred to the Committee on [Appropriations]",16,0,0,1,17
1980236,1577205,2025-05-23,Assembly,"Do pass",14,0,0,1,15
1980236,1584427,2025-06-03,Assembly,"AB 1339 Mark González Assembly Third Reading",79,0,0,0,79
1980236,1598060,2025-07-09,Senate,"Do pass, but first be re-referred to the Committee on [Appropriations] with the recommendation: To Consent Calendar",7,0,0,0,7
1980236,1599546,2025-08-18,Senate,"Do pass",7,0,0,0,7
1980236,1600912,2025-09-03,Senate,"Assembly 3rd Reading AB1339 Mark González et al. By Smallwood-Cuevas",40,0,0,0,40
1980236,1601095,2025-09-04,Assembly,"AB 1339 Mark González Concurrence in Senate Amendments",78,0,0,1,79
1980237,1557585,2025-04-23,Assembly,"Do pass and be re-referred to the Committee on [Appropriations]",5,0,0,2,7
1980237,1577758,2025-05-23,Assembly,"Do pass as amended",11,3,0,1,15
1980237,1585102,2025-06-04,Assembly,"AB 1340 Wicks Assembly Third Reading",54,15,0,10,79
1980237,1595206,2025-06-25,Senate,"Do pass, but first be re-referred to the Committee on [Transportation]",4,1,0,0,5
1980237,1597827,2025-07-08,Senate,"Do pass, but first be re-referred to the Committee on [Appropriations]",11,4,0,0,15
1980237,1599552,2025-08-18,Senate,"Placed on suspense file",7,0,0,0,7
1980237,1600673,2025-08-29,Senate,"Do pass",5,2,0,0,7
1980237,1600910,2025-09-03,Senate,"That the measure be returned to Senate Floor for consideration. Ordered to third reading",4,1,0,0,5
1980237,1601270,2025-09-08,Senate,"Assembly 3rd Reading AB1340 Wicks et al. By Cortese",29,10,0,1,40
1980237,1601669,2025-09-09,Assembly,"AB 1340 Wicks Concurrence in Senate Amendments",60,15,0,5,80
1980238,1554602,2025-04-22,Assembly,"Do pass as amended and be re-referred to the Committee on [Appropriations]",18,0,0,0,18
1980238,1562936,2025-04-30,Assembly,"Do pass",14,0,0,1,15
1980238,1572379,2025-05-15,Assembly,"AB 1341 Hoover Assembly Third Reading",70,0,0,9,79
1980238,1596779,2025-06-30,Senate,"Do pass as amended, but first amend, and re-refer to the Committee on [Appropriations]",9,0,0,2,11
1980238,1599989,2025-08-25,Senate,"Placed on suspense file",6,0,0,1,7
1980239,1564151,2025-04-30,Assembly,"Do pass and be re-referred to the Committee on [Appropriations] with recommendation: To Consent Calendar",18,0,0,0,18
1980240,1561156,2025-04-28,Assembly,"Do pass and be re-referred to the Committee on [Appropriations] with recommendation: To Consent Calendar",16,0,0,0,16
1980241,1542810,2025-04-08,Assembly,"Do pass and be re-referred to the Committee on [Appropriations]",8,0,0,1,9
1980241,1577178,2025-05-23,Assembly,"Do pass as amended",11,0,0,4,15
1980241,1583552,2025-06-02,Assembly,"AB 1344 Irwin Assembly Third Reading",69,3,0,7,79
1980241,1597866,2025-07-08,Senate,"Do pass, but first be re-referred to the Committee on [Appropriations]",5,0,0,1,6
1980241,1599434,2025-08-18,Senate,"Placed on suspense file",7,0,0,0,7
1980241,1600305,2025-08-29,Senate,"Do pass",5,2,0,0,7
1980241,1601081,2025-09-04,Senate,"Assembly 3rd Reading AB1344 Irwin et al. By Arreguín",32,4,0,4,40
1980241,1601304,2025-09-08,Assembly,"AB 1344 Irwin Concurrence in Senate Amendments",65,5,0,10,80
1980243,1542903,2025-04-08,Assembly,"Do pass and be re-referred to the Committee on [Military and Veterans Affairs]",9,0,0,1,10
1980243,1561151,2025-04-29,Assembly,"Do pass and be re-referred to the Committee on [Appropriations]",8,0,0,0,8
1980243,1563043,2025-04-29,Assembly,"Do pass and be re-referred to the Committee on [Appropriations] with recommendation: To Consent Calendar",8,0,0,0,8
1980243,1571638,2025-05-14,Assembly,"Do pass. To Consent Calendar",15,0,0,0,15
1980243,1577261,2025-05-23,Assembly,"AB 1346 DeMaio Consent Calendar Second Day Regular Session",71,0,0,8,79
1980244,1554532,2025-04-22,Assembly,"Do pass and be re-referred to the Committee on [Utilities and Energy]",7,0,0,1,8
1980245,1564256,2025-04-30,Assembly,"Do pass as amended and be re-referred to the Committee on [Appropriations]",7,2,0,0,9
1980245,1577162,2025-05-23,Assembly,"Do pass",11,3,0,1,15
1980245,1583375,2025-06-02,Assembly,"AB 1348 Bains Assembly Third Reading",62,13,0,4,79
1980245,1595149,2025-06-25,Senate,"Do pass, but first be re-referred to the Committee on [Judiciary]",5,2,0,0,7
1980245,1597953,2025-07-08,Senate,"Do pass, but first be re-referred to the Committee on [Appropriations]",12,0,0,1,13
1980245,1599605,2025-08-18,Senate,"Placed on suspense file",7,0,0,0,7
1980245,1600713,2025-08-29,Senate,"Do pass as amended",5,2,0,0,7
1980245,1601280,2025-09-08,Senate,"Assembly 3rd Reading AB1348 Bains By Pérez",30,8,0,2,40
1980245,1601452,2025-09-09,Assembly,"AB 1348 Bains Concurrence in Senate Amendments",62,15,0,3,80
1980246,1540844,2025-04-08,Assembly,"Do pass as amended and be re-referred to the Committee on [Privacy and Consumer Protection]",7,0,0,2,9
1980246,1556008,2025-04-22,Assembly,"Do pass as amended and be re-referred to the Committee on [Judiciary]",11,1,0,3,15
1980246,1564200,2025-05-01,Assembly,"Do pass as amended and be re-referred to the Committee on [Appropriations]",10,0,0,2,12
1980252,1555986,2025-04-22,Assembly,"Do pass and be re-referred to the Committee on [Judiciary]",9,3,0,3,15
1980252,1561126,2025-04-29,Assembly,"Do pass as amended and be re-referred to the Committee on [Appropriations]",7,3,0,2,12
1980253,1556044,2025-04-22,Assembly,"Do pass as amended and be re-referred to the Committee on [Appropriations]",16,0,0,0,16
1980253,1575471,2025-05-21,Assembly,"Do pass",15,0,0,0,15
1980253,1582225,2025-05-29,Assembly,"AB 1356 Dixon Assembly Third Reading",70,0,0,9,79
1980253,1595680,2025-06-25,Senate,"Do pass, but first be re-referred to the Committee on [Appropriations] with the recommendation: To Consent Calendar",11,0,0,0,11
1980253,1598304,2025-07-14,Senate,"Placed on suspense file",7,0,0,0,7
1980253,1600663,2025-08-29,Senate,"Do pass as amended",7,0,0,0,7
1980253,1601908,2025-09-11,Senate,"Special Consent AB1356 Dixon By Jones",40,0,0,0,40
1980253,1602332,2025-09-13,Assembly,"AB 1356 Dixon Concurrence in Senate Amendments",74,0,0,6,80
1980254,1562963,2025-04-29,Assembly,"Do pass as amended and be re-referred to the Committee on [Appropriations]",5,2,0,0,7
1980254,1577478,2025-05-23,Assembly,"Do pass",12,2,0,1,15
1980254,1583381,2025-06-02,Assembly,"AB 1357 Celeste Rodriguez Assembly Third Reading",63,14,0,2,79
1980254,1597217,2025-06-30,Senate,"Do pass as amended, but first amend, and re-refer to the Committee on [Appropriations]",5,0,0,0,5
1980254,1598299,2025-07-14,Senate,"Placed on suspense file",7,0,0,0,7
1980255,1538984,2025-04-07,Assembly,"Do pass and be re-referred to the Committee on [Appropriations]",9,4,0,1,14
1980258,1542730,2025-04-08,Assembly,"Do pass as amended, and be re-referred to the Committee on [Appropriations] with recommendation: To Consent Calendar",10,0,0,0,10
1980259,1557543,2025-04-23,Assembly,"Do pass and be re-referred to the Committee on [Appropriations]",5,0,0,2,7
1980259,1577913,2025-05-23,Assembly,"Do pass",11,2,0,2,15
1980259,1583484,2025-06-02,Assembly,"AB 1362 Kalra Assembly Third Reading",57,12,0,10,79
1980259,1592555,2025-06-18,Senate,"Do pass, but first be re-referred to the Committee on [Judiciary]",4,1,0,0,5
1980259,1597860,2025-07-08,Senate,"Do pass, but first be re-referred to the Committee on [Appropriations]",11,1,0,1,13
1980259,1599414,2025-08-18,Senate,"Placed on suspense file",7,0,0,0,7
1980259,1600581,2025-08-29,Senate,"Do pass",5,2,0,0,7
1980259,1601800,2025-09-10,Senate,"Assembly 3rd Reading AB1362 Kalra et al. By Laird",30,8,0,2,40
1980260,1554503,2025-04-22,Assembly,"Do pass as amended, and be re-referred to the Committee on [Appropriations] with recommendation: To Consent Calendar",12,0,0,0,12
1980260,1577342,2025-05-23,Assembly,"Do pass as amended",11,0,0,4,15
1980260,1583478,2025-06-02,Assembly,"AB 1363 Stefani Assembly Third Reading",79,0,0,0,79
1980260,1597955,2025-07-08,Senate,"Do pass as amended, but first amend, and re-refer to the Committee on [Public Safety]",13,0,0,0,13
1980260,1598392,2025-07-15,Senate,"Do pass, but first be re-referred to the Committee on [Appropriations] with the recommendation: To Consent Calendar",6,0,0,0,6
1980260,1599618,2025-08-18,Senate,"Placed on suspense file",7,0,0,0,7
1980260,1600636,2025-08-29,Senate,"Do pass as amended",7,0,0,0,7
1980260,1601844,2025-09-11,Senate,"Special Consent AB1363 Stefani et al. By Ashby",40,0,0,0,40
1980260,1602256,2025-09-12,Assembly,"AB 1363 Stefani Concurrence in Senate Amendments",80,0,0,0,80
1980262,1552874,2025-04-21,Assembly,"Do pass and be re-referred to the Committee on [Labor and Employment]",7,2,0,0,9
1980262,1557579,2025-04-23,Assembly,"Do pass as amended and be re-referred to the Committee on [Appropriations]",5,1,0,1,7
1980266,1545019,2025-04-09,Assembly,"Do pass and be re-referred to the Committee on [Judiciary] with recommendation: To Consent Calendar",9,0,0,0,9
1980266,1566687,2025-05-06,Assembly,"Do pass. To Consent Calendar",12,0,0,0,12
1980266,1569836,2025-05-12,Assembly,"AB 1369 Ramos Consent Calendar Second Day Regular Session",77,0,0,2,79
1980266,1592560,2025-06-18,Senate,"Do pass as amended, but first amend, and re-refer to the Committee on [Judiciary]",7,0,0,0,7
1980266,1597523,2025-07-01,Senate,"Do pass",13,0,0,0,13
1980266,1600838,2025-09-02,Senate,"Assembly 3rd Reading AB1369 Ramos By Laird",40,0,0,0,40
1980266,1601183,2025-09-04,Assembly,"AB 1369 Ramos Concurrence in Senate Amendments",77,0,0,2,79
1980267,1542824,2025-04-09,Assembly,"Do pass as amended and be re-referred to the Committee on [Judiciary]",7,0,0,0,7
1980267,1554436,2025-04-22,Assembly,"Do pass and be re-referred to the Committee on [Appropriations] with recommendation: To Consent Calendar",12,0,0,0,12
1980267,1571534,2025-05-14,Assembly,"Do pass. To Consent Calendar",15,0,0,0,15
1980267,1577838,2025-05-23,Assembly,"AB 1370 Patterson Consent Calendar Second Day Regular Session",71,0,0,8,79
1980267,1597474,2025-07-01,Senate,"Do pass, but first be re-referred to the Committee on [Elections and Constitutional Amendments] with the recommendation: To Consent Calendar",13,0,0,0,13
1980267,1598443,2025-07-15,Senate,"Do pass, but first be re-referred to the Committee on [Appropriations] with the recommendation: To Consent Calendar",5,0,0,0,5
1980267,1599534,2025-08-18,Senate,"Placed on suspense file",7,0,0,0,7
1980267,1600605,2025-08-29,Senate,"Do pass",7,0,0,0,7
1980267,1601147,2025-09-04,Senate,"Assembly 3rd Reading AB1370 Patterson et al. By Ochoa Bogh",39,0,0,1,40
1980270,1561085,2025-04-29,Assembly,"Do pass and be re-referred to the Committee on [Appropriations]",7,0,0,0,7
1980270,1577825,2025-05-23,Assembly,"Do pass as amended",11,0,0,4,15
1980270,1584404,2025-06-03,Assembly,"AB 1373 Soria Assembly Third Reading",74,0,0,5,79
1980270,1598627,2025-07-16,Senate,"Do pass, but first be re-referred to the Committee on [Appropriations] with the recommendation: To Consent Calendar",8,0,0,0,8
1980270,1599446,2025-08-18,Senate,"Placed on suspense file",7,0,0,0,7
1980270,1600513,2025-08-29,Senate,"Do pass as amended",7,0,0,0,7
1980270,1601963,2025-09-11,Senate,"Special Consent AB1373 Soria By Caballero",40,0,0,0,40
1980270,1602260,2025-09-12,Assembly,"AB 1373 Soria Concurrence in Senate Amendments",73,0,0,7,80
1980271,1566696,2025-05-06,Assembly,"Do pass as amended",13,0,0,2,15
1980271,1573568,2025-05-19,Assembly,"AB 1374 Berman Assembly Third Reading",71,1,0,7,79
1980271,1595230,2025-06-24,Senate,"Do pass as amended",11,0,0,2,13
1980271,1601101,2025-09-04,Senate,"Assembly 3rd Reading AB1374 Berman et al. By Umberg",29,3,0,8,40
1980271,1601305,2025-09-08,Assembly,"AB 1374 Berman Concurrence in Senate Amendments",70,2,0,8,80
1980272,1561054,2025-04-29,Assembly,"Do pass as amended",11,0,0,1,12
1980272,1577457,2025-05-23,Assembly,"Do pass as amended",11,0,0,4,15
1980272,1584309,2025-06-03,Assembly,"AB 1375 Hoover Assembly Third Reading",79,0,0,0,79
1980272,1598641,2025-07-15,Senate,"Do pass as amended, but first amend, and re-refer to the Committee on [Appropriations] with the recommendation: To Consent Calendar",13,0,0,0,13
1980272,1600022,2025-08-25,Senate,"Consent Calendar 2nd AB1375 Hoover et al",37,0,0,3,40
1980272,1600240,2025-08-28,Assembly,"AB 1375 Hoover Concurrence in Senate Amendments",72,0,0,7,79
1980273,1563126,2025-04-29,Assembly,"Do pass as amended",5,1,0,3,9
1980273,1579303,2025-05-27,Assembly,"AB 1376 Bonta Assembly Third Reading",49,18,0,12,79
1980273,1594677,2025-06-24,Senate,"Do pass, but first be re-referred to the Committee on [Appropriations]",4,1,0,1,6
1980273,1597666,2025-07-07,Senate,"Placed on suspense file",6,0,0,1,7
1980273,1600525,2025-08-29,Senate,"Do pass as amended",5,2,0,0,7
1980273,1602121,2025-09-12,Senate,"Assembly 3rd Reading AB1376 Bonta et al. By Arreguín",24,10,0,6,40
1980273,1602122,2025-09-13,Assembly,"AB 1376 Bonta Concurrence in Senate Amendments",48,21,0,11,80
1980274,1554499,2025-04-22,Assembly,"Do pass and be re-referred to the Committee on [Revenue and Taxation]",7,0,0,2,9
1980274,1566736,2025-05-05,Assembly,"Do pass and be re-referred to the Committee on [Appropriations]",5,1,0,1,7
1980274,1577644,2025-05-23,Assembly,"Do pass",11,0,0,4,15
1980274,1583445,2025-06-02,Assembly,"AB 1377 McKinnor Assembly Third Reading",64,5,0,10,79
1980274,1598102,2025-07-09,Senate,"Do pass, but first be re-referred to the Committee on [Appropriations]",4,0,0,1,5
1980274,1599630,2025-08-18,Senate,"Placed on suspense file",7,0,0,0,7
1980274,1600375,2025-08-29,Senate,"Do pass",5,2,0,0,7
1980275,1540877,2025-04-08,Assembly,"Do pass and be re-referred to the Committee on [Judiciary] with recommendation: To Consent Calendar",6,0,0,0,6
1980275,1554470,2025-04-22,Assembly,"Do pass and be re-referred to the Committee on [Appropriations] with recommendation: To Consent Calendar",12,0,0,0,12
1980275,1577903,2025-05-23,Assembly,"Do pass",14,0,0,1,15
1980275,1583481,2025-06-02,Assembly,"AB 1378 Rogers Assembly Third Reading",79,0,0,0,79
1980275,1597243,2025-06-30,Senate,"Do pass, but first be re-referred to the Committee on [Judiciary] with the recommendation: To Consent Calendar",5,0,0,0,5
1980275,1597821,2025-07-08,Senate,"Do pass, but first be re-referred to the Committee on [Appropriations] with the recommendation: To Consent Calendar",13,0,0,0,13
1980275,1599413,2025-08-18,Senate,"Placed on suspense file",7,0,0,0,7
1980275,1600770,2025-08-29,Senate,"Do pass as amended",7,0,0,0,7
1980275,1601258,2025-09-08,Senate,"Assembly 3rd Reading AB1378 Rogers et al. By Arreguín",39,0,0,1,40
1980277,1558719,2025-04-21,Assembly,"Do pass and be re-referred to the Committee on [Public Safety]",9,4,0,1,14
1980277,1562883,2025-04-29,Assembly,"Do pass and be re-referred to the Committee on [Appropriations]",8,0,0,1,9
1980277,1577691,2025-05-23,Assembly,"Do pass as amended",11,2,0,2,15
1980277,1583571,2025-06-02,Assembly,"AB 1380 Elhawary Assembly Third Reading",76,0,0,3,79
1980277,1594657,2025-06-24,Senate,"Do pass, but first be re-referred to the Committee on [Public Safety]",7,0,0,0,7
1980277,1598523,2025-07-15,Senate,"Do pass, but first be re-referred to the Committee on [Appropriations] with the recommendation: To Consent Calendar",6,0,0,0,6
1980277,1599520,2025-08-18,Senate,"Placed on suspense file",7,0,0,0,7
1980278,1564249,2025-04-30,Assembly,"Do pass as amended, and be re-referred to the Committee on [Appropriations] with recommendation: To Consent Calendar",9,0,0,0,9
1980278,1577555,2025-05-23,Assembly,"Do pass",14,0,0,1,15
1980278,1583529,2025-06-02,Assembly,"AB 1381 Muratsuchi Assembly Third Reading",79,0,0,0,79
1980278,1595227,2025-06-25,Senate,"Do pass, but first be re-referred to the Committee on [Appropriations]",5,1,0,1,7
1980278,1597702,2025-07-07,Senate,"Placed on suspense file",6,0,0,1,7
1980280,1555892,2025-04-23,Assembly,"Do pass and be re-referred to the Committee on [Appropriations]",7,0,0,0,7
1980281,1540935,2025-04-08,Assembly,"Do pass. To Consent Calendar",12,0,0,0,12
1980281,1552920,2025-04-21,Assembly,"AB 1384 Nguyen Consent Calendar Second Day Regular Session",73,0,0,6,79
1980281,1595133,2025-06-24,Senate,"Do pass",10,0,0,3,13
1980281,1600936,2025-09-03,Senate,"Assembly 3rd Reading AB1384 Nguyen et al. By Richardson",40,0,0,0,40
1980281,1601670,2025-09-09,Assembly,"AB 1384 Nguyen Concurrence in Senate Amendments",80,0,0,0,80
1980282,1540830,2025-04-08,Assembly,"Do pass as amended and be re-referred to the Committee on [Appropriations]",10,2,0,0,12
1980282,1577964,2025-05-23,Assembly,"Do pass",11,3,0,1,15
1980282,1583504,2025-06-02,Assembly,"AB 1385 Petrie-Norris Assembly Third Reading",63,10,0,6,79
1980282,1597457,2025-07-01,Senate,"Do pass as amended, but first amend, and re-refer to the Committee on [Housing]",11,1,0,1,13
1980282,1598413,2025-07-15,Senate,"Do pass, but first be re-referred to the Committee on [Appropriations]",8,2,0,1,11
1980282,1599573,2025-08-18,Senate,"Placed on suspense file",7,0,0,0,7
1980283,1562843,2025-04-29,Assembly,"Do pass and be re-referred to the Committee on [Appropriations]",13,1,0,2,16
1980284,1542724,2025-04-08,Assembly,"Do pass and be re-referred to the Committee on [Privacy and Consumer Protection] with recommendation: To Consent Calendar",9,0,0,0,9
1980284,1564202,2025-05-01,Assembly,"Do pass and be re-referred to the Committee on [Appropriations] with recommendation: To Consent Calendar",13,0,0,2,15
1980284,1575474,2025-05-21,Assembly,"Do pass. To Consent Calendar",15,0,0,0,15
1980284,1579296,2025-05-27,Assembly,"AB 1387 Quirk-Silva Consent Calendar Second Day Regular Session",76,0,0,3,79
1980284,1594612,2025-06-24,Senate,"Do pass, but first be re-referred to the Committee on [Judiciary] with the recommendation: To Consent Calendar",6,0,0,0,6
1980284,1597822,2025-07-08,Senate,"Do pass and be ordered to the Consent Calendar",13,0,0,0,13
1980284,1598895,2025-07-17,Senate,"Consent Calendar 2nd AB1387 Quirk-Silva",35,0,0,5,40
1980284,1599486,2025-08-18,Assembly,"AB 1387 Quirk-Silva Concurrence in Senate Amendments",76,0,0,3,79
1980285,1562895,2025-04-29,Assembly,"Do pass and be re-referred to the Committee on [Appropriations]",7,1,0,1,9
1980285,1577432,2025-05-23,Assembly,"Do pass as amended",11,0,0,4,15
1980285,1584344,2025-06-03,Assembly,"AB 1388 Bryan Assembly Third Reading",69,0,0,10,79
1980285,1598457,2025-07-15,Senate,"Do pass, but first be re-referred to the Committee on [Appropriations]",6,0,0,0,6
1980285,1602277,2025-09-12,Senate,"Assembly 3rd Reading AB1388 Bryan By Arreguín",38,0,0,2,40
1980285,1602278,2025-09-13,Assembly,"AB 1388 Bryan Concurrence in Senate Amendments",74,0,0,6,80
1980286,1535077,2025-04-02,Assembly,"Do pass. To Consent Calendar",21,0,0,1,22
1980286,1544988,2025-04-10,Assembly,"AB 1389 Blanca Rubio Consent Calendar Second Day",67,0,0,12,79
1980286,1597845,2025-07-08,Senate,"Do pass and be ordered to the Consent Calendar",15,0,0,0,15
1980287,1529520,2025-03-26,Assembly,"Do pass",7,0,0,2,9
1980287,1579271,2025-05-27,Assembly,"AB 1390 Solache Assembly Third Reading",61,2,0,16,79
1980287,1592588,2025-06-18,Senate,"Do pass, but first be re-referred to the Committee on [Appropriations]",5,0,0,2,7
1980287,1596812,2025-06-30,Senate,"Placed on suspense file",6,0,0,1,7
1980287,1600376,2025-08-29,Senate,"Do pass",5,0,0,2,7
1980287,1601948,2025-09-11,Senate,"Assembly 3rd Reading AB1390 Solache et al. By Allen",32,1,0,7,40
1980287,1601949,2025-09-11,Senate,"Assembly 3rd Reading AB1390 Solache et al. By Allen Reconsider",39,0,0,1,40
1980287,1601950,2025-09-11,Senate,"Assembly 3rd Reading AB1390 Solache et al. By Allen",28,0,0,12,40
1980287,1602317,2025-09-13,Assembly,"AB 1390 Solache Concurrence in Senate Amendments",62,6,0,12,80
1980288,1564274,2025-04-30,Assembly,"Do pass and be re-referred to the Committee on [Appropriations]",8,0,0,1,9
1980289,1536819,2025-04-02,Assembly,"Do pass. To Consent Calendar",7,0,0,0,7
1980289,1544954,2025-04-10,Assembly,"AB 1392 Flora Consent Calendar Second Day Regular Session",67,0,0,12,79
1980289,1589112,2025-06-11,Senate,"Do pass and be ordered to the Consent Calendar",5,0,0,0,5
1980289,1597202,2025-07-01,Senate,"Do pass as amended, but first amend, and re-refer to the Committee on [Judiciary]",5,0,0,0,5
1980289,1598565,2025-07-15,Senate,"Do pass, but first be re-referred to the Committee on [Appropriations]",13,0,0,0,13
1980289,1599523,2025-08-18,Senate,"Placed on suspense file",7,0,0,0,7
1980289,1600369,2025-08-29,Senate,"Do pass as amended",7,0,0,0,7
1980289,1601543,2025-09-09,Senate,"Assembly 3rd Reading AB1392 Sharp-Collins et al. By Grove",40,0,0,0,40
1980289,1602029,2025-09-12,Assembly,"With recommendation: That Senate amendments be concurred in",7,0,0,0,7
1980289,1602135,2025-09-13,Assembly,"AB 1392 Sharp-Collins Concurrence in Senate Amendments",77,0,0,3,80
1980290,1535044,2025-04-02,Assembly,"Do pass. To Consent Calendar",21,0,0,1,22
1980290,1544979,2025-04-10,Assembly,"AB 1393 Blanca Rubio Consent Calendar Second Day Regular Session",67,0,0,12,79
1980290,1597911,2025-07-08,Senate,"Do pass and be ordered to the Consent Calendar",15,0,0,0,15
1980292,1559488,2025-04-28,Assembly,"Do pass and be re-referred to the Committee on [Appropriations] with recommendation: To Consent Calendar",14,0,0,0,14
1980293,1554513,2025-04-22,Assembly,"Do pass as amended and be re-referred to the Committee on [Appropriations]",9,0,0,0,9
1980295,1556040,2025-04-23,Assembly,"Do pass as amended, and be re-referred to the Committee on [Appropriations] with recommendation: To Consent Calendar",17,0,0,0,17
1980295,1577358,2025-05-23,Assembly,"Do pass",14,0,0,1,15
1980295,1584236,2025-06-03,Assembly,"AB 1398 Valencia Assembly Third Reading",79,0,0,0,79
1980295,1598078,2025-07-09,Senate,"Do pass, but first be re-referred to the Committee on [Appropriations] with the recommendation: To Consent Calendar",5,0,0,0,5
1980295,1599382,2025-08-18,Senate,"Placed on suspense file",7,0,0,0,7
1980295,1600512,2025-08-29,Senate,"Do pass",7,0,0,0,7
1980295,1601136,2025-09-04,Senate,"Special Consent AB1398 Valencia",39,0,0,1,40
1980297,1561122,2025-04-29,Assembly,"Do pass and be re-referred to the Committee on [Appropriations]",10,0,0,0,10
1980297,1577466,2025-05-23,Assembly,"Do pass",14,0,0,1,15
1980297,1584378,2025-06-03,Assembly,"AB 1400 Soria Assembly Third Reading",74,0,0,5,79
1980297,1598100,2025-07-09,Senate,"Do pass, but first be re-referred to the Committee on [Appropriations]",7,0,0,0,7
1980297,1600024,2025-08-25,Senate,"Placed on suspense file",6,0,0,1,7
1980297,1600385,2025-08-29,Senate,"Do pass as amended",7,0,0,0,7
1980297,1601641,2025-09-09,Senate,"Assembly 3rd Reading AB1400 Soria et al. By Reyes",39,0,0,1,40
1980297,1602309,2025-09-12,Assembly,"AB 1400 Soria Concurrence in Senate Amendments",74,0,0,6,80
1980298,1545047,2025-04-09,Assembly,"Do pass and be re-referred to the Committee on [Privacy and Consumer Protection]",2,5,0,2,9
1980302,1534994,2025-04-01,Assembly,"Do pass as amended and be re-referred to the Committee on [Appropriations]",11,1,0,3,15
1980302,1577291,2025-05-23,Assembly,"Do pass",11,0,0,4,15
1980302,1583398,2025-06-02,Assembly,"AB 1405 Bauer-Kahan Assembly Third Reading",62,4,0,13,79
1980302,1597412,2025-07-01,Senate,"Do pass, but first be re-referred to the Committee on [Governmental Organization]",11,1,0,1,13
1980302,1597871,2025-07-08,Senate,"Do pass as amended, but first amend, and re-refer to the Committee on [Appropriations]",11,2,0,2,15
1980302,1599621,2025-08-18,Senate,"Placed on suspense file",7,0,0,0,7
1980305,1564287,2025-04-30,Assembly,"Do pass as amended, and be re-referred to the Committee on [Appropriations] with recommendation: To Consent Calendar",18,0,0,0,18
1980305,1577707,2025-05-23,Assembly,"Do pass",14,0,0,1,15
1980305,1583474,2025-06-02,Assembly,"AB 1408 Irwin Assembly Third Reading",79,0,0,0,79
1980305,1598459,2025-07-15,Senate,"Do pass as amended, but first amend, and re-refer to the Committee on [Appropriations]",16,0,0,1,17
1980305,1600984,2025-09-03,Senate,"Assembly 3rd Reading AB1408 Irwin et al. By Padilla",40,0,0,0,40
1980305,1601151,2025-09-04,Assembly,"AB 1408 Irwin Concurrence in Senate Amendments",78,0,0,1,79
1980307,1556160,2025-04-23,Assembly,"Do pass and be re-referred to the Committee on [Appropriations]",18,0,0,0,18
1980307,1575487,2025-05-21,Assembly,"Do pass",15,0,0,0,15
1980307,1579272,2025-05-27,Assembly,"AB 1410 Garcia Assembly Third Reading",76,0,0,3,79
1980307,1597188,2025-07-01,Senate,"Do pass as amended, but first amend, and re-refer to the Committee on [Appropriations]",17,0,0,0,17
1980307,1601665,2025-09-09,Senate,"Assembly 3rd Reading AB1410 Garcia By Rubio",40,0,0,0,40
1980308,1542848,2025-04-09,Assembly,"Do pass and be re-referred to the Committee on [Appropriations]",5,0,0,2,7
1980308,1577631,2025-05-23,Assembly,"Do pass",11,0,0,4,15
1980308,1584400,2025-06-03,Assembly,"AB 1411 Sharp-Collins Assembly Third Reading",62,2,0,15,79
1980308,1598390,2025-07-15,Senate,"Do pass as amended, but first amend, and re-refer to the Committee on [Appropriations]",4,1,0,0,5
1980308,1599615,2025-08-18,Senate,"Placed on suspense file",7,0,0,0,7
1980308,1600435,2025-08-29,Senate,"Do pass",5,2,0,0,7
1980308,1601520,2025-09-09,Senate,"Assembly 3rd Reading AB1411 Sharp-Collins By Umberg",30,10,0,0,40
1980309,1545036,2025-04-09,Assembly,"Do pass as amended and be re-referred to the Committee on [Military and Veterans Affairs]",9,0,0,0,9
1980309,1561007,2025-04-29,Assembly,"Do pass and be re-referred to the Committee on [Appropriations]",8,0,0,0,8
1980309,1571537,2025-05-14,Assembly,"Do pass",15,0,0,0,15
1980309,1577382,2025-05-23,Assembly,"AB 1412 Jeff Gonzalez Assembly Third Reading",70,0,0,9,79
1980309,1592592,2025-06-18,Senate,"Do pass, but first be re-referred to the Committee on [Military and Veterans Affairs] with the recommendation: To Consent Calendar",7,0,0,0,7
1980309,1598213,2025-07-14,Senate,"Do pass, but first be re-referred to the Committee on [Appropriations] with the recommendation: To Consent Calendar",5,0,0,0,5
1980309,1600064,2025-08-25,Senate,"Consent Calendar 2nd AB1412 Jeff Gonzalez et al",37,0,0,3,40
1980310,1540991,2025-04-08,Assembly,"Do pass as amended and be re-referred to the Committee on [Judiciary]",9,4,0,0,13
1980310,1561138,2025-04-29,Assembly,"Do pass and be re-referred to the Committee on [Appropriations]",8,3,0,1,12
1980310,1571614,2025-05-14,Assembly,"Do pass",10,4,0,1,15
1980310,1584347,2025-06-03,Assembly,"AB 1413 Papan Assembly Third Reading",45,21,0,13,79
1980310,1597862,2025-07-08,Senate,"Do pass, but first be re-referred to the Committee on [Judiciary]",4,3,0,0,7
1980310,1598709,2025-07-15,Senate,"Do pass as amended, but first amend, and re-refer to the Committee on [Appropriations]",10,3,0,0,13
1980310,1600004,2025-08-25,Senate,"Placed on suspense file",6,0,0,1,7
1980310,1600286,2025-08-29,Senate,"Do pass as amended",5,2,0,0,7
1980311,1540949,2025-04-08,Assembly,"Do pass",12,0,0,0,12
1980311,1552855,2025-04-21,Assembly,"AB 1414 Ransom Assembly Third Reading",75,0,0,4,79
1980311,1597551,2025-07-01,Senate,"Do pass",13,0,0,0,13
1980311,1601642,2025-09-09,Senate,"Assembly 3rd Reading AB1414 Ransom et al. By Wiener",30,7,0,3,40
1980312,1556079,2025-04-22,Assembly,"Do pass as amended and be re-referred to the Committee on [Appropriations]",11,3,0,2,16
1980312,1567864,2025-05-07,Assembly,"Do pass",11,4,0,0,15
1980312,1572387,2025-05-15,Assembly,"AB 1415 Bonta Assembly Third Reading",42,16,0,21,79
1980312,1595683,2025-06-25,Senate,"Do pass as amended, but first amend, and re-refer to the Committee on [Appropriations]",9,2,0,0,11
1980312,1601163,2025-09-04,Senate,"Assembly 3rd Reading AB1415 Bonta et al. By Menjivar",26,10,0,4,40
1980312,1601306,2025-09-08,Assembly,"AB 1415 Bonta Concurrence in Senate Amendments",51,19,0,10,80
1980313,1566715,2025-05-05,Assembly,"Do pass",7,0,0,0,7
1980313,1569885,2025-05-12,Assembly,"AB 1416 Ta Assembly Third Reading",74,0,0,5,79
1980313,1595162,2025-06-25,Senate,"Do pass as amended, and be ordered to the Consent Calendar",5,0,0,0,5
1980313,1597566,2025-07-03,Senate,"Consent Calendar 2nd AB1416 Ta",35,0,0,5,40
1980313,1597673,2025-07-07,Assembly,"AB 1416 Ta Concurrence in Senate Amendments",74,0,0,5,79
1980314,1558728,2025-04-21,Assembly,"Do pass as amended and be re-referred to the Committee on [Utilities and Energy]",10,4,0,0,14
1980314,1564191,2025-04-30,Assembly,"Do pass as amended and be re-referred to the Committee on [Appropriations]",17,0,0,1,18
1980314,1577412,2025-05-23,Assembly,"Do pass",13,0,0,2,15
1980314,1585057,2025-06-04,Assembly,"AB 1417 Stefani Assembly Third Reading",77,1,0,1,79
1980314,1597114,2025-07-01,Senate,"Do pass, but first be re-referred to the Committee on [Natural Resources and Water]",13,2,0,2,17
1980314,1598767,2025-07-16,Senate,"Do pass, but first be re-referred to the Committee on [Appropriations]",5,2,0,0,7
1980314,1599485,2025-08-18,Senate,"Placed on suspense file",7,0,0,0,7
1980314,1600381,2025-08-29,Senate,"Do pass",5,2,0,0,7
1980314,1601945,2025-09-11,Senate,"Assembly 3rd Reading AB1417 Stefani et al. By Rubio",30,10,0,0,40
1980314,1602103,2025-09-13,Assembly,"AB 1417 Stefani Concurrence in Senate Amendments",78,0,0,2,80
1980315,1540952,2025-04-08,Assembly,"Do pass and be re-referred to the Committee on [Appropriations]",14,0,0,1,15
1980315,1577494,2025-05-23,Assembly,"Do pass as amended",12,0,0,3,15
1980315,1584249,2025-06-03,Assembly,"AB 1418 Schiavo Assembly Third Reading",70,1,0,8,79
1980315,1598101,2025-07-09,Senate,"Do pass, but first be re-referred to the Committee on [Appropriations]",11,0,0,0,11
1980315,1599651,2025-08-18,Senate,"Placed on suspense file",7,0,0,0,7
1980315,1600709,2025-08-29,Senate,"Do pass as amended",7,0,0,0,7
1980315,1601892,2025-09-11,Senate,"Special Consent AB1418 Schiavo By Pérez",40,0,0,0,40
1980315,1602174,2025-09-13,Assembly,"AB 1418 Schiavo Concurrence in Senate Amendments",68,2,0,10,80
1980316,1556170,2025-04-22,Assembly,"Do pass as amended, and be re-referred to the Committee on [Appropriations] with recommendation: To Consent Calendar",16,0,0,0,16
1980316,1577360,2025-05-23,Assembly,"Do pass",14,0,0,1,15
1980316,1584317,2025-06-03,Assembly,"AB 1419 Addis Assembly Third Reading",79,0,0,0,79
1980316,1598882,2025-07-16,Senate,"Do pass, but first be re-referred to the Committee on [Appropriations] with the recommendation: To Consent Calendar",10,0,0,1,11
1980316,1599421,2025-08-18,Senate,"Placed on suspense file",7,0,0,0,7
1980317,1556031,2025-04-23,Assembly,"Do pass and be re-referred to the Committee on [Appropriations]",21,0,0,1,22
1980320,1554438,2025-04-21,Assembly,"Do pass and be re-referred to the Committee on [Utilities and Energy]",14,1,0,1,16
1980320,1564304,2025-04-30,Assembly,"Do pass and be re-referred to the Committee on [Appropriations]",18,0,0,0,18
1980320,1577187,2025-05-23,Assembly,"Do pass",14,0,0,1,15
1980320,1583510,2025-06-02,Assembly,"AB 1423 Irwin Assembly Third Reading",78,0,0,1,79
1980320,1597747,2025-07-07,Senate,"Do pass, but first be re-referred to the Committee on [Transportation]",12,1,0,4,17
1980320,1597865,2025-07-08,Senate,"Do pass as amended, but first amend, and re-refer to the Committee on [Appropriations]",15,0,0,0,15
1980320,1601223,2025-09-08,Senate,"Assembly 3rd Reading AB1423 Irwin By McNerney",39,0,0,1,40
1980321,1542738,2025-04-08,Assembly,"Do pass and be re-referred to the Committee on [Labor and Employment]",6,2,0,1,9
1980321,1557496,2025-04-23,Assembly,"Do pass and be re-referred to the Committee on [Appropriations]",5,1,0,1,7
1980322,1559375,2025-04-28,Assembly,"Do pass and be re-referred to the Committee on [Appropriations]",1,4,0,9,14
1980323,1540893,2025-04-08,Assembly,"Do pass as amended and be re-referred to the Committee on [Natural Resources]",10,2,0,1,13
1980323,1559411,2025-04-28,Assembly,"Do pass and be re-referred to the Committee on [Appropriations]",12,1,0,1,14
1980324,1566689,2025-05-06,Assembly,"Do pass as amended and be re-referred to the Committee on [Appropriations]",11,0,0,1,12
1980324,1577301,2025-05-23,Assembly,"Do pass",12,0,0,3,15
1980324,1584288,2025-06-03,Assembly,"AB 1427 Calderon Assembly Third Reading",76,0,0,3,79
1980326,1563125,2025-04-29,Assembly,"Do pass as amended and be re-referred to the Committee on [Appropriations]",12,1,0,3,16
1980327,1564292,2025-04-30,Assembly,"Do pass and be re-referred to the Committee on [Appropriations]",8,0,0,2,10
1980327,1571619,2025-05-14,Assembly,"Do pass",12,1,0,2,15
1980327,1577158,2025-05-23,Assembly,"AB 1430 Bennett Assembly Third Reading",64,1,0,14,79
1980327,1592611,2025-06-18,Senate,"Do pass, but first be re-referred to the Committee on [Appropriations]",6,0,0,1,7
1980327,1601765,2025-09-10,Senate,"Assembly 3rd Reading AB1430 Bennett By Durazo",35,0,0,5,40
1980330,1542918,2025-04-08,Assembly,"Do pass and be re-referred to the Committee on [Military and Veterans Affairs]",9,0,0,1,10
1980330,1561062,2025-04-29,Assembly,"Do pass and be re-referred to the Committee on [Appropriations]",8,0,0,0,8
1980333,1567921,2025-05-07,Assembly,"Do pass. To Consent Calendar",15,0,0,3,18
1980333,1572378,2025-05-15,Assembly,"AB 1436 Ávila Farías Consent Calendar Second Day Regular Session",69,0,0,10,79
1980335,1529536,2025-03-26,Assembly,"Do pass as amended and be re-referred to the Committee on [Appropriations]",9,0,0,0,9
1980335,1555912,2025-04-23,Assembly,"Do pass",15,0,0,0,15
1980335,1565323,2025-05-05,Assembly,"AB 1438 Gallagher Third Reading Urgency",72,0,0,7,79
1980335,1589116,2025-06-11,Senate,"Do pass, but first be re-referred to the Committee on [Appropriations] with the recommendation: To Consent Calendar",6,0,0,1,7
1980335,1594073,2025-06-23,Senate,"Placed on suspense file",7,0,0,0,7
1980335,1600687,2025-08-29,Senate,"Do pass",7,0,0,0,7
1980335,1601106,2025-09-04,Senate,"Special Consent AB1438 Gallagher By Ochoa Bogh Urgency Clause",39,0,0,1,40
1980337,1528306,2025-03-25,Assembly,"Do pass and be re-referred to the Committee on [Appropriations] with recommendation: To Consent Calendar",7,0,0,0,7
1980337,1577902,2025-05-23,Assembly,"Do pass",14,0,0,1,15
1980337,1583385,2025-06-02,Assembly,"AB 1440 Environmental Safety and Assembly Third Reading By CONNOLLY",79,0,0,0,79
1980337,1597445,2025-07-02,Senate,"Do pass, but first be re-referred to the Committee on [Appropriations] with the recommendation: To Consent Calendar",8,0,0,0,8
1980337,1598269,2025-07-14,Senate,"Placed on suspense file",7,0,0,0,7
1980337,1600478,2025-08-29,Senate,"Do pass",7,0,0,0,7
1980338,1542728,2025-04-09,Assembly,"Do pass as amended and be re-referred to the Committee on [Local Government]",5,2,0,0,7
1980338,1564184,2025-04-30,Assembly,"Do pass and be re-referred to the Committee on [Appropriations]",7,2,0,1,10
1980338,1577454,2025-05-23,Assembly,"Do pass",11,3,0,1,15
1980338,1585059,2025-06-04,Assembly,"AB 1441 Soria Assembly Third Reading",60,19,0,0,79
1980338,1597254,2025-07-01,Senate,"Do pass, but first be re-referred to the Committee on [Local Government]",4,1,0,0,5
1980338,1598668,2025-07-16,Senate,"Do pass, but first be re-referred to the Committee on [Appropriations]",5,2,0,0,7
1980338,1599549,2025-08-18,Senate,"Placed on suspense file",7,0,0,0,7
1980338,1600430,2025-08-29,Senate,"Do pass",5,2,0,0,7
1980338,1601955,2025-09-11,Senate,"Assembly 3rd Reading AB1441 Soria By Caballero",28,10,0,2,40
1980338,1602050,2025-09-13,Assembly,"AB 1441 Soria Concurrence in Senate Amendments",59,19,0,2,80
1980341,1527007,2025-03-25,Assembly,"Do pass",12,0,0,0,12
1980342,1556152,2025-04-23,Assembly,"Do pass as amended and be re-referred to the Committee on [Housing and Community Development]",9,0,0,1,10
1980342,1567906,2025-05-07,Assembly,"Do pass",11,0,0,1,12
1980342,1577729,2025-05-23,Assembly,"AB 1445 Haney Assembly Third Reading",63,0,0,16,79
1980342,1597405,2025-07-02,Senate,"Do pass as amended, but first amend, and re-refer to the Committee on [Housing]",5,0,0,2,7
1980342,1598456,2025-07-15,Senate,"Do pass as amended, but first amend, and re-refer to the Committee on [Appropriations]",8,1,0,2,11
1980342,1599481,2025-08-18,Senate,"Placed on suspense file",7,0,0,0,7
1980342,1600756,2025-08-29,Senate,"Do pass",5,0,0,2,7
1980342,1601783,2025-09-10,Senate,"Assembly 3rd Reading AB1445 Haney et al. By Ashby",28,0,0,12,40
1980344,1540811,2025-04-08,Assembly,"Do pass as amended, and be re-referred to the Committee on [Appropriations] with recommendation: To Consent Calendar",12,0,0,0,12
1980344,1563016,2025-04-30,Assembly,"Do pass. To Consent Calendar",14,0,0,1,15
1980344,1568602,2025-05-08,Assembly,"AB 1447 Gipson Consent Calendar Second Day Regular Session",69,0,0,10,79
1980344,1597443,2025-07-01,Senate,"Do pass, but first be re-referred to the Committee on [Appropriations] with the recommendation: To Consent Calendar",13,0,0,0,13
1980344,1598875,2025-07-17,Senate,"Consent Calendar 2nd AB1447 Gipson",35,0,0,5,40
1980345,1559489,2025-04-28,Assembly,"Do pass as amended and be re-referred to the Committee on [Appropriations]",10,4,0,0,14
1980345,1577215,2025-05-23,Assembly,"Do pass",11,3,0,1,15
1980345,1585105,2025-06-04,Assembly,"AB 1448 Hart Assembly Third Reading",42,26,0,11,79
1980345,1597928,2025-07-08,Senate,"Do pass, but first be re-referred to the Committee on [Governmental Organization]",4,3,0,0,7
1980345,1599597,2025-08-18,Senate,"Placed on suspense file",7,0,0,0,7
1980345,1600621,2025-08-29,Senate,"Do pass as amended",5,2,0,0,7
1980350,1555989,2025-04-22,Assembly,"Do pass as amended and be re-referred to the Committee on [Appropriations]",4,1,0,5,10
1980351,1564260,2025-04-30,Assembly,"Do pass as amended and be re-referred to the Committee on [Appropriations]",9,0,0,0,9
1980351,1577575,2025-05-23,Assembly,"Do pass",14,0,0,1,15
1980351,1585810,2025-06-05,Assembly,"AB 1454 Rivas Assembly Third Reading",78,0,0,1,79
1980351,1598038,2025-07-09,Senate,"Do pass, but first be re-referred to the Committee on [Appropriations] with the recommendation: To Consent Calendar",7,0,0,0,7
1980351,1599454,2025-08-18,Senate,"Placed on suspense file",7,0,0,0,7
1980351,1600548,2025-08-29,Senate,"Do pass as amended",7,0,0,0,7
1980351,1602199,2025-09-12,Senate,"Assembly 3rd Reading AB1454 Rivas et al. By Weber Pierson",38,0,0,2,40
1980351,1602200,2025-09-13,Assembly,"AB 1454 RIVAS Concurrence in Senate Amendments",80,0,0,0,80
1980352,1538916,2025-04-07,Assembly,"Do pass and be re-referred to the Committee on [Appropriations]",12,0,0,2,14
1980352,1577867,2025-05-23,Assembly,"Do pass as amended",13,0,0,2,15
1980352,1584366,2025-06-03,Assembly,"AB 1455 Bryan Assembly Third Reading",72,1,0,6,79
1980352,1597916,2025-07-08,Senate,"Do pass as amended, but first amend, and re-refer to the Committee on [Appropriations]",6,0,0,1,7
1980352,1601552,2025-09-09,Senate,"Assembly 3rd Reading AB1455 Bryan By Becker Urgency Clause",39,0,0,1,40
1980353,1559410,2025-04-28,Assembly,"Do pass and be re-referred to the Committee on [Appropriations] with recommendation: To Consent Calendar",14,0,0,0,14
1980353,1577635,2025-05-23,Assembly,"Do pass",14,0,0,1,15
1980353,1584282,2025-06-03,Assembly,"AB 1456 Bryan Assembly Third Reading",79,0,0,0,79
1980353,1597444,2025-07-02,Senate,"Do pass, but first be re-referred to the Committee on [Natural Resources and Water]",8,0,0,0,8
1980353,1598713,2025-07-16,Senate,"Do pass as amended, but first amend, and re-refer to the Committee on [Appropriations]",7,0,0,0,7
1980353,1599393,2025-08-18,Senate,"Placed on suspense file",7,0,0,0,7
1980354,1538928,2025-04-07,Assembly,"Do pass and be re-referred to the Committee on [Emergency Management] with recommendation: To Consent Calendar",14,0,0,0,14
1980354,1561180,2025-04-28,Assembly,"Do pass and be re-referred to the Committee on [Appropriations] with recommendation: To Consent Calendar",7,0,0,0,7
1980354,1577593,2025-05-23,Assembly,"Do pass as amended",11,0,0,4,15
1980354,1584398,2025-06-03,Assembly,"AB 1457 Bryan Assembly Third Reading",79,0,0,0,79
1980354,1598718,2025-07-16,Senate,"Do pass, but first be re-referred to the Committee on [Appropriations] with the recommendation: To Consent Calendar",7,0,0,0,7
1980354,1600363,2025-08-29,Senate,"Consent Calendar 2nd AB1457 Bryan",37,0,0,3,40
1980356,1528277,2025-03-25,Assembly,"Do pass and be re-referred to the Committee on [Appropriations] with recommendation: To Consent Calendar",7,0,0,0,7
1980356,1542778,2025-04-09,Assembly,"Do pass. To Consent Calendar",14,0,0,1,15
1980356,1557517,2025-04-24,Assembly,"AB 1459 Environmental Safety and Toxic Materials Consent Calendar Second Day Regular Session",75,0,0,4,79
1980356,1592578,2025-06-18,Senate,"Do pass, but first be re-referred to the Committee on [Appropriations] with the recommendation: To Consent Calendar",6,0,0,2,8
1980356,1597562,2025-07-03,Senate,"Consent Calendar 2nd AB1459 E.S. & T.M. (Connolly)",35,0,0,5,40
1980356,1598843,2025-07-17,Assembly,"AB 1459 Environmental Safety and Concurrence in Senate Amendments By CONNOLLY",74,0,0,5,79
1980357,1555924,2025-04-22,Assembly,"Do pass as amended",9,4,0,3,16
1980357,1573562,2025-05-19,Assembly,"AB 1460 Rogers Assembly Third Reading",44,6,0,29,79
1980363,1540809,2025-04-08,Assembly,"Do pass and be re-referred to the Committee on [Judiciary]",9,4,0,0,13
1980363,1554635,2025-04-22,Assembly,"Do pass and be re-referred to the Committee on [Appropriations]",9,3,0,0,12
1980363,1567919,2025-05-07,Assembly,"Do pass",11,4,0,0,15
1980363,1585100,2025-06-04,Assembly,"AB 1466 Hart Assembly Third Reading",50,20,0,9,79
1980363,1597843,2025-07-08,Senate,"Do pass, but first be re-referred to the Committee on [Judiciary]",5,2,0,0,7
1980363,1598580,2025-07-15,Senate,"Do pass as amended, but first amend, and re-refer to the Committee on [Appropriations]",11,2,0,0,13
1980363,1601741,2025-09-10,Senate,"Assembly 3rd Reading AB1466 Hart By Laird",35,5,0,0,40
1980367,1561101,2025-04-29,Assembly,"Do pass as amended and be re-referred to the Committee on [Appropriations]",8,0,0,2,10
1980367,1571644,2025-05-14,Assembly,"Do pass",14,0,0,1,15
1980367,1579260,2025-05-27,Assembly,"AB 1470 Haney Assembly Third Reading",73,0,0,6,79
1980367,1598033,2025-07-09,Senate,"Do pass as amended, but first amend, and re-refer to the Committee on [Environmental Quality] with the recommendation: To Consent Calendar",11,0,0,0,11
1980367,1599559,2025-08-18,Senate,"Placed on suspense file",7,0,0,0,7
1980368,1562747,2025-04-29,Assembly,"Do pass and be re-referred to the Committee on [Appropriations] with recommendation: To Consent Calendar",7,0,0,0,7
1980373,1554620,2025-04-22,Assembly,"Do pass and be re-referred to the Committee on [Appropriations]",6,0,0,1,7
1980373,1577685,2025-05-23,Assembly,"Do pass",14,0,0,1,15
1980373,1583431,2025-06-02,Assembly,"AB 1476 Wallis Assembly Third Reading",79,0,0,0,79
1980373,1597168,2025-06-30,Senate,"Do pass, but first be re-referred to the Committee on [Appropriations] with the recommendation: To Consent Calendar",5,0,0,0,5
1980373,1598297,2025-07-14,Senate,"Placed on suspense file",7,0,0,0,7
1980373,1600516,2025-08-29,Senate,"Do pass as amended",7,0,0,0,7
1980373,1601850,2025-09-11,Senate,"Special Consent AB1476 Wallis et al. By Arreguín",40,0,0,0,40
1980373,1602065,2025-09-12,Assembly,"AB 1476 Wallis Concurrence in Senate Amendments",80,0,0,0,80
1980374,1554569,2025-04-22,Assembly,"Do pass and be re-referred to the Committee on [Appropriations] with recommendation: To Consent Calendar",8,0,0,0,8
1980375,1558708,2025-04-21,Assembly,"Do pass as amended, and be re-referred to the Committee on [Appropriations] with recommendation: To Consent Calendar",14,0,0,0,14
1980375,1567873,2025-05-07,Assembly,"Do pass. To Consent Calendar",15,0,0,0,15
1980375,1572391,2025-05-15,Assembly,"AB 1478 Hoover Consent Calendar Second Day Regular Session",69,0,0,10,79
1980375,1592615,2025-06-18,Senate,"Do pass, but first be re-referred to the Committee on [Appropriations] with the recommendation: To Consent Calendar",6,0,0,2,8
1980375,1597581,2025-07-03,Senate,"Consent Calendar 2nd AB1478 Hoover",35,0,0,5,40
1980375,1598169,2025-07-10,Assembly,"AB 1478 Hoover Concurrence in Senate Amendments",73,0,0,6,79
1980376,1542864,2025-04-09,Assembly,"Do pass. To Consent Calendar",10,0,0,0,10
1980376,1557558,2025-04-24,Assembly,"AB 1479 Tangipa Consent Calendar Second Day Regular Session",75,0,0,4,79
1980376,1597463,2025-07-02,Senate,"Do pass, but first be re-referred to the Committee on [Transportation] with the recommendation: To Consent Calendar",7,0,0,0,7
1980376,1597853,2025-07-08,Senate,"Do pass and be ordered to the Consent Calendar",15,0,0,0,15
1980376,1598893,2025-07-17,Senate,"Consent Calendar 2nd AB1479 Tangipa et al",35,0,0,5,40
1980376,1602127,2025-09-13,Assembly,"AB 1479 Tangipa Concurrence in Senate Amendments",70,1,0,9,80
1980379,1561051,2025-04-29,Assembly,"Do pass as amended and be re-referred to the Committee on [Appropriations]",17,0,0,1,18
1980380,1554509,2025-04-22,Assembly,"Do pass as amended and be re-referred to the Committee on [Appropriations]",6,2,0,1,9
1980382,1566731,2025-05-05,Assembly,"Do pass and be re-referred to the Committee on [Appropriations]",7,0,0,0,7
1980382,1577940,2025-05-23,Assembly,"Do pass",14,0,0,1,15
1980382,1584397,2025-06-03,Assembly,"AB 1485 Macedo Assembly Third Reading",77,0,0,2,79
1980382,1598037,2025-07-09,Senate,"Do pass as amended, but first amend, and re-refer to the Committee on [Appropriations]",5,0,0,0,5
1980382,1599561,2025-08-18,Senate,"Placed on suspense file",7,0,0,0,7
1980382,1600606,2025-08-29,Senate,"Do pass as amended",7,0,0,0,7
1980382,1601987,2025-09-11,Senate,"Special Consent AB1485 Macedo et al. By Rubio",40,0,0,0,40
1980383,1528276,2025-03-26,Assembly,"Do pass as amended and be re-referred to the Committee on [Natural Resources]",8,0,0,0,8
1980383,1558715,2025-04-21,Assembly,"Do pass and be re-referred to the Committee on [Appropriations] with recommendation: To Consent Calendar",14,0,0,0,14
1980384,1556019,2025-04-22,Assembly,"Do pass and be re-referred to the Committee on [Appropriations]",12,3,0,1,16
1980384,1577386,2025-05-23,Assembly,"Do pass",11,3,0,1,15
1980384,1583587,2025-06-02,Assembly,"AB 1487 Addis Assembly Third Reading",59,15,0,5,79
1980384,1597433,2025-07-02,Senate,"Do pass as amended, but first amend, and re-refer to the Committee on [Appropriations]",9,2,0,0,11
1980384,1599410,2025-08-18,Senate,"Placed on suspense file",7,0,0,0,7
1980384,1600269,2025-08-29,Senate,"Do pass",5,2,0,0,7
1980384,1601632,2025-09-09,Senate,"Assembly 3rd Reading AB1487 Addis et al. By Menjivar",30,10,0,0,40
1980386,1563114,2025-04-29,Assembly,"Do pass and be re-referred to the Committee on [Appropriations]",5,1,0,3,9
1980390,1564187,2025-04-30,Assembly,"Do pass as amended and be re-referred to the Committee on [Appropriations]",4,1,0,4,9
1980390,1564188,2025-04-30,Assembly,Reconsideration,9,0,0,0,9
1980392,1562887,2025-04-29,Assembly,"Do pass and be re-referred to the Committee on [Appropriations] with recommendation: To Consent Calendar",16,0,0,0,16
1980392,1577848,2025-05-23,Assembly,"Do pass",14,0,0,1,15
1980392,1584382,2025-06-03,Assembly,"AB 1495 Valencia Assembly Third Reading",79,0,0,0,79
1980392,1598081,2025-07-09,Senate,"Do pass, but first be re-referred to the Committee on [Appropriations] with the recommendation: To Consent Calendar",11,0,0,0,11
1980392,1600028,2025-08-25,Senate,"Consent Calendar 2nd AB1495 Valencia",37,0,0,3,40
1980393,1540850,2025-04-08,Assembly,"Do pass and be re-referred to the Committee on [Appropriations] with recommendation: To Consent Calendar",17,0,0,1,18
1980393,1556066,2025-04-23,Assembly,"Do pass. To Consent Calendar",15,0,0,0,15
1980393,1564164,2025-05-01,Assembly,"AB 1496 Blanca Rubio Consent Calendar Second Day Regular Session",76,0,0,3,79
1980397,1540974,2025-04-08,Assembly,"Do pass and be re-referred to the Committee on [Appropriations]",12,1,0,2,15
1980399,1525444,2025-03-24,Assembly,"Be adopted. To Consent Calendar",11,0,0,0,11
1980399,1530397,2025-03-28,Assembly,"ACR 39 Ramos Consent Calendar Second Day",62,0,0,18,80
1980399,1557531,2025-04-24,Senate,"Special Consent ACR39 Ramos et al",37,0,0,3,40
1980399,1568593,2025-05-08,Assembly,"ACR 39 Ramos Concurrence in Senate Amendments",73,0,0,6,79
1980400,1521951,2025-03-18,Assembly,"Be adopted. To third reading",6,1,0,3,10
1980400,1595165,2025-06-25,Senate,"Be adopted. Ordered to third reading",7,0,0,0,7
1980401,1511418,2025-03-10,Assembly,"Be adopted. To third reading",9,0,0,2,11
1980402,1554605,2025-04-22,Senate,"Do pass, but first be re-referred to the Committee on [Appropriations]",5,1,0,0,6
1980402,1565291,2025-05-05,Senate,"Placed on suspense file",7,0,0,0,7
1980402,1577872,2025-05-23,Senate,"Do pass as amended",5,1,0,1,7
1980402,1584319,2025-06-03,Senate,"Senate 3rd Reading SB672 Rubio et al",24,11,0,5,40
1980403,1556098,2025-04-22,Senate,"Do pass, but first be re-referred to the Committee on [Appropriations] with the recommendation: To Consent Calendar",13,0,0,0,13
1980403,1568606,2025-05-08,Senate,"Consent Calendar 2nd SB673 Ochoa Bogh et al",36,0,0,4,40
1980403,1591906,2025-06-17,Assembly,"Do pass and be re-referred to the Committee on [Appropriations] with recommendation: To Consent Calendar",11,0,0,1,12
1980403,1597516,2025-07-02,Assembly,"Do pass. To Consent Calendar",14,0,0,1,15
1980403,1598166,2025-07-10,Assembly,"SB 673 Ochoa Bogh Consent Calendar Second Day Regular Session",72,0,0,7,79
1980404,1556096,2025-04-23,Senate,"Do pass, but first be re-referred to the Committee on [Appropriations]",8,0,0,0,8
1980404,1565363,2025-05-05,Senate,"Placed on suspense file",7,0,0,0,7
1980404,1577314,2025-05-23,Senate,"Do pass",6,0,0,1,7
1980404,1580542,2025-05-28,Senate,"Senate 3rd Reading SB674 Cabaldon et al",38,0,0,2,40
1980404,1597738,2025-07-07,Assembly,"Do pass and be re-referred to the Committee on [Appropriations]",13,0,0,1,14
1980405,1556138,2025-04-23,Senate,"Do pass, but first be re-referred to the Committee on [Rules]",8,0,0,0,8
1980405,1562913,2025-04-30,Senate,"Do pass as amended, but first amend, and re-refer to the Committee on [Appropriations]",7,0,0,0,7
1980405,1573550,2025-05-19,Senate,"Placed on suspense file",5,0,0,2,7
1980405,1577922,2025-05-23,Senate,"Do pass as amended",5,0,0,2,7
1980405,1585083,2025-06-04,Senate,"Senate 3rd Reading SB675 Padilla",39,0,0,1,40
1980406,1536777,2025-04-02,Senate,"Do pass, but first be re-referred to the Committee on [Rules]",8,0,0,0,8
1980406,1556145,2025-04-22,Senate,"Do pass, but first be re-referred to the Committee on [Appropriations] with the recommendation: To Consent Calendar",13,0,0,0,13
1980406,1565257,2025-05-05,Senate,"Placed on suspense file",7,0,0,0,7
1980406,1577192,2025-05-23,Senate,"Do pass",6,0,0,1,7
1980406,1584405,2025-06-03,Senate,"Senate 3rd Reading SB676 Limón et al",39,0,0,1,40
1980406,1597726,2025-07-07,Assembly,"Do pass as amended and be re-referred to the Committee on [Judiciary]",12,0,0,2,14
1980406,1598427,2025-07-15,Assembly,"Do pass and be re-referred to the Committee on [Appropriations]",12,0,0,0,12
1980406,1600541,2025-08-29,Assembly,"Do pass as amended",11,0,0,4,15
1980406,1601393,2025-09-08,Assembly,"SB 676 Limón Senate Third Reading By Bennett",79,0,0,1,80
1980406,1601565,2025-09-09,Senate,"Unfinished Business SB676 Limón et al. Concurrence",40,0,0,0,40
1980407,1556139,2025-04-22,Senate,"Do pass, but first be re-referred to the Committee on [Local Government]",4,3,0,4,11
1980407,1556140,2025-04-22,Senate,"[First] hearing set for [04-23-2025]: Failed passage in Committee. Reconsideration granted",11,0,0,0,11
1980408,1555899,2025-04-22,Senate,"Do pass, but first be re-referred to the Committee on [Appropriations] with the recommendation: To Consent Calendar",13,0,0,0,13
1980408,1565360,2025-05-05,Senate,"Placed on suspense file",7,0,0,0,7
1980409,1552959,2025-04-21,Senate,"Do pass as amended, but first amend, and re-refer to the Committee on [Judiciary]",8,0,0,3,11
1980409,1563015,2025-04-29,Senate,"Do pass, but first be re-referred to the Committee on [Appropriations]",12,0,0,1,13
1980409,1569841,2025-05-12,Senate,"Placed on suspense file",7,0,0,0,7
1980410,1540855,2025-04-08,Senate,"Do pass, but first be re-referred to the Committee on [Appropriations]",4,1,0,1,6
1980410,1552840,2025-04-21,Senate,"Placed on suspense file",6,0,0,1,7
1980410,1577436,2025-05-23,Senate,"Do pass as amended",6,0,0,1,7
1980410,1585097,2025-06-04,Senate,"Senate 3rd Reading SB680 Rubio",37,1,0,2,40
1980410,1598669,2025-07-15,Assembly,"Do pass and be re-referred to the Committee on [Appropriations]",9,0,0,0,9
1980410,1600610,2025-08-29,Assembly,"Do pass",15,0,0,0,15
1980410,1601156,2025-09-04,Assembly,"SB 680 Rubio Senate Third Reading By Krell",72,0,0,7,79
1980411,1556055,2025-04-22,Senate,"Do pass, but first be re-referred to the Committee on [Rules]",8,2,0,1,11
1980411,1562911,2025-04-29,Senate,"Do pass, but first be re-referred to the Committee on [Appropriations]",11,2,0,0,13
1980411,1573549,2025-05-19,Senate,"Placed on suspense file",5,0,0,2,7
1980411,1577834,2025-05-23,Senate,"Do pass as amended",5,1,0,1,7
1980411,1585070,2025-06-04,Senate,"Senate 3rd Reading SB681 Wahab et al",28,10,0,2,40
1980412,1536817,2025-04-02,Senate,"Do pass as amended, but first amend, and re-refer to the Committee on [Health]",5,3,0,0,8
1980412,1564297,2025-04-30,Senate,"Do pass as amended, but first amend, and re-refer to the Committee on [Appropriations]",7,2,0,2,11
1980412,1573569,2025-05-19,Senate,"Placed on suspense file",5,0,0,2,7
1980412,1577670,2025-05-23,Senate,"Do pass as amended",5,1,0,1,7
1980412,1584299,2025-06-03,Senate,"Senate 3rd Reading SB682 Allen",28,7,0,5,40
1980412,1598613,2025-07-15,Assembly,"Do pass as amended and be re-referred to the Committee on [Appropriations]",5,2,0,0,7
1980412,1600602,2025-08-29,Assembly,"Do pass as amended",9,3,0,3,15
1980412,1602044,2025-09-12,Senate,"Unfinished Business SB682 Allen Concurrence",30,5,0,5,40
1980412,1602045,2025-09-12,Assembly,"SB 682 Allen Senate Third Reading By Connolly",45,21,0,14,80
1980413,1542758,2025-04-08,Senate,"Do pass as amended, but first amend, and re-refer to the Committee on [Appropriations]",13,0,0,0,13
1980413,1559379,2025-04-28,Senate,"Placed on suspense file",7,0,0,0,7
1980413,1577579,2025-05-23,Senate,"Do pass",6,0,0,1,7
1980413,1580491,2025-05-28,Senate,"Senate 3rd Reading SB683 Cortese",38,0,0,2,40
1980413,1591844,2025-06-17,Assembly,"Do pass as amended and be re-referred to the Committee on [Privacy and Consumer Protection]",11,0,0,1,12
1980413,1594625,2025-06-24,Assembly,"Do pass and be re-referred to the Committee on [Appropriations]",14,0,0,1,15
1980413,1597527,2025-07-02,Assembly,"Do pass",14,0,0,1,15
1980413,1601988,2025-09-11,Senate,"Unfinished Business SB683 Cortese Concurrence",39,0,0,1,40
1980414,1536802,2025-04-02,Senate,"Do pass, but first be re-referred to the Committee on [Judiciary]",5,3,0,0,8
1980415,1542779,2025-04-09,Senate,"Do pass as amended, but first amend, and re-refer to the Committee on [Appropriations]",6,0,0,1,7
1980415,1559395,2025-04-28,Senate,"Placed on suspense file",7,0,0,0,7
1980415,1577397,2025-05-23,Senate,"Do pass",6,0,0,1,7
1980415,1580492,2025-05-28,Senate,"Senate 3rd Reading SB685 Cortese",36,0,0,4,40
1980415,1594601,2025-06-24,Assembly,"Do pass as amended and be re-referred to the Committee on [Education]",8,0,0,2,10
1980416,1533511,2025-04-01,Senate,"Do pass, but first be re-referred to the Committee on [Appropriations] with the recommendation: To Consent Calendar",11,0,0,0,11
1980416,1552884,2025-04-21,Senate,"Placed on suspense file",6,0,0,1,7
1980416,1577270,2025-05-23,Senate,"Do pass",6,0,0,1,7
1980416,1581776,2025-05-29,Senate,"Special Consent SB686 Reyes et al",38,0,0,2,40
1980416,1598675,2025-07-16,Assembly,"Do pass and be re-referred to the Committee on [Appropriations] with recommendation: To Consent Calendar",12,0,0,0,12
1980416,1599770,2025-08-20,Assembly,"Do pass. To Consent Calendar",15,0,0,0,15
1980416,1600216,2025-08-28,Assembly,"SB 686 Reyes Consent Calendar Second Day Regular Session",74,0,0,5,79
1980416,1601940,2025-09-11,Senate,"Special Consent SB686 Reyes et al",40,0,0,0,40
1980418,1526994,2025-03-25,Senate,"Do pass, but first be re-referred to the Committee on [Appropriations]",13,0,0,2,15
1980418,1538898,2025-04-07,Senate,"Placed on suspense file",7,0,0,0,7
1980420,1562868,2025-04-29,Senate,"Do pass, but first be re-referred to the Committee on [Appropriations]",6,0,0,0,6
1980420,1573538,2025-05-19,Senate,"Placed on suspense file",5,0,0,2,7
1980420,1577634,2025-05-23,Senate,"Do pass as amended",6,0,0,1,7
1980420,1584256,2025-06-03,Senate,"Senate 3rd Reading SB690 Caballero et al",35,0,0,5,40
1980420,1597189,2025-07-01,Assembly,"Do pass and be re-referred to the Committee on [Privacy and Consumer Protection]",9,0,0,0,9
1980421,1562879,2025-04-29,Senate,"Do pass, but first be re-referred to the Committee on [Appropriations]",6,0,0,0,6
1980421,1569822,2025-05-12,Senate,"Placed on suspense file",7,0,0,0,7
1980422,1554573,2025-04-22,Senate,"Do pass, but first be re-referred to the Committee on [Housing]",6,0,0,0,6
1980422,1565272,2025-05-05,Senate,"Placed on suspense file",7,0,0,0,7
1980422,1577951,2025-05-23,Senate,"Do pass as amended",6,0,0,1,7
1980422,1584429,2025-06-03,Senate,"Senate 3rd Reading SB692 Arreguín et al",38,0,0,2,40
1980422,1597222,2025-07-01,Assembly,"Do pass as amended and be re-referred to the Committee on [Transportation]",9,0,0,0,9
1980422,1598388,2025-07-14,Assembly,"Do pass as amended and be re-referred to the Committee on [Appropriations]",16,0,0,0,16
1980423,1563090,2025-04-30,Senate,"Do pass, but first be re-referred to the Committee on [Appropriations] with the recommendation: To Consent Calendar",5,0,0,0,5
1980423,1572458,2025-05-15,Senate,"Consent Calendar 2nd SB693 Cortese",34,0,0,6,40
1980423,1595673,2025-06-25,Assembly,"Do pass and be re-referred to the Committee on [Appropriations] with recommendation: To Consent Calendar",7,0,0,0,7
1980423,1598051,2025-07-09,Assembly,"Do pass. To Consent Calendar",15,0,0,0,15
1980423,1598891,2025-07-17,Assembly,"SB 693 Cortese Consent Calendar Second Day Regular Session",75,0,0,4,79
1980424,1559406,2025-04-28,Senate,"Do pass, but first be re-referred to the Committee on [Appropriations] with the recommendation: To Consent Calendar",4,0,0,1,5
1980424,1577856,2025-05-23,Senate,"Consent Calendar 2nd SB694 Archuleta",36,0,0,4,40
1980424,1597255,2025-07-01,Assembly,"Do pass and be re-referred to the Committee on [Judiciary]",6,0,0,2,8
1980424,1597870,2025-07-08,Assembly,"Do pass and be re-referred to the Committee on [Appropriations]",11,0,0,1,12
1980424,1600504,2025-08-29,Assembly,"Do pass",14,0,0,1,15
1980424,1601153,2025-09-04,Assembly,"SB 694 Archuleta Senate Third Reading By Schiavo",68,0,0,11,79
1980424,1601645,2025-09-09,Senate,"Be re-referred to the Committee on [Rules]",12,0,0,1,13
1980425,1561066,2025-04-28,Senate,"Do pass, but first be re-referred to the Committee on [Appropriations] with the recommendation: To Consent Calendar",15,0,0,0,15
1980425,1569864,2025-05-12,Senate,"Placed on suspense file",7,0,0,0,7
1980425,1577272,2025-05-23,Senate,"Do pass",6,0,0,1,7
1980425,1581761,2025-05-29,Senate,"Special Consent SB695 Cortese et al",38,0,0,2,40
1980425,1597691,2025-07-07,Assembly,"Do pass and be re-referred to the Committee on [Appropriations] with recommendation: To Consent Calendar",16,0,0,0,16
1980425,1600349,2025-08-29,Assembly,"Do pass",15,0,0,0,15
1980425,1601127,2025-09-04,Assembly,"SB 695 Cortese Senate Third Reading By Soria",78,0,0,1,79
1980426,1571624,2025-05-14,Senate,"Do pass, but first be re-referred to the Committee on [Appropriations]",5,0,0,0,5
1980426,1573616,2025-05-19,Senate,"Placed on suspense file",5,0,0,2,7
1980427,1527006,2025-03-25,Senate,"Do pass, but first be re-referred to the Committee on [Judiciary]",5,0,0,2,7
1980427,1555886,2025-04-22,Senate,"Do pass, but first be re-referred to the Committee on [Appropriations]",11,0,0,2,13
1980427,1580553,2025-05-28,Senate,"Senate 3rd Reading SB697 Laird",29,1,0,10,40
1980427,1597117,2025-07-01,Assembly,"Do pass as amended and be re-referred to the Committee on [Judiciary]",11,0,0,2,13
1980427,1597906,2025-07-08,Assembly,"Do pass and be re-referred to the Committee on [Appropriations]",11,0,0,1,12
1980427,1599778,2025-08-20,Assembly,"Do pass",13,0,0,2,15
1980427,1600753,2025-08-29,Assembly,"SB 697 Laird Senate Third Reading By Papan",66,0,0,13,79
1980427,1600836,2025-09-02,Senate,"Unfinished Business SB697 Laird Concurrence",36,0,0,4,40
1980428,1538867,2025-04-07,Senate,"Do pass as amended, but first amend, and re-refer to the Committee on [Appropriations]",13,3,0,1,17
1980428,1559392,2025-04-28,Senate,"Placed on suspense file",7,0,0,0,7
1980431,1540834,2025-04-08,Senate,"Do pass as amended, but first amend, and re-refer to the Committee on [Appropriations]",6,0,0,0,6
1980431,1559497,2025-04-28,Senate,"Placed on suspense file",7,0,0,0,7
1980431,1577950,2025-05-23,Senate,"Do pass",6,0,0,1,7
1980431,1585006,2025-06-04,Senate,"Senate 3rd Reading SB701 Wahab et al",38,0,0,2,40
1980431,1597230,2025-07-01,Assembly,"Do pass as amended and be re-referred to the Committee on [Appropriations]",9,0,0,0,9
1980431,1600538,2025-08-29,Assembly,"Do pass",15,0,0,0,15
1980431,1601395,2025-09-08,Assembly,"SB 701 Wahab Senate Third Reading By Alanis",75,0,0,5,80
1980431,1601557,2025-09-09,Senate,"Unfinished Business SB701 Wahab et al. Concurrence",40,0,0,0,40
1980432,1527005,2025-03-25,Senate,"Do pass as amended, but first amend, and re-refer to the Committee on [Judiciary]",13,0,0,2,15
1980432,1556011,2025-04-22,Senate,"Do pass, but first be re-referred to the Committee on [Appropriations]",13,0,0,0,13
1980432,1565320,2025-05-05,Senate,"Placed on suspense file",7,0,0,0,7
1980432,1577679,2025-05-23,Senate,"Do pass",6,0,0,1,7
1980432,1586369,2025-06-02,Senate,"Senate 3rd Reading SB702 Limón et al",38,0,0,2,40
1980432,1595215,2025-06-25,Assembly,"Do pass and be re-referred to the Committee on [Judiciary]",22,0,0,0,22
1980432,1597158,2025-07-01,Assembly,"Do pass and be re-referred to the Committee on [Appropriations] with recommendation: To Consent Calendar",12,0,0,0,12
1980432,1600508,2025-08-29,Assembly,"Do pass as amended",11,0,0,4,15
1980432,1601548,2025-09-09,Assembly,"SB 702 Limón Senate Third Reading By Blanca Rubio",79,0,0,1,80
1980432,1601724,2025-09-10,Senate,"Unfinished Business SB702 Limón et al. Concurrence",40,0,0,0,40
1980433,1542854,2025-04-08,Senate,"Do pass, but first be re-referred to the Committee on [Labor, Public Employment and Retirement ]",11,3,0,1,15
1980433,1563054,2025-04-30,Senate,"Do pass as amended, but first amend, and re-refer to the Committee on [Appropriations]",4,1,0,0,5
1980433,1569931,2025-05-12,Senate,"Placed on suspense file",7,0,0,0,7
1980433,1577441,2025-05-23,Senate,"Do pass",5,1,0,1,7
1980433,1586399,2025-06-02,Senate,"Senate 3rd Reading SB703 Richardson",28,10,0,2,40
1980433,1595675,2025-06-25,Assembly,"Do pass and be re-referred to the Committee on [Transportation]",7,0,0,0,7
1980433,1598519,2025-07-14,Assembly,"Do pass as amended and be re-referred to the Committee on [Appropriations]",14,1,0,1,16
1980433,1600529,2025-08-29,Assembly,"Do pass as amended",11,3,0,1,15
1980433,1602206,2025-09-12,Senate,"Unfinished Business SB703 Richardson Concurrence",29,8,0,3,40
1980433,1602207,2025-09-12,Assembly,"SB 703 Richardson Senate Third Reading By Bryan",66,10,0,4,80
1980434,1563111,2025-04-29,Senate,"Do pass, but first be re-referred to the Committee on [Appropriations]",5,1,0,0,6
1980434,1569746,2025-05-12,Senate,"Placed on suspense file",7,0,0,0,7
1980434,1577861,2025-05-23,Senate,"Do pass as amended",5,1,0,1,7
1980434,1585119,2025-06-04,Senate,"Senate 3rd Reading SB704 Arreguín",28,11,0,1,40
1980434,1598631,2025-07-15,Assembly,"Do pass as amended and be re-referred to the Committee on [Appropriations]",7,2,0,0,9
1980434,1600599,2025-08-29,Assembly,"Do pass as amended",11,4,0,0,15
1980434,1601396,2025-09-08,Assembly,"SB 704 Arreguín Senate Third Reading By Stefani",57,20,0,3,80
1980434,1601640,2025-09-09,Senate,"Unfinished Business SB704 Arreguín et al. Concurrence",29,10,0,1,40
1980436,1555905,2025-04-22,Senate,"Do pass, but first be re-referred to the Committee on [Banking and Financial Institutions]",1,2,0,10,13
1980436,1555906,2025-04-22,Senate,"[First] hearing set for [04-22-2025]: Failed passage in Committee. Reconsideration granted",13,0,0,0,13
1980437,1536808,2025-04-02,Senate,"Do pass as amended, but first amend, and re-refer to the Committee on [Judiciary]",5,0,0,2,7
1980437,1555891,2025-04-22,Senate,"Do pass, but first be re-referred to the Committee on [Appropriations]",9,0,0,4,13
1980437,1584418,2025-06-03,Senate,"Senate 3rd Reading SB707 Durazo et al",24,6,0,10,40
1980437,1598846,2025-07-16,Assembly,"Do pass as amended and be re-referred to the Committee on [Appropriations]",6,2,0,2,10
1980437,1600353,2025-08-29,Assembly,"Do pass as amended",11,4,0,0,15
1980437,1602290,2025-09-12,Senate,"Unfinished Business SB707 Durazo et al. Concurrence",27,6,0,7,40
1980437,1602291,2025-09-13,Assembly,"SB 707 Durazo Senate Third Reading By Blanca Rubio",53,16,0,11,80
1980439,1567909,2025-05-06,Senate,"Do pass as amended",11,0,0,2,13
1980439,1584419,2025-06-03,Senate,"Senate 3rd Reading SB709 Menjivar et al",30,6,0,4,40
1980439,1594659,2025-06-24,Assembly,"Do pass",9,3,0,0,12
1980439,1601919,2025-09-11,Senate,"Unfinished Business SB709 Menjivar et al. Concurrence",31,6,0,3,40
1980440,1571635,2025-05-14,Senate,"Do pass, but first be re-referred to the Committee on [Appropriations]",5,0,0,0,5
1980440,1573509,2025-05-19,Senate,"Placed on suspense file",5,0,0,2,7
1980440,1577697,2025-05-23,Senate,"Do pass as amended",6,0,0,1,7
1980440,1585050,2025-06-04,Senate,"Special Consent SB710 Blakespear et al",39,0,0,1,40
1980440,1598470,2025-07-14,Assembly,"Do pass as amended and be re-referred to the Committee on [Appropriations]",4,0,0,3,7
1980440,1600566,2025-08-29,Assembly,"Do pass as amended",10,0,0,5,15
1980440,1601633,2025-09-09,Assembly,"SB 710 Blakespear Senate Third Reading By Berman",77,0,0,3,80
1980440,1601888,2025-09-11,Senate,"Unfinished Business SB710 Blakespear et al. Concurrence",40,0,0,0,40
1980441,1555944,2025-04-23,Senate,"Do pass as amended, but first amend, and re-refer to the Committee on [Appropriations]",4,0,0,1,5
1980441,1569914,2025-05-12,Senate,"Placed on suspense file",7,0,0,0,7
1980441,1577171,2025-05-23,Senate,"Do pass",6,0,0,1,7
1980441,1580552,2025-05-28,Senate,"Senate 3rd Reading SB711 McNerney Urgency Clause",38,0,0,2,40
1980441,1598416,2025-07-14,Assembly,"Do pass and be re-referred to the Committee on [Appropriations]",4,1,0,2,7
1980441,1600311,2025-08-29,Assembly,"Do pass as amended",11,1,0,3,15
1980441,1601559,2025-09-09,Assembly,"SB 711 McNerney Third Reading Urgency By McKinnor",58,1,0,21,80
1980441,1601991,2025-09-11,Senate,"Unfinished Business SB711 McNerney Urgency Clause Concurrence",40,0,0,0,40
1980442,1542898,2025-04-08,Senate,"Do pass, but first be re-referred to the Committee on [Appropriations]",12,2,0,1,15
1980442,1559412,2025-04-28,Senate,"Placed on suspense file",7,0,0,0,7
1980442,1577265,2025-05-23,Senate,"Do pass as amended",5,1,0,1,7
1980442,1585051,2025-06-04,Senate,"Senate 3rd Reading SB712 Grove et al",32,3,0,5,40
1980442,1598372,2025-07-14,Assembly,"Do pass as amended and be re-referred to the Committee on [Appropriations]",14,0,0,2,16
1980443,1552921,2025-04-21,Senate,"Do pass, but first be re-referred to the Committee on [Rules]",11,0,0,0,11
1980443,1561027,2025-04-28,Senate,"Do pass, but first be re-referred to the Committee on [Appropriations]",15,0,0,0,15
1980443,1569763,2025-05-12,Senate,"Placed on suspense file",7,0,0,0,7
1980445,1562999,2025-04-29,Senate,"Do pass as amended, but first amend, and re-refer to the Committee on [Appropriations]",9,1,0,1,11
1980445,1580519,2025-05-28,Senate,"Senate 3rd Reading SB715 Allen et al",27,8,0,5,40
1980446,1563044,2025-04-29,Senate,"Do pass as amended, but first amend, and re-refer to the Committee on [Appropriations]",13,3,0,1,17
1980446,1573496,2025-05-19,Senate,"Placed on suspense file",5,0,0,2,7
1980446,1577472,2025-05-23,Senate,"Do pass as amended",5,1,0,1,7
1980446,1585107,2025-06-04,Senate,"Senate 3rd Reading SB716 Durazo",29,8,0,3,40
1980446,1598596,2025-07-16,Assembly,"Do pass as amended and be re-referred to the Committee on [Appropriations]",7,1,0,1,9
1980446,1600429,2025-08-29,Assembly,"Do pass",11,4,0,0,15
1980447,1528280,2025-03-26,Senate,"Do pass, but first be re-referred to the Committee on [Appropriations] with the recommendation: To Consent Calendar",10,0,0,1,11
1980447,1552961,2025-04-21,Senate,"Placed on suspense file",6,0,0,1,7
1980447,1577599,2025-05-23,Senate,"Do pass",6,0,0,1,7
1980447,1581799,2025-05-29,Senate,"Special Consent SB717 Richardson",38,0,0,2,40
1980447,1594639,2025-06-24,Assembly,"Do pass and be re-referred to the Committee on [Appropriations]",15,0,0,1,16
1980447,1598732,2025-07-16,Assembly,"Do pass",13,0,0,2,15
1980447,1601553,2025-09-09,Assembly,"SB 717 Richardson Senate Third Reading By Aguiar-Curry",80,0,0,0,80
1980447,1601876,2025-09-11,Senate,"Unfinished Business SB717 Richardson Concurrence",39,0,0,1,40
1980448,1554601,2025-04-22,Senate,"Do pass as amended, but first amend, and re-refer to the Committee on [Appropriations] with the recommendation: To Consent Calendar",6,0,0,1,7
1980448,1569888,2025-05-12,Senate,"Placed on suspense file",7,0,0,0,7
1980448,1577900,2025-05-23,Senate,"Do pass as amended",6,0,0,1,7
1980448,1585030,2025-06-04,Senate,"Special Consent SB718 Dahle et al",39,0,0,1,40
1980448,1598466,2025-07-15,Assembly,"Do pass as amended and be re-referred to the Committee on [Appropriations]",12,0,0,1,13
1980450,1542743,2025-04-08,Senate,"Do pass, but first be re-referred to the Committee on [Judiciary]",12,0,0,3,15
1980450,1562986,2025-04-29,Senate,"Do pass as amended, but first amend, and re-refer to the Committee on [Appropriations]",13,0,0,0,13
1980450,1573541,2025-05-19,Senate,"Placed on suspense file",5,0,0,2,7
1980450,1577852,2025-05-23,Senate,"Do pass",4,2,0,1,7
1980450,1584350,2025-06-03,Senate,"Senate 3rd Reading SB720 Ashby",31,3,0,6,40
1980450,1598493,2025-07-14,Assembly,"Do pass and be re-referred to the Committee on [Privacy and Consumer Protection]",15,0,0,1,16
1980450,1598546,2025-07-16,Assembly,"Do pass as amended and be re-referred to the Committee on [Appropriations]",13,2,0,0,15
1980450,1600312,2025-08-29,Assembly,"Do pass as amended",12,3,0,0,15
1980450,1602294,2025-09-12,Senate,"Unfinished Business SB720 Ashby et al. Concurrence",33,3,0,4,40
1980450,1602295,2025-09-12,Assembly,"SB 720 Ashby Senate Third Reading By Pellerin",68,8,0,4,80
1980452,1563029,2025-04-29,Senate,"Do pass, but first be re-referred to the Committee on [Appropriations]",3,3,0,7,13
1980452,1563030,2025-04-29,Senate,"[First] hearing set for [04-30-2025]: Failed passage in Committee. Reconsideration granted",13,0,0,0,13
1980453,1571543,2025-05-14,Senate,"Do pass, but first be re-referred to the Committee on [Appropriations]",5,0,0,0,5
1980453,1573535,2025-05-19,Senate,"Placed on suspense file",5,0,0,2,7
1980453,1577300,2025-05-23,Senate,"Do pass",6,0,0,1,7
1980453,1581764,2025-05-29,Senate,"Special Consent SB723 Choi et al",38,0,0,2,40
1980454,1562785,2025-04-30,Senate,"Do pass as amended, but first amend, and re-refer to the Committee on [Appropriations] with the recommendation: To Consent Calendar",8,0,0,0,8
1980454,1573643,2025-05-19,Senate,"Placed on suspense file",5,0,0,2,7
1980454,1577163,2025-05-23,Senate,"Do pass",6,0,0,1,7
1980454,1581723,2025-05-29,Senate,"Special Consent SB724 Richardson",38,0,0,2,40
1980454,1591849,2025-06-17,Assembly,"Do pass and be re-referred to the Committee on [Housing and Community Development] with recommendation: To Consent Calendar",7,0,0,0,7
1980454,1598701,2025-07-16,Assembly,"Do pass and be re-referred to the Committee on [Appropriations] with recommendation: To Consent Calendar",12,0,0,0,12
1980457,1554583,2025-04-22,Senate,"Do pass, but first be re-referred to the Committee on [Appropriations] with the recommendation: To Consent Calendar",6,0,0,1,7
1980457,1569908,2025-05-12,Senate,"Placed on suspense file",7,0,0,0,7
1980457,1577736,2025-05-23,Senate,"Do pass as amended",6,0,0,1,7
1980457,1585054,2025-06-04,Senate,"Special Consent SB727 McGuire",39,0,0,1,40
1980457,1597695,2025-07-07,Assembly,"Do pass and be re-referred to the Committee on [Natural Resources] with recommendation: To Consent Calendar",16,0,0,0,16
1980457,1600449,2025-08-29,Assembly,"Do pass",15,0,0,0,15
1980457,1602076,2025-09-13,Assembly,"SB 727 McGuire Senate Third Reading By Rogers",80,0,0,0,80
1980458,1538981,2025-04-07,Senate,"Do pass, but first be re-referred to the Committee on [Judiciary]",5,0,0,2,7
1980458,1556192,2025-04-22,Senate,"Do pass as amended, but first amend, and re-refer to the Committee on [Appropriations]",12,0,0,1,13
1980458,1565237,2025-05-05,Senate,"Placed on suspense file",7,0,0,0,7
1980459,1540915,2025-04-08,Senate,"Do pass, but first be re-referred to the Committee on [Appropriations] with the recommendation: To Consent Calendar",15,0,0,0,15
1980459,1552839,2025-04-21,Senate,"Placed on suspense file",6,0,0,1,7
1980461,1526951,2025-03-25,Senate,"Do pass, but first be re-referred to the Committee on [Appropriations]",14,0,0,1,15
1980461,1581778,2025-05-29,Senate,"Senate 3rd Reading SB731 Archuleta",38,0,0,2,40
1980461,1598507,2025-07-14,Assembly,"Do pass and be re-referred to the Committee on [Appropriations] with recommendation: To Consent Calendar",16,0,0,0,16
1980461,1599743,2025-08-20,Assembly,"Do pass. To Consent Calendar",15,0,0,0,15
1980461,1600188,2025-08-28,Assembly,"SB 731 Archuleta Consent Calendar Second Day Regular Session",74,0,0,5,79
1980461,1600881,2025-09-03,Senate,"Unfinished Business SB731 Archuleta Concurrence",40,0,0,0,40
1980463,1533488,2025-04-01,Senate,"Do pass, but first be re-referred to the Committee on [Appropriations] with the recommendation: To Consent Calendar",11,0,0,0,11
1980463,1557541,2025-04-24,Senate,"Consent Calendar 2nd SB733 Wahab",37,0,0,3,40
1980463,1598646,2025-07-15,Assembly,"Do pass. To Consent Calendar",9,0,0,0,9
1980463,1599840,2025-08-21,Assembly,"SB 733 Wahab Consent Calendar Second Day Regular Session",77,0,0,2,79
1980463,1601754,2025-09-10,Assembly,"Do pass",15,0,0,0,15
1980463,1602283,2025-09-12,Senate,"Unfinished Business SB733 Wahab et al. Concurrence",34,0,0,6,40
1980463,1602284,2025-09-13,Assembly,"SB 733 Wahab Senate Third Reading By Schultz",79,0,0,1,80
1980464,1533557,2025-04-01,Senate,"Do pass as amended, but first amend, and re-refer to the Committee on [Appropriations]",6,0,0,0,6
1980464,1580515,2025-05-28,Senate,"Senate 3rd Reading SB734 Caballero",38,0,0,2,40
1980464,1580516,2025-05-28,Senate,"Senate 3rd Reading SB734 Caballero Reconsider",38,0,0,2,40
1980464,1580517,2025-05-28,Senate,"Senate 3rd Reading SB734 Caballero",36,0,0,4,40
1980464,1591898,2025-06-17,Assembly,"Do pass and be re-referred to the Committee on [Appropriations]",9,0,0,0,9
1980464,1597539,2025-07-02,Assembly,"Do pass",14,0,0,1,15
1980464,1601397,2025-09-08,Assembly,"SB 734 Caballero Senate Third Reading By Irwin",76,0,0,4,80
1980464,1601567,2025-09-09,Senate,"Unfinished Business SB734 Caballero Concurrence",40,0,0,0,40
1980465,1536798,2025-04-02,Senate,"Do pass and be ordered to the Consent Calendar",7,0,0,0,7
1980465,1545008,2025-04-10,Senate,"Consent Calendar 2nd SB735 L. GOV. (Durazo) Urgency Clause",35,0,0,5,40
1980465,1592579,2025-06-18,Assembly,"Do pass. To Consent Calendar",10,0,0,0,10
1980465,1595967,2025-06-27,Assembly,"SB 735 L.Gov. Consent Calendar Second Day Regular Session",75,0,0,4,79
1980466,1536849,2025-04-02,Senate,"Do pass and be ordered to the Consent Calendar",7,0,0,0,7
1980466,1544940,2025-04-10,Senate,"Consent Calendar 2nd SB736 L. GOV. (Durazo) Urgency Clause",35,0,0,5,40
1980466,1592574,2025-06-18,Assembly,"Do pass. To Consent Calendar",10,0,0,0,10
1980466,1596035,2025-06-27,Assembly,"SB 736 L.Gov. Consent Calendar Second Day Regular Session",75,0,0,4,79
1980467,1536839,2025-04-02,Senate,"Do pass and be ordered to the Consent Calendar",7,0,0,0,7
1980467,1545023,2025-04-10,Senate,"Consent Calendar 2nd SB737 L. GOV. (Durazo)",35,0,0,5,40
1980467,1592566,2025-06-18,Assembly,"Do pass. To Consent Calendar",10,0,0,0,10
1980467,1595988,2025-06-27,Assembly,"SB 737 L.Gov. Consent Calendar Second Day Regular Session",75,0,0,4,79
1980468,1562801,2025-04-29,Senate,"Do pass as amended, but first amend, and re-refer to the Committee on [Appropriations] with the recommendation: To Consent Calendar",13,0,0,0,13
1980468,1569829,2025-05-12,Senate,"Placed on suspense file",7,0,0,0,7
1980469,1540832,2025-04-07,Senate,"Do pass, but first be re-referred to the Committee on [Appropriations] with the recommendation: To Consent Calendar",5,0,0,0,5
1980469,1552880,2025-04-21,Senate,"Placed on suspense file",6,0,0,1,7
1980469,1577734,2025-05-23,Senate,"Do pass",6,0,0,1,7
1980469,1581731,2025-05-29,Senate,"Special Consent SB739 Arreguín",38,0,0,2,40
1980469,1597130,2025-07-01,Assembly,"Do pass and be re-referred to the Committee on [Appropriations]",7,0,0,0,7
1980469,1598688,2025-07-16,Assembly,"Do pass",13,0,0,2,15
1980470,1536789,2025-04-02,Senate,"Do pass, but first be re-referred to the Committee on [Environmental Quality] with the recommendation: To Consent Calendar",7,0,0,0,7
1980471,1554454,2025-04-22,Senate,"Do pass, but first be re-referred to the Committee on [Appropriations]",6,0,0,1,7
1980471,1579244,2025-05-27,Senate,"Senate 3rd Reading SB741 Blakespear",39,0,0,1,40
1980473,1542761,2025-04-09,Senate,"Do pass, but first be re-referred to the Committee on [Appropriations]",4,0,0,3,7
1980473,1552826,2025-04-21,Senate,"Placed on suspense file",6,0,0,1,7
1980473,1577963,2025-05-23,Senate,"Do pass",5,0,0,2,7
1980473,1584223,2025-06-03,Senate,"Senate 3rd Reading SB743 Cortese",30,2,0,8,40
1980473,1598589,2025-07-16,Assembly,"Do pass and be re-referred to the Committee on [Appropriations]",7,0,0,2,9
1980474,1542721,2025-04-09,Senate,"Do pass, but first be re-referred to the Committee on [Appropriations]",7,0,0,0,7
1980474,1552869,2025-04-21,Senate,"Placed on suspense file",6,0,0,1,7
1980474,1577855,2025-05-23,Senate,"Do pass",6,0,0,1,7
1980474,1581692,2025-05-29,Senate,"Special Consent SB744 Cabaldon",38,0,0,2,40
1980474,1597815,2025-07-08,Assembly,"Do pass and be re-referred to the Committee on [Appropriations]",7,3,0,0,10
1980474,1600424,2025-08-29,Assembly,"Do pass",11,4,0,0,15
1980474,1602131,2025-09-12,Senate,"Unfinished Business SB744 Cabaldon Concurrence",30,5,0,5,40
1980474,1602132,2025-09-12,Assembly,"SB 744 Cabaldon Senate Third Reading By Bryan",60,18,0,2,80
1980475,1562877,2025-04-30,Senate,"Do pass as amended, but first amend, and re-refer to the Committee on [Appropriations]",7,0,0,0,7
1980475,1573504,2025-05-19,Senate,"Placed on suspense file",5,0,0,2,7
1980475,1577233,2025-05-23,Senate,"Do pass",6,0,0,1,7
1980475,1581682,2025-05-29,Senate,"Special Consent SB745 Ochoa Bogh et al",38,0,0,2,40
1980475,1597536,2025-07-02,Assembly,"Do pass as amended and be re-referred to the Committee on [Appropriations]",8,0,0,1,9
1980476,1554508,2025-04-22,Senate,"Do pass, but first be re-referred to the Committee on [Appropriations]",6,0,0,1,7
1980476,1565334,2025-05-05,Senate,"Placed on suspense file",7,0,0,0,7
1980477,1555926,2025-04-23,Senate,"Do pass, but first be re-referred to the Committee on [Judiciary]",4,0,0,1,5
1980477,1562909,2025-04-29,Senate,"Do pass as amended, but first amend, and re-refer to the Committee on [Appropriations]",9,2,0,2,13
1980477,1573491,2025-05-19,Senate,"Placed on suspense file",5,0,0,2,7
1980477,1577305,2025-05-23,Senate,"Do pass",5,1,0,1,7
1980478,1540928,2025-04-07,Senate,"Do pass as amended, but first amend, and re-refer to the Committee on [Housing]",5,0,0,0,5
1980478,1563027,2025-04-29,Senate,"Do pass as amended, but first amend, and re-refer to the Committee on [Appropriations]",11,0,0,0,11
1980478,1580501,2025-05-28,Senate,"Senate 3rd Reading SB748 Richardson",38,0,0,2,40
1980478,1592601,2025-06-18,Assembly,"Do pass as amended and be re-referred to the Committee on [Human Services]",11,0,0,1,12
1980478,1598401,2025-07-15,Assembly,"Do pass as amended and be re-referred to the Committee on [Appropriations]",7,0,0,0,7
1980478,1600459,2025-08-29,Assembly,"Do pass as amended",11,0,0,4,15
1980478,1601398,2025-09-08,Assembly,"SB 748 Richardson Senate Third Reading By Jackson",76,1,0,3,80
1980478,1601788,2025-09-10,Senate,"Unfinished Business SB748 Richardson et al. Concurrence",39,0,0,1,40
1980479,1556090,2025-04-22,Senate,"Do pass, but first be re-referred to the Committee on [Judiciary]",8,2,0,1,11
1980479,1563113,2025-04-29,Senate,"Do pass, but first be re-referred to the Committee on [Appropriations]",11,2,0,0,13
1980479,1569825,2025-05-12,Senate,"Placed on suspense file",7,0,0,0,7
1980479,1577906,2025-05-23,Senate,"Do pass",5,1,0,1,7
1980479,1586408,2025-06-02,Senate,"Senate 3rd Reading SB749 Allen et al",27,10,0,3,40
1980479,1597486,2025-07-02,Assembly,"Do pass and be re-referred to the Committee on [Judiciary]",7,4,0,1,12
1980479,1597834,2025-07-08,Assembly,"Do pass and be re-referred to the Committee on [Appropriations]",9,2,0,1,12
1980480,1556084,2025-04-22,Senate,"Do pass, but first be re-referred to the Committee on [Judiciary]",11,0,0,0,11
1980480,1562944,2025-04-29,Senate,"Do pass as amended, but first amend, and re-refer to the Committee on [Appropriations] with the recommendation: To Consent Calendar",13,0,0,0,13
1980480,1573614,2025-05-19,Senate,"Placed on suspense file",5,0,0,2,7
1980480,1577680,2025-05-23,Senate,"Do pass as amended",6,0,0,1,7
1980480,1580485,2025-05-28,Senate,"Senate 3rd Reading SB750 Cortese et al",38,0,0,2,40
1980480,1597479,2025-07-02,Assembly,"Do pass as amended and be re-referred to the Committee on [Judiciary]",8,0,0,4,12
1980480,1598376,2025-07-15,Assembly,"Do pass as amended and be re-referred to the Committee on [Appropriations]",11,0,0,1,12
1980481,1557601,2025-04-23,Senate,"Do pass as amended, but first amend, and re-refer to the Committee on [Education]",7,0,0,4,11
1980481,1562829,2025-04-30,Senate,"Do pass, but first be re-referred to the Committee on [Appropriations]",6,0,0,1,7
1980481,1569777,2025-05-12,Senate,"Placed on suspense file",7,0,0,0,7
1980482,1571558,2025-05-14,Senate,"Do pass, but first be re-referred to the Committee on [Appropriations]",5,0,0,0,5
1980482,1573489,2025-05-19,Senate,"Placed on suspense file",5,0,0,2,7
1980483,1567912,2025-05-07,Senate,"Do pass",6,0,0,1,7
1980483,1579241,2025-05-27,Senate,"Senate 3rd Reading SB753 Cortese",39,0,0,1,40
1980483,1598858,2025-07-16,Assembly,"Do pass as amended",6,0,0,4,10
1980483,1602183,2025-09-12,Senate,"Unfinished Business SB753 Cortese Concurrence",37,0,0,3,40
1980484,1562950,2025-04-30,Senate,"Do pass as amended, but first amend, and re-refer to the Committee on [Appropriations]",8,0,0,0,8
1980484,1573518,2025-05-19,Senate,"Placed on suspense file",5,0,0,2,7
1980484,1577714,2025-05-23,Senate,"Do pass",6,0,0,1,7
1980484,1579305,2025-05-27,Senate,"Senate 3rd Reading SB754 Durazo",39,0,0,1,40
1980484,1597233,2025-07-01,Assembly,"Do pass and be re-referred to the Committee on [Appropriations]",5,0,0,2,7
1980484,1600499,2025-08-29,Assembly,"Do pass as amended",11,0,0,4,15
1980484,1601500,2025-09-09,Assembly,"SB 754 Durazo Senate Third Reading By Papan",71,0,0,9,80
1980484,1601723,2025-09-10,Senate,"Unfinished Business SB754 Durazo Concurrence",40,0,0,0,40
1980485,1562795,2025-04-30,Senate,"Do pass as amended, but first amend, and re-refer to the Committee on [Appropriations]",5,2,0,1,8
1980485,1573517,2025-05-19,Senate,"Placed on suspense file",5,0,0,2,7
1980486,1559382,2025-04-28,Senate,"Do pass, but first be re-referred to the Committee on [Appropriations]",10,0,0,1,11
1980486,1569750,2025-05-12,Senate,"Placed on suspense file",7,0,0,0,7
1980486,1577408,2025-05-23,Senate,"Do pass as amended",6,0,0,1,7
1980486,1585088,2025-06-04,Senate,"Senate 3rd Reading SB756 Smallwood-Cuevas",38,0,0,2,40
1980486,1597881,2025-07-08,Assembly,"Do pass and be re-referred to the Committee on [Appropriations]",8,0,0,1,9
1980486,1600671,2025-08-29,Assembly,"Do pass as amended",11,0,0,4,15
1980486,1602285,2025-09-12,Senate,"Unfinished Business SB756 Smallwood-Cuevas Concurrence",37,0,0,3,40
1980486,1602286,2025-09-12,Assembly,"SB 756 Smallwood-Cuevas Senate Third Reading By McKinnor",78,1,0,1,80
1980487,1536787,2025-04-02,Senate,"Do pass as amended, but first amend, and re-refer to the Committee on [Judiciary]",7,0,0,0,7
1980487,1567908,2025-05-06,Senate,"Do pass as amended",12,0,0,1,13
1980487,1579273,2025-05-27,Senate,"Senate 3rd Reading SB757 Richardson",39,0,0,1,40
1980487,1592558,2025-06-18,Assembly,"Do pass as amended and be re-referred to the Committee on [Judiciary]",9,0,0,1,10
1980487,1597144,2025-07-01,Assembly,"Do pass as amended",12,0,0,0,12
1980487,1598313,2025-07-14,Assembly,"SB 757 Richardson Senate Third Reading By Dixon",71,0,0,8,79
1980487,1600995,2025-09-03,Senate,"Unfinished Business SB757 Richardson Concurrence",40,0,0,0,40
1980489,1554565,2025-04-22,Senate,"Do pass, but first be re-referred to the Committee on [Appropriations]",6,0,0,0,6
1980489,1565290,2025-05-05,Senate,"Placed on suspense file",7,0,0,0,7
1980489,1577221,2025-05-23,Senate,"Do pass as amended",5,0,0,2,7
1980489,1585129,2025-06-04,Senate,"Senate 3rd Reading SB759 Archuleta",39,0,0,1,40
1980489,1597227,2025-07-01,Assembly,"Do pass and be re-referred to the Committee on [Appropriations]",9,0,0,0,9
1980490,1561031,2025-04-29,Senate,"Do pass",5,0,0,0,5
1980490,1579256,2025-05-27,Senate,"Senate 3rd Reading SB760 Allen",39,0,0,1,40
1980490,1598593,2025-07-16,Assembly,"Do pass as amended",7,0,0,0,7
1980490,1602119,2025-09-12,Senate,"Unfinished Business SB760 Allen et al. Concurrence",37,0,0,3,40
1980490,1602120,2025-09-12,Assembly,"SB 760 Allen Senate Third Reading By Solache",77,0,0,3,80
1980491,1542796,2025-04-09,Senate,"Do pass as amended, but first amend, and re-refer to the Committee on [Human Services]",7,0,0,0,7
1980491,1552823,2025-04-21,Senate,"Do pass, but first be re-referred to the Committee on [Appropriations] with the recommendation: To Consent Calendar",5,0,0,0,5
1980491,1565307,2025-05-05,Senate,"Placed on suspense file",7,0,0,0,7
1980491,1577269,2025-05-23,Senate,"Do pass as amended",6,0,0,1,7
1980491,1585027,2025-06-04,Senate,"Special Consent SB761 Ashby",39,0,0,1,40
1980491,1597826,2025-07-08,Assembly,"Do pass as amended and be re-referred to the Committee on [Human Services]",10,0,0,0,10
1980491,1598438,2025-07-15,Assembly,"Do pass as amended and be re-referred to the Committee on [Appropriations]",6,0,0,1,7
1980491,1600315,2025-08-29,Assembly,"Do pass",15,0,0,0,15
1980491,1602350,2025-09-12,Senate,"Unfinished Business SB761 Ashby et al. Concurrence",38,0,0,2,40
1980493,1542699,2025-04-08,Senate,"Do pass, but first be re-referred to the Committee on [Public Safety]",11,2,0,0,13
1980493,1563092,2025-04-29,Senate,"Do pass, but first be re-referred to the Committee on [Appropriations]",5,1,0,0,6
1980493,1569840,2025-05-12,Senate,"Placed on suspense file",7,0,0,0,7
1980493,1577577,2025-05-23,Senate,"Do pass as amended",5,1,0,1,7
1980493,1585052,2025-06-04,Senate,"Senate 3rd Reading SB763 Hurtado",29,10,0,1,40
1980493,1597200,2025-07-01,Assembly,"Do pass and be re-referred to the Committee on [Public Safety]",8,3,0,1,12
1980493,1598721,2025-07-15,Assembly,"Do pass and be re-referred to the Committee on [Appropriations]",7,2,0,0,9
1980493,1600357,2025-08-29,Assembly,"Do pass as amended",10,4,0,1,15
1980493,1602305,2025-09-12,Senate,"Unfinished Business SB763 Hurtado Concurrence",29,8,0,3,40
1980493,1602306,2025-09-12,Assembly,"SB 763 Hurtado Senate Third Reading By Kalra",53,20,0,7,80
1980494,1545015,2025-04-09,Senate,"Do pass, but first be re-referred to the Committee on [Appropriations] with the recommendation: To Consent Calendar",11,0,0,0,11
1980494,1559457,2025-04-28,Senate,"Placed on suspense file",7,0,0,0,7
1980494,1577811,2025-05-23,Senate,"Do pass",6,0,0,1,7
1980494,1581722,2025-05-29,Senate,"Special Consent SB764 Weber Pierson",38,0,0,2,40
1980494,1598030,2025-07-08,Assembly,"Do pass and be re-referred to the Committee on [Appropriations] with recommendation: To Consent Calendar",16,0,0,0,16
1980494,1599749,2025-08-20,Assembly,"Do pass. To Consent Calendar",15,0,0,0,15
1980494,1600245,2025-08-28,Assembly,"SB 764 Weber Pierson Consent Calendar Second Day Regular Session",74,0,0,5,79
1980494,1600903,2025-09-03,Senate,"Unfinished Business SB764 Weber Pierson et al. Concurrence",40,0,0,0,40
1980495,1540862,2025-04-08,Senate,"Do pass",15,0,0,0,15
1980495,1579264,2025-05-27,Senate,"Senate 3rd Reading SB765 Niello",39,0,0,1,40
1980495,1597184,2025-07-01,Assembly,"Do pass. To Consent Calendar",12,0,0,1,13
1980495,1597733,2025-07-07,Assembly,"SB 765 Niello Consent Calendar Second Day Regular Session",75,0,0,4,79
1980495,1600828,2025-09-02,Senate,"Unfinished Business SB765 Niello Concurrence",40,0,0,0,40
1980496,1542787,2025-04-08,Senate,"Do pass as amended, but first amend, and re-refer to the Committee on [Judiciary]",9,3,0,3,15
1980496,1562922,2025-04-29,Senate,"Do pass as amended, but first amend, and re-refer to the Committee on [Appropriations]",11,0,0,2,13
1980496,1573563,2025-05-19,Senate,"Placed on suspense file",5,0,0,2,7
1980496,1577547,2025-05-23,Senate,"Do pass as amended",5,1,0,1,7
1980496,1586403,2025-06-02,Senate,"Senate 3rd Reading SB766 Allen",27,9,0,4,40
1980496,1597204,2025-07-01,Assembly,"Do pass and be re-referred to the Committee on [Privacy and Consumer Protection]",9,1,0,2,12
1980496,1598734,2025-07-16,Assembly,"Do pass as amended",11,0,0,4,15
1980496,1601918,2025-09-11,Senate,"Unfinished Business SB766 Allen et al. Concurrence",30,8,0,2,40
1980497,1554498,2025-04-21,Senate,"Do pass, but first be re-referred to the Committee on [Natural Resources and Water]",15,0,0,2,17
1980497,1569851,2025-05-12,Senate,"Placed on suspense file",7,0,0,0,7
1980497,1577936,2025-05-23,Senate,"Do pass",6,0,0,1,7
1980497,1586363,2025-06-02,Senate,"Senate 3rd Reading SB767 Richardson et al",37,0,0,3,40
1980497,1598135,2025-07-09,Assembly,"Do pass and be re-referred to the Committee on [Natural Resources] with recommendation: To Consent Calendar",18,0,0,0,18
1980497,1598251,2025-07-14,Assembly,"Do pass as amended, and be re-referred to the Committee on [Appropriations] with recommendation: To Consent Calendar",13,0,0,1,14
1980497,1600654,2025-08-29,Assembly,"Do pass as amended",11,0,0,4,15
1980497,1602066,2025-09-12,Senate,"Unfinished Business SB767 Richardson et al. Concurrence",36,0,0,4,40
1980497,1602067,2025-09-12,Assembly,"SB 767 Richardson Senate Third Reading By Petrie-Norris",80,0,0,0,80
1980498,1555925,2025-04-22,Senate,"Do pass, but first be re-referred to the Committee on [Appropriations] with the recommendation: To Consent Calendar",13,0,0,0,13
1980498,1565254,2025-05-05,Senate,"Placed on suspense file",7,0,0,0,7
1980499,1552918,2025-04-21,Senate,"Do pass, but first be re-referred to the Committee on [Judiciary]",10,0,0,1,11
1980499,1562816,2025-04-29,Senate,"Do pass as amended, but first amend, and re-refer to the Committee on [Appropriations]",13,0,0,0,13
1980499,1573635,2025-05-19,Senate,"Placed on suspense file",5,0,0,2,7
1980499,1577474,2025-05-23,Senate,"Do pass",6,0,0,1,7
1980499,1580525,2025-05-28,Senate,"Senate 3rd Reading SB769 Caballero",35,2,0,3,40
1980499,1597162,2025-07-01,Assembly,"Do pass and be re-referred to the Committee on [Economic Development, Growth, and Household Impact]",10,0,0,2,12
1980499,1597829,2025-07-08,Assembly,"Do pass and be re-referred to the Committee on [Appropriations]",6,0,0,2,8
1980499,1600736,2025-08-29,Assembly,"Do pass",11,1,0,3,15
1980500,1556133,2025-04-22,Senate,"Do pass, but first be re-referred to the Committee on [Judiciary]",8,2,0,1,11
1980500,1567856,2025-05-06,Senate,"Do pass",11,1,0,1,13
1980500,1580532,2025-05-28,Senate,"Senate 3rd Reading SB770 Allen",28,10,0,2,40
1980500,1594606,2025-06-24,Assembly,"Do pass and be re-referred to the Committee on [Insurance]",9,3,0,0,12
1980500,1598652,2025-07-16,Assembly,"Do pass",11,3,0,3,17
1980501,1562768,2025-04-29,Senate,"Do pass, but first be re-referred to the Committee on [Appropriations]",10,0,0,3,13
1980501,1569921,2025-05-12,Senate,"Placed on suspense file",7,0,0,0,7
1980501,1577174,2025-05-23,Senate,"Do pass as amended",4,0,0,3,7
1980501,1585019,2025-06-04,Senate,"Senate 3rd Reading SB771 Stern",29,4,0,7,40
1980501,1594652,2025-06-24,Assembly,"Do pass and be re-referred to the Committee on [Judiciary]",11,1,0,3,15
1980501,1597929,2025-07-08,Assembly,"Do pass as amended and be re-referred to the Committee on [Appropriations]",11,0,0,1,12
1980501,1600543,2025-08-29,Assembly,"Do pass as amended",11,1,0,3,15
1980501,1601976,2025-09-11,Senate,"Unfinished Business SB771 Stern et al. Concurrence",30,8,0,2,40
1980502,1563115,2025-04-29,Senate,"Do pass, but first be re-referred to the Committee on [Appropriations] with the recommendation: To Consent Calendar",11,0,0,0,11
1980502,1572445,2025-05-15,Senate,"Consent Calendar 2nd SB772 Cabaldon",34,0,0,6,40
1980502,1598571,2025-07-16,Assembly,"Do pass as amended and be re-referred to the Committee on [Appropriations]",12,0,0,0,12
1980503,1559399,2025-04-28,Senate,"Do pass, but first be re-referred to the Committee on [Appropriations] with the recommendation: To Consent Calendar",11,0,0,0,11
1980503,1572431,2025-05-15,Senate,"Consent Calendar 2nd SB773 Ashby",34,0,0,6,40
1980503,1594664,2025-06-24,Assembly,"Do pass and be re-referred to the Committee on [Appropriations] with recommendation: To Consent Calendar",16,0,0,2,18
1980503,1598710,2025-07-16,Assembly,"Do pass. To Consent Calendar",13,0,0,2,15
1980504,1559387,2025-04-28,Senate,"Do pass as amended",11,0,0,0,11
1980504,1569837,2025-05-12,Senate,"Placed on suspense file",7,0,0,0,7
1980504,1577389,2025-05-23,Senate,"Do pass",6,0,0,1,7
1980504,1581734,2025-05-29,Senate,"Special Consent SB774 Ashby",38,0,0,2,40
1980504,1597910,2025-07-08,Assembly,"Do pass as amended and be re-referred to the Committee on [Appropriations]",17,0,0,1,18
1980504,1600648,2025-08-29,Assembly,"Do pass",15,0,0,0,15
1980504,1602059,2025-09-12,Senate,"Unfinished Business SB774 Ashby Concurrence",37,0,0,3,40
1980505,1559473,2025-04-28,Senate,"Do pass as amended, but first amend, and re-refer to the Committee on [Appropriations]",11,0,0,0,11
1980505,1569863,2025-05-12,Senate,"Placed on suspense file",7,0,0,0,7
1980505,1577279,2025-05-23,Senate,"Do pass as amended",6,0,0,1,7
1980505,1585112,2025-06-04,Senate,"Special Consent SB775 Ashby",39,0,0,1,40
1980505,1597963,2025-07-08,Assembly,"Do pass and be re-referred to the Committee on [Appropriations]",16,0,0,2,18
1980505,1600361,2025-08-29,Assembly,"Do pass as amended",11,0,0,4,15
1980505,1602106,2025-09-12,Senate,"Unfinished Business SB775 Ashby Concurrence",37,0,0,3,40
1980505,1602107,2025-09-12,Assembly,"SB 775 Ashby Senate Third Reading By Berman",78,1,0,1,80
1980506,1559380,2025-04-28,Senate,"Do pass as amended, but first amend, and re-refer to the Committee on [Appropriations]",11,0,0,0,11
1980506,1569874,2025-05-12,Senate,"Placed on suspense file",7,0,0,0,7
1980506,1577953,2025-05-23,Senate,"Do pass as amended",6,0,0,1,7
1980506,1585043,2025-06-04,Senate,"Special Consent SB776 Ashby",39,0,0,1,40
1980506,1597880,2025-07-08,Assembly,"Do pass and be re-referred to the Committee on [Appropriations]",17,0,0,1,18
1980506,1600672,2025-08-29,Assembly,"Do pass as amended",11,0,0,4,15
1980506,1602346,2025-09-12,Senate,"Unfinished Business SB776 Ashby Concurrence",37,0,0,3,40
1980506,1602347,2025-09-12,Assembly,"SB 776 Ashby Senate Third Reading By Berman",78,2,0,0,80
1980507,1536769,2025-04-02,Senate,"Do pass, but first be re-referred to the Committee on [Appropriations]",6,1,0,0,7
1980507,1559366,2025-04-28,Senate,"Placed on suspense file",7,0,0,0,7
1980507,1577638,2025-05-23,Senate,"Do pass",5,1,0,1,7
1980507,1577639,2025-05-23,Senate,"[05-23-2025] set for [First] hearing: Reconsideration of favorable vote granted",6,0,0,1,7
1980507,1577640,2025-05-23,Senate,"Do pass",4,2,0,1,7
1980507,1585118,2025-06-04,Senate,"Senate 3rd Reading SB777 Richardson",38,0,0,2,40
1980507,1597967,2025-07-08,Assembly,"Do pass as amended and be re-referred to the Committee on [Local Government]",17,0,0,1,18
1980507,1599725,2025-08-20,Assembly,"Do pass",15,0,0,0,15
1980507,1602038,2025-09-12,Senate,"That the Assembly amendments be concurred in",8,0,0,3,11
1980507,1602354,2025-09-12,Senate,"Unfinished Business SB777 Richardson Concurrence",37,0,0,3,40
1980508,1540920,2025-04-07,Senate,"Do pass, but first be re-referred to the Committee on [Appropriations]",5,0,0,0,5
1980508,1552903,2025-04-21,Senate,"Placed on suspense file",6,0,0,1,7
1980508,1577137,2025-05-23,Senate,"Do pass",5,0,0,2,7
1980508,1584395,2025-06-03,Senate,"Senate 3rd Reading SB778 Limón",34,1,0,5,40
1980508,1597113,2025-07-01,Assembly,"Do pass and be re-referred to the Committee on [Appropriations]",7,0,0,0,7
1980508,1600564,2025-08-29,Assembly,"Do pass as amended",13,0,0,2,15
1980508,1601399,2025-09-08,Assembly,"SB 778 Limón Senate Third Reading By Bains",78,0,0,2,80
1980508,1601460,2025-09-09,Senate,"Unfinished Business SB778 Limón Concurrence",34,3,0,3,40
1980509,1538881,2025-04-07,Senate,"Do pass, but first be re-referred to the Committee on [Judiciary]",10,0,0,1,11
1980509,1556104,2025-04-22,Senate,"Do pass, but first be re-referred to the Committee on [Appropriations]",13,0,0,0,13
1980509,1584263,2025-06-03,Senate,"Senate 3rd Reading SB779 Archuleta",39,0,0,1,40
1980509,1597187,2025-07-01,Assembly,"Do pass as amended and be re-referred to the Committee on [Appropriations]",17,0,0,1,18
1980509,1600738,2025-08-29,Assembly,"Do pass",15,0,0,0,15
1980509,1601591,2025-09-09,Assembly,"SB 779 Archuleta Senate Third Reading By Berman",80,0,0,0,80
1980509,1601881,2025-09-11,Senate,"Unfinished Business SB779 Archuleta Concurrence",40,0,0,0,40
1980511,1538863,2025-04-07,Senate,"Do pass, but first be re-referred to the Committee on [Local Government]",10,0,0,1,11
1980511,1562894,2025-04-30,Senate,"Do pass as amended, but first amend, and re-refer to the Committee on [Appropriations] with the recommendation: To Consent Calendar",7,0,0,0,7
1980511,1569871,2025-05-12,Senate,"Placed on suspense file",7,0,0,0,7
1980511,1577665,2025-05-23,Senate,"Do pass",6,0,0,1,7
1980511,1581703,2025-05-29,Senate,"Special Consent SB781 Reyes et al",38,0,0,2,40
1980511,1597825,2025-07-08,Assembly,"Do pass as amended and be re-referred to the Committee on [Local Government]",7,0,0,1,8
1980511,1598863,2025-07-16,Assembly,"Do pass and be re-referred to the Committee on [Appropriations] with recommendation: To Consent Calendar",10,0,0,0,10
1980512,1567918,2025-05-07,Senate,"Do pass as amended",7,0,0,0,7
1980512,1580528,2025-05-28,Senate,"Senate 3rd Reading SB782 Pérez Urgency Clause",38,0,0,2,40
1980512,1598859,2025-07-16,Assembly,"Do pass as amended",10,0,0,0,10
1980512,1600921,2025-09-03,Assembly,"SB 782 Pérez Third Reading Urgency By Harabedian",77,1,0,1,79
1980512,1601178,2025-09-04,Senate,"Unfinished Business SB782 Pérez Urgency Clause Concurrence",39,0,0,1,40
1980513,1542748,2025-04-08,Senate,"Do pass, but first be re-referred to the Committee on [Appropriations]",14,0,0,1,15
1980513,1584286,2025-06-03,Senate,"Senate 3rd Reading SB783 Rubio",39,0,0,1,40
1980513,1598120,2025-07-09,Assembly,"Do pass as amended and be re-referred to the Committee on [Appropriations]",22,0,0,0,22
1980513,1600383,2025-08-29,Assembly,"Do pass",15,0,0,0,15
1980513,1601131,2025-09-04,Assembly,"SB 783 Rubio Senate Third Reading By Blanca Rubio",75,0,0,4,79
1980513,1601282,2025-09-08,Senate,"Unfinished Business SB783 Rubio et al. Concurrence",38,1,0,1,40
1980514,1535101,2025-04-02,Senate,"Do pass as amended, but first amend, and re-refer to the Committee on [Judiciary]",5,0,0,2,7
1980514,1562776,2025-04-29,Senate,"Do pass as amended, but first amend, and re-refer to the Committee on [Appropriations]",10,0,0,3,13
1980514,1569846,2025-05-12,Senate,"Placed on suspense file",7,0,0,0,7
1980514,1577921,2025-05-23,Senate,"Do pass",5,0,0,2,7
1980514,1586433,2025-06-02,Senate,"Senate 3rd Reading SB784 Durazo et al",27,2,0,11,40
1980514,1597754,2025-07-07,Assembly,"Do pass and be re-referred to the Committee on [Judiciary]",7,1,0,1,9
1980514,1598509,2025-07-15,Assembly,"Do pass as amended and be re-referred to the Committee on [Appropriations]",9,3,0,0,12
1980515,1571577,2025-05-14,Senate,"Do pass, but first be re-referred to the Committee on [Appropriations]",5,0,0,0,5
1980515,1573561,2025-05-19,Senate,"Placed on suspense file",5,0,0,2,7
1980515,1577821,2025-05-23,Senate,"Do pass",6,0,0,1,7
1980515,1581774,2025-05-29,Senate,"Special Consent SB785 Caballero",38,0,0,2,40
1980515,1598441,2025-07-14,Assembly,"Do pass and be re-referred to the Committee on [Appropriations]",7,0,0,0,7
1980515,1600591,2025-08-29,Assembly,"Do pass",15,0,0,0,15
1980515,1601143,2025-09-04,Assembly,"SB 785 Caballero Senate Third Reading By Elhawary",78,0,0,1,79
1980515,1601283,2025-09-08,Senate,"Unfinished Business SB785 Caballero Concurrence",39,0,0,1,40
1980516,1556199,2025-04-23,Senate,"Do pass, but first be re-referred to the Committee on [Judiciary]",5,2,0,0,7
1980516,1563086,2025-04-29,Senate,"Do pass as amended, but first amend, and re-refer to the Committee on [Appropriations]",11,2,0,0,13
1980516,1581727,2025-05-29,Senate,"Senate 3rd Reading SB786 Arreguín",28,10,0,2,40
1980516,1597440,2025-07-02,Assembly,"Do pass and be re-referred to the Committee on [Judiciary]",7,3,0,2,12
1980516,1598505,2025-07-15,Assembly,"Do pass and be re-referred to the Committee on [Appropriations]",9,3,0,0,12
1980516,1600768,2025-08-29,Assembly,"Do pass as amended",11,4,0,0,15
1980516,1601401,2025-09-08,Assembly,"SB 786 Arreguín Senate Third Reading By Bryan",58,19,0,3,80
1980516,1601507,2025-09-09,Senate,"Unfinished Business SB786 Arreguín et al. Concurrence",30,10,0,0,40
1980517,1554654,2025-04-21,Senate,"Do pass as amended, but first amend, and re-refer to the Committee on [Appropriations]",14,2,0,1,17
1980517,1569811,2025-05-12,Senate,"Placed on suspense file",7,0,0,0,7
1980517,1577911,2025-05-23,Senate,"Do pass",5,1,0,1,7
1980517,1586383,2025-06-02,Senate,"Senate 3rd Reading SB787 McNerney",28,10,0,2,40
1980517,1598077,2025-07-09,Assembly,"Do pass and be re-referred to the Committee on [Transportation]",15,1,0,2,18
1980517,1598482,2025-07-14,Assembly,"Do pass and be re-referred to the Committee on [Appropriations]",14,1,0,1,16
1980517,1600526,2025-08-29,Assembly,"Do pass as amended",11,3,0,1,15
1980517,1602220,2025-09-12,Senate,"Unfinished Business SB787 McNerney et al. Concurrence",29,8,0,3,40
1980517,1602221,2025-09-12,Assembly,"SB 787 McNerney Senate Third Reading By Petrie-Norris",64,10,0,6,80
1980518,1559486,2025-04-28,Senate,"Do pass as amended, but first amend, and re-refer to the Committee on [Appropriations]",11,0,0,0,11
1980518,1584432,2025-06-03,Senate,"Senate 3rd Reading SB788 Niello",38,0,0,2,40
1980518,1594622,2025-06-24,Assembly,"Do pass and be re-referred to the Committee on [Appropriations]",16,0,0,2,18
1980518,1598122,2025-07-09,Assembly,"Do pass",15,0,0,0,15
1980518,1601122,2025-09-04,Assembly,"SB 788 Niello Senate Third Reading By Krell",77,0,0,2,79
1980519,1555967,2025-04-23,Senate,"Do pass as amended, but first amend, and re-refer to the Committee on [Appropriations]",3,1,0,1,5
1980519,1569868,2025-05-12,Senate,"Placed on suspense file",7,0,0,0,7
1980520,1552911,2025-04-21,Senate,"Do pass, but first be re-referred to the Committee on [Education]",11,0,0,0,11
1980520,1562826,2025-04-30,Senate,"Do pass as amended, but first amend, and re-refer to the Committee on [Appropriations]",6,0,0,1,7
1980520,1573574,2025-05-19,Senate,"Placed on suspense file",5,0,0,2,7
1980520,1577712,2025-05-23,Senate,"Do pass",6,0,0,1,7
1980520,1586404,2025-06-02,Senate,"Senate 3rd Reading SB790 Cabaldon",34,0,0,6,40
1980520,1594644,2025-06-24,Assembly,"Do pass as amended and be re-referred to the Committee on [Business and Professions]",9,1,0,0,10
1980520,1597839,2025-07-08,Assembly,"Do pass as amended and be re-referred to the Committee on [Appropriations]",17,0,0,1,18
1980521,1554595,2025-04-22,Senate,"Do pass, but first be re-referred to the Committee on [Rules]",12,1,0,2,15
1980521,1584374,2025-06-03,Senate,"Senate 3rd Reading SB791 Cortese et al",29,1,0,10,40
1980521,1598369,2025-07-14,Assembly,"Do pass and be re-referred to the Committee on [Appropriations]",11,0,0,5,16
1980521,1600641,2025-08-29,Assembly,"Do pass as amended",12,0,0,3,15
1980521,1601402,2025-09-08,Assembly,"SB 791 Cortese Senate Third Reading By Wilson",60,3,0,17,80
1980521,1601748,2025-09-10,Senate,"Unfinished Business SB791 Cortese et al. Concurrence",37,0,0,3,40
1980522,1540965,2025-04-07,Senate,"Do pass, but first be re-referred to the Committee on [Appropriations] with the recommendation: To Consent Calendar",5,0,0,0,5
1980522,1557572,2025-04-24,Senate,"Consent Calendar 2nd SB792 Arreguín",37,0,0,3,40
1980522,1597150,2025-07-01,Assembly,"Do pass and be re-referred to the Committee on [Appropriations] with recommendation: To Consent Calendar",7,0,0,0,7
1980522,1599765,2025-08-20,Assembly,"Do pass. To Consent Calendar",15,0,0,0,15
1980522,1600223,2025-08-28,Assembly,"SB 792 Arreguín Consent Calendar Second Day Regular Session",74,0,0,5,79
1980522,1601816,2025-09-10,Senate,"That the Assembly amendments be concurred in",5,0,0,0,5
1980522,1601964,2025-09-11,Senate,"Unfinished Business SB792 Arreguín et al. Concurrence",40,0,0,0,40
1980523,1540966,2025-04-08,Senate,"Do pass, but first be re-referred to the Committee on [Judiciary]",15,0,0,0,15
1980523,1563100,2025-04-29,Senate,"Do pass and be ordered to the Consent Calendar",13,0,0,0,13
1980523,1568658,2025-05-08,Senate,"Consent Calendar 2nd SB793 Archuleta",36,0,0,4,40
1980523,1597135,2025-06-30,Assembly,"Do pass and be re-referred to the Committee on [Judiciary] with recommendation: To Consent Calendar",7,0,0,0,7
1980523,1597966,2025-07-08,Assembly,"Do pass and be re-referred to the Committee on [Appropriations] with recommendation: To Consent Calendar",12,0,0,0,12
1980523,1600304,2025-08-29,Assembly,"Do pass as amended",11,0,0,4,15
1980523,1601660,2025-09-09,Assembly,"SB 793 Archuleta Senate Third Reading By Ransom",80,0,0,0,80
1980523,1601924,2025-09-11,Senate,"Unfinished Business SB793 Archuleta Concurrence",40,0,0,0,40
1980526,1557504,2025-04-23,Senate,"Do pass as amended, but first amend, and re-refer to the Committee on [Appropriations]",11,0,0,0,11
1980526,1569923,2025-05-12,Senate,"Placed on suspense file",7,0,0,0,7
1980527,1555932,2025-04-23,Senate,"Do pass, but first be re-referred to the Committee on [Energy, Utilities and Communications]",8,0,0,0,8
1980527,1562965,2025-04-29,Senate,"Do pass as amended, but first amend, and re-refer to the Committee on [Appropriations]",13,1,0,3,17
1980527,1573625,2025-05-19,Senate,"Placed on suspense file",5,0,0,2,7
1980528,1559483,2025-04-28,Senate,"Do pass, but first be re-referred to the Committee on [Appropriations] with the recommendation: To Consent Calendar",4,0,0,1,5
1980528,1561084,2025-04-28,Senate,"Do pass and be ordered to the Consent Calendar",4,0,0,1,5
1980528,1565310,2025-05-05,Senate,"Consent Calendar 2nd SB798 Rubio",38,0,0,2,40
1980529,1542809,2025-04-08,Senate,"Do pass as amended, but first amend, and re-refer to the Committee on [Revenue and Taxation]",10,2,0,1,13
1980529,1555887,2025-04-23,Senate,"Do pass as amended, but first amend, and re-refer to the Committee on [Appropriations]",2,1,0,2,5
1980529,1555888,2025-04-23,Senate,"[First] hearing set for [04-23-2025]: Failed passage in Committee. Reconsideration granted",5,0,0,0,5
1980530,1561113,2025-04-28,Senate,"Do pass, but first be re-referred to the Committee on [Appropriations]",15,0,0,0,15
1980530,1569744,2025-05-12,Senate,"Placed on suspense file",7,0,0,0,7
1980530,1577359,2025-05-23,Senate,"Do pass as amended",6,0,0,1,7
1980530,1585039,2025-06-04,Senate,"Special Consent SB800 Reyes et al",39,0,0,1,40
1980530,1598411,2025-07-14,Assembly,"Do pass and be re-referred to the Committee on [Appropriations]",16,0,0,0,16
1980530,1600560,2025-08-29,Assembly,"Do pass as amended",11,0,0,4,15
1980530,1601403,2025-09-08,Assembly,"SB 800 Reyes Senate Third Reading By Garcia",79,0,0,1,80
1980530,1601743,2025-09-10,Senate,"Unfinished Business SB800 Reyes et al. Concurrence",40,0,0,0,40
1980532,1552832,2025-04-21,Senate,"Do pass, but first be re-referred to the Committee on [Housing]",5,0,0,0,5
1980532,1562886,2025-04-29,Senate,"Do pass as amended, but first amend, and re-refer to the Committee on [Appropriations] with the recommendation: To Consent Calendar",11,0,0,0,11
1980532,1577464,2025-05-23,Senate,"Consent Calendar 2nd SB802 Ashby",36,0,0,4,40
1980533,1540823,2025-04-08,Senate,"Do pass as amended, but first amend, and re-refer to the Committee on [Appropriations]",6,0,0,1,7
1980533,1559490,2025-04-28,Senate,"Placed on suspense file",7,0,0,0,7
1980534,1563061,2025-04-29,Senate,"Do pass as amended, but first amend, and re-refer to the Committee on [Appropriations]",16,0,0,1,17
1980534,1573558,2025-05-19,Senate,"Placed on suspense file",5,0,0,2,7
1980534,1577863,2025-05-23,Senate,"Do pass",6,0,0,1,7
1980534,1586365,2025-06-02,Senate,"Senate 3rd Reading SB804 Archuleta et al",34,0,0,6,40
1980534,1595172,2025-06-25,Assembly,"Do pass as amended, and be re-referred to the Committee on [Emergency Management] with recommendation: To Consent Calendar",18,0,0,0,18
1980534,1598412,2025-07-14,Assembly,"Do pass and be re-referred to the Committee on [Appropriations] with recommendation: To Consent Calendar",7,0,0,0,7
1980534,1600414,2025-08-29,Assembly,"Do pass",15,0,0,0,15
1980535,1556122,2025-04-23,Senate,"Do pass, but first be re-referred to the Committee on [Appropriations] with the recommendation: To Consent Calendar",7,0,0,0,7
1980535,1568674,2025-05-08,Senate,"Consent Calendar 2nd SB805 Pérez",36,0,0,4,40
1980535,1598692,2025-07-15,Assembly,"Do pass as amended and be re-referred to the Committee on [Appropriations]",7,0,0,2,9
1980535,1599748,2025-08-20,Assembly,"Do pass",11,4,0,0,15
1980535,1601456,2025-09-09,Assembly,"SB 805 Pérez Third Reading Urgency By Ortega",60,15,0,5,80
1980535,1601941,2025-09-11,Senate,"That the Assembly amendments be concurred in",5,1,0,0,6
1980535,1601942,2025-09-11,Senate,"Unfinished Business SB805 Pérez et al. Urgency Clause Concurrence",30,10,0,0,40
1980538,1542763,2025-04-08,Senate,"Do pass, but first be re-referred to the Committee on [Appropriations] with the recommendation: To Consent Calendar",13,0,0,0,13
1980538,1552922,2025-04-21,Senate,"Placed on suspense file",6,0,0,1,7
1980538,1577490,2025-05-23,Senate,"Do pass as amended",6,0,0,1,7
1980538,1580518,2025-05-28,Senate,"Senate 3rd Reading SB808 Caballero",38,0,0,2,40
1980538,1591841,2025-06-17,Assembly,"Do pass and be re-referred to the Committee on [Appropriations]",10,0,0,2,12
1980538,1600468,2025-08-29,Assembly,"Do pass",14,0,0,1,15
1980538,1601015,2025-09-03,Assembly,"SB 808 Caballero Senate Third Reading By Wicks",77,0,0,2,79
1980539,1542785,2025-04-09,Senate,"Do pass, but first be re-referred to the Committee on [Judiciary]",4,1,0,0,5
1980539,1556163,2025-04-22,Senate,"Do pass as amended, but first amend, and re-refer to the Committee on [Appropriations]",12,1,0,0,13
1980539,1573547,2025-05-19,Senate,"Placed on suspense file",5,0,0,2,7
1980539,1577564,2025-05-23,Senate,"Do pass as amended",5,1,0,1,7
1980539,1581706,2025-05-29,Senate,"Senate 3rd Reading SB809 Durazo",28,10,0,2,40
1980539,1598088,2025-07-09,Assembly,"Do pass and be re-referred to the Committee on [Judiciary]",6,0,0,1,7
1980539,1598475,2025-07-15,Assembly,"Do pass and be re-referred to the Committee on [Appropriations]",9,3,0,0,12
1980539,1600452,2025-08-29,Assembly,"Do pass as amended",11,3,0,1,15
1980539,1602227,2025-09-12,Senate,"Unfinished Business SB809 Durazo et al. Concurrence",29,8,0,3,40
1980539,1602228,2025-09-12,Assembly,"SB 809 Durazo Senate Third Reading By Ramos",63,12,0,5,80
1980542,1564158,2025-04-30,Senate,"Do pass as amended, but first amend, and re-refer to the Committee on [Appropriations]",9,0,0,2,11
1980542,1573605,2025-05-19,Senate,"Placed on suspense file",5,0,0,2,7
1980542,1577413,2025-05-23,Senate,"Do pass",6,0,0,1,7
1980542,1580524,2025-05-28,Senate,"Senate 3rd Reading SB812 Allen",35,0,0,5,40
1980542,1598527,2025-07-15,Assembly,"Do pass as amended, and be re-referred to the Committee on [Appropriations] with recommendation: To Consent Calendar",16,0,0,0,16
1980543,1562769,2025-04-29,Senate,"Do pass as amended, but first amend, and re-refer to the Committee on [Appropriations]",10,0,0,3,13
1980543,1569924,2025-05-12,Senate,"Placed on suspense file",7,0,0,0,7
1980544,1540829,2025-04-07,Senate,"Do pass, but first be re-referred to the Committee on [Housing] with the recommendation: To Consent Calendar",5,0,0,0,5
1980544,1563067,2025-04-29,Senate,"Do pass, but first be re-referred to the Committee on [Appropriations] with the recommendation: To Consent Calendar",11,0,0,0,11
1980544,1569858,2025-05-12,Senate,"Placed on suspense file",7,0,0,0,7
1980545,1562900,2025-04-30,Senate,"Do pass, but first be re-referred to the Committee on [Appropriations]",5,1,0,1,7
1980545,1569807,2025-05-12,Senate,"Placed on suspense file",7,0,0,0,7
1980548,1554566,2025-04-22,Senate,"Do pass as amended, but first amend, and re-refer to the Committee on [Appropriations]",4,1,0,2,7
1980548,1554567,2025-04-22,Senate,"[04-22-2025] set for [First] hearing: Reconsideration of favorable vote granted",2,4,0,1,7
1980548,1573494,2025-05-19,Senate,"Placed on suspense file",5,0,0,2,7
1980549,1555953,2025-04-23,Senate,"Do pass, but first be re-referred to the Committee on [Appropriations]",8,0,0,0,8
1980549,1565286,2025-05-05,Senate,"Placed on suspense file",7,0,0,0,7
1980550,1562851,2025-04-29,Senate,"Do pass",6,0,0,0,6
1980550,1579300,2025-05-27,Senate,"Senate 3rd Reading SB820 Stern",39,0,0,1,40
1980550,1597239,2025-07-01,Assembly,"Do pass as amended",9,0,0,0,9
1980550,1600678,2025-08-29,Assembly,"Do pass",15,0,0,0,15
1980550,1601842,2025-09-11,Senate,"Unfinished Business SB820 Stern Concurrence",39,0,0,1,40
1980551,1540865,2025-04-08,Senate,"Do pass, but first be re-referred to the Committee on [Appropriations]",5,0,0,1,6
1980551,1552858,2025-04-21,Senate,"Placed on suspense file",6,0,0,1,7
1980552,1556130,2025-04-22,Senate,"Do pass, but first be re-referred to the Committee on [Appropriations] with the recommendation: To Consent Calendar",13,0,0,0,13
1980552,1565258,2025-05-05,Senate,"Placed on suspense file",7,0,0,0,7
1980552,1577383,2025-05-23,Senate,"Do pass",6,0,0,1,7
1980552,1581793,2025-05-29,Senate,"Special Consent SB822 Becker",38,0,0,2,40
1980552,1597178,2025-07-01,Assembly,"Do pass and be re-referred to the Committee on [Banking and Finance] with recommendation: To Consent Calendar",12,0,0,0,12
1980552,1598225,2025-07-14,Assembly,"Do pass as amended and be re-referred to the Committee on [Appropriations]",9,0,0,0,9
1980552,1600582,2025-08-29,Assembly,"Do pass as amended",11,0,0,4,15
1980552,1602088,2025-09-12,Senate,"Unfinished Business SB822 Becker et al. Concurrence",37,0,0,3,40
1980552,1602089,2025-09-12,Assembly,"SB 822 Becker Senate Third Reading By Valencia",80,0,0,0,80
1980553,1545017,2025-04-09,Senate,"Do pass, but first be re-referred to the Committee on [Appropriations]",11,0,0,0,11
1980553,1559369,2025-04-28,Senate,"Placed on suspense file",7,0,0,0,7
1980554,1554553,2025-04-22,Senate,"Do pass as amended, but first amend, and re-refer to the Committee on [Appropriations]",5,0,0,1,6
1980554,1565355,2025-05-05,Senate,"Placed on suspense file",7,0,0,0,7
1980555,1535024,2025-04-02,Senate,"Do pass, but first be re-referred to the Committee on [Judiciary]",5,2,0,0,7
1980555,1556038,2025-04-22,Senate,"Do pass, but first be re-referred to the Committee on [Appropriations]",11,2,0,0,13
1980555,1584292,2025-06-03,Senate,"Senate 3rd Reading SB825 Limón et al",28,10,0,2,40
1980555,1597706,2025-07-07,Assembly,"Do pass and be re-referred to the Committee on [Appropriations]",7,1,0,1,9
1980555,1599726,2025-08-20,Assembly,"Do pass",11,4,0,0,15
1980556,1562929,2025-04-30,Senate,"Do pass, but first be re-referred to the Committee on [Appropriations]",4,0,0,1,5
1980556,1569834,2025-05-12,Senate,"Placed on suspense file",7,0,0,0,7
1980557,1562942,2025-04-30,Senate,"Do pass as amended, but first amend, and re-refer to the Committee on [Appropriations]",5,2,0,0,7
1980557,1573590,2025-05-19,Senate,"Placed on suspense file",5,0,0,2,7
1980557,1577303,2025-05-23,Senate,"Do pass",5,1,0,1,7
1980557,1580551,2025-05-28,Senate,"Senate 3rd Reading SB827 Gonzalez et al",28,10,0,2,40
1980557,1598906,2025-07-16,Assembly,"Do pass and be re-referred to the Committee on [Appropriations]",7,0,0,3,10
1980557,1600553,2025-08-29,Assembly,"Do pass as amended",10,2,0,3,15
1980557,1601405,2025-09-08,Assembly,"SB 827 Gonzalez Senate Third Reading By Wicks",64,7,0,9,80
1980557,1601525,2025-09-09,Senate,"Unfinished Business SB827 Gonzalez et al. Concurrence",30,10,0,0,40
1980559,1544965,2025-04-09,Senate,"Do pass, but first be re-referred to the Committee on [Natural Resources and Water]",8,2,0,1,11
1980559,1554582,2025-04-22,Senate,"Do pass as amended, but first amend, and re-refer to the Committee on [Appropriations]",4,2,0,1,7
1980559,1565352,2025-05-05,Senate,"Placed on suspense file",7,0,0,0,7
1980560,1540808,2025-04-08,Senate,"Do pass, but first be re-referred to the Committee on [Judiciary] with the recommendation: To Consent Calendar",6,0,0,0,6
1980560,1557559,2025-04-24,Senate,"Consent Calendar 2nd SB830 Arreguín",37,0,0,3,40
1980560,1598227,2025-07-14,Assembly,"Do pass and be re-referred to the Committee on [Judiciary]",13,0,0,1,14
1980560,1598384,2025-07-15,Assembly,"Do pass and be re-referred to the Committee on [Appropriations]",12,0,0,0,12
1980560,1600288,2025-08-29,Assembly,"Do pass as amended",11,0,0,4,15
1980560,1601406,2025-09-08,Assembly,"SB 830 Arreguín Senate Third Reading By Bonta",79,0,0,1,80
1980560,1601756,2025-09-10,Senate,"That the Assembly amendments be concurred in",5,0,0,3,8
1980561,1540799,2025-04-08,Senate,"Do pass, but first be re-referred to the Committee on [Appropriations]",5,0,0,2,7
1980561,1586378,2025-06-02,Senate,"Senate 3rd Reading SB831 Limón",29,0,0,11,40
1980561,1594039,2025-06-23,Assembly,"Do pass and be re-referred to the Committee on [Appropriations]",13,0,0,1,14
1980561,1597386,2025-07-02,Assembly,"Do pass",10,0,0,5,15
1980561,1601092,2025-09-04,Assembly,"SB 831 Limón Senate Third Reading By Muratsuchi",65,2,0,12,79
1980563,1554538,2025-04-22,Senate,"Do pass, but first be re-referred to the Committee on [Appropriations]",12,0,0,3,15
1980563,1565262,2025-05-05,Senate,"Placed on suspense file",7,0,0,0,7
1980563,1577285,2025-05-23,Senate,"Do pass",6,0,0,1,7
1980563,1584341,2025-06-03,Senate,"Senate 3rd Reading SB833 McNerney",37,0,0,3,40
1980563,1598700,2025-07-16,Assembly,"Do pass as amended and be re-referred to the Committee on [Appropriations]",15,0,0,0,15
1980564,1554451,2025-04-22,Senate,"Do pass, but first be re-referred to the Committee on [Appropriations]",5,1,0,0,6
1980564,1565331,2025-05-05,Senate,"Placed on suspense file",7,0,0,0,7
1980564,1577268,2025-05-23,Senate,"Do pass",5,1,0,1,7
1980564,1585125,2025-06-04,Senate,"Senate 3rd Reading SB834 Durazo",29,10,0,1,40
1980564,1597169,2025-07-01,Assembly,"Do pass and be re-referred to the Committee on [Appropriations]",8,1,0,0,9
1980565,1542736,2025-04-09,Senate,"Do pass",6,0,0,1,7
1980565,1585034,2025-06-04,Senate,"Senate 3rd Reading SB835 Ochoa Bogh et al",30,1,0,9,40
1980566,1554626,2025-04-21,Senate,"Do pass, but first be re-referred to the Committee on [Appropriations]",14,2,0,1,17
1980566,1565351,2025-05-05,Senate,"Placed on suspense file",7,0,0,0,7
1980568,1555980,2025-04-22,Senate,"Do pass, but first be re-referred to the Committee on [Local Government]",9,2,0,0,11
1980568,1567903,2025-05-07,Senate,"Do pass",5,1,0,1,7
1980568,1586443,2025-06-02,Senate,"Senate 3rd Reading SB838 Durazo",23,11,0,6,40
1980568,1598612,2025-07-16,Assembly,"Do pass and be re-referred to the Committee on [Local Government]",8,2,0,2,12
1980568,1598909,2025-07-16,Assembly,"Do pass as amended",9,1,0,0,10
1980568,1602123,2025-09-12,Senate,"Unfinished Business SB838 Durazo Concurrence",26,9,0,5,40
1980569,1540977,2025-04-08,Senate,"Do pass, but first be re-referred to the Committee on [Environmental Quality]",5,0,0,2,7
1980569,1562958,2025-04-30,Senate,"Do pass, but first be re-referred to the Committee on [Appropriations]",8,0,0,0,8
1980569,1569861,2025-05-12,Senate,"Placed on suspense file",7,0,0,0,7
1980569,1577168,2025-05-23,Senate,"Do pass",5,0,0,2,7
1980569,1580522,2025-05-28,Senate,"Senate 3rd Reading SB839 Laird",32,0,0,8,40
1980569,1594034,2025-06-23,Assembly,"Do pass and be re-referred to the Committee on [Judiciary] with recommendation: To Consent Calendar",14,0,0,0,14
1980569,1597215,2025-07-01,Assembly,"Do pass and be re-referred to the Committee on [Appropriations]",11,0,0,1,12
1980569,1600338,2025-08-29,Assembly,"Do pass as amended",11,0,0,4,15
1980569,1602190,2025-09-12,Senate,"Unfinished Business SB839 Laird Concurrence",32,0,0,8,40
1980569,1602191,2025-09-13,Assembly,"SB 839 Laird Senate Third Reading By Connolly",79,0,0,1,80
1980570,1562770,2025-04-30,Senate,"Do pass, but first be re-referred to the Committee on [Appropriations]",8,0,0,0,8
1980570,1569876,2025-05-12,Senate,"Placed on suspense file",7,0,0,0,7
1980570,1577916,2025-05-23,Senate,"Do pass",6,0,0,1,7
1980570,1586426,2025-06-02,Senate,"Senate 3rd Reading SB840 Limón et al",38,0,0,2,40
1980570,1598302,2025-07-14,Assembly,"Do pass and be re-referred to the Committee on [Appropriations]",12,0,0,2,14
1980570,1600299,2025-08-29,Assembly,"Do pass",15,0,0,0,15
1980570,1602039,2025-09-12,Assembly,"Do pass",10,2,0,2,14
1980570,1602365,2025-09-12,Senate,"W/O REF. TO FILE SB840 Limón",28,6,0,6,40
1980570,1602366,2025-09-13,Assembly,"SB 840 Limón Third Reading Urgency By IRWIN",59,15,0,6,80
1980571,1556049,2025-04-22,Senate,"Do pass, but first be re-referred to the Committee on [Public Safety]",11,0,0,2,13
1980571,1562790,2025-04-29,Senate,"Do pass, but first be re-referred to the Committee on [Appropriations]",5,0,0,1,6
1980571,1584399,2025-06-03,Senate,"Senate 3rd Reading SB841 Rubio",31,0,0,9,40
1980571,1594686,2025-06-24,Assembly,"Do pass and be re-referred to the Committee on [Public Safety]",9,0,0,3,12
1980571,1598671,2025-07-15,Assembly,"Do pass and be re-referred to the Committee on [Appropriations]",7,0,0,2,9
1980571,1599722,2025-08-20,Assembly,"Do pass",12,0,0,3,15
1980572,1562927,2025-04-29,Senate,"Do pass as amended, but first amend, and re-refer to the Committee on [Appropriations]",13,3,0,1,17
1980572,1573603,2025-05-19,Senate,"Placed on suspense file",5,0,0,2,7
1980572,1577306,2025-05-23,Senate,"Do pass as amended",5,1,0,1,7
1980572,1585041,2025-06-04,Senate,"Senate 3rd Reading SB842 Stern",29,10,0,1,40
1980572,1598061,2025-07-09,Assembly,"Do pass and be re-referred to the Committee on [Appropriations] with recommendation: To Consent Calendar",18,0,0,0,18
1980574,1526920,2025-03-25,Senate,"Do pass, but first be re-referred to the Committee on [Appropriations]",12,0,0,3,15
1980574,1580540,2025-05-28,Senate,"Senate 3rd Reading SB844 Rubio",39,0,0,1,40
1980575,1542698,2025-04-09,Senate,"Do pass as amended, but first amend, and re-refer to the Committee on [Labor, Public Employment and Retirement ]",7,0,0,0,7
1980575,1562910,2025-04-30,Senate,"Do pass, but first be re-referred to the Committee on [Appropriations]",5,0,0,0,5
1980575,1579267,2025-05-27,Senate,"Senate 3rd Reading SB845 Pérez et al",39,0,0,1,40
1980576,1567910,2025-05-06,Senate,"Do pass and be ordered to the Consent Calendar",12,0,0,1,13
1980576,1572439,2025-05-15,Senate,"Consent Calendar 2nd SB846 McNerney",34,0,0,6,40
1980576,1591885,2025-06-17,Assembly,"Do pass. To Consent Calendar",11,0,0,1,12
1980576,1594078,2025-06-23,Assembly,"SB 846 McNerney Consent Calendar Second Day Regular Session",71,0,0,8,79
1980577,1542726,2025-04-09,Senate,"Do pass, but first be re-referred to the Committee on [Judiciary]",5,0,0,0,5
1980577,1562765,2025-04-29,Senate,"Do pass, but first be re-referred to the Committee on [Appropriations]",13,0,0,0,13
1980577,1581744,2025-05-29,Senate,"Senate 3rd Reading SB847 Reyes By Cortese",38,0,0,2,40
1980577,1597251,2025-07-01,Assembly,"Do pass and be re-referred to the Committee on [Insurance] with recommendation: To Consent Calendar",12,0,0,0,12
1980577,1598745,2025-07-16,Assembly,"Do pass and be re-referred to the Committee on [Appropriations] with recommendation: To Consent Calendar",17,0,0,0,17
1980577,1599753,2025-08-20,Assembly,"Do pass. To Consent Calendar",15,0,0,0,15
1980577,1600237,2025-08-28,Assembly,"SB 847 Reyes Consent Calendar Second Day Regular Session",74,0,0,5,79
1980578,1556006,2025-04-23,Senate,"Do pass, but first be re-referred to the Committee on [Public Safety]",7,0,0,0,7
1980578,1563004,2025-04-29,Senate,"Do pass as amended, but first amend, and re-refer to the Committee on [Appropriations]",6,0,0,0,6
1980578,1573506,2025-05-19,Senate,"Placed on suspense file",5,0,0,2,7
1980578,1577881,2025-05-23,Senate,"Do pass as amended",6,0,0,1,7
1980578,1586361,2025-06-02,Senate,"Senate 3rd Reading SB848 Pérez",38,0,0,2,40
1980578,1597542,2025-07-02,Assembly,"Do pass as amended and be re-referred to the Committee on [Public Safety]",9,0,0,0,9
1980578,1598660,2025-07-15,Assembly,"Do pass and be re-referred to the Committee on [Appropriations]",9,0,0,0,9
1980578,1600677,2025-08-29,Assembly,"Do pass as amended",11,0,0,4,15
1980578,1602093,2025-09-12,Senate,"Unfinished Business SB848 Pérez et al. Concurrence",37,0,0,3,40
1980578,1602094,2025-09-12,Assembly,"SB 848 Pérez Senate Third Reading By Wicks",71,0,0,9,80
1980580,1561120,2025-04-29,Senate,"Do pass, but first be re-referred to the Committee on [Labor, Public Employment and Retirement ]",6,0,0,0,6
1980580,1562849,2025-04-30,Senate,"Do pass as amended, but first amend, and re-refer to the Committee on [Appropriations]",4,0,0,1,5
1980580,1573583,2025-05-19,Senate,"Placed on suspense file",5,0,0,2,7
1980581,1503912,2025-03-03,Senate,"Senate 3rd Reading SCR27 Choi",37,0,0,2,39
1980581,1552847,2025-04-21,Assembly,"Be adopted. To Consent Calendar",10,0,0,1,11
1980581,1557489,2025-04-24,Assembly,"SCR 27 Choi Consent Calendar Second Day Regular Session",75,0,0,4,79
1980582,1508042,2025-03-06,Senate,"Senate 3rd Reading SR19 Wahab et al",34,0,0,5,39
1980583,1568611,2025-05-08,Senate,"Senate 3rd Reading SR20 Cortese et al",36,0,0,4,40
1980584,1600664,2025-08-29,Senate,"Senate 3rd Reading SR21 Archuleta et al",37,0,0,3,40
1980585,1525437,2025-03-24,Senate,"Senate 3rd Reading SR22 Wiener et al",26,1,0,13,40
1982217,1561099,2025-04-29,Assembly,"Do pass as amended and be re-referred to the Committee on [Appropriations]",17,0,0,1,18
1982217,1577146,2025-05-23,Assembly,"Do pass",13,0,0,2,15
1982217,1583502,2025-06-02,Assembly,"AB 1501 Berman Assembly Third Reading",75,1,0,3,79
1982217,1596799,2025-06-30,Senate,"Do pass as amended, but first amend, and re-refer to the Committee on [Appropriations]",7,0,0,4,11
1982217,1599482,2025-08-18,Senate,"Placed on suspense file",7,0,0,0,7
1982217,1600514,2025-08-29,Senate,"Do pass as amended",7,0,0,0,7
1982217,1601649,2025-09-09,Senate,"Assembly 3rd Reading AB1501 Berman By Ashby",40,0,0,0,40
1982218,1561052,2025-04-29,Assembly,"Do pass as amended and be re-referred to the Committee on [Appropriations]",17,0,0,1,18
1982218,1577805,2025-05-23,Assembly,"Do pass",13,0,0,2,15
1982218,1583456,2025-06-02,Assembly,"AB 1502 Berman Assembly Third Reading",76,0,0,3,79
1982218,1596769,2025-06-30,Senate,"Do pass as amended, but first amend, and re-refer to the Committee on [Appropriations]",8,0,0,3,11
1982218,1599420,2025-08-18,Senate,"Placed on suspense file",7,0,0,0,7
1982218,1600700,2025-08-29,Senate,"Do pass",7,0,0,0,7
1982218,1601594,2025-09-09,Senate,"Assembly 3rd Reading AB1502 Berman By Ashby",39,0,0,1,40
1982219,1561041,2025-04-29,Assembly,"Do pass as amended and be re-referred to the Committee on [Appropriations]",13,1,0,4,18
1982219,1577650,2025-05-23,Assembly,"Do pass",11,1,0,3,15
1982219,1583500,2025-06-02,Assembly,"AB 1503 Berman Assembly Third Reading",54,1,0,24,79
1982219,1598226,2025-07-14,Senate,"Do pass as amended, but first amend, and re-refer to the Committee on [Appropriations]",10,0,0,1,11
1982219,1599477,2025-08-18,Senate,"Placed on suspense file",7,0,0,0,7
1982219,1600625,2025-08-29,Senate,"Do pass",7,0,0,0,7
1982219,1601488,2025-09-09,Senate,"Assembly 3rd Reading AB1503 Berman et al. By Ashby",39,0,0,1,40
1982220,1561158,2025-04-29,Assembly,"Do pass as amended and be re-referred to the Committee on [Appropriations]",16,0,0,2,18
1982220,1571605,2025-05-14,Assembly,"Do pass",15,0,0,0,15
1982220,1573624,2025-05-19,Assembly,"AB 1504 Berman Assembly Third Reading",67,0,0,12,79
1982220,1596793,2025-06-30,Senate,"Do pass, but first be re-referred to the Committee on [Public Safety]",7,0,0,4,11
1982220,1598397,2025-07-15,Senate,"Do pass as amended, but first amend, and re-refer to the Committee on [Appropriations]",5,0,0,1,6
1982220,1599438,2025-08-18,Senate,"Placed on suspense file",7,0,0,0,7
1982220,1600270,2025-08-29,Senate,"Do pass",5,0,0,2,7
1982220,1601516,2025-09-09,Senate,"Assembly 3rd Reading AB1504 Berman By Ashby",35,0,0,5,40
1982221,1503915,2025-03-03,Assembly,"Be adopted. To third reading",6,0,0,5,11
1982221,1557491,2025-04-24,Senate,"Special Consent ACR41 Patterson et al",37,0,0,3,40
1982222,1511500,2025-03-10,Assembly,"Be adopted. To third reading",9,0,0,2,11
1982223,1599403,2025-08-18,Senate,"Senate 3rd Reading SCR28 Grove et al",36,0,0,4,40
1982223,1600190,2025-08-28,Assembly,"Be adopted. To Consent Calendar",9,0,0,2,11
1982223,1600812,2025-09-02,Assembly,"SCR 28 Grove Consent Calendar Second Day Regular Session",78,0,0,1,79
1983852,1562838,2025-04-30,Assembly,"Do pass and be re-referred to the Committee on [Appropriations] with recommendation: To Consent Calendar",8,0,0,0,8
1983852,1577877,2025-05-23,Assembly,"Do pass",14,0,0,1,15
1983852,1583494,2025-06-02,Assembly,"AB 1505 Agriculture Assembly Third Reading By SORIA",79,0,0,0,79
1983852,1597218,2025-07-01,Senate,"Do pass, but first be re-referred to the Committee on [Appropriations] with the recommendation: To Consent Calendar",5,0,0,0,5
1983852,1598839,2025-07-17,Senate,"Consent Calendar 2nd AB1505 AGRI. (Soria) By Caballero",35,0,0,5,40
1983852,1600062,2025-08-25,Assembly,"AB 1505 Agriculture Concurrence in Senate Amendments By SORIA",76,0,0,3,79
1983853,1511455,2025-03-10,Assembly,"Be adopted. To third reading",9,0,0,2,11
1983854,1519129,2025-03-17,Senate,"Senate 3rd Reading SCR29 McNerney",37,0,0,3,40
1983854,1552917,2025-04-21,Assembly,"Be adopted. To Consent Calendar",10,0,0,1,11
1983854,1557523,2025-04-24,Assembly,"SCR 29 McNerney Consent Calendar Second Day Regular Session",75,0,0,4,79
1983855,1508044,2025-03-06,Senate,"Senate 3rd Reading SCR30 Smallwood-Cuevas",34,0,0,5,39
1983855,1519116,2025-03-17,Assembly,"Be adopted. To Consent Calendar",10,0,0,1,11
1983855,1523556,2025-03-20,Assembly,"SCR 30 Smallwood-Cuevas Consent Calendar Second Day Regular Session",67,0,0,13,80
1983856,1517829,2025-03-13,Senate,"Senate 3rd Reading SR23 Rubio et al",28,2,0,10,40
1983857,1523506,2025-03-20,Senate,"Senate 3rd Reading SR24 Wahab et al",38,0,0,2,40
1983858,1511456,2025-03-10,Senate,"Senate 3rd Reading SR25 Limón",38,0,0,1,39
1983859,1523551,2025-03-20,Senate,"Senate 3rd Reading SR26 Padilla et al",38,0,0,2,40
1986151,1542732,2025-04-09,Assembly,"Do pass and be re-referred to the Committee on [Appropriations] with recommendation: To Consent Calendar",8,0,0,0,8
1986152,1530381,2025-03-28,Assembly,"Be adopted. To Consent Calendar",7,0,0,4,11
1986152,1536814,2025-04-03,Assembly,"ACR 42 Pacheco Consent Calendar Second Day Regular Session",74,0,0,5,79
1986152,1572388,2025-05-15,Senate,"Special Consent ACR42 Pacheco et al",34,0,0,6,40
1986153,1503918,2025-03-03,Assembly,"Be adopted. To Consent Calendar",6,0,0,5,11
1986153,1508048,2025-03-06,Assembly,"ACR 43 Pacheco Consent Calendar Second Day",76,0,0,4,80
1986153,1536793,2025-04-03,Senate,"Special Consent ACR43 Pacheco et al",39,0,0,1,40
1986154,1503928,2025-03-03,Assembly,"Be adopted. To Consent Calendar",6,0,0,5,11
1986154,1508045,2025-03-06,Assembly,"HR 20 Ransom Consent Calendar Second Day Regular Session",76,0,0,4,80
1987922,1565306,2025-05-05,Assembly,"Do pass. To Consent Calendar",9,0,0,0,9
1987922,1569814,2025-05-12,Assembly,"AB 1507 Banking and Finance Consent Calendar Second Day Regular Session",77,0,0,2,79
1987922,1597570,2025-07-02,Senate,"Do pass and be ordered to the Consent Calendar",7,0,0,0,7
1987922,1598176,2025-07-10,Senate,"Consent Calendar 2nd AB1507 B. & F. (Valencia)",37,0,0,3,40
1987923,1530378,2025-03-28,Assembly,"Be adopted. To third reading",7,0,0,4,11
1987923,1572409,2025-05-15,Senate,"Special Consent ACR44 Pacheco et al",34,0,0,6,40
1987924,1561021,2025-04-29,Senate,"Do pass and be ordered to the Consent Calendar",5,0,0,0,5
1987924,1565288,2025-05-05,Senate,"Consent Calendar 2nd SB851 E. & C.A. (Cervantes)",38,0,0,2,40
1987924,1597382,2025-07-02,Assembly,"Do pass. To Consent Calendar",7,0,0,0,7
1987924,1602031,2025-09-12,Assembly,"Do pass",5,2,0,0,7
1987924,1602224,2025-09-12,Senate,"Unfinished Business SB851 Cervantes et al. Urgency Clause Concurrence",29,6,0,5,40
1987924,1602225,2025-09-13,Assembly,"SB 851 Cervantes Senate Second Reading By Pellerin",60,19,0,1,80
1987925,1561129,2025-04-29,Senate,"Do pass, but first be re-referred to the Committee on [Appropriations] with the recommendation: To Consent Calendar",5,0,0,0,5
1987925,1572385,2025-05-15,Senate,"Consent Calendar 2nd SB852 E. & C.A. (Cervantes)",34,0,0,6,40
1987925,1597501,2025-07-02,Assembly,"Do pass and be re-referred to the Committee on [Appropriations] with recommendation: To Consent Calendar",7,0,0,0,7
1987925,1598697,2025-07-16,Assembly,"Do pass. To Consent Calendar",13,0,0,2,15
1987925,1601407,2025-09-08,Assembly,"SB 852 Elections and Constitutio Senate Third Reading By PELLERIN",78,0,0,2,80
1987925,1601738,2025-09-10,Senate,"That the Assembly amendments be concurred in",5,0,0,0,5
1987925,1601846,2025-09-11,Senate,"Unfinished Business SB852 E. & C.A. (Cervantes) Concurrence",40,0,0,0,40
1987926,1519126,2025-03-17,Senate,"Senate 3rd Reading SCR31 Allen",37,0,0,3,40
1987926,1552859,2025-04-21,Assembly,"Be adopted. To Consent Calendar",10,0,0,1,11
1987926,1557533,2025-04-24,Assembly,"SCR 31 Allen Consent Calendar Second Day Regular Session",75,0,0,4,79
1987927,1525432,2025-03-24,Senate,"Senate 3rd Reading SCR32 Allen",35,0,0,5,40
1987927,1552882,2025-04-21,Assembly,"Be adopted. To Consent Calendar",10,0,0,1,11
1987927,1557525,2025-04-24,Assembly,"SCR 32 Allen Consent Calendar Second Day Regular Session",75,0,0,4,79
1990391,1544975,2025-04-08,Assembly,"Do pass and be re-referred to the Committee on [Appropriations]",7,0,0,1,8
1990391,1577167,2025-05-23,Assembly,"Do pass",14,0,0,1,15
1990391,1584316,2025-06-03,Assembly,"AB 1508 M. & V. A. Assembly Third Reading By SCHIAVO",78,0,0,1,79
1990391,1598220,2025-07-14,Senate,"Do pass, but first be re-referred to the Committee on [Appropriations] with the recommendation: To Consent Calendar",5,0,0,0,5
1990391,1599624,2025-08-18,Senate,"Placed on suspense file",7,0,0,0,7
1990391,1600506,2025-08-29,Senate,"Do pass",7,0,0,0,7
1990391,1601076,2025-09-04,Senate,"Special Consent AB1508 M. & V.A. (Schiavo) By Menjivar",39,0,0,1,40
1990392,1545016,2025-04-08,Assembly,"Do pass and be re-referred to the Committee on [Appropriations]",7,0,0,1,8
1990392,1556124,2025-04-23,Assembly,"Do pass",15,0,0,0,15
1990392,1568601,2025-05-08,Assembly,"AB 1509 M. & V. A. Assembly Third Reading By SCHIAVO",72,0,0,7,79
1990392,1598273,2025-07-14,Senate,"Do pass, but first be re-referred to the Committee on [Appropriations] with the recommendation: To Consent Calendar",5,0,0,0,5
1990392,1600008,2025-08-25,Senate,"Consent Calendar 2nd AB1509 M. & V.A. (Schiavo)",37,0,0,3,40
1990393,1565278,2025-05-05,Assembly,"Be adopted. To Consent Calendar",9,0,0,2,11
1990393,1568657,2025-05-08,Assembly,"ACR 45 Quirk-Silva Consent Calendar Second Day Regular Session",69,0,0,10,79
1990393,1593180,2025-06-19,Senate,"Special Consent ACR45 Quirk-Silva et al",35,0,0,5,40
1990394,1555992,2025-04-23,Assembly,"Be adopted. To third reading",7,0,0,0,7
1990394,1573546,2025-05-19,Assembly,"AJR 3 Schiavo Assembly Third Reading",64,2,0,13,79
1990394,1591158,2025-06-16,Senate,"Be adopted. Ordered to third reading",5,0,0,0,5
1990394,1599993,2025-08-25,Senate,"Assembly 3rd Reading AJR3 Schiavo et al. By Arreguín",29,0,0,11,40
1990394,1600204,2025-08-28,Assembly,"AJR 3 Schiavo Concurrence in Senate Amendments",57,0,0,22,79
1990395,1519117,2025-03-17,Assembly,"Be adopted. To third reading",10,0,0,1,11
1990396,1528309,2025-03-26,Senate,"Be adopted as amended",4,1,0,0,5
1990396,1538955,2025-04-07,Senate,"Senate 3rd Reading SJR2 Cortese et al",29,7,0,4,40
1990396,1595151,2025-06-25,Assembly,"Be adopted. To third reading",5,0,0,2,7
1990396,1597574,2025-07-03,Assembly,"SJR 2 Cortese Senate Third Reading By Ortega",57,7,0,15,79
1990397,1565359,2025-05-05,Senate,"Senate 3rd Reading SR27 Gonzalez et al",38,0,0,2,40
1991546,1556128,2025-04-23,Assembly,"Do pass and be re-referred to the Committee on [Appropriations]",7,0,0,0,7
1991546,1567861,2025-05-07,Assembly,"Do pass",15,0,0,0,15
1991546,1569798,2025-05-12,Assembly,"AB 1510 Public Employment and Re Assembly Third Reading By McKINNOR",73,1,0,5,79
1991546,1595184,2025-06-25,Senate,"Do pass, but first be re-referred to the Committee on [Judiciary] with the recommendation: To Consent Calendar",5,0,0,0,5
1991546,1597950,2025-07-08,Senate,"Do pass, but first be re-referred to the Committee on [Appropriations] with the recommendation: To Consent Calendar",13,0,0,0,13
1991546,1600015,2025-08-25,Senate,"Consent Calendar 2nd AB1510 P. E. & R. (McKinnor)",37,0,0,3,40
1991546,1600808,2025-09-02,Assembly,"AB 1510 Public Employment and Re Concurrence in Senate Amendments By McKINNOR",76,1,0,2,79
1991548,1511484,2025-03-10,Assembly,"Be adopted. To Consent Calendar",9,0,0,2,11
1991548,1517621,2025-03-13,Assembly,"ACR 46 Soria Consent Calendar Second Day",68,0,0,12,80
1991548,1536820,2025-04-03,Senate,"Special Consent ACR46 Soria et al",39,0,0,1,40
1991549,1511462,2025-03-10,Assembly,"Be adopted. To third reading",9,0,0,2,11
1991549,1536816,2025-04-03,Senate,"Special Consent ACR47 Chen et al",39,0,0,1,40
1991550,1511493,2025-03-10,Assembly,"Be adopted. To third reading",9,0,0,2,11
1991550,1557479,2025-04-24,Senate,"Special Consent ACR48 DeMaio et al",37,0,0,3,40
1991551,1511419,2025-03-10,Assembly,"Be adopted. To Consent Calendar",9,0,0,2,11
1991551,1517614,2025-03-13,Assembly,"HR 22 Soria Consent Calendar Second Day Regular Session",68,0,0,12,80
1991552,1525425,2025-03-24,Assembly,"Be adopted. To third reading",11,0,0,0,11
1991553,1542791,2025-04-09,Senate,"Do pass as amended, but first amend, and re-refer to the Committee on [Judiciary] with the recommendation: To Consent Calendar",5,0,0,0,5
1991553,1564302,2025-05-01,Senate,"Consent Calendar 2nd SB853 L., P.E. & R. (Smallwood-Cuevas)",37,0,0,3,40
1991553,1595171,2025-06-25,Assembly,"Do pass and be re-referred to the Committee on [Appropriations] with recommendation: To Consent Calendar",7,0,0,0,7
1991553,1597422,2025-07-02,Assembly,"Do pass. To Consent Calendar",14,0,0,1,15
1991553,1600814,2025-09-02,Assembly,"SB 853 Labor, Public Employment Senate Third Reading By McKINNOR",77,1,0,1,79
1991553,1601962,2025-09-11,Senate,"Special Consent SB853 L., P.E. & R. (Smallwood-Cuevas)",40,0,0,0,40
1991554,1542790,2025-04-09,Senate,"Do pass as amended, but first amend, and re-refer to the Committee on [Appropriations] with the recommendation: To Consent Calendar",5,0,0,0,5
1991554,1564190,2025-05-01,Senate,"Consent Calendar 2nd SB854 L., P.E. & R. (Smallwood-Cuevas)",37,0,0,3,40
1991554,1598059,2025-07-09,Assembly,"Do pass and be re-referred to the Committee on [Appropriations] with recommendation: To Consent Calendar",15,0,0,2,17
1991554,1599777,2025-08-20,Assembly,"Do pass. To Consent Calendar",15,0,0,0,15
1991554,1600202,2025-08-28,Assembly,"SB 854 Labor, Public Employment and Retirement Consent Calendar Second Day Regular Session",74,0,0,5,79
1991555,1579243,2025-05-27,Senate,"Senate 3rd Reading SCR33 Padilla et al",39,0,0,1,40
1991555,1594089,2025-06-23,Assembly,"Be adopted. To Consent Calendar",10,0,0,1,11
1991555,1596037,2025-06-27,Assembly,"SCR 33 Padilla Consent Calendar Second Day Regular Session",75,0,0,4,79
1991556,1517830,2025-03-13,Senate,"Senate 3rd Reading SR28 Hurtado et al",36,0,0,4,40
1992995,1519115,2025-03-17,Assembly,"Be adopted. To third reading",10,0,0,1,11
1992995,1557502,2025-04-24,Senate,"Special Consent ACR49 DeMaio et al",37,0,0,3,40
1992996,1519128,2025-03-17,Assembly,"Be adopted. To third reading",10,0,0,1,11
1992996,1557505,2025-04-24,Senate,"Special Consent ACR50 Ahrens et al",37,0,0,3,40
1994335,1517616,2025-03-13,Assembly,"Be adopted. To third reading",9,0,0,2,11
1994336,1540958,2025-04-08,Senate,"Do pass, but first be re-referred to the Committee on [Military and Veterans Affairs] with the recommendation: To Consent Calendar",15,0,0,0,15
1994336,1559500,2025-04-28,Senate,"Do pass, but first be re-referred to the Committee on [Appropriations] with the recommendation: To Consent Calendar",4,0,0,1,5
1994336,1569927,2025-05-12,Senate,"Placed on suspense file",7,0,0,0,7
1994336,1577310,2025-05-23,Senate,"Do pass",6,0,0,1,7
1994336,1581790,2025-05-29,Senate,"Special Consent SB855 M.&V.A. (Archuleta)",38,0,0,2,40
1994336,1597270,2025-07-01,Assembly,"Do pass and be re-referred to the Committee on [Governmental Organization] with recommendation: To Consent Calendar",8,0,0,0,8
1994336,1598032,2025-07-09,Assembly,"Do pass and be re-referred to the Committee on [Appropriations] with recommendation: To Consent Calendar",22,0,0,0,22
1994336,1600540,2025-08-29,Assembly,"Do pass",15,0,0,0,15
1994336,1602203,2025-09-12,Assembly,"SB 855 Military and Veterans Aff Senate Third Reading By SCHIAVO",80,0,0,0,80
1994337,1557547,2025-04-24,Senate,"Senate 3rd Reading SCR34 Grove et al",38,0,0,2,40
1994337,1569872,2025-05-12,Assembly,"Be adopted. To Consent Calendar",7,0,0,4,11
1994337,1572419,2025-05-15,Assembly,"SCR 34 Grove Consent Calendar Second Day Regular Session",69,0,0,10,79
1994338,1523642,2025-03-20,Senate,"Senate 3rd Reading SCR35 Grayson",38,0,0,2,40
1994338,1552825,2025-04-21,Assembly,"Be adopted. To Consent Calendar",10,0,0,1,11
1994338,1557503,2025-04-24,Assembly,"SCR 35 Grayson Consent Calendar Second Day Regular Session",75,0,0,4,79
1994339,1530379,2025-03-28,Senate,"Senate 3rd Reading SR29 Arreguín et al",34,0,0,6,40
1997024,1563062,2025-04-30,Assembly,"Do pass as amended. To Consent Calendar",7,0,0,0,7
1997024,1569806,2025-05-12,Assembly,"AB 1511 Elections Consent Calendar Second Day By PELLERIN",77,0,0,2,79
1997024,1598394,2025-07-15,Senate,"Do pass and be ordered to the Consent Calendar",5,0,0,0,5
1997024,1601262,2025-09-08,Senate,"Assembly 3rd Reading AB1511 ELECTIONS (Pellerin) By Cervantes",39,0,0,1,40
1997026,1562825,2025-04-30,Assembly,"Do pass as amended. To Consent Calendar",7,0,0,0,7
1997026,1568628,2025-05-08,Assembly,"AB 1512 Elections Consent Calendar Second Day Regular Session",69,0,0,10,79
1997026,1598434,2025-07-15,Senate,"Do pass and be ordered to the Consent Calendar",5,0,0,0,5
1997026,1600006,2025-08-25,Senate,"Consent Calendar 2nd AB1512 ELECTIONS (Pellerin)",37,0,0,3,40
1997027,1562857,2025-04-30,Assembly,"Do pass. To Consent Calendar",7,0,0,0,7
1997027,1568612,2025-05-08,Assembly,"AB 1513 Elections Consent Calendar Second Day Regular Session",69,0,0,10,79
1997027,1598474,2025-07-15,Senate,"Do pass, but first be re-referred to the Committee on [Appropriations] with the recommendation: To Consent Calendar",5,0,0,0,5
1997027,1601285,2025-09-08,Senate,"Assembly 3rd Reading AB1513 ELECTIONS (Pellerin) By Cervantes",38,0,0,2,40
1997028,1557529,2025-04-23,Assembly,"Do pass. To Consent Calendar",7,0,0,0,7
1997028,1564169,2025-05-01,Assembly,"AB 1514 Labor and Employment Consent Calendar Second Day Regular Session",76,0,0,3,79
1997028,1598058,2025-07-09,Senate,"Do pass, but first be re-referred to the Committee on [Appropriations]",5,0,0,0,5
1997028,1599431,2025-08-18,Senate,"Placed on suspense file",7,0,0,0,7
1997028,1600705,2025-08-29,Senate,"Do pass",7,0,0,0,7
1997028,1601224,2025-09-08,Senate,"Assembly 3rd Reading AB1514 L. & E. (Ortega) By Smallwood-Cuevas",39,0,0,1,40
1997028,1601771,2025-09-10,Assembly,"With recommendation: That Senate amendments be concurred in",6,0,0,1,7
1997029,1557571,2025-04-23,Assembly,"Do pass and be re-referred to the Committee on [Appropriations] with recommendation: To Consent Calendar",7,0,0,0,7
1997029,1567891,2025-05-07,Assembly,"Do pass. To Consent Calendar",15,0,0,0,15
1997029,1572394,2025-05-15,Assembly,"AB 1515 Labor and Employment Consent Calendar Second Day Regular Session",69,0,0,10,79
1997029,1598039,2025-07-09,Senate,"Do pass, but first be re-referred to the Committee on [Appropriations]",4,1,0,0,5
1997029,1599540,2025-08-18,Senate,"Placed on suspense file",7,0,0,0,7
1997029,1600573,2025-08-29,Senate,"Do pass",5,2,0,0,7
1997030,1536785,2025-04-03,Senate,"Senate 3rd Reading SCR36 Seyarto et al",39,0,0,1,40
1997030,1552881,2025-04-21,Assembly,"Be adopted. To Consent Calendar",10,0,0,1,11
1997030,1557530,2025-04-24,Assembly,"SCR 36 Seyarto Consent Calendar Second Day Regular Session",75,0,0,4,79
1997031,1519125,2025-03-17,Senate,"Senate 3rd Reading SCR37 Wiener",37,0,0,3,40
1997031,1552844,2025-04-21,Assembly,"Be adopted. To Consent Calendar",10,0,0,1,11
1997031,1557487,2025-04-24,Assembly,"SCR 37 Wiener Consent Calendar Second Day Regular Session",75,0,0,4,79
1997032,1523691,2025-03-20,Senate,"Senate 3rd Reading SCR38 Grove et al",38,0,0,2,40
1997032,1552860,2025-04-21,Assembly,"Be adopted. To Consent Calendar",10,0,0,1,11
1997032,1557520,2025-04-24,Assembly,"SCR 38 Grove Consent Calendar Second Day Regular Session",75,0,0,4,79
2000329,1517607,2025-03-13,Assembly,"Be adopted. To third reading",9,0,0,2,11
2000329,1536797,2025-04-03,Senate,"Special Consent ACR51 Haney et al",39,0,0,1,40
2000330,1554618,2025-04-22,Senate,"Do pass, but first be re-referred to the Committee on [Appropriations] with the recommendation: To Consent Calendar",6,0,0,1,7
2000330,1568598,2025-05-08,Senate,"Consent Calendar 2nd SB856 N.R. & W. (Limón)",36,0,0,4,40
2000330,1597757,2025-07-07,Assembly,"Do pass and be re-referred to the Committee on [Appropriations] with recommendation: To Consent Calendar",14,0,0,0,14
2000330,1598747,2025-07-16,Assembly,"Do pass. To Consent Calendar",13,0,0,2,15
2000330,1599865,2025-08-21,Assembly,"SB 856 Natural Resources and Water Consent Calendar Second Day Regular Session",77,0,0,2,79
2005483,1562783,2025-04-29,Senate,"Do pass, but first be re-referred to the Committee on [Appropriations] with the recommendation: To Consent Calendar",6,0,0,0,6
2005483,1572437,2025-05-15,Senate,"Consent Calendar 2nd SB857 PUB. S. (Arreguín)",34,0,0,6,40
2005483,1598581,2025-07-15,Assembly,"Do pass and be re-referred to the Committee on [Appropriations] with recommendation: To Consent Calendar",9,0,0,0,9
2005483,1599744,2025-08-20,Assembly,"Do pass. To Consent Calendar",15,0,0,0,15
2005483,1600232,2025-08-28,Assembly,"SB 857 Public Safety Consent Calendar Second Day Regular Session",74,0,0,5,79
2005483,1601959,2025-09-11,Senate,"Special Consent SB857 PUB. S. (Arreguín)",40,0,0,0,40
2005484,1556026,2025-04-23,Senate,"Do pass, but first be re-referred to the Committee on [Judiciary] with the recommendation: To Consent Calendar",7,0,0,0,7
2005484,1567884,2025-05-06,Senate,"Do pass and be ordered to the Consent Calendar",12,0,0,1,13
2005484,1572412,2025-05-15,Senate,"Consent Calendar 2nd SB858 L. GOV. (Durazo)",34,0,0,6,40
2005484,1598867,2025-07-16,Assembly,"Do pass. To Consent Calendar",10,0,0,0,10
2005484,1599850,2025-08-21,Assembly,"SB 858 L.Gov. Consent Calendar Second Day Regular Session",77,0,0,2,79
2005484,1600423,2025-08-29,Senate,"Special Consent SB858 L. GOV. (Durazo)",37,0,0,3,40
2007014,1554592,2025-04-21,Assembly,"Do pass and be re-referred to the Committee on [Appropriations] with recommendation: To Consent Calendar",7,0,0,0,7
2007014,1567928,2025-05-07,Assembly,"Do pass. To Consent Calendar",15,0,0,0,15
2007014,1572442,2025-05-15,Assembly,"AB 1516 REV. & TAX. Consent Calendar Second Day Regular Session",69,0,0,10,79
2007014,1595208,2025-06-25,Senate,"Do pass, but first be re-referred to the Committee on [Appropriations] with the recommendation: To Consent Calendar",5,0,0,0,5
2007014,1598161,2025-07-10,Senate,"Consent Calendar 2nd AB1516 REV. & TAX. (Gipson)",37,0,0,3,40
2007015,1554619,2025-04-21,Assembly,"Do pass and be re-referred to the Committee on [Appropriations] with recommendation: To Consent Calendar",7,0,0,0,7
2007016,1554599,2025-04-21,Assembly,"Do pass and be re-referred to the Committee on [Appropriations] with recommendation: To Consent Calendar",7,0,0,0,7
2007016,1562779,2025-04-30,Assembly,"Do pass. To Consent Calendar",14,0,0,1,15
2007016,1568644,2025-05-08,Assembly,"AB 1518 REV. & TAX. Consent Calendar Second Day Regular Session",69,0,0,10,79
2007016,1595135,2025-06-25,Senate,"Do pass, but first be re-referred to the Committee on [Appropriations] with the recommendation: To Consent Calendar",5,0,0,0,5
2007016,1598157,2025-07-10,Senate,"Consent Calendar 2nd AB1518 REV. & TAX. (Gipson)",37,0,0,3,40
2007017,1554453,2025-04-21,Assembly,"Do pass. To Consent Calendar",7,0,0,0,7
2007017,1559367,2025-04-28,Assembly,"AB 1519 Revenue and Taxation Consent Calendar Second Day",76,0,0,3,79
2007018,1562763,2025-04-29,Assembly,"Do pass and be re-referred to the Committee on [Appropriations] with recommendation: To Consent Calendar",13,0,0,0,13
2007018,1577377,2025-05-23,Assembly,"Do pass",14,0,0,1,15
2007018,1584261,2025-06-03,Assembly,"AB 1520 W., P. & W. Assembly Third Reading By PAPAN",79,0,0,0,79
2007018,1597952,2025-07-08,Senate,"Do pass as amended, but first amend, and re-refer to the Committee on [Appropriations] with the recommendation: To Consent Calendar",7,0,0,0,7
2007018,1600014,2025-08-25,Senate,"Placed on suspense file",6,0,0,1,7
2007018,1600260,2025-08-29,Senate,"Do pass",7,0,0,0,7
2007018,1601636,2025-09-09,Senate,"Assembly 3rd Reading AB1520 W., P., & W. (Papan) By Limón",40,0,0,0,40
2007019,1554504,2025-04-22,Senate,"Do pass, but first be re-referred to the Committee on [Appropriations] with the recommendation: To Consent Calendar",14,0,0,1,15
2007019,1568649,2025-05-08,Senate,"Consent Calendar 2nd SB859 G.O. (Padilla)",36,0,0,4,40
2007019,1598048,2025-07-09,Assembly,"Do pass and be re-referred to the Committee on [Appropriations] with recommendation: To Consent Calendar",22,0,0,0,22
2007019,1599740,2025-08-20,Assembly,"Do pass. To Consent Calendar",15,0,0,0,15
2007019,1600226,2025-08-28,Assembly,"SB 859 Governmental Organization Consent Calendar Second Day Regular Session",74,0,0,5,79
2007020,1554437,2025-04-22,Senate,"Do pass, but first be re-referred to the Committee on [Appropriations] with the recommendation: To Consent Calendar",14,0,0,1,15
2007020,1568632,2025-05-08,Senate,"Consent Calendar 2nd SB860 G.O. (Padilla)",36,0,0,4,40
2007020,1595140,2025-06-25,Assembly,"Do pass and be re-referred to the Committee on [Appropriations] with recommendation: To Consent Calendar",22,0,0,0,22
2007020,1597478,2025-07-02,Assembly,"Do pass. To Consent Calendar",14,0,0,1,15
2007020,1598168,2025-07-10,Assembly,"SB 860 Governmental Organization Consent Calendar Second Day Regular Session",72,0,0,7,79
2007021,1552936,2025-04-21,Senate,"Do pass, but first be re-referred to the Committee on [Judiciary] with the recommendation: To Consent Calendar",11,0,0,0,11
2007021,1562869,2025-04-29,Senate,"Do pass, but first be re-referred to the Committee on [Appropriations] with the recommendation: To Consent Calendar",13,0,0,0,13
2007021,1577695,2025-05-23,Senate,"Consent Calendar 2nd SB861 B., P. & E.D. (Ashby)",36,0,0,4,40
2007021,1597883,2025-07-08,Assembly,"Do pass and be re-referred to the Committee on [Appropriations] with recommendation: To Consent Calendar",17,0,0,1,18
2007021,1598684,2025-07-16,Assembly,"Do pass. To Consent Calendar",13,0,0,2,15
2007021,1602212,2025-09-12,Senate,"Unfinished Business SB861 B., P. & E.D. (Ashby) Concurrence",34,0,0,6,40
2007021,1602213,2025-09-13,Assembly,"SB 861 Business, Professions and Senate Third Reading By FLORA",79,0,0,1,80
2009611,1525413,2025-03-24,Assembly,"Be adopted. To Consent Calendar",11,0,0,0,11
2009611,1530396,2025-03-28,Assembly,"ACR 53 Bonta Consent Calendar Second Day Regular Session",61,0,0,19,80
2009611,1557526,2025-04-24,Senate,"Special Consent ACR53 Bonta et al",37,0,0,3,40
2009612,1594091,2025-06-23,Assembly,"Be adopted. To Consent Calendar",10,0,0,1,11
2009612,1595999,2025-06-27,Assembly,"ACR 54 Ta Consent Calendar Second Day",75,0,0,4,79
2009612,1598871,2025-07-17,Senate,"Special Consent ACR54 Ta et al",35,0,0,5,40
2009613,1564273,2025-04-30,Senate,"Do pass, but first be re-referred to the Committee on [Appropriations] with the recommendation: To Consent Calendar",11,0,0,0,11
2009613,1569880,2025-05-12,Senate,"Placed on suspense file",7,0,0,0,7
2009613,1577336,2025-05-23,Senate,"Do pass",6,0,0,1,7
2009613,1581702,2025-05-29,Senate,"Special Consent SB862 HEALTH (Menjivar)",38,0,0,2,40
2009613,1594632,2025-06-24,Assembly,"Do pass as amended and be re-referred to the Committee on [Appropriations]",15,0,0,1,16
2009613,1598773,2025-07-16,Assembly,"Do pass as amended",13,0,0,2,15
2009613,1600954,2025-09-03,Assembly,"SB 862 Health Senate Third Reading By BONTA",79,0,0,0,79
2009613,1601268,2025-09-08,Senate,"Unfinished Business SB862 HEALTH (Menjivar) Concurrence",39,0,0,1,40
2009614,1525424,2025-03-24,Senate,"Senate 3rd Reading SCR39 Durazo et al",35,0,0,5,40
2009614,1552905,2025-04-21,Assembly,"Be adopted. To third reading",9,1,0,1,11
2009614,1565316,2025-05-05,Assembly,"SCR 39 Durazo Senate Third Reading By Quirk-Silva",69,0,0,10,79
2009615,1536830,2025-04-03,Senate,"Senate 3rd Reading SCR40 Blakespear et al",39,0,0,1,40
2009615,1552824,2025-04-21,Assembly,"Be adopted. To Consent Calendar",10,0,0,1,11
2009615,1557568,2025-04-24,Assembly,"SCR 40 Blakespear Consent Calendar Second Day Regular Session",75,0,0,4,79
2009616,1525468,2025-03-24,Senate,"Senate 3rd Reading SCR41 Ashby et al",35,0,0,5,40
2009616,1552893,2025-04-21,Assembly,"Be adopted. To Consent Calendar",10,0,0,1,11
2009616,1557477,2025-04-24,Assembly,"SCR 41 Ashby Consent Calendar Second Day Regular Session",75,0,0,4,79
2010618,1554587,2025-04-22,Assembly,"Do pass and be re-referred to the Committee on [Appropriations]",9,0,0,3,12
2010618,1577373,2025-05-23,Assembly,"Do pass as amended",11,0,0,4,15
2010618,1583485,2025-06-02,Assembly,"AB 1521 Judiciary Assembly Third Reading By KALRA",63,0,0,16,79
2010618,1597512,2025-07-01,Senate,"Do pass as amended, but first amend, and re-refer to the Committee on [Banking and Financial Institutions]",11,0,0,2,13
2010618,1599487,2025-08-18,Senate,"Placed on suspense file",7,0,0,0,7
2010618,1600345,2025-08-29,Senate,"Do pass",7,0,0,0,7
2010618,1601290,2025-09-08,Senate,"Assembly 3rd Reading AB1521 JUD. (Kalra) By Umberg",35,0,0,5,40
2010619,1554622,2025-04-22,Assembly,"Do pass",9,3,0,0,12
2010619,1565336,2025-05-05,Assembly,"AB 1522 JUD. Third Reading Urgency By KALRA",60,17,0,2,79
2010620,1566714,2025-05-06,Assembly,"Do pass",12,0,0,0,12
2010620,1573570,2025-05-19,Assembly,"AB 1523 JUD. Assembly Third Reading By KALRA",74,0,0,5,79
2010620,1591883,2025-06-17,Senate,"Do pass",9,0,0,4,13
2010620,1600817,2025-09-02,Senate,"Assembly 3rd Reading AB1523 JUD. (Kalra) By Becker",40,0,0,0,40
2010620,1600899,2025-09-03,Assembly,"AB 1523 Judiciary Concurrence in Senate Amendments By KALRA",75,0,0,4,79
2010621,1554510,2025-04-22,Assembly,"Do pass as amended, and be re-referred to the Committee on [Appropriations] with recommendation: To Consent Calendar",12,0,0,0,12
2010621,1577917,2025-05-23,Assembly,"Do pass",14,0,0,1,15
2010621,1583534,2025-06-02,Assembly,"AB 1524 Judiciary Assembly Third Reading By KALRA",79,0,0,0,79
2010621,1597492,2025-07-01,Senate,"Do pass, but first be re-referred to the Committee on [Appropriations] with the recommendation: To Consent Calendar",13,0,0,0,13
2010621,1598277,2025-07-14,Senate,"Placed on suspense file",7,0,0,0,7
2010621,1600396,2025-08-29,Senate,"Do pass as amended",7,0,0,0,7
2010621,1601902,2025-09-11,Senate,"Special Consent AB1524 JUD. (Kalra)",40,0,0,0,40
2010621,1602187,2025-09-12,Assembly,"AB 1524 JUD. Concurrence in Senate Amendments By KALRA",79,0,0,1,80
2010622,1554434,2025-04-22,Assembly,"Do pass. To Consent Calendar",12,0,0,0,12
2010622,1559398,2025-04-28,Assembly,"AB 1525 Judiciary Consent Calendar Second Day Regular Session",76,0,0,3,79
2010622,1597932,2025-07-08,Senate,"Do pass",11,1,0,1,13
2010622,1601621,2025-09-09,Senate,"Assembly 3rd Reading AB1525 JUD. (Kalra) By Reyes",30,10,0,0,40
2010623,1556020,2025-04-23,Assembly,"Do pass. To Consent Calendar",22,0,0,0,22
2010623,1564197,2025-05-01,Assembly,"AB 1526 Governmental Organization Consent Calendar Second Day Regular Session",76,0,0,3,79
2010623,1597899,2025-07-08,Senate,"Do pass and be ordered to the Consent Calendar",15,0,0,0,15
2010624,1556121,2025-04-23,Assembly,"Do pass. To Consent Calendar",22,0,0,0,22
2010624,1564167,2025-05-01,Assembly,"AB 1527 Governmental Organization Consent Calendar Second Day Regular Session",76,0,0,3,79
2010624,1601807,2025-09-10,Senate,"Assembly 3rd Reading AB1527 Soria et al. By Hurtado Urgency Clause",40,0,0,0,40
2011456,1525443,2025-03-24,Assembly,"Be adopted. To third reading",11,0,0,0,11
2011456,1557483,2025-04-24,Senate,"Special Consent ACR55 Jeff Gonzalez et al",37,0,0,3,40
2011457,1538908,2025-04-07,Assembly,"Be adopted. To third reading",7,0,0,4,11
2011457,1572422,2025-05-15,Senate,"Special Consent ACR56 Michelle Rodriguez",34,0,0,6,40
2011458,1538902,2025-04-07,Assembly,"Be adopted. To Consent Calendar",7,0,0,4,11
2011458,1544996,2025-04-10,Assembly,"ACR 57 Patterson Consent Calendar Second Day Regular Session",67,0,0,12,79
2011458,1572400,2025-05-15,Senate,"Special Consent ACR57 Patterson et al",34,0,0,6,40
2011459,1538869,2025-04-07,Assembly,"Be adopted. To third reading",7,0,0,4,11
2011460,1559403,2025-04-28,Assembly,"Be adopted. To third reading",9,0,0,2,11
2011461,1556190,2025-04-23,Senate,"Do pass and be ordered to the Consent Calendar",5,0,0,0,5
2011461,1564199,2025-05-01,Senate,"Consent Calendar 2nd SB863 REV. & TAX. (McNerney)",37,0,0,3,40
2011461,1597905,2025-07-07,Assembly,"Do pass. To Consent Calendar",7,0,0,0,7
2011461,1598300,2025-07-14,Assembly,"SB 863 Rev. & Tax. Consent Calendar Second Day Regular Session",77,0,0,2,79
2011461,1601098,2025-09-04,Assembly,"SB 863 Revenue and Taxation Senate Third Reading By GIPSON",78,0,0,1,79
2011461,1601232,2025-09-08,Senate,"Unfinished Business SB863 REV. & TAX. (McNerney) Concurrence",39,0,0,1,40
2011462,1552929,2025-04-21,Senate,"Senate 3rd Reading SCR42 Umberg",36,0,0,4,40
2011462,1573612,2025-05-19,Assembly,"Be adopted. To Consent Calendar",6,0,0,5,11
2011462,1577218,2025-05-23,Assembly,"SCR 42 Umberg Consent Calendar Second Day Regular Session",71,0,0,8,79
2011463,1572401,2025-05-15,Senate,"Special Consent SR30 Seyarto",34,0,0,6,40
2012250,1566684,2025-05-06,Assembly,"Be adopted. To third reading",9,0,0,3,12
2012250,1573593,2025-05-19,Assembly,"AJR 5 Lee Assembly Third Reading",61,1,0,17,79
2012250,1595175,2025-06-24,Senate,"Be adopted. Ordered to third reading",11,0,0,2,13
2012250,1600819,2025-09-02,Senate,"Assembly 3rd Reading AJR5 Lee et al. By Gonzalez",30,0,0,10,40
2012250,1601078,2025-09-04,Assembly,"AJR 5 Lee Concurrence in Senate Amendments",60,0,0,19,79
2012251,1554482,2025-04-22,Assembly,"Be adopted. To Consent Calendar",8,0,0,0,8
2012251,1557501,2025-04-24,Assembly,"HR 27 Gipson Consent Calendar Second Day Regular Session",75,0,0,4,79
2012252,1525427,2025-03-24,Assembly,"Be adopted. To third reading",11,0,0,0,11
2012253,1554479,2025-04-22,Senate,"Do pass, but first be re-referred to the Committee on [Appropriations] with the recommendation: To Consent Calendar",14,0,0,1,15
2012253,1568621,2025-05-08,Senate,"Consent Calendar 2nd SB864 G.O. (Padilla)",36,0,0,4,40
2012253,1595141,2025-06-25,Assembly,"Do pass and be re-referred to the Committee on [Appropriations] with recommendation: To Consent Calendar",22,0,0,0,22
2012253,1597460,2025-07-02,Assembly,"Do pass. To Consent Calendar",14,0,0,1,15
2012253,1601470,2025-09-09,Assembly,"SB 864 Padilla Third Reading Urgency By Ramos",79,0,0,1,80
2012253,1601920,2025-09-11,Senate,"Unfinished Business SB864 Padilla et al. Urgency Clause Concurrence",40,0,0,0,40
2013760,1581752,2025-05-29,Assembly,"Be adopted. To Consent Calendar",6,0,0,5,11
2013760,1584352,2025-06-03,Assembly,"ACR 58 Sharp-Collins Consent Calendar Second Day",77,0,0,2,79
2013760,1593163,2025-06-19,Senate,"Special Consent ACR58 Sharp-Collins et al",35,0,0,5,40
2013761,1552889,2025-04-21,Senate,"Senate 3rd Reading SCR43 Archuleta",36,0,0,4,40
2013761,1573575,2025-05-19,Assembly,"Be adopted. To Consent Calendar",6,0,0,5,11
2013761,1577540,2025-05-23,Assembly,"SCR 43 Archuleta Consent Calendar Second Day Regular Session",71,0,0,8,79
2013762,1533484,2025-04-01,Senate,"Senate 3rd Reading SCR44 Valladares",39,0,0,1,40
2013762,1552924,2025-04-21,Assembly,"Be adopted. To Consent Calendar",10,0,0,1,11
2013762,1557555,2025-04-24,Assembly,"SCR 44 Valladares Consent Calendar Second Day Regular Session",75,0,0,4,79
2013763,1557581,2025-04-24,Senate,"Senate 3rd Reading SCR45 Wahab et al",37,0,0,3,40
2013763,1573510,2025-05-19,Assembly,"Be adopted. To Consent Calendar",6,0,0,5,11
2013763,1577140,2025-05-23,Assembly,"SCR 45 Wahab Consent Calendar Second Day Regular Session",71,0,0,8,79
2013764,1559470,2025-04-28,Senate,"Senate 3rd Reading SCR46 Wiener et al",37,0,0,3,40
2013764,1594048,2025-06-23,Assembly,"Be adopted. To Consent Calendar",10,0,0,1,11
2013764,1596005,2025-06-27,Assembly,"SCR 46 Wiener Consent Calendar Second Day Regular Session",75,0,0,4,79
2013765,1564240,2025-05-01,Senate,"Senate 3rd Reading SR31 Wahab et al",37,0,0,3,40
2014760,1562773,2025-04-29,Assembly,"Do pass and be re-referred to the Committee on [Appropriations] with recommendation: To Consent Calendar",7,0,0,0,7
2014760,1567887,2025-05-07,Assembly,"Do pass. To Consent Calendar",15,0,0,0,15
2014760,1572436,2025-05-15,Assembly,"AB 1528 Human Services Consent Calendar Second Day Regular Session",69,0,0,10,79
2014761,1562864,2025-04-30,Assembly,"Do pass and be re-referred to the Committee on [Appropriations] with recommendation: To Consent Calendar",10,0,0,2,12
2014761,1567867,2025-05-07,Assembly,"Do pass. To Consent Calendar",15,0,0,0,15
2014761,1572396,2025-05-15,Assembly,"AB 1529 Housing and Community Development Consent Calendar Second Day Regular Session",69,0,0,10,79
2014761,1594569,2025-06-24,Senate,"Do pass, but first be re-referred to the Committee on [Local Government] with the recommendation: To Consent Calendar",11,0,0,0,11
2014761,1598642,2025-07-16,Senate,"Do pass, but first be re-referred to the Committee on [Appropriations] with the recommendation: To Consent Calendar",7,0,0,0,7
2014761,1601761,2025-09-10,Senate,"Assembly 3rd Reading AB1529 H. & C.D. (Haney) By Wahab",40,0,0,0,40
2014762,1552866,2025-04-21,Senate,"Senate 3rd Reading SCR47 Niello",36,0,0,4,40
2014762,1565309,2025-05-05,Assembly,"Be adopted. To Consent Calendar",9,0,0,2,11
2014762,1568620,2025-05-08,Assembly,"SCR 47 Niello Consent Calendar Second Day Regular Session",69,0,0,10,79
2015520,1561044,2025-04-28,Assembly,"Do pass and be re-referred to the Committee on [Appropriations] with recommendation: To Consent Calendar",7,0,0,0,7
2015520,1577792,2025-05-23,Assembly,"Do pass as amended",11,0,0,4,15
2015520,1585005,2025-06-04,Assembly,"AB 1530 Emergency Management Assembly Third Reading By RANSOM",79,0,0,0,79
2015520,1597917,2025-07-08,Senate,"Do pass, but first be re-referred to the Committee on [Appropriations] with the recommendation: To Consent Calendar",15,0,0,0,15
2015520,1599645,2025-08-18,Senate,"Placed on suspense file",7,0,0,0,7
2015521,1561112,2025-04-28,Assembly,"Do pass and be re-referred to the Committee on [Insurance]",7,0,0,0,7
2015521,1562837,2025-04-30,Assembly,"Do pass and be re-referred to the Committee on [Appropriations] with recommendation: To Consent Calendar",16,0,0,1,17
2015521,1571617,2025-05-14,Assembly,"Do pass. To Consent Calendar",15,0,0,0,15
2015521,1577176,2025-05-23,Assembly,"AB 1531 E.M. Consent Calendar Second Day Regular Session",71,0,0,8,79
2015521,1594573,2025-06-24,Senate,"Do pass, but first be re-referred to the Committee on [Natural Resources and Water] with the recommendation: To Consent Calendar",15,0,0,0,15
2015521,1597901,2025-07-08,Senate,"Do pass as amended, but first amend, and re-refer to the Committee on [Appropriations] with the recommendation: To Consent Calendar",7,0,0,0,7
2015521,1599423,2025-08-18,Senate,"Placed on suspense file",7,0,0,0,7
2015521,1600488,2025-08-29,Senate,"Do pass",7,0,0,0,7
2015521,1601274,2025-09-08,Senate,"Assembly 3rd Reading AB1531 E.M. (Ransom) By Padilla",39,0,0,1,40
2015523,1542897,2025-04-09,Assembly,"Be adopted. To third reading",8,0,0,0,8
2015523,1565263,2025-05-05,Assembly,"AJR 6 Aguiar-Curry Assembly Third Reading",77,0,0,2,79
2015523,1597250,2025-07-01,Senate,"Be adopted. Ordered to third reading",5,0,0,0,5
2015524,1545029,2025-04-09,Assembly,"Be adopted. To third reading",9,0,0,0,9
2015524,1582229,2025-05-29,Assembly,"AJR 7 Addis Assembly Third Reading",72,0,0,7,79
2015524,1598618,2025-07-16,Senate,"Be adopted and be ordered to the Consent Calendar",7,0,0,0,7
2015524,1600038,2025-08-25,Senate,"Consent Calendar 2nd AJR7 Addis et al",37,0,0,3,40
2015525,1557532,2025-04-24,Senate,"Senate 3rd Reading SCR48 Cervantes et al",37,0,0,3,40
2015525,1598257,2025-07-14,Assembly,"Be adopted. To Consent Calendar",10,0,0,1,11
2015525,1598860,2025-07-17,Assembly,"SCR 48 Cervantes Consent Calendar Second Day Regular Session",75,0,0,4,79
2015525,1600012,2025-08-25,Senate,"Special Consent SCR48 Cervantes et al",37,0,0,3,40
2015526,1538925,2025-04-07,Senate,"Senate 3rd Reading SCR49 Wahab",36,0,0,4,40
2015526,1573581,2025-05-19,Assembly,"Be adopted. To Consent Calendar",6,0,0,5,11
2015526,1577757,2025-05-23,Assembly,"SCR 49 Wahab Consent Calendar Second Day Regular Session",71,0,0,8,79
2015527,1554475,2025-04-22,Senate,"Be adopted. Ordered to third reading",4,0,0,3,7
2015527,1579294,2025-05-27,Senate,"Senate 3rd Reading SCR50 Stern",29,0,0,11,40
2015527,1594050,2025-06-23,Assembly,"Be adopted. To third reading",11,0,0,3,14
2015528,1556111,2025-04-22,Senate,"Be adopted as amended",11,0,0,2,13
2015528,1598175,2025-07-10,Senate,"Senate 3rd Reading SR32 Wahab",27,0,0,13,40
2016196,1535045,2025-04-02,Assembly,"Be adopted. To third reading",7,0,0,0,7
2016196,1600197,2025-08-28,Assembly,"AJR 8 Haney Assembly Third Reading",57,8,0,14,79
2016197,1565245,2025-05-05,Senate,"Senate 3rd Reading SCR51 Laird",38,0,0,2,40
2016197,1594088,2025-06-23,Assembly,"Be adopted. To Consent Calendar",10,0,0,1,11
2016197,1595976,2025-06-27,Assembly,"SCR 51 Laird Consent Calendar Second Day Regular Session",75,0,0,4,79
2016198,1552890,2025-04-21,Senate,"Be adopted and be ordered to the Consent Calendar",5,0,0,0,5
2016198,1565289,2025-05-05,Senate,"Senate 3rd Reading SJR3 Arreguín et al",38,0,0,2,40
2016198,1591854,2025-06-17,Assembly,"Be adopted. To third reading",7,0,0,0,7
2016198,1598204,2025-07-14,Assembly,"SJR 3 Arreguín Senate Third Reading By Calderon",72,0,0,7,79
2016652,1562839,2025-04-30,Assembly,"Do pass and be re-referred to the Committee on [Utilities and Energy]",8,0,0,2,10
2016652,1564157,2025-04-30,Assembly,"Do pass as amended and be re-referred to the Committee on [Appropriations]",17,0,0,1,18
2016652,1571591,2025-05-14,Assembly,"Do pass",11,0,0,4,15
2016652,1573599,2025-05-19,Assembly,"AB 1532 C. & C. Assembly Third Reading By BOERNER",65,1,0,13,79
2016652,1597258,2025-07-01,Senate,"Do pass as amended, but first amend, and re-refer to the Committee on [Transportation]",15,0,0,2,17
2016652,1597875,2025-07-08,Senate,"Do pass, but first be re-referred to the Committee on [Appropriations]",15,0,0,0,15
2016652,1600069,2025-08-25,Senate,"Placed on suspense file",6,0,0,1,7
2016652,1600596,2025-08-29,Senate,"Do pass as amended",7,0,0,0,7
2016652,1601239,2025-09-08,Senate,"Assembly 3rd Reading AB1532 C. & C. (Boerner) By McNerney Urgency Clause",39,0,0,1,40
2016653,1552942,2025-04-21,Assembly,"Be adopted. To third reading",10,0,0,1,11
2016653,1572377,2025-05-15,Senate,"Special Consent ACR59 Addis et al",34,0,0,6,40
2016654,1562993,2025-04-29,Assembly,"Be adopted. To third reading",9,0,0,0,9
2016654,1577394,2025-05-23,Senate,"Special Consent ACR60 Pacheco et al",36,0,0,4,40
2016655,1538989,2025-04-07,Assembly,"Be adopted. To Consent Calendar",7,0,0,4,11
2016655,1544982,2025-04-10,Assembly,"HR 29 Gabriel Consent Calendar Second Day Regular Session",67,0,0,12,79
2016656,1557562,2025-04-24,Senate,"Senate 3rd Reading SCR52 Ochoa Bogh et al",38,0,0,2,40
2016656,1594085,2025-06-23,Assembly,"Be adopted. To Consent Calendar",10,0,0,1,11
2016656,1596023,2025-06-27,Assembly,"SCR 52 Ochoa Bogh Consent Calendar Second Day Regular Session",75,0,0,4,79
2016658,1552935,2025-04-21,Senate,"Senate 3rd Reading SR33 Pérez et al",36,0,0,4,40
2016659,1538903,2025-04-07,Senate,"Senate 3rd Reading SR34 Choi et al",36,0,0,4,40
2016660,1552849,2025-04-21,Senate,"Senate 3rd Reading SR35 Gonzalez et al",36,0,0,4,40
2018617,1538887,2025-04-07,Assembly,"Be adopted. To Consent Calendar",7,0,0,4,11
2018617,1545009,2025-04-10,Assembly,"ACR 61 Stefani Consent Calendar Second Day Regular Session",67,0,0,12,79
2018618,1565232,2025-05-05,Assembly,"Be adopted. To third reading",9,0,0,2,11
2018618,1593181,2025-06-19,Senate,"Special Consent ACR62 Hart et al",35,0,0,5,40
2018619,1538886,2025-04-07,Assembly,"Be adopted. To third reading",7,0,0,4,11
2018620,1552853,2025-04-21,Senate,"Senate 3rd Reading SCR54 Grayson et al",36,0,0,4,40
2018620,1597763,2025-07-07,Assembly,"Be adopted. To Consent Calendar",16,0,0,0,16
2018620,1598152,2025-07-10,Assembly,"SCR 54 Grayson Consent Calendar Second Day Regular Session",72,0,0,7,79
2018621,1559364,2025-04-28,Senate,"Senate 3rd Reading SCR55 Niello",39,0,0,1,40
2018621,1569847,2025-05-12,Assembly,"Be adopted. To Consent Calendar",7,0,0,4,11
2018621,1572438,2025-05-15,Assembly,"SCR 55 Niello Consent Calendar Second Day Regular Session",69,0,0,10,79
2018622,1563129,2025-04-30,Senate,"Be adopted as amended",6,2,0,0,8
2018622,1579293,2025-05-27,Senate,"Senate 3rd Reading SR36 Cortese et al",29,9,0,2,40
2019483,1577812,2025-05-23,Senate,"Senate 3rd Reading SCR56 Archuleta et al",36,0,0,4,40
2019483,1594087,2025-06-23,Assembly,"Be adopted. To Consent Calendar",10,0,0,1,11
2019483,1596010,2025-06-27,Assembly,"SCR 56 Archuleta Consent Calendar Second Day Regular Session",75,0,0,4,79
2019484,1544958,2025-04-10,Senate,"Senate 3rd Reading SCR57 Reyes et al. By Limón",33,0,0,7,40
2019484,1552836,2025-04-21,Assembly,"Be adopted. To third reading",10,0,0,1,11
2019484,1559414,2025-04-28,Assembly,"SCR 57 Reyes Senate Third Reading By Carrillo",73,0,0,6,79
2020167,1591890,2025-06-17,Assembly,"Be adopted. To Consent Calendar",10,0,0,3,13
2020167,1596788,2025-06-30,Assembly,"AJR 9 Wallis Assembly Third Reading",76,0,0,3,79
2020167,1598755,2025-07-16,Senate,"Be adopted. Ordered to third reading",7,0,0,0,7
2020168,1557554,2025-04-24,Senate,"Senate 3rd Reading SR37 Gonzalez et al",38,0,0,2,40
2021330,1569887,2025-05-12,Senate,"Senate 3rd Reading SCR58 Wahab et al",35,0,0,5,40
2021330,1594051,2025-06-23,Assembly,"Be adopted. To Consent Calendar",10,0,0,1,11
2021330,1596000,2025-06-27,Assembly,"SCR 58 Wahab Consent Calendar Second Day Regular Session",75,0,0,4,79
2021331,1552939,2025-04-21,Senate,"Senate 3rd Reading SCR59 Allen et al",36,0,0,4,40
2021331,1573579,2025-05-19,Assembly,"Be adopted. To Consent Calendar",6,0,0,5,11
2021331,1577147,2025-05-23,Assembly,"SCR 59 Allen Consent Calendar Second Day Regular Session",71,0,0,8,79
2021825,1565236,2025-05-05,Assembly,"Be adopted. To third reading",9,0,0,2,11
2021825,1593182,2025-06-19,Senate,"Special Consent ACR63 Tangipa et al",35,0,0,5,40
2021826,1552906,2025-04-21,Assembly,"Be adopted. To Consent Calendar",10,0,0,1,11
2021826,1557545,2025-04-24,Assembly,"ACR 64 Macedo Consent Calendar Second Day Regular Session",75,0,0,4,79
2021826,1572441,2025-05-15,Senate,"Special Consent ACR64 Macedo et al",34,0,0,6,40
2022411,1552821,2025-04-21,Assembly,"Be adopted. To third reading",10,0,0,1,11
2022412,1552886,2025-04-21,Assembly,"Be adopted. To third reading",10,0,0,1,11
2022413,1557538,2025-04-24,Senate,"Senate 3rd Reading SCR60 Cortese",38,0,0,2,40
2022413,1594041,2025-06-23,Assembly,"Be adopted. To Consent Calendar",10,0,0,1,11
2022413,1595983,2025-06-27,Assembly,"SCR 60 Cortese Consent Calendar Second Day Regular Session",75,0,0,4,79
2022414,1573539,2025-05-19,Senate,"Senate 3rd Reading SR38 Padilla et al",29,0,0,11,40
2023028,1559408,2025-04-28,Assembly,"Be adopted. To third reading",9,0,0,2,11
2023028,1593168,2025-06-19,Senate,"Special Consent ACR65 Ward et al",35,0,0,5,40
2023029,1599646,2025-08-18,Senate,"Senate 3rd Reading SCR61 Archuleta et al",37,0,0,3,40
2023029,1600209,2025-08-28,Assembly,"Be adopted. To Consent Calendar",9,0,0,2,11
2023029,1600829,2025-09-02,Assembly,"SCR 61 Archuleta Consent Calendar Second Day Regular Session",78,0,0,1,79
2023030,1562959,2025-04-30,Senate,"Be adopted. Ordered to third reading",5,1,0,1,7
2023030,1572390,2025-05-15,Senate,"Senate 3rd Reading SJR4 Laird et al",26,6,0,8,40
2023030,1597923,2025-07-08,Assembly,"Be adopted. To third reading",7,2,0,1,10
2023030,1600892,2025-09-03,Assembly,"SJR 4 Laird Senate Third Reading By Fong",61,9,0,9,79
2025383,1569894,2025-05-12,Assembly,"Be adopted. To third reading",7,0,0,4,11
2025383,1593186,2025-06-19,Senate,"Special Consent ACR66 Dixon et al",35,0,0,5,40
2025384,1559430,2025-04-28,Assembly,"Be adopted. To Consent Calendar",9,0,0,2,11
2025384,1568659,2025-05-08,Assembly,"ACR 67 Sharp-Collins Consent Calendar Second Day",69,0,0,10,79
2025384,1593172,2025-06-19,Senate,"Special Consent ACR67 Sharp-Collins et al",35,0,0,5,40
2025385,1564173,2025-05-01,Assembly,"Be adopted. To third reading",14,0,0,0,14
2025385,1568605,2025-05-08,Assembly,"AJR 10 Rogers Assembly Third Reading",69,0,0,10,79
2025385,1588069,2025-06-10,Senate,"Be adopted. Ordered to third reading",7,0,0,0,7
2025385,1596781,2025-06-30,Senate,"Assembly 3rd Reading AJR10 Rogers et al. By Limón",39,0,0,1,40
2025386,1559405,2025-04-28,Assembly,"Be adopted. To third reading",9,0,0,2,11
2025387,1565347,2025-05-05,Senate,"Senate 3rd Reading SCR62 Becker",38,0,0,2,40
2025387,1594045,2025-06-23,Assembly,"Be adopted. To Consent Calendar",10,0,0,1,11
2025387,1596001,2025-06-27,Assembly,"SCR 62 Becker Consent Calendar Second Day Regular Session",75,0,0,4,79
2025388,1559390,2025-04-28,Senate,"Senate 3rd Reading SCR63 Wahab",39,0,0,1,40
2025388,1594037,2025-06-23,Assembly,"Be adopted. To Consent Calendar",10,0,0,1,11
2025388,1595987,2025-06-27,Assembly,"SCR 63 Wahab Consent Calendar Second Day Regular Session",75,0,0,4,79
2025389,1573631,2025-05-19,Senate,"Senate 3rd Reading SR39 Richardson",37,0,0,3,40
2025875,1569781,2025-05-12,Assembly,"Be adopted. To third reading",7,0,0,4,11
2025875,1593177,2025-06-19,Senate,"Special Consent ACR68 Ávila Farías et al",35,0,0,5,40
2025876,1569881,2025-05-12,Assembly,"Be adopted as amended",7,0,0,4,11
2025877,1559413,2025-04-28,Assembly,"Be adopted. To third reading",9,0,0,2,11
2025878,1568671,2025-05-08,Senate,"Senate 3rd Reading SCR64 Rubio et al",36,0,0,4,40
2025878,1594060,2025-06-23,Assembly,"Be adopted. To Consent Calendar",10,0,0,1,11
2025878,1595991,2025-06-27,Assembly,"SCR 64 Rubio Consent Calendar Second Day Regular Session",75,0,0,4,79
2025879,1592613,2025-06-18,Senate,"Be adopted as amended, and be ordered to the Consent Calendar",6,0,0,2,8
2025879,1600013,2025-08-25,Senate,"Senate 3rd Reading SJR5 Becker",36,0,0,4,40
2026248,1565356,2025-05-05,Assembly,"Be adopted. To third reading",9,0,0,2,11
2026248,1593164,2025-06-19,Senate,"Special Consent ACR69 Berman et al",35,0,0,5,40
2026249,1569759,2025-05-12,Assembly,"Be adopted. To third reading",7,0,0,0,7
2026249,1573607,2025-05-19,Assembly,"AJR 11 Ransom Assembly Third Reading",75,0,0,4,79
2026249,1588092,2025-06-10,Senate,"Be adopted and be ordered to the Consent Calendar",14,0,0,1,15
2026249,1590714,2025-06-13,Senate,"Consent Calendar 2nd AJR11 Ransom et al",35,0,0,5,40
2026518,1581766,2025-05-29,Assembly,"Be adopted. To Consent Calendar",6,0,0,5,11
2026518,1584296,2025-06-03,Assembly,"ACR 70 Pellerin Consent Calendar Second Day Regular Session",77,0,0,2,79
2026518,1600647,2025-08-29,Senate,"Special Consent ACR70 Pellerin et al. By Caballero",37,0,0,3,40
2026519,1573600,2025-05-19,Senate,"Senate 3rd Reading SCR65 Alvarado-Gil et al",36,0,0,4,40
2026519,1594090,2025-06-23,Assembly,"Be adopted. To Consent Calendar",10,0,0,1,11
2026519,1596036,2025-06-27,Assembly,"SCR 65 Alvarado-Gil Consent Calendar Second Day Regular Session",75,0,0,4,79
2026520,1567882,2025-05-06,Senate,"Be adopted. Ordered to third reading",11,0,0,2,13
2026520,1580556,2025-05-28,Senate,"Senate 3rd Reading SCR66 Umberg",28,8,0,4,40
2026520,1591899,2025-06-17,Assembly,"Be adopted. To third reading",9,0,0,3,12
2026521,1573560,2025-05-19,Senate,"Senate 3rd Reading SCR67 Grayson et al",37,0,0,3,40
2026521,1594049,2025-06-23,Assembly,"Be adopted. To Consent Calendar",10,0,0,1,11
2026521,1595970,2025-06-27,Assembly,"SCR 67 Grayson Consent Calendar Second Day Regular Session",75,0,0,4,79
2026522,1594052,2025-06-23,Senate,"Be adopted. Ordered to third reading",7,2,0,2,11
2026522,1598896,2025-07-17,Senate,"Senate 3rd Reading SJR6 Cortese et al",27,6,0,7,40
2026523,1569883,2025-05-12,Senate,"Senate 3rd Reading SR40 Dahle et al",34,0,0,6,40
2026978,1598090,2025-07-09,Assembly,"Do pass as amended",15,0,0,0,15
2026978,1598885,2025-07-17,Assembly,"AB 1533 Wicks Third Reading Urgency",74,0,0,5,79
2026978,1601281,2025-09-08,Senate,"Assembly 3rd Reading AB1533 Wicks By Caballero Urgency Clause",39,0,0,1,40
2026979,1597768,2025-07-07,Assembly,"Be adopted. To Consent Calendar",16,0,0,0,16
2026981,1568667,2025-05-08,Senate,"Senate 3rd Reading SCR68 Blakespear et al",36,0,0,4,40
2026981,1594035,2025-06-23,Assembly,"Be adopted. To Consent Calendar",10,0,0,1,11
2026981,1595971,2025-06-27,Assembly,"SCR 68 Blakespear Consent Calendar Second Day Regular Session",75,0,0,4,79
2026982,1580503,2025-05-28,Senate,"Senate 3rd Reading SCR69 Weber Pierson et al",38,0,0,2,40
2026982,1594047,2025-06-23,Assembly,"Be adopted. To Consent Calendar",10,0,0,1,11
2026982,1595986,2025-06-27,Assembly,"SCR 69 Weber Pierson Consent Calendar Second Day Regular Session",75,0,0,4,79
2026983,1573582,2025-05-19,Senate,"Senate 3rd Reading SR41 Niello",36,0,0,4,40
2027348,1573626,2025-05-19,Assembly,"Be adopted. To third reading",6,0,0,5,11
2027348,1593161,2025-06-19,Senate,"Special Consent ACR73 Stefani et al",35,0,0,5,40
2027349,1573540,2025-05-19,Assembly,"Be adopted. To Consent Calendar",6,0,0,5,11
2027349,1577225,2025-05-23,Assembly,"ACR 74 Wilson Consent Calendar Second Day Regular Session",71,0,0,8,79
2027349,1593183,2025-06-19,Senate,"Special Consent ACR74 Wilson et al",35,0,0,5,40
2027350,1568622,2025-05-08,Senate,"Senate 3rd Reading SCR70 Blakespear et al",36,0,0,4,40
2027350,1594082,2025-06-23,Assembly,"Be adopted. To Consent Calendar",10,0,0,1,11
2027350,1595996,2025-06-27,Assembly,"SCR 70 Blakespear Consent Calendar Second Day Regular Session",75,0,0,4,79
2027661,1565299,2025-05-05,Assembly,"Be adopted. To Consent Calendar",9,0,0,2,11
2027661,1568654,2025-05-08,Assembly,"ACR 75 Alanis Consent Calendar Second Day Regular Session",69,0,0,10,79
2027661,1577816,2025-05-23,Senate,"Special Consent ACR75 Alanis et al",36,0,0,4,40
2027661,1582237,2025-05-29,Assembly,"ACR 75 Alanis Concurrence in Senate Amendments",71,0,0,8,79
2027662,1569817,2025-05-12,Assembly,"Be adopted. To third reading",7,0,0,4,11
2027663,1565281,2025-05-05,Assembly,"Be adopted. To third reading",9,0,0,2,11
2027664,1572421,2025-05-15,Senate,"Senate 3rd Reading SCR71 Allen et al",34,0,0,6,40
2027664,1594083,2025-06-23,Assembly,"Be adopted. To Consent Calendar",10,0,0,1,11
2027664,1595962,2025-06-27,Assembly,"SCR 71 Allen Consent Calendar Second Day Regular Session",75,0,0,4,79
2028066,1569778,2025-05-12,Assembly,"Be adopted. To third reading",7,0,0,4,11
2028066,1593173,2025-06-19,Senate,"Special Consent ACR76 Solache et al",35,0,0,5,40
2028067,1569854,2025-05-12,Assembly,"Be adopted. To Consent Calendar",7,0,0,4,11
2028067,1572429,2025-05-15,Assembly,"HR 38 Fong Consent Calendar Second Day Regular Session",69,0,0,10,79
2028068,1569857,2025-05-12,Assembly,"Be adopted. To third reading",7,0,0,4,11
2028069,1572383,2025-05-15,Senate,"Senate 3rd Reading SCR72 Wahab et al",34,0,0,6,40
2028069,1594075,2025-06-23,Assembly,"Be adopted. To Consent Calendar",10,0,0,1,11
2028069,1596034,2025-06-27,Assembly,"SCR 72 Wahab Consent Calendar Second Day Regular Session",75,0,0,4,79
2028070,1594043,2025-06-23,Senate,"Senate 3rd Reading SCR73 Niello",37,0,0,3,40
2028070,1597698,2025-07-07,Assembly,"Be adopted. To Consent Calendar",8,0,0,3,11
2028070,1598155,2025-07-10,Assembly,"SCR 73 Niello Consent Calendar Second Day Regular Session",72,0,0,7,79
2028757,1569769,2025-05-12,Assembly,"Be adopted. To third reading",7,0,0,4,11
2028757,1597597,2025-07-03,Senate,"Special Consent ACR77 Davies et al. By Niello",35,0,0,5,40
2028758,1569767,2025-05-12,Assembly,"Be adopted. To third reading",7,0,0,4,11
2028758,1593174,2025-06-19,Senate,"Special Consent ACR78 Patel et al",35,0,0,5,40
2028760,1569848,2025-05-12,Assembly,"Be adopted. To Consent Calendar",7,0,0,4,11
2028760,1572407,2025-05-15,Assembly,"ACR 80 Stefani Consent Calendar Second Day Regular Session",69,0,0,10,79
2028760,1593167,2025-06-19,Senate,"Assembly 3rd Reading ACR80 Stefani By Wiener",35,0,0,5,40
2028761,1573532,2025-05-19,Assembly,"Be adopted. To third reading",6,0,0,5,11
2028762,1569820,2025-05-12,Assembly,"Be adopted. To third reading",7,0,0,4,11
2028763,1590713,2025-06-13,Senate,"Senate 3rd Reading SCR74 Ochoa Bogh et al",36,0,0,4,40
2028763,1596782,2025-06-30,Assembly,"Be adopted. To Consent Calendar",10,0,0,1,11
2028763,1597583,2025-07-03,Assembly,"SCR 74 Ochoa Bogh Consent Calendar Second Day Regular Session",74,0,0,5,79
2029488,1597654,2025-07-07,Assembly,"Be adopted. To Consent Calendar",16,0,0,0,16
2029488,1598151,2025-07-10,Assembly,"ACR 81 DeMaio Consent Calendar Second Day Regular Session",72,0,0,7,79
2029489,1591152,2025-06-16,Senate,"Senate 3rd Reading SCR75 Weber Pierson et al",35,0,0,5,40
2029489,1596792,2025-06-30,Assembly,"Be adopted. To Consent Calendar",10,0,0,1,11
2029489,1597598,2025-07-03,Assembly,"SCR 75 Weber Pierson Consent Calendar Second Day Regular Session",74,0,0,5,79
2029823,1573497,2025-05-19,Assembly,"Be adopted. To third reading",6,0,0,5,11
2029823,1593175,2025-06-19,Senate,"Special Consent ACR82 Bryan et al",35,0,0,5,40
2029824,1579259,2025-05-27,Senate,"Senate 3rd Reading SR42 Choi et al",39,0,0,1,40
2030564,1573534,2025-05-19,Assembly,"Be adopted. To third reading",6,0,0,5,11
2030564,1577956,2025-05-23,Assembly,"ACR 83 Wilson Assembly Third Reading",73,0,0,6,79
2030564,1594079,2025-06-23,Senate,"Be adopted, but first be re-referred to the Committee on [Appropriations]",11,0,0,0,11
2030564,1600493,2025-08-29,Senate,"Special Consent ACR83 Wilson et al. By Cabaldon",37,0,0,3,40
2030565,1573557,2025-05-19,Assembly,"Be adopted. To Consent Calendar",6,0,0,5,11
2030565,1579287,2025-05-27,Assembly,"ACR 84 Hoover Consent Calendar Second Day",76,0,0,3,79
2030565,1593170,2025-06-19,Senate,"Special Consent ACR84 Hoover et al",35,0,0,5,40
2030566,1573512,2025-05-19,Assembly,"Be adopted. To third reading",6,0,0,5,11
2030566,1593187,2025-06-19,Senate,"Special Consent ACR85 Garcia et al",35,0,0,5,40
2030567,1580543,2025-05-28,Senate,"Senate 3rd Reading SCR76 Valladares et al",39,0,0,1,40
2030567,1594084,2025-06-23,Assembly,"Be adopted. To Consent Calendar",10,0,0,1,11
2030567,1596021,2025-06-27,Assembly,"SCR 76 Valladares Consent Calendar Second Day Regular Session",75,0,0,4,79
2030568,1595982,2025-06-27,Senate,"Special Consent SCR77 Seyarto et al",38,0,0,2,40
2030568,1597687,2025-07-07,Assembly,"Be adopted. To Consent Calendar",8,0,0,3,11
2030568,1598172,2025-07-10,Assembly,"SCR 77 Seyarto Consent Calendar Second Day Regular Session",72,0,0,7,79
2030569,1581748,2025-05-29,Senate,"Special Consent SR43 Becker",38,0,0,2,40
2030570,1581783,2025-05-29,Senate,"Senate 3rd Reading SR44 McGuire et al",38,0,0,2,40
2031072,1573585,2025-05-19,Assembly,"Be adopted. To Consent Calendar",6,0,0,5,11
2031072,1577832,2025-05-23,Assembly,"ACR 86 Rivas Consent Calendar Second Day Regular Session",71,0,0,8,79
2031072,1593165,2025-06-19,Senate,"Special Consent ACR86 Rivas et al",35,0,0,5,40
2031073,1588096,2025-06-10,Senate,"Be adopted, but first be re-referred to the Committee on [Appropriations] with recommendation: To Consent Calendar",13,0,0,2,15
2031073,1598235,2025-07-14,Senate,"Senate 3rd Reading SCR78 McGuire",37,0,0,3,40
2031073,1600003,2025-08-25,Assembly,"Be adopted. To Consent Calendar",11,0,0,5,16
2031073,1600219,2025-08-28,Assembly,"SCR 78 McGuire Consent Calendar Second Day Regular Session",74,0,0,5,79
2031074,1588054,2025-06-10,Senate,"Be adopted, but first be re-referred to the Committee on [Appropriations] with recommendation: To Consent Calendar",13,0,0,2,15
2031074,1596007,2025-06-27,Senate,"Consent Calendar 2nd SCR79 McGuire",38,0,0,2,40
2031074,1598510,2025-07-14,Assembly,"Be adopted. To Consent Calendar",16,0,0,0,16
2031074,1598874,2025-07-17,Assembly,"SCR 79 McGuire Consent Calendar Second Day Regular Session",75,0,0,4,79
2031437,1581739,2025-05-29,Assembly,"Be adopted. To Consent Calendar",6,0,0,5,11
2031437,1584248,2025-06-03,Assembly,"ACR 87 Nguyen Consent Calendar Second Day Regular Session",77,0,0,2,79
2031437,1593159,2025-06-19,Senate,"Special Consent ACR87 Nguyen et al",35,0,0,5,40
2031438,1581715,2025-05-29,Assembly,"Be adopted. To Consent Calendar",6,0,0,5,11
2031438,1584425,2025-06-03,Assembly,"ACR 88 Jeff Gonzalez Consent Calendar Second Day Regular Session",77,0,0,2,79
2031438,1593184,2025-06-19,Senate,"Special Consent ACR88 Jeff Gonzalez et al",35,0,0,5,40
2031439,1597183,2025-07-01,Assembly,"Be adopted. To third reading",7,0,0,0,7
2031439,1598158,2025-07-10,Assembly,"AJR 12 Ahrens Assembly Third Reading By HADWICK",74,0,0,5,79
2031439,1600129,2025-08-27,Senate,"Be adopted and be ordered to the Consent Calendar",4,0,0,1,5
2031439,1600928,2025-09-03,Senate,"Consent Calendar 2nd AJR12 Ahrens et al",40,0,0,0,40
2032037,1573520,2025-05-19,Assembly,"Be adopted. To third reading",6,0,0,5,11
2032037,1593176,2025-06-19,Senate,"Special Consent ACR89 Jeff Gonzalez et al",35,0,0,5,40
2032038,1573571,2025-05-19,Assembly,"Be adopted. To third reading",6,0,0,5,11
2032039,1599620,2025-08-18,Senate,"Senate 3rd Reading SCR80 Niello et al",37,0,0,3,40
2032039,1600236,2025-08-28,Assembly,"Be adopted. To Consent Calendar",9,0,0,2,11
2032039,1600826,2025-09-02,Assembly,"SCR 80 Niello Consent Calendar Second Day Regular Session",78,0,0,1,79
2032040,1593166,2025-06-19,Senate,"Special Consent SCR81 Niello et al",35,0,0,5,40
2032040,1596787,2025-06-30,Assembly,"Be adopted. To Consent Calendar",10,0,0,1,11
2032040,1597567,2025-07-03,Assembly,"SCR 81 Niello Consent Calendar Second Day Regular Session",74,0,0,5,79
2032041,1597387,2025-07-02,Senate,"Be adopted and be ordered to the Consent Calendar",7,0,0,0,7
2032041,1598181,2025-07-10,Senate,"Consent Calendar 2nd SCR82 Niello",37,0,0,3,40
2032042,1591162,2025-06-16,Senate,"Senate 3rd Reading SCR83 Stern et al",35,0,0,5,40
2032042,1596751,2025-06-30,Assembly,"Be adopted. To Consent Calendar",10,0,0,1,11
2032042,1597608,2025-07-03,Assembly,"SCR 83 Stern Consent Calendar Second Day Regular Session",74,0,0,5,79
2032536,1596780,2025-06-30,Senate,"Be adopted. Ordered to third reading",8,3,0,0,11
2032536,1598894,2025-07-17,Senate,"Senate 3rd Reading SJR7 Cervantes et al",26,9,0,5,40
2032537,1581785,2025-05-29,Senate,"Senate 3rd Reading SR45 Rubio et al",38,0,0,2,40
2032538,1581718,2025-05-29,Senate,"Senate 3rd Reading SR46 Cabaldon et al",32,0,0,8,40
2033471,1585804,2025-06-05,Assembly,"Be adopted. To third reading",9,0,0,2,11
2033471,1597569,2025-07-03,Senate,"Special Consent ACR90 Gipson et al",35,0,0,5,40
2033472,1591161,2025-06-16,Assembly,"Be adopted. To third reading",7,0,0,4,11
2033473,1600020,2025-08-25,Senate,"Senate 3rd Reading SCR85 Archuleta et al",38,0,0,2,40
2033473,1600924,2025-09-03,Assembly,"Be adopted. To Consent Calendar",6,0,0,5,11
2033473,1601414,2025-09-08,Assembly,"SCR 85 Archuleta Consent Calendar Second Day Regular Session",71,0,0,9,80
2033474,1596031,2025-06-27,Senate,"Special Consent SR47 Stern et al",38,0,0,2,40
2033682,1581760,2025-05-29,Assembly,"Be adopted as amended",6,0,0,5,11
2033682,1596013,2025-06-27,Senate,"Special Consent ACR91 Aguiar-Curry et al",38,0,0,2,40
2033684,1591164,2025-06-16,Senate,"Senate 3rd Reading SCR86 Weber Pierson et al",34,0,0,6,40
2033684,1596770,2025-06-30,Assembly,"Be adopted. To Consent Calendar",10,0,0,1,11
2033684,1597578,2025-07-03,Assembly,"SCR 86 Weber Pierson Consent Calendar Second Day Regular Session",74,0,0,5,79
2034050,1594057,2025-06-23,Senate,"Senate 3rd Reading SR48 Menjivar et al",27,0,0,13,40
2034334,1596758,2025-06-30,Assembly,"Be adopted. To Consent Calendar",10,0,0,1,11
2034334,1597605,2025-07-03,Assembly,"SCR 87 Weber Pierson Consent Calendar Second Day Regular Session",74,0,0,5,79
2034335,1594066,2025-06-23,Senate,"Senate 3rd Reading SR49 Choi et al",37,0,0,3,40
2034533,1585799,2025-06-05,Assembly,"Be adopted. To third reading",9,0,0,2,11
2034533,1597580,2025-07-03,Senate,"Special Consent ACR92 Mark González et al",35,0,0,5,40
2034534,1596011,2025-06-27,Senate,"Special Consent SCR88 Seyarto et al",38,0,0,2,40
2034534,1597688,2025-07-07,Assembly,"Be adopted. To Consent Calendar",8,0,0,3,11
2034534,1598167,2025-07-10,Assembly,"SCR 88 Seyarto Consent Calendar Second Day Regular Session",72,0,0,7,79
2034535,1597886,2025-07-08,Senate,"Be adopted. Ordered to third reading",11,1,0,1,13
2034536,1600036,2025-08-25,Senate,"Special Consent SR50 Archuleta et al",37,0,0,3,40
2035186,1591160,2025-06-16,Assembly,"Be adopted. To Consent Calendar",10,0,0,1,11
2035186,1593185,2025-06-19,Assembly,"ACR 93 Dixon Consent Calendar Second Day",72,0,0,7,79
2035186,1598841,2025-07-17,Senate,"Special Consent ACR93 Dixon et al",35,0,0,5,40
2035187,1598062,2025-07-08,Assembly,"Be adopted. To Consent Calendar",16,0,0,0,16
2035187,1598215,2025-07-14,Assembly,"ACR 94 Patel Consent Calendar Second Day",77,0,0,2,79
2035188,1592607,2025-06-18,Assembly,"Be adopted. To Consent Calendar",11,0,0,1,12
2035551,1590918,2025-06-09,Assembly,"Be adopted. To third reading",6,0,0,5,11
2035552,1594648,2025-06-24,Senate,"Be adopted, but first be re-referred to the Committee on [Appropriations] with recommendation: To Consent Calendar",14,0,0,1,15
2035552,1598180,2025-07-10,Senate,"Consent Calendar 2nd SCR90 Grove",37,0,0,3,40
2035552,1600063,2025-08-25,Assembly,"Be adopted. To Consent Calendar",11,0,0,5,16
2035552,1600194,2025-08-28,Assembly,"SCR 90 Grove Consent Calendar Second Day Regular Session",74,0,0,5,79
2036403,1597948,2025-07-08,Assembly,"Be adopted. To third reading",7,0,0,1,8
2036403,1600049,2025-08-25,Assembly,"AJR 14 Gipson Assembly Third Reading",60,1,0,18,79
2036404,1600496,2025-08-29,Senate,"Senate 3rd Reading SCR91 Alvarado-Gil",37,0,0,3,40
2036404,1600900,2025-09-03,Assembly,"Be adopted. To Consent Calendar",6,0,0,5,11
2036404,1601415,2025-09-08,Assembly,"SCR 91 Alvarado-Gil Consent Calendar Second Day Regular Session",71,0,0,9,80
2036406,1600040,2025-08-25,Senate,"Senate 3rd Reading SCR93 Ochoa Bogh et al",37,0,0,3,40
2036406,1600916,2025-09-03,Assembly,"Be adopted. To Consent Calendar",6,0,0,5,11
2036406,1601416,2025-09-08,Assembly,"SCR 93 Ochoa Bogh Consent Calendar Second Day Regular Session",71,0,0,9,80
2036699,1593156,2025-06-19,Senate,"Senate 3rd Reading SCR94 Blakespear et al",34,0,0,6,40
2036699,1596773,2025-06-30,Assembly,"Be adopted. To Consent Calendar",10,0,0,1,11
2036699,1597575,2025-07-03,Assembly,"SCR 94 Blakespear Consent Calendar Second Day Regular Session",74,0,0,5,79
2036700,1597847,2025-07-08,Senate,"Be adopted. Ordered to third reading",6,0,0,1,7
2036700,1599997,2025-08-25,Senate,"Senate 3rd Reading SR51 Becker et al",38,0,0,2,40
2036904,1591156,2025-06-16,Assembly,"Be adopted. To Consent Calendar",10,0,0,1,11
2036904,1593169,2025-06-19,Assembly,"ACR 95 Kalra Consent Calendar Second Day Regular Session",72,0,0,7,79
2036905,1597670,2025-07-07,Assembly,"Be adopted. To Consent Calendar",16,0,0,0,16
2036905,1598174,2025-07-10,Assembly,"ACR 96 Rogers Assembly Third Reading",74,0,0,5,79
2036906,1597727,2025-07-07,Assembly,"Be adopted. To Consent Calendar",16,0,0,0,16
2036906,1598150,2025-07-10,Assembly,"ACR 97 Rogers Consent Calendar Second Day Regular Session",72,0,0,7,79
2036907,1597151,2025-07-01,Assembly,"Be adopted. To Consent Calendar",8,0,0,0,8
2036907,1597723,2025-07-07,Assembly,"AJR 15 Alanis Consent Calendar Second Day Regular Session",75,0,0,4,79
2036907,1600109,2025-08-25,Senate,"Be adopted and be ordered to the Consent Calendar",4,0,0,1,5
2036907,1600726,2025-08-29,Senate,"Consent Calendar 2nd AJR15 Alanis et al",37,0,0,3,40
2037335,1600001,2025-08-25,Senate,"Senate 3rd Reading SCR95 Choi et al",37,0,0,3,40
2037335,1600901,2025-09-03,Assembly,"Be adopted. To Consent Calendar",6,0,0,5,11
2037335,1601417,2025-09-08,Assembly,"SCR 95 Choi Consent Calendar Second Day Regular Session",71,0,0,9,80
2037430,1594036,2025-06-23,Assembly,"Be adopted. To Consent Calendar",10,0,0,1,11
2037430,1595993,2025-06-27,Assembly,"ACR 99 Davies Consent Calendar Second Day Regular Session",75,0,0,4,79
2037430,1598862,2025-07-17,Senate,"Special Consent ACR99 Davies et al",35,0,0,5,40
2037431,1598685,2025-07-15,Senate,"Be adopted. Ordered to third reading",12,0,0,1,13
2037431,1600033,2025-08-25,Senate,"Senate 3rd Reading SJR8 Arreguín et al",29,0,0,11,40
2037493,1594092,2025-06-23,Assembly,"Be adopted. To third reading",10,0,0,1,11
2037612,1598264,2025-07-14,Assembly,"Be adopted. To third reading",10,0,0,1,11
2037613,1600005,2025-08-25,Senate,"Senate 3rd Reading SCR96 Wahab et al",38,0,0,2,40
2037613,1600986,2025-09-03,Assembly,"Be adopted. To Consent Calendar",6,0,0,5,11
2037613,1601418,2025-09-08,Assembly,"SCR 96 Wahab Consent Calendar Second Day Regular Session",71,0,0,9,80
2037614,1594678,2025-06-24,Senate,"Be adopted as amended",5,1,0,0,6
2037614,1597586,2025-07-03,Senate,"Senate 3rd Reading SJR9 Durazo et al",29,6,0,5,40
2037614,1598662,2025-07-15,Assembly,"Be adopted. To third reading",7,0,0,2,9
2037614,1600824,2025-09-02,Assembly,"SJR 9 Durazo Senate Third Reading By Mark González",59,11,0,9,79
2037800,1597244,2025-07-01,Assembly,"Be adopted. To Consent Calendar",7,0,0,0,7
2037800,1597659,2025-07-07,Assembly,"AJR 16 Alvarez Consent Calendar Second Day",75,0,0,4,79
2038042,1598502,2025-07-14,Assembly,"Be adopted. To Consent Calendar",16,0,0,0,16
2038042,1600037,2025-08-25,Assembly,"ACR 101 Addis Assembly Third Reading",74,0,0,5,79
2038043,1597907,2025-07-08,Assembly,"Be adopted. To third reading",9,2,0,1,12
2038043,1599985,2025-08-25,Assembly,"AJR 17 Celeste Rodriguez Assembly Third Reading",57,7,0,15,79
2038045,1599995,2025-08-25,Senate,"Senate 3rd Reading SR53 Rubio et al. By Cortese",38,0,0,2,40
2038203,1598287,2025-07-14,Assembly,"Be adopted. To third reading",10,0,0,1,11
2038203,1601977,2025-09-11,Senate,"Special Consent ACR102 Ramos et al",40,0,0,0,40
2038204,1597681,2025-07-07,Assembly,"Be adopted. To third reading",8,0,0,3,11
2038204,1600617,2025-08-29,Senate,"Special Consent ACR103 Addis et al",37,0,0,3,40
2038205,1597693,2025-07-07,Assembly,"Be adopted. To Consent Calendar",8,0,0,3,11
2038205,1598147,2025-07-10,Assembly,"ACR 104 Wallis Consent Calendar Second Day",72,0,0,7,79
2038205,1600328,2025-08-29,Senate,"Special Consent ACR104 Wallis By Ochoa Bogh",37,0,0,3,40
2038206,1598850,2025-07-17,Senate,"Special Consent SCR97 Seyarto et al",35,0,0,5,40
2038206,1599495,2025-08-18,Assembly,"Be adopted. To Consent Calendar",9,0,0,2,11
2038206,1599845,2025-08-21,Assembly,"SCR 97 Seyarto Consent Calendar Second Day Regular Session",77,0,0,2,79
2038778,1597941,2025-07-08,Assembly,"Be adopted. To third reading",11,0,0,1,12
2038778,1598296,2025-07-14,Assembly,"AJR 18 Ramos Assembly Third Reading",76,0,0,3,79
2038885,1598591,2025-07-16,Assembly,"Be adopted. To third reading",7,0,0,2,9
2038885,1600218,2025-08-28,Assembly,"AJR 19 Muratsuchi Assembly Third Reading",62,4,0,13,79
2038925,1600058,2025-08-25,Senate,"Special Consent SR54 Choi et al",37,0,0,3,40
2038964,1599407,2025-08-18,Assembly,"Be adopted. To Consent Calendar",9,0,0,2,11
2038964,1599841,2025-08-21,Assembly,"ACR 105 McKinnor Consent Calendar Second Day",77,0,0,2,79
2038964,1601840,2025-09-11,Senate,"Special Consent ACR105 McKinnor et al",40,0,0,0,40
2039095,1598842,2025-07-17,Senate,"Senate 3rd Reading SCR99 Allen",37,0,0,3,40
2039095,1599565,2025-08-18,Assembly,"Be adopted. To Consent Calendar",9,0,0,2,11
2039095,1599856,2025-08-21,Assembly,"SCR 99 Allen Consent Calendar Second Day Regular Session",77,0,0,2,79
2039140,1598216,2025-07-14,Assembly,"Be adopted. To Consent Calendar",10,0,0,1,11
2039140,1598888,2025-07-17,Assembly,"ACR 106 Kalra Consent Calendar Second Day Regular Session",75,0,0,4,79
2039141,1598240,2025-07-14,Assembly,"Be adopted. To third reading",10,0,0,1,11
2039469,1601744,2025-09-10,Assembly,"Be adopted. To Consent Calendar",13,0,0,0,13
2039469,1602111,2025-09-13,Assembly,"ACR 107 Bauer-Kahan Consent Calendar Second Day",74,0,0,6,80
2039470,1599844,2025-08-21,Assembly,"Be adopted. To third reading",11,0,0,0,11
2039470,1601848,2025-09-11,Senate,"Special Consent ACR108 Hoover et al",40,0,0,0,40
2039471,1599391,2025-08-18,Assembly,"Be adopted. To Consent Calendar",9,0,0,2,11
2039471,1599843,2025-08-21,Assembly,"HR 49 Schiavo Consent Calendar Second Day Regular Session",77,0,0,2,79
2039472,1601873,2025-09-11,Senate,"Special Consent SR55 Hurtado",40,0,0,0,40
2039621,1600016,2025-08-25,Assembly,"Be adopted. To Consent Calendar",11,0,0,5,16
2039621,1600195,2025-08-28,Assembly,"ACR 109 Arambula Consent Calendar Second Day Regular Session",74,0,0,5,79
2039622,1600032,2025-08-25,Senate,"Senate 3rd Reading SCR100 Arreguín",38,0,0,2,40
2039622,1601000,2025-09-03,Assembly,"Be adopted. To Consent Calendar",6,0,0,5,11
2039622,1601409,2025-09-08,Assembly,"SCR 100 Arreguín Consent Calendar Second Day Regular Session",71,0,0,9,80
2039623,1600318,2025-08-29,Senate,"Senate 3rd Reading SR56 Weber Pierson et al",37,0,0,3,40
2039775,1599383,2025-08-18,Assembly,"Be adopted. To third reading",9,0,0,2,11
2039776,1599857,2025-08-21,Assembly,"Be adopted. To Consent Calendar",11,0,0,0,11
2039776,1600189,2025-08-28,Assembly,"HR 51 Schultz Consent Calendar Second Day",74,0,0,5,79
2039777,1600027,2025-08-25,Senate,"Senate 3rd Reading SCR101 Choi et al",38,0,0,2,40
2039777,1600998,2025-09-03,Assembly,"Be adopted. To Consent Calendar",6,0,0,5,11
2039777,1601410,2025-09-08,Assembly,"SCR 101 Choi Consent Calendar Second Day Regular Session",71,0,0,9,80
2039779,1600055,2025-08-25,Senate,"Senate 3rd Reading SR58 Blakespear et al",38,0,0,2,40
2039957,1599866,2025-08-21,Assembly,"Be adopted. To Consent Calendar",11,0,0,0,11
2039957,1600852,2025-09-02,Assembly,"HR 52 Harabedian Consent Calendar Second Day",78,0,0,1,79
2042252,1599839,2025-08-21,Assembly,"Be adopted. To third reading",11,0,0,0,11
2042253,1599861,2025-08-21,Assembly,"Be adopted. To third reading",11,0,0,0,11
2042253,1601856,2025-09-11,Senate,"Special Consent ACR111 Sharp-Collins",40,0,0,0,40
2042256,1599862,2025-08-21,Assembly,"Be adopted. To third reading",11,0,0,0,11
2042257,1599867,2025-08-21,Assembly,"Be adopted. To Consent Calendar",11,0,0,0,11
2042257,1600203,2025-08-28,Assembly,"HR 54 Fong Consent Calendar Second Day Regular Session",74,0,0,5,79
2042258,1599859,2025-08-21,Assembly,"Be adopted. To third reading",11,0,0,0,11
2042259,1599853,2025-08-21,Assembly,"Be adopted. To third reading",11,0,0,0,11
2042260,1599847,2025-08-21,Assembly,"Be adopted. To third reading",8,3,0,0,11
2042261,1599849,2025-08-21,Assembly,"Be adopted. To third reading",11,0,0,0,11
2042262,1599851,2025-08-21,Assembly,"Be adopted. To Consent Calendar",11,0,0,0,11
2042262,1600200,2025-08-28,Assembly,"HR 59 Dixon Consent Calendar Second Day Regular Session",74,0,0,5,79
2042263,1599858,2025-08-21,Assembly,"Be adopted. To Consent Calendar",11,0,0,0,11
2042263,1600235,2025-08-28,Assembly,"HR 60 Gabriel Consent Calendar Second Day Regular Session",74,0,0,5,79
2042264,1599874,2025-08-21,Assembly,"Be adopted. To Consent Calendar",11,0,0,0,11
2042264,1600225,2025-08-28,Assembly,"HR 61 McKinnor Consent Calendar Second Day Regular Session",74,0,0,5,79
2042265,1600448,2025-08-29,Senate,"Senate 3rd Reading SCR102 Caballero et al",37,0,0,3,40
2042265,1600976,2025-09-03,Assembly,"Be adopted. To Consent Calendar",6,0,0,5,11
2042265,1601411,2025-09-08,Assembly,"SCR 102 Caballero Consent Calendar Second Day Regular Session",71,0,0,9,80
2042266,1601975,2025-09-11,Senate,"Special Consent SCR103 Caballero et al",40,0,0,0,40
2042268,1601859,2025-09-11,Senate,"Special Consent SR59 Niello",40,0,0,0,40
2042269,1600401,2025-08-29,Senate,"Senate 3rd Reading SR60 Rubio et al",37,0,0,3,40
2042270,1601899,2025-09-11,Senate,"Special Consent SR61 Pérez et al",40,0,0,0,40
2042356,1599848,2025-08-21,Assembly,"Be adopted. To third reading",11,0,0,0,11
2042357,1599855,2025-08-21,Assembly,"Be adopted. To third reading",11,0,0,0,11
2042358,1600289,2025-08-29,Senate,"Senate 3rd Reading SCR104 Valladares et al",37,0,0,3,40
2042358,1600949,2025-09-03,Assembly,"Be adopted. To Consent Calendar",6,0,0,5,11
2042358,1601412,2025-09-08,Assembly,"SCR 104 Valladares Consent Calendar Second Day Regular Session",71,0,0,9,80
2042359,1600471,2025-08-29,Senate,"Senate 3rd Reading SR62 Valladares et al",37,0,0,3,40
2042441,1599846,2025-08-21,Assembly,"Be adopted. To third reading",11,0,0,0,11
2042441,1601980,2025-09-11,Senate,"Special Consent ACR113 Bauer-Kahan By Umberg",40,0,0,0,40
2042442,1599842,2025-08-21,Assembly,"Be adopted. To third reading",11,0,0,0,11
2042442,1601878,2025-09-11,Senate,"Special Consent ACR114 Pacheco et al",40,0,0,0,40
2042443,1600546,2025-08-29,Senate,"Senate 3rd Reading SR63 McNerney et al",37,0,0,3,40
2042444,1600520,2025-08-29,Senate,"Senate 3rd Reading SR64 Cabaldon et al",37,0,0,3,40
2042445,1600317,2025-08-29,Senate,"Senate 3rd Reading SR65 Wahab",37,0,0,3,40
2042549,1600896,2025-09-03,Assembly,"Be adopted. To Consent Calendar",6,0,0,5,11
2042549,1601336,2025-09-08,Assembly,"HR 63 Alanis Consent Calendar Second Day",71,0,0,9,80
2042839,1600227,2025-08-28,Assembly,"Be adopted. To Consent Calendar",9,0,0,2,11
2042839,1600844,2025-09-02,Assembly,"HR 64 Hoover Consent Calendar Second Day Regular Session",78,0,0,1,79
2042840,1600243,2025-08-28,Assembly,"Be adopted. To third reading",9,0,0,2,11
2042841,1600193,2025-08-28,Assembly,"Be adopted. To Consent Calendar",9,0,0,2,11
2042841,1600837,2025-09-02,Assembly,"HR 66 Aguiar-Curry Consent Calendar Second Day Regular Session",78,0,0,1,79
2042906,1600911,2025-09-03,Assembly,"Be adopted. To third reading",6,0,0,5,11
2042907,1600965,2025-09-03,Assembly,"Be adopted. To third reading",6,0,0,5,11
2042953,1600939,2025-09-03,Assembly,"Be adopted. To Consent Calendar",6,0,0,5,11
2042953,1601337,2025-09-08,Assembly,"HR 69 Calderon Consent Calendar Second Day Regular Session",71,0,0,9,80
2042954,1600880,2025-09-03,Assembly,"Be adopted. To third reading",6,0,0,5,11
2042955,1600957,2025-09-03,Assembly,"Be adopted. To third reading",6,0,0,5,11
2043038,1600974,2025-09-03,Assembly,"Be adopted. To Consent Calendar",6,0,0,5,11
2043038,1601338,2025-09-08,Assembly,"HR 72 Carrillo Consent Calendar Second Day Regular Session",71,0,0,9,80
2043040,1600933,2025-09-03,Assembly,"Be adopted. To Consent Calendar",6,0,0,5,11
2043040,1601339,2025-09-08,Assembly,"HR 74 Jeff Gonzalez Consent Calendar Second Day Regular Session",71,0,0,9,80
2043492,1602092,2025-09-12,Senate,"Senate 3rd Reading SCR105 Wahab et al",35,0,0,5,40
