bill_id,roll_call_id,date,chamber,description,yea,nay,nv,absent,total
1885882,1464647,2024-02-08,House,"House: Subcommittee recommends reporting with amendments (6-Y 1-N)",6,1,0,1,8
1885882,1464648,2024-02-09,House,"House: Reported from Counties, Cities and Towns with amendment(s) (13-Y 8-N)",13,8,0,1,22
1885882,1464649,2024-02-13,House,"House: VOTE: Passage (55-Y 42-N 1-A)",55,42,1,2,100
1885882,1464650,2024-02-28,Senate,"Senate: Continued to 2025 in General Laws and Technology (9-Y 3-N 3-A)",9,3,3,0,15
1885884,1464651,2024-01-31,House,"House: Subcommittee recommends reporting with substitute (8-Y 1-N)",8,1,0,1,10
1885884,1464652,2024-02-05,House,"House: Reported from Communications, Technology and Innovation with substitute (14-Y 6-N)",14,6,2,0,22
1885884,1464653,2024-02-09,House,"House: VOTE: Passage (66-Y 27-N)",66,27,0,7,100
1885884,1464654,2024-02-26,Senate,"Senate: Rereferred from Transportation (15-Y 0-N)",15,0,0,0,15
1885884,1464655,2024-02-28,Senate,"Senate: Continued to 2025 in Courts of Justice (12-Y 0-N)",12,0,0,0,12
1885887,1464656,2024-01-24,House,"House: Subcommittee recommends reporting (5-Y 3-N)",5,3,0,0,8
1885888,1464657,2024-02-05,Senate,"Senate: Continued to 2025 in Commerce and Labor (10-Y 5-N)",10,5,0,0,15
1885889,1464658,2024-01-18,Senate,"Senate: Reported from Education and Health (15-Y 0-N)",15,0,0,0,15
1885889,1464659,2024-01-31,Senate,"Senate: Continued to 2025 in Finance and Appropriations (12-Y 3-N)",12,3,0,0,15
1885890,1464660,2024-02-05,Senate,"Senate: Continued to 2025 in Local Government (11-Y 4-N)",11,4,0,0,15
1885891,1464661,2024-02-08,Senate,"Senate: Reported from Education and Health with substitute (15-Y 0-N)",15,0,0,0,15
1885891,1464662,2024-02-08,Senate,"Senate: Constitutional reading dispensed (40-Y 0-N)",40,0,0,0,40
1885891,1464663,2024-02-09,Senate,"Senate: Constitutional reading dispensed (40-Y 0-N)",40,0,0,0,40
1885891,1464664,2024-02-09,Senate,"Senate: Passed Senate (40-Y 0-N)",40,0,0,0,40
1885892,1464665,2024-01-30,Senate,"Senate: Reported from Privileges and Elections (8-Y 7-N)",8,7,0,0,15
1885892,1464666,2024-02-07,Senate,"Senate: Reported from Finance and Appropriations with amendment (10-Y 5-N)",10,5,0,0,15
1885892,1464667,2024-02-08,Senate,"Senate: Constitutional reading dispensed (40-Y 0-N)",40,0,0,0,40
1885892,1464668,2024-02-12,Senate,"Senate: Read third time and passed Senate (21-Y 19-N)",21,19,0,0,40
1885893,1464669,2024-01-17,House,"House: Subcommittee recommends reporting (6-Y 1-N)",6,1,0,1,8
1885893,1464670,2024-01-22,House,"House: Reported from Education (13-Y 8-N)",13,8,0,1,22
1885897,1471499,2024-11-13,House,"Reported from Privileges and Elections with substitute (16-Y 5-N)",16,5,0,1,22
1885897,1471500,2025-01-14,House,"Agreed to by House (58-Y 35-N 2-A)",58,35,2,5,100
1885897,1475693,2025-01-28,Senate,"Reported from Privileges and Elections (10-Y 5-N)",10,5,0,0,15
1885897,1477728,2025-01-30,Senate,"Reading waived (on 1st reading) (39-Y 0-N)",39,0,0,1,40
1885897,1478240,2025-01-31,Senate,"Agreed to by Senate (24-Y 15-N)",24,15,0,1,40
1885898,1464671,2024-02-09,Senate,"Senate: Continued to 2025 in Commerce and Labor (11-Y 4-N)",11,4,0,0,15
1885900,1464672,2024-02-01,Senate,"Senate: Reported from Education and Health with amendment (15-Y 0-N)",15,0,0,0,15
1885900,1464673,2024-02-08,Senate,"Senate: Continued to 2025 in Finance and Appropriations (10-Y 5-N)",10,5,0,0,15
1885901,1464674,2024-02-01,Senate,"Senate: Continued to 2025 in Transportation (15-Y 0-N)",15,0,0,0,15
1885902,1464675,2024-02-05,Senate,"Senate: Continued to 2025 in Commerce and Labor (14-Y 1-N)",14,1,0,0,15
1885903,1464676,2024-01-23,Senate,"Senate: Reported from Privileges and Elections (14-Y 0-N)",14,0,0,0,14
1885903,1464677,2024-01-25,Senate,"Senate: Constitutional reading dispensed (40-Y 0-N)",40,0,0,0,40
1885903,1464678,2024-01-29,Senate,"Senate: Read third time and passed Senate (40-Y 0-N)",40,0,0,0,40
1885904,1464679,2024-01-30,Senate,"Senate: Reported from Agriculture, Conservation and Natural Resources with substitute (15-Y 0-N)",15,0,0,0,15
1885904,1464680,2024-02-12,Senate,"Senate: Continued to 2025 in Finance and Appropriations (12-Y 3-N)",12,3,0,0,15
1885905,1464681,2024-02-06,Senate,"Senate: Continued to 2025 in Finance and Appropriations (12-Y 3-N)",12,3,0,0,15
1885906,1464682,2024-01-30,House,"House: Subcommittee recommends reporting with substitute (4-Y 3-N)",4,3,0,0,7
1885906,1464683,2024-02-01,House,"House: Reported from Labor and Commerce with substitute (12-Y 10-N)",12,10,0,0,22
1885908,1464684,2024-02-01,House,"House: Subcommittee recommends reporting with substitute (4-Y 2-N)",4,2,0,0,6
1885908,1464685,2024-02-02,House,"House: Reported from Public Safety with substitute (14-Y 8-N)",14,8,0,0,22
1885908,1464686,2024-02-08,House,"House: VOTE: Passage (59-Y 39-N)",59,39,0,2,100
1885908,1464687,2024-02-23,Senate,"Senate: Reported from Rehabilitation and Social Services (15-Y 0-N)",15,0,0,0,15
1885908,1464688,2024-02-28,Senate,"Senate: Continued to 2025 in Finance and Appropriations (15-Y 0-N)",15,0,0,0,15
1885911,1464689,2024-02-08,Senate,"Senate: Continued to 2025 in Education and Health (15-Y 0-N)",15,0,0,0,15
1885912,1464690,2024-01-29,Senate,"Senate: Continued to 2025 in Commerce and Labor (15-Y 0-N)",15,0,0,0,15
1885915,1464691,2024-02-05,Senate,"Senate: Continued to 2025 in Courts of Justice (15-Y 0-N)",15,0,0,0,15
1885916,1464692,2024-01-16,Senate,"Senate: Continued to 2025 in Privileges and Elections (14-Y 0-N)",14,0,0,0,14
1885918,1464693,2024-02-05,House,"House: Subcommittee recommends continuing to 2025 (7-Y 0-N)",7,0,0,1,8
1885920,1464694,2024-02-09,House,"House: Reported from Privileges and Elections with substitute (22-Y 0-N)",22,0,0,0,22
1885920,1464695,2024-02-13,House,"House: VOTE: Block Vote Passage (99-Y 0-N)",99,0,0,1,100
1885920,1464696,2024-02-27,Senate,"Senate: Continued to 2025 in Privileges and Elections (8-Y 7-N)",8,7,0,0,15
1885921,1464697,2024-01-30,House,"House: Subcommittee recommends reporting (5-Y 4-N)",5,4,0,1,10
1885921,1464698,2024-02-06,House,"House: Reported from Labor and Commerce (12-Y 10-N)",12,10,0,0,22
1885921,1464699,2024-02-12,House,"House: VOTE: Passage (51-Y 49-N)",51,49,0,0,100
1885921,1464700,2024-03-04,Senate,"Senate: Continued to 2025 in Commerce and Labor (14-Y 0-N)",14,0,0,0,14
1885922,1471489,2024-11-13,House,"Reported from Privileges and Elections (12-Y 9-N)",12,9,0,1,22
1885922,1471490,2025-01-14,House,"Motion to pass by Delegate Cherry Amendment #1 agreed to (52-Y 47-N 0-A)",52,47,0,1,100
1885922,1471491,2025-01-14,House,"Motion to pass by Delegate Cherry Amendments #2, #3 agreed to  (51-Y 48-N 0-A)",0,0,0,0,0
1885922,1471492,2025-01-14,House,"Agreed to by House (55-Y 44-N 0-A)",55,44,0,1,100
1885922,1475691,2025-01-28,Senate,"Reported from Privileges and Elections (8-Y 7-N)",8,7,0,0,15
1885922,1478216,2025-01-30,Senate,"Reading waived (on 2nd reading) (39-Y 0-N)",39,0,0,1,40
1885922,1478217,2025-01-31,Senate,"Agreed to by Senate (21-Y 18-N)",21,18,0,1,40
1885923,1464701,2024-02-01,House,"House: Subcommittee recommends reporting with amendments (6-Y 3-N)",6,3,0,1,10
1885923,1464702,2024-02-02,House,"House: Reported from Public Safety with amendment(s) (12-Y 10-N)",12,10,0,0,22
1885926,1464703,2024-01-31,Senate,"Senate: Reported from General Laws and Technology (15-Y 0-N)",15,0,0,0,15
1885926,1464704,2024-02-07,Senate,"Senate: Reported from Finance and Appropriations with substitute (15-Y 0-N)",15,0,0,0,15
1885926,1464705,2024-02-08,Senate,"Senate: Constitutional reading dispensed (40-Y 0-N)",40,0,0,0,40
1885926,1464706,2024-02-09,Senate,"Senate: Constitutional reading dispensed (40-Y 0-N)",40,0,0,0,40
1885926,1464707,2024-02-09,Senate,"Senate: Passed Senate (40-Y 0-N)",40,0,0,0,40
1885926,1464708,2024-02-20,House,"House: Subcommittee recommends reporting with substitute (8-Y 0-N)",8,0,0,0,8
1885926,1464709,2024-02-22,House,"House: Reported from Health and Human Services with substitute (21-Y 0-N)",21,0,0,1,22
1885927,1464710,2024-02-05,House,"House: Subcommittee recommends continuing to 2025 with substitute (7-Y 0-N)",7,0,0,1,8
1885928,1464711,2024-02-07,Senate,"Senate: Continued to 2025 in General Laws and Technology (13-Y 2-N)",13,2,0,0,15
1885929,1464712,2024-02-06,Senate,"Senate: Continued to 2025 in Finance and Appropriations (15-Y 0-N)",15,0,0,0,15
1885931,1464713,2024-02-07,Senate,"Senate: Continued to 2025 in Courts of Justice (15-Y 0-N)",15,0,0,0,15
1885933,1464714,2024-02-07,Senate,"Senate: Reported from General Laws and Technology with substitute (14-Y 0-N 1-A)",14,0,1,0,15
1885933,1464715,2024-02-08,Senate,"Senate: Constitutional reading dispensed (40-Y 0-N)",40,0,0,0,40
1885933,1464716,2024-02-12,Senate,"Senate: Read third time and passed Senate (40-Y 0-N)",40,0,0,0,40
1885933,1464717,2024-02-19,House,"House: Subcommittee recommends continuing to 2025 with amendment(s) (9-Y 1-N)",9,1,0,0,10
1885935,1464718,2024-01-29,Senate,"Senate: Continued to 2025 in Commerce and Labor (15-Y 0-N)",15,0,0,0,15
1885936,1464719,2024-01-24,Senate,"Senate: Continued to 2025 in General Laws and Technology (15-Y 0-N)",15,0,0,0,15
1885938,1464720,2024-02-09,Senate,"Senate: Reported from Rules with amendments (15-Y 0-N)",15,0,0,0,15
1885938,1464721,2024-02-09,Senate,"Senate: Constitutional reading dispensed (39-Y 0-N)",39,0,0,1,40
1885938,1464722,2024-02-12,Senate,"Senate: Constitutional reading dispensed (40-Y 0-N)",40,0,0,0,40
1885938,1464723,2024-02-12,Senate,"Senate: Passed Senate (40-Y 0-N)",40,0,0,0,40
1885938,1464724,2024-02-23,House,"House: Subcommittee recommends reporting (6-Y 0-N)",6,0,0,0,6
1885938,1464725,2024-02-23,House,"House: Reported from Rules (16-Y 0-N)",16,0,0,2,18
1885940,1464726,2024-01-23,Senate,"Senate: Passed by indefinitely in Agriculture, Conservation and Natural Resources (9-Y 6-N)",9,6,0,0,15
1885940,1464727,2024-01-30,Senate,"Senate: Continued to 2025 in Agriculture, Conservation and Natural Resources (9-Y 6-N)",9,6,0,0,15
1885941,1464728,2024-01-25,Senate,"Senate: Reported from Education and Health with substitute (8-Y 6-N 1-A)",8,6,1,0,15
1885941,1464729,2024-02-06,Senate,"Senate: Reported from Finance and Appropriations (10-Y 5-N)",10,5,0,0,15
1885941,1464730,2024-02-07,Senate,"Senate: Constitutional reading dispensed (40-Y 0-N)",40,0,0,0,40
1885941,1464731,2024-02-09,Senate,"Senate: Read third time and passed Senate (21-Y 19-N)",21,19,0,0,40
1885944,1464732,2024-02-01,House,"House: Subcommittee recommends reporting with amendments (3-Y 2-N)",3,2,0,3,8
1885944,1464733,2024-02-06,House,"House: Reported from General Laws with amendment(s) (12-Y 8-N)",12,8,0,2,22
1885945,1464734,2024-02-08,Senate,"Senate: Continued to 2025 in Education and Health (15-Y 0-N)",15,0,0,0,15
1885946,1464735,2024-02-05,Senate,"Senate: Continued to 2025 in Commerce and Labor (15-Y 0-N)",15,0,0,0,15
1885948,1464736,2024-02-02,Senate,"Senate: Continued to 2025 in Rehabilitation and Social Services (13-Y 0-N)",13,0,0,0,13
1885949,1464737,2024-02-06,Senate,"Senate: Continued to 2025 in Finance and Appropriations (14-Y 0-N)",14,0,0,0,14
1885950,1464738,2024-02-01,House,"House: Subcommittee recommends reporting with amendments (8-Y 0-N)",8,0,0,0,8
1885950,1464739,2024-02-02,House,"House: Reported from Counties, Cities and Towns with amendment(s) (22-Y 0-N)",22,0,0,0,22
1885950,1464740,2024-02-08,House,"House: VOTE: Block Vote Passage (98-Y 0-N)",98,0,0,2,100
1885950,1464741,2024-02-19,Senate,"Senate: Reported from Local Government with substitute (14-Y 0-N)",14,0,0,0,14
1885950,1464742,2024-02-27,Senate,"Senate: Continued to 2025 in Finance and Appropriations (10-Y 5-N)",10,5,0,0,15
1885955,1464743,2024-02-05,House,"House: Subcommittee recommends reporting with amendments (5-Y 3-N)",5,3,0,1,9
1885955,1464744,2024-02-09,House,"House: Reported from Privileges and Elections with amendment(s) (12-Y 10-N)",12,10,0,0,22
1885955,1464745,2024-02-13,House,"House: VOTE: Passage (52-Y 47-N)",52,47,0,1,100
1885955,1464746,2024-02-27,Senate,"Senate: Continued to 2025 in Privileges and Elections (15-Y 0-N)",15,0,0,0,15
1885957,1464747,2024-02-01,Senate,"Senate: Reported from Education and Health with substitute (9-Y 6-N)",9,6,0,0,15
1885957,1464748,2024-02-12,Senate,"Senate: Continued to 2025 in Finance and Appropriations (15-Y 0-N)",15,0,0,0,15
1885958,1464749,2024-01-30,House,"House: Subcommittee recommends reporting (9-Y 0-N)",9,0,0,0,9
1885958,1464750,2024-01-31,House,"House: Reported from Education (17-Y 5-N)",17,5,0,0,22
1885958,1464751,2024-02-05,House,"House: Subcommittee recommends reporting with amendments (7-Y 1-N)",7,1,0,1,9
1885958,1464752,2024-02-07,House,"House: Reported from Appropriations with amendment(s) (14-Y 8-N)",14,8,0,0,22
1885958,1464753,2024-02-13,House,"House: VOTE: Passage (63-Y 36-N)",63,36,0,1,100
1885958,1464754,2024-02-29,Senate,"Senate: Reported from Education and Health (15-Y 0-N)",15,0,0,0,15
1885958,1464755,2024-03-04,Senate,"Senate: Continued to 2025 in Finance and Appropriations (15-Y 0-N)",15,0,0,0,15
1885960,1464756,2024-01-24,House,"House: Continued to 2025 in Agriculture, Chesapeake and Natural Resources (22-Y 0-N)",22,0,0,0,22
1885962,1464757,2024-02-05,Senate,"Senate: Reported from Commerce and Labor (15-Y 0-N)",15,0,0,0,15
1885962,1464758,2024-02-12,Senate,"Senate: Continued to 2025 in Finance and Appropriations (14-Y 1-N)",14,1,0,0,15
1885963,1464759,2024-01-23,House,"House: Subcommittee recommends reporting (8-Y 0-N)",8,0,0,1,9
1885963,1464760,2024-01-24,House,"House: Reported from Education (21-Y 0-N)",21,0,0,1,22
1885963,1464761,2024-01-30,House,"House: VOTE: Block Vote Passage (100-Y 0-N)",100,0,0,0,100
1885963,1464762,2024-02-22,Senate,"Senate: Reported from Education and Health (15-Y 0-N)",15,0,0,0,15
1885963,1464763,2024-02-27,Senate,"Senate: Continued to 2025 in Finance and Appropriations (15-Y 0-N)",15,0,0,0,15
1885965,1464764,2024-01-23,House,"House: Subcommittee recommends reporting with substitute (7-Y 0-N)",7,0,0,0,7
1885965,1464765,2024-01-25,House,"House: Reported from Labor and Commerce with substitute (21-Y 0-N)",21,0,0,1,22
1885966,1464766,2024-01-31,House,"House: Subcommittee recommends reporting with substitute (5-Y 3-N)",5,3,0,1,9
1885966,1464767,2024-02-02,House,"House: Reported from Appropriations with substitute (13-Y 9-N)",13,9,0,0,22
1885966,1464768,2024-02-08,House,"House: VOTE: Passage (55-Y 43-N)",55,43,0,2,100
1885966,1464769,2024-02-27,Senate,"Senate: Continued to 2025 in Finance and Appropriations (15-Y 0-N)",15,0,0,0,15
1885969,1464770,2024-02-01,House,"House: Subcommittee recommends reporting with substitute (8-Y 0-N)",8,0,0,1,9
1885971,1464771,2024-01-22,Senate,"Senate: Reported from Commerce and Labor (9-Y 6-N)",9,6,0,0,15
1885971,1464772,2024-01-31,Senate,"Senate: Continued to 2025 in Finance and Appropriations (15-Y 0-N)",15,0,0,0,15
1885973,1464773,2024-02-08,Senate,"Senate: Reported from Local Government with substitute (9-Y 6-N)",9,6,0,0,15
1885973,1464774,2024-02-08,Senate,"Senate: Constitutional reading dispensed (40-Y 0-N)",40,0,0,0,40
1885973,1464775,2024-02-12,Senate,"Senate: Read third time and passed Senate (21-Y 18-N)",21,18,0,1,40
1885975,1464776,2024-02-01,House,"House: Subcommittee recommends reporting (5-Y 0-N)",5,0,0,3,8
1885975,1464777,2024-02-06,House,"House: Reported from General Laws (20-Y 0-N)",20,0,0,2,22
1885975,1464778,2024-02-12,House,"House: VOTE: Block Vote Passage (100-Y 0-N)",100,0,0,0,100
1885975,1464779,2024-02-21,Senate,"Senate: Reported from General Laws and Technology (8-Y 0-N)",8,0,0,0,8
1885975,1464780,2024-02-29,Senate,"Senate: Continued to 2025 in Finance and Appropriations (13-Y 1-N)",13,1,0,0,14
1885977,1464781,2024-01-30,Senate,"Senate: Reported from Agriculture, Conservation and Natural Resources with amendment (15-Y 0-N)",15,0,0,0,15
1885977,1464782,2024-02-06,Senate,"Senate: Continued to 2025 in Finance and Appropriations (13-Y 2-N)",13,2,0,0,15
1885978,1464783,2024-02-06,Senate,"Senate: Reported from Finance and Appropriations with substitute (15-Y 0-N)",15,0,0,0,15
1885978,1464784,2024-02-07,Senate,"Senate: Constitutional reading dispensed (40-Y 0-N)",40,0,0,0,40
1885978,1464785,2024-02-08,Senate,"Senate: Constitutional reading dispensed (40-Y 0-N)",40,0,0,0,40
1885978,1464786,2024-02-08,Senate,"Senate: Read third time and passed Senate (40-Y 0-N)",40,0,0,0,40
1885979,1464787,2024-01-25,House,"House: Subcommittee recommends reporting (5-Y 3-N)",5,3,0,0,8
1885979,1464788,2024-01-30,House,"House: Reported from Labor and Commerce (12-Y 10-N)",12,10,0,0,22
1885980,1464789,2024-01-25,Senate,"Senate: Reported from Education and Health with substitute (15-Y 0-N)",15,0,0,0,15
1885980,1464790,2024-02-07,Senate,"Senate: Continued to 2025 in Finance and Appropriations (10-Y 5-N)",10,5,0,0,15
1885981,1464791,2024-02-08,Senate,"Senate: Continued to 2025 in Education and Health (15-Y 0-N)",15,0,0,0,15
1885985,1464792,2024-01-30,House,"House: Subcommittee recommends reporting with amendments (5-Y 2-N)",5,2,0,0,7
1885985,1464793,2024-02-01,House,"House: Reported from Labor and Commerce with amendment(s) (16-Y 6-N)",16,6,0,0,22
1885986,1464794,2024-01-30,House,"House: Subcommittee recommends reporting (8-Y 0-N)",8,0,0,1,9
1885986,1464795,2024-02-01,House,"House: Reported from General Laws (22-Y 0-N)",22,0,0,0,22
1885986,1464796,2024-02-07,House,"House: VOTE: Passage (92-Y 6-N)",92,6,0,2,100
1885986,1464797,2024-02-14,Senate,"Senate: Reported from General Laws and Technology with substitute (15-Y 0-N)",15,0,0,0,15
1885986,1464798,2024-02-27,Senate,"Senate: Continued to 2025 in Finance and Appropriations (14-Y 1-N)",14,1,0,0,15
1885987,1464799,2024-01-31,Senate,"Senate: Reported from General Laws and Technology with substitute (8-Y 7-N)",8,7,0,0,15
1885987,1464800,2024-02-09,Senate,"Senate: Reported from Commerce and Labor with substitute (8-Y 6-N)",8,6,0,0,14
1885987,1464801,2024-02-12,Senate,"Senate: Continued to 2025 in Finance and Appropriations (11-Y 4-N)",11,4,0,0,15
1885989,1464802,2024-01-23,House,"House: Subcommittee recommends reporting (7-Y 0-N)",7,0,0,1,8
1885989,1464803,2024-01-24,House,"House: Reported from Education (18-Y 3-N)",18,3,0,1,22
1885990,1464804,2024-01-25,House,"House: Subcommittee recommends reporting with substitute (6-Y 4-N)",6,4,0,0,10
1885990,1464805,2024-01-26,House,"House: Reported from Public Safety with substitute (12-Y 10-N)",12,10,0,0,22
1885990,1464806,2024-02-01,House,"House: VOTE: Passage (51-Y 49-N)",51,49,0,0,100
1885990,1464807,2024-02-28,Senate,"Senate: Continued to 2025 in Courts of Justice (15-Y 0-N)",15,0,0,0,15
1885991,1464808,2024-02-05,House,"House: Subcommittee recommends continuing to 2025 (7-Y 0-N)",7,0,0,1,8
1885992,1464809,2024-02-06,House,"House: Subcommittee recommends reporting (8-Y 0-N)",8,0,0,0,8
1885992,1464810,2024-02-07,House,"House: Reported from Education (22-Y 0-N)",22,0,0,0,22
1885992,1464811,2024-02-13,House,"House: VOTE: Block Vote Passage (99-Y 0-N)",99,0,0,1,100
1885992,1464812,2024-02-29,Senate,"Senate: Reported from Education and Health (15-Y 0-N)",15,0,0,0,15
1885992,1464813,2024-03-04,Senate,"Senate: Continued to 2025 in Finance and Appropriations (14-Y 1-N)",14,1,0,0,15
1885993,1464814,2024-02-05,Senate,"Senate: Continued to 2025 in Commerce and Labor (11-Y 4-N)",11,4,0,0,15
1885994,1464815,2024-02-05,Senate,"Senate: Continued to 2025 in Courts of Justice (12-Y 0-N)",12,0,0,0,12
1885999,1464816,2024-02-05,House,"House: Subcommittee recommends reporting with substitute (8-Y 2-N)",8,2,0,0,10
1885999,1464817,2024-02-07,House,"House: Reported from Agriculture, Chesapeake and Natural Resources with substitute (19-Y 3-N)",19,3,0,0,22
1885999,1464818,2024-02-13,House,"House: VOTE: Passage (90-Y 9-N)",90,9,0,1,100
1885999,1464819,2024-02-21,Senate,"Senate: Continued to 2025 in Courts of Justice (15-Y 0-N)",15,0,0,0,15
1886000,1464820,2024-01-29,Senate,"Senate: Continued to 2025 in Local Government (15-Y 0-N)",15,0,0,0,15
1886001,1464821,2024-01-25,Senate,"Senate: Rereferred from Education and Health (14-Y 0-N)",14,0,0,0,14
1886001,1464822,2024-01-31,Senate,"Senate: Continued to 2025 in Courts of Justice (15-Y 0-N)",15,0,0,0,15
1886004,1464823,2024-01-30,House,"House: Subcommittee recommends reporting with amendments (8-Y 0-N)",8,0,0,0,8
1886004,1464824,2024-02-05,House,"House: Reported from Education with amendment(s) (20-Y 2-N)",20,2,0,0,22
1886004,1464825,2024-02-12,House,"House: VOTE: Passage (81-Y 19-N)",81,19,0,0,100
1886004,1464826,2024-02-29,Senate,"Senate: Continued to 2025 in Education and Health (14-Y 1-N)",14,1,0,0,15
1886006,1464827,2024-02-02,House,"House: Subcommittee recommends reporting (8-Y 0-N)",8,0,0,0,8
1886006,1464828,2024-02-02,House,"House: Reported from Counties, Cities and Towns (19-Y 3-N)",19,3,0,0,22
1886006,1464829,2024-02-08,House,"House: VOTE: Passage (75-Y 23-N)",75,23,0,2,100
1886006,1464830,2024-02-26,Senate,"Senate: Continued to 2025 in Local Government (14-Y 0-N)",14,0,0,0,14
1886007,1464831,2024-02-08,Senate,"Senate: Reported from Education and Health with substitute (15-Y 0-N)",15,0,0,0,15
1886007,1464832,2024-02-08,Senate,"Senate: Reported from Finance and Appropriations with substitute (15-Y 0-N)",15,0,0,0,15
1886007,1464833,2024-02-09,Senate,"Senate: Constitutional reading dispensed (39-Y 0-N)",39,0,0,1,40
1886007,1464834,2024-02-12,Senate,"Senate: Constitutional reading dispensed (40-Y 0-N)",40,0,0,0,40
1886007,1464835,2024-02-12,Senate,"Senate: Passed Senate (40-Y 0-N)",40,0,0,0,40
1886008,1464836,2024-02-09,Senate,"Senate: Reading waived (39-Y 0-N)",39,0,0,1,40
1886008,1464837,2024-02-23,House,"House: Subcommittee recommends reporting (6-Y 0-N)",6,0,0,0,6
1886008,1464838,2024-02-23,House,"House: Reported from Rules (16-Y 0-N)",16,0,0,2,18
1886009,1464839,2024-01-23,Senate,"Senate: Reported from Agriculture, Conservation and Natural Resources with amendment (9-Y 6-N)",9,6,0,0,15
1886009,1464840,2024-01-30,Senate,"Senate: Continued to 2025 in Finance and Appropriations (10-Y 5-N)",10,5,0,0,15
1886010,1464841,2024-02-08,Senate,"Senate: Continued to 2025 in Education and Health (15-Y 0-N)",15,0,0,0,15
1886011,1464842,2024-01-22,House,"House: Subcommittee recommends reporting (6-Y 2-N)",6,2,0,1,9
1886011,1464843,2024-01-26,House,"House: Reported from Courts of Justice (11-Y 10-N)",11,10,0,1,22
1886011,1464844,2024-02-01,House,"House: VOTE: Passage (62-Y 37-N)",62,37,0,1,100
1886011,1464845,2024-02-14,Senate,"Senate: Continued to 2025 in Courts of Justice (8-Y 7-N)",8,7,0,0,15
1886016,1464846,2024-02-06,House,"House: Subcommittee recommends reporting with substitute (6-Y 2-N)",6,2,0,1,9
1886016,1464847,2024-02-07,House,"House: Continued to 2025 with substitute in Finance (12-Y 9-N)",12,9,0,1,22
1886017,1464848,2024-02-06,Senate,"Senate: Continued to 2025 in Finance and Appropriations (15-Y 0-N)",15,0,0,0,15
1886018,1464849,2024-01-30,Senate,"Senate: Continued to 2025 in Finance and Appropriations (14-Y 1-N)",14,1,0,0,15
1886020,1464850,2024-01-19,Senate,"Senate: Reported from Rehabilitation and Social Services (13-Y 0-N 2-A)",13,0,2,0,15
1886020,1464851,2024-01-31,Senate,"Senate: Continued to 2025 in Finance and Appropriations (15-Y 0-N)",15,0,0,0,15
1886021,1464852,2024-01-22,Senate,"Senate: Reported from Commerce and Labor with amendments (14-Y 0-N)",14,0,0,0,14
1886021,1464853,2024-02-07,Senate,"Senate: Reported from Finance and Appropriations with substitute (15-Y 0-N)",15,0,0,0,15
1886021,1464854,2024-02-08,Senate,"Senate: Constitutional reading dispensed (40-Y 0-N)",40,0,0,0,40
1886021,1464855,2024-02-09,Senate,"Senate: Constitutional reading dispensed (40-Y 0-N)",40,0,0,0,40
1886021,1464856,2024-02-09,Senate,"Senate: Passed Senate (40-Y 0-N)",40,0,0,0,40
1886021,1464857,2024-02-20,House,"House: Reported from Labor and Commerce (22-Y 0-N)",22,0,0,0,22
1886028,1464858,2024-02-05,House,"House: Subcommittee recommends continuing to 2025 with substitute (7-Y 0-N)",7,0,0,1,8
1886029,1464859,2024-01-24,House,"House: Subcommittee recommends reporting with substitute (5-Y 3-N)",5,3,0,0,8
1886029,1464860,2024-01-30,House,"House: Reported from Transportation with substitute (18-Y 4-N)",18,4,0,0,22
1886029,1464861,2024-02-09,House,"House: Subcommittee recommends reporting (5-Y 2-N)",5,2,0,2,9
1886029,1464862,2024-02-09,House,"House: Reported from Appropriations (12-Y 8-N)",12,8,0,2,22
1886029,1464863,2024-02-13,House,"House: VOTE: Passage (55-Y 42-N)",55,42,0,3,100
1886029,1464864,2024-02-26,Senate,"Senate: Reported from Transportation (8-Y 7-N)",8,7,0,0,15
1886029,1464865,2024-02-27,Senate,"Senate: Continued to 2025 in Finance and Appropriations (12-Y 3-N)",12,3,0,0,15
1886031,1464866,2024-01-26,House,"House: Subcommittee recommends continuing to 2025 (8-Y 0-N)",8,0,0,1,9
1886032,1464867,2024-02-06,House,"House: Subcommittee recommends reporting with substitute (5-Y 2-N)",5,2,0,1,8
1886032,1464868,2024-02-08,House,"House: Reported from General Laws with substitute (13-Y 7-N)",13,7,0,2,22
1886032,1464869,2024-02-09,House,"House: Subcommittee recommends reporting with substitute (4-Y 3-N)",4,3,0,2,9
1886032,1464870,2024-02-09,House,"House: Reported from Appropriations with substitute (11-Y 9-N)",11,9,0,2,22
1886032,1464871,2024-02-13,House,"House: VOTE: Passage (51-Y 48-N)",51,48,0,1,100
1886032,1464872,2024-02-21,Senate,"Senate: Reported from General Laws and Technology (9-Y 5-N)",9,5,0,0,14
1886032,1464873,2024-02-27,Senate,"Senate: Continued to 2025 in Finance and Appropriations (15-Y 0-N)",15,0,0,0,15
1886034,1464874,2024-01-25,Senate,"Senate: Reported from Education and Health with substitute (11-Y 2-N 2-A)",11,2,2,0,15
1886034,1464875,2024-01-26,Senate,"Senate: Constitutional reading dispensed (37-Y 0-N)",37,0,0,3,40
1886034,1464876,2024-01-30,Senate,"Senate: Read third time and passed Senate (34-Y 6-N)",34,6,0,0,40
1886035,1464877,2024-02-06,Senate,"Senate: Continued to 2025 in Finance and Appropriations (14-Y 1-N)",14,1,0,0,15
1886036,1464878,2024-02-07,House,"House: Reported from Finance with amendment(s) (21-Y 0-N)",21,0,0,1,22
1886036,1464879,2024-02-13,House,"House: VOTE: Block Vote Passage (99-Y 0-N)",99,0,0,1,100
1886036,1464880,2024-02-27,Senate,"Senate: Continued to 2025 in Finance and Appropriations (15-Y 0-N)",15,0,0,0,15
1886038,1464881,2024-02-05,Senate,"Senate: Continued to 2025 in Commerce and Labor (15-Y 0-N)",15,0,0,0,15
1886039,1464882,2024-02-07,Senate,"Senate: Continued to 2025 in Courts of Justice (13-Y 2-N)",13,2,0,0,15
1886044,1464883,2024-01-26,House,"House: Subcommittee recommends continuing to 2025 with amendment(s) (0-Y 0-N)",0,0,0,8,8
1886045,1464884,2024-02-01,House,"House: Subcommittee recommends reporting with substitute (3-Y 2-N)",3,2,0,3,8
1886045,1464885,2024-02-06,House,"House: Reported from General Laws with substitute (10-Y 9-N)",10,9,0,3,22
1886045,1464886,2024-02-09,House,"House: Subcommittee recommends reporting with amendments (4-Y 3-N)",4,3,0,2,9
1886046,1464887,2024-01-22,House,"House: Subcommittee recommends reporting with amendments (10-Y 0-N)",10,0,0,0,10
1886046,1464888,2024-01-24,House,"House: Reported from Education with amendment(s) (21-Y 0-N)",21,0,0,1,22
1886046,1464889,2024-01-31,House,"House: Subcommittee recommends reporting with amendments (8-Y 0-N)",8,0,0,1,9
1886046,1464890,2024-01-31,House,"House: Reported from Appropriations with amendment(s) (22-Y 0-N)",22,0,0,0,22
1886046,1464891,2024-02-06,House,"House: VOTE: Block Vote Passage (99-Y 0-N)",99,0,0,1,100
1886046,1464892,2024-02-15,Senate,"Senate: Reported from Education and Health (13-Y 0-N)",13,0,0,0,13
1886046,1464893,2024-02-27,Senate,"Senate: Continued to 2025 in Finance and Appropriations (13-Y 2-N)",13,2,0,0,15
1886047,1465250,2024-02-07,Senate,"Senate: Continued to 2025 in Finance and Appropriations (13-Y 2-N)",13,2,0,0,15
1886048,1464894,2024-02-05,Senate,"Senate: Reported from Local Government with substitute (8-Y 6-N 1-A)",8,6,1,0,15
1886048,1464895,2024-02-06,Senate,"Senate: Constitutional reading dispensed (39-Y 0-N)",39,0,0,1,40
1886048,1464896,2024-02-09,Senate,"Senate: Engrossment reconsidered by Senate (40-Y 0-N)",40,0,0,0,40
1886048,1464897,2024-02-09,Senate,"Senate: Constitutional reading dispensed (38-Y 2-N)",38,2,0,0,40
1886048,1464898,2024-02-09,Senate,"Senate: Passed Senate (22-Y 18-N)",22,18,0,0,40
1886049,1464899,2024-02-06,Senate,"Senate: Continued to 2025 in Finance and Appropriations (14-Y 0-N)",14,0,0,0,14
1886051,1464900,2024-02-01,Senate,"Senate: Continued to 2025 in Education and Health (15-Y 0-N)",15,0,0,0,15
1886052,1464901,2024-01-30,Senate,"Senate: Reported from Privileges and Elections with substitute (8-Y 7-N)",8,7,0,0,15
1886052,1464902,2024-02-07,Senate,"Senate: Reported from Finance and Appropriations (10-Y 5-N)",10,5,0,0,15
1886052,1464903,2024-02-08,Senate,"Senate: Constitutional reading dispensed (40-Y 0-N)",40,0,0,0,40
1886052,1464904,2024-02-12,Senate,"Senate: Read third time and passed Senate (21-Y 19-N)",21,19,0,0,40
1886055,1464905,2024-01-22,Senate,"Senate: Reported from Commerce and Labor (8-Y 6-N)",8,6,0,0,14
1886055,1464906,2024-01-31,Senate,"Senate: Continued to 2025 in Finance and Appropriations (15-Y 0-N)",15,0,0,0,15
1886057,1464907,2024-01-29,Senate,"Senate: Reading waived (40-Y 0-N)",40,0,0,0,40
1886057,1464908,2024-02-23,House,"House: Reported from Rules (17-Y 0-N)",17,0,0,1,18
1886060,1464909,2024-01-22,House,"House: Subcommittee recommends reporting (8-Y 0-N)",8,0,0,1,9
1886060,1464910,2024-01-26,House,"House: Reported from Courts of Justice (21-Y 0-N)",21,0,0,1,22
1886061,1464911,2024-02-07,Senate,"Senate: Continued to 2025 in General Laws and Technology (13-Y 2-N)",13,2,0,0,15
1886062,1464912,2024-01-26,House,"House: Subcommittee recommends reporting with amendments (5-Y 3-N)",5,3,0,1,9
1886062,1464913,2024-02-02,House,"House: Reported from Courts of Justice with amendment(s) (12-Y 9-N)",12,9,0,1,22
1886062,1464914,2024-02-08,House,"House: VOTE: Passage (50-Y 47-N)",50,47,0,3,100
1886062,1464915,2024-02-19,Senate,"Senate: Reported from Courts of Justice with substitute (8-Y 5-N)",8,5,0,0,13
1886062,1464916,2024-02-27,Senate,"Senate: Continued to 2025 in Finance and Appropriations (14-Y 1-N)",14,1,0,0,15
1886063,1464917,2024-01-31,Senate,"Senate: Continued to 2025 in General Laws and Technology (8-Y 7-N)",8,7,0,0,15
1886065,1464918,2024-01-31,House,"House: Subcommittee recommends reporting with substitute (8-Y 0-N)",8,0,0,1,9
1886065,1464919,2024-02-02,House,"House: Reported from Courts of Justice with substitute (21-Y 0-N)",21,0,0,1,22
1886065,1464920,2024-02-08,House,"House: VOTE: Block Vote Passage (98-Y 0-N)",98,0,0,2,100
1886065,1464921,2024-02-19,Senate,"Senate: Continued to 2025 in Courts of Justice (11-Y 2-N)",11,2,0,0,13
1886069,1464922,2024-02-08,Senate,"Senate: Continued to 2025 in Education and Health (15-Y 0-N)",15,0,0,0,15
1886073,1464923,2024-02-02,Senate,"Senate: Reported from Rules (14-Y 0-N)",14,0,0,0,14
1886073,1464924,2024-02-05,Senate,"Senate: Constitutional reading dispensed (39-Y 0-N)",39,0,0,1,40
1886073,1464925,2024-02-06,Senate,"Senate: Constitutional reading dispensed (39-Y 0-N)",39,0,0,1,40
1886073,1464926,2024-02-06,Senate,"Senate: Passed Senate (39-Y 0-N)",39,0,0,1,40
1886073,1464927,2024-02-23,House,"House: Subcommittee recommends reporting (6-Y 0-N)",6,0,0,0,6
1886073,1464928,2024-02-23,House,"House: Reported from Rules (16-Y 0-N)",16,0,0,2,18
1886074,1464929,2024-01-25,House,"House: Subcommittee recommends reporting (8-Y 0-N)",8,0,0,1,9
1886074,1464930,2024-01-26,House,"House: Reported from Counties, Cities and Towns (19-Y 1-N)",19,1,0,2,22
1886074,1464931,2024-02-01,House,"House: VOTE: Passage (85-Y 15-N)",85,15,0,0,100
1886074,1464932,2024-02-19,Senate,"Senate: Reported from Local Government with amendments (9-Y 6-N)",9,6,0,0,15
1886074,1464933,2024-02-20,Senate,"Senate: Constitutional reading dispensed (39-Y 0-N)",39,0,0,1,40
1886074,1464934,2024-02-28,Senate,"Senate: Continued to 2025 in General Laws and Technology (15-Y 0-N)",15,0,0,0,15
1886076,1464935,2024-01-23,Senate,"Senate: Continued to 2025 in Agriculture, Conservation and Natural Resources (13-Y 2-N)",13,2,0,0,15
1886078,1464936,2024-02-06,Senate,"Senate: Continued to 2025 in Finance and Appropriations (14-Y 0-N)",14,0,0,0,14
1886079,1464937,2024-01-25,Senate,"Senate: Reported from Education and Health (14-Y 1-N)",14,1,0,0,15
1886079,1464938,2024-01-31,Senate,"Senate: Reported from Finance and Appropriations with substitute (15-Y 0-N)",15,0,0,0,15
1886079,1464939,2024-02-01,Senate,"Senate: Constitutional reading dispensed (40-Y 0-N)",40,0,0,0,40
1886079,1464940,2024-02-05,Senate,"Senate: Read third time and passed Senate (35-Y 5-N)",35,5,0,0,40
1886080,1464941,2024-02-01,Senate,"Senate: Reported from Education and Health with substitute (15-Y 0-N)",15,0,0,0,15
1886080,1464942,2024-02-02,Senate,"Senate: Constitutional reading dispensed (38-Y 0-N)",38,0,0,2,40
1886080,1464943,2024-02-12,Senate,"Senate: Continued to 2025 in Finance and Appropriations (15-Y 0-N)",15,0,0,0,15
1886081,1464944,2024-02-01,Senate,"Senate: Continued to 2025 in Education and Health (15-Y 0-N)",15,0,0,0,15
1886082,1464945,2024-02-08,Senate,"Senate: Continued to 2025 in Education and Health (15-Y 0-N)",15,0,0,0,15
1886087,1464946,2024-01-29,House,"House: Subcommittee recommends reporting (6-Y 0-N)",6,0,0,0,6
1886087,1464947,2024-02-01,House,"House: Reported from Rules (18-Y 0-N)",18,0,0,0,18
1886087,1464948,2024-02-05,House,"House: Subcommittee recommends reporting with substitute (8-Y 0-N)",8,0,0,1,9
1886087,1464949,2024-02-07,House,"House: Reported from Appropriations with substitute (22-Y 0-N)",22,0,0,0,22
1886087,1464950,2024-02-12,House,"House: VOTE: Block vote adoption (97-Y 0-N)",97,0,0,3,100
1886087,1464951,2024-03-04,Senate,"Senate: Continued to 2025 in Finance and Appropriations (15-Y 0-N)",15,0,0,0,15
1886088,1464952,2024-02-08,House,"House: Subcommittee recommends reporting with substitute (5-Y 3-N)",5,3,0,0,8
1886088,1464953,2024-02-08,House,"House: Reported from Labor and Commerce with substitute (12-Y 10-N)",12,10,0,0,22
1886088,1464954,2024-02-13,House,"House: VOTE: Passage (51-Y 48-N)",51,48,0,1,100
1886088,1464955,2024-02-26,Senate,"Senate: Reported from Local Government (8-Y 7-N)",8,7,0,0,15
1886088,1464956,2024-02-29,Senate,"Senate: Continued to 2025 in Finance and Appropriations (14-Y 0-N)",14,0,0,0,14
1886090,1464957,2024-01-23,Senate,"Senate: Reported from Privileges and Elections with amendments (13-Y 1-N)",13,1,0,0,14
1886090,1464958,2024-01-31,Senate,"Senate: Reported from Finance and Appropriations (15-Y 0-N)",15,0,0,0,15
1886090,1464959,2024-02-01,Senate,"Senate: Constitutional reading dispensed (40-Y 0-N)",40,0,0,0,40
1886090,1464960,2024-02-06,Senate,"Senate: Read third time and passed Senate (35-Y 4-N)",35,4,0,1,40
1886090,1464961,2024-02-23,House,"House: Reported from Privileges and Elections (22-Y 0-N)",22,0,0,0,22
1886093,1464962,2024-02-08,Senate,"Senate: Continued to 2025 in Education and Health (15-Y 0-N)",15,0,0,0,15
1886095,1464963,2024-02-07,House,"House: Subcommittee recommends reporting with substitute (5-Y 3-N)",5,3,0,0,8
1886095,1464964,2024-02-08,House,"House: Reported from Health and Human Services with substitute (12-Y 8-N)",12,8,1,1,22
1886095,1464965,2024-02-13,House,"House: VOTE: Passage (71-Y 28-N)",71,28,0,1,100
1886095,1464966,2024-02-29,Senate,"Senate: Continued to 2025 in Education and Health (14-Y 1-N)",14,1,0,0,15
1886096,1464967,2024-02-12,Senate,"Senate: Continued to 2025 in Courts of Justice (14-Y 0-N)",14,0,0,0,14
1886098,1464968,2024-01-22,Senate,"Senate: Continued to 2025 in Local Government (12-Y 3-N)",12,3,0,0,15
1886099,1464969,2024-01-25,House,"House: Subcommittee recommends reporting (5-Y 3-N)",5,3,0,0,8
1886101,1464970,2024-02-09,Senate,"Senate: Continued to 2025 in Commerce and Labor (15-Y 0-N)",15,0,0,0,15
1886102,1464971,2024-01-23,Senate,"Senate: Continued to 2025 in Agriculture, Conservation and Natural Resources (10-Y 5-N)",10,5,0,0,15
1886104,1464972,2024-01-25,House,"House: Subcommittee recommends continuing to 2025 (8-Y 0-N)",8,0,0,1,9
1886105,1464973,2024-01-22,Senate,"Senate: Continued to 2025 in Commerce and Labor (15-Y 0-N)",15,0,0,0,15
1886109,1464974,2024-01-15,Senate,"Senate: Reported from Courts of Justice (8-Y 7-N)",8,7,0,0,15
1886109,1464975,2024-01-16,Senate,"Senate: Constitutional reading dispensed (38-Y 0-N)",38,0,0,1,39
1886109,1464976,2024-01-18,Senate,"Senate: Read third time and passed Senate (21-Y 19-N)",21,19,0,0,40
1886109,1464977,2024-02-23,House,"House: Reported from Courts of Justice (11-Y 10-N)",11,10,0,1,22
1886110,1464978,2024-02-05,Senate,"Senate: Continued to 2025 in Commerce and Labor (9-Y 6-N)",9,6,0,0,15
1886111,1464979,2024-01-29,Senate,"Senate: Continued to 2025 in Local Government (8-Y 7-N)",8,7,0,0,15
1886112,1464980,2024-01-25,Senate,"Senate: Reported from Education and Health with amendment (15-Y 0-N)",15,0,0,0,15
1886112,1464981,2024-01-31,Senate,"Senate: Continued to 2025 in Finance and Appropriations (10-Y 5-N)",10,5,0,0,15
1886113,1464982,2024-01-31,Senate,"Senate: Continued to 2025 in General Laws and Technology (8-Y 6-N 1-A)",8,6,1,0,15
1886115,1464983,2024-02-01,House,"House: Continued to 2025 in Transportation (22-Y 0-N)",22,0,0,0,22
1886116,1464984,2024-02-07,Senate,"Senate: Reported from General Laws and Technology with substitute (9-Y 6-N)",9,6,0,0,15
1886116,1464985,2024-02-12,Senate,"Senate: Continued to 2025 in Finance and Appropriations (15-Y 0-N)",15,0,0,0,15
1886122,1464986,2024-01-30,House,"House: Subcommittee recommends reporting with amendments (8-Y 0-N)",8,0,0,0,8
1886124,1464987,2024-02-07,Senate,"Senate: Reported from General Laws and Technology (15-Y 0-N)",15,0,0,0,15
1886124,1464988,2024-02-12,Senate,"Senate: Continued to 2025 in Finance and Appropriations (10-Y 5-N)",10,5,0,0,15
1886125,1464989,2024-01-30,House,"House: Subcommittee recommends reporting with amendments (9-Y 0-N)",9,0,0,0,9
1886125,1464990,2024-01-31,House,"House: Reported from Education with amendment(s) (18-Y 4-N)",18,4,0,0,22
1886126,1464991,2024-02-07,Senate,"Senate: Reported from General Laws and Technology with substitute (14-Y 0-N)",14,0,0,0,14
1886126,1464992,2024-02-12,Senate,"Senate: Reported from Finance and Appropriations (15-Y 0-N)",15,0,0,0,15
1886126,1464993,2024-02-12,Senate,"Senate: Constitutional reading dispensed (40-Y 0-N)",40,0,0,0,40
1886126,1464994,2024-02-13,Senate,"Senate: Constitutional reading dispensed (39-Y 0-N)",39,0,0,1,40
1886126,1464995,2024-02-13,Senate,"Senate: Passed Senate (40-Y 0-N)",40,0,0,0,40
1886126,1464996,2024-02-23,House,"House: Subcommittee recommends reporting (6-Y 0-N)",6,0,0,0,6
1886126,1464997,2024-02-23,House,"House: Reported from Rules (16-Y 0-N)",16,0,0,2,18
1886127,1464998,2024-01-26,Senate,"Senate: Rereferred from Rules (15-Y 0-N)",15,0,0,0,15
1886127,1464999,2024-02-05,Senate,"Senate: Continued to 2025 in Commerce and Labor (15-Y 0-N)",15,0,0,0,15
1886128,1465000,2024-01-29,Senate,"Senate: Continued to 2025 in Local Government (15-Y 0-N)",15,0,0,0,15
1886131,1465001,2024-01-30,Senate,"Senate: Continued to 2025 in Agriculture, Conservation and Natural Resources (15-Y 0-N)",15,0,0,0,15
1886132,1465002,2024-01-18,House,"House: Subcommittee recommends reporting with amendments (8-Y 0-N)",8,0,0,0,8
1886132,1465003,2024-01-23,House,"House: Reported from Health and Human Services with amendment(s) (16-Y 6-N)",16,6,0,0,22
1886132,1465004,2024-01-29,House,"House: VOTE: Passage (66-Y 32-N)",66,32,0,2,100
1886132,1465005,2024-02-15,Senate,"Senate: Rereferred from Education and Health (11-Y 0-N 1-A)",11,0,1,0,12
1886132,1465006,2024-03-01,Senate,"Senate: Continued to 2025 in Rehabilitation and Social Services (8-Y 6-N)",8,6,0,0,14
1886133,1465007,2024-02-05,Senate,"Senate: Reported from Courts of Justice with substitute (9-Y 6-N)",9,6,0,0,15
1886133,1465008,2024-02-07,Senate,"Senate: Reported from Finance and Appropriations (9-Y 5-N 1-A)",9,5,1,0,15
1886133,1465009,2024-02-08,Senate,"Senate: Constitutional reading dispensed (40-Y 0-N)",40,0,0,0,40
1886133,1465010,2024-02-13,Senate,"Senate: Constitutional reading dispensed (40-Y 0-N)",40,0,0,0,40
1886133,1465011,2024-02-13,Senate,"Senate: Passed Senate (21-Y 19-N)",21,19,0,0,40
1886133,1465012,2024-02-21,House,"House: Subcommittee recommends reporting (6-Y 2-N)",6,2,0,1,9
1886133,1465251,2024-02-23,House,"House: Reported from Courts of Justice (12-Y 9-N)",12,9,0,1,22
1886135,1465013,2024-02-05,House,"House: Subcommittee recommends continuing to 2025 (7-Y 0-N)",7,0,0,1,8
1886138,1465014,2024-02-09,Senate,"Senate: Reading waived (39-Y 0-N)",39,0,0,1,40
1886138,1465015,2024-02-12,Senate,"Senate: Reading waived (39-Y 0-N)",39,0,0,1,40
1886138,1465016,2024-02-23,House,"House: Subcommittee recommends reporting (6-Y 0-N)",6,0,0,0,6
1886138,1465017,2024-02-23,House,"House: Reported from Rules (16-Y 0-N)",16,0,0,2,18
1886139,1465018,2024-01-25,Senate,"Senate: Continued to 2025 in Education and Health (15-Y 0-N)",15,0,0,0,15
1886141,1465019,2024-01-31,Senate,"Senate: Reported from Courts of Justice with substitute (10-Y 5-N)",10,5,0,0,15
1886141,1465020,2024-02-07,Senate,"Senate: Continued to 2025 in Finance and Appropriations (14-Y 0-N 1-A)",14,0,1,0,15
1886142,1465021,2024-01-18,Senate,"Senate: Reported from Transportation with substitute (15-Y 0-N)",15,0,0,0,15
1886142,1465022,2024-01-30,Senate,"Senate: Continued to 2025 in Finance and Appropriations (9-Y 6-N)",9,6,0,0,15
1886143,1465023,2024-01-15,Senate,"Senate: Continued to 2025 in Courts of Justice (15-Y 0-N)",15,0,0,0,15
1886150,1465024,2024-02-06,Senate,"Senate: Continued to 2025 in Finance and Appropriations (15-Y 0-N)",15,0,0,0,15
1886153,1465025,2024-01-26,Senate,"Senate: Reported from Rehabilitation and Social Services with amendments (15-Y 0-N)",15,0,0,0,15
1886153,1465026,2024-02-08,Senate,"Senate: Reported from Finance and Appropriations with substitute (15-Y 0-N)",15,0,0,0,15
1886153,1465027,2024-02-09,Senate,"Senate: Constitutional reading dispensed (39-Y 0-N)",39,0,0,1,40
1886153,1465028,2024-02-12,Senate,"Senate: Constitutional reading dispensed (40-Y 0-N)",40,0,0,0,40
1886153,1465029,2024-02-12,Senate,"Senate: Passed Senate (40-Y 0-N)",40,0,0,0,40
1886153,1465030,2024-02-22,House,"House: Reported from Health and Human Services with substitute (21-Y 0-N)",21,0,0,1,22
1886154,1465031,2024-02-06,Senate,"Senate: Continued to 2025 in Finance and Appropriations (15-Y 0-N)",15,0,0,0,15
1886155,1465032,2024-02-01,House,"House: Reported from Labor and Commerce with substitute (12-Y 10-N)",12,10,0,0,22
1886156,1465033,2024-02-09,Senate,"Senate: Continued to 2025 in Commerce and Labor (15-Y 0-N)",15,0,0,0,15
1886157,1465034,2024-02-06,Senate,"Senate: Continued to 2025 in Finance and Appropriations (14-Y 1-N)",14,1,0,0,15
1886159,1465035,2024-01-18,Senate,"Senate: Rereferred from Transportation (13-Y 0-N)",13,0,0,0,13
1886159,1465036,2024-02-01,Senate,"Senate: Reported from Education and Health with amendments (15-Y 0-N)",15,0,0,0,15
1886159,1465037,2024-02-07,Senate,"Senate: Continued to 2025 in Finance and Appropriations (14-Y 1-N)",14,1,0,0,15
1886160,1465038,2024-01-29,House,"House: Subcommittee recommends reporting (11-Y 0-N)",11,0,0,0,11
1886160,1465039,2024-01-31,House,"House: Reported from Education (22-Y 0-N)",22,0,0,0,22
1886160,1465040,2024-02-05,House,"House: Subcommittee recommends reporting (8-Y 0-N)",8,0,0,1,9
1886160,1465041,2024-02-05,House,"House: Reported from Appropriations (20-Y 0-N)",20,0,0,2,22
1886160,1465042,2024-02-09,House,"House: VOTE: Block Vote Passage (96-Y 0-N)",96,0,0,4,100
1886160,1465043,2024-02-22,Senate,"Senate: Reported from Education and Health (14-Y 0-N 1-A)",14,0,1,0,15
1886160,1465044,2024-03-04,Senate,"Senate: Continued to 2025 in Finance and Appropriations (12-Y 3-N)",12,3,0,0,15
1886163,1465045,2024-02-01,House,"House: Subcommittee recommends reporting with amendments (7-Y 0-N)",7,0,0,1,8
1886163,1465046,2024-02-06,House,"House: Reported from Labor and Commerce with amendment(s) (21-Y 0-N)",21,0,0,1,22
1886164,1465047,2024-01-22,Senate,"Senate: Reported from Commerce and Labor with substitute (8-Y 6-N)",8,6,0,0,14
1886164,1465048,2024-01-31,Senate,"Senate: Continued to 2025 in Finance and Appropriations (13-Y 2-N)",13,2,0,0,15
1886165,1465049,2024-01-25,Senate,"Senate: Reported from Transportation with amendments (9-Y 5-N 1-A)",9,5,1,0,15
1886165,1465050,2024-02-06,Senate,"Senate: Continued to 2025 in Finance and Appropriations (11-Y 4-N)",11,4,0,0,15
1886166,1465051,2024-01-24,Senate,"Senate: Reported from General Laws and Technology (12-Y 2-N 1-A)",12,2,1,0,15
1886166,1465052,2024-02-06,Senate,"Senate: Continued to 2025 in Finance and Appropriations (14-Y 0-N)",14,0,0,0,14
1886169,1465053,2024-02-08,Senate,"Senate: Continued to 2025 in Education and Health (14-Y 1-N)",14,1,0,0,15
1886176,1465054,2024-02-01,Senate,"Senate: Reported from Education and Health with substitute (15-Y 0-N)",15,0,0,0,15
1886176,1465055,2024-02-08,Senate,"Senate: Continued to 2025 in Finance and Appropriations (15-Y 0-N)",15,0,0,0,15
1886181,1465056,2024-01-29,Senate,"Senate: Reading waived (40-Y 0-N)",40,0,0,0,40
1886181,1465057,2024-01-31,Senate,"Senate: Agreed to by Senate (21-Y 19-N)",21,19,0,0,40
1886181,1465058,2024-01-31,Senate,"Senate: Reconsideration of passage agreed to by Senate (40-Y 0-N)",40,0,0,0,40
1886181,1465059,2024-01-31,Senate,"Senate: Agreed to by Senate (22-Y 18-N)",22,18,0,0,40
1886182,1465060,2024-02-01,Senate,"Senate: Reported from Education and Health with substitute (15-Y 0-N)",15,0,0,0,15
1886182,1465061,2024-02-08,Senate,"Senate: Continued to 2025 in Finance and Appropriations (15-Y 0-N)",15,0,0,0,15
1886183,1465062,2024-02-06,House,"House: Subcommittee recommends reporting with substitute (7-Y 0-N)",7,0,0,1,8
1886183,1465063,2024-02-06,House,"House: Reported from General Laws with substitute (20-Y 0-N)",20,0,0,2,22
1886184,1465064,2024-01-23,Senate,"Senate: Continued to 2025 in Agriculture, Conservation and Natural Resources (15-Y 0-N)",15,0,0,0,15
1886185,1465065,2024-02-09,Senate,"Senate: Continued to 2025 in Commerce and Labor (14-Y 1-N)",14,1,0,0,15
1886188,1465066,2024-02-07,Senate,"Senate: Continued to 2025 in General Laws and Technology (15-Y 0-N)",15,0,0,0,15
1886189,1465067,2024-01-25,House,"House: Subcommittee recommends reporting (4-Y 3-N)",4,3,0,2,9
1886189,1465068,2024-01-26,House,"House: Reported from Counties, Cities and Towns (11-Y 9-N)",11,9,0,2,22
1886190,1465069,2024-01-23,House,"House: Subcommittee recommends reporting (7-Y 0-N)",7,0,0,0,7
1886190,1465070,2024-01-25,House,"House: Reported from Labor and Commerce (21-Y 0-N)",21,0,0,1,22
1886190,1465071,2024-01-31,House,"House: VOTE: Block Vote Passage (100-Y 0-N)",100,0,0,0,100
1886190,1465072,2024-02-19,Senate,"Senate: Reported from Commerce and Labor with amendments (13-Y 1-N)",13,1,0,0,14
1886190,1465073,2024-02-21,Senate,"Senate: Continued to 2025 in Finance and Appropriations (13-Y 1-N)",13,1,0,0,14
1886191,1465074,2024-02-01,Senate,"Senate: Reported from Transportation with substitute (8-Y 6-N 1-A)",8,6,1,0,15
1886191,1465075,2024-02-07,Senate,"Senate: Continued to 2025 in Finance and Appropriations (9-Y 6-N)",9,6,0,0,15
1886194,1465076,2024-01-31,Senate,"Senate: Continued to 2025 in Finance and Appropriations (15-Y 0-N)",15,0,0,0,15
1886197,1465077,2024-02-07,Senate,"Senate: Continued to 2025 in Finance and Appropriations (15-Y 0-N)",15,0,0,0,15
1886205,1465078,2024-02-01,House,"House: Subcommittee recommends reporting with substitute (7-Y 2-N)",7,2,0,1,10
1886205,1465079,2024-02-02,House,"House: Reported from Public Safety with substitute (12-Y 10-N)",12,10,0,0,22
1886206,1465080,2024-01-23,House,"House: Subcommittee recommends reporting with substitute (6-Y 2-N)",6,2,0,1,9
1886206,1465081,2024-01-24,House,"House: Reported from Education with substitute (12-Y 9-N)",12,9,0,1,22
1886212,1465082,2024-02-06,Senate,"Senate: Reported from Finance and Appropriations with substitute (15-Y 0-N)",15,0,0,0,15
1886212,1465083,2024-02-07,Senate,"Senate: Constitutional reading dispensed (40-Y 0-N)",40,0,0,0,40
1886212,1465084,2024-02-08,Senate,"Senate: Constitutional reading dispensed (40-Y 0-N)",40,0,0,0,40
1886212,1465085,2024-02-08,Senate,"Senate: Read third time and passed Senate (40-Y 0-N)",40,0,0,0,40
1886213,1465086,2024-02-08,Senate,"Senate: Reported from Education and Health with substitute (15-Y 0-N)",15,0,0,0,15
1886213,1465087,2024-02-09,Senate,"Senate: Continued to 2025 in Rules (8-Y 6-N 1-A)",8,6,1,0,15
1886214,1465088,2024-01-29,House,"House: Subcommittee recommends reporting (6-Y 0-N)",6,0,0,0,6
1886214,1465089,2024-02-01,House,"House: Reported from Rules (18-Y 0-N)",18,0,0,0,18
1886215,1465090,2024-01-18,House,"House: Subcommittee recommends reporting with amendments (5-Y 3-N)",5,3,0,0,8
1886215,1465091,2024-01-23,House,"House: Reported from Labor and Commerce with amendment(s) (13-Y 7-N)",13,7,0,2,22
1886219,1465092,2024-01-24,Senate,"Senate: Reported from General Laws and Technology with substitute (10-Y 3-N 2-A)",10,3,2,0,15
1886219,1465093,2024-01-31,Senate,"Senate: Continued to 2025 in Finance and Appropriations (15-Y 0-N)",15,0,0,0,15
1886220,1465094,2024-01-30,Senate,"Senate: Reported from Agriculture, Conservation and Natural Resources (15-Y 0-N)",15,0,0,0,15
1886220,1465095,2024-02-07,Senate,"Senate: Continued to 2025 in Finance and Appropriations (12-Y 3-N)",12,3,0,0,15
1886221,1465096,2024-01-29,Senate,"Senate: Continued to 2025 in Commerce and Labor (15-Y 0-N)",15,0,0,0,15
1886222,1465097,2024-01-24,Senate,"Senate: Rereferred from General Laws and Technology (15-Y 0-N)",15,0,0,0,15
1886222,1465098,2024-02-07,Senate,"Senate: Continued to 2025 in Finance and Appropriations (15-Y 0-N)",15,0,0,0,15
1886228,1465099,2024-02-05,House,"House: Subcommittee recommends continuing to 2025 with amendment(s) (7-Y 0-N)",7,0,0,1,8
1886232,1465100,2024-02-01,House,"House: Subcommittee recommends reporting with amendments (5-Y 2-N)",5,2,0,1,8
1886232,1465101,2024-02-06,House,"House: Reported from Labor and Commerce with amendment(s) (12-Y 10-N)",12,10,0,0,22
1886232,1465102,2024-02-12,House,"House: VOTE: Passage (51-Y 47-N)",51,47,0,2,100
1886232,1465103,2024-02-26,Senate,"Senate: Reported from Commerce and Labor (9-Y 6-N)",9,6,0,0,15
1886232,1465104,2024-02-29,Senate,"Senate: Continued to 2025 in Finance and Appropriations (14-Y 0-N)",14,0,0,0,14
1886233,1465105,2024-02-05,Senate,"Senate: Continued to 2025 in Commerce and Labor (15-Y 0-N)",15,0,0,0,15
1886235,1465106,2024-02-01,House,"House: Subcommittee recommends reporting with amendments (8-Y 0-N)",8,0,0,0,8
1886235,1465107,2024-02-06,House,"House: Reported from Health and Human Services with amendment(s) (22-Y 0-N)",22,0,0,0,22
1886235,1465108,2024-02-07,House,"House: Subcommittee recommends reporting (7-Y 0-N)",7,0,0,2,9
1886235,1465109,2024-02-09,House,"House: Reported from Appropriations (20-Y 0-N)",20,0,0,2,22
1886235,1465110,2024-02-13,House,"House: VOTE: Block Vote Passage (99-Y 0-N)",99,0,0,1,100
1886235,1465111,2024-02-29,Senate,"Senate: Reported from Education and Health (15-Y 0-N)",15,0,0,0,15
1886235,1465112,2024-03-04,Senate,"Senate: Continued to 2025 in Finance and Appropriations (12-Y 3-N)",12,3,0,0,15
1886236,1465113,2024-02-01,Senate,"Senate: Reported from Education and Health with substitute (15-Y 0-N)",15,0,0,0,15
1886236,1465114,2024-02-12,Senate,"Senate: Reported from Finance and Appropriations with substitute (15-Y 0-N)",15,0,0,0,15
1886236,1465115,2024-02-12,Senate,"Senate: Constitutional reading dispensed (40-Y 0-N)",40,0,0,0,40
1886236,1465116,2024-02-13,Senate,"Senate: Constitutional reading dispensed (39-Y 0-N)",39,0,0,1,40
1886236,1465117,2024-02-13,Senate,"Senate: Passed Senate (40-Y 0-N)",40,0,0,0,40
1886236,1465118,2024-02-23,House,"House: Subcommittee recommends reporting (6-Y 0-N)",6,0,0,0,6
1886236,1465119,2024-02-23,House,"House: Reported from Rules (16-Y 0-N)",16,0,0,2,18
1886237,1465120,2024-01-22,Senate,"Senate: Continued to 2025 in Local Government (13-Y 2-N)",13,2,0,0,15
1886238,1465121,2024-01-16,House,"House: Subcommittee recommends reporting (8-Y 0-N)",8,0,0,0,8
1886238,1465122,2024-01-17,House,"House: Reported from Education (17-Y 4-N)",17,4,0,1,22
1886239,1465123,2024-01-29,Senate,"Senate: Reported from Commerce and Labor with amendments (13-Y 2-N)",13,2,0,0,15
1886239,1465124,2024-02-06,Senate,"Senate: Reported from Finance and Appropriations with substitute (13-Y 2-N)",13,2,0,0,15
1886239,1465125,2024-02-07,Senate,"Senate: Constitutional reading dispensed (40-Y 0-N)",40,0,0,0,40
1886239,1465126,2024-02-09,Senate,"Senate: Read third time and passed Senate (31-Y 7-N)",31,7,0,2,40
1886239,1465127,2024-02-09,Senate,"Senate: Reconsideration of passage agreed to by Senate (37-Y 2-N)",37,2,0,1,40
1886239,1465128,2024-02-09,Senate,"Senate: Passed Senate (30-Y 10-N)",30,10,0,0,40
1886243,1465129,2024-01-30,Senate,"Senate: Continued to 2025 in Agriculture, Conservation and Natural Resources (15-Y 0-N)",15,0,0,0,15
1886248,1465130,2024-01-29,House,"House: Subcommittee recommends reporting (11-Y 0-N)",11,0,0,0,11
1886248,1465131,2024-01-31,House,"House: Reported from Education (22-Y 0-N)",22,0,0,0,22
1886248,1465132,2024-02-06,House,"House: VOTE: Block Vote Passage (99-Y 0-N)",99,0,0,1,100
1886248,1465133,2024-02-22,Senate,"Senate: Reported from Education and Health (15-Y 0-N)",15,0,0,0,15
1886248,1465134,2024-02-27,Senate,"Senate: Continued to 2025 in Finance and Appropriations (15-Y 0-N)",15,0,0,0,15
1886249,1465135,2024-02-05,House,"House: Subcommittee recommends continuing to 2025 (7-Y 0-N)",7,0,0,1,8
1886252,1465136,2024-02-05,House,"House: Subcommittee recommends reporting with amendments (10-Y 0-N)",10,0,0,0,10
1886252,1465137,2024-02-05,House,"House: Reported from Communications, Technology and Innovation with amendment(s) (22-Y 0-N)",22,0,0,0,22
1886252,1465138,2024-02-09,House,"House: Subcommittee recommends reporting with amendments (5-Y 2-N)",5,2,0,2,9
1886252,1465139,2024-02-09,House,"House: Reported from Appropriations with amendment(s) (13-Y 7-N)",13,7,0,2,22
1886252,1465140,2024-02-13,House,"House: VOTE: Passage (71-Y 27-N)",71,27,0,2,100
1886252,1465141,2024-02-28,Senate,"Senate: Continued to 2025 in General Laws and Technology (15-Y 0-N)",15,0,0,0,15
1886255,1465142,2024-02-01,House,"House: Subcommittee recommends reporting (8-Y 0-N)",8,0,0,0,8
1886255,1465143,2024-02-02,House,"House: Reported from Counties, Cities and Towns (22-Y 0-N)",22,0,0,0,22
1886255,1465144,2024-02-08,House,"House: VOTE: Block Vote Passage (98-Y 0-N)",98,0,0,2,100
1886255,1465145,2024-02-26,Senate,"Senate: Continued to 2025 in Local Government (12-Y 3-N)",12,3,0,0,15
1886257,1465146,2024-01-29,Senate,"Senate: Continued to 2025 in Local Government (15-Y 0-N)",15,0,0,0,15
1886263,1465147,2024-02-12,Senate,"Senate: Continued to 2025 in Finance and Appropriations (15-Y 0-N)",15,0,0,0,15
1886264,1465148,2024-02-12,Senate,"Senate: Continued to 2025 in Finance and Appropriations (12-Y 3-N)",12,3,0,0,15
1886266,1465149,2024-02-07,Senate,"Senate: Continued to 2025 in Finance and Appropriations (11-Y 4-N)",11,4,0,0,15
1886268,1471487,2024-11-13,House,"Reported from Privileges and Elections with substitute (12-Y 9-N)",12,9,0,1,22
1886268,1471488,2025-01-14,House,"Agreed to by House (51-Y 48-N 0-A)",51,48,0,1,100
1886268,1475679,2025-01-28,Senate,"Reported from Privileges and Elections (8-Y 7-N)",8,7,0,0,15
1886268,1478218,2025-01-30,Senate,"Reading waived (on 2nd reading) (39-Y 0-N)",39,0,0,1,40
1886268,1565112,2025-01-31,Senate,"Agreed to by Senate (21-Y 18-N)",21,18,0,1,40
1886269,1465150,2024-02-08,Senate,"Senate: Continued to 2025 in Education and Health (15-Y 0-N)",15,0,0,0,15
1886272,1465151,2024-02-05,House,"House: Subcommittee recommends reporting (10-Y 0-N)",10,0,0,0,10
1886272,1465152,2024-02-07,House,"House: Reported from Agriculture, Chesapeake and Natural Resources (22-Y 0-N)",22,0,0,0,22
1886272,1465153,2024-02-13,House,"House: VOTE: Block Vote Passage (99-Y 0-N)",99,0,0,1,100
1886272,1465154,2024-02-20,Senate,"Senate: Reported from Agriculture, Conservation and Natural Resources with substitute (15-Y 0-N)",15,0,0,0,15
1886272,1465155,2024-02-29,Senate,"Senate: Continued to 2025 in Finance and Appropriations (12-Y 2-N)",12,2,0,0,14
1886273,1465156,2024-02-02,House,"House: Reported from Public Safety with substitute (12-Y 9-N)",12,9,0,1,22
1886275,1465157,2024-01-31,Senate,"Senate: Continued to 2025 in General Laws and Technology (15-Y 0-N)",15,0,0,0,15
1886279,1465158,2024-01-22,Senate,"Senate: Reported from Local Government (15-Y 0-N)",15,0,0,0,15
1886279,1465159,2024-02-07,Senate,"Senate: Continued to 2025 in Finance and Appropriations (10-Y 5-N)",10,5,0,0,15
1886281,1465160,2024-01-31,House,"House: Subcommittee recommends reporting (9-Y 1-N)",9,1,0,0,10
1886281,1465161,2024-02-07,House,"House: Reported from Agriculture, Chesapeake and Natural Resources (20-Y 2-N)",20,2,0,0,22
1886281,1465162,2024-02-13,House,"House: VOTE: Passage (95-Y 4-N)",95,4,0,1,100
1886281,1465163,2024-02-27,Senate,"Senate: Reported from Agriculture, Conservation and Natural Resources (14-Y 0-N)",14,0,0,0,14
1886281,1465164,2024-02-29,Senate,"Senate: Continued to 2025 in Finance and Appropriations (13-Y 1-N)",13,1,0,0,14
1886283,1465165,2024-02-08,Senate,"Senate: Continued to 2025 in Education and Health (15-Y 0-N)",15,0,0,0,15
1886284,1465166,2024-01-15,Senate,"Senate: Reported from Courts of Justice with amendments (9-Y 6-N)",9,6,0,0,15
1886284,1465167,2024-02-07,Senate,"Senate: Continued to 2025 in Finance and Appropriations (9-Y 6-N)",9,6,0,0,15
1886285,1465168,2024-01-24,Senate,"Senate: Reported from Courts of Justice with substitute (11-Y 4-N)",11,4,0,0,15
1886285,1465169,2024-02-07,Senate,"Senate: Continued to 2025 in Finance and Appropriations (15-Y 0-N)",15,0,0,0,15
1886288,1465170,2024-01-24,Senate,"Senate: Continued to 2025 in General Laws and Technology (15-Y 0-N)",15,0,0,0,15
1886290,1465171,2024-02-08,Senate,"Senate: Continued to 2025 in Education and Health (15-Y 0-N)",15,0,0,0,15
1886291,1465172,2024-01-24,Senate,"Senate: Reported from General Laws and Technology with substitute (14-Y 1-N)",14,1,0,0,15
1886291,1465173,2024-02-06,Senate,"Senate: Continued to 2025 in Finance and Appropriations (15-Y 0-N)",15,0,0,0,15
1886292,1465174,2024-01-24,Senate,"Senate: Reported from General Laws and Technology with substitute (10-Y 4-N 1-A)",10,4,1,0,15
1886292,1465175,2024-02-06,Senate,"Senate: Continued to 2025 in Finance and Appropriations (13-Y 2-N)",13,2,0,0,15
1886294,1465176,2024-02-05,House,"House: Subcommittee recommends reporting with substitute (8-Y 0-N)",8,0,0,1,9
1886294,1465177,2024-02-07,House,"House: Reported from Appropriations with substitute (22-Y 0-N)",22,0,0,0,22
1886294,1465178,2024-02-13,House,"House: VOTE: Passage (90-Y 9-N)",90,9,0,1,100
1886294,1465179,2024-02-27,Senate,"Senate: Continued to 2025 in Finance and Appropriations (15-Y 0-N)",15,0,0,0,15
1886295,1465180,2024-01-17,Senate,"Senate: Rereferred from General Laws and Technology (15-Y 0-N)",15,0,0,0,15
1886295,1465181,2024-01-25,Senate,"Senate: Continued to 2025 in Transportation (15-Y 0-N)",15,0,0,0,15
1886297,1465182,2024-02-07,Senate,"Senate: Continued to 2025 in General Laws and Technology (9-Y 6-N)",9,6,0,0,15
1886298,1465183,2024-01-25,House,"House: Subcommittee recommends reporting with amendments (8-Y 0-N)",8,0,0,0,8
1886298,1465184,2024-01-30,House,"House: Reported from Health and Human Services with amendment(s) (22-Y 0-N)",22,0,0,0,22
1886298,1465185,2024-02-09,House,"House: Subcommittee recommends reporting (7-Y 0-N)",7,0,0,2,9
1886298,1465186,2024-02-09,House,"House: Reported from Appropriations (20-Y 0-N)",20,0,0,2,22
1886298,1465187,2024-02-13,House,"House: VOTE: Block Vote Passage (99-Y 0-N)",99,0,0,1,100
1886298,1465188,2024-02-23,Senate,"Senate: Reported from Rehabilitation and Social Services (15-Y 0-N)",15,0,0,0,15
1886298,1465189,2024-02-27,Senate,"Senate: Continued to 2025 in Finance and Appropriations (15-Y 0-N)",15,0,0,0,15
1886299,1465190,2024-01-16,Senate,"Senate: Continued to 2025 in Privileges and Elections (14-Y 0-N)",14,0,0,0,14
1886301,1465191,2024-02-05,House,"House: Subcommittee recommends continuing to 2025 (7-Y 0-N)",7,0,0,1,8
1886305,1465192,2024-01-22,Senate,"Senate: Reported from Commerce and Labor (8-Y 6-N)",8,6,0,0,14
1886305,1465193,2024-01-31,Senate,"Senate: Continued to 2025 in Finance and Appropriations (15-Y 0-N)",15,0,0,0,15
1886308,1465194,2024-02-05,House,"House: Subcommittee recommends continuing to 2025 with amendment(s) (7-Y 0-N)",7,0,0,1,8
1886313,1465195,2024-01-18,Senate,"Senate: Reported from Education and Health (15-Y 0-N)",15,0,0,0,15
1886313,1465196,2024-01-31,Senate,"Senate: Reported from Finance and Appropriations (15-Y 0-N)",15,0,0,0,15
1886313,1465197,2024-02-01,Senate,"Senate: Constitutional reading dispensed (40-Y 0-N)",40,0,0,0,40
1886313,1465198,2024-02-05,Senate,"Senate: Read third time and passed Senate (40-Y 0-N)",40,0,0,0,40
1886313,1465199,2024-02-27,House,"House: Subcommittee recommends reporting (8-Y 0-N)",8,0,0,0,8
1886313,1465200,2024-02-28,House,"House: Reported from Education (22-Y 0-N)",22,0,0,0,22
1886314,1465201,2024-01-16,Senate,"Senate: Continued to 2025 in Privileges and Elections (14-Y 0-N)",14,0,0,0,14
1886316,1465202,2024-01-22,Senate,"Senate: Reported from Local Government with amendments (9-Y 4-N 2-A)",9,4,2,0,15
1886316,1465203,2024-01-23,Senate,"Senate: Constitutional reading dispensed (39-Y 0-N)",39,0,0,1,40
1886316,1465204,2024-01-26,Senate,"Senate: Read third time and passed Senate (30-Y 7-N)",30,7,0,3,40
1886317,1465205,2024-02-06,House,"House: Subcommittee recommends reporting (7-Y 0-N)",7,0,0,1,8
1886317,1465206,2024-02-08,House,"House: Reported from General Laws (20-Y 0-N)",20,0,0,2,22
1886317,1465207,2024-02-13,House,"House: VOTE: Block Vote Passage (99-Y 0-N)",99,0,0,1,100
1886317,1465208,2024-02-28,Senate,"Senate: Reported from General Laws and Technology with amendment (15-Y 0-N)",15,0,0,0,15
1886317,1465209,2024-03-04,Senate,"Senate: Continued to 2025 in Finance and Appropriations (10-Y 5-N)",10,5,0,0,15
1886320,1465210,2024-02-06,House,"House: Subcommittee recommends reporting with substitute (7-Y 0-N)",7,0,0,0,7
1886320,1465211,2024-02-08,House,"House: Reported from Labor and Commerce with substitute (22-Y 0-N)",22,0,0,0,22
1886320,1465212,2024-02-09,House,"House: Subcommittee recommends reporting (7-Y 0-N)",7,0,0,2,9
1886320,1465213,2024-02-09,House,"House: Reported from Appropriations (20-Y 0-N)",20,0,0,2,22
1886320,1465214,2024-02-13,House,"House: VOTE: Block Vote Passage (99-Y 0-N)",99,0,0,1,100
1886320,1465215,2024-02-26,Senate,"Senate: Reported from Commerce and Labor (15-Y 0-N)",15,0,0,0,15
1886320,1465216,2024-02-29,Senate,"Senate: Continued to 2025 in Finance and Appropriations (10-Y 4-N)",10,4,0,0,14
1886322,1465217,2024-01-23,Senate,"Senate: Continued to 2025 in Agriculture, Conservation and Natural Resources (14-Y 1-N)",14,1,0,0,15
1886323,1465218,2024-01-16,Senate,"Senate: Continued to 2025 in Privileges and Elections (14-Y 0-N)",14,0,0,0,14
1886327,1465219,2024-01-31,Senate,"Senate: Continued to 2025 in Finance and Appropriations (15-Y 0-N)",15,0,0,0,15
1886328,1465220,2024-01-18,Senate,"Senate: Reported from Education and Health with amendment (14-Y 1-N)",14,1,0,0,15
1886328,1465221,2024-02-06,Senate,"Senate: Continued to 2025 in Finance and Appropriations (14-Y 1-N)",14,1,0,0,15
1886329,1465222,2024-02-05,House,"House: Subcommittee recommends reporting with amendments (8-Y 2-N)",8,2,0,0,10
1886329,1465223,2024-02-07,House,"House: Reported from Education with amendment(s) (22-Y 0-N)",22,0,0,0,22
1886329,1465224,2024-02-13,House,"House: VOTE: Block Vote Passage (99-Y 0-N)",99,0,0,1,100
1886329,1465225,2024-02-29,Senate,"Senate: Reported from Education and Health (14-Y 1-N)",14,1,0,0,15
1886329,1465226,2024-03-04,Senate,"Senate: Continued to 2025 in Finance and Appropriations (10-Y 5-N)",10,5,0,0,15
1886331,1465227,2024-02-07,Senate,"Senate: Continued to 2025 in General Laws and Technology (15-Y 0-N)",15,0,0,0,15
1886333,1465229,2024-02-01,Senate,"Senate: Reported from Education and Health with substitute (15-Y 0-N)",15,0,0,0,15
1886333,1465230,2024-02-08,Senate,"Senate: Continued to 2025 in Finance and Appropriations (14-Y 1-N)",14,1,0,0,15
1887475,1473551,2025-01-23,Senate,"Reported from Education and Health with substitute (9-Y 6-N)",9,6,0,0,15
1887475,1474258,2025-01-24,Senate,"Constitutional reading dispensed (on 1st reading) (37-Y 0-N)",37,0,0,3,40
1887475,1476760,2025-01-28,Senate,"Read third time and passed Senate (21-Y 18-N)",21,18,0,1,40
1887475,1480752,2025-02-05,House,"Reported from Education with substitute (14-Y 6-N)",14,6,0,2,22
1887475,1484692,2025-02-10,House,"Passed House with substitute (67-Y 28-N)",67,28,0,5,100
1887475,1488691,2025-02-12,Senate,"House substitute rejected by Senate (0-Y 37-N)",0,37,0,3,40
1887475,1491352,2025-02-17,Senate,"Senate acceded to request (39-Y 0-N)",39,0,0,1,40
1887475,1496678,2025-02-21,Senate,"Conference report agreed to by Senate (21-Y 18-N)",21,18,0,1,40
1887475,1504231,2025-02-21,House,"Conference report agreed to by House (73-Y 23-N)",73,23,0,4,100
1887475,1535014,2025-04-02,House,"House concurred in Governor's recommendation (91-Y 2-N)",91,2,0,7,100
1887475,1536303,2025-04-02,Senate,"Senate concurred in Governor's recommendation (40-Y 0-N)",40,0,0,0,40
1896334,1478041,2025-01-30,Senate,"Stricken at request of Patron in Education and Health (15-Y 0-N)",15,0,0,0,15
1896336,1471452,2025-01-13,House,"Subcommittee recommends reporting (8-Y 0-N)",8,0,0,1,9
1896336,1472193,2025-01-17,House,"Reported from Courts of Justice (22-Y 0-N)",22,0,0,0,22
1896336,1473584,2025-01-23,House,"Read third time and passed House (97-Y 0-N)",97,0,0,3,100
1896336,1483014,2025-02-05,Senate,"Reported from Courts of Justice (14-Y 0-N)",14,0,0,1,15
1896336,1483938,2025-02-07,Senate,"Constitutional reading dispensed (on 2nd reading) (38-Y 0-N)",38,0,0,2,40
1896336,1484673,2025-02-10,Senate,"Passed Senate (39-Y 0-N)",39,0,0,1,40
1896337,1475993,2025-01-28,House,"Subcommittee recommends laying on the table (5-Y 2-N)",5,2,0,2,9
1896338,1471746,2025-01-15,Senate,"Reported from General Laws and Technology with substitute (9-Y 6-N)",9,6,0,0,15
1896338,1472199,2025-01-17,Senate,"Constitutional reading dispensed (on 1st reading) (40-Y 0-N)",40,0,0,0,40
1896338,1472641,2025-01-21,Senate,"Read third time and passed Senate (21-Y 19-N)",21,19,0,0,40
1896338,1490808,2025-02-17,House,"Tabled in Rules (18-Y 0-N)",18,0,0,0,18
1896339,1472560,2025-01-21,House,"Subcommittee recommends reporting with substitute (7-Y 0-N)",7,0,0,2,9
1896339,1473451,2025-01-23,House,"Reported from Health and Human Services with substitute (22-Y 0-N)",22,0,0,0,22
1896339,1477416,2025-01-29,House,"Read third time and passed House (97-Y 0-N)",97,0,0,3,100
1896339,1483117,2025-02-06,Senate,"Reported from Education and Health (14-Y 0-N)",14,0,0,1,15
1896339,1483873,2025-02-07,Senate,"Constitutional reading dispensed (on 2nd reading) (38-Y 0-N)",38,0,0,2,40
1896339,1484652,2025-02-10,Senate,"Passed Senate (39-Y 0-N)",39,0,0,1,40
1896340,1471976,2025-01-16,Senate,"Reported from Education and Health and rereferred to Finance and Appropriations (14-Y 0-N)",14,0,0,1,15
1896340,1474492,2025-01-23,Senate,"Reported from Finance and Appropriations (12-Y 0-N)",12,0,0,3,15
1896340,1474905,2025-01-27,Senate,"Constitutional reading dispensed (on 1st reading) (36-Y 0-N)",36,0,0,4,40
1896340,1476280,2025-01-29,Senate,"Read third time and passed Senate (38-Y 0-N)",38,0,0,2,40
1896340,1485931,2025-02-11,House,"Reported from Health and Human Services and referred to Appropriations (22-Y 0-N)",22,0,0,0,22
1896341,1473626,2025-01-23,Senate,"Reported from Education and Health with substitute (14-Y 0-N)",14,0,0,1,15
1896341,1474272,2025-01-24,Senate,"Constitutional reading dispensed (on 1st reading) (37-Y 0-N)",37,0,0,3,40
1896341,1476474,2025-01-28,Senate,"Read third time and passed Senate (39-Y 0-N)",39,0,0,1,40
1896341,1486720,2025-02-11,House,"Subcommittee recommends reporting (8-Y 0-N)",8,0,0,1,9
1896341,1488728,2025-02-13,House,"Reported from Health and Human Services (21-Y 0-N)",21,0,0,1,22
1896341,1492436,2025-02-18,House,"Passed House (97-Y 0-N)",97,0,0,3,100
1896342,1475275,2025-01-27,Senate,"Reported from Courts of Justice with substitute and rereferred to Finance and Appropriations (13-Y 1-N)",13,1,0,1,15
1896342,1477149,2025-01-29,Senate,"Reported from Finance and Appropriations (12-Y 1-N 2-A)",12,1,2,0,15
1896342,1477519,2025-01-30,Senate,"Constitutional reading dispensed (on 1st reading) (39-Y 0-N 1-A)",39,0,1,0,40
1896342,1480538,2025-02-04,Senate,"Read third time and passed Senate (33-Y 6-N)",33,6,0,1,40
1896342,1485319,2025-02-10,House,"Reported from Courts of Justice with substitute (20-Y 2-N)",20,2,0,0,22
1896342,1489281,2025-02-13,House,"Courts of Justice Substitute agreed to (51-Y 46-N)",51,46,0,3,100
1896342,1489282,2025-02-13,House,"Passed House with substitute (95-Y 2-N)",95,2,0,3,100
1896342,1491281,2025-02-17,Senate,"House substitute rejected by Senate (18-Y 21-N)",18,21,0,1,40
1896342,1493941,2025-02-19,Senate,"Senate acceded to request (40-Y 0-N)",40,0,0,0,40
1896342,1496568,2025-02-21,Senate,"Conference report agreed to by Senate (34-Y 3-N)",34,3,0,3,40
1896342,1504056,2025-02-21,House,"Conference report agreed to by House (91-Y 2-N)",91,2,0,7,100
1896342,1536857,2025-04-02,Senate,"Senate rejected Governor's recommendation (19-Y 21-N)",19,21,0,0,40
1896342,1565105,2025-02-03,Senate,"Courts of Justice Substitute agreed to",21,19,0,0,40
1896343,1473858,2025-01-16,Senate,"Reported from Transportation and rereferred to Finance and Appropriations (15-Y 0-N)",15,0,0,0,15
1896343,1475259,2025-01-28,Senate,"Reported from Finance and Appropriations (15-Y 0-N)",15,0,0,0,15
1896343,1476297,2025-01-29,Senate,"Constitutional reading dispensed (on 1st reading) (38-Y 0-N)",38,0,0,2,40
1896343,1477490,2025-01-30,Senate,"Read third time and passed Senate (40-Y 0-N)",40,0,0,0,40
1896343,1478316,2025-01-30,Senate,"Constitutional reading dispensed (on 3rd reading) (39-Y 1-N)",39,1,0,0,40
1896343,1478317,2025-01-30,Senate,"Passed Senate (40-Y 0-N)",39,1,0,0,40
1896343,1485910,2025-02-11,House,"Subcommittee recommends reporting (7-Y 0-N)",7,0,0,2,9
1896343,1488604,2025-02-13,House,"Reported from Transportation (20-Y 0-N)",20,0,0,2,22
1896343,1493107,2025-02-18,House,"Passed House (97-Y 0-N)",97,0,0,3,100
1896344,1471511,2025-01-13,Senate,"Reported from Courts of Justice with substitute and rereferred to Finance and Appropriations (8-Y 5-N)",8,5,0,1,14
1896344,1472963,2025-01-22,Senate,"Reported from Finance and Appropriations with substitute (15-Y 0-N)",15,0,0,0,15
1896344,1473754,2025-01-23,Senate,"Constitutional reading dispensed (on 1st reading) (39-Y 0-N)",39,0,0,1,40
1896344,1475398,2025-01-27,Senate,"Read third time and passed Senate (38-Y 0-N)",38,0,0,2,40
1896344,1488016,2025-02-12,House,"Subcommittee recommends reporting with amendment(s) (8-Y 0-N)",8,0,0,1,9
1896345,1476624,2025-01-29,House,"Subcommittee recommends reporting and referring to Courts of Justice (6-Y 0-N)",6,0,0,3,9
1896345,1477789,2025-01-30,House,"Reported from Transportation and referred to Courts of Justice (21-Y 1-N)",21,1,0,0,22
1896345,1478372,2025-01-31,House,"Reported from Courts of Justice with substitute (20-Y 0-N)",20,0,0,2,22
1896345,1482981,2025-02-04,House,"Read third time and passed House (95-Y 4-N)",95,4,0,1,100
1896345,1489789,2025-02-13,Senate,"Reported from Transportation (15-Y 0-N)",15,0,0,0,15
1896345,1491319,2025-02-17,Senate,"Constitutional reading dispensed (on 2nd reading)",39,0,0,1,40
1896345,1492417,2025-02-18,Senate,"Passed Senate (40-Y 0-N)",40,0,0,0,40
1896346,1473494,2025-01-23,Senate,"Passed by indefinitely in Education and Health (9-Y 6-N)",9,6,0,0,15
1896347,1476724,2025-01-29,House,"Subcommittee recommends reporting with substitute and referring to Appropriations (5-Y 3-N)",5,3,0,1,9
1896347,1477108,2025-01-30,House,"Failed to report from Health and Human Services with substitute (9-Y 12-N)",9,12,0,1,22
1896348,1475680,2025-01-27,Senate,"Stricken at request of Patron in Commerce and Labor (15-Y 0-N)",15,0,0,0,15
1896349,1476926,2025-01-29,Senate,"Incorporated by Courts of Justice (SB957-Perry) (15-Y 0-N)",15,0,0,0,15
1896350,1473538,2025-01-23,Senate,"Reported from Education and Health with substitute and rereferred to Finance and Appropriations (15-Y 0-N)",15,0,0,0,15
1896351,1473896,2025-01-23,Senate,"Reported from Education and Health with substitute and rereferred to Finance and Appropriations (15-Y 0-N)",15,0,0,0,15
1896351,1476756,2025-01-29,Senate,"Reported from Finance and Appropriations (14-Y 0-N)",14,0,0,1,15
1896351,1477764,2025-01-30,Senate,"Constitutional reading dispensed (on 1st reading) (39-Y 0-N 1-A)",39,0,1,0,40
1896351,1479164,2025-01-31,Senate,"Constitutional reading dispensed (on 3rd reading) (40-Y 0-N)",40,0,0,0,40
1896351,1479165,2025-01-31,Senate,"Passed Senate (40-Y 0-N)",40,0,0,0,40
1896351,1485493,2025-02-10,House,"Subcommittee recommends reporting with amendment(s) (10-Y 0-N)",10,0,0,1,11
1896351,1488174,2025-02-12,House,"Reported from Education with amendment(s) (21-Y 0-N)",21,0,0,1,22
1896351,1491450,2025-02-17,House,"Passed House with amendment (95-Y 0-N)",95,0,0,5,100
1896351,1491451,2025-02-17,House,"Passed House with amendment (96-Y 0-N)",96,0,0,4,100
1896351,1492567,2025-02-18,Senate,"House Amendment agreed to by Senate (40-Y 0-N)",40,0,0,0,40
1896351,1534793,2025-04-02,Senate,"Senate concurred in Governor's recommendation (40-Y 0-N)",40,0,0,0,40
1896351,1534794,2025-04-02,House,"House concurred in Governor's recommendation (96-Y 0-N)",96,0,0,4,100
1896352,1473520,2025-01-23,Senate,"Reported from Education and Health with substitute and rereferred to Finance and Appropriations (12-Y 3-N)",12,3,0,0,15
1896353,1473561,2025-01-23,Senate,"Reported from Education and Health (10-Y 4-N)",10,4,0,1,15
1896353,1474583,2025-01-24,Senate,"Constitutional reading dispensed (on 1st reading) (37-Y 0-N)",37,0,0,3,40
1896353,1476667,2025-01-28,Senate,"Read third time and passed Senate (23-Y 14-N)",23,14,0,3,40
1896353,1483017,2025-02-06,House,"Reported from Health and Human Services (14-Y 8-N)",14,8,0,0,22
1896353,1485995,2025-02-11,House,"Passed House (50-Y 44-N)",50,44,0,6,100
1896353,1536281,2025-04-02,Senate,"Senate rejected Governor's recommendation (17-Y 23-N)",17,23,0,0,40
1896354,1472296,2025-01-20,House,"Subcommittee recommends laying on the table (5-Y 3-N)",5,3,0,1,9
1896355,1471512,2025-01-13,Senate,"Reported from Courts of Justice with substitute and rereferred to Finance and Appropriations (13-Y 0-N)",13,0,0,1,14
1896355,1472929,2025-01-22,Senate,"Reported from Finance and Appropriations (15-Y 0-N)",15,0,0,0,15
1896355,1473696,2025-01-23,Senate,"Constitutional reading dispensed (on 1st reading) (39-Y 0-N)",39,0,0,1,40
1896355,1475597,2025-01-27,Senate,"Read third time and passed Senate (38-Y 0-N)",38,0,0,2,40
1896355,1480787,2025-02-05,House,"Reported from Courts of Justice with substitute (22-Y 0-N)",22,0,0,0,22
1896355,1484693,2025-02-10,House,"Passed House (95-Y 0-N)",95,0,0,5,100
1896356,1474664,2025-01-24,House,"Tabled in Courts of Justice (22-Y 0-N)",22,0,0,0,22
1896357,1471750,2025-01-15,House,"Subcommittee recommends laying on the table (5-Y 3-N)",5,3,0,1,9
1896358,1471551,2025-01-14,Senate,"Reported from Privileges and Elections (8-Y 6-N)",8,6,0,0,14
1896358,1472346,2025-01-20,Senate,"Reading of amendments waived",35,4,0,1,40
1896358,1472726,2025-01-21,Senate,"Read third time and agreed to by Senate (21-Y 18-N)",21,18,0,1,40
1896358,1483910,2025-02-07,House,"Reported from Privileges and Elections (13-Y 9-N)",13,9,0,0,22
1896358,1489241,2025-02-13,House,"Agreed to by House (55-Y 42-N)",55,42,0,3,100
1896358,1565073,2025-01-20,Senate,"Senator McDougle Amendments rejected",19,21,0,0,40
1896359,1471773,2025-01-15,Senate,"Reported from General Laws and Technology and rereferred to Finance and Appropriations (9-Y 6-N)",9,6,0,0,15
1896359,1472594,2025-01-21,Senate,"Reported from Finance and Appropriations (10-Y 5-N)",10,5,0,0,15
1896359,1473148,2025-01-22,Senate,"Constitutional reading dispensed (on 1st reading) (40-Y 0-N)",40,0,0,0,40
1896359,1474593,2025-01-24,Senate,"Read third time and passed Senate (21-Y 17-N)",21,17,0,2,40
1896359,1483331,2025-02-06,House,"Subcommittee recommends reporting (6-Y 2-N)",6,2,0,1,9
1896359,1486225,2025-02-11,House,"Reported from General Laws (12-Y 7-N)",12,7,0,3,22
1896359,1490292,2025-02-14,House,"Passed House (52-Y 43-N)",52,43,0,5,100
1896360,1471509,2025-01-13,Senate,"Reported from Courts of Justice (8-Y 5-N)",8,5,0,1,14
1896360,1471510,2025-01-14,Senate,"Constitutional reading dispensed (on 1st reading) (37-Y 0-N)",37,0,0,1,38
1896360,1472129,2025-01-17,Senate,"Read third time and passed Senate (21-Y 19-N)",21,19,0,0,40
1896360,1483925,2025-02-07,House,"Reported from Public Safety (11-Y 10-N)",11,10,0,1,22
1896360,1487624,2025-02-12,House,"Passed House (50-Y 47-N)",50,47,0,3,100
1896361,1471550,2025-01-14,Senate,"Reported from Privileges and Elections (8-Y 6-N)",8,6,0,0,14
1896361,1472703,2025-01-21,Senate,"Read third time and agreed to by Senate (21-Y 19-N)",21,19,0,0,40
1896361,1483920,2025-02-07,House,"Reported from Privileges and Elections (12-Y 10-N)",12,10,0,0,22
1896361,1489285,2025-02-13,House,"Agreed to by House (51-Y 46-N)",51,46,0,3,100
1896361,1565167,2025-01-20,Senate,"Senator Durant Amendment rejected",19,21,0,0,40
1896361,1565168,2025-01-20,Senate,"Senator Jordan Amendment rejected",19,21,0,0,40
1896362,1473570,2025-01-23,Senate,"Passed by indefinitely in Education and Health (9-Y 6-N)",9,6,0,0,15
1896363,1473526,2025-01-23,Senate,"Reported from Education and Health (15-Y 0-N)",15,0,0,0,15
1896363,1474572,2025-01-24,Senate,"Constitutional reading dispensed (on 1st reading) (37-Y 0-N)",37,0,0,3,40
1896363,1476295,2025-01-28,Senate,"Read third time and passed Senate (39-Y 0-N)",39,0,0,1,40
1896363,1485929,2025-02-11,House,"Subcommittee recommends reporting (6-Y 2-N)",6,2,0,1,9
1896363,1488817,2025-02-13,House,"Reported from Health and Human Services (14-Y 8-N)",14,8,0,0,22
1896363,1492083,2025-02-18,House,"Passed House (51-Y 46-N)",51,46,0,3,100
1896364,1471984,2025-01-16,Senate,"Rereferred from Education and Health",14,0,0,1,15
1896364,1471985,2025-01-16,Senate,"Rereferred from Education and Health to Courts of Justice (14-Y 0-N)",14,0,0,1,15
1896364,1473267,2025-01-22,Senate,"Reported from Courts of Justice (8-Y 6-N)",8,6,0,1,15
1896364,1474579,2025-01-24,Senate,"Constitutional reading dispensed (on 1st reading) (37-Y 0-N)",37,0,0,3,40
1896364,1476708,2025-01-28,Senate,"Read third time and passed Senate (21-Y 18-N)",21,18,0,1,40
1896364,1487962,2025-02-12,House,"Subcommittee recommends reporting (5-Y 3-N)",5,3,0,1,9
1896365,1472835,2025-01-21,Senate,"Reported from Privileges and Elections (11-Y 4-N)",11,4,0,0,15
1896365,1474324,2025-01-23,Senate,"Constitutional reading dispensed (on 1st reading) (39-Y 0-N)",39,0,0,1,40
1896365,1474828,2025-01-27,Senate,"Read third time and passed Senate (23-Y 15-N)",23,15,0,2,40
1896365,1484989,2025-02-10,House,"Subcommittee recommends reporting (5-Y 3-N)",5,3,0,1,9
1896365,1490043,2025-02-14,House,"Reported from Privileges and Elections (12-Y 10-N)",12,10,0,0,22
1896365,1493337,2025-02-19,House,"Passed House (54-Y 43-N)",54,43,0,3,100
1896366,1472172,2025-01-17,House,"Subcommittee recommends laying on the table (5-Y 3-N)",5,3,0,1,9
1896367,1471552,2025-01-14,Senate,"Reported from Privileges and Elections (10-Y 4-N)",10,4,0,0,14
1896367,1473582,2025-01-21,Senate,"Read third time and agreed to by Senate (24-Y 15-N)",24,15,0,1,40
1896367,1483916,2025-02-07,House,"Reported from Privileges and Elections (15-Y 6-N)",15,6,0,1,22
1896367,1489277,2025-02-13,House,"Agreed to by House (56-Y 35-N)",56,35,0,9,100
1896367,1489278,2025-02-13,House,"Agreed to by House (58-Y 34-N)",58,34,0,8,100
1896368,1473906,2025-01-16,Senate,"Reported from Transportation and rereferred to Courts of Justice (14-Y 0-N)",14,0,0,1,15
1896368,1478719,2025-02-03,Senate,"Reported from Courts of Justice with substitute (15-Y 0-N)",15,0,0,0,15
1896368,1482201,2025-02-04,Senate,"Constitutional reading dispensed (on 1st reading) (40-Y 0-N)",40,0,0,0,40
1896368,1482202,2025-02-04,Senate,"Constitutional reading dispensed (on 3rd reading) (40-Y 0-N)",40,0,0,0,40
1896368,1482203,2025-02-04,Senate,"Passed Senate (40-Y 0-N)",40,0,0,0,40
1896368,1486012,2025-02-11,House,"Reported from Transportation with substitute and referred to Courts of Justice (20-Y 0-N)",20,0,0,2,22
1896368,1487982,2025-02-12,House,"Subcommittee recommends reporting (8-Y 0-N)",8,0,0,1,9
1896368,1490056,2025-02-14,House,"Reported from Courts of Justice (21-Y 0-N)",21,0,0,1,22
1896368,1493447,2025-02-19,House,"Passed House with substitute (97-Y 0-N)",97,0,0,3,100
1896368,1495155,2025-02-20,Senate,"House substitute rejected by Senate (4-Y 34-N)",4,34,0,2,40
1896368,1495810,2025-02-20,Senate,"Senate acceded to request (38-Y 0-N)",38,0,0,2,40
1896368,1497135,2025-02-22,House,"Conference report agreed to by House (91-Y 5-N)",91,5,0,4,100
1896368,1503654,2025-02-22,Senate,"Conference report agreed to by Senate (40-Y 0-N)",40,0,0,0,40
1898414,1471986,2025-01-16,Senate,"Reported from Education and Health (14-Y 0-N)",14,0,0,1,15
1898414,1472135,2025-01-17,Senate,"Constitutional reading dispensed (on 1st reading) (40-Y 0-N)",40,0,0,0,40
1898414,1473899,2025-01-21,Senate,"Read third time and passed Senate (40-Y 0-N)",40,0,0,0,40
1898414,1490806,2025-02-17,House,"Reported from Rules (17-Y 1-N)",17,1,0,0,18
1898414,1496681,2025-02-20,House,"Passed House (97-Y 1-N)",97,1,0,2,100
1898415,1473540,2025-01-23,Senate,"Passed by indefinitely in Education and Health (9-Y 6-N)",9,6,0,0,15
1898416,1472298,2025-01-20,House,"Subcommittee recommends laying on the table (5-Y 3-N)",5,3,0,1,9
1898417,1471515,2025-01-13,Senate,"Reported from Local Government (7-Y 4-N 1-A)",7,4,1,1,13
1898417,1471516,2025-01-14,Senate,"Constitutional reading dispensed (on 1st reading) (37-Y 0-N)",37,0,0,1,38
1898417,1472366,2025-01-20,Senate,"Read third time and defeated by Senate (13-Y 23-N 1-A)",13,23,1,3,40
1898418,1478627,2025-02-02,Senate,"Reported from Finance and Appropriations with amendments (15-Y 0-N)",15,0,0,0,15
1898418,1479601,2025-02-04,Senate,"Constitutional reading dispensed (on 1st reading) (40-Y 0-N)",40,0,0,0,40
1898418,1482273,2025-02-05,Senate,"Motion for Special and Continuing Order (40-Y 0-N)",40,0,0,0,40
1898418,1483296,2025-02-06,Senate,"Constitutional reading dispensed (on 3rd reading) (40-Y 0-N)",40,0,0,0,40
1898418,1483297,2025-02-06,Senate,"Passed Senate (38-Y 2-N)",38,2,0,0,40
1898418,1483986,2025-02-06,Senate,"Contested committee amendment agreed to (Page 147 Item 377 #1s) (21-Y 19-N)",21,19,0,0,40
1898421,1472376,2025-01-20,Senate,"Constitutional reading dispensed (on 1st reading) (40-Y 0-N)",40,0,0,0,40
1898421,1473141,2025-01-22,Senate,"Read third time and passed Senate (40-Y 0-N)",40,0,0,0,40
1898421,1473670,2025-01-17,Senate,"Reported from Rehabilitation and Social Services (15-Y 0-N)",15,0,0,0,15
1898421,1483008,2025-02-06,House,"Subcommittee recommends reporting (6-Y 0-N)",6,0,0,1,7
1898421,1483909,2025-02-07,House,"Reported from Public Safety (21-Y 0-N)",21,0,0,1,22
1898421,1487588,2025-02-12,House,"Passed House (97-Y 0-N)",97,0,0,3,100
1898425,1471513,2025-01-13,Senate,"Reported from Courts of Justice with substitute (13-Y 0-N)",13,0,0,1,14
1898425,1471514,2025-01-14,Senate,"Constitutional reading dispensed (on 1st reading) (37-Y 0-N)",37,0,0,1,38
1898425,1471975,2025-01-16,Senate,"Read third time and passed Senate (39-Y 0-N)",39,0,0,1,40
1898425,1482806,2025-02-05,House,"Subcommittee recommends reporting (8-Y 0-N)",8,0,0,1,9
1898425,1486088,2025-02-10,House,"Reported from Courts of Justice (22-Y 0-N)",22,0,0,0,22
1898425,1488889,2025-02-13,House,"Passed House (96-Y 0-N)",96,0,0,4,100
1898426,1478628,2025-02-02,House,"Reported from Appropriations with amendment(s) (22-Y 0-N)",22,0,0,0,22
1898426,1482228,2025-02-05,House,"Motion for Special and Continuing Order for Thursday, February 6, 2025 (92-Y 0-N)",92,0,0,8,100
1898426,1483270,2025-02-06,House,"Contested committee amendment Item 4-14 #3h agreed to (97-Y 0-N)",97,0,0,3,100
1898426,1484153,2025-02-06,House,"Uncontested Committee amendments agreed to (97-Y 0-N)",97,0,0,3,100
1898426,1484154,2025-02-06,House,"Contested committee amendment Item 7 #1h agreed to (53-Y 44-N)",53,44,0,3,100
1898426,1484155,2025-02-06,House,"Contested committee amendment Item 33 #3h agreed to (50-Y 47-N)",50,47,0,3,100
1898426,1484156,2025-02-06,House,"Contested committee amendment Item 34 #1h agreed to (97-Y 0-N)",97,0,0,3,100
1898426,1484157,2025-02-06,House,"Contested committee amendment Item 35 #1h agreed to (97-Y 0-N)",97,0,0,3,100
1898426,1484158,2025-02-06,House,"Contested committee amendment Item 40 #2h agreed to (51-Y 46-N)",51,46,0,3,100
1898426,1484159,2025-02-06,House,"Contested committee amendment Item 49 #1h agreed to (48-Y 47-N)",48,47,0,5,100
1898426,1484160,2025-02-06,House,"Contested committee amendment Item 51 #1h agreed to (50-Y 47-N)",50,47,0,3,100
1898426,1484161,2025-02-06,House,"Contested committee amendment Item 86 #3h agreed to (62-Y 32-N)",62,32,0,6,100
1898426,1484162,2025-02-06,House,"Contested committee amendment Item 101 #5h agreed to (94-Y 3-N)",94,3,0,3,100
1898426,1484163,2025-02-06,House,"Contested committee amendment Item 102 #1h agreed to (50-Y 47-N)",50,47,0,3,100
1898426,1484164,2025-02-06,House,"Contested committee amendment Item 102 #5h agreed to (48-Y 47-N)",48,47,0,5,100
1898426,1484165,2025-02-06,House,"Contested committee amendment Item 102 #12h agreed to (97-Y 0-N)",97,0,0,3,100
1898426,1484166,2025-02-06,House,"Contested committee amendment Item 103 #1h agreed to (50-Y 45-N)",50,45,0,5,100
1898426,1484167,2025-02-06,House,"Contested committee amendment Item 120 #1h agreed to (51-Y 45-N)",51,45,0,4,100
1898426,1484168,2025-02-06,House,"Contested committee amendment Item 123 #1h agreed to (50-Y 47-N)",50,47,0,3,100
1898426,1484169,2025-02-06,House,"Contested committee amendment Item 124 #2h agreed to (78-Y 19-N)",78,19,0,3,100
1898426,1484170,2025-02-06,House,"Contested committee amendment Item 124 #7h agreed to (49-Y 44-N)",49,44,0,7,100
1898426,1484171,2025-02-06,House,"Contested committee amendment Item 125 #1h agreed to (48-Y 44-N)",48,44,0,8,100
1898426,1484172,2025-02-06,House,"Contested committee amendment Item 125 #3h agreed to (50-Y 45-N)",50,45,0,5,100
1898426,1484173,2025-02-06,House,"Contested committee amendment Item 125 #4h agreed to (96-Y 0-N)",96,0,0,4,100
1898426,1484174,2025-02-06,House,"Contested committee amendment Item 132 #1h agreed to (97-Y 0-N)",97,0,0,3,100
1898426,1484175,2025-02-06,House,"Contested committee amendment Item 236 #1h agreed to (80-Y 16-N)",80,16,0,4,100
1898426,1484176,2025-02-06,House,"Contested committee amendment Item 236 #2h agreed to (88-Y 9-N)",88,9,0,3,100
1898426,1484177,2025-02-06,House,"Contested committee amendment Item 255 #1h agreed to (51-Y 45-N)",51,45,0,4,100
1898426,1484178,2025-02-06,House,"Contested committee amendment Item 258 #2h agreed to (97-Y 0-N)",97,0,0,3,100
1898426,1484179,2025-02-06,House,"Contested committee amendment Item 277 #1h agreed to (97-Y 0-N)",97,0,0,3,100
1898426,1484180,2025-02-06,House,"Contested committee amendment Item 277 #4h agreed to (51-Y 45-N 1-A)",51,45,1,3,100
1898426,1484181,2025-02-06,House,"Contested committee amendment Item 288 #1h agreed to (52-Y 44-N)",52,44,0,4,100
1898426,1484182,2025-02-06,House,"Contested committee amendment Item 288 #4h agreed to (50-Y 47-N)",50,47,0,3,100
1898426,1484183,2025-02-06,House,"Contested committee amendment Item 295 #2h agreed to (49-Y 48-N)",49,48,0,3,100
1898426,1484184,2025-02-06,House,"Contested committee amendment 296 #1h agreed to (50-Y 45-N)",50,45,0,5,100
1898426,1484185,2025-02-06,House,"Contested committee amendment Item 331 #1h agreed to (49-Y 47-N)",49,47,0,4,100
1898426,1484186,2025-02-06,House,"Contested committee amendment Item 349 #1h agreed to (50-Y 47-N)",50,47,0,3,100
1898426,1484187,2025-02-06,House,"Contested committee amendment Item 356 #1h agreed to (50-Y 47-N)",50,47,0,3,100
1898426,1484188,2025-02-06,House,"Contested committee amendment Item 362 #1h agreed to (50-Y 47-N)",50,47,0,3,100
1898426,1484189,2025-02-06,House,"Contested committee amendment Item 365 #3h agreed to (50-Y 45-N)",50,45,0,5,100
1898426,1484190,2025-02-06,House,"Contested committee amendment Item 377 #1h agreed to (48-Y 47-N)",48,47,0,5,100
1898426,1484191,2025-02-06,House,"Contested committee amendment Item 394 #1h agreed to (50-Y 47-N)",50,47,0,3,100
1898426,1484192,2025-02-06,House,"Contested committee amendment Item 394 #2h agreed to (50-Y 46-N)",50,46,0,4,100
1898426,1484193,2025-02-06,House,"Contested committee amendment Item 394 #3h agreed to (53-Y 43-N)",53,43,0,4,100
1898426,1484194,2025-02-06,House,"Contested committee amendment Item 394 #7h agreed to (50-Y 47-N)",50,47,0,3,100
1898426,1484195,2025-02-06,House,"Contested committee amendment Item 401 #1h agreed to (50-Y 47-N)",50,47,0,3,100
1898426,1484196,2025-02-06,House,"Contested committee amendment Item 415 #1h agreed t (50-Y 47-N)",50,47,0,3,100
1898426,1484197,2025-02-06,House,"Contested committee amendment Item 415 #6h agreed to (50-Y 47-N)",50,47,0,3,100
1898426,1484198,2025-02-06,House,"Contested committee amendment Item 433 #1h agreed to (50-Y 47-N)",50,47,0,3,100
1898426,1484199,2025-02-06,House,"Contested committee amendment Item 437 #1h agreed to (50-Y 47-N)",50,47,0,3,100
1898426,1484200,2025-02-06,House,"Contested committee amendment Item 471 #2h agreed to (49-Y 47-N)",49,47,0,4,100
1898426,1484201,2025-02-06,House,"Contested committee amendment Item 471 #3h agreed to (49-Y 47-N)",49,47,0,4,100
1898426,1484202,2025-02-06,House,"Contested committee amendment Item 471 #4h agreed to (51-Y 46-N)",51,46,0,3,100
1898426,1484203,2025-02-06,House,"Contested committee amendment Item 489.30 #1h agreed to (51-Y 45-N)",51,45,0,4,100
1898426,1484204,2025-02-06,House,"Contested committee amendment Item C-32.10 #1h agreed to (51-Y 46-N)",51,46,0,3,100
1898426,1484205,2025-02-06,House,"Contested committee amendment Item C-52.10 #1h agreed to (94-Y 0-N 1-A)",94,0,1,5,100
1898426,1484206,2025-02-06,House,"Contested committee amendment Item 4-1.01 #1h agreed to (50-Y 47-N)",50,47,0,3,100
1898426,1484207,2025-02-06,House,"Contested committee amendment Item 4-2.01 #1h agreed to (51-Y 45-N)",51,45,0,4,100
1898426,1484208,2025-02-06,House,"Contested committee amendment Item 4-5.04 #1h agreed to (50-Y 46-N)",50,46,0,4,100
1898426,1484209,2025-02-06,House,"Motion to pass by Item 125 #1h offered by Delegate Milde rejected (48-Y 48-N)",48,48,0,4,100
1898426,1484210,2025-02-06,House,"Floor Amendment Item 125 #1h offered by Delegate Milde rejected (48-Y 49-N)",48,49,0,3,100
1898426,1484211,2025-02-06,House,"Motion to pass by Item 476 #1h offered by Delegate Gilbert agreed to (50-Y 47-N)",50,47,0,3,100
1898426,1484212,2025-02-06,House,"Constitutional reading dispensed ( on third reading ) (96-Y 1-N)",96,1,0,3,100
1898426,1484213,2025-02-06,House,"Passed House (79-Y 18-N)",79,18,0,3,100
1898426,1485835,2025-02-11,Senate,"Reported from Finance and Appropriations with amendments (13-Y 0-N)",13,0,0,2,15
1898426,1486184,2025-02-11,Senate,"Constitutional reading dispensed (on 2nd reading) (40-Y 0-N)",40,0,0,0,40
1898426,1489016,2025-02-12,Senate,"Passed Senate with amendments (36-Y 2-N)",36,2,0,2,40
1898426,1489017,2025-02-12,Senate,"Reconsideration of Senate passage agreed to by Senate (39-Y 0-N)",39,0,0,1,40
1898426,1489018,2025-02-12,Senate,"Passed Senate with amendments (37-Y 2-N)",37,2,0,1,40
1898426,1489019,2025-02-12,House,"Senate amendments rejected by House (0-Y 89-N)",0,89,0,11,100
1898426,1489020,2025-02-12,Senate,"Senate insisted on amendments (40-Y 0-N)",40,0,0,0,40
1898426,1504046,2025-02-22,Senate,"Conference report agreed to by Senate (37-Y 3-N)",37,3,0,0,40
1898426,1536821,2025-04-02,Senate,"Senate concurred in Governor's recommendation #'s 15, 17, 20, 25, 26, 29, 33, 34, 36, 41, 42, 43, 44, 47, 55,(40-Y 0-N)",40,0,0,0,40
1898426,1536822,2025-04-02,Senate,"Governor's Recommendation #101 Passed by for the day (21-Y 19-N)",21,19,0,0,40
1898426,1536823,2025-04-02,Senate,"Governor's Recommendation #200 Passed by for the day (21-Y 19-N)",21,19,0,0,40
1898426,1536824,2025-04-02,Senate,"Governor's Recommendation #201 Passed by for the day (21-Y 19-N)",21,19,0,0,40
1898426,1565088,2025-02-06,House,"Contested committee amendment Item 102 #3h agreed to (50-Y 47-N)",50,47,0,3,100
1898426,1565089,2025-02-06,House,"Contested committee amendment Item 102 #8h agreed to (50-Y 46-N)",50,46,0,4,100
1898426,1565090,2025-02-06,House,"Contested committee amendment Item 125 #9h agreed to (50-Y 46-N)",50,46,0,4,100
1898426,1565091,2025-02-06,House,"Contested committee amendment Item 390 #1h agreed to (51-Y 45-N)",51,45,0,4,100
1898426,1565092,2025-02-22,House,"Conference report agreed to by House (81-Y 18-N)",81,18,0,1,100
1898426,1565093,2025-04-02,House,"House concurred in Governor's recommendation #`s 15, 17, 20, 25, 26, 29, 33, 34, 36, 37, 41, 42, 43, 44, 47, 51, 55, 62, 67, 82, 88, 91, 99, 101, 112, 130, 131, 132, 134, 136, 156, 158, 164, 171, 173, 175, 181, 191, 200, 201, 204 (95-Y 0-N)",95,0,0,5,100
1898427,1471742,2025-01-15,Senate,"Reported from General Laws and Technology and rereferred to Finance and Appropriations (15-Y 0-N)",15,0,0,0,15
1898427,1472683,2025-01-21,Senate,"Passed by indefinitely in Finance and Appropriations (11-Y 4-N)",11,4,0,0,15
1898429,1472829,2025-01-21,Senate,"Incorporated by Privileges and Elections (SB1070-Peake) (15-Y 0-N)",15,0,0,0,15
1898430,1472396,2025-01-20,House,"Subcommittee recommends striking from the docket (8-Y 0-N)",8,0,0,1,9
1898431,1471493,2025-01-08,House,"Agreed to by House (97-Y 0-N)",97,0,0,2,99
1898431,1471494,2025-01-08,Senate,"Agreed to by Senate (36-Y 0-N)",36,0,0,2,38
1898432,1473868,2025-01-23,House,"Subcommittee recommends laying on the table (5-Y 3-N)",5,3,0,3,11
1898433,1473585,2025-01-17,Senate,"Rereferred from Rehabilitation and Social Services to Courts of Justice (14-Y 0-N)",14,0,0,1,15
1898433,1476390,2025-01-29,Senate,"Reported from Courts of Justice with substitute (10-Y 2-N 3-A)",10,2,3,0,15
1898433,1478127,2025-01-31,Senate,"Constitutional reading dispensed (on 1st reading) (39-Y 0-N)",39,0,0,1,40
1898433,1479679,2025-02-04,Senate,"Read third time and passed Senate (39-Y 0-N 1-A)",39,0,1,0,40
1898434,1471495,2025-01-08,House,"Agreed to by House (Y-97 N-0)",97,0,0,2,99
1898434,1471496,2025-01-08,Senate,"Rules suspended (36-Y 0-N)",36,0,0,2,38
1898434,1471497,2025-01-08,Senate,"Agreed to by Senate with amendment (36-Y 0-N)",36,0,0,2,38
1898434,1471498,2025-01-08,House,"Senate amendment agreed to by House (93-Y 0-N)",93,0,0,6,99
1898435,1472295,2025-01-20,House,"Subcommittee failed to recommend reporting (3-Y 5-N)",3,5,0,1,9
1899666,1471923,2025-01-16,House,"Subcommittee recommends reporting (8-Y 0-N)",8,0,0,1,9
1899666,1472881,2025-01-21,House,"Reported from General Laws (21-Y 0-N)",21,0,0,1,22
1899666,1474830,2025-01-27,House,"Read third time and passed House (97-Y 0-N)",97,0,0,3,100
1899666,1482662,2025-02-05,Senate,"Reported from General Laws and Technology (12-Y 0-N)",12,0,0,3,15
1899666,1484216,2025-02-07,Senate,"Constitutional reading dispensed (on 2nd reading) (38-Y 0-N)",38,0,0,2,40
1899666,1485299,2025-02-10,Senate,"Passed Senate (39-Y 0-N)",39,0,0,1,40
1899667,1478641,2025-02-03,Senate,"Passed by indefinitely in Courts of Justice (9-Y 6-N)",9,6,0,0,15
1899668,1473509,2025-01-23,Senate,"Reported from Education and Health (15-Y 0-N)",15,0,0,0,15
1899668,1474576,2025-01-24,Senate,"Constitutional reading dispensed (on 1st reading) (37-Y 0-N)",37,0,0,3,40
1899668,1476288,2025-01-28,Senate,"Read third time and passed Senate (39-Y 0-N)",39,0,0,1,40
1899668,1480584,2025-02-05,House,"Reported from Education (20-Y 0-N)",20,0,0,2,22
1899668,1485930,2025-02-10,House,"Passed House (95-Y 0-N)",95,0,0,5,100
1899669,1471453,2025-01-13,House,"Subcommittee recommends reporting with substitute (8-Y 0-N)",8,0,0,1,9
1899669,1472187,2025-01-17,House,"Reported from Courts of Justice with substitute (22-Y 0-N)",22,0,0,0,22
1899669,1473583,2025-01-23,House,"Read third time and passed House (97-Y 0-N)",97,0,0,3,100
1899669,1483106,2025-02-05,Senate,"Reported from Courts of Justice (14-Y 0-N)",14,0,0,1,15
1899669,1483866,2025-02-07,Senate,"Constitutional reading dispensed (on 2nd reading) (38-Y 0-N)",38,0,0,2,40
1899669,1486284,2025-02-10,Senate,"Passed Senate (39-Y 0-N)",39,0,0,1,40
1899670,1471943,2025-01-16,House,"Subcommittee recommends laying on the table (7-Y 3-N)",7,3,0,1,11
1899671,1477725,2025-01-30,House,"Subcommittee recommends laying on the table (3-Y 2-N)",3,2,0,1,6
1900748,1473833,2025-01-21,Senate,"Reported from Privileges and Elections (8-Y 7-N)",8,7,0,0,15
1900748,1473834,2025-01-23,Senate,"Constitutional reading dispensed (on 1st reading) (39-Y 0-N)",39,0,0,1,40
1900748,1475447,2025-01-27,Senate,"Read third time and passed Senate (20-Y 18-N)",20,18,0,2,40
1900748,1485515,2025-02-10,House,"Subcommittee recommends reporting (5-Y 3-N)",5,3,0,1,9
1900748,1490035,2025-02-14,House,"Reported from Privileges and Elections (12-Y 10-N)",12,10,0,0,22
1900748,1493276,2025-02-19,House,"Passed House with amendment (51-Y 46-N)",51,46,0,3,100
1900748,1494987,2025-02-20,Senate,"House Amendment agreed to by Senate (20-Y 19-N)",20,19,0,1,40
1900750,1471743,2025-01-15,Senate,"Reported from General Laws and Technology (15-Y 0-N)",15,0,0,0,15
1900750,1472125,2025-01-17,Senate,"Constitutional reading dispensed (on 1st reading) (40-Y 0-N)",40,0,0,0,40
1900750,1472671,2025-01-21,Senate,"Read third time and passed Senate (40-Y 0-N)",40,0,0,0,40
1900750,1489165,2025-02-13,House,"Subcommittee recommends reporting (4-Y 3-N)",4,3,0,2,9
1900750,1489166,2025-02-13,House,"Reported from General Laws (13-Y 6-N)",13,6,0,3,22
1900750,1491793,2025-02-18,House,"Passed House (87-Y 9-N)",87,9,0,4,100
1900751,1472374,2025-01-20,Senate,"Constitutional reading dispensed (on 1st reading) (40-Y 0-N)",40,0,0,0,40
1900751,1473350,2025-01-22,Senate,"Read third time and passed Senate (40-Y 0-N)",40,0,0,0,40
1900751,1474066,2025-01-17,Senate,"Reported from Rules (15-Y 0-N)",15,0,0,0,15
1900751,1490777,2025-02-17,House,"Reported from Rules (17-Y 1-N)",17,1,0,0,18
1900751,1496765,2025-02-20,House,"Passed House (98-Y 0-N)",98,0,0,2,100
1900752,1471825,2025-01-15,Senate,"Reported from General Laws and Technology and rereferred to Finance and Appropriations (13-Y 0-N)",13,0,0,2,15
1900753,1472334,2025-01-20,House,"Subcommittee recommends reporting (7-Y 1-N)",7,1,0,1,9
1900753,1473171,2025-01-22,House,"Reported from Finance (19-Y 2-N 1-A)",19,2,1,0,22
1900753,1487436,2025-02-12,Senate,"Reported from Finance and Appropriations (15-Y 0-N)",15,0,0,0,15
1900753,1489054,2025-02-13,Senate,"Constitutional reading dispensed (on 2nd reading) (40-Y 0-N)",40,0,0,0,40
1900753,1490296,2025-02-14,Senate,"Passed Senate (36-Y 0-N)",36,0,0,4,40
1900753,1565039,2025-01-28,House,"Read third time and passed House (91-Y 7-N)",91,7,0,2,100
1900754,1474545,2025-01-23,Senate,"Reported from Finance and Appropriations with substitute (13-Y 0-N)",13,0,0,2,15
1900754,1475358,2025-01-27,Senate,"Constitutional reading dispensed (on 1st reading) (36-Y 0-N)",36,0,0,4,40
1900754,1476228,2025-01-29,Senate,"Read third time and passed Senate (38-Y 0-N)",38,0,0,2,40
1900754,1485323,2025-02-10,House,"Reported from Finance (19-Y 0-N)",19,0,0,3,22
1900754,1488944,2025-02-13,House,"Passed House (96-Y 0-N)",96,0,0,4,100
1900755,1474036,2025-01-23,Senate,"Incorporated by Education and Health (SB953-Favola) (15-Y 0-N)",15,0,0,0,15
1900756,1473529,2025-01-23,Senate,"Reported from Education and Health with substitute and rereferred to Finance and Appropriations (15-Y 0-N)",15,0,0,0,15
1900757,1472347,2025-01-20,Senate,"Constitutional reading dispensed (on 1st reading) (40-Y 0-N)",40,0,0,0,40
1900757,1473072,2025-01-22,Senate,"Read third time and passed Senate (40-Y 0-N)",40,0,0,0,40
1900757,1473592,2025-01-17,Senate,"Reported from Rehabilitation and Social Services (14-Y 0-N)",14,0,0,1,15
1900757,1479921,2025-02-04,House,"Reported from General Laws with substitute (19-Y 2-N)",19,2,0,1,22
1900757,1483930,2025-02-07,House,"Passed House with substitute (86-Y 7-N)",86,7,0,7,100
1900757,1485908,2025-02-11,Senate,"House substitute agreed to by Senate",37,1,0,2,40
1900758,1471455,2025-01-13,House,"Subcommittee recommends laying on the table (5-Y 3-N)",5,3,0,1,9
1900759,1471747,2025-01-15,Senate,"Stricken at request of Patron in General Laws and Technology (13-Y 0-N)",13,0,0,2,15
1900762,1472440,2025-01-20,Senate,"Incorporated by Commerce and Labor (SB788-Head) (14-Y 0-N)",14,0,0,1,15
1900764,1473846,2025-01-16,Senate,"Rereferred from Transportation to Commerce and Labor (14-Y 0-N)",14,0,0,1,15
1900764,1476000,2025-01-27,Senate,"Reported from Commerce and Labor (8-Y 7-N)",8,7,0,0,15
1900764,1476163,2025-01-29,Senate,"Constitutional reading dispensed (on 1st reading) (38-Y 0-N)",38,0,0,2,40
1900764,1478616,2025-01-31,Senate,"Read third time and passed Senate (21-Y 19-N)",21,19,0,0,40
1900764,1491599,2025-02-17,House,"Passed by indefinitely in Rules (18-Y 0-N)",18,0,0,0,18
1900765,1472439,2025-01-20,Senate,"Stricken at request of Patron in Commerce and Labor (15-Y 0-N)",15,0,0,0,15
1900766,1472370,2025-01-20,Senate,"Reading waived (on 1st reading) (40-Y 0-N)",40,0,0,0,40
1900766,1490781,2025-02-17,House,"Reported from Rules (18-Y 0-N)",18,0,0,0,18
1900766,1497183,2025-02-20,House,"Agreed to by House (97-Y 0-N)",97,0,0,3,100
1900767,1473543,2025-01-23,Senate,"Incorporated by Education and Health (SB1035-Pekarsky) (15-Y 0-N)",15,0,0,0,15
1900768,1473919,2025-01-23,Senate,"Reported from Education and Health with substitute (15-Y 0-N)",15,0,0,0,15
1900768,1474454,2025-01-24,Senate,"Constitutional reading dispensed (on 1st reading) (37-Y 0-N)",37,0,0,3,40
1900768,1476676,2025-01-28,Senate,"Read third time and passed Senate (39-Y 0-N)",39,0,0,1,40
1900768,1486483,2025-02-11,House,"Subcommittee recommends reporting with substitute (7-Y 1-N)",7,1,0,1,9
1900768,1489224,2025-02-13,House,"Reported from Health and Human Services with substitute (22-Y 0-N)",22,0,0,0,22
1900768,1492724,2025-02-18,House,"Passed House with substitute (97-Y 0-N)",97,0,0,3,100
1900768,1495311,2025-02-19,Senate,"House substitute agreed to by Senate (40-Y 0-N)",40,0,0,0,40
1900769,1472015,2025-01-16,Senate,"Reported from Education and Health and rereferred to Finance and Appropriations (14-Y 0-N)",14,0,0,1,15
1900769,1474542,2025-01-23,Senate,"Reported from Finance and Appropriations (13-Y 0-N)",13,0,0,2,15
1900769,1475396,2025-01-27,Senate,"Constitutional reading dispensed (on 1st reading) (36-Y 0-N)",36,0,0,4,40
1900769,1476830,2025-01-29,Senate,"Read third time and passed Senate (38-Y 0-N)",38,0,0,2,40
1900769,1484685,2025-02-10,House,"Reported from Appropriations with substitute (22-Y 0-N)",22,0,0,0,22
1900769,1490016,2025-02-13,House,"Passed House with substitute (96-Y 0-N)",96,0,0,4,100
1900769,1491321,2025-02-17,Senate,"House substitute agreed to by Senate (39-Y 0-N)",39,0,0,1,40
1900770,1471520,2025-01-13,Senate,"Reported from Commerce and Labor (13-Y 0-N 2-A)",13,0,2,0,15
1900770,1471705,2025-01-15,Senate,"Constitutional reading dispensed (on 1st reading) (38-Y 0-N)",38,0,0,0,38
1900770,1473620,2025-01-17,Senate,"Read third time and passed Senate (40-Y 0-N)",40,0,0,0,40
1900770,1486438,2025-02-11,House,"Subcommittee recommends passing by indefinitely (6-Y 2-N)",6,2,0,1,9
1900771,1473619,2025-01-23,Senate,"Reported from Transportation with amendment (10-Y 4-N)",10,4,0,1,15
1900771,1474922,2025-01-27,Senate,"Constitutional reading dispensed (on 1st reading) (36-Y 0-N)",36,0,0,4,40
1900771,1476162,2025-01-29,Senate,"Read third time and passed Senate (25-Y 13-N)",25,13,0,2,40
1900771,1487688,2025-02-12,House,"Subcommittee recommends reporting (4-Y 3-N 1-A)",4,3,1,1,9
1900771,1488598,2025-02-13,House,"Failed to report (defeated) in Transportation (6-Y 14-N)",6,14,0,2,22
1900772,1476486,2025-01-29,Senate,"Passed by indefinitely in General Laws and Technology (8-Y 6-N 1-A)",8,6,1,0,15
1900773,1472344,2025-01-20,Senate,"Constitutional reading dispensed (on 1st reading) (40-Y 0-N)",40,0,0,0,40
1900773,1473070,2025-01-22,Senate,"Read third time and passed Senate (40-Y 0-N)",40,0,0,0,40
1900773,1473904,2025-01-17,Senate,"Reported from Rules (15-Y 0-N)",15,0,0,0,15
1900773,1486859,2025-02-11,House,"Subcommittee recommends reporting (7-Y 0-N)",7,0,0,1,8
1900773,1489410,2025-02-13,House,"Reported from Labor and Commerce (22-Y 0-N)",22,0,0,0,22
1900773,1491855,2025-02-18,House,"Passed House (97-Y 0-N)",97,0,0,3,100
1900774,1471748,2025-01-15,Senate,"Reported from General Laws and Technology with substitute and rereferred to Finance and Appropriations (15-Y 0-N)",15,0,0,0,15
1900774,1473770,2025-01-22,Senate,"Reported from Finance and Appropriations (15-Y 0-N)",15,0,0,0,15
1900774,1473771,2025-01-23,Senate,"Constitutional reading dispensed (on 1st reading) (39-Y 0-N)",39,0,0,1,40
1900774,1474947,2025-01-27,Senate,"Read third time and passed Senate (38-Y 0-N)",38,0,0,2,40
1900774,1480300,2025-02-04,House,"Reported from General Laws (21-Y 0-N)",21,0,0,1,22
1900774,1483969,2025-02-07,House,"Passed House (94-Y 0-N)",94,0,0,6,100
1900775,1472162,2025-01-17,Senate,"Reported from Rehabilitation and Social Services with substitute (15-Y 0-N)",15,0,0,0,15
1900775,1472323,2025-01-20,Senate,"Constitutional reading dispensed (on 1st reading) (40-Y 0-N)",40,0,0,0,40
1900775,1473017,2025-01-22,Senate,"Read third time and passed Senate (40-Y 0-N)",40,0,0,0,40
1900775,1483162,2025-02-06,House,"Subcommittee recommends reporting with amendment(s) (8-Y 0-N)",8,0,0,1,9
1900775,1483163,2025-02-06,House,"Reported from Health and Human Services with amendment(s) (22-Y 0-N)",22,0,0,0,22
1900775,1485953,2025-02-11,House,"Passed House with amendment (94-Y 0-N)",94,0,0,6,100
1900775,1489006,2025-02-13,Senate,"House Amendment agreed to by Senate (40-Y 0-N)",40,0,0,0,40
1900776,1471454,2025-01-13,House,"Subcommittee recommends laying on the table (5-Y 3-N)",5,3,0,1,9
1900777,1473962,2025-01-23,Senate,"Passed by indefinitely in Education and Health (9-Y 6-N)",9,6,0,0,15
1900778,1472181,2025-01-17,Senate,"Rereferred from Rehabilitation and Social Services to Education and Health (14-Y 0-N)",14,0,0,1,15
1900778,1478049,2025-01-30,Senate,"Reported from Education and Health with amendments (15-Y 0-N)",15,0,0,0,15
1900778,1478594,2025-01-31,Senate,"Constitutional reading dispensed (on 1st reading) (39-Y 0-N)",39,0,0,1,40
1900778,1479911,2025-02-03,Senate,"Constitutional reading dispensed (on 3rd reading) (40-Y 0-N)",40,0,0,0,40
1900778,1479912,2025-02-03,Senate,"Passed Senate (40-Y 0-N)",40,0,0,0,40
1900778,1485973,2025-02-11,House,"Subcommittee recommends reporting (8-Y 0-N)",8,0,0,1,9
1900778,1488762,2025-02-13,House,"Reported from Health and Human Services (22-Y 0-N)",22,0,0,0,22
1900778,1491992,2025-02-18,House,"Passed House (97-Y 0-N)",97,0,0,3,100
1900779,1472675,2025-01-21,Senate,"Passed by indefinitely in Finance and Appropriations (13-Y 1-N)",13,1,0,1,15
1900780,1472900,2025-01-22,House,"Subcommittee failed to recommend reporting (3-Y 5-N)",3,5,0,1,9
1900781,1472584,2025-01-21,House,"Subcommittee recommends reporting (7-Y 0-N)",7,0,0,2,9
1900781,1473971,2025-01-23,House,"Reported from Health and Human Services (22-Y 0-N)",22,0,0,0,22
1900781,1477209,2025-01-29,House,"Read third time and passed House (97-Y 0-N)",97,0,0,3,100
1900781,1482800,2025-02-05,Senate,"Reported from General Laws and Technology (15-Y 0-N)",15,0,0,0,15
1900781,1483977,2025-02-07,Senate,"Constitutional reading dispensed (on 2nd reading) (38-Y 0-N)",38,0,0,2,40
1900781,1484639,2025-02-10,Senate,"Passed Senate (39-Y 0-N)",39,0,0,1,40
1900782,1473882,2025-01-15,Senate,"Rereferred from General Laws and Technology to Courts of Justice (15-Y 0-N)",15,0,0,0,15
1900782,1473883,2025-01-22,Senate,"Reported from Courts of Justice (11-Y 4-N)",11,4,0,0,15
1900782,1474581,2025-01-24,Senate,"Constitutional reading dispensed (on 1st reading) (37-Y 0-N)",37,0,0,3,40
1900782,1476713,2025-01-28,Senate,"Read third time and passed Senate (23-Y 16-N)",23,16,0,1,40
1900782,1479929,2025-02-04,House,"Reported from General Laws with amendment(s) (12-Y 9-N)",12,9,0,1,22
1900782,1483931,2025-02-07,House,"Passed House with amendment (49-Y 45-N)",49,45,0,6,100
1900782,1485920,2025-02-11,Senate,"House Amendment agreed to by Senate",28,11,1,0,40
1900783,1471518,2025-01-13,Senate,"Reported from Courts of Justice with amendments (13-Y 0-N)",13,0,0,1,14
1900783,1471519,2025-01-14,Senate,"Constitutional reading dispensed (on 1st reading) (37-Y 0-N)",37,0,0,1,38
1900783,1471893,2025-01-16,Senate,"Read third time and passed Senate (39-Y 0-N)",39,0,0,1,40
1900783,1482670,2025-02-05,House,"Reported from Courts of Justice (22-Y 0-N)",22,0,0,0,22
1900783,1484699,2025-02-10,House,"Passed House (95-Y 0-N)",95,0,0,5,100
1900784,1472904,2025-01-22,House,"Subcommittee recommends striking from the docket (8-Y 0-N)",8,0,0,1,9
1900785,1473588,2025-01-23,Senate,"Reported from Education and Health and rereferred to Finance and Appropriations (15-Y 0-N)",15,0,0,0,15
1900786,1473707,2025-01-21,Senate,"Passed by indefinitely in Agriculture, Conservation and Natural Resources (8-Y 7-N)",8,7,0,0,15
1900787,1471744,2025-01-15,Senate,"Reported from General Laws and Technology (15-Y 0-N)",15,0,0,0,15
1900787,1472152,2025-01-17,Senate,"Constitutional reading dispensed (on 1st reading) (40-Y 0-N)",40,0,0,0,40
1900787,1472662,2025-01-21,Senate,"Read third time and passed Senate (40-Y 0-N)",40,0,0,0,40
1900787,1483736,2025-02-06,House,"Reported from General Laws with amendment(s) (21-Y 0-N)",21,0,0,1,22
1900787,1486063,2025-02-11,House,"Passed House with amendments (94-Y 0-N)",94,0,0,6,100
1900787,1489286,2025-02-13,Senate,"House Amendments agreed to by Senate (40-Y 0-N)",40,0,0,0,40
1900789,1473466,2025-01-23,Senate,"Reported from Education and Health with substitute (15-Y 0-N)",15,0,0,0,15
1900789,1474559,2025-01-24,Senate,"Constitutional reading dispensed (on 1st reading) (37-Y 0-N)",37,0,0,3,40
1900789,1476884,2025-01-28,Senate,"Read third time and passed Senate (39-Y 0-N)",39,0,0,1,40
1900789,1480793,2025-02-05,House,"Reported from Education (11-Y 9-N)",11,9,0,2,22
1900789,1487744,2025-02-12,House,"Passed House (52-Y 41-N)",52,41,0,7,100
1900790,1471761,2025-01-15,Senate,"Reported from General Laws and Technology with substitute and rereferred to Finance and Appropriations (15-Y 0-N)",15,0,0,0,15
1900790,1472589,2025-01-21,Senate,"Reported from Finance and Appropriations with amendments (15-Y 0-N)",15,0,0,0,15
1900790,1473117,2025-01-22,Senate,"Constitutional reading dispensed (on 1st reading) (40-Y 0-N)",40,0,0,0,40
1900790,1475349,2025-01-27,Senate,"Read third time and passed Senate (38-Y 0-N)",38,0,0,2,40
1900790,1483392,2025-02-06,House,"Reported from Labor and Commerce with amendment(s) (17-Y 4-N)",17,4,0,1,22
1900790,1486338,2025-02-11,House,"Passed House with amendments (73-Y 21-N)",73,21,0,6,100
1900790,1489218,2025-02-13,Senate,"House Amendments agreed to by Senate (40-Y 0-N)",40,0,0,0,40
1900792,1471739,2025-01-15,Senate,"Reported from General Laws and Technology (15-Y 0-N)",15,0,0,0,15
1900792,1472198,2025-01-17,Senate,"Constitutional reading dispensed (on 1st reading) (40-Y 0-N)",40,0,0,0,40
1900792,1472849,2025-01-21,Senate,"Read third time and passed Senate (40-Y 0-N)",40,0,0,0,40
1900792,1483729,2025-02-06,House,"Reported from General Laws (21-Y 0-N)",21,0,0,1,22
1900792,1486046,2025-02-11,House,"Passed House (94-Y 0-N)",94,0,0,6,100
1900793,1475747,2025-01-28,Senate,"Reported from Education and Health with substitute and rereferred to Finance and Appropriations (15-Y 0-N)",15,0,0,0,15
1900793,1477710,2025-01-30,Senate,"Reported from Finance and Appropriations with substitute (15-Y 0-N)",15,0,0,0,15
1900793,1479858,2025-02-04,Senate,"Constitutional reading dispensed (on 3rd reading) (39-Y 0-N)",39,0,0,1,40
1900793,1479859,2025-02-04,Senate,"Passed Senate (40-Y 0-N)",40,0,0,0,40
1900793,1480455,2025-02-03,Senate,"Constitutional reading dispensed (on 1st reading) (40-Y 0-N)",40,0,0,0,40
1900793,1488205,2025-02-12,House,"Reported from Education with substitute (21-Y 0-N)",21,0,0,1,22
1900793,1491455,2025-02-17,House,"Passed House with substitute (95-Y 0-N)",95,0,0,5,100
1900793,1491456,2025-02-17,House,"Passed House with substitute (96-Y 0-N)",96,0,0,4,100
1900793,1492391,2025-02-18,Senate,"House substitute rejected by Senate (1-Y 39-N)",1,39,0,0,40
1900793,1495988,2025-02-20,Senate,"Senate acceded to request (39-Y 0-N)",39,0,0,1,40
1900793,1496712,2025-02-21,Senate,"Conference report agreed to by Senate (37-Y 1-N)",37,1,0,2,40
1900793,1504055,2025-02-21,House,"Conference report agreed to by House (95-Y 0-N)",95,0,0,5,100
1900794,1473916,2025-01-17,Senate,"Reported from Rehabilitation and Social Services with substitute and rereferred to Finance and Appropriations (15-Y 0-N)",15,0,0,0,15
1900794,1474490,2025-01-23,Senate,"Reported from Finance and Appropriations with amendments (12-Y 0-N)",12,0,0,3,15
1900794,1474891,2025-01-27,Senate,"Constitutional reading dispensed (on 1st reading) (36-Y 0-N)",36,0,0,4,40
1900794,1477195,2025-01-29,Senate,"Read third time and passed Senate (38-Y 0-N)",38,0,0,2,40
1900794,1485934,2025-02-11,House,"Subcommittee recommends reporting and referring to Appropriations (8-Y 0-N)",8,0,0,1,9
1900794,1488794,2025-02-13,House,"Reported from Health and Human Services and referred to Appropriations (22-Y 0-N)",22,0,0,0,22
1900795,1471523,2025-01-13,Senate,"Reported from Courts of Justice (12-Y 1-N)",12,1,0,1,14
1900795,1471524,2025-01-14,Senate,"Constitutional reading dispensed (on 1st reading) (37-Y 0-N)",37,0,0,1,38
1900795,1472133,2025-01-17,Senate,"Read third time and passed Senate (32-Y 7-N)",32,7,0,1,40
1900795,1480820,2025-02-05,House,"Subcommittee recommends reporting (8-Y 0-N)",8,0,0,1,9
1900795,1485411,2025-02-10,House,"Reported from Courts of Justice (22-Y 0-N)",22,0,0,0,22
1900795,1489691,2025-02-13,House,"Passed House (77-Y 19-N)",77,19,0,4,100
1900795,1536273,2025-04-02,Senate,"Senate rejected Governor's recommendation (18-Y 22-N)",18,22,0,0,40
1900796,1471741,2025-01-15,Senate,"Reported from General Laws and Technology (9-Y 6-N)",9,6,0,0,15
1900796,1472121,2025-01-17,Senate,"Constitutional reading dispensed (on 1st reading) (40-Y 0-N)",40,0,0,0,40
1900796,1473650,2025-01-21,Senate,"Read third time and passed Senate (20-Y 19-N)",20,19,0,1,40
1900796,1483380,2025-02-06,House,"Reported from General Laws (12-Y 9-N)",12,9,0,1,22
1900796,1487524,2025-02-12,House,"Passed House (50-Y 47-N)",50,47,0,3,100
1900797,1471814,2025-01-15,House,"Subcommittee recommends laying on the table (8-Y 0-N)",8,0,0,1,9
1900798,1472431,2025-01-20,Senate,"Passed by indefinitely in Commerce and Labor (9-Y 6-N)",9,6,0,0,15
1900800,1475382,2025-01-28,Senate,"Reported from Education and Health and rereferred to Finance and Appropriations (15-Y 0-N)",15,0,0,0,15
1900801,1471653,2025-01-14,Senate,"Reported from Agriculture, Conservation and Natural Resources and rereferred to Finance and Appropriations (13-Y 0-N)",13,0,0,1,14
1900801,1472667,2025-01-21,Senate,"Reported from Finance and Appropriations (15-Y 0-N)",15,0,0,0,15
1900801,1473352,2025-01-22,Senate,"Constitutional reading dispensed (on 1st reading) (40-Y 0-N)",40,0,0,0,40
1900801,1474610,2025-01-24,Senate,"Read third time and passed Senate (38-Y 0-N)",38,0,0,2,40
1900801,1487707,2025-02-12,House,"Reported from Agriculture, Chesapeake and Natural Resources with amendment(s) (22-Y 0-N)",22,0,0,0,22
1900801,1491538,2025-02-17,House,"Passed House with amendments (95-Y 0-N)",95,0,0,5,100
1900801,1491539,2025-02-17,House,"Passed House with amendments (96-Y 0-N)",96,0,0,4,100
1900801,1492370,2025-02-18,Senate,"House Amendments agreed to by Senate (40-Y 0-N)",40,0,0,0,40
1900802,1472930,2025-01-21,Senate,"Incorporated by Agriculture, Conservation and Natural Resources (SB990-Williams Graves) (14-Y 0-N)",14,0,0,1,15
1900803,1475701,2025-01-28,Senate,"Reported from Privileges and Elections with substitute (8-Y 7-N)",8,7,0,0,15
1900803,1478677,2025-02-03,Senate,"Reported from Courts of Justice with substitute (8-Y 5-N 2-A)",8,5,2,0,15
1900803,1480031,2025-02-04,Senate,"Constitutional reading dispensed (on 3rd reading) (40-Y 0-N)",40,0,0,0,40
1900803,1480032,2025-02-04,Senate,"Passed Senate (23-Y 17-N)",23,17,0,0,40
1900803,1480858,2025-02-04,Senate,"Constitutional reading dispensed (on 1st reading) (40-Y 0-N)",40,0,0,0,40
1900803,1490028,2025-02-14,House,"Reported from Privileges and Elections with substitute (15-Y 7-N)",15,7,0,0,22
1900803,1493249,2025-02-19,House,"Passed House with substitute (72-Y 25-N)",72,25,0,3,100
1900803,1494953,2025-02-20,Senate,"House substitute rejected by Senate (0-Y 39-N)",0,39,0,1,40
1900803,1495610,2025-02-20,Senate,"Senate acceded to request (38-Y 0-N)",38,0,0,2,40
1900803,1497128,2025-02-22,House,"Conference report agreed to by House (71-Y 25-N)",71,25,0,4,100
1900803,1503572,2025-02-22,Senate,"Conference report agreed to by Senate (22-Y 18-N)",22,18,0,0,40
1900804,1471928,2025-01-16,House,"Subcommittee recommends reporting (8-Y 0-N)",8,0,0,1,9
1900804,1472701,2025-01-21,House,"Reported from General Laws (21-Y 0-N)",21,0,0,1,22
1900804,1474820,2025-01-27,House,"Read third time and passed House (97-Y 0-N)",97,0,0,3,100
1900804,1482420,2025-02-05,Senate,"Reported from General Laws and Technology (13-Y 0-N)",13,0,0,2,15
1900804,1483880,2025-02-07,Senate,"Constitutional reading dispensed (on 2nd reading) (38-Y 0-N)",38,0,0,2,40
1900804,1484591,2025-02-10,Senate,"Passed Senate (39-Y 0-N)",39,0,0,1,40
1900805,1471517,2025-01-13,Senate,"Reported from Commerce and Labor with amendments and rereferred to Finance and Appropriations (9-Y 6-N)",9,6,0,0,15
1900805,1472595,2025-01-21,Senate,"Reported from Finance and Appropriations (10-Y 5-N)",10,5,0,0,15
1900805,1473094,2025-01-22,Senate,"Constitutional reading dispensed (on 1st reading) (40-Y 0-N)",40,0,0,0,40
1900805,1474606,2025-01-24,Senate,"Read third time and passed Senate (21-Y 17-N)",21,17,0,2,40
1900805,1483373,2025-02-06,House,"Reported from Labor and Commerce with amendment(s) (15-Y 6-N)",15,6,0,1,22
1900805,1487505,2025-02-12,House,"Passed House with amendment (67-Y 30-N)",67,30,0,3,100
1900805,1490695,2025-02-14,Senate,"House amendment agreed to by Senate (24-Y 11-N)",24,11,0,5,40
1900805,1490696,2025-02-14,Senate,"Reconsideration of House amendment agreed to by Senate (36-Y 0-N)",36,0,0,4,40
1900805,1490697,2025-02-14,Senate,"House Amendment agreed to by Senate (24-Y 12-N)",24,12,0,4,40
1900805,1534664,2025-04-02,Senate,"Senate rejected Governor's recommendation (19-Y 21-N)",19,21,0,0,40
1900806,1472737,2025-01-21,House,"Subcommittee recommends reporting with substitute (8-Y 0-N)",8,0,0,1,9
1900806,1473161,2025-01-22,House,"Reported from Finance with substitute (22-Y 0-N)",22,0,0,0,22
1900806,1476469,2025-01-28,House,"Read third time and passed House (99-Y 0-N)",99,0,0,1,100
1900806,1485935,2025-02-11,Senate,"Passed by indefinitely in Finance and Appropriations with letter (10-Y 5-N)",10,5,0,0,15
1900807,1471521,2025-01-13,Senate,"Reported from Courts of Justice with substitute (13-Y 0-N)",13,0,0,1,14
1900807,1471522,2025-01-14,Senate,"Constitutional reading dispensed (on 1st reading) (37-Y 0-N)",37,0,0,1,38
1900807,1472019,2025-01-16,Senate,"Read third time and passed Senate (39-Y 0-N)",39,0,0,1,40
1900807,1482499,2025-02-05,House,"Reported from Courts of Justice (22-Y 0-N)",22,0,0,0,22
1900807,1485394,2025-02-10,House,"Passed House (95-Y 0-N)",95,0,0,5,100
1900808,1472342,2025-01-20,Senate,"Constitutional reading dispensed (on 1st reading) (40-Y 0-N)",40,0,0,0,40
1900808,1473061,2025-01-22,Senate,"Read third time and passed Senate (40-Y 0-N)",40,0,0,0,40
1900808,1473612,2025-01-17,Senate,"Reported from Rehabilitation and Social Services with amendments (15-Y 0-N)",15,0,0,0,15
1900808,1483025,2025-02-06,House,"Subcommittee recommends reporting (8-Y 0-N)",8,0,0,1,9
1900808,1483026,2025-02-06,House,"Reported from Health and Human Services (21-Y 1-N)",21,1,0,0,22
1900808,1488761,2025-02-12,House,"Passed House (97-Y 0-N)",97,0,0,3,100
1900809,1471722,2025-01-15,Senate,"Reported from Courts of Justice with substitute (9-Y 5-N)",9,5,0,1,15
1900809,1472130,2025-01-17,Senate,"Constitutional reading dispensed (on 1st reading) (40-Y 0-N)",40,0,0,0,40
1900809,1472950,2025-01-22,Senate,"Read third time and passed Senate (21-Y 18-N 1-A)",21,18,1,0,40
1900809,1482367,2025-02-05,House,"Subcommittee recommends reporting (5-Y 3-N)",5,3,0,1,9
1900809,1485306,2025-02-10,House,"Reported from Courts of Justice (12-Y 9-N)",12,9,0,1,22
1900809,1489303,2025-02-13,House,"Passed House (51-Y 46-N)",51,46,0,3,100
1900810,1472826,2025-01-21,Senate,"Reported from Privileges and Elections with substitute (8-Y 7-N)",8,7,0,0,15
1900810,1473805,2025-01-23,Senate,"Constitutional reading dispensed (on 1st reading) (39-Y 0-N)",39,0,0,1,40
1900810,1474829,2025-01-27,Senate,"Read third time and passed Senate (20-Y 18-N)",20,18,0,2,40
1900810,1483915,2025-02-07,House,"Reported from Privileges and Elections (13-Y 9-N)",13,9,0,0,22
1900810,1487636,2025-02-12,House,"Passed House (51-Y 46-N)",51,46,0,3,100
1900812,1478460,2025-01-31,House,"Subcommittee recommends reporting (8-Y 0-N)",8,0,0,1,9
1900812,1478461,2025-01-31,House,"Reported from Courts of Justice (20-Y 0-N)",20,0,0,2,22
1900812,1482399,2025-02-04,House,"Read third time and passed House (97-Y 0-N)",97,0,0,3,100
1900812,1482400,2025-02-04,House,"Passed House (99-Y 0-N)",99,0,0,1,100
1900812,1488540,2025-02-12,Senate,"Reported from Courts of Justice with substitute and rereferred to Finance and Appropriations (15-Y 0-N)",15,0,0,0,15
1900812,1490128,2025-02-14,Senate,"Reported from Finance and Appropriations (14-Y 0-N)",14,0,0,1,15
1900812,1492671,2025-02-17,Senate,"Constitutional reading dispensed (on 2nd reading) (39-Y 0-N)",39,0,0,1,40
1900812,1493614,2025-02-18,Senate,"Passed Senate with substitute (40-Y 0-N)",40,0,0,0,40
1900812,1493615,2025-02-19,House,"Senate substitute rejected by House (2-Y 95-N)",2,95,0,3,100
1900812,1495247,2025-02-20,Senate,"Senate insisted on substitute (39-Y 0-N)",39,0,0,1,40
1900812,1497162,2025-02-22,House,"Conference report agreed to by House (99-Y 0-N)",99,0,0,1,100
1900812,1504064,2025-02-22,Senate,"Conference report agreed to by Senate (40-Y 0-N)",40,0,0,0,40
1900813,1471456,2025-01-13,House,"Subcommittee recommends reporting (6-Y 2-N)",6,2,0,1,9
1900813,1472196,2025-01-17,House,"Stricken from docket by Courts of Justice (22-Y 0-N)",22,0,0,0,22
1900814,1475413,2025-01-28,House,"Subcommittee recommends striking from the docket (8-Y 0-N)",8,0,0,1,9
1900815,1471880,2025-01-16,House,"Reported from Health and Human Services with amendment(s) (22-Y 0-N)",22,0,0,0,22
1900815,1472964,2025-01-22,House,"Read third time and passed House (96-Y 0-N)",96,0,0,4,100
1900815,1472965,2025-01-22,House,"Passed House (97-Y 0-N)",97,0,0,3,100
1900815,1489604,2025-02-13,Senate,"Reported from Education and Health with substitute (15-Y 0-N)",15,0,0,0,15
1900815,1491098,2025-02-17,Senate,"Constitutional reading dispensed (on 2nd reading)",39,0,0,1,40
1900815,1493078,2025-02-18,Senate,"Passed Senate with substitute (40-Y 0-N)",40,0,0,0,40
1900815,1495399,2025-02-19,House,"Senate substitute agreed to by House (96-Y 0-N)",96,0,0,4,100
1900926,1475158,2025-01-27,House,"Subcommittee recommends reporting with amendment(s) (7-Y 0-N)",7,0,0,2,9
1900926,1476922,2025-01-29,House,"Reported from Appropriations with amendment(s) (20-Y 1-N)",20,1,0,1,22
1900926,1488131,2025-02-12,Senate,"Reported from Finance and Appropriations (15-Y 0-N)",15,0,0,0,15
1900926,1489125,2025-02-13,Senate,"Constitutional reading dispensed (on 2nd reading) (40-Y 0-N)",40,0,0,0,40
1900926,1490240,2025-02-14,Senate,"Passed Senate (36-Y 0-N)",36,0,0,4,40
1900926,1565422,2025-02-04,House,"Read third time and passed House (97-Y 0-N)",97,0,0,3,100
1900954,1472064,2025-01-16,Senate,"Reported from Education and Health with substitute and rereferred to Finance and Appropriations (14-Y 0-N)",14,0,0,1,15
1900954,1474539,2025-01-23,Senate,"Reported from Finance and Appropriations with amendments (13-Y 0-N)",13,0,0,2,15
1900954,1475191,2025-01-27,Senate,"Constitutional reading dispensed (on 1st reading) (36-Y 0-N)",36,0,0,4,40
1900954,1477186,2025-01-29,Senate,"Read third time and passed Senate (38-Y 0-N)",38,0,0,2,40
1900954,1486455,2025-02-11,House,"Subcommittee recommends striking from the docket (8-Y 0-N)",8,0,0,1,9
1900959,1475381,2025-01-27,Senate,"Reading waived (on 1st reading) (38-Y 0-N)",38,0,0,2,40
1900959,1490813,2025-02-17,House,"Reported from Rules with substitute (14-Y 4-N)",14,4,0,0,18
1900959,1496663,2025-02-20,House,"Agreed to by House (55-Y 43-N)",55,43,0,2,100
1900972,1471648,2025-01-14,House,"Subcommittee recommends laying on the table (5-Y 2-N)",5,2,0,2,9
1900977,1472420,2025-01-20,House,"Subcommittee recommends reporting with substitute (7-Y 1-N)",7,1,0,1,9
1900977,1474672,2025-01-24,House,"Reported from Courts of Justice with substitute (21-Y 1-N)",21,1,0,0,22
1900977,1478614,2025-01-31,House,"Read third time and passed House (92-Y 4-N)",92,4,0,4,100
1900977,1484788,2025-02-10,Senate,"Reported from Courts of Justice with substitute (15-Y 0-N)",15,0,0,0,15
1900977,1486054,2025-02-11,Senate,"Constitutional reading dispensed (on 2nd reading) (40-Y 0-N)",40,0,0,0,40
1900977,1488717,2025-02-12,Senate,"Passed Senate with substitute (39-Y 0-N)",39,0,0,1,40
1900977,1564847,2025-02-14,House,"Senate substitute agreed to by House (Y-95 N-1 A-0)",95,1,0,4,100
1900983,1477212,2025-01-30,Senate,"Reported from Education and Health with substitute (15-Y 0-N)",15,0,0,0,15
1900983,1478094,2025-01-31,Senate,"Constitutional reading dispensed (on 1st reading) (39-Y 0-N)",39,0,0,1,40
1900983,1480100,2025-02-03,Senate,"Constitutional reading dispensed (on 3rd reading) (40-Y 0-N)",40,0,0,0,40
1900983,1480101,2025-02-03,Senate,"Passed Senate (40-Y 0-N)",40,0,0,0,40
1900983,1486082,2025-02-11,House,"Subcommittee recommends reporting (8-Y 0-N)",8,0,0,1,9
1900983,1488715,2025-02-13,House,"Reported from Health and Human Services (21-Y 0-N)",21,0,0,1,22
1900983,1492144,2025-02-18,House,"Passed House (97-Y 0-N)",97,0,0,3,100
1900990,1473569,2025-01-23,Senate,"Reported from Education and Health and rereferred to Finance and Appropriations (15-Y 0-N)",15,0,0,0,15
1900994,1471527,2025-01-13,Senate,"Reported from Courts of Justice with substitute (13-Y 0-N)",13,0,0,1,14
1900994,1471603,2025-01-14,Senate,"Constitutional reading dispensed (on 1st reading) (37-Y 0-N)",37,0,0,1,38
1900994,1472205,2025-01-17,Senate,"Engrossment reconsidered by Senate",40,0,0,0,40
1900994,1472206,2025-01-17,Senate,"Committee substitute reconsidered",40,0,0,0,40
1900994,1472207,2025-01-17,Senate,"Passed Senate (40-Y 0-N)",40,0,0,0,40
1900994,1479252,2025-01-17,Senate,"Constitutional reading dispensed (on 3rd reading) (40-Y 0-N)",40,0,0,0,40
1900999,1472371,2025-01-20,Senate,"Constitutional reading dispensed (on 1st reading) (40-Y 0-N)",40,0,0,0,40
1900999,1472948,2025-01-22,Senate,"Read third time and passed Senate (40-Y 0-N)",40,0,0,0,40
1900999,1473867,2025-01-17,Senate,"Reported from Rehabilitation and Social Services (15-Y 0-N)",15,0,0,0,15
1900999,1480327,2025-02-04,House,"Reported from General Laws (21-Y 0-N)",21,0,0,1,22
1900999,1483980,2025-02-07,House,"Passed House (94-Y 0-N)",94,0,0,6,100
1901005,1471882,2025-01-16,House,"Reported from Health and Human Services (22-Y 0-N)",22,0,0,0,22
1901005,1472972,2025-01-22,House,"Read third time and passed House (96-Y 0-N)",96,0,0,4,100
1901005,1472973,2025-01-22,House,"Passed House (97-Y 0-N)",97,0,0,3,100
1901005,1489622,2025-02-13,Senate,"Reported from Education and Health (15-Y 0-N)",15,0,0,0,15
1901005,1491038,2025-02-17,Senate,"Constitutional reading dispensed (on 2nd reading)",39,0,0,1,40
1901005,1492324,2025-02-18,Senate,"Passed Senate (40-Y 0-N)",40,0,0,0,40
1901014,1473495,2025-01-23,House,"Subcommittee recommends reporting with substitute and referring to Appropriations (3-Y 2-N)",3,2,0,2,7
1901014,1474209,2025-01-24,House,"Reported from Public Safety with substitute and referred to Appropriations (14-Y 8-N)",14,8,0,0,22
1901014,1476396,2025-01-29,House,"Subcommittee recommends reporting with amendment(s) (8-Y 0-N)",8,0,0,1,9
1901014,1476779,2025-01-29,House,"Reported from Appropriations with amendment(s) (21-Y 0-N)",21,0,0,1,22
1901014,1480583,2025-02-04,House,"Read third time and passed House (61-Y 38-N)",61,38,0,1,100
1901014,1483856,2025-02-07,Senate,"Rereferred from Rehabilitation and Social Services to Courts of Justice (15-Y 0-N)",15,0,0,0,15
1901014,1488505,2025-02-12,Senate,"Reported from Courts of Justice with substitute and rereferred to Finance and Appropriations (14-Y 0-N)",14,0,0,1,15
1901014,1490166,2025-02-14,Senate,"Reported from Finance and Appropriations (14-Y 0-N)",14,0,0,1,15
1901014,1492187,2025-02-17,Senate,"Constitutional reading dispensed (on 2nd reading) (39-Y 0-N)",39,0,0,1,40
1901014,1492188,2025-02-18,Senate,"Passed Senate with substitute (40-Y 0-N)",40,0,0,0,40
1901014,1493592,2025-02-19,House,"Senate substitute rejected by House (0-Y 96-N)",0,96,0,4,100
1901014,1495248,2025-02-20,Senate,"Senate insisted on substitute (39-Y 0-N)",39,0,0,1,40
1901014,1497144,2025-02-22,House,"Conference report agreed to by House (71-Y 28-N)",71,28,0,1,100
1901014,1503726,2025-02-22,Senate,"Conference report agreed to by Senate (40-Y 0-N)",40,0,0,0,40
1901014,1536354,2025-04-02,House,"House rejected Governor's recommendation (9-Y 86-N)",9,86,0,5,100
1901018,1473898,2025-01-22,Senate,"Passed by indefinitely in General Laws and Technology with letter (12-Y 0-N)",12,0,0,3,15
1901023,1471526,2025-01-13,Senate,"Reported from Commerce and Labor with amendment (8-Y 6-N 1-A)",8,6,1,0,15
1901023,1471704,2025-01-15,Senate,"Constitutional reading dispensed (on 1st reading) (38-Y 0-N)",38,0,0,0,38
1901023,1473586,2025-01-17,Senate,"Read third time and passed Senate (21-Y 19-N)",21,19,0,0,40
1901023,1486383,2025-02-11,House,"Subcommittee recommends reporting (6-Y 4-N)",6,4,0,1,11
1901023,1489431,2025-02-13,House,"Reported from Labor and Commerce (12-Y 10-N)",12,10,0,0,22
1901023,1492069,2025-02-18,House,"Passed House (51-Y 46-N)",51,46,0,3,100
1901029,1471856,2025-01-15,Senate,"Reported from General Laws and Technology with substitute and rereferred to Finance and Appropriations (9-Y 4-N)",9,4,0,2,15
1901033,1471849,2025-01-15,Senate,"Reported from General Laws and Technology and rereferred to Finance and Appropriations (15-Y 0-N)",15,0,0,0,15
1901033,1473908,2025-01-22,Senate,"Reported from Finance and Appropriations with amendments (14-Y 0-N)",14,0,0,1,15
1901033,1473909,2025-01-23,Senate,"Constitutional reading dispensed (on 1st reading) (39-Y 0-N)",39,0,0,1,40
1901033,1475090,2025-01-27,Senate,"Read third time and passed Senate (38-Y 0-N)",38,0,0,2,40
1901033,1479971,2025-02-04,House,"Reported from General Laws (19-Y 2-N)",19,2,0,1,22
1901033,1483921,2025-02-07,House,"Passed House (76-Y 18-N)",76,18,0,6,100
1901038,1472332,2025-01-20,House,"Subcommittee recommends laying on the table (5-Y 3-N)",5,3,0,1,9
1901044,1471525,2025-01-13,Senate,"Reported from Commerce and Labor with amendment (9-Y 6-N)",9,6,0,0,15
1901044,1471706,2025-01-15,Senate,"Constitutional reading dispensed (on 1st reading) (38-Y 0-N)",38,0,0,0,38
1901044,1472120,2025-01-17,Senate,"Read third time and passed Senate (21-Y 19-N)",21,19,0,0,40
1901044,1486497,2025-02-11,House,"Subcommittee recommends reporting (6-Y 4-N)",6,4,0,1,11
1901044,1489422,2025-02-13,House,"Reported from Labor and Commerce (12-Y 10-N)",12,10,0,0,22
1901044,1492023,2025-02-18,House,"Passed House (51-Y 46-N)",51,46,0,3,100
1901054,1471528,2025-01-13,Senate,"Reported from Local Government with amendments (12-Y 0-N)",12,0,0,1,13
1901054,1471529,2025-01-14,Senate,"Constitutional reading dispensed (on 1st reading) (37-Y 0-N)",37,0,0,1,38
1901054,1471906,2025-01-16,Senate,"Read third time and passed Senate (39-Y 0-N)",39,0,0,1,40
1901054,1482415,2025-02-05,House,"Subcommittee recommends reporting (5-Y 3-N)",5,3,0,1,9
1901054,1483966,2025-02-07,House,"Reported from Counties, Cities and Towns (17-Y 4-N)",17,4,0,1,22
1901054,1489733,2025-02-12,House,"Passed House (91-Y 6-N)",91,6,0,3,100
1901058,1472062,2025-01-16,Senate,"Reported from Education and Health with substitute and rereferred to Finance and Appropriations (14-Y 0-N)",14,0,0,1,15
1901070,1473783,2025-01-20,Senate,"Failed to report (defeated) in Local Government (5-Y 7-N 3-A)",5,7,3,0,15
1901079,1472063,2025-01-16,Senate,"Reported from Education and Health (14-Y 0-N)",14,0,0,1,15
1901079,1472126,2025-01-17,Senate,"Constitutional reading dispensed (on 1st reading) (40-Y 0-N)",40,0,0,0,40
1901079,1472850,2025-01-21,Senate,"Read third time and passed Senate (40-Y 0-N)",40,0,0,0,40
1901079,1485915,2025-02-11,House,"Subcommittee recommends reporting with amendment(s) and referring to Appropriations (8-Y 0-N)",8,0,0,1,9
1901079,1488771,2025-02-13,House,"Reported from Health and Human Services with amendment(s) and referred to Appropriations (22-Y 0-N)",22,0,0,0,22
1901088,1472061,2025-01-16,Senate,"Reported from Education and Health (14-Y 0-N)",14,0,0,1,15
1901088,1473880,2025-01-17,Senate,"Constitutional reading dispensed (on 1st reading) (40-Y 0-N)",40,0,0,0,40
1901088,1473881,2025-01-21,Senate,"Read third time and passed Senate (40-Y 0-N)",40,0,0,0,40
1901088,1485933,2025-02-11,House,"Subcommittee recommends reporting (8-Y 0-N)",8,0,0,1,9
1901088,1488787,2025-02-13,House,"Reported from Health and Human Services (22-Y 0-N)",22,0,0,0,22
1901088,1492064,2025-02-18,House,"Passed House (97-Y 0-N)",97,0,0,3,100
1901097,1472518,2025-01-20,Senate,"Incorporated by Commerce and Labor (SB998-Williams Graves) (15-Y 0-N)",15,0,0,0,15
1901105,1472033,2025-01-16,Senate,"Rereferred from Education and Health to Rehabilitation and Social Services (14-Y 0-N)",14,0,0,1,15
1901105,1474178,2025-01-24,Senate,"Reported from Rehabilitation and Social Services with substitute and rereferred to Finance and Appropriations (13-Y 1-N 1-A)",13,1,1,0,15
1901105,1477756,2025-01-29,Senate,"Reported from Finance and Appropriations with amendment (15-Y 0-N)",15,0,0,0,15
1901105,1477757,2025-01-30,Senate,"Constitutional reading dispensed (on 1st reading) (39-Y 0-N 1-A)",39,0,1,0,40
1901105,1480053,2025-02-03,Senate,"Read third time and passed Senate (40-Y 0-N)",40,0,0,0,40
1901105,1485954,2025-02-11,House,"Subcommittee recommends reporting and referring to Appropriations (8-Y 0-N)",8,0,0,1,9
1901105,1488773,2025-02-13,House,"Reported from Health and Human Services with amendment(s) and referred to Appropriations (22-Y 0-N)",22,0,0,0,22
1901105,1490165,2025-02-14,House,"Reported from Appropriations (21-Y 0-N)",21,0,0,1,22
1901105,1495235,2025-02-19,House,"Passed House with amendments (97-Y 0-N)",97,0,0,3,100
1901105,1495236,2025-02-20,Senate,"House Amendments agreed to by Senate (38-Y 0-N)",38,0,0,2,40
1901105,1535334,2025-04-02,House,"House concurred in Governor's recommendation (93-Y 0-N)",93,0,0,7,100
1901105,1536542,2025-04-02,Senate,"Senate concurred in Governor's recommendation (40-Y 0-N)",40,0,0,0,40
1901112,1471530,2025-01-13,Senate,"Reported from Courts of Justice with substitute (13-Y 0-N)",13,0,0,1,14
1901112,1471531,2025-01-14,Senate,"Constitutional reading dispensed (on 1st reading) (37-Y 0-N)",37,0,0,1,38
1901112,1472032,2025-01-16,Senate,"Read third time and passed Senate (39-Y 0-N)",39,0,0,1,40
1901112,1483006,2025-02-06,House,"Subcommittee recommends reporting (6-Y 0-N)",6,0,0,1,7
1901112,1484262,2025-02-07,House,"Reported from Public Safety (21-Y 0-N)",21,0,0,1,22
1901112,1489454,2025-02-12,House,"Passed House (97-Y 0-N)",97,0,0,3,100
1901119,1474013,2025-01-17,Senate,"Passed by indefinitely in Courts of Justice (9-Y 6-N)",9,6,0,0,15
1901122,1471855,2025-01-15,Senate,"Reported from General Laws and Technology with amendments and rereferred to Finance and Appropriations (15-Y 0-N)",15,0,0,0,15
1901122,1473779,2025-01-22,Senate,"Reported from Finance and Appropriations (14-Y 0-N)",14,0,0,1,15
1901122,1473780,2025-01-23,Senate,"Constitutional reading dispensed (on 1st reading) (39-Y 0-N)",39,0,0,1,40
1901122,1474948,2025-01-27,Senate,"Read third time and passed Senate (38-Y 0-N)",38,0,0,2,40
1901122,1483750,2025-02-06,House,"Subcommittee recommends reporting (8-Y 0-N)",8,0,0,1,9
1901122,1486651,2025-02-11,House,"Reported from General Laws (19-Y 0-N)",19,0,0,3,22
1901122,1489982,2025-02-14,House,"Passed House (96-Y 0-N)",96,0,0,4,100
1901150,1478019,2025-01-31,House,"Reported from Public Safety with substitute (12-Y 9-N)",12,9,0,1,22
1901150,1480623,2025-02-04,House,"Read third time and passed House (50-Y 48-N)",50,48,0,2,100
1901150,1484864,2025-02-10,Senate,"Reported from Courts of Justice with substitute and rereferred to Finance and Appropriations (8-Y 6-N 1-A)",8,6,1,0,15
1901150,1487452,2025-02-12,Senate,"Reported from Finance and Appropriations with substitute (10-Y 5-N)",10,5,0,0,15
1901150,1489126,2025-02-13,Senate,"Constitutional reading dispensed (on 2nd reading) (40-Y 0-N)",40,0,0,0,40
1901150,1491185,2025-02-17,Senate,"Passed Senate with substitute (21-Y 18-N)",21,18,0,1,40
1901150,1493136,2025-02-18,House,"Senate substitute rejected by House (0-Y 97-N)",0,97,0,3,100
1901150,1493845,2025-02-19,Senate,"Senate insisted on amendment (36-Y 3-N)",36,3,0,1,40
1901163,1474994,2025-01-27,House,"Subcommittee recommends laying on the table (5-Y 3-N)",5,3,0,1,9
1901169,1472375,2025-01-20,House,"Subcommittee recommends reporting and referred to Appropriations (10-Y 0-N)",10,0,0,1,11
1901169,1472985,2025-01-22,House,"Reported from Education and referred to Appropriations (22-Y 0-N)",22,0,0,0,22
1901169,1478496,2025-01-31,House,"Reported from Appropriations with amendment(s) (22-Y 0-N)",22,0,0,0,22
1901169,1480069,2025-02-04,House,"Read third time and passed House (97-Y 0-N)",97,0,0,3,100
1901169,1480070,2025-02-04,House,"Passed House (99-Y 0-N)",99,0,0,1,100
1901169,1489175,2025-02-13,Senate,"Reported from Education and Health with substitute and rereferred to Finance and Appropriations (15-Y 0-N)",15,0,0,0,15
1901169,1491918,2025-02-17,Senate,"Reported from Finance and Appropriations (14-Y 0-N)",14,0,0,1,15
1901169,1495863,2025-02-19,Senate,"Constitutional reading dispensed (on 2nd reading) (40-Y 0-N)",40,0,0,0,40
1901169,1495864,2025-02-20,Senate,"Senate insisted on substitute (38-Y 0-N)",38,0,0,2,40
1901169,1496145,2025-02-20,Senate,"Passed Senate with substitute (39-Y 0-N)",39,0,0,1,40
1901169,1496146,2025-02-20,Senate,"Reconsideration of Senate passage agreed to by Senate (39-Y 0-N)",39,0,0,1,40
1901169,1496147,2025-02-20,Senate,"Passed Senate with substitute (39-Y 0-N)",39,0,0,1,40
1901169,1496559,2025-02-21,Senate,"Conference report agreed to by Senate (38-Y 0-N)",38,0,0,2,40
1901169,1497201,2025-02-22,House,"Conference report agreed to by House (99-Y 0-N)",99,0,0,1,100
1901169,1565432,2025-02-20,House,"Senate substitute rejected by House (1-Y 95-N)",1,95,0,4,100
1901188,1474867,2025-01-27,House,"Subcommittee recommends reporting and referring to Appropriations (5-Y 3-N)",5,3,0,0,8
1901188,1476328,2025-01-29,House,"Reported from Finance and referred to Appropriations (11-Y 10-N)",11,10,0,1,22
1901188,1478209,2025-01-31,House,"Reported from Appropriations with substitute (12-Y 10-N)",12,10,0,0,22
1901188,1480774,2025-02-04,House,"Read third time and passed House (52-Y 47-N)",52,47,0,1,100
1901188,1485923,2025-02-11,Senate,"Passed by indefinitely in Finance and Appropriations (12-Y 1-N 2-A)",12,1,2,0,15
1901196,1471878,2025-01-16,House,"Subcommittee recommends reporting with amendment(s) (5-Y 3-N)",5,3,0,1,9
1901196,1472095,2025-01-17,House,"Reported from Counties, Cities and Towns with amendment(s) (13-Y 9-N)",13,9,0,0,22
1901196,1473579,2025-01-23,House,"Read third time and passed House (57-Y 40-N)",57,40,0,3,100
1901196,1484568,2025-02-10,Senate,"Reported from Local Government with substitute (11-Y 3-N 1-A)",11,3,1,0,15
1901196,1486170,2025-02-11,Senate,"Constitutional reading dispensed (on 2nd reading) (40-Y 0-N)",40,0,0,0,40
1901196,1488878,2025-02-12,Senate,"Passed Senate with substitute (26-Y 10-N 1-A)",26,10,1,3,40
1901196,1493036,2025-02-18,Senate,"Senate insisted on substitute (38-Y 0-N)",38,0,0,2,40
1901196,1496418,2025-02-21,Senate,"Conference report agreed to by Senate (22-Y 13-N 1-A)",22,13,1,4,40
1901196,1497207,2025-02-22,House,"Conference report agreed to by House (55-Y 44-N)",55,44,0,1,100
1901196,1536526,2025-04-02,House,"House rejected Governor's recommendation (11-Y 85-N)",11,85,0,4,100
1901196,1536527,2025-04-02,House,"Motion to pass in enrolled form rejected (51-Y 44-N)",51,44,0,5,100
1901196,1564998,2025-02-14,House,"Senate substitute rejected by House (Y-2 N-94 A-0)",2,94,0,4,100
1901207,1473140,2025-01-22,House,"Subcommittee recommends reporting with amendment(s) (8-Y 0-N)",8,0,0,1,9
1901207,1474262,2025-01-24,House,"Reported from Appropriations with amendment(s) (22-Y 0-N)",22,0,0,0,22
1901207,1478109,2025-01-30,House,"Read third time and passed House (96-Y 0-N)",96,0,0,4,100
1901207,1480473,2025-02-05,Senate,"Reported from Finance and Appropriations (13-Y 0-N)",13,0,0,2,15
1901207,1483592,2025-02-06,Senate,"Constitutional reading dispensed (on 2nd reading) (40-Y 0-N)",40,0,0,0,40
1901207,1484529,2025-02-07,Senate,"Passed Senate (39-Y 0-N)",39,0,0,1,40
1901216,1473940,2025-01-23,House,"Subcommittee recommends reporting with substitute and referring to Appropriations (8-Y 0-N)",8,0,0,1,9
1901216,1475649,2025-01-28,House,"Reported from Health and Human Services with substitute and referred to Appropriations (21-Y 0-N)",21,0,0,1,22
1901216,1476588,2025-01-29,House,"Subcommittee recommends laying on the table (6-Y 0-N)",6,0,0,3,9
1901250,1472082,2025-01-17,House,"Reported from Public Safety (22-Y 0-N)",22,0,0,0,22
1901250,1473646,2025-01-23,House,"Read third time and passed House (97-Y 0-N)",97,0,0,3,100
1901250,1480687,2025-02-05,Senate,"Reported from General Laws and Technology with amendments and rereferred to Finance and Appropriations (15-Y 0-N)",15,0,0,0,15
1901250,1485888,2025-02-11,Senate,"Passed by indefinitely in Finance and Appropriations (14-Y 1-N)",14,1,0,0,15
1901267,1475903,2025-01-28,House,"Subcommittee recommends laying on the table (8-Y 0-N)",8,0,0,1,9
1901271,1471940,2025-01-16,House,"Subcommittee recommends reporting and referred to Appropriations (8-Y 0-N)",8,0,0,1,9
1901271,1472548,2025-01-21,House,"Reported from Health and Human Services and referred to Appropriations (20-Y 1-N)",20,1,0,1,22
1901271,1476607,2025-01-29,House,"Subcommittee recommends laying on the table (6-Y 0-N)",6,0,0,3,9
1901275,1476662,2025-01-29,House,"Tabled in Rules (14-Y 0-N)",14,0,0,4,18
1901281,1472569,2025-01-21,House,"Subcommittee recommends reporting with substitute and referred to Appropriations (8-Y 0-N)",8,0,0,1,9
1901281,1473340,2025-01-22,House,"Reported from Education with substitute (22-Y 0-N)",22,0,0,0,22
1901281,1477029,2025-01-28,House,"Read third time and passed House (99-Y 0-N)",99,0,0,1,100
1901281,1489658,2025-02-13,Senate,"Reported from Education and Health with substitute and rereferred to Finance and Appropriations (15-Y 0-N)",15,0,0,0,15
1901281,1492190,2025-02-17,Senate,"Reported from Finance and Appropriations (14-Y 0-N)",14,0,0,1,15
1901281,1493627,2025-02-19,Senate,"Constitutional reading dispensed (on 2nd reading) (40-Y 0-N)",40,0,0,0,40
1901281,1495933,2025-02-20,Senate,"Senate insisted on substitute (38-Y 0-N)",38,0,0,2,40
1901281,1496405,2025-02-20,Senate,"Passed Senate with substitute (39-Y 0-N)",39,0,0,1,40
1901281,1496406,2025-02-20,Senate,"Reconsideration of Senate passage agreed to by Senate (39-Y 0-N)",39,0,0,1,40
1901281,1496407,2025-02-20,Senate,"Passed Senate with substitute (39-Y 0-N)",39,0,0,1,40
1901281,1496821,2025-02-20,House,"Senate substitute rejected by House (96-Y 4-N)",0,96,0,4,100
1901281,1497158,2025-02-21,Senate,"Conference report agreed to by Senate (40-Y 0-N)",40,0,0,0,40
1901281,1503960,2025-02-21,House,"Conference report agreed to by House (98-Y 0-N)",98,0,0,2,100
1901283,1472538,2025-01-21,House,"Subcommittee recommends reporting (7-Y 1-N)",7,1,0,1,9
1901283,1473450,2025-01-23,House,"Reported from Health and Human Services (21-Y 1-N)",21,1,0,0,22
1901283,1483124,2025-02-06,Senate,"Reported from Education and Health (14-Y 0-N)",14,0,0,1,15
1901283,1483888,2025-02-07,Senate,"Constitutional reading dispensed (on 2nd reading) (38-Y 0-N)",38,0,0,2,40
1901283,1484701,2025-02-10,Senate,"Passed Senate (39-Y 0-N)",39,0,0,1,40
1901283,1564975,2025-01-29,House,"Read third time and passed House (93-Y 4-N)",93,4,0,3,100
1901287,1473261,2025-01-22,House,"Subcommittee recommends reporting with amendment(s) (8-Y 0-N)",8,0,0,1,9
1901287,1475024,2025-01-24,House,"Reported from Courts of Justice with amendment(s) (22-Y 0-N)",22,0,0,0,22
1901287,1478196,2025-01-31,House,"Read third time and passed House (96-Y 0-N)",96,0,0,4,100
1901287,1491406,2025-02-17,Senate,"Reported from Courts of Justice (15-Y 0-N)",15,0,0,0,15
1901287,1492147,2025-02-18,Senate,"Constitutional reading dispensed (on 2nd reading) (39-Y 0-N)",39,0,0,1,40
1901287,1494959,2025-02-19,Senate,"Passed Senate (40-Y 0-N)",40,0,0,0,40
1901299,1471457,2025-01-13,House,"Subcommittee recommends reporting (8-Y 0-N)",8,0,0,1,9
1901299,1472182,2025-01-17,House,"Reported from Courts of Justice (22-Y 0-N)",22,0,0,0,22
1901299,1473622,2025-01-23,House,"Read third time and passed House (97-Y 0-N)",97,0,0,3,100
1901299,1483108,2025-02-05,Senate,"Reported from Courts of Justice (14-Y 0-N)",14,0,0,1,15
1901299,1483881,2025-02-07,Senate,"Constitutional reading dispensed (on 2nd reading) (38-Y 0-N)",38,0,0,2,40
1901299,1484604,2025-02-10,Senate,"Passed Senate (39-Y 0-N)",39,0,0,1,40
1901303,1472087,2025-01-17,House,"Reported from Public Safety (12-Y 10-N)",12,10,0,0,22
1901303,1473706,2025-01-23,House,"Read third time and passed House (49-Y 47-N)",49,47,0,4,100
1901303,1484799,2025-02-10,Senate,"Reported from Courts of Justice with substitute and rereferred to Finance and Appropriations (9-Y 6-N)",9,6,0,0,15
1901303,1487357,2025-02-12,Senate,"Reported from Finance and Appropriations (10-Y 5-N)",10,5,0,0,15
1901303,1488880,2025-02-13,Senate,"Constitutional reading dispensed (on 2nd reading) (40-Y 0-N)",40,0,0,0,40
1901303,1490203,2025-02-14,Senate,"Passed Senate with substitute (21-Y 15-N)",21,15,0,4,40
1901303,1492293,2025-02-18,House,"Senate substitute agreed to by House (50-Y 47-N)",50,47,0,3,100
1901306,1471461,2025-01-14,House,"Subcommittee recommends reporting with substitute (7-Y 0-N)",7,0,0,1,8
1901306,1471965,2025-01-16,House,"Reported from Labor and Commerce with substitute (22-Y 0-N)",22,0,0,0,22
1901306,1473631,2025-01-23,House,"Read third time and passed House (58-Y 39-N)",58,39,0,3,100
1901306,1491343,2025-02-17,Senate,"Reported from Commerce and Labor (15-Y 0-N)",15,0,0,0,15
1901306,1493295,2025-02-18,Senate,"Constitutional reading dispensed (on 2nd reading) (40-Y 0-N)",40,0,0,0,40
1901306,1495656,2025-02-19,Senate,"Passed Senate (40-Y 0-N)",40,0,0,0,40
1901315,1472047,2025-01-16,House,"Subcommittee recommends reporting (8-Y 0-N)",8,0,0,1,9
1901315,1472649,2025-01-21,House,"Reported from General Laws (21-Y 0-N)",21,0,0,1,22
1901315,1475270,2025-01-27,House,"Read third time and passed House (97-Y 0-N)",97,0,0,3,100
1901315,1482727,2025-02-05,Senate,"Reported from General Laws and Technology and rereferred to Finance and Appropriations (13-Y 0-N)",13,0,0,2,15
1901315,1486791,2025-02-11,Senate,"Reported from Finance and Appropriations (15-Y 0-N)",15,0,0,0,15
1901315,1486792,2025-02-11,Senate,"Constitutional reading dispensed (on 2nd reading) (40-Y 0-N)",40,0,0,0,40
1901315,1488090,2025-02-12,Senate,"Passed Senate (39-Y 0-N)",39,0,0,1,40
1901323,1471770,2025-01-15,House,"Subcommittee recommends reporting with substitute (8-Y 0-N)",8,0,0,1,9
1901323,1472179,2025-01-17,House,"Reported from Courts of Justice with substitute (22-Y 0-N)",22,0,0,0,22
1901323,1473517,2025-01-23,House,"Read third time and passed House (97-Y 0-N)",97,0,0,3,100
1901323,1488488,2025-02-12,Senate,"Reported from Courts of Justice with substitute (15-Y 0-N)",15,0,0,0,15
1901323,1490195,2025-02-14,Senate,"Constitutional reading dispensed (on 2nd reading) (36-Y 0-N)",36,0,0,4,40
1901323,1490995,2025-02-17,Senate,"Passed Senate with substitute (39-Y 0-N)",39,0,0,1,40
1901323,1492297,2025-02-18,House,"Senate substitute agreed to by House (96-Y 1-N)",96,1,0,3,100
1901323,1535384,2025-04-02,Senate,"Senate concurred in Governor's recommendation (40-Y 0-N)",40,0,0,0,40
1901323,1536610,2025-04-02,House,"House concurred in Governor's recommendation (96-Y 0-N)",96,0,0,4,100
1901327,1476712,2025-01-29,House,"Reported from Rules with amendment(s) (13-Y 0-N)",13,0,0,5,18
1901327,1479623,2025-02-03,House,"Agreed to by House (69-Y 27-N)",69,27,0,4,100
1901327,1491095,2025-02-17,Senate,"Reading waived (on 2nd reading) (39-Y 0-N)",39,0,0,1,40
1901331,1472005,2025-01-16,House,"Subcommittee recommends reporting (8-Y 0-N)",8,0,0,1,9
1901331,1472659,2025-01-21,House,"Reported from General Laws (21-Y 0-N)",21,0,0,1,22
1901331,1475143,2025-01-27,House,"Read third time and passed House (97-Y 0-N)",97,0,0,3,100
1901331,1482139,2025-02-05,Senate,"Reported from General Laws and Technology (13-Y 0-N)",13,0,0,2,15
1901331,1484008,2025-02-07,Senate,"Constitutional reading dispensed (on 2nd reading) (38-Y 0-N)",38,0,0,2,40
1901331,1484723,2025-02-10,Senate,"Passed Senate (39-Y 0-N)",39,0,0,1,40
1901334,1471775,2025-01-15,House,"Subcommittee recommends reporting and referred to Appropriations (5-Y 3-N)",5,3,0,1,9
1901334,1472329,2025-01-20,House,"Reported from Education with substitute and referred to Appropriations (16-Y 5-N)",16,5,0,1,22
1901334,1474503,2025-01-24,House,"Subcommittee recommends laying on the table (7-Y 1-N)",7,1,0,1,9
1901338,1473418,2025-01-22,House,"Subcommittee recommends reporting with substitute (7-Y 1-N)",7,1,0,1,9
1901338,1474676,2025-01-24,House,"Reported from Courts of Justice with substitute (20-Y 2-N)",20,2,0,0,22
1901338,1478456,2025-01-30,House,"Read third time and passed House (96-Y 0-N)",96,0,0,4,100
1901338,1484852,2025-02-10,Senate,"Reported from Courts of Justice with substitute and rereferred to Finance and Appropriations (14-Y 0-N)",14,0,0,1,15
1901338,1492418,2025-02-17,Senate,"Reported from Finance and Appropriations with substitute (14-Y 0-N)",14,0,0,1,15
1901338,1496045,2025-02-19,Senate,"Constitutional reading dispensed (on 2nd reading) (40-Y 0-N)",40,0,0,0,40
1901338,1496046,2025-02-20,House,"Senate substitute agreed to by House (96-Y 0-N)",96,0,0,4,100
1901338,1496674,2025-02-20,Senate,"Passed Senate with substitute (39-Y 0-N)",39,0,0,1,40
1901338,1496675,2025-02-20,Senate,"Reconsideration of Senate passage agreed to by Senate (39-Y 0-N)",39,0,0,1,40
1901338,1496676,2025-02-20,Senate,"Passed Senate with substitute (39-Y 0-N)",39,0,0,1,40
1901343,1471644,2025-01-14,House,"Reported from General Laws with amendment(s) (12-Y 10-N)",12,10,0,0,22
1901343,1480761,2025-02-05,Senate,"Reported from General Laws and Technology with amendment (13-Y 0-N)",13,0,0,2,15
1901343,1483932,2025-02-07,Senate,"Constitutional reading dispensed (on 2nd reading) (38-Y 0-N)",38,0,0,2,40
1901343,1484672,2025-02-10,Senate,"Passed Senate with amendment (23-Y 15-N)",23,15,0,2,40
1901343,1490455,2025-02-13,House,"Senate Amendment agreed to by House (Y-53 N-44 A-0)",53,44,0,3,100
1901343,1565136,2025-01-20,House,"Read third time and passed House (50-Y 47-N)",50,47,0,3,100
1901347,1474202,2025-01-24,House,"Reported from Public Safety (13-Y 9-N)",13,9,0,0,22
1901347,1478263,2025-01-30,House,"Read third time and passed House (51-Y 45-N)",51,45,0,4,100
1901347,1484748,2025-02-10,Senate,"Passed by indefinitely in Courts of Justice (14-Y 1-N)",14,1,0,0,15
1901353,1471678,2025-01-15,House,"Subcommittee recommends reporting (8-Y 0-N)",8,0,0,1,9
1901353,1472145,2025-01-17,House,"Reported from Counties, Cities and Towns (22-Y 0-N)",22,0,0,0,22
1901353,1473741,2025-01-23,House,"Read third time and passed House (97-Y 0-N)",97,0,0,3,100
1901353,1485096,2025-02-10,Senate,"Reported from Local Government (14-Y 0-N)",14,0,0,1,15
1901353,1486478,2025-02-11,Senate,"Constitutional reading dispensed (on 2nd reading) (40-Y 0-N)",40,0,0,0,40
1901353,1487772,2025-02-12,Senate,"Passed Senate (39-Y 0-N)",39,0,0,1,40
1901359,1471681,2025-01-15,House,"Subcommittee recommends reporting (6-Y 2-N)",6,2,0,1,9
1901359,1472153,2025-01-17,House,"Reported from Counties, Cities and Towns (12-Y 10-N)",12,10,0,0,22
1901359,1485057,2025-02-10,Senate,"Reported from Local Government (11-Y 1-N 2-A)",11,1,2,1,15
1901359,1486472,2025-02-11,Senate,"Constitutional reading dispensed (on 2nd reading) (40-Y 0-N)",40,0,0,0,40
1901359,1487787,2025-02-12,Senate,"Passed Senate (37-Y 2-N)",37,2,0,1,40
1901359,1564915,2025-01-24,House,"Read third time and passed House (91-Y 5-N)",91,5,0,4,100
1901363,1473265,2025-01-22,House,"Subcommittee recommends reporting with substitute (8-Y 0-N)",8,0,0,1,9
1901363,1474660,2025-01-24,House,"Reported from Courts of Justice with substitute (22-Y 0-N)",22,0,0,0,22
1901363,1478299,2025-01-30,House,"Read third time and passed House (96-Y 0-N)",96,0,0,4,100
1901363,1483119,2025-02-06,Senate,"Rereferred from Education and Health to Courts of Justice (14-Y 0-N)",14,0,0,1,15
1901363,1490847,2025-02-17,Senate,"Reported from Courts of Justice (15-Y 0-N)",15,0,0,0,15
1901363,1492088,2025-02-18,Senate,"Constitutional reading dispensed (on 2nd reading) (39-Y 0-N)",39,0,0,1,40
1901363,1495186,2025-02-19,Senate,"Passed Senate (40-Y 0-N)",40,0,0,0,40
1901366,1471458,2025-01-14,House,"Subcommittee recommends reporting with substitute (7-Y 0-N)",7,0,0,1,8
1901366,1471949,2025-01-16,House,"Reported from Labor and Commerce with substitute and referred to Appropriations (17-Y 5-N)",17,5,0,0,22
1901366,1474392,2025-01-24,House,"Subcommittee recommends reporting (7-Y 0-N)",7,0,0,2,9
1901366,1475035,2025-01-27,House,"Reported from Appropriations (20-Y 2-N)",20,2,0,0,22
1901366,1478609,2025-01-31,House,"Read third time and passed House (84-Y 11-N)",84,11,0,5,100
1901366,1483127,2025-02-06,Senate,"Rereferred from Education and Health to Commerce and Labor (14-Y 0-N)",14,0,0,1,15
1901366,1485341,2025-02-10,Senate,"Reported from Commerce and Labor and rereferred to Finance and Appropriations (10-Y 5-N)",10,5,0,0,15
1901366,1490139,2025-02-14,Senate,"Reported from Finance and Appropriations with amendment (10-Y 3-N)",10,3,0,2,15
1901366,1492054,2025-02-17,Senate,"Constitutional reading dispensed (on 2nd reading) (39-Y 0-N)",39,0,0,1,40
1901366,1492055,2025-02-18,Senate,"Passed Senate with amendment (23-Y 16-N)",23,16,0,1,40
1901366,1536488,2025-04-02,House,"House rejected Governor's recommendation (26-Y 67-N)",26,67,0,7,100
1901366,1536489,2025-04-02,House,"Passed in enrolled form (64-Y 31-N)",64,31,0,5,100
1901366,1564933,2025-02-19,House,"Senate Amendment agreed to by House (85-Y 9-N)",85,9,0,6,100
1901372,1471886,2025-01-16,House,"Subcommittee recommends reporting (8-Y 0-N)",8,0,0,1,9
1901372,1472673,2025-01-21,House,"Reported from Health and Human Services (21-Y 0-N)",21,0,0,1,22
1901372,1474736,2025-01-27,House,"Read third time and passed House (97-Y 0-N)",97,0,0,3,100
1901372,1489678,2025-02-13,Senate,"Reported from Education and Health (15-Y 0-N)",15,0,0,0,15
1901372,1491115,2025-02-17,Senate,"Constitutional reading dispensed (on 2nd reading)",39,0,0,1,40
1901372,1492358,2025-02-18,Senate,"Passed Senate (40-Y 0-N)",40,0,0,0,40
1901376,1472372,2025-01-20,House,"Subcommittee recommends reporting with substitute (6-Y 4-N)",6,4,0,1,11
1901376,1472957,2025-01-22,House,"Reported from Education with substitute (12-Y 10-N)",12,10,0,0,22
1901376,1478359,2025-01-30,House,"Read third time and passed House (51-Y 45-N)",51,45,0,4,100
1901376,1489747,2025-02-13,Senate,"Reported from Education and Health (9-Y 6-N)",9,6,0,0,15
1901376,1490931,2025-02-17,Senate,"Constitutional reading dispensed (on 1st reading) (39-Y 0-N)",39,0,0,1,40
1901376,1494415,2025-02-18,Senate,"Passed Senate (21-Y 19-N)",21,19,0,0,40
1901384,1471950,2025-01-16,House,"Subcommittee recommends reporting (8-Y 0-N)",8,0,0,1,9
1901384,1472750,2025-01-21,House,"Reported from General Laws (21-Y 0-N)",21,0,0,1,22
1901384,1475971,2025-01-27,House,"Read third time and passed House (97-Y 0-N)",97,0,0,3,100
1901384,1482197,2025-02-05,Senate,"Reported from General Laws and Technology and rereferred to Finance and Appropriations (15-Y 0-N)",15,0,0,0,15
1901384,1485977,2025-02-11,Senate,"Passed by indefinitely in Finance and Appropriations (15-Y 0-N)",15,0,0,0,15
1901389,1471988,2025-01-16,House,"Subcommittee recommends reporting with substitute and referred to Appropriations (8-Y 0-N)",8,0,0,1,9
1901389,1472549,2025-01-21,House,"Reported from Health and Human Services with substitute and referred to Appropriations (19-Y 2-N)",19,2,0,1,22
1901389,1474415,2025-01-24,House,"Subcommittee recommends reporting with amendment(s) (7-Y 0-N)",7,0,0,2,9
1901389,1475065,2025-01-27,House,"Reported from Appropriations with amendment(s) (22-Y 0-N)",22,0,0,0,22
1901389,1478604,2025-01-31,House,"Read third time and passed House (92-Y 2-N)",92,2,0,6,100
1901389,1483105,2025-02-06,Senate,"Rereferred from Education and Health to Rehabilitation and Social Services (14-Y 0-N)",14,0,0,1,15
1901389,1483878,2025-02-07,Senate,"Reported from Rehabilitation and Social Services and rereferred to Finance and Appropriations (15-Y 0-N)",15,0,0,0,15
1901389,1485857,2025-02-11,Senate,"Reported from Finance and Appropriations (14-Y 0-N)",14,0,0,1,15
1901389,1486322,2025-02-11,Senate,"Constitutional reading dispensed (on 2nd reading) (40-Y 0-N)",40,0,0,0,40
1901389,1489008,2025-02-12,Senate,"Passed Senate (39-Y 0-N)",39,0,0,1,40
1901392,1473662,2025-01-23,House,"Subcommittee recommends reporting (8-Y 0-N)",8,0,0,1,9
1901392,1476017,2025-01-28,House,"Reported from Health and Human Services (21-Y 0-N)",21,0,0,1,22
1901392,1478917,2025-02-03,House,"Read third time and passed House (98-Y 0-N)",98,0,0,2,100
1901392,1478918,2025-02-03,House,"Read third time and passed House (99-Y 0-N)",99,0,0,1,100
1901392,1489783,2025-02-13,Senate,"Reported from Education and Health (13-Y 0-N)",13,0,0,2,15
1901392,1491475,2025-02-17,Senate,"Constitutional reading dispensed (on 2nd reading)",39,0,0,1,40
1901392,1494296,2025-02-18,Senate,"Passed Senate (40-Y 0-N)",40,0,0,0,40
1901398,1471908,2025-01-16,House,"Subcommittee recommends reporting (5-Y 3-N)",5,3,0,1,9
1901398,1472545,2025-01-21,House,"Reported from Health and Human Services (13-Y 8-N)",13,8,0,1,22
1901398,1477369,2025-01-29,House,"Read third time and passed House (52-Y 45-N)",52,45,0,3,100
1901398,1483115,2025-02-06,Senate,"Reported from Education and Health (10-Y 3-N)",10,3,0,2,15
1901398,1483877,2025-02-07,Senate,"Constitutional reading dispensed (on 2nd reading) (38-Y 0-N)",38,0,0,2,40
1901398,1484600,2025-02-10,Senate,"Passed Senate (24-Y 14-N)",24,14,0,2,40
1901398,1536748,2025-04-02,House,"Passed by for the day (47-Y 46-N)",47,46,0,7,100
1901403,1471459,2025-01-14,House,"Reported from Labor and Commerce (12-Y 10-N)",12,10,0,0,22
1901403,1472009,2025-01-16,House,"Reported from Labor and Commerce and referred to Appropriations (12-Y 9-N)",12,9,0,1,22
1901403,1473209,2025-01-22,House,"Subcommittee recommends reporting (5-Y 3-N)",5,3,0,1,9
1901403,1474277,2025-01-24,House,"Reported from Appropriations (12-Y 10-N)",12,10,0,0,22
1901403,1485348,2025-02-10,Senate,"Reported from Commerce and Labor and rereferred to Finance and Appropriations (9-Y 6-N)",9,6,0,0,15
1901403,1490178,2025-02-14,Senate,"Reported from Finance and Appropriations (10-Y 4-N)",10,4,0,1,15
1901403,1490985,2025-02-17,Senate,"Constitutional reading dispensed (on 2nd reading) (39-Y 0-N)",39,0,0,1,40
1901403,1492282,2025-02-18,Senate,"Passed Senate (21-Y 19-N)",21,19,0,0,40
1901403,1564892,2025-01-30,House,"Read third time and passed House (50-Y 46-N)",50,46,0,4,100
1901421,1478009,2025-01-31,House,"Reported from Public Safety (12-Y 9-N)",12,9,0,1,22
1901421,1479613,2025-02-04,House,"Passed House (50-Y 48-N)",50,48,0,2,100
1901421,1482243,2025-02-04,House,"Read third time and passed House (52-Y 47-N)",52,47,0,1,100
1901421,1484626,2025-02-10,Senate,"Reported from Courts of Justice and rereferred to Finance and Appropriations (9-Y 6-N)",9,6,0,0,15
1901421,1487395,2025-02-12,Senate,"Reported from Finance and Appropriations (10-Y 5-N)",10,5,0,0,15
1901421,1489000,2025-02-13,Senate,"Constitutional reading dispensed (on 2nd reading) (40-Y 0-N)",40,0,0,0,40
1901421,1490264,2025-02-14,Senate,"Passed Senate (21-Y 15-N)",21,15,0,4,40
1901421,1536553,2025-04-02,House,"House sustained Governor's veto (50-Y 46-N)",50,46,0,4,100
1901426,1471460,2025-01-14,House,"Subcommittee recommends laying on the table (7-Y 0-N)",7,0,0,1,8
1901439,1473349,2025-01-22,House,"Subcommittee recommends reporting with amendment(s) (7-Y 1-N)",7,1,0,1,9
1901439,1474680,2025-01-24,House,"Reported from Courts of Justice with substitute (20-Y 2-N)",20,2,0,0,22
1901439,1478147,2025-01-30,House,"Read third time and passed House (88-Y 6-N)",88,6,0,6,100
1901439,1484630,2025-02-10,Senate,"Reported from Courts of Justice with substitute and rereferred to Finance and Appropriations (12-Y 1-N)",12,1,0,2,15
1901439,1492502,2025-02-17,Senate,"Reported from Finance and Appropriations (14-Y 0-N)",14,0,0,1,15
1901439,1493713,2025-02-19,Senate,"Constitutional reading dispensed (on 2nd reading) (40-Y 0-N)",40,0,0,0,40
1901439,1495397,2025-02-20,Senate,"Passed Senate with substitute (39-Y 0-N)",39,0,0,1,40
1901439,1496593,2025-02-20,House,"Senate substitute agreed to by House (87-Y 6-N)",87,6,0,7,100
1901439,1535534,2025-04-02,House,"VOTE: Pass by for the day - Adoption (47-Y 46-N)",47,46,0,7,100
1901448,1474666,2025-01-27,House,"Subcommittee recommends laying on the table (6-Y 4-N)",6,4,0,1,11
1901454,1472044,2025-01-16,House,"Subcommittee recommends striking from the docket (8-Y 0-N)",8,0,0,1,9
1901454,1472684,2025-01-21,House,"Stricken from docket by General Laws (21-Y 0-N)",21,0,0,1,22
1901456,1471462,2025-01-14,House,"Subcommittee recommends reporting and referred to Appropriations (7-Y 0-N)",7,0,0,1,8
1901456,1471967,2025-01-16,House,"Reported from Labor and Commerce and referred to Appropriations (22-Y 0-N)",22,0,0,0,22
1901456,1476816,2025-01-29,House,"Subcommittee recommends reporting (6-Y 0-N)",6,0,0,3,9
1901456,1478287,2025-01-31,House,"Reported from Appropriations (22-Y 0-N)",22,0,0,0,22
1901456,1482156,2025-02-04,House,"Read third time and passed House (97-Y 0-N)",97,0,0,3,100
1901456,1482157,2025-02-04,House,"Passed House (99-Y 0-N)",99,0,0,1,100
1901456,1485351,2025-02-10,Senate,"Reported from Commerce and Labor and rereferred to Finance and Appropriations (15-Y 0-N)",15,0,0,0,15
1901456,1490179,2025-02-14,Senate,"Reported from Finance and Appropriations (14-Y 0-N)",14,0,0,1,15
1901456,1490989,2025-02-17,Senate,"Constitutional reading dispensed (on 2nd reading) (39-Y 0-N)",39,0,0,1,40
1901456,1492284,2025-02-18,Senate,"Passed Senate (40-Y 0-N)",40,0,0,0,40
1901460,1477312,2025-01-30,House,"Subcommittee recommends reporting (8-Y 0-N)",8,0,0,1,9
1901460,1477313,2025-01-30,House,"Reported from Health and Human Services (21-Y 0-N)",21,0,0,1,22
1901460,1479552,2025-02-04,House,"Read third time and passed House (97-Y 0-N)",97,0,0,3,100
1901460,1479553,2025-02-04,House,"Passed House (99-Y 0-N)",99,0,0,1,100
1901460,1489580,2025-02-13,Senate,"Reported from Education and Health (13-Y 0-N)",13,0,0,2,15
1901460,1491507,2025-02-17,Senate,"Constitutional reading dispensed (on 2nd reading)",39,0,0,1,40
1901460,1492720,2025-02-18,Senate,"Passed Senate (40-Y 0-N)",40,0,0,0,40
1901464,1477007,2025-01-29,House,"Reported from Rules (14-Y 0-N)",14,0,0,4,18
1901464,1478850,2025-02-03,House,"Agreed to by House (96-Y 0-N)",96,0,0,4,100
1901464,1491474,2025-02-17,Senate,"Reading waived (on 2nd reading) (39-Y 0-N)",39,0,0,1,40
1901467,1472056,2025-01-16,House,"Subcommittee recommends reporting with amendment(s) and referred to Appropriations (8-Y 0-N)",8,0,0,1,9
1901467,1472605,2025-01-21,House,"Reported from Health and Human Services with amendment(s) (21-Y 0-N)",21,0,0,1,22
1901467,1475484,2025-01-27,House,"Amendment by Delegate Garrett passed by (49-Y 46-N)",49,46,0,5,100
1901467,1477446,2025-01-28,House,"Read third time and passed House (89-Y 9-N)",89,9,0,2,100
1901467,1483122,2025-02-06,Senate,"Reported from Education and Health and rereferred to Finance and Appropriations (14-Y 0-N)",14,0,0,1,15
1901467,1487404,2025-02-12,Senate,"Reported from Finance and Appropriations (15-Y 0-N)",15,0,0,0,15
1901467,1489003,2025-02-13,Senate,"Constitutional reading dispensed (on 2nd reading) (40-Y 0-N)",40,0,0,0,40
1901467,1490261,2025-02-14,Senate,"Passed Senate with substitute (36-Y 0-N)",36,0,0,4,40
1901467,1493090,2025-02-18,House,"Senate substitute agreed to by House (89-Y 7-N)",89,7,0,4,100
1901467,1536827,2025-04-02,House,"Passed by for the day (47-Y 46-N)",47,46,0,7,100
1901474,1477447,2025-01-30,House,"Subcommittee recommends reporting with substitute (8-Y 0-N)",8,0,0,1,9
1901474,1477720,2025-01-30,House,"Reported from General Laws with substitute (21-Y 0-N)",21,0,0,1,22
1901474,1479885,2025-02-04,House,"Read third time and passed House (97-Y 0-N)",97,0,0,3,100
1901474,1479886,2025-02-04,House,"Passed House (99-Y 0-N)",99,0,0,1,100
1901474,1488167,2025-02-12,Senate,"Reported from General Laws and Technology (12-Y 0-N)",12,0,0,3,15
1901474,1490723,2025-02-14,Senate,"Constitutional reading dispensed (on 2nd reading) (36-Y 0-N)",36,0,0,4,40
1901474,1491249,2025-02-17,Senate,"Passed Senate (39-Y 0-N)",39,0,0,1,40
1901477,1472016,2025-01-16,House,"Subcommittee recommends reporting (8-Y 0-N)",8,0,0,1,9
1901477,1472746,2025-01-21,House,"Reported from General Laws (21-Y 0-N)",21,0,0,1,22
1901477,1474998,2025-01-27,House,"Read third time and passed House (92-Y 3-N)",92,3,0,5,100
1901477,1482140,2025-02-05,Senate,"Reported from General Laws and Technology and rereferred to Finance and Appropriations (13-Y 0-N)",13,0,0,2,15
1901477,1486100,2025-02-11,Senate,"Reported from Finance and Appropriations (15-Y 0-N)",15,0,0,0,15
1901477,1486101,2025-02-11,Senate,"Constitutional reading dispensed (on 2nd reading) (40-Y 0-N)",40,0,0,0,40
1901477,1488895,2025-02-12,Senate,"Passed Senate (39-Y 0-N)",39,0,0,1,40
1901480,1471640,2025-01-14,House,"Subcommittee recommends reporting (7-Y 0-N)",7,0,0,1,8
1901480,1472038,2025-01-16,House,"Reported from Labor and Commerce (22-Y 0-N)",22,0,0,0,22
1901480,1473083,2025-01-22,House,"Read third time and passed House (96-Y 0-N)",96,0,0,4,100
1901480,1473084,2025-01-22,House,"Passed House (97-Y 0-N)",97,0,0,3,100
1901480,1485101,2025-02-10,Senate,"Reported from Commerce and Labor (15-Y 0-N)",15,0,0,0,15
1901480,1487777,2025-02-12,Senate,"Constitutional reading dispensed (on 2nd reading) (39-Y 0-N)",39,0,0,1,40
1901480,1488972,2025-02-13,Senate,"Passed Senate (40-Y 0-N)",40,0,0,0,40
1901483,1471463,2025-01-13,House,"Subcommittee recommends laying on the table (5-Y 3-N)",5,3,0,1,9
1901486,1474046,2025-01-23,House,"Subcommittee recommends reporting with substitute and referring to Appropriations (7-Y 3-N)",7,3,0,1,11
1901486,1475829,2025-01-28,House,"Reported from Labor and Commerce with substitute and referred to Appropriations (14-Y 8-N)",14,8,0,0,22
1901486,1476402,2025-01-29,House,"Subcommittee recommends reporting (7-Y 1-N)",7,1,0,1,9
1901486,1476810,2025-01-29,House,"Reported from Appropriations (14-Y 7-N)",14,7,0,1,22
1901486,1480581,2025-02-04,House,"Read third time and passed House (57-Y 41-N)",57,41,0,2,100
1901486,1485416,2025-02-10,Senate,"Reported from Commerce and Labor and rereferred to Finance and Appropriations (11-Y 4-N)",11,4,0,0,15
1901486,1492176,2025-02-17,Senate,"Reported from Finance and Appropriations (10-Y 4-N)",10,4,0,1,15
1901486,1493647,2025-02-19,Senate,"Constitutional reading dispensed (on 2nd reading) (40-Y 0-N)",40,0,0,0,40
1901486,1496330,2025-02-20,Senate,"Passed Senate (20-Y 19-N)",20,19,0,1,40
1901491,1472049,2025-01-16,House,"Subcommittee recommends reporting with amendment(s) (8-Y 0-N)",8,0,0,1,9
1901491,1472642,2025-01-21,House,"Reported from General Laws with amendment(s) (21-Y 0-N)",21,0,0,1,22
1901491,1475111,2025-01-27,House,"Read third time and passed House (72-Y 21-N)",72,21,0,7,100
1901491,1480784,2025-02-05,Senate,"Reported from General Laws and Technology (13-Y 0-N)",13,0,0,2,15
1901491,1483933,2025-02-07,Senate,"Constitutional reading dispensed (on 2nd reading) (38-Y 0-N)",38,0,0,2,40
1901491,1484686,2025-02-10,Senate,"Passed Senate (39-Y 0-N)",39,0,0,1,40
1901494,1477711,2025-01-30,House,"Subcommittee recommends reporting with amendment(s) (6-Y 2-N)",6,2,0,1,9
1901494,1477712,2025-01-30,House,"Reported from General Laws with amendment(s) (12-Y 9-N)",12,9,0,1,22
1901494,1480849,2025-02-04,House,"Read third time and passed House (55-Y 44-N)",55,44,0,1,100
1901494,1488109,2025-02-12,Senate,"Reported from General Laws and Technology and rereferred to Finance and Appropriations (15-Y 0-N)",15,0,0,0,15
1901494,1492075,2025-02-17,Senate,"Reported from Finance and Appropriations with substitute (14-Y 0-N)",14,0,0,1,15
1901494,1495825,2025-02-19,Senate,"Constitutional reading dispensed (on 2nd reading) (40-Y 0-N)",40,0,0,0,40
1901494,1495826,2025-02-20,House,"Senate substitute rejected by House (0-Y 96-N)",0,96,0,4,100
1901494,1495827,2025-02-20,Senate,"Senate insisted on substitute (38-Y 0-N)",38,0,0,2,40
1901494,1496263,2025-02-20,Senate,"Passed Senate with substitute (39-Y 0-N)",39,0,0,1,40
1901494,1496264,2025-02-20,Senate,"Reconsideration of Senate passage agreed to by Senate (39-Y 0-N)",39,0,0,1,40
1901494,1496265,2025-02-20,Senate,"Passed Senate with substitute (39-Y 0-N)",39,0,0,1,40
1901494,1496739,2025-02-21,Senate,"Conference report agreed to by Senate (21-Y 19-N)",21,19,0,0,40
1901494,1497134,2025-02-22,House,"Conference report agreed to by House (59-Y 39-N)",59,39,0,2,100
1901979,1473172,2025-01-22,House,"Subcommittee recommends striking from the docket (8-Y 0-N)",8,0,0,1,9
1901980,1473499,2025-01-23,House,"Subcommittee recommends reporting with substitute (8-Y 0-N)",8,0,0,1,9
1901980,1474250,2025-01-24,House,"Reported from Counties, Cities and Towns with substitute (16-Y 4-N)",16,4,0,2,22
1901981,1471466,2025-01-14,House,"Subcommittee recommends reporting (8-Y 0-N)",8,0,0,1,9
1901981,1471764,2025-01-15,House,"Reported from Education (14-Y 7-N)",14,7,0,1,22
1901981,1483112,2025-02-06,Senate,"Reported from Education and Health (9-Y 5-N)",9,5,0,1,15
1901981,1483884,2025-02-07,Senate,"Constitutional reading dispensed (on 2nd reading) (38-Y 0-N)",38,0,0,2,40
1901981,1484589,2025-02-10,Senate,"Passed Senate (21-Y 18-N)",21,18,0,1,40
1901981,1565118,2025-01-21,House,"Read third time and passed House (55-Y 41-N)",55,41,0,4,100
1901982,1476436,2025-01-29,House,"Subcommittee recommends reporting (7-Y 0-N 1-A)",7,0,1,1,9
1901982,1478073,2025-01-31,House,"Reported from Counties, Cities and Towns (22-Y 0-N)",22,0,0,0,22
1901982,1480693,2025-02-04,House,"Read third time and passed House (97-Y 0-N)",97,0,0,3,100
1901982,1480694,2025-02-04,House,"Passed House (99-Y 0-N)",99,0,0,1,100
1901982,1484669,2025-02-10,Senate,"Reported from Local Government (15-Y 0-N)",15,0,0,0,15
1901982,1486089,2025-02-11,Senate,"Constitutional reading dispensed (on 2nd reading) (40-Y 0-N)",40,0,0,0,40
1901982,1488902,2025-02-12,Senate,"Passed Senate (39-Y 0-N)",39,0,0,1,40
1901983,1472043,2025-01-16,House,"Subcommittee recommends reporting with amendment(s) (8-Y 0-N)",8,0,0,1,9
1901983,1472831,2025-01-21,House,"Reported from Labor and Commerce with amendment(s) (22-Y 0-N)",22,0,0,0,22
1901983,1474941,2025-01-27,House,"Read third time and passed House (97-Y 0-N)",97,0,0,3,100
1901983,1482424,2025-02-05,Senate,"Reported from General Laws and Technology with substitute (14-Y 0-N)",14,0,0,1,15
1901983,1484242,2025-02-07,Senate,"Constitutional reading dispensed (on 2nd reading) (38-Y 0-N)",38,0,0,2,40
1901983,1484959,2025-02-10,Senate,"Passed Senate with substitute (39-Y 0-N)",39,0,0,1,40
1901983,1489797,2025-02-12,House,"Senate substitute agreed to by House (95-Y 0-N)",95,0,0,5,100
1901984,1476442,2025-01-29,House,"Subcommittee recommends reporting (8-Y 0-N)",8,0,0,1,9
1901984,1478034,2025-01-31,House,"Reported from Counties, Cities and Towns (21-Y 1-N)",21,1,0,0,22
1901984,1482236,2025-02-04,House,"Read third time and passed House (98-Y 0-N)",98,0,0,2,100
1901984,1484702,2025-02-10,Senate,"Reported from Local Government (15-Y 0-N)",15,0,0,0,15
1901984,1486149,2025-02-11,Senate,"Constitutional reading dispensed (on 2nd reading) (40-Y 0-N)",40,0,0,0,40
1901984,1489851,2025-02-12,Senate,"Passed Senate (39-Y 0-N)",39,0,0,1,40
1901985,1471464,2025-01-14,House,"Subcommittee recommends reporting (5-Y 3-N)",5,3,0,1,9
1901985,1471719,2025-01-15,House,"Reported from Education (11-Y 10-N)",11,10,0,1,22
1901986,1471465,2025-01-14,House,"Subcommittee recommends laying on the table (7-Y 0-N)",7,0,0,1,8
1901987,1475077,2025-01-27,House,"Subcommittee recommends reporting with substitute and referring to Appropriations (6-Y 2-N)",6,2,0,1,9
1901987,1478063,2025-01-31,House,"Reported from Privileges and Elections with substitute and referred to Appropriations (13-Y 8-N)",13,8,0,1,22
1901987,1478270,2025-01-31,House,"Reported from Appropriations (13-Y 9-N)",13,9,0,0,22
1901987,1482179,2025-02-04,House,"Read third time and passed House (53-Y 45-N)",53,45,0,2,100
1901987,1486509,2025-02-11,Senate,"Reported from Privileges and Elections and rereferred to Finance and Appropriations (8-Y 7-N)",8,7,0,0,15
1901987,1490123,2025-02-14,Senate,"Reported from Finance and Appropriations (8-Y 4-N)",8,4,0,3,15
1901987,1492027,2025-02-17,Senate,"Constitutional reading dispensed (on 2nd reading) (39-Y 0-N)",39,0,0,1,40
1901987,1492028,2025-02-18,Senate,"Passed Senate (21-Y 19-N)",21,19,0,0,40
1901987,1536400,2025-04-02,House,"House sustained Governor's veto (50-Y 46-N)",50,46,0,4,100
1901988,1476971,2025-01-29,House,"Tabled in Rules (14-Y 0-N)",14,0,0,4,18
1901989,1471710,2025-01-15,House,"Subcommittee recommends reporting with substitute (7-Y 1-N)",7,1,0,1,9
1901989,1472223,2025-01-17,House,"Reported from Courts of Justice with substitute and referred to Appropriations (14-Y 8-N)",14,8,0,0,22
1901989,1472505,2025-01-20,House,"Subcommittee recommends reporting with amendment(s) (7-Y 1-N)",7,1,0,1,9
1901989,1473370,2025-01-22,House,"Reported from Appropriations with amendment(s) (20-Y 2-N)",20,2,0,0,22
1901989,1476857,2025-01-28,House,"Read third time and passed House (63-Y 36-N)",63,36,0,1,100
1901989,1485328,2025-02-10,Senate,"Reported from Courts of Justice and rereferred to Finance and Appropriations (8-Y 7-N)",8,7,0,0,15
1901989,1488154,2025-02-12,Senate,"Reported from Finance and Appropriations with substitute (13-Y 0-N 2-A)",13,0,2,0,15
1901989,1489223,2025-02-13,Senate,"Constitutional reading dispensed (on 2nd reading) (40-Y 0-N)",40,0,0,0,40
1901989,1490297,2025-02-14,Senate,"Passed Senate with substitute (32-Y 2-N)",32,2,0,6,40
1901989,1491972,2025-02-18,House,"Senate substitute agreed to by House (64-Y 33-N)",64,33,0,3,100
1901990,1471606,2025-01-14,House,"Subcommittee recommends reporting and referred to Appropriations (8-Y 0-N)",8,0,0,1,9
1901990,1471672,2025-01-15,House,"Reported from Education and referred to Appropriations (16-Y 5-N)",16,5,0,1,22
1901990,1472452,2025-01-20,House,"Subcommittee recommends reporting (8-Y 0-N)",8,0,0,1,9
1901990,1473169,2025-01-22,House,"Reported from Appropriations (22-Y 0-N)",22,0,0,0,22
1901990,1476545,2025-01-28,House,"Read third time and passed House (83-Y 16-N)",83,16,0,1,100
1901990,1489147,2025-02-13,Senate,"Reported from Education and Health with substitute (9-Y 6-N)",9,6,0,0,15
1901990,1491103,2025-02-17,Senate,"Constitutional reading dispensed (on 1st reading) (39-Y 0-N)",39,0,0,1,40
1901990,1492382,2025-02-18,Senate,"Passed Senate with substitute (23-Y 17-N)",23,17,0,0,40
1901990,1495344,2025-02-19,House,"Senate substitute agreed to by House (79-Y 17-N)",79,17,0,4,100
1901991,1471792,2025-01-15,House,"Subcommittee recommends reporting (8-Y 0-N)",8,0,0,1,9
1901991,1472159,2025-01-17,House,"Reported from Appropriations (21-Y 0-N)",21,0,0,1,22
1901991,1473798,2025-01-23,House,"Read third time and passed House (90-Y 7-N)",90,7,0,3,100
1901991,1480474,2025-02-05,Senate,"Passed by indefinitely in Finance and Appropriations (9-Y 4-N)",9,4,0,2,15
1901993,1473276,2025-01-22,House,"Subcommittee recommends striking from the docket (8-Y 0-N)",8,0,0,1,9
1901994,1471635,2025-01-14,House,"Subcommittee recommends reporting with substitute (7-Y 1-N)",7,1,0,1,9
1901994,1471769,2025-01-15,House,"Reported from Education with substitute (14-Y 7-N)",14,7,0,1,22
1901994,1472838,2025-01-21,House,"Read third time and passed House (88-Y 8-N)",88,8,0,4,100
1901994,1489506,2025-02-13,Senate,"Reported from Education and Health (15-Y 0-N)",15,0,0,0,15
1901994,1491019,2025-02-17,Senate,"Constitutional reading dispensed (on 2nd reading)",39,0,0,1,40
1901994,1492288,2025-02-18,Senate,"Passed Senate (40-Y 0-N)",40,0,0,0,40
1901995,1472010,2025-01-16,House,"Subcommittee recommends reporting (5-Y 3-N)",5,3,0,1,9
1901995,1472690,2025-01-21,House,"Reported from Health and Human Services (12-Y 9-N)",12,9,0,1,22
1901995,1476561,2025-01-29,House,"Read third time and passed House (53-Y 44-N)",53,44,0,3,100
1901995,1489774,2025-02-13,Senate,"Reported from Education and Health (10-Y 4-N)",10,4,0,1,15
1901995,1491193,2025-02-17,Senate,"Constitutional reading dispensed (on 2nd reading) (39-Y 0-N)",39,0,0,1,40
1901995,1493275,2025-02-18,Senate,"Passed Senate (23-Y 16-N)",23,16,0,1,40
1901995,1535580,2025-04-02,House,"VOTE: Pass by for the day - Adoption (47-Y 46-N)",47,46,0,7,100
1901996,1476896,2025-01-29,House,"Subcommittee recommends reporting with amendment(s) (5-Y 3-N)",5,3,0,1,9
1901997,1477726,2025-01-30,House,"Subcommittee recommends laying on the table (5-Y 0-N)",5,0,0,1,6
1901998,1471930,2025-01-16,House,"Subcommittee recommends reporting (8-Y 0-N)",8,0,0,1,9
1901998,1472154,2025-01-17,House,"Reported from Counties, Cities and Towns (22-Y 0-N)",22,0,0,0,22
1901998,1473483,2025-01-23,House,"Read third time and passed House (91-Y 5-N)",91,5,0,4,100
1901998,1484560,2025-02-10,Senate,"Reported from Local Government (15-Y 0-N)",15,0,0,0,15
1901998,1486136,2025-02-11,Senate,"Constitutional reading dispensed (on 2nd reading) (40-Y 0-N)",40,0,0,0,40
1901998,1488838,2025-02-12,Senate,"Passed Senate (39-Y 0-N)",39,0,0,1,40
1901999,1471573,2025-01-14,House,"Subcommittee recommends laying on the table (8-Y 0-N)",8,0,0,1,9
1902001,1471837,2025-01-15,House,"Subcommittee recommends reporting (7-Y 1-N)",7,1,0,1,9
1902001,1472245,2025-01-17,House,"Reported from Courts of Justice (21-Y 1-N)",21,1,0,0,22
1902001,1484606,2025-02-10,Senate,"Reported from Courts of Justice and rereferred to Finance and Appropriations (9-Y 6-N)",9,6,0,0,15
1902001,1488171,2025-02-12,Senate,"Reported from Finance and Appropriations (10-Y 5-N)",10,5,0,0,15
1902001,1489577,2025-02-13,Senate,"Constitutional reading dispensed (on 2nd reading) (40-Y 0-N)",40,0,0,0,40
1902001,1490536,2025-02-14,Senate,"Passed Senate (26-Y 10-N)",26,10,0,4,40
1902001,1535572,2025-04-02,House,"House concurred in Governor's recommendation (96-Y 0-N)",96,0,0,4,100
1902001,1535573,2025-04-02,Senate,"Senate concurred in Governor's recommendation (40-Y 0-N)",40,0,0,0,40
1902001,1564890,2025-01-24,House,"Read third time and passed House (88-Y 7-N)",88,7,0,5,100
1902006,1476775,2025-01-29,House,"Subcommittee recommends reporting (5-Y 3-N)",5,3,0,1,9
1902006,1476776,2025-01-29,House,"Reported from Appropriations (13-Y 8-N)",13,8,0,1,22
1902006,1480557,2025-02-04,House,"Read third time and passed House (54-Y 45-N)",54,45,0,1,100
1902006,1484786,2025-02-10,Senate,"Reported from Courts of Justice and rereferred to Finance and Appropriations (9-Y 6-N)",9,6,0,0,15
1902006,1487356,2025-02-12,Senate,"Reported from Finance and Appropriations with substitute (10-Y 5-N)",10,5,0,0,15
1902006,1488859,2025-02-13,Senate,"Constitutional reading dispensed (on 2nd reading) (40-Y 0-N)",40,0,0,0,40
1902006,1490192,2025-02-14,Senate,"Passed Senate with substitute (20-Y 15-N)",20,15,0,5,40
1902006,1492264,2025-02-18,House,"Senate substitute agreed to by House (52-Y 43-N)",52,43,0,5,100
1902008,1472984,2025-01-22,House,"Subcommittee recommends reporting with amendment(s) (8-Y 0-N)",8,0,0,1,9
1902008,1476175,2025-01-29,House,"Reported from Education with amendment(s) (21-Y 1-N)",21,1,0,0,22
1902008,1482318,2025-02-04,House,"Read third time and passed House (98-Y 0-N)",98,0,0,2,100
1902008,1489867,2025-02-13,Senate,"Reported from Education and Health (14-Y 0-N)",14,0,0,1,15
1902008,1491528,2025-02-17,Senate,"Constitutional reading dispensed (on 2nd reading)",39,0,0,1,40
1902008,1492742,2025-02-18,Senate,"Passed Senate (40-Y 0-N)",40,0,0,0,40
1902010,1471575,2025-01-14,House,"Subcommittee recommends reporting (8-Y 0-N)",8,0,0,1,9
1902010,1472320,2025-01-20,House,"Reported from Finance (22-Y 0-N)",22,0,0,0,22
1902010,1474427,2025-01-24,House,"Read third time and passed House (97-Y 0-N)",97,0,0,3,100
1902010,1485553,2025-02-10,Senate,"Reported from Commerce and Labor with substitute and rereferred to Finance and Appropriations (15-Y 0-N)",15,0,0,0,15
1902010,1486789,2025-02-11,Senate,"Reported from Finance and Appropriations (13-Y 0-N)",13,0,0,2,15
1902010,1486790,2025-02-11,Senate,"Constitutional reading dispensed (on 2nd reading) (40-Y 0-N)",40,0,0,0,40
1902010,1487761,2025-02-12,Senate,"Passed Senate with substitute (39-Y 0-N)",39,0,0,1,40
1902010,1487762,2025-02-12,House,"Senate substitute agreed to by House (Y-88 N-1 A-0)",88,1,0,11,100
1902012,1473464,2025-01-23,House,"Subcommittee recommends reporting and referring to Appropriations (6-Y 2-N)",6,2,0,1,9
1902012,1475596,2025-01-28,House,"Reported from Health and Human Services and referred to Appropriations (16-Y 6-N)",16,6,0,0,22
1902012,1476626,2025-01-29,House,"Subcommittee recommends reporting with substitute (6-Y 0-N)",6,0,0,3,9
1902012,1478272,2025-01-31,House,"Reported from Appropriations with substitute (22-Y 0-N)",22,0,0,0,22
1902012,1482145,2025-02-04,House,"Read third time and passed House (72-Y 24-N)",72,24,0,4,100
1902012,1489684,2025-02-13,Senate,"Reported from Education and Health and rereferred to Finance and Appropriations (15-Y 0-N)",15,0,0,0,15
1902012,1492151,2025-02-17,Senate,"Reported from Finance and Appropriations with amendment (14-Y 0-N)",14,0,0,1,15
1902012,1495892,2025-02-19,Senate,"Constitutional reading dispensed (on 2nd reading) (40-Y 0-N)",40,0,0,0,40
1902012,1496321,2025-02-20,Senate,"Passed Senate with amendment (39-Y 0-N)",39,0,0,1,40
1902012,1496322,2025-02-20,Senate,"Reconsideration of Senate passage agreed to by Senate (39-Y 0-N)",39,0,0,1,40
1902012,1496323,2025-02-20,Senate,"Passed Senate with amendment (39-Y 0-N)",39,0,0,1,40
1902012,1496784,2025-02-20,House,"Senate Amendment agreed to by House (64-Y 31-N)",64,31,0,5,100
1902013,1474870,2025-01-27,House,"Subcommittee recommends reporting with substitute and referring to Appropriations (8-Y 0-N)",8,0,0,0,8
1902013,1476898,2025-01-29,House,"Reported from Finance with substitute and referred to Appropriations (22-Y 0-N)",22,0,0,0,22
1902015,1472397,2025-01-20,House,"Subcommittee recommends reporting (6-Y 2-N)",6,2,0,1,9
1902015,1474656,2025-01-24,House,"Reported from Courts of Justice (13-Y 9-N)",13,9,0,0,22
1902015,1488494,2025-02-12,Senate,"Reported from Courts of Justice (12-Y 2-N 1-A)",12,2,1,0,15
1902015,1490198,2025-02-14,Senate,"Constitutional reading dispensed (on 2nd reading) (36-Y 0-N)",36,0,0,4,40
1902015,1495266,2025-02-19,Senate,"Passed Senate (38-Y 2-N)",38,2,0,0,40
1902015,1564917,2025-01-31,House,"Read third time and passed House (66-Y 30-N)",66,30,0,4,100
1902017,1471999,2025-01-16,House,"Subcommittee recommends reporting and referred to Appropriations (8-Y 0-N)",8,0,0,1,9
1902017,1472689,2025-01-21,House,"Reported from Health and Human Services and referred to Appropriations (20-Y 2-N)",20,2,0,0,22
1902017,1474306,2025-01-24,House,"Subcommittee recommends laying on the table (7-Y 0-N)",7,0,0,2,9
1902017,1478490,2025-01-31,House,"Reported from Appropriations with substitute (22-Y 0-N)",22,0,0,0,22
1902017,1482297,2025-02-04,House,"Read third time and passed House (80-Y 16-N)",80,16,0,4,100
1902017,1483857,2025-02-07,Senate,"Reported from Rehabilitation and Social Services (15-Y 0-N)",15,0,0,0,15
1902017,1485486,2025-02-10,Senate,"Constitutional reading dispensed (on 2nd reading) (39-Y 0-N)",39,0,0,1,40
1902017,1487764,2025-02-12,Senate,"Passed Senate (39-Y 0-N)",39,0,0,1,40
1902017,1535461,2025-04-02,House,"House rejected Governor's recommendation (31-Y 63-N)",31,63,0,6,100
1902019,1472888,2025-01-21,House,"Subcommittee recommends laying on the table (6-Y 2-N)",6,2,0,1,9
1902020,1472698,2025-01-21,House,"Subcommittee recommends striking from the docket (8-Y 0-N)",8,0,0,1,9
1902021,1475305,2025-01-28,House,"Subcommittee recommends reporting with substitute (8-Y 0-N)",8,0,0,1,9
1902021,1476253,2025-01-29,House,"Reported from Education with substitute (22-Y 0-N)",22,0,0,0,22
1902021,1482550,2025-02-04,House,"Read third time and passed House (97-Y 0-N)",97,0,0,3,100
1902021,1482551,2025-02-04,House,"Passed House (99-Y 0-N)",99,0,0,1,100
1902021,1489306,2025-02-13,Senate,"Reported from Education and Health (15-Y 0-N)",15,0,0,0,15
1902021,1491576,2025-02-17,Senate,"Constitutional reading dispensed (on 2nd reading)",39,0,0,1,40
1902021,1493039,2025-02-18,Senate,"Passed Senate (40-Y 0-N)",40,0,0,0,40
1902023,1471607,2025-01-14,House,"Subcommittee recommends reporting with substitute and referred to Appropriations (6-Y 2-N)",6,2,0,1,9
1902023,1471784,2025-01-15,House,"Reported from Education with substitute and referred to Appropriations (13-Y 8-N)",13,8,0,1,22
1902023,1472456,2025-01-20,House,"Subcommittee recommends reporting with amendment(s) (8-Y 0-N)",8,0,0,1,9
1902023,1473174,2025-01-22,House,"Reported from Appropriations with amendment(s) (22-Y 0-N)",22,0,0,0,22
1902023,1476508,2025-01-28,House,"Read third time and passed House (77-Y 22-N)",77,22,0,1,100
1902023,1483021,2025-02-05,Senate,"Reported from Courts of Justice with substitute and rereferred to Education and Health (14-Y 0-N)",14,0,0,1,15
1902023,1489662,2025-02-13,Senate,"Reported from Education and Health with substitute and rereferred to Finance and Appropriations (14-Y 0-N 1-A)",14,0,1,0,15
1902023,1492162,2025-02-17,Senate,"Reported from Finance and Appropriations (14-Y 0-N)",14,0,0,1,15
1902023,1495231,2025-02-20,Senate,"Passed Senate with substitute (39-Y 0-N)",39,0,0,1,40
1902023,1495873,2025-02-19,Senate,"Constitutional reading dispensed (on 2nd reading) (40-Y 0-N)",40,0,0,0,40
1902023,1496774,2025-02-20,House,"Senate substitute agreed to by House (77-Y 19-N)",77,19,0,4,100
1902024,1472000,2025-01-16,House,"Subcommittee recommends reporting and referred to Appropriations (8-Y 0-N)",8,0,0,1,9
1902024,1472630,2025-01-21,House,"Reported from Health and Human Services and referred to Appropriations (22-Y 0-N)",22,0,0,0,22
1902024,1474508,2025-01-24,House,"Subcommittee recommends reporting (7-Y 0-N)",7,0,0,2,9
1902024,1475049,2025-01-27,House,"Reported from Appropriations (22-Y 0-N)",22,0,0,0,22
1902024,1478182,2025-01-31,House,"Read third time and passed House (96-Y 0-N)",96,0,0,4,100
1902024,1489719,2025-02-13,Senate,"Reported from Education and Health and rereferred to Finance and Appropriations (15-Y 0-N)",15,0,0,0,15
1902024,1492124,2025-02-17,Senate,"Reported from Finance and Appropriations (14-Y 0-N)",14,0,0,1,15
1902024,1495858,2025-02-19,Senate,"Constitutional reading dispensed (on 2nd reading) (40-Y 0-N)",40,0,0,0,40
1902024,1496283,2025-02-20,Senate,"Passed Senate (39-Y 0-N)",39,0,0,1,40
1902024,1496284,2025-02-20,Senate,"Reconsideration of Senate passage agreed to by Senate (39-Y 0-N)",39,0,0,1,40
1902024,1496285,2025-02-20,Senate,"Passed Senate (39-Y 0-N)",39,0,0,1,40
1902026,1478332,2025-01-31,House,"Subcommittee recommends laying on the table (5-Y 3-N)",5,3,0,1,9
1902029,1474200,2025-01-24,House,"Reported from Public Safety with amendment(s) and referred to Appropriations (22-Y 0-N)",22,0,0,0,22
1902029,1476410,2025-01-29,House,"Subcommittee recommends reporting with amendment(s) (8-Y 0-N)",8,0,0,1,9
1902029,1477002,2025-01-29,House,"Reported from Appropriations with amendment(s) (21-Y 0-N)",21,0,0,1,22
1902029,1479548,2025-02-04,House,"Read third time and passed House (97-Y 0-N)",97,0,0,3,100
1902029,1479549,2025-02-04,House,"Passed House (99-Y 0-N)",99,0,0,1,100
1902029,1488548,2025-02-12,Senate,"Reported from General Laws and Technology with amendments and rereferred to Finance and Appropriations (15-Y 0-N)",15,0,0,0,15
1902029,1492215,2025-02-17,Senate,"Passed by indefinitely in Finance and Appropriations (10-Y 3-N 1-A)",10,3,1,1,15
1902031,1477229,2025-01-30,House,"Reported from Transportation with substitute (22-Y 0-N)",22,0,0,0,22
1902031,1480596,2025-02-04,House,"Read third time and passed House (97-Y 0-N)",97,0,0,3,100
1902031,1480597,2025-02-04,House,"Passed House (99-Y 0-N)",99,0,0,1,100
1902031,1489695,2025-02-13,Senate,"Reported from Transportation (14-Y 0-N)",14,0,0,1,15
1902031,1491164,2025-02-17,Senate,"Constitutional reading dispensed (on 2nd reading)",39,0,0,1,40
1902031,1493122,2025-02-18,Senate,"Passed Senate (40-Y 0-N)",40,0,0,0,40
1902033,1474177,2025-01-24,House,"Subcommittee recommends striking from the docket (8-Y 0-N)",8,0,0,1,9
1902034,1475016,2025-01-27,House,"Subcommittee recommends reporting with amendment(s) (8-Y 0-N)",8,0,0,1,9
1902034,1478016,2025-01-31,House,"Reported from Privileges and Elections with amendment(s) (21-Y 0-N)",21,0,0,1,22
1902034,1486396,2025-02-11,Senate,"Reported from Privileges and Elections (12-Y 3-N)",12,3,0,0,15
1902034,1488993,2025-02-13,Senate,"Constitutional reading dispensed (on 2nd reading) (40-Y 0-N)",40,0,0,0,40
1902034,1490277,2025-02-14,Senate,"Passed Senate (21-Y 15-N)",21,15,0,4,40
1902034,1565038,2025-02-04,House,"Read third time and passed House (78-Y 20-N)",78,20,0,2,100
1902036,1474541,2025-01-24,House,"Subcommittee recommends reporting with substitute and referring to Appropriations (7-Y 1-N)",7,1,0,1,9
1902036,1476915,2025-01-29,House,"Reported from Courts of Justice with substitute and referred to Appropriations (16-Y 6-N)",16,6,0,0,22
1902036,1478177,2025-01-31,House,"Reported from Appropriations (14-Y 8-N)",14,8,0,0,22
1902036,1488532,2025-02-12,Senate,"Reported from Courts of Justice with substitute (15-Y 0-N)",15,0,0,0,15
1902036,1490069,2025-02-14,Senate,"Constitutional reading dispensed (on 2nd reading) (36-Y 0-N)",36,0,0,4,40
1902036,1491291,2025-02-17,Senate,"Passed Senate with substitute (39-Y 0-N)",39,0,0,1,40
1902036,1491823,2025-02-18,House,"Senate substitute rejected by House (2-Y 94-N)",2,94,0,4,100
1902036,1493987,2025-02-19,Senate,"Senate insisted on substitute (40-Y 0-N)",40,0,0,0,40
1902036,1497118,2025-02-22,House,"Conference report agreed to by House (60-Y 39-N)",60,39,0,1,100
1902036,1504091,2025-02-22,Senate,"Conference report agreed to by Senate (40-Y 0-N)",40,0,0,0,40
1902036,1536867,2025-04-02,House,"House concurred in Governor's recommendation (90-Y 5-N)",90,5,0,5,100
1902036,1536868,2025-04-02,Senate,"Senate concurred in Governor's recommendation (40-Y 0-N)",40,0,0,0,40
1902036,1565102,2025-02-04,House,"Read third time and passed House (56-Y 41-N)",56,41,0,3,100
1902038,1471612,2025-01-14,House,"Subcommittee recommends reporting with substitute and referred to Appropriations (8-Y 0-N)",8,0,0,1,9
1902038,1472085,2025-01-16,House,"Reported from General Laws with substitute and referred to Appropriations (22-Y 0-N)",22,0,0,0,22
1902038,1473213,2025-01-22,House,"Subcommittee recommends reporting with amendment(s) (8-Y 0-N)",8,0,0,1,9
1902038,1474276,2025-01-24,House,"Reported from Appropriations with amendment(s) (22-Y 0-N)",22,0,0,0,22
1902038,1478251,2025-01-30,House,"Read third time and passed House (96-Y 0-N)",96,0,0,4,100
1902038,1481512,2025-02-05,Senate,"Reported from General Laws and Technology and rereferred to Finance and Appropriations (13-Y 0-N)",13,0,0,2,15
1902038,1486020,2025-02-11,Senate,"Passed by indefinitely in Finance and Appropriations (14-Y 1-N)",14,1,0,0,15
1902040,1471468,2025-01-13,House,"Subcommittee recommends reporting with amendment(s) and referred to Appropriations (5-Y 3-N)",5,3,0,1,9
1902040,1472195,2025-01-17,House,"Reported from Courts of Justice with amendment(s) and referred to Appropriations (12-Y 10-N)",12,10,0,0,22
1902040,1473194,2025-01-22,House,"Subcommittee recommends reporting with substitute (8-Y 0-N)",8,0,0,1,9
1902040,1474269,2025-01-24,House,"Reported from Appropriations with substitute (22-Y 0-N)",22,0,0,0,22
1902040,1478248,2025-01-30,House,"Read third time and passed House (84-Y 12-N)",84,12,0,4,100
1902040,1484754,2025-02-10,Senate,"Reported from Courts of Justice and rereferred to Finance and Appropriations (15-Y 0-N)",15,0,0,0,15
1902040,1492126,2025-02-17,Senate,"Passed by indefinitely in Finance and Appropriations (12-Y 2-N)",12,2,0,1,15
1902042,1473751,2025-01-23,House,"Subcommittee recommends reporting with amendment(s) (8-Y 0-N)",8,0,0,1,9
1902042,1474328,2025-01-24,House,"Tabled in Counties, Cities and Towns (19-Y 1-N)",19,1,0,2,22
1902044,1472469,2025-01-20,House,"Subcommittee recommends laying on the table (8-Y 0-N)",8,0,0,1,9
1902047,1477844,2025-01-30,House,"Subcommittee recommends laying on the table (8-Y 0-N)",8,0,0,1,9
1902048,1471946,2025-01-16,House,"Subcommittee failed to recommend reporting (2-Y 4-N)",2,4,0,1,7
1902054,1472007,2025-01-16,House,"Subcommittee recommends laying on the table (5-Y 3-N)",5,3,0,1,9
1902057,1472497,2025-01-20,House,"Subcommittee recommends reporting with amendment(s) (8-Y 0-N)",8,0,0,1,9
1902057,1473364,2025-01-22,House,"Reported from Appropriations with amendment(s) (22-Y 0-N)",22,0,0,0,22
1902057,1476818,2025-01-28,House,"Read third time and passed House (99-Y 0-N)",99,0,0,1,100
1902057,1489567,2025-02-13,Senate,"Reported from Education and Health with substitute (15-Y 0-N)",15,0,0,0,15
1902057,1491052,2025-02-17,Senate,"Constitutional reading dispensed (on 2nd reading)",39,0,0,1,40
1902057,1492326,2025-02-18,Senate,"Passed Senate with substitute (40-Y 0-N)",40,0,0,0,40
1902057,1495361,2025-02-19,House,"Senate substitute rejected by House (0-Y 97-N)",0,97,0,3,100
1902057,1496461,2025-02-20,Senate,"Senate insisted on substitute (39-Y 0-N)",39,0,0,1,40
1902057,1496462,2025-02-21,Senate,"Conference report agreed to by Senate (40-Y 0-N)",40,0,0,0,40
1902057,1503951,2025-02-21,House,"Conference report agreed to by House (92-Y 0-N)",92,0,0,8,100
1902058,1472441,2025-01-20,House,"Subcommittee recommends laying on the table (8-Y 0-N)",8,0,0,1,9
1902059,1473490,2025-01-23,House,"Subcommittee recommends reporting with amendment(s) (6-Y 0-N)",6,0,0,1,7
1902059,1474194,2025-01-24,House,"Reported from Public Safety with amendment(s) (22-Y 0-N)",22,0,0,0,22
1902059,1478264,2025-01-30,House,"Read third time and passed House (96-Y 0-N)",96,0,0,4,100
1902059,1482147,2025-02-05,Senate,"Rereferred from General Laws and Technology to Rehabilitation and Social Services (12-Y 0-N)",12,0,0,3,15
1902059,1483855,2025-02-07,Senate,"Reported from Rehabilitation and Social Services with amendment and rereferred to Finance and Appropriations (15-Y 0-N)",15,0,0,0,15
1902059,1487370,2025-02-12,Senate,"Reported from Finance and Appropriations (15-Y 0-N)",15,0,0,0,15
1902059,1488946,2025-02-13,Senate,"Constitutional reading dispensed (on 2nd reading) (40-Y 0-N)",40,0,0,0,40
1902059,1490214,2025-02-14,Senate,"Passed Senate with amendment (36-Y 0-N)",36,0,0,4,40
1902059,1492369,2025-02-18,House,"Senate Amendment agreed to by House (96-Y 0-N)",96,0,0,4,100
1902060,1471650,2025-01-14,House,"Subcommittee recommends reporting (6-Y 0-N 2-A)",6,0,2,1,9
1902060,1472068,2025-01-16,House,"Reported from General Laws (22-Y 0-N)",22,0,0,0,22
1902060,1473306,2025-01-22,House,"Read third time and passed House (96-Y 0-N)",96,0,0,4,100
1902060,1473307,2025-01-22,House,"Passed House (97-Y 0-N)",97,0,0,3,100
1902060,1482134,2025-02-05,Senate,"Reported from General Laws and Technology (13-Y 2-N)",13,2,0,0,15
1902060,1483943,2025-02-07,Senate,"Constitutional reading dispensed (on 2nd reading) (38-Y 0-N)",38,0,0,2,40
1902060,1485333,2025-02-10,Senate,"Passed Senate (35-Y 4-N)",35,4,0,1,40
1902061,1476831,2025-01-29,House,"Reported from Rules (11-Y 4-N)",11,4,0,3,18
1902061,1478955,2025-02-03,House,"Agreed to by House (72-Y 24-N)",72,24,0,4,100
1902061,1491003,2025-02-17,Senate,"Reading waived (on 1st reading) (39-Y 0-N)",39,0,0,1,40
1902063,1472002,2025-01-16,House,"Subcommittee recommends reporting with substitute (6-Y 2-N)",6,2,0,1,9
1902063,1472815,2025-01-21,House,"Reported from General Laws with substitute (13-Y 8-N)",13,8,0,1,22
1902063,1476757,2025-01-28,House,"Read third time and passed House (57-Y 40-N)",57,40,0,3,100
1902063,1482775,2025-02-05,Senate,"Reported from General Laws and Technology (15-Y 0-N)",15,0,0,0,15
1902063,1484239,2025-02-07,Senate,"Constitutional reading dispensed (on 2nd reading) (38-Y 0-N)",38,0,0,2,40
1902063,1484902,2025-02-10,Senate,"Passed Senate (31-Y 5-N 2-A)",31,5,2,2,40
1902064,1472086,2025-01-17,House,"Reported from Public Safety with amendment(s) (12-Y 10-N)",12,10,0,0,22
1902064,1473746,2025-01-23,House,"Read third time and passed House (49-Y 47-N)",49,47,0,4,100
1902064,1484783,2025-02-10,Senate,"Reported from Courts of Justice and rereferred to Finance and Appropriations (9-Y 6-N)",9,6,0,0,15
1902064,1487351,2025-02-12,Senate,"Reported from Finance and Appropriations with amendment (10-Y 5-N)",10,5,0,0,15
1902064,1488873,2025-02-13,Senate,"Constitutional reading dispensed (on 2nd reading) (40-Y 0-N)",40,0,0,0,40
1902064,1490201,2025-02-14,Senate,"Passed Senate with amendment (21-Y 14-N)",21,14,0,5,40
1902064,1492272,2025-02-18,House,"Senate Amendment agreed to by House (51-Y 45-N)",51,45,0,4,100
1902065,1471879,2025-01-16,House,"Reported from Health and Human Services and referred to Appropriations (22-Y 0-N)",22,0,0,0,22
1902065,1474357,2025-01-24,House,"Subcommittee recommends reporting with substitute (7-Y 0-N)",7,0,0,2,9
1902065,1475045,2025-01-27,House,"Reported from Appropriations with substitute (21-Y 1-N)",21,1,0,0,22
1902065,1478612,2025-01-31,House,"Read third time and passed House (96-Y 0-N)",96,0,0,4,100
1902065,1489668,2025-02-13,Senate,"Reported from Education and Health and rereferred to Finance and Appropriations (15-Y 0-N)",15,0,0,0,15
1902065,1492129,2025-02-17,Senate,"Reported from Finance and Appropriations with substitute (14-Y 0-N)",14,0,0,1,15
1902065,1495893,2025-02-19,Senate,"Constitutional reading dispensed (on 2nd reading) (40-Y 0-N)",40,0,0,0,40
1902065,1495894,2025-02-20,Senate,"Senate insisted on substitute (38-Y 0-N)",38,0,0,2,40
1902065,1496358,2025-02-20,Senate,"Passed Senate with substitute (39-Y 0-N)",39,0,0,1,40
1902065,1496359,2025-02-20,Senate,"Reconsideration of Senate passage agreed to by Senate (39-Y 0-N)",39,0,0,1,40
1902065,1496360,2025-02-20,Senate,"Passed Senate with substitute (39-Y 0-N)",39,0,0,1,40
1902065,1496802,2025-02-20,House,"Senate substitute rejected by House (0-Y 94-N)",0,94,0,6,100
1902065,1497151,2025-02-21,Senate,"Conference report agreed to by Senate (39-Y 0-N)",39,0,0,1,40
1902065,1503773,2025-02-21,House,"Conference report agreed to by House (96-Y 0-N)",96,0,0,4,100
1902066,1471790,2025-01-15,House,"Subcommittee recommends reporting with substitute (8-Y 0-N)",8,0,0,1,9
1902066,1472164,2025-01-17,House,"Reported from Appropriations with substitute (21-Y 0-N)",21,0,0,1,22
1902066,1473649,2025-01-23,House,"Read third time and passed House (90-Y 6-N)",90,6,0,4,100
1902066,1486079,2025-02-11,Senate,"Passed by indefinitely in Finance and Appropriations (15-Y 0-N)",15,0,0,0,15
1902068,1478361,2025-01-31,House,"Subcommittee recommends reporting with substitute (8-Y 0-N)",8,0,0,1,9
1902068,1478362,2025-01-31,House,"Reported from Courts of Justice with substitute (20-Y 0-N)",20,0,0,2,22
1902068,1480764,2025-02-04,House,"Read third time and passed House (97-Y 0-N)",97,0,0,3,100
1902068,1480765,2025-02-04,House,"Passed House (99-Y 0-N)",99,0,0,1,100
1902068,1484851,2025-02-10,Senate,"Reported from Courts of Justice with substitute and rereferred to Finance and Appropriations (14-Y 0-N)",14,0,0,1,15
1902068,1487430,2025-02-12,Senate,"Reported from Finance and Appropriations (15-Y 0-N)",15,0,0,0,15
1902068,1489053,2025-02-13,Senate,"Constitutional reading dispensed (on 2nd reading) (40-Y 0-N)",40,0,0,0,40
1902068,1490275,2025-02-14,Senate,"Passed Senate with substitute (36-Y 0-N)",36,0,0,4,40
1902068,1492325,2025-02-18,House,"Senate substitute agreed to by House (95-Y 0-N)",95,0,0,5,100
1902070,1472048,2025-01-16,House,"Subcommittee recommends reporting (8-Y 0-N)",8,0,0,1,9
1902070,1472691,2025-01-21,House,"Reported from General Laws (21-Y 0-N)",21,0,0,1,22
1902070,1475286,2025-01-27,House,"Read third time and passed House (97-Y 0-N)",97,0,0,3,100
1902070,1480803,2025-02-05,Senate,"Reported from General Laws and Technology (12-Y 0-N)",12,0,0,3,15
1902070,1483942,2025-02-07,Senate,"Constitutional reading dispensed (on 2nd reading) (38-Y 0-N)",38,0,0,2,40
1902070,1484712,2025-02-10,Senate,"Passed Senate (39-Y 0-N)",39,0,0,1,40
1902071,1472490,2025-01-20,House,"Subcommittee recommends reporting (8-Y 0-N)",8,0,0,1,9
1902071,1473365,2025-01-22,House,"Reported from Appropriations (22-Y 0-N)",22,0,0,0,22
1902071,1487617,2025-02-12,Senate,"Passed by indefinitely in Finance and Appropriations (15-Y 0-N)",15,0,0,0,15
1902071,1565425,2025-01-28,House,"Read third time and passed House (84-Y 15-N)",84,15,0,1,100
1902073,1472221,2025-01-17,House,"Subcommittee recommends laying on the table (5-Y 3-N)",5,3,0,1,9
1902074,1475618,2025-01-28,House,"Subcommittee recommends laying on the table (5-Y 3-N)",5,3,0,1,9
1902076,1473951,2025-01-23,House,"Subcommittee recommends reporting and referring to Appropriations (8-Y 0-N)",8,0,0,1,9
1902076,1475639,2025-01-28,House,"Reported from Health and Human Services and referred to Appropriations (21-Y 0-N)",21,0,0,1,22
1902076,1476620,2025-01-29,House,"Subcommittee recommends laying on the table (6-Y 0-N)",6,0,0,3,9
1902078,1473973,2025-01-23,House,"Subcommittee recommends reporting (5-Y 3-N)",5,3,0,1,9
1902078,1475648,2025-01-28,House,"Reported from General Laws (12-Y 10-N)",12,10,0,0,22
1902078,1479738,2025-02-03,House,"Read third time and passed House (50-Y 48-N)",50,48,0,2,100
1902078,1488113,2025-02-12,Senate,"Reported from General Laws and Technology (8-Y 5-N)",8,5,0,2,15
1902078,1490266,2025-02-14,Senate,"Constitutional reading dispensed (on 2nd reading) (36-Y 0-N)",36,0,0,4,40
1902078,1492346,2025-02-18,Senate,"Passed Senate (21-Y 19-N)",21,19,0,0,40
1902079,1472417,2025-01-20,House,"Reported from Finance (12-Y 10-N)",12,10,0,0,22
1902079,1480479,2025-02-05,Senate,"Reported from Finance and Appropriations (10-Y 3-N)",10,3,0,2,15
1902079,1483221,2025-02-06,Senate,"Constitutional reading dispensed (on 2nd reading) (40-Y 0-N)",40,0,0,0,40
1902079,1483949,2025-02-07,Senate,"Passed Senate (21-Y 17-N)",21,17,0,2,40
1902079,1536423,2025-04-02,House,"House rejected Governor's recommendation (20-Y 74-N)",20,74,0,6,100
1902079,1536424,2025-04-02,House,"Motion to pass in enrolled form rejected (52-Y 42-N)",52,42,0,6,100
1902079,1564818,2025-01-24,House,"Read third time and passed House (53-Y 42-N)",53,42,0,5,100
1902080,1471924,2025-01-16,House,"Subcommittee recommends reporting with amendment(s) (5-Y 3-N)",5,3,0,1,9
1902080,1472679,2025-01-21,House,"Reported from General Laws with amendment(s) (12-Y 9-N)",12,9,0,1,22
1902080,1474792,2025-01-27,House,"Read third time and passed House (48-Y 46-N)",48,46,0,6,100
1902080,1490235,2025-02-14,Senate,"Reported from Rules (15-Y 0-N)",15,0,0,0,15
1902080,1491058,2025-02-17,Senate,"Constitutional reading dispensed (on 2nd reading)",39,0,0,1,40
1902080,1492329,2025-02-18,Senate,"Passed Senate (40-Y 0-N)",40,0,0,0,40
1902083,1471689,2025-01-15,House,"Subcommittee recommends reporting with substitute (8-Y 0-N)",8,0,0,1,9
1902083,1472186,2025-01-17,House,"Reported from Courts of Justice with substitute (22-Y 0-N)",22,0,0,0,22
1902083,1473599,2025-01-23,House,"Read third time and passed House (97-Y 0-N)",97,0,0,3,100
1902083,1490824,2025-02-17,Senate,"Reported from Courts of Justice with amendments (14-Y 1-N)",14,1,0,0,15
1902083,1491991,2025-02-18,Senate,"Constitutional reading dispensed (on 2nd reading) (39-Y 0-N)",39,0,0,1,40
1902083,1495814,2025-02-20,House,"Senate substitute rejected by House (0-Y 96-N)",0,96,0,4,100
1902083,1495815,2025-02-20,Senate,"Senate insisted on substitute (38-Y 0-N)",38,0,0,2,40
1902083,1496286,2025-02-20,Senate,"Passed Senate with substitute (39-Y 0-N)",39,0,0,1,40
1902083,1496761,2025-02-21,Senate,"Conference report agreed to by Senate (40-Y 0-N)",40,0,0,0,40
1902083,1535181,2025-04-02,Senate,"Senate rejected Governor's recommendation (19-Y 21-N)",19,21,0,0,40
1902083,1536345,2025-04-02,House,"House concurred in Governor's recommendation (96-Y 0-N)",96,0,0,4,100
1902083,1564838,2025-02-22,House,"Conference report agreed to by House (98-Y 0-N)",98,0,0,2,100
1902087,1474840,2025-01-27,House,"Subcommittee recommends reporting with substitute and referring to Appropriations (5-Y 3-N)",5,3,0,0,8
1902087,1476814,2025-01-29,House,"Reported from Finance with substitute and referred to Appropriations (12-Y 10-N)",12,10,0,0,22
1902089,1478523,2025-01-31,House,"Subcommittee recommends reporting with substitute (8-Y 0-N)",8,0,0,1,9
1902089,1478524,2025-01-31,House,"Reported from Courts of Justice with substitute (20-Y 0-N)",20,0,0,2,22
1902089,1479726,2025-02-04,House,"Read third time and passed House (97-Y 0-N)",97,0,0,3,100
1902089,1479727,2025-02-04,House,"Passed House (99-Y 0-N)",99,0,0,1,100
1902089,1484593,2025-02-10,Senate,"Reported from Courts of Justice and rereferred to Finance and Appropriations (12-Y 1-N)",12,1,0,2,15
1902089,1487803,2025-02-12,Senate,"Reported from Finance and Appropriations (15-Y 0-N)",15,0,0,0,15
1902089,1488815,2025-02-13,Senate,"Constitutional reading dispensed (on 2nd reading) (40-Y 0-N)",40,0,0,0,40
1902089,1490071,2025-02-14,Senate,"Passed Senate (35-Y 1-N)",35,1,0,4,40
1902090,1472394,2025-01-20,House,"Subcommittee failed to recommend reporting (3-Y 5-N)",3,5,0,1,9
1902092,1471471,2025-01-13,House,"Subcommittee recommends reporting (8-Y 0-N)",8,0,0,1,9
1902092,1472184,2025-01-17,House,"Reported from Courts of Justice (22-Y 0-N)",22,0,0,0,22
1902092,1473563,2025-01-23,House,"Read third time and passed House (97-Y 0-N)",97,0,0,3,100
1902092,1483040,2025-02-05,Senate,"Reported from Courts of Justice (14-Y 0-N)",14,0,0,1,15
1902092,1483987,2025-02-07,Senate,"Constitutional reading dispensed (on 2nd reading) (38-Y 0-N)",38,0,0,2,40
1902092,1485044,2025-02-10,Senate,"Passed Senate (39-Y 0-N)",39,0,0,1,40
1902093,1471469,2025-01-14,House,"Reported from Labor and Commerce and referred to Appropriations (12-Y 10-N)",12,10,0,0,22
1902093,1474371,2025-01-24,House,"Subcommittee recommends reporting (5-Y 2-N)",5,2,0,2,9
1902093,1475056,2025-01-27,House,"Reported from Appropriations (14-Y 8-N)",14,8,0,0,22
1902093,1478605,2025-01-31,House,"Read third time and passed House (52-Y 44-N)",52,44,0,4,100
1902093,1484946,2025-02-10,Senate,"Reported from Commerce and Labor and rereferred to Finance and Appropriations (10-Y 5-N)",10,5,0,0,15
1902093,1490121,2025-02-14,Senate,"Reported from Finance and Appropriations with substitute (10-Y 4-N)",10,4,0,1,15
1902093,1491349,2025-02-17,Senate,"Constitutional reading dispensed (on 2nd reading) (39-Y 0-N)",39,0,0,1,40
1902093,1493262,2025-02-18,Senate,"Passed Senate with substitute (24-Y 16-N)",24,16,0,0,40
1902093,1493263,2025-02-18,Senate,"Reconsideration of Senate passage agreed to by Senate",40,0,0,0,40
1902093,1493264,2025-02-18,Senate,"Passed Senate with substitute (26-Y 14-N)",26,14,0,0,40
1902093,1493265,2025-02-19,House,"Senate substitute agreed to by House (52-Y 45-N)",52,45,0,3,100
1902097,1472103,2025-01-17,House,"Subcommittee recommends reporting (5-Y 3-N)",5,3,0,1,9
1902097,1474273,2025-01-24,House,"Reported from Counties, Cities and Towns (13-Y 7-N)",13,7,0,2,22
1902097,1478601,2025-01-31,House,"Read third time and passed House (69-Y 26-N 1-A)",69,26,1,4,100
1902097,1484577,2025-02-10,Senate,"Reported from Local Government (8-Y 7-N)",8,7,0,0,15
1902097,1486206,2025-02-11,Senate,"Constitutional reading dispensed (on 2nd reading) (40-Y 0-N)",40,0,0,0,40
1902097,1489154,2025-02-12,Senate,"Defeated by Senate (21-Y 18-N)",21,18,0,1,40
1902097,1489155,2025-02-12,Senate,"Reconsideration of defeated action agreed to by Senate (39-Y 0-N)",39,0,0,1,40
1902097,1489156,2025-02-13,Senate,"Defeated by Senate (21-Y 19-N)",21,19,0,0,40
1902098,1472089,2025-01-17,House,"Subcommittee recommends reporting (8-Y 0-N)",8,0,0,1,9
1902098,1474339,2025-01-24,House,"Reported from Counties, Cities and Towns (20-Y 0-N)",20,0,0,2,22
1902098,1478318,2025-01-30,House,"Read third time and passed House (96-Y 0-N)",96,0,0,4,100
1902098,1484833,2025-02-10,Senate,"Reported from Local Government (15-Y 0-N)",15,0,0,0,15
1902098,1486282,2025-02-11,Senate,"Constitutional reading dispensed (on 2nd reading) (40-Y 0-N)",40,0,0,0,40
1902098,1487568,2025-02-12,Senate,"Passed Senate (39-Y 0-N)",39,0,0,1,40
1902100,1471647,2025-01-14,House,"Reported from General Laws (13-Y 9-N)",13,9,0,0,22
1902100,1473678,2025-01-20,House,"Read third time and passed House (53-Y 43-N)",53,43,0,4,100
1902100,1487974,2025-02-12,Senate,"Reported from General Laws and Technology (14-Y 1-N)",14,1,0,0,15
1902100,1490167,2025-02-14,Senate,"Constitutional reading dispensed (on 2nd reading) (36-Y 0-N)",36,0,0,4,40
1902100,1492198,2025-02-18,Senate,"Passed Senate (23-Y 17-N)",23,17,0,0,40
1902102,1472845,2025-01-21,House,"Subcommittee recommends laying on the table (6-Y 2-N)",6,2,0,1,9
1902104,1471611,2025-01-14,House,"Stricken from docket by General Laws (22-Y 0-N)",22,0,0,0,22
1902106,1471472,2025-01-13,House,"Subcommittee recommends reporting (8-Y 0-N)",8,0,0,1,9
1902106,1472104,2025-01-17,House,"Reported from Privileges and Elections (19-Y 2-N)",19,2,0,1,22
1902106,1473648,2025-01-23,House,"Read third time and passed House (94-Y 3-N)",94,3,0,3,100
1902106,1486368,2025-02-11,Senate,"Reported from Privileges and Elections (15-Y 0-N)",15,0,0,0,15
1902106,1488979,2025-02-13,Senate,"Constitutional reading dispensed (on 2nd reading) (40-Y 0-N)",40,0,0,0,40
1902106,1490256,2025-02-14,Senate,"Passed Senate (36-Y 0-N)",36,0,0,4,40
1902108,1471979,2025-01-16,House,"Subcommittee recommends reporting and referred to Appropriations (8-Y 0-N)",8,0,0,1,9
1902108,1472563,2025-01-21,House,"Reported from Health and Human Services and referred to Appropriations (21-Y 0-N)",21,0,0,1,22
1902108,1474395,2025-01-24,House,"Subcommittee recommends laying on the table (7-Y 0-N)",7,0,0,2,9
1902110,1475159,2025-01-27,House,"Subcommittee recommends reporting with amendment(s) (7-Y 0-N)",7,0,0,2,9
1902110,1476773,2025-01-29,House,"Reported from Appropriations with amendment(s) (20-Y 1-N)",20,1,0,1,22
1902110,1480648,2025-02-04,House,"Read third time and passed House (98-Y 0-N)",98,0,0,2,100
1902110,1488216,2025-02-12,Senate,"Reported from Finance and Appropriations (15-Y 0-N)",15,0,0,0,15
1902110,1489133,2025-02-13,Senate,"Constitutional reading dispensed (on 2nd reading) (40-Y 0-N)",40,0,0,0,40
1902110,1490060,2025-02-14,Senate,"Passed Senate (36-Y 0-N)",36,0,0,4,40
1902111,1474129,2025-01-23,House,"Subcommittee recommends reporting (8-Y 0-N)",8,0,0,1,9
1902111,1476015,2025-01-28,House,"Reported from Health and Human Services (21-Y 0-N)",21,0,0,1,22
1902111,1480197,2025-02-03,House,"Read third time and passed House (98-Y 0-N)",98,0,0,2,100
1902111,1480198,2025-02-03,House,"Read third time and passed House (99-Y 0-N)",99,0,0,1,100
1902111,1487999,2025-02-12,Senate,"Rereferred from General Laws and Technology to Rehabilitation and Social Services (10-Y 0-N)",10,0,0,5,15
1902111,1490270,2025-02-14,Senate,"Reported from Rehabilitation and Social Services (11-Y 0-N)",11,0,0,4,15
1902111,1491560,2025-02-17,Senate,"Constitutional reading dispensed (on 2nd reading)",39,0,0,1,40
1902111,1492304,2025-02-18,Senate,"Passed Senate (40-Y 0-N)",40,0,0,0,40
1902114,1472766,2025-01-21,House,"Subcommittee recommends reporting and referred to Appropriations (7-Y 0-N 1-A)",7,0,1,1,9
1902114,1473272,2025-01-22,House,"Reported from Finance and referred to Appropriations (21-Y 1-N)",21,1,0,0,22
1902114,1478431,2025-01-31,House,"Reported from Appropriations with amendment(s) (22-Y 0-N)",22,0,0,0,22
1902114,1482728,2025-02-04,House,"Read third time and passed House (94-Y 3-N)",94,3,0,3,100
1902114,1486022,2025-02-11,Senate,"Passed by indefinitely in Finance and Appropriations (15-Y 0-N)",15,0,0,0,15
1902116,1471853,2025-01-15,House,"Subcommittee recommends reporting and referred to Appropriations (7-Y 0-N)",7,0,0,2,9
1902116,1472272,2025-01-17,House,"Reported from Courts of Justice with substitute and referred to Appropriations (19-Y 3-N)",19,3,0,0,22
1902116,1472526,2025-01-20,House,"Subcommittee recommends reporting with substitute (8-Y 0-N)",8,0,0,1,9
1902116,1473368,2025-01-22,House,"Reported from Appropriations with substitute (22-Y 0-N)",22,0,0,0,22
1902116,1477054,2025-01-28,House,"Read third time and passed House (89-Y 10-N)",89,10,0,1,100
1902116,1485429,2025-02-10,Senate,"Reported from Courts of Justice with amendments and rereferred to Finance and Appropriations (12-Y 3-N)",12,3,0,0,15
1902116,1488206,2025-02-12,Senate,"Reported from Finance and Appropriations (13-Y 2-N)",13,2,0,0,15
1902116,1490591,2025-02-13,Senate,"Constitutional reading dispensed (on 2nd reading) (40-Y 0-N)",40,0,0,0,40
1902116,1490681,2025-02-14,Senate,"Passed Senate with amendments (32-Y 4-N)",32,4,0,4,40
1902116,1492311,2025-02-18,House,"Senate Amendments agreed to by House (92-Y 4-N)",92,4,0,4,100
1902119,1472046,2025-01-16,House,"Subcommittee recommends reporting (8-Y 0-N)",8,0,0,1,9
1902119,1472658,2025-01-21,House,"Reported from General Laws (21-Y 0-N)",21,0,0,1,22
1902119,1475336,2025-01-27,House,"Read third time and passed House (97-Y 0-N)",97,0,0,3,100
1902119,1482561,2025-02-05,Senate,"Reported from General Laws and Technology (13-Y 0-N)",13,0,0,2,15
1902119,1484100,2025-02-07,Senate,"Constitutional reading dispensed (on 2nd reading) (38-Y 0-N)",38,0,0,2,40
1902119,1485126,2025-02-10,Senate,"Passed Senate (39-Y 0-N)",39,0,0,1,40
1902121,1475892,2025-01-28,House,"Subcommittee recommends striking from the docket (8-Y 0-N)",8,0,0,1,9
1902123,1471475,2025-01-14,House,"Subcommittee recommends reporting with substitute (8-Y 0-N)",8,0,0,1,9
1902123,1471691,2025-01-15,House,"Reported from Education with substitute (21-Y 0-N)",21,0,0,1,22
1902123,1473815,2025-01-21,House,"Read third time and passed House (96-Y 0-N)",96,0,0,4,100
1902123,1483114,2025-02-06,Senate,"Reported from Education and Health with substitute (14-Y 0-N)",14,0,0,1,15
1902123,1483875,2025-02-07,Senate,"Constitutional reading dispensed (on 2nd reading) (38-Y 0-N)",38,0,0,2,40
1902123,1486257,2025-02-10,Senate,"Passed Senate with substitute (39-Y 0-N)",39,0,0,1,40
1902123,1487492,2025-02-12,House,"Senate substitute agreed to by House (Y-97 N-0 A-0)",97,0,0,3,100
1902124,1471996,2025-01-16,House,"Subcommittee recommends reporting with substitute (8-Y 0-N)",8,0,0,1,9
1902124,1472665,2025-01-21,House,"Reported from General Laws with substitute (21-Y 0-N)",21,0,0,1,22
1902124,1475327,2025-01-27,House,"Read third time and passed House (97-Y 0-N)",97,0,0,3,100
1902124,1482795,2025-02-05,Senate,"Reported from General Laws and Technology (13-Y 0-N)",13,0,0,2,15
1902124,1484102,2025-02-07,Senate,"Constitutional reading dispensed (on 2nd reading) (38-Y 0-N)",38,0,0,2,40
1902124,1485136,2025-02-10,Senate,"Passed Senate (39-Y 0-N)",39,0,0,1,40
1902128,1472045,2025-01-16,House,"Subcommittee recommends striking from the docket (8-Y 0-N)",8,0,0,1,9
1902128,1472868,2025-01-21,House,"Stricken from docket by General Laws (21-Y 0-N)",21,0,0,1,22
1902130,1472791,2025-01-21,House,"Subcommittee recommends laying on the table (7-Y 0-N)",7,0,0,1,8
1902131,1471473,2025-01-14,House,"Subcommittee recommends reporting (8-Y 0-N)",8,0,0,1,9
1902131,1471726,2025-01-15,House,"Reported from Education (21-Y 0-N)",21,0,0,1,22
1902131,1473774,2025-01-21,House,"Read third time and passed House (96-Y 0-N)",96,0,0,4,100
1902131,1489673,2025-02-13,Senate,"Reported from Education and Health (14-Y 0-N)",14,0,0,1,15
1902131,1491131,2025-02-17,Senate,"Constitutional reading dispensed (on 2nd reading)",39,0,0,1,40
1902131,1493117,2025-02-18,Senate,"Passed Senate (40-Y 0-N)",40,0,0,0,40
1902133,1471881,2025-01-16,House,"Reported from Health and Human Services (15-Y 7-N)",15,7,0,0,22
1902133,1489720,2025-02-13,Senate,"Reported from Education and Health (7-Y 6-N)",7,6,0,2,15
1902133,1491200,2025-02-17,Senate,"Constitutional reading dispensed (on 2nd reading) (39-Y 0-N)",39,0,0,1,40
1902133,1492422,2025-02-18,Senate,"Passed Senate (21-Y 18-N)",21,18,0,1,40
1902133,1536572,2025-04-02,House,"House rejected Governor's recommendation (42-Y 54-N)",42,54,0,4,100
1902133,1564987,2025-01-23,House,"Read third time and passed House (53-Y 44-N)",53,44,0,3,100
1902133,1564988,2025-04-02,House,"Motion to pass in enrolled form rejected (Y-55 N-41 A-0)",55,41,0,4,100
1902135,1471467,2025-01-14,House,"Subcommittee recommends reporting and referred to Appropriations (6-Y 2-N)",6,2,0,1,9
1902135,1471692,2025-01-15,House,"Reported from Education and referred to Appropriations (13-Y 8-N)",13,8,0,1,22
1902135,1476433,2025-01-29,House,"Subcommittee recommends reporting with substitute (4-Y 3-N)",4,3,0,2,9
1902135,1478290,2025-01-31,House,"Reported from Appropriations with substitute (12-Y 10-N)",12,10,0,0,22
1902135,1482186,2025-02-04,House,"Read third time and passed House (51-Y 47-N)",51,47,0,2,100
1902135,1489709,2025-02-13,Senate,"Passed by indefinitely in Education and Health (15-Y 0-N)",15,0,0,0,15
1902137,1473211,2025-01-22,House,"Subcommittee recommends laying on the table (10-Y 0-N)",10,0,0,1,11
1902141,1471675,2025-01-15,House,"Subcommittee recommends laying on the table (7-Y 1-N)",7,1,0,1,9
1902142,1472427,2025-01-20,House,"Subcommittee recommends reporting (10-Y 0-N)",10,0,0,1,11
1902142,1473146,2025-01-22,House,"Reported from Agriculture, Chesapeake and Natural Resources (22-Y 0-N)",22,0,0,0,22
1902142,1476450,2025-01-28,House,"Read third time and passed House (99-Y 0-N)",99,0,0,1,100
1902142,1486709,2025-02-11,Senate,"Reported from Agriculture, Conservation and Natural Resources (14-Y 0-N)",14,0,0,1,15
1902142,1489032,2025-02-13,Senate,"Constitutional reading dispensed (on 2nd reading) (40-Y 0-N)",40,0,0,0,40
1902142,1490295,2025-02-14,Senate,"Passed Senate (36-Y 0-N)",36,0,0,4,40
1902145,1473498,2025-01-23,House,"Subcommittee recommends reporting with amendment(s) (6-Y 0-N)",6,0,0,1,7
1902145,1474218,2025-01-24,House,"Reported from Public Safety with amendment(s) (22-Y 0-N)",22,0,0,0,22
1902145,1478256,2025-01-30,House,"Read third time and passed House (96-Y 0-N)",96,0,0,4,100
1902145,1488478,2025-02-12,Senate,"Reported from Courts of Justice with amendments (15-Y 0-N)",15,0,0,0,15
1902145,1490174,2025-02-14,Senate,"Constitutional reading dispensed (on 2nd reading) (36-Y 0-N)",36,0,0,4,40
1902145,1492071,2025-02-17,Senate,"Passed Senate with amendments (39-Y 0-N)",39,0,0,1,40
1902145,1492072,2025-02-18,House,"Senate Amendments agreed to by House (97-Y 0-N)",97,0,0,3,100
1902147,1472917,2025-01-22,House,"Subcommittee recommends reporting with substitute and referring to Labor and Commerce (9-Y 0-N)",9,0,0,2,11
1902147,1474810,2025-01-27,House,"Reported from Communications, Technology and Innovation with substitute (20-Y 2-N)",20,2,0,0,22
1902147,1478613,2025-01-31,House,"Read third time and passed House (87-Y 8-N)",87,8,0,5,100
1902147,1485060,2025-02-10,Senate,"Reported from Commerce and Labor with amendment and rereferred to Finance and Appropriations (11-Y 0-N 4-A)",11,0,4,0,15
1902147,1492111,2025-02-17,Senate,"Reported from Finance and Appropriations with amendment (14-Y 0-N)",14,0,0,1,15
1902147,1495217,2025-02-20,Senate,"Reconsideration of defeat agreed to by Senate (39-Y 0-N)",39,0,0,1,40
1902147,1495218,2025-02-20,Senate,"Passed Senate with amendments (20-Y 19-N)",20,19,0,1,40
1902147,1495861,2025-02-19,Senate,"Constitutional reading dispensed (on 2nd reading) (40-Y 0-N)",40,0,0,0,40
1902147,1496288,2025-02-20,Senate,"Defeated by Senate (17-Y 22-N)",17,22,0,1,40
1902147,1496289,2025-02-20,Senate,"Defeated by Senate (19-Y 19-N 1-A), Chair Votes No",19,19,1,1,40
1902147,1496760,2025-02-20,House,"Senate Amendments agreed to by House (85-Y 10-N)",85,10,0,5,100
1902147,1536396,2025-04-02,House,"House rejected Governor's recommendation (28-Y 68-N)",28,68,0,4,100
1902149,1472024,2025-01-16,House,"Subcommittee recommends reporting and referred to Appropriations (5-Y 3-N)",5,3,0,1,9
1902149,1472575,2025-01-21,House,"Reported from Health and Human Services and referred to Appropriations (13-Y 9-N)",13,9,0,0,22
1902149,1474507,2025-01-24,House,"Subcommittee recommends laying on the table (7-Y 0-N)",7,0,0,2,9
1902151,1474284,2025-01-24,House,"Subcommittee recommends reporting (7-Y 1-N)",7,1,0,1,9
1902151,1476674,2025-01-29,House,"Reported from Courts of Justice (17-Y 5-N)",17,5,0,0,22
1902151,1482265,2025-02-04,House,"Read third time and passed House (55-Y 44-N)",55,44,0,1,100
1902151,1488527,2025-02-12,Senate,"Reported from Courts of Justice (15-Y 0-N)",15,0,0,0,15
1902151,1490301,2025-02-14,Senate,"Constitutional reading dispensed (on 2nd reading) (36-Y 0-N)",36,0,0,4,40
1902151,1491139,2025-02-17,Senate,"Passed Senate (39-Y 0-N)",39,0,0,1,40
1902154,1476700,2025-01-29,House,"Reported from Rules and referred to Appropriations (14-Y 0-N)",14,0,0,4,18
1902156,1472091,2025-01-17,House,"Reported from Counties, Cities and Towns (13-Y 9-N)",13,9,0,0,22
1902156,1473488,2025-01-23,House,"Read third time and passed House (52-Y 45-N)",52,45,0,3,100
1902156,1484553,2025-02-10,Senate,"Reported from Local Government and rereferred to Finance and Appropriations (8-Y 7-N)",8,7,0,0,15
1902156,1487410,2025-02-12,Senate,"Reported from Finance and Appropriations (10-Y 5-N)",10,5,0,0,15
1902156,1488971,2025-02-13,Senate,"Constitutional reading dispensed (on 2nd reading) (40-Y 0-N)",40,0,0,0,40
1902156,1490229,2025-02-14,Senate,"Passed Senate (21-Y 15-N)",21,15,0,4,40
1902159,1472359,2025-01-20,House,"Subcommittee recommends reporting with substitute and referred to Appropriations (10-Y 0-N)",10,0,0,1,11
1902159,1472967,2025-01-22,House,"Reported from Education with substitute and referred to Appropriations (22-Y 0-N)",22,0,0,0,22
1902159,1478492,2025-01-31,House,"Reported from Appropriations with amendment(s) (22-Y 0-N)",22,0,0,0,22
1902159,1479624,2025-02-04,House,"Read third time and passed House (97-Y 0-N)",97,0,0,3,100
1902159,1479625,2025-02-04,House,"Passed House (99-Y 0-N)",99,0,0,1,100
1902159,1489596,2025-02-13,Senate,"Reported from Education and Health with substitute and rereferred to Finance and Appropriations (15-Y 0-N)",15,0,0,0,15
1902159,1490511,2025-02-14,Senate,"Reported from Finance and Appropriations (14-Y 0-N)",14,0,0,1,15
1902159,1491016,2025-02-17,Senate,"Constitutional reading dispensed (on 2nd reading) (39-Y 0-N)",39,0,0,1,40
1902159,1493359,2025-02-18,Senate,"Passed Senate with substitute (40-Y 0-N)",40,0,0,0,40
1902159,1493360,2025-02-19,House,"Senate substitute rejected by House (6-Y 91-N)",6,91,0,3,100
1902159,1496218,2025-02-20,Senate,"Senate insisted on substitute (39-Y 0-N)",39,0,0,1,40
1902159,1496945,2025-02-21,Senate,"Conference report agreed to by Senate (40-Y 0-N)",40,0,0,0,40
1902159,1497161,2025-02-22,House,"Conference report agreed to by House (99-Y 0-N)",99,0,0,1,100
1902160,1471737,2025-01-15,House,"Subcommittee recommends striking from the docket (8-Y 0-N)",8,0,0,1,9
1902165,1471859,2025-01-15,House,"Subcommittee recommends reporting (8-Y 0-N)",8,0,0,1,9
1902165,1472220,2025-01-17,House,"Reported from Courts of Justice (22-Y 0-N)",22,0,0,0,22
1902165,1473963,2025-01-23,House,"Read third time and passed House (97-Y 0-N)",97,0,0,3,100
1902165,1483121,2025-02-05,Senate,"Reported from Courts of Justice (14-Y 0-N)",14,0,0,1,15
1902165,1483967,2025-02-07,Senate,"Constitutional reading dispensed (on 2nd reading) (38-Y 0-N)",38,0,0,2,40
1902165,1485550,2025-02-10,Senate,"Passed Senate (39-Y 0-N)",39,0,0,1,40
1902167,1475743,2025-01-28,House,"Subcommittee recommends reporting with substitute (7-Y 1-N)",7,1,0,1,9
1902167,1477090,2025-01-30,House,"Reported from Transportation with substitute (21-Y 0-N 1-A)",21,0,1,0,22
1902167,1482630,2025-02-04,House,"Read third time and passed House (97-Y 0-N)",97,0,0,3,100
1902167,1489261,2025-02-13,Senate,"Reported from Transportation (13-Y 0-N)",13,0,0,2,15
1902167,1491641,2025-02-17,Senate,"Constitutional reading dispensed (on 2nd reading)",39,0,0,1,40
1902167,1494072,2025-02-18,Senate,"Passed Senate (40-Y 0-N)",40,0,0,0,40
1902169,1471929,2025-01-16,House,"Subcommittee recommends reporting (6-Y 2-N)",6,2,0,1,9
1902169,1472706,2025-01-21,House,"Reported from General Laws (15-Y 6-N)",15,6,0,1,22
1902169,1475276,2025-01-27,House,"Read third time and passed House (61-Y 35-N)",61,35,0,4,100
1902169,1482364,2025-02-05,Senate,"Reported from General Laws and Technology (15-Y 0-N)",15,0,0,0,15
1902169,1483865,2025-02-07,Senate,"Constitutional reading dispensed (on 2nd reading) (38-Y 0-N)",38,0,0,2,40
1902169,1484592,2025-02-10,Senate,"Passed Senate (39-Y 0-N)",39,0,0,1,40
1902173,1472790,2025-01-21,House,"Subcommittee recommends reporting with substitute and referred to Appropriations (6-Y 4-N)",6,4,0,1,11
1902173,1474023,2025-01-23,House,"Reported from Labor and Commerce with substitute and referred to Appropriations (12-Y 10-N)",12,10,0,0,22
1902173,1478184,2025-01-31,House,"Reported from Appropriations with amendment(s) (15-Y 7-N)",15,7,0,0,22
1902173,1480661,2025-02-04,House,"Read third time and passed House (56-Y 41-N)",56,41,0,3,100
1902173,1485329,2025-02-10,Senate,"Reported from Commerce and Labor with substitute and rereferred to Finance and Appropriations (9-Y 5-N 1-A)",9,5,1,0,15
1902173,1490163,2025-02-14,Senate,"Reported from Finance and Appropriations (8-Y 6-N)",8,6,0,1,15
1902173,1490935,2025-02-17,Senate,"Constitutional reading dispensed (on 2nd reading) (39-Y 0-N)",39,0,0,1,40
1902173,1493637,2025-02-19,Senate,"Passed Senate with substitute (21-Y 19-N)",21,19,0,0,40
1902173,1536537,2025-04-02,House,"House sustained Governor's veto (51-Y 45-N)",51,45,0,4,100
1902173,1564911,2025-02-20,House,"Senate substitute agreed to by House (56-Y 42-N)",56,42,0,2,100
1902176,1471962,2025-01-16,House,"Subcommittee recommends reporting and referred to Appropriations (5-Y 3-N)",5,3,0,1,9
1902176,1472795,2025-01-21,House,"Reported from Labor and Commerce and referred to Appropriations (12-Y 10-N)",12,10,0,0,22
1902176,1478207,2025-01-31,House,"Reported from Appropriations (12-Y 10-N)",12,10,0,0,22
1902176,1480701,2025-02-04,House,"Read third time and passed House (51-Y 47-N)",51,47,0,2,100
1902176,1484913,2025-02-10,Senate,"Reported from Commerce and Labor with substitute and rereferred to Finance and Appropriations (15-Y 0-N)",15,0,0,0,15
1902176,1490162,2025-02-14,Senate,"Reported from Finance and Appropriations (10-Y 3-N)",10,3,0,2,15
1902176,1492196,2025-02-17,Senate,"Constitutional reading dispensed (on 2nd reading) (39-Y 0-N)",39,0,0,1,40
1902176,1493609,2025-02-19,Senate,"Reconsideration of Senate passage agreed to by Senate",40,0,0,0,40
1902176,1493610,2025-02-19,Senate,"Passed Senate with substitute (27-Y 13-N)",27,13,0,0,40
1902176,1495257,2025-02-19,Senate,"Passed Senate with substitute (23-Y 16-N)",23,16,0,1,40
1902176,1496396,2025-02-20,House,"Senate substitute rejected by House (0-Y 97-N)",0,97,0,3,100
1902176,1496817,2025-02-20,Senate,"Senate insisted on substitute (39-Y 0-N)",39,0,0,1,40
1902176,1497156,2025-02-22,House,"Conference report agreed to by House (52-Y 47-N)",52,47,0,1,100
1902176,1503925,2025-02-22,Senate,"Conference report agreed to by Senate (27-Y 13-N)",27,13,0,0,40
1902176,1535355,2025-04-02,Senate,"Senate concurred in Governor's recommendation (40-Y 0-N)",40,0,0,0,40
1902176,1536528,2025-04-02,House,"House concurred in Governor's recommendation (Y-63 N-33 A-0)",63,33,0,4,100
1902178,1471836,2025-01-15,House,"Subcommittee recommends reporting (8-Y 0-N)",8,0,0,1,9
1902178,1472255,2025-01-17,House,"Reported from Courts of Justice (22-Y 0-N)",22,0,0,0,22
1902178,1474054,2025-01-23,House,"Read third time and passed House (97-Y 0-N)",97,0,0,3,100
1902178,1483022,2025-02-05,Senate,"Reported from Courts of Justice (14-Y 0-N)",14,0,0,1,15
1902178,1483886,2025-02-07,Senate,"Constitutional reading dispensed (on 2nd reading) (38-Y 0-N)",38,0,0,2,40
1902178,1485860,2025-02-10,Senate,"Passed Senate (39-Y 0-N)",39,0,0,1,40
1902180,1472704,2025-01-21,House,"Subcommittee recommends reporting with substitute (8-Y 0-N)",8,0,0,1,9
1902180,1473278,2025-01-22,House,"Reported from Finance with substitute (15-Y 7-N)",15,7,0,0,22
1902180,1477044,2025-01-28,House,"Read third time and passed House (96-Y 3-N)",96,3,0,1,100
1902180,1482548,2025-02-05,Senate,"Reported from Finance and Appropriations with substitute (13-Y 0-N)",13,0,0,2,15
1902180,1483251,2025-02-06,Senate,"Constitutional reading dispensed (on 2nd reading) (40-Y 0-N)",40,0,0,0,40
1902180,1484007,2025-02-07,Senate,"Passed Senate with substitute (39-Y 0-N)",39,0,0,1,40
1902180,1485912,2025-02-11,House,"Senate substitute rejected by House (0-Y 89-N 1-A)",0,89,1,10,100
1902180,1490002,2025-02-13,Senate,"Senate insisted on substitute (39-Y 0-N)",39,0,0,1,40
1902180,1497170,2025-02-22,House,"Conference report agreed to by House (98-Y 1-N)",98,1,0,1,100
1902180,1504084,2025-02-22,Senate,"Conference report agreed to by Senate (40-Y 0-N)",40,0,0,0,40
1902181,1471835,2025-01-15,House,"Subcommittee recommends reporting with substitute (7-Y 1-N)",7,1,0,1,9
1902181,1472269,2025-01-17,House,"Reported from Courts of Justice with substitute (21-Y 1-N)",21,1,0,0,22
1902181,1490839,2025-02-17,Senate,"Reported from Courts of Justice (15-Y 0-N)",15,0,0,0,15
1902181,1494004,2025-02-18,Senate,"Constitutional reading dispensed (on 2nd reading) (39-Y 0-N)",39,0,0,1,40
1902181,1494005,2025-02-19,Senate,"Passed Senate (40-Y 0-N)",40,0,0,0,40
1902181,1564918,2025-01-23,House,"Read third time and passed House (97-Y 0-N)",97,0,0,3,100
1902185,1477715,2025-01-30,House,"Subcommittee recommends reporting with substitute (6-Y 2-N)",6,2,0,1,9
1902185,1477716,2025-01-30,House,"Reported from General Laws with substitute (21-Y 0-N)",21,0,0,1,22
1902185,1479996,2025-02-04,House,"Read third time and passed House (97-Y 0-N)",97,0,0,3,100
1902185,1479997,2025-02-04,House,"Passed House (99-Y 0-N)",99,0,0,1,100
1902185,1488403,2025-02-12,Senate,"Reported from General Laws and Technology (13-Y 0-N)",13,0,0,2,15
1902185,1490050,2025-02-14,Senate,"Constitutional reading dispensed (on 2nd reading) (36-Y 0-N)",36,0,0,4,40
1902185,1491371,2025-02-17,Senate,"Passed Senate (39-Y 0-N)",39,0,0,1,40
1902186,1475031,2025-01-27,House,"Subcommittee recommends striking from the docket (8-Y 0-N)",8,0,0,0,8
1902188,1472481,2025-01-20,House,"Subcommittee recommends reporting with substitute (8-Y 0-N)",8,0,0,1,9
1902188,1474760,2025-01-24,House,"Reported from Courts of Justice with substitute (22-Y 0-N)",22,0,0,0,22
1902188,1478432,2025-01-30,House,"Read third time and passed House (96-Y 0-N)",96,0,0,4,100
1902188,1485301,2025-02-10,Senate,"Reported from Courts of Justice (12-Y 0-N)",12,0,0,3,15
1902188,1486653,2025-02-11,Senate,"Constitutional reading dispensed (on 2nd reading) (40-Y 0-N)",40,0,0,0,40
1902188,1487478,2025-02-12,Senate,"Passed Senate (39-Y 0-N)",39,0,0,1,40
1902190,1471649,2025-01-14,House,"Subcommittee recommends reporting with amendment(s) (8-Y 0-N)",8,0,0,1,9
1902190,1476385,2025-01-29,House,"Reported from Finance with substitute (21-Y 0-N)",21,0,0,1,22
1902190,1480511,2025-02-04,House,"Read third time and passed House (97-Y 0-N)",97,0,0,3,100
1902190,1480512,2025-02-04,House,"Passed House (99-Y 0-N)",99,0,0,1,100
1902190,1485846,2025-02-11,Senate,"Reported from Finance and Appropriations with substitute (15-Y 0-N)",15,0,0,0,15
1902190,1486215,2025-02-11,Senate,"Constitutional reading dispensed (on 2nd reading) (40-Y 0-N)",40,0,0,0,40
1902190,1489111,2025-02-12,Senate,"Passed Senate with substitute (39-Y 0-N)",39,0,0,1,40
1902190,1490330,2025-02-14,House,"Senate substitute rejected by House (Y-2 N-93 A-0)",2,93,0,5,100
1902190,1493103,2025-02-18,Senate,"Senate insisted on substitute (40-Y 0-N)",40,0,0,0,40
1902190,1496492,2025-02-21,Senate,"Conference report agreed to by Senate (38-Y 0-N)",38,0,0,2,40
1902190,1497210,2025-02-22,House,"Conference report agreed to by House (99-Y 0-N)",99,0,0,1,100
1902191,1476019,2025-01-28,House,"Subcommittee recommends reporting with substitute (5-Y 3-N)",5,3,0,1,9
1902191,1478004,2025-01-30,House,"Reported from General Laws with substitute (14-Y 7-N)",14,7,0,1,22
1902191,1482276,2025-02-04,House,"Read third time and passed House (63-Y 34-N)",63,34,0,3,100
1902191,1488147,2025-02-12,Senate,"Reported from General Laws and Technology (14-Y 1-N)",14,1,0,0,15
1902191,1490432,2025-02-14,Senate,"Constitutional reading dispensed (on 2nd reading) (36-Y 0-N)",36,0,0,4,40
1902191,1493584,2025-02-18,Senate,"Passed Senate (23-Y 17-N)",23,17,0,0,40
1902192,1471845,2025-01-15,House,"Subcommittee recommends laying on the table (5-Y 3-N)",5,3,0,1,9
1902194,1472108,2025-01-17,House,"Reported from Privileges and Elections (22-Y 0-N)",22,0,0,0,22
1902194,1474245,2025-01-24,House,"Read third time and passed House (97-Y 0-N)",97,0,0,3,100
1902194,1486061,2025-02-11,Senate,"Failed to report (defeated) in Privileges and Elections (7-Y 8-N)",7,8,0,0,15
1902196,1471961,2025-01-16,House,"Subcommittee recommends reporting and referred to Appropriations (5-Y 3-N)",5,3,0,1,9
1902196,1472805,2025-01-21,House,"Reported from Labor and Commerce and referred to Appropriations (13-Y 9-N)",13,9,0,0,22
1902196,1476409,2025-01-29,House,"Subcommittee recommends reporting (5-Y 3-N)",5,3,0,1,9
1902196,1476804,2025-01-29,House,"Reported from Appropriations (12-Y 9-N)",12,9,0,1,22
1902196,1480600,2025-02-04,House,"Read third time and passed House (52-Y 47-N)",52,47,0,1,100
1902196,1485334,2025-02-10,Senate,"Reported from Commerce and Labor and rereferred to Finance and Appropriations (9-Y 6-N)",9,6,0,0,15
1902196,1490176,2025-02-14,Senate,"Reported from Finance and Appropriations with amendment (10-Y 4-N)",10,4,0,1,15
1902196,1492183,2025-02-17,Senate,"Constitutional reading dispensed (on 2nd reading) (39-Y 0-N)",39,0,0,1,40
1902196,1495219,2025-02-20,Senate,"Senator Surovell Amendment agreed to (20-Y 19-N)",20,19,0,1,40
1902196,1495220,2025-02-20,Senate,"Passed Senate with amendments (30-Y 1-N)",30,1,0,9,40
1902198,1471828,2025-01-15,House,"Subcommittee recommends reporting (7-Y 1-N)",7,1,0,1,9
1902198,1472124,2025-01-17,House,"Reported from Courts of Justice (16-Y 6-N)",16,6,0,0,22
1902198,1473975,2025-01-23,House,"Read third time and passed House (59-Y 38-N)",59,38,0,3,100
1902198,1488590,2025-02-12,Senate,"Reported from Courts of Justice (12-Y 0-N)",12,0,0,3,15
1902198,1490417,2025-02-14,Senate,"Constitutional reading dispensed (on 2nd reading) (36-Y 0-N)",36,0,0,4,40
1902198,1492825,2025-02-17,Senate,"Passed Senate (36-Y 2-N)",36,2,0,2,40
1902199,1476728,2025-01-29,House,"Reported from Rules with amendment(s) and referred to Appropriations (11-Y 3-N)",11,3,0,4,18
1902199,1478494,2025-01-31,House,"Reported from Appropriations with substitute (13-Y 9-N)",13,9,0,0,22
1902199,1480791,2025-02-04,House,"Agreed to by House (54-Y 44-N)",54,44,0,2,100
1902199,1491063,2025-02-17,Senate,"Reading waived (on 2nd reading) (39-Y 0-N)",39,0,0,1,40
1902199,1493749,2025-02-19,House,"Senate substitute agreed to by House (55-Y 42-N)",55,42,0,3,100
1902200,1477705,2025-01-30,House,"Subcommittee recommends laying on the table (6-Y 2-N)",6,2,0,1,9
1902202,1471474,2025-01-13,House,"Subcommittee recommends reporting (7-Y 1-N)",7,1,0,1,9
1902202,1472185,2025-01-17,House,"Reported from Courts of Justice (15-Y 7-N)",15,7,0,0,22
1902202,1473606,2025-01-23,House,"Read third time and passed House (88-Y 9-N)",88,9,0,3,100
1902202,1483015,2025-02-05,Senate,"Reported from Courts of Justice (14-Y 0-N)",14,0,0,1,15
1902202,1483935,2025-02-07,Senate,"Constitutional reading dispensed (on 2nd reading) (38-Y 0-N)",38,0,0,2,40
1902202,1484677,2025-02-10,Senate,"Passed Senate (39-Y 0-N)",39,0,0,1,40
1902206,1475116,2025-01-27,House,"Subcommittee recommends reporting with substitute (7-Y 0-N)",7,0,0,2,9
1902206,1476750,2025-01-29,House,"Reported from Appropriations with substitute (21-Y 0-N)",21,0,0,1,22
1902206,1480494,2025-02-04,House,"Read third time and passed House (97-Y 0-N)",97,0,0,3,100
1902206,1480495,2025-02-04,House,"Passed House (99-Y 0-N)",99,0,0,1,100
1902206,1485876,2025-02-11,Senate,"Reported from Finance and Appropriations (15-Y 0-N)",15,0,0,0,15
1902206,1487858,2025-02-11,Senate,"Constitutional reading dispensed (on 2nd reading) (40-Y 0-N)",40,0,0,0,40
1902206,1487859,2025-02-12,Senate,"Passed Senate (39-Y 0-N)",39,0,0,1,40
1902207,1478123,2025-01-31,House,"Reported from Privileges and Elections (12-Y 9-N)",12,9,0,1,22
1902207,1482470,2025-02-04,House,"Read third time and passed House (52-Y 45-N)",52,45,0,3,100
1902207,1486267,2025-02-11,Senate,"Reported from Privileges and Elections and rereferred to Finance and Appropriations (8-Y 7-N)",8,7,0,0,15
1902207,1492224,2025-02-17,Senate,"Passed by indefinitely in Finance and Appropriations (13-Y 1-N)",13,1,0,1,15
1902210,1475262,2025-01-28,House,"Subcommittee recommends reporting with substitute (6-Y 2-N)",6,2,0,1,9
1902210,1476181,2025-01-29,House,"Reported from Education with substitute (12-Y 10-N)",12,10,0,0,22
1902210,1480625,2025-02-04,House,"Read third time and passed House (52-Y 47-N)",52,47,0,1,100
1902210,1489692,2025-02-13,Senate,"Reported from Education and Health with substitute (13-Y 2-N)",13,2,0,0,15
1902210,1491119,2025-02-17,Senate,"Constitutional reading dispensed (on 1st reading) (39-Y 0-N)",39,0,0,1,40
1902210,1495376,2025-02-19,Senate,"Passed Senate with substitute (37-Y 3-N)",37,3,0,0,40
1902210,1496495,2025-02-20,House,"Senate substitute agreed to by House (55-Y 43-N)",55,43,0,2,100
1902211,1471957,2025-01-16,House,"Subcommittee recommends reporting with substitute (5-Y 3-N)",5,3,0,1,9
1902211,1474035,2025-01-23,House,"Reported from Labor and Commerce with substitute (12-Y 10-N)",12,10,0,0,22
1902211,1477402,2025-01-29,House,"Read third time and passed House (49-Y 46-N)",49,46,0,5,100
1902211,1491366,2025-02-17,Senate,"Reported from Commerce and Labor with substitute (13-Y 2-N)",13,2,0,0,15
1902211,1493372,2025-02-18,Senate,"Constitutional reading dispensed (on 2nd reading) (40-Y 0-N)",40,0,0,0,40
1902211,1495730,2025-02-19,Senate,"Passed Senate with substitute (27-Y 13-N)",27,13,0,0,40
1902211,1496673,2025-02-20,House,"Senate substitute agreed to by House (53-Y 44-N)",53,44,0,3,100
1902211,1534985,2025-04-02,House,"House rejected Governor's recommendation (33-Y 63-N)",33,63,0,4,100
1902211,1534986,2025-04-02,House,"Motion to pass in enrolled form rejected (51-Y 45-N)",51,45,0,4,100
1902212,1477595,2025-01-30,House,"Subcommittee recommends laying on the table (7-Y 0-N 1-A)",7,0,1,1,9
1902217,1471470,2025-01-13,House,"Subcommittee recommends reporting (7-Y 1-N)",7,1,0,1,9
1902217,1475044,2025-01-27,House,"Subcommittee recommends reporting with substitute (5-Y 2-N)",5,2,0,2,9
1902217,1476725,2025-01-29,House,"Reported from Courts of Justice with substitute (17-Y 4-N 1-A)",17,4,1,0,22
1902217,1480781,2025-02-04,House,"Read third time and passed House (60-Y 38-N 1-A)",60,38,1,1,100
1902217,1484733,2025-02-10,Senate,"Reported from Courts of Justice with amendment (15-Y 0-N)",15,0,0,0,15
1902217,1485982,2025-02-11,Senate,"Constitutional reading dispensed (on 2nd reading) (40-Y 0-N)",40,0,0,0,40
1902217,1487799,2025-02-12,Senate,"Passed Senate with amendment (32-Y 5-N)",32,5,0,3,40
1902217,1487800,2025-02-12,Senate,"Reconsideration of Senate passage agreed to by Senate (39-Y 0-N)",39,0,0,1,40
1902217,1487801,2025-02-12,Senate,"Passed Senate with amendment (33-Y 6-N)",33,6,0,1,40
1902217,1490066,2025-02-14,House,"Senate substitute agreed to by House (Y-51 N-43 A-1)",51,43,1,5,100
1902217,1534946,2025-04-02,House,"House rejected Governor's recommendation (31-Y 63-N 1-A)",31,63,1,5,100
1902217,1534947,2025-04-02,House,"Motion to pass in enrolled form rejected (54-Y 41-N 1-A)",54,41,1,4,100
1902219,1473797,2025-01-23,House,"Subcommittee recommends reporting with substitute (7-Y 1-N)",7,1,0,1,9
1902219,1476020,2025-01-28,House,"Reported from General Laws with substitute (15-Y 7-N)",15,7,0,0,22
1902219,1479481,2025-02-03,House,"Read third time and passed House (55-Y 44-N)",55,44,0,1,100
1902219,1488468,2025-02-12,Senate,"Reported from General Laws and Technology with substitute and rereferred to Finance and Appropriations (9-Y 0-N 6-A)",9,0,6,0,15
1902219,1491943,2025-02-17,Senate,"Passed by indefinitely in Finance and Appropriations (13-Y 1-N)",13,1,0,1,15
1902221,1475137,2025-01-27,House,"Subcommittee recommends reporting (7-Y 0-N)",7,0,0,2,9
1902221,1476740,2025-01-29,House,"Reported from Appropriations (20-Y 1-N)",20,1,0,1,22
1902221,1482676,2025-02-04,House,"Read third time and passed House (99-Y 0-N)",99,0,0,1,100
1902221,1488140,2025-02-12,Senate,"Reported from Finance and Appropriations (15-Y 0-N)",15,0,0,0,15
1902221,1489356,2025-02-13,Senate,"Constitutional reading dispensed (on 2nd reading) (40-Y 0-N)",40,0,0,0,40
1902221,1490429,2025-02-14,Senate,"Passed Senate (36-Y 0-N)",36,0,0,4,40
1902222,1477022,2025-01-29,House,"Tabled in Rules (15-Y 0-N)",15,0,0,3,18
1902225,1474708,2025-01-27,House,"Subcommittee recommends reporting (7-Y 1-N)",7,1,0,1,9
1902225,1476426,2025-01-29,House,"Reported from Finance (22-Y 0-N)",22,0,0,0,22
1902225,1480630,2025-02-04,House,"Read third time and passed House (97-Y 0-N)",97,0,0,3,100
1902225,1480631,2025-02-04,House,"Passed House (99-Y 0-N)",99,0,0,1,100
1902225,1485889,2025-02-11,Senate,"Reported from Finance and Appropriations (13-Y 0-N)",13,0,0,2,15
1902225,1485890,2025-02-11,Senate,"Constitutional reading dispensed (on 2nd reading) (40-Y 0-N)",40,0,0,0,40
1902225,1489128,2025-02-12,Senate,"Passed Senate (39-Y 0-N)",39,0,0,1,40
1902226,1471671,2025-01-15,House,"Reported from Agriculture, Chesapeake and Natural Resources (22-Y 0-N)",22,0,0,0,22
1902226,1472552,2025-01-21,House,"Read third time and passed House (96-Y 0-N)",96,0,0,4,100
1902226,1488125,2025-02-11,Senate,"Reported from Agriculture, Conservation and Natural Resources (14-Y 0-N)",14,0,0,1,15
1902226,1489013,2025-02-13,Senate,"Constitutional reading dispensed (on 2nd reading) (40-Y 0-N)",40,0,0,0,40
1902226,1490286,2025-02-14,Senate,"Passed Senate (36-Y 0-N)",36,0,0,4,40
1902228,1471651,2025-01-14,House,"Subcommittee recommends reporting (7-Y 0-N)",7,0,0,1,8
1902228,1472041,2025-01-16,House,"Reported from Labor and Commerce (22-Y 0-N)",22,0,0,0,22
1902228,1473153,2025-01-22,House,"Read third time and passed House (96-Y 0-N)",96,0,0,4,100
1902228,1473154,2025-01-22,House,"Passed House (97-Y 0-N 0-A)",97,0,0,3,100
1902228,1491441,2025-02-17,Senate,"Reported from Commerce and Labor (10-Y 3-N 1-A)",10,3,1,1,15
1902228,1492542,2025-02-18,Senate,"Constitutional reading dispensed (on 2nd reading) (40-Y 0-N)",40,0,0,0,40
1902228,1494066,2025-02-19,Senate,"Passed Senate (36-Y 3-N 1-A)",36,3,1,0,40
1902230,1478012,2025-01-31,House,"Reported from Public Safety with substitute (12-Y 9-N)",12,9,0,1,22
1902230,1482142,2025-02-04,House,"Read third time and passed House (51-Y 48-N)",51,48,0,1,100
1902230,1484796,2025-02-10,Senate,"Reported from Courts of Justice with substitute and rereferred to Finance and Appropriations (8-Y 5-N)",8,5,0,2,15
1902230,1487393,2025-02-12,Senate,"Reported from Finance and Appropriations (10-Y 5-N)",10,5,0,0,15
1902230,1488977,2025-02-13,Senate,"Constitutional reading dispensed (on 2nd reading) (40-Y 0-N)",40,0,0,0,40
1902230,1493404,2025-02-18,Senate,"Passed Senate with substitute (21-Y 19-N)",21,19,0,0,40
1902230,1493405,2025-02-19,House,"Senate substitute agreed to by House (51-Y 46-N)",51,46,0,3,100
1902233,1471973,2025-01-16,House,"Subcommittee recommends reporting (8-Y 0-N)",8,0,0,1,9
1902233,1472688,2025-01-21,House,"Reported from General Laws and referred to Appropriations (20-Y 1-N)",20,1,0,1,22
1902233,1476965,2025-01-29,House,"Reported from Appropriations (21-Y 0-N)",21,0,0,1,22
1902233,1482613,2025-02-04,House,"Read third time and passed House (98-Y 1-N)",98,1,0,1,100
1902233,1488075,2025-02-12,Senate,"Reported from General Laws and Technology and rereferred to Finance and Appropriations (13-Y 0-N)",13,0,0,2,15
1902233,1490501,2025-02-14,Senate,"Passed by indefinitely in Finance and Appropriations (13-Y 1-N)",13,1,0,1,15
1902235,1472531,2025-01-21,House,"Subcommittee recommends reporting (8-Y 0-N)",8,0,0,1,9
1902235,1473782,2025-01-23,House,"Reported from Transportation (21-Y 0-N)",21,0,0,1,22
1902235,1476543,2025-01-29,House,"Read third time and passed House (97-Y 0-N)",97,0,0,3,100
1902235,1483765,2025-02-06,Senate,"Reported from Transportation and rereferred to Finance and Appropriations (12-Y 0-N)",12,0,0,3,15
1902235,1488213,2025-02-12,Senate,"Reported from Finance and Appropriations (15-Y 0-N)",15,0,0,0,15
1902235,1489595,2025-02-13,Senate,"Constitutional reading dispensed (on 2nd reading) (40-Y 0-N)",40,0,0,0,40
1902235,1490542,2025-02-14,Senate,"Passed Senate (36-Y 0-N)",36,0,0,4,40
1902236,1471919,2025-01-16,House,"Subcommittee recommends reporting (8-Y 0-N)",8,0,0,1,9
1902236,1472562,2025-01-21,House,"Reported from Health and Human Services (22-Y 0-N)",22,0,0,0,22
1902236,1474837,2025-01-27,House,"Read third time and passed House (97-Y 0-N)",97,0,0,3,100
1902236,1483083,2025-02-05,Senate,"Reported from Courts of Justice (14-Y 0-N)",14,0,0,1,15
1902236,1483997,2025-02-07,Senate,"Constitutional reading dispensed (on 2nd reading) (38-Y 0-N)",38,0,0,2,40
1902236,1484634,2025-02-10,Senate,"Passed Senate (39-Y 0-N)",39,0,0,1,40
1902237,1475486,2025-01-28,House,"Subcommittee recommends striking from the docket (8-Y 0-N)",8,0,0,1,9
1902240,1472368,2025-01-20,House,"Subcommittee recommends reporting (5-Y 3-N)",5,3,0,1,9
1902240,1473285,2025-01-22,House,"Reported from Finance (22-Y 0-N)",22,0,0,0,22
1902240,1477180,2025-01-28,House,"Read third time and passed House (99-Y 0-N)",99,0,0,1,100
1902240,1487349,2025-02-12,Senate,"Reported from Finance and Appropriations (15-Y 0-N)",15,0,0,0,15
1902240,1488867,2025-02-13,Senate,"Constitutional reading dispensed (on 2nd reading) (40-Y 0-N)",40,0,0,0,40
1902240,1490200,2025-02-14,Senate,"Passed Senate (36-Y 0-N)",36,0,0,4,40
1902242,1476130,2025-01-29,House,"Subcommittee recommends laying on the table (9-Y 1-N)",9,1,0,1,11
1902243,1471763,2025-01-15,House,"Subcommittee recommends reporting (8-Y 0-N)",8,0,0,1,9
1902243,1472141,2025-01-17,House,"Reported from Counties, Cities and Towns (22-Y 0-N)",22,0,0,0,22
1902243,1473785,2025-01-23,House,"Read third time and passed House (97-Y 0-N)",97,0,0,3,100
1902243,1484787,2025-02-10,Senate,"Reported from Local Government (14-Y 0-N)",14,0,0,1,15
1902243,1486262,2025-02-11,Senate,"Constitutional reading dispensed (on 2nd reading) (40-Y 0-N)",40,0,0,0,40
1902243,1488231,2025-02-12,Senate,"Passed Senate (39-Y 0-N)",39,0,0,1,40
1902246,1471972,2025-01-16,House,"Subcommittee recommends reporting (10-Y 0-N)",10,0,0,1,11
1902246,1472758,2025-01-21,House,"Reported from Labor and Commerce (22-Y 0-N)",22,0,0,0,22
1902246,1474741,2025-01-27,House,"Read third time and passed House (97-Y 0-N)",97,0,0,3,100
1902246,1485370,2025-02-10,Senate,"Reported from Commerce and Labor (15-Y 0-N)",15,0,0,0,15
1902246,1487747,2025-02-12,Senate,"Constitutional reading dispensed (on 2nd reading) (39-Y 0-N)",39,0,0,1,40
1902246,1490020,2025-02-13,Senate,"Passed Senate (40-Y 0-N)",40,0,0,0,40
1902248,1472328,2025-01-20,House,"Subcommittee recommends reporting and referred to Appropriations (7-Y 3-N)",7,3,0,1,11
1902248,1473034,2025-01-22,House,"Reported from Education and referred to Appropriations (17-Y 5-N)",17,5,0,0,22
1902248,1478191,2025-01-31,House,"Reported from Appropriations (22-Y 0-N)",22,0,0,0,22
1902248,1480685,2025-02-04,House,"Read third time and passed House (82-Y 14-N)",82,14,0,4,100
1902248,1489518,2025-02-13,Senate,"Reported from Education and Health (15-Y 0-N)",15,0,0,0,15
1902248,1491010,2025-02-17,Senate,"Constitutional reading dispensed (on 2nd reading)",39,0,0,1,40
1902248,1492270,2025-02-18,Senate,"Passed Senate (40-Y 0-N)",40,0,0,0,40
1902249,1471811,2025-01-15,House,"Subcommittee recommends laying on the table (8-Y 0-N)",8,0,0,1,9
1902251,1471652,2025-01-14,House,"Subcommittee recommends reporting (8-Y 0-N)",8,0,0,1,9
1902251,1472098,2025-01-16,House,"Reported from General Laws (22-Y 0-N)",22,0,0,0,22
1902251,1483862,2025-02-07,Senate,"Reported from Rehabilitation and Social Services (13-Y 0-N)",13,0,0,2,15
1902251,1485528,2025-02-10,Senate,"Constitutional reading dispensed (on 2nd reading) (39-Y 0-N)",39,0,0,1,40
1902251,1488152,2025-02-12,Senate,"Passed Senate (38-Y 0-N)",38,0,0,2,40
1902251,1564825,2025-01-22,House,"Read third time and passed House (96-Y 0-N)",96,0,0,4,100
1902264,1471766,2025-01-15,House,"Subcommittee recommends reporting with substitute (7-Y 1-N)",7,1,0,1,9
1902264,1472259,2025-01-17,House,"Reported from Courts of Justice with substitute (12-Y 10-N)",12,10,0,0,22
1902264,1473474,2025-01-23,House,"Read third time and passed House (53-Y 44-N)",53,44,0,3,100
1902264,1483016,2025-02-05,Senate,"Reported from Courts of Justice with amendment (8-Y 5-N)",8,5,0,2,15
1902264,1483947,2025-02-07,Senate,"Constitutional reading dispensed (on 2nd reading) (38-Y 0-N)",38,0,0,2,40
1902264,1485376,2025-02-10,Senate,"Passed Senate with amendment (21-Y 18-N)",21,18,0,1,40
1902264,1564832,2025-02-12,House,"Senate Amendment agreed to by House (Y-54 N-43 A-0)",54,43,0,3,100
1902269,1478008,2025-01-31,House,"Reported from Public Safety with substitute (12-Y 9-N)",12,9,0,1,22
1902269,1482705,2025-02-04,House,"Read third time and passed House (52-Y 46-N)",52,46,0,2,100
1902269,1484782,2025-02-10,Senate,"Reported from Courts of Justice with substitute and rereferred to Finance and Appropriations (9-Y 6-N)",9,6,0,0,15
1902269,1487445,2025-02-12,Senate,"Reported from Finance and Appropriations (10-Y 5-N)",10,5,0,0,15
1902269,1489116,2025-02-13,Senate,"Constitutional reading dispensed (on 2nd reading) (40-Y 0-N)",40,0,0,0,40
1902269,1490321,2025-02-14,Senate,"Passed Senate with substitute (21-Y 15-N)",21,15,0,4,40
1902269,1492303,2025-02-18,House,"Senate substitute agreed to by House (51-Y 45-N)",51,45,0,4,100
1902269,1536534,2025-04-02,House,"House sustained Governor's veto (50-Y 46-N)",50,46,0,4,100
1902273,1472911,2025-01-22,House,"Subcommittee recommends laying on the table (6-Y 4-N)",6,4,0,1,11
1902280,1473862,2025-01-20,Senate,"Rereferred from Local Government and Rereferred to Agriculture, Conservation and Natural Resources (15-Y 0-N)",15,0,0,0,15
1902280,1475844,2025-01-28,Senate,"Reported from Agriculture, Conservation and Natural Resources (14-Y 0-N)",14,0,0,1,15
1902280,1477450,2025-01-30,Senate,"Constitutional reading dispensed (on 1st reading) (39-Y 0-N 1-A)",39,0,1,0,40
1902280,1479096,2025-01-31,Senate,"Constitutional reading dispensed (on 3rd reading) (40-Y 0-N)",40,0,0,0,40
1902280,1479097,2025-01-31,Senate,"Passed Senate (40-Y 0-N)",40,0,0,0,40
1902280,1487382,2025-02-12,House,"Reported from Agriculture, Chesapeake and Natural Resources (22-Y 0-N)",22,0,0,0,22
1902280,1491136,2025-02-17,House,"Passed House (95-Y 0-N)",95,0,0,5,100
1902280,1491137,2025-02-17,House,"Passed House (96-Y 0-N)",96,0,0,4,100
1902286,1471902,2025-01-16,House,"Subcommittee recommends reporting and referred to Appropriations (8-Y 0-N)",8,0,0,1,9
1902286,1472556,2025-01-21,House,"Reported from Health and Human Services and referred to Appropriations (21-Y 1-N)",21,1,0,0,22
1902286,1476599,2025-01-29,House,"Subcommittee recommends reporting (6-Y 0-N)",6,0,0,3,9
1902286,1478266,2025-01-31,House,"Reported from Appropriations (22-Y 0-N)",22,0,0,0,22
1902286,1482137,2025-02-04,House,"Read third time and passed House (96-Y 2-N)",96,2,0,2,100
1902286,1489533,2025-02-13,Senate,"Reported from Education and Health (15-Y 0-N)",15,0,0,0,15
1902286,1491057,2025-02-17,Senate,"Constitutional reading dispensed (on 2nd reading)",39,0,0,1,40
1902286,1492349,2025-02-18,Senate,"Passed Senate (40-Y 0-N)",40,0,0,0,40
1902289,1471840,2025-01-15,House,"Subcommittee recommends reporting with amendment(s) (8-Y 0-N)",8,0,0,1,9
1902289,1472261,2025-01-17,House,"Reported from Courts of Justice with amendment(s) (22-Y 0-N)",22,0,0,0,22
1902289,1473578,2025-01-23,House,"Read third time and passed House (97-Y 0-N)",97,0,0,3,100
1902289,1483458,2025-02-05,Senate,"Reported from Courts of Justice (14-Y 0-N)",14,0,0,1,15
1902289,1484225,2025-02-07,Senate,"Constitutional reading dispensed (on 2nd reading) (38-Y 0-N)",38,0,0,2,40
1902289,1484695,2025-02-10,Senate,"Passed Senate (39-Y 0-N)",39,0,0,1,40
1902294,1472388,2025-01-20,Senate,"Constitutional reading dispensed (on 1st reading) (40-Y 0-N)",40,0,0,0,40
1902294,1473160,2025-01-22,Senate,"Read third time and passed Senate (30-Y 10-N)",30,10,0,0,40
1902294,1473799,2025-01-16,Senate,"Reported from Transportation (13-Y 2-N)",13,2,0,0,15
1902294,1488103,2025-02-12,House,"Subcommittee recommends reporting (7-Y 0-N)",7,0,0,2,9
1902294,1489196,2025-02-13,House,"Reported from Transportation (13-Y 6-N)",13,6,0,3,22
1902294,1491826,2025-02-18,House,"Passed House (69-Y 27-N)",69,27,0,4,100
1902300,1473208,2025-01-22,House,"Subcommittee recommends reporting (10-Y 0-N)",10,0,0,1,11
1902300,1476397,2025-01-29,House,"Reported from Agriculture, Chesapeake and Natural Resources (22-Y 0-N)",22,0,0,0,22
1902300,1480572,2025-02-04,House,"Read third time and passed House (97-Y 0-N)",97,0,0,3,100
1902300,1480573,2025-02-04,House,"Passed House (99-Y 0-N)",99,0,0,1,100
1902300,1486710,2025-02-11,Senate,"Reported from Agriculture, Conservation and Natural Resources (15-Y 0-N)",15,0,0,0,15
1902300,1488812,2025-02-13,Senate,"Constitutional reading dispensed (on 2nd reading) (40-Y 0-N)",40,0,0,0,40
1902300,1490132,2025-02-14,Senate,"Passed Senate (36-Y 0-N)",36,0,0,4,40
1902304,1475769,2025-01-28,House,"Subcommittee recommends reporting with substitute (8-Y 0-N)",8,0,0,1,9
1902304,1477182,2025-01-30,House,"Reported from Transportation with substitute (22-Y 0-N)",22,0,0,0,22
1902304,1480632,2025-02-04,House,"Read third time and passed House (97-Y 0-N)",97,0,0,3,100
1902304,1480633,2025-02-04,House,"Passed House (99-Y 0-N)",99,0,0,1,100
1902304,1489842,2025-02-13,Senate,"Reported from Transportation (14-Y 0-N)",14,0,0,1,15
1902304,1491041,2025-02-17,Senate,"Constitutional reading dispensed (on 2nd reading)",39,0,0,1,40
1902304,1492552,2025-02-18,Senate,"Passed Senate (40-Y 0-N)",40,0,0,0,40
1902310,1478014,2025-01-31,House,"Subcommittee recommends laying on the table (5-Y 3-N)",5,3,0,1,9
1902310,1478398,2025-01-31,House,"Reported from Counties, Cities and Towns (22-Y 0-N)",22,0,0,0,22
1902310,1480490,2025-02-04,House,"Read third time and passed House (97-Y 0-N)",97,0,0,3,100
1902310,1480491,2025-02-04,House,"Passed House (99-Y 0-N)",99,0,0,1,100
1902310,1485083,2025-02-10,Senate,"Reported from Local Government (13-Y 1-N 1-A)",13,1,1,0,15
1902310,1486465,2025-02-11,Senate,"Constitutional reading dispensed (on 2nd reading) (40-Y 0-N)",40,0,0,0,40
1902310,1489992,2025-02-13,Senate,"Defeated by Senate (18-Y 22-N)",18,22,0,0,40
1902310,1489993,2025-02-13,Senate,"Reconsideration of defeated action agreed to by Senate (40-Y 0-N)",40,0,0,0,40
1902310,1489994,2025-02-13,Senate,"Defeated by Senate (19-Y 21-N)",19,21,0,0,40
1902316,1473964,2025-01-23,House,"Subcommittee recommends reporting with substitute (8-Y 0-N)",8,0,0,1,9
1902316,1476008,2025-01-28,House,"Reported from Health and Human Services with substitute (21-Y 0-N)",21,0,0,1,22
1902316,1479576,2025-02-03,House,"Read third time and passed House (98-Y 0-N)",98,0,0,2,100
1902316,1479577,2025-02-03,House,"Read third time and passed House (99-Y 0-N)",99,0,0,1,100
1902316,1489491,2025-02-13,Senate,"Reported from Education and Health (15-Y 0-N)",15,0,0,0,15
1902316,1490971,2025-02-17,Senate,"Constitutional reading dispensed (on 2nd reading)",39,0,0,1,40
1902316,1492680,2025-02-18,Senate,"Passed Senate (40-Y 0-N)",40,0,0,0,40
1902320,1474330,2025-01-24,House,"Subcommittee recommends reporting with amendment(s) and referring to Appropriations (7-Y 1-N)",7,1,0,1,9
1902320,1476699,2025-01-29,House,"Reported from Courts of Justice with amendment(s) and referred to Appropriations (15-Y 7-N)",15,7,0,0,22
1902326,1472528,2025-01-20,House,"Subcommittee recommends reporting (8-Y 0-N)",8,0,0,1,9
1902326,1473200,2025-01-22,House,"Reported from Appropriations (22-Y 0-N)",22,0,0,0,22
1902326,1477871,2025-01-28,House,"Read third time and passed House (78-Y 21-N)",78,21,0,1,100
1902326,1489346,2025-02-13,Senate,"Reported from Education and Health and rereferred to Finance and Appropriations (15-Y 0-N)",15,0,0,0,15
1902326,1491905,2025-02-17,Senate,"Reported from Finance and Appropriations (14-Y 0-N)",14,0,0,1,15
1902326,1495917,2025-02-19,Senate,"Constitutional reading dispensed (on 2nd reading) (40-Y 0-N)",40,0,0,0,40
1902326,1496157,2025-02-20,Senate,"Passed Senate (39-Y 0-N)",39,0,0,1,40
1902326,1496158,2025-02-20,Senate,"Reconsideration of Senate passage agreed to by Senate (39-Y 0-N)",39,0,0,1,40
1902326,1496159,2025-02-20,Senate,"Passed Senate (39-Y 0-N)",39,0,0,1,40
1902326,1535510,2025-04-02,House,"House rejected Governor's recommendation (35-Y 60-N)",35,60,0,5,100
1902332,1472493,2025-01-20,Senate,"Reported from Commerce and Labor with substitute (9-Y 6-N)",9,6,0,0,15
1902332,1473136,2025-01-22,Senate,"Constitutional reading dispensed (on 1st reading) (40-Y 0-N)",40,0,0,0,40
1902332,1474590,2025-01-24,Senate,"Read third time and passed Senate (20-Y 18-N)",20,18,0,2,40
1902332,1483399,2025-02-06,House,"Reported from Labor and Commerce (11-Y 10-N)",11,10,0,1,22
1902332,1487549,2025-02-12,House,"Passed House (50-Y 47-N)",50,47,0,3,100
1902337,1472355,2025-01-20,House,"Subcommittee recommends reporting (8-Y 0-N)",8,0,0,1,9
1902337,1473401,2025-01-22,House,"Reported from Finance (22-Y 0-N)",22,0,0,0,22
1902337,1476900,2025-01-28,House,"Read third time and passed House (99-Y 0-N)",99,0,0,1,100
1902337,1486254,2025-02-11,Senate,"Reported from Finance and Appropriations (15-Y 0-N)",15,0,0,0,15
1902337,1486255,2025-02-11,Senate,"Constitutional reading dispensed (on 2nd reading) (40-Y 0-N)",40,0,0,0,40
1902337,1488166,2025-02-12,Senate,"Passed Senate (39-Y 0-N)",39,0,0,1,40
1902342,1471670,2025-01-15,House,"Subcommittee recommends reporting (5-Y 3-N)",5,3,0,1,9
1902342,1472094,2025-01-17,House,"Reported from Counties, Cities and Towns (17-Y 5-N)",17,5,0,0,22
1902342,1473577,2025-01-23,House,"Read third time and passed House (58-Y 39-N)",58,39,0,3,100
1902342,1484563,2025-02-10,Senate,"Reported from Local Government (12-Y 2-N)",12,2,0,1,15
1902342,1486155,2025-02-11,Senate,"Constitutional reading dispensed (on 2nd reading) (40-Y 0-N)",40,0,0,0,40
1902342,1488855,2025-02-12,Senate,"Passed Senate (22-Y 16-N)",22,16,0,2,40
1902348,1472111,2025-01-17,House,"Stricken from docket by Privileges and Elections (22-Y 0-N)",22,0,0,0,22
1902354,1472776,2025-01-21,House,"Subcommittee recommends reporting and referred to Appropriations (5-Y 3-N)",5,3,0,1,9
1902354,1476353,2025-01-29,House,"Reported from Education (12-Y 10-N)",12,10,0,0,22
1902354,1482326,2025-02-04,House,"Read third time and passed House (51-Y 48-N)",51,48,0,1,100
1902354,1489503,2025-02-13,Senate,"Reported from Education and Health (9-Y 6-N)",9,6,0,0,15
1902354,1490966,2025-02-17,Senate,"Constitutional reading dispensed (on 1st reading) (39-Y 0-N)",39,0,0,1,40
1902354,1495290,2025-02-19,Senate,"Passed Senate (21-Y 19-N)",21,19,0,0,40
1902359,1471787,2025-01-15,House,"Subcommittee recommends reporting (8-Y 0-N)",8,0,0,1,9
1902359,1471998,2025-01-16,House,"Reported from Transportation (21-Y 0-N)",21,0,0,1,22
1902359,1473012,2025-01-22,House,"Read third time and passed House (96-Y 0-N)",96,0,0,4,100
1902359,1473013,2025-01-22,House,"Passed House (97-Y 0-N)",97,0,0,3,100
1902359,1483757,2025-02-06,Senate,"Reported from Transportation (13-Y 0-N 1-A)",13,0,1,1,15
1902359,1484671,2025-02-10,Senate,"Constitutional reading dispensed (on 2nd reading) (39-Y 0-N)",39,0,0,1,40
1902359,1489760,2025-02-12,Senate,"Passed Senate (36-Y 2-N)",36,2,0,2,40
1902374,1473548,2025-01-23,Senate,"Reported from Education and Health with substitute and rereferred to Finance and Appropriations (15-Y 0-N)",15,0,0,0,15
1902387,1476999,2025-01-29,House,"Reported from Rules and referred to Appropriations (14-Y 0-N)",14,0,0,4,18
1902387,1478324,2025-01-31,House,"Reported from Appropriations (22-Y 0-N)",22,0,0,0,22
1902394,1471852,2025-01-15,House,"Subcommittee recommends reporting with amendment(s) (8-Y 0-N)",8,0,0,1,9
1902394,1472216,2025-01-17,House,"Reported from Courts of Justice with amendment(s) (22-Y 0-N)",22,0,0,0,22
1902394,1473590,2025-01-23,House,"Read third time and passed House (97-Y 0-N)",97,0,0,3,100
1902394,1483205,2025-02-05,Senate,"Reported from Courts of Justice (14-Y 0-N)",14,0,0,1,15
1902394,1484037,2025-02-07,Senate,"Constitutional reading dispensed (on 2nd reading) (38-Y 0-N)",38,0,0,2,40
1902394,1485056,2025-02-10,Senate,"Passed Senate (39-Y 0-N)",39,0,0,1,40
1902396,1472358,2025-01-20,House,"Subcommittee recommends reporting (7-Y 1-N)",7,1,0,1,9
1902396,1474731,2025-01-24,House,"Reported from Courts of Justice (21-Y 1-N)",21,1,0,0,22
1902396,1478556,2025-01-30,House,"Read third time and passed House (95-Y 0-N)",95,0,0,5,100
1902396,1483024,2025-02-05,Senate,"Reported from Courts of Justice (14-Y 0-N)",14,0,0,1,15
1902396,1483893,2025-02-07,Senate,"Constitutional reading dispensed (on 2nd reading) (38-Y 0-N)",38,0,0,2,40
1902396,1484627,2025-02-10,Senate,"Passed Senate (39-Y 0-N)",39,0,0,1,40
1902402,1472351,2025-01-20,House,"Subcommittee recommends reporting with substitute (7-Y 1-N)",7,1,0,1,9
1902402,1474663,2025-01-24,House,"Reported from Courts of Justice with substitute (21-Y 1-N)",21,1,0,0,22
1902402,1478096,2025-01-30,House,"Read third time and passed House (96-Y 0-N)",96,0,0,4,100
1902402,1488503,2025-02-12,Senate,"Reported from Courts of Justice (15-Y 0-N)",15,0,0,0,15
1902402,1490238,2025-02-14,Senate,"Constitutional reading dispensed (on 2nd reading) (36-Y 0-N)",36,0,0,4,40
1902402,1491094,2025-02-17,Senate,"Passed Senate (39-Y 0-N)",39,0,0,1,40
1902407,1474005,2025-01-23,House,"Subcommittee recommends reporting with amendment(s) and referring to Appropriations (6-Y 2-N)",6,2,0,1,9
1902407,1475987,2025-01-28,House,"Reported from General Laws with amendment(s) and referred to Appropriations (13-Y 9-N)",13,9,0,0,22
1902412,1471482,2025-01-14,House,"Subcommittee recommends reporting and referred to Appropriations (5-Y 3-N)",5,3,0,1,9
1902412,1471687,2025-01-15,House,"Reported from Education and referred to Appropriations (11-Y 10-N)",11,10,0,1,22
1902416,1472308,2025-01-20,House,"Subcommittee recommends laying on the table (5-Y 3-N)",5,3,0,1,9
1902420,1471481,2025-01-14,House,"Subcommittee recommends reporting and referred to Appropriations (5-Y 3-N)",5,3,0,1,9
1902420,1471685,2025-01-15,House,"Reported from Education and referred to Appropriations (11-Y 10-N)",11,10,0,1,22
1902420,1476455,2025-01-29,House,"Subcommittee recommends reporting with substitute (6-Y 1-N)",6,1,0,2,9
1902420,1478283,2025-01-31,House,"Reported from Appropriations with substitute (19-Y 3-N)",19,3,0,0,22
1902420,1482159,2025-02-04,House,"Read third time and passed House (68-Y 30-N)",68,30,0,2,100
1902420,1489505,2025-02-13,Senate,"Reported from Education and Health (14-Y 0-N)",14,0,0,1,15
1902420,1491026,2025-02-17,Senate,"Constitutional reading dispensed (on 2nd reading)",39,0,0,1,40
1902420,1492298,2025-02-18,Senate,"Passed Senate (40-Y 0-N)",40,0,0,0,40
1902429,1474073,2025-01-23,House,"Subcommittee recommends reporting and referring to Appropriations (8-Y 0-N)",8,0,0,1,9
1902429,1475579,2025-01-28,House,"Reported from Health and Human Services and referred to Appropriations (21-Y 0-N)",21,0,0,1,22
1902429,1476611,2025-01-29,House,"Subcommittee recommends reporting (6-Y 0-N)",6,0,0,3,9
1902429,1478285,2025-01-31,House,"Reported from Appropriations (22-Y 0-N)",22,0,0,0,22
1902429,1479529,2025-02-04,House,"Read third time and passed House (97-Y 0-N)",97,0,0,3,100
1902429,1479530,2025-02-04,House,"Passed House (99-Y 0-N)",99,0,0,1,100
1902429,1489628,2025-02-13,Senate,"Reported from Education and Health with substitute (15-Y 0-N)",15,0,0,0,15
1902429,1491096,2025-02-17,Senate,"Constitutional reading dispensed (on 2nd reading)",39,0,0,1,40
1902429,1493073,2025-02-18,Senate,"Passed Senate with substitute (40-Y 0-N)",40,0,0,0,40
1902429,1495352,2025-02-19,House,"Senate substitute agreed to by House (96-Y 0-N)",96,0,0,4,100
1902436,1471733,2025-01-15,House,"Subcommittee recommends laying on the table (6-Y 4-N)",6,4,0,1,11
1902442,1472438,2025-01-20,House,"Subcommittee recommends reporting with amendment(s) (10-Y 0-N)",10,0,0,1,11
1902442,1473156,2025-01-22,House,"Reported from Agriculture, Chesapeake and Natural Resources with amendment(s) (22-Y 0-N)",22,0,0,0,22
1902442,1476487,2025-01-28,House,"Read third time and passed House (99-Y 0-N)",99,0,0,1,100
1902442,1488194,2025-02-11,Senate,"Reported from Agriculture, Conservation and Natural Resources (14-Y 0-N)",14,0,0,1,15
1902442,1489065,2025-02-13,Senate,"Constitutional reading dispensed (on 2nd reading) (40-Y 0-N)",40,0,0,0,40
1902442,1490300,2025-02-14,Senate,"Passed Senate (36-Y 0-N)",36,0,0,4,40
1902461,1473793,2025-01-16,Senate,"Rereferred from Transportation to Courts of Justice (14-Y 0-N)",14,0,0,1,15
1902461,1476904,2025-01-29,Senate,"Reported from Courts of Justice with amendment (15-Y 0-N)",15,0,0,0,15
1902461,1478095,2025-01-31,Senate,"Constitutional reading dispensed (on 1st reading) (39-Y 0-N)",39,0,0,1,40
1902461,1480245,2025-02-03,Senate,"Constitutional reading dispensed (on 3rd reading) (40-Y 0-N)",40,0,0,0,40
1902461,1480246,2025-02-03,Senate,"Passed Senate (40-Y 0-N)",40,0,0,0,40
1902461,1488518,2025-02-12,House,"Subcommittee recommends reporting (8-Y 0-N)",8,0,0,1,9
1902461,1490498,2025-02-14,House,"Reported from Courts of Justice (21-Y 0-N)",21,0,0,1,22
1902461,1494665,2025-02-19,House,"Passed House (97-Y 0-N)",97,0,0,3,100
1902468,1473142,2025-01-22,House,"Subcommittee recommends reporting with substitute (8-Y 0-N)",8,0,0,1,9
1902468,1474519,2025-01-24,House,"Reported from Appropriations with substitute (22-Y 0-N)",22,0,0,0,22
1902468,1478064,2025-01-30,House,"Read third time and passed House (90-Y 6-N)",90,6,0,4,100
1902468,1488067,2025-02-12,Senate,"Reported from Finance and Appropriations (15-Y 0-N)",15,0,0,0,15
1902468,1489195,2025-02-13,Senate,"Constitutional reading dispensed (on 2nd reading) (40-Y 0-N)",40,0,0,0,40
1902468,1490181,2025-02-14,Senate,"Passed Senate (36-Y 0-N)",36,0,0,4,40
1902475,1472958,2025-01-22,Senate,"Reported from Finance and Appropriations (10-Y 5-N)",10,5,0,0,15
1902475,1473757,2025-01-17,Senate,"Reported from Courts of Justice and rereferred to Finance and Appropriations (9-Y 6-N)",9,6,0,0,15
1902475,1473758,2025-01-23,Senate,"Constitutional reading dispensed (on 1st reading) (39-Y 0-N)",39,0,0,1,40
1902475,1475404,2025-01-27,Senate,"Read third time and passed Senate (19-Y 18-N)",19,18,0,3,40
1902475,1475405,2025-01-27,Senate,"Reconsideration of passage agreed to by Senate",37,0,0,3,40
1902475,1475406,2025-01-27,Senate,"Passed Senate (20-Y 18-N)",20,18,0,2,40
1902475,1483941,2025-02-07,House,"Reported from Public Safety (11-Y 10-N)",11,10,0,1,22
1902475,1487716,2025-02-12,House,"Passed House (50-Y 47-N)",50,47,0,3,100
1902480,1471720,2025-01-15,Senate,"Reported from Courts of Justice with substitute (15-Y 0-N)",15,0,0,0,15
1902480,1472128,2025-01-17,Senate,"Constitutional reading dispensed (on 1st reading) (40-Y 0-N)",40,0,0,0,40
1902480,1472629,2025-01-21,Senate,"Read third time and passed Senate (40-Y 0-N)",40,0,0,0,40
1902480,1482467,2025-02-05,House,"Reported from Courts of Justice with amendment(s) (21-Y 1-N)",21,1,0,0,22
1902480,1484615,2025-02-10,House,"Passed House with amendment (90-Y 5-N)",90,5,0,5,100
1902480,1487537,2025-02-12,Senate,"House Amendment rejected by Senate (1-Y 38-N)",1,38,0,1,40
1902480,1491230,2025-02-17,Senate,"Senate acceded to request (39-Y 0-N)",39,0,0,1,40
1902480,1496551,2025-02-21,Senate,"Conference report agreed to by Senate (40-Y 0-N)",40,0,0,0,40
1902480,1565085,2025-02-20,House,"Conference report agreed to by House (98-Y 0-N)",98,0,0,2,100
1902484,1474406,2025-01-24,House,"Subcommittee recommends laying on the table (7-Y 1-N)",7,1,0,1,9
1902501,1472294,2025-01-20,House,"Subcommittee recommends passing by indefinitely (6-Y 4-N)",6,4,0,1,11
1902505,1471904,2025-01-16,House,"Subcommittee recommends reporting with amendment(s) and referred to Appropriations (8-Y 0-N)",8,0,0,1,9
1902505,1472555,2025-01-21,House,"Reported from Health and Human Services with amendment(s) and referred to Appropriations (22-Y 0-N)",22,0,0,0,22
1902505,1474401,2025-01-24,House,"Subcommittee recommends laying on the table (7-Y 0-N)",7,0,0,2,9
1902508,1475268,2025-01-28,House,"Subcommittee recommends reporting (5-Y 3-N)",5,3,0,1,9
1902508,1476183,2025-01-29,House,"Reported from Education (12-Y 9-N)",12,9,0,1,22
1902508,1480815,2025-02-04,House,"Read third time and passed House (51-Y 48-N)",51,48,0,1,100
1902508,1489519,2025-02-13,Senate,"Reported from Education and Health with amendments (10-Y 5-N)",10,5,0,0,15
1902508,1491015,2025-02-17,Senate,"Constitutional reading dispensed (on 1st reading) (39-Y 0-N)",39,0,0,1,40
1902508,1495319,2025-02-19,Senate,"Passed Senate with amendments (24-Y 16-N)",24,16,0,0,40
1902508,1496460,2025-02-20,House,"Senate Amendments agreed to by House (52-Y 46-N)",52,46,0,2,100
1902508,1536640,2025-04-02,House,"House rejected Governor's recommendation (26-Y 70-N)",26,70,0,4,100
1902508,1536641,2025-04-02,House,"Motion to pass in enrolled form rejected (51-Y 45-N)",51,45,0,4,100
1902530,1472023,2025-01-16,House,"Subcommittee recommends laying on the table (4-Y 3-N)",4,3,0,2,9
1902536,1477452,2025-01-30,House,"Subcommittee recommends reporting with substitute (8-Y 0-N)",8,0,0,1,9
1902536,1477692,2025-01-30,House,"Reported from General Laws with substitute (19-Y 2-N)",19,2,0,1,22
1902536,1482443,2025-02-04,House,"Read third time and passed House (91-Y 6-N)",91,6,0,3,100
1902536,1488141,2025-02-12,Senate,"Reported from General Laws and Technology (15-Y 0-N)",15,0,0,0,15
1902536,1490019,2025-02-14,Senate,"Constitutional reading dispensed (on 2nd reading) (36-Y 0-N)",36,0,0,4,40
1902536,1491180,2025-02-17,Senate,"Passed Senate (39-Y 0-N)",39,0,0,1,40
1902536,1536217,2025-04-02,House,"Passed by for the day",47,46,0,7,100
1902541,1475430,2025-01-28,House,"Reported from Transportation with substitute (22-Y 0-N)",22,0,0,0,22
1902541,1479525,2025-02-03,House,"Read third time and passed House (98-Y 0-N)",98,0,0,2,100
1902541,1479526,2025-02-03,House,"Read third time and passed House (99-Y 0-N)",99,0,0,1,100
1902541,1489560,2025-02-13,Senate,"Reported from Transportation (13-Y 0-N)",13,0,0,2,15
1902541,1491054,2025-02-17,Senate,"Constitutional reading dispensed (on 2nd reading)",39,0,0,1,40
1902541,1492294,2025-02-18,Senate,"Passed Senate (40-Y 0-N)",40,0,0,0,40
1902547,1471533,2025-01-13,Senate,"Reported from Local Government (10-Y 0-N 3-A)",10,0,3,0,13
1902547,1471636,2025-01-14,Senate,"Constitutional reading dispensed (on 1st reading) (37-Y 0-N)",37,0,0,1,38
1902547,1474080,2025-01-17,Senate,"Read third time and passed Senate (38-Y 1-N)",38,1,0,1,40
1902547,1480471,2025-02-05,House,"Subcommittee recommends reporting (8-Y 0-N)",8,0,0,1,9
1902547,1483963,2025-02-07,House,"Reported from Counties, Cities and Towns (21-Y 0-N)",21,0,0,1,22
1902547,1488726,2025-02-12,House,"Passed House (91-Y 3-N)",91,3,0,6,100
1902553,1478103,2025-01-31,House,"Tabled in Finance (12-Y 8-N)",12,8,0,2,22
1902558,1473654,2025-01-23,House,"Subcommittee recommends reporting (8-Y 0-N)",8,0,0,1,9
1902558,1475549,2025-01-28,House,"Reported from Health and Human Services (21-Y 0-N)",21,0,0,1,22
1902558,1479690,2025-02-03,House,"Read third time and passed House (98-Y 0-N)",98,0,0,2,100
1902558,1479691,2025-02-03,House,"Read third time and passed House (99-Y 0-N)",99,0,0,1,100
1902558,1489880,2025-02-13,Senate,"Reported from Education and Health (13-Y 0-N)",13,0,0,2,15
1902558,1492775,2025-02-17,Senate,"Constitutional reading dispensed (on 2nd reading)",39,0,0,1,40
1902558,1492776,2025-02-18,Senate,"Passed Senate (40-Y 0-N)",40,0,0,0,40
1902563,1471877,2025-01-16,House,"Subcommittee recommends reporting with substitute (7-Y 1-N)",7,1,0,1,9
1902563,1472096,2025-01-17,House,"Reported from Counties, Cities and Towns with substitute (22-Y 0-N)",22,0,0,0,22
1902563,1473565,2025-01-23,House,"Read third time and passed House (97-Y 0-N)",97,0,0,3,100
1902563,1484569,2025-02-10,Senate,"Reported from Local Government and rereferred to Finance and Appropriations (13-Y 2-N)",13,2,0,0,15
1902563,1487420,2025-02-12,Senate,"Reported from Finance and Appropriations with substitute (15-Y 0-N)",15,0,0,0,15
1902563,1489039,2025-02-13,Senate,"Constitutional reading dispensed (on 2nd reading) (40-Y 0-N)",40,0,0,0,40
1902563,1490302,2025-02-14,Senate,"Passed Senate with substitute (35-Y 0-N)",35,0,0,5,40
1902563,1493129,2025-02-18,House,"Senate substitute agreed to by House (95-Y 1-N)",95,1,0,4,100
1902569,1471661,2025-01-14,House,"Subcommittee recommends reporting (8-Y 0-N)",8,0,0,1,9
1902569,1471796,2025-01-15,House,"Reported from Education (21-Y 0-N)",21,0,0,1,22
1902569,1472656,2025-01-21,House,"Read third time and passed House (96-Y 0-N)",96,0,0,4,100
1902569,1489613,2025-02-13,Senate,"Reported from Education and Health (15-Y 0-N)",15,0,0,0,15
1902569,1491168,2025-02-17,Senate,"Constitutional reading dispensed (on 2nd reading)",39,0,0,1,40
1902569,1492104,2025-02-18,Senate,"Passed Senate (40-Y 0-N)",40,0,0,0,40
1902574,1473290,2025-01-22,Senate,"Stricken at request of Patron in General Laws and Technology (12-Y 0-N)",12,0,0,3,15
1902586,1471898,2025-01-16,House,"Subcommittee recommends reporting with substitute (8-Y 0-N)",8,0,0,1,9
1902586,1472557,2025-01-21,House,"Reported from Health and Human Services with substitute (22-Y 0-N)",22,0,0,0,22
1902586,1474935,2025-01-27,House,"Read third time and passed House (97-Y 0-N)",97,0,0,3,100
1902586,1489192,2025-02-13,Senate,"Reported from Education and Health (15-Y 0-N)",15,0,0,0,15
1902586,1491274,2025-02-17,Senate,"Constitutional reading dispensed (on 2nd reading)",39,0,0,1,40
1902586,1492327,2025-02-18,Senate,"Passed Senate (40-Y 0-N)",40,0,0,0,40
1902590,1474524,2025-01-24,House,"Subcommittee recommends reporting with substitute (8-Y 0-N)",8,0,0,1,9
1902590,1477026,2025-01-29,House,"Reported from Courts of Justice with substitute (22-Y 0-N)",22,0,0,0,22
1902590,1480618,2025-02-04,House,"Read third time and passed House (97-Y 0-N)",97,0,0,3,100
1902590,1480619,2025-02-04,House,"Passed House (99-Y 0-N)",99,0,0,1,100
1902590,1484622,2025-02-10,Senate,"Reported from Courts of Justice (12-Y 0-N)",12,0,0,3,15
1902590,1486016,2025-02-11,Senate,"Constitutional reading dispensed (on 2nd reading) (40-Y 0-N)",40,0,0,0,40
1902590,1489766,2025-02-12,Senate,"Passed Senate (39-Y 0-N)",39,0,0,1,40
1902595,1474025,2025-01-23,House,"Subcommittee recommends laying on the table (6-Y 4-N)",6,4,0,1,11
1902601,1473344,2025-01-22,House,"Subcommittee recommends reporting with substitute (7-Y 1-N)",7,1,0,1,9
1902601,1474717,2025-01-24,House,"Reported from Courts of Justice with substitute (13-Y 9-N)",13,9,0,0,22
1902601,1478898,2025-02-03,House,"Read third time and passed House (59-Y 40-N)",59,40,0,1,100
1902601,1490798,2025-02-17,Senate,"Reported from Courts of Justice with amendments (11-Y 3-N 1-A)",11,3,1,0,15
1902601,1492843,2025-02-18,Senate,"Constitutional reading dispensed (on 2nd reading) (39-Y 0-N)",39,0,0,1,40
1902601,1494376,2025-02-19,Senate,"Passed Senate with amendments (39-Y 1-N)",39,1,0,0,40
1902601,1496224,2025-02-20,House,"Senate Amendments agreed to by House (55-Y 42-N)",55,42,0,3,100
1902601,1535544,2025-04-02,House,"House concurred in Governor's recommendation (95-Y 1-N)",95,1,0,4,100
1902601,1535545,2025-04-02,Senate,"Senate concurred in Governor's recommendation (36-Y 4-N)",36,4,0,0,40
1902606,1474888,2025-01-27,House,"Subcommittee recommends laying on the table (5-Y 3-N)",5,3,0,1,9
1902617,1471788,2025-01-15,Senate,"Reported from Courts of Justice and rereferred to Finance and Appropriations (15-Y 0-N)",15,0,0,0,15
1902617,1473969,2025-01-22,Senate,"Reported from Finance and Appropriations (15-Y 0-N)",15,0,0,0,15
1902617,1473970,2025-01-23,Senate,"Constitutional reading dispensed (on 1st reading) (39-Y 0-N)",39,0,0,1,40
1902617,1475280,2025-01-27,Senate,"Read third time and passed Senate (38-Y 0-N)",38,0,0,2,40
1902617,1484098,2025-02-07,House,"Reported from Public Safety with substitute (20-Y 1-N)",20,1,0,1,22
1902617,1565410,2025-02-12,House,"Passed House (97-Y 0-N)",97,0,0,3,100
1902623,1478027,2025-01-31,Senate,"Reported from Rehabilitation and Social Services (14-Y 0-N)",14,0,0,1,15
1902623,1479762,2025-02-04,Senate,"Constitutional reading dispensed (on 3rd reading) (39-Y 0-N)",39,0,0,1,40
1902623,1479763,2025-02-04,Senate,"Passed Senate (39-Y 1-N)",39,1,0,0,40
1902623,1480268,2025-02-03,Senate,"Constitutional reading dispensed (on 1st reading) (40-Y 0-N)",40,0,0,0,40
1902623,1486337,2025-02-11,House,"Subcommittee recommends reporting (6-Y 1-N)",6,1,0,2,9
1902623,1489266,2025-02-13,House,"Reported from General Laws (18-Y 1-N)",18,1,0,3,22
1902623,1491835,2025-02-18,House,"Passed House (87-Y 8-N)",87,8,0,5,100
1902635,1473491,2025-01-23,House,"Subcommittee recommends reporting with substitute (8-Y 0-N)",8,0,0,1,9
1902635,1475622,2025-01-28,House,"Reported from Health and Human Services with substitute (21-Y 0-N)",21,0,0,1,22
1902635,1479764,2025-02-03,House,"Read third time and passed House (98-Y 0-N)",98,0,0,2,100
1902635,1489687,2025-02-13,Senate,"Reported from Education and Health (15-Y 0-N)",15,0,0,0,15
1902635,1491126,2025-02-17,Senate,"Constitutional reading dispensed (on 2nd reading)",39,0,0,1,40
1902635,1493087,2025-02-18,Senate,"Passed Senate (40-Y 0-N)",40,0,0,0,40
1902641,1471476,2025-01-14,House,"Subcommittee recommends reporting with amendment(s) and referred to Appropriations (8-Y 0-N)",8,0,0,1,9
1902641,1471690,2025-01-15,House,"Reported from Education with amendment(s) and referred to Appropriations (21-Y 0-N)",21,0,0,1,22
1902641,1472457,2025-01-20,House,"Subcommittee recommends laying on the table (8-Y 0-N)",8,0,0,1,9
1902646,1476352,2025-01-29,House,"Reported from Agriculture, Chesapeake and Natural Resources with substitute and referred to Appropriations (22-Y 0-N)",22,0,0,0,22
1902646,1478205,2025-01-31,House,"Reported from Appropriations (22-Y 0-N)",22,0,0,0,22
1902646,1480714,2025-02-04,House,"Read third time and passed House (97-Y 0-N)",97,0,0,3,100
1902646,1480715,2025-02-04,House,"Passed House (99-Y 0-N)",99,0,0,1,100
1902646,1486643,2025-02-11,Senate,"Reported from Agriculture, Conservation and Natural Resources with amendment and rereferred to Finance and Appropriations (15-Y 0-N)",15,0,0,0,15
1902646,1490183,2025-02-14,Senate,"Reported from Finance and Appropriations (13-Y 0-N)",13,0,0,2,15
1902646,1490957,2025-02-17,Senate,"Constitutional reading dispensed (on 2nd reading) (39-Y 0-N)",39,0,0,1,40
1902646,1492236,2025-02-18,Senate,"Passed Senate with amendment (40-Y 0-N)",40,0,0,0,40
1902646,1495300,2025-02-19,House,"Senate Amendment agreed to by House (96-Y 0-N)",96,0,0,4,100
1902646,1536578,2025-04-02,House,"Passed by for the day (47-Y 46-N)",47,46,0,7,100
1902657,1473439,2025-01-23,House,"Subcommittee recommends reporting with amendment(s) (8-Y 0-N)",8,0,0,1,9
1902657,1476014,2025-01-28,House,"Reported from Health and Human Services with amendment(s) (22-Y 0-N)",22,0,0,0,22
1902657,1479089,2025-02-03,House,"Read third time and passed House (92-Y 5-N)",92,5,0,3,100
1902657,1489558,2025-02-13,Senate,"Reported from Education and Health (15-Y 0-N)",15,0,0,0,15
1902657,1491638,2025-02-17,Senate,"Constitutional reading dispensed (on 2nd reading)",39,0,0,1,40
1902657,1493144,2025-02-18,Senate,"Passed Senate (40-Y 0-N)",40,0,0,0,40
1902660,1471989,2025-01-16,House,"Subcommittee recommends striking from the docket (8-Y 0-N)",8,0,0,1,9
1902665,1472304,2025-01-20,House,"Subcommittee recommends reporting (8-Y 0-N)",8,0,0,1,9
1902665,1473277,2025-01-22,House,"Reported from Finance with amendment(s) (22-Y 0-N)",22,0,0,0,22
1902665,1477767,2025-01-28,House,"Read third time and passed House (99-Y 0-N)",99,0,0,1,100
1902665,1492161,2025-02-17,Senate,"Reported from Finance and Appropriations with substitute (14-Y 0-N)",14,0,0,1,15
1902665,1493601,2025-02-19,Senate,"Constitutional reading dispensed (on 2nd reading) (40-Y 0-N)",40,0,0,0,40
1902665,1496383,2025-02-20,Senate,"Passed Senate with substitute (39-Y 0-N)",39,0,0,1,40
1902665,1496384,2025-02-20,Senate,"Reconsideration of Senate passage agreed to by Senate (39-Y 0-N)",39,0,0,1,40
1902665,1496385,2025-02-20,Senate,"Substitute by Senator Rouse reconsidered",39,0,0,1,40
1902665,1496386,2025-02-20,Senate,"Committee substitute reconsidered (39-Y 0-N)",39,0,0,1,40
1902665,1496387,2025-02-20,Senate,"Passed Senate with substitute (39-Y 0-N)",39,0,0,1,40
1902665,1496811,2025-02-20,House,"Senate substitute agreed to by House (95-Y 0-N)",95,0,0,5,100
1902672,1473052,2025-01-22,House,"Subcommittee recommends reporting (10-Y 0-N)",10,0,0,1,11
1902672,1476366,2025-01-29,House,"Reported from Agriculture, Chesapeake and Natural Resources (22-Y 0-N)",22,0,0,0,22
1902672,1479646,2025-02-04,House,"Read third time and passed House (97-Y 0-N)",97,0,0,3,100
1902672,1479647,2025-02-04,House,"Passed House (99-Y 0-N)",99,0,0,1,100
1902672,1486640,2025-02-11,Senate,"Reported from Agriculture, Conservation and Natural Resources (14-Y 0-N)",14,0,0,1,15
1902672,1490097,2025-02-13,Senate,"Constitutional reading dispensed (on 2nd reading) (40-Y 0-N)",40,0,0,0,40
1902672,1490098,2025-02-14,Senate,"Passed Senate (36-Y 0-N)",36,0,0,4,40
1902675,1472771,2025-01-21,House,"Subcommittee recommends reporting with substitute (6-Y 4-N)",6,4,0,1,11
1902675,1473998,2025-01-23,House,"Reported from Labor and Commerce with substitute (12-Y 10-N)",12,10,0,0,22
1902675,1477332,2025-01-29,House,"Read third time and passed House (50-Y 47-N)",50,47,0,3,100
1902675,1491419,2025-02-17,Senate,"Reported from Commerce and Labor with amendments (9-Y 6-N)",9,6,0,0,15
1902675,1493438,2025-02-18,Senate,"Constitutional reading dispensed (on 2nd reading) (40-Y 0-N)",40,0,0,0,40
1902675,1495759,2025-02-19,Senate,"Passed Senate with amendments (21-Y 18-N)",21,18,0,1,40
1902675,1496718,2025-02-20,House,"Senate Amendments agreed to by House (52-Y 46-N)",52,46,0,2,100
1902675,1536503,2025-04-02,House,"Passed by for the day (47-Y 46-N)",47,46,0,7,100
1902682,1472886,2025-01-21,House,"Subcommittee recommends laying on the table (6-Y 2-N)",6,2,0,1,9
1902686,1472828,2025-01-21,Senate,"Incorporated by Privileges and Elections (SB1072-Peake) (15-Y 0-N)",15,0,0,0,15
1902691,1473202,2025-01-22,House,"Subcommittee recommends reporting with substitute (8-Y 0-N)",8,0,0,1,9
1902691,1474271,2025-01-24,House,"Reported from Appropriations with substitute (22-Y 0-N)",22,0,0,0,22
1902691,1478300,2025-01-30,House,"Read third time and passed House (96-Y 0-N)",96,0,0,4,100
1902691,1487402,2025-02-12,Senate,"Reported from Finance and Appropriations with substitute (15-Y 0-N)",15,0,0,0,15
1902691,1488999,2025-02-13,Senate,"Constitutional reading dispensed (on 2nd reading) (40-Y 0-N)",40,0,0,0,40
1902691,1490291,2025-02-14,Senate,"Passed Senate with substitute (36-Y 0-N)",36,0,0,4,40
1902691,1493089,2025-02-18,House,"Senate substitute agreed to by House (95-Y 0-N)",95,0,0,5,100
1902697,1473655,2025-01-17,Senate,"Passed by indefinitely in Courts of Justice (9-Y 6-N)",9,6,0,0,15
1902703,1471944,2025-01-16,House,"Subcommittee recommends reporting (8-Y 0-N)",8,0,0,1,9
1902703,1472661,2025-01-21,House,"Reported from Health and Human Services (22-Y 0-N)",22,0,0,0,22
1902703,1475265,2025-01-27,House,"Read third time and passed House (97-Y 0-N)",97,0,0,3,100
1902703,1483005,2025-02-06,Senate,"Reported from Education and Health (14-Y 0-N)",14,0,0,1,15
1902703,1484045,2025-02-07,Senate,"Constitutional reading dispensed (on 2nd reading) (38-Y 0-N)",38,0,0,2,40
1902703,1484719,2025-02-10,Senate,"Passed Senate (39-Y 0-N)",39,0,0,1,40
1902708,1472254,2025-01-17,House,"Subcommittee recommends reporting with substitute (5-Y 3-N)",5,3,0,1,9
1902708,1474749,2025-01-24,House,"Reported from Courts of Justice with substitute (13-Y 9-N)",13,9,0,0,22
1902708,1478541,2025-01-30,House,"Read third time and passed House (50-Y 46-N)",50,46,0,4,100
1902708,1488538,2025-02-12,Senate,"Reported from Courts of Justice (9-Y 6-N)",9,6,0,0,15
1902708,1490603,2025-02-14,Senate,"Constitutional reading dispensed (on 2nd reading) (36-Y 0-N)",36,0,0,4,40
1902708,1492519,2025-02-18,Senate,"Passed Senate (20-Y 19-N)",20,19,0,1,40
1902713,1472430,2025-01-20,House,"Subcommittee recommends laying on the table (7-Y 3-N)",7,3,0,1,11
1902718,1473493,2025-01-23,House,"Subcommittee recommends reporting with amendment(s) and referring to Appropriations (6-Y 0-N)",6,0,0,1,7
1902718,1474458,2025-01-24,House,"Reported from Public Safety with amendment(s) and referred to Appropriations (22-Y 0-N)",22,0,0,0,22
1902718,1476420,2025-01-29,House,"Subcommittee recommends reporting (7-Y 0-N)",7,0,0,2,9
1902718,1476874,2025-01-29,House,"Reported from Appropriations (21-Y 0-N)",21,0,0,1,22
1902718,1479527,2025-02-04,House,"Read third time and passed House (97-Y 0-N)",97,0,0,3,100
1902718,1479528,2025-02-04,House,"Passed House (99-Y 0-N)",99,0,0,1,100
1902718,1485347,2025-02-10,Senate,"Reported from Courts of Justice with amendments and rereferred to Finance and Appropriations (14-Y 0-N)",14,0,0,1,15
1902718,1490308,2025-02-14,Senate,"Reported from Finance and Appropriations (14-Y 0-N)",14,0,0,1,15
1902718,1490972,2025-02-17,Senate,"Constitutional reading dispensed (on 2nd reading) (39-Y 0-N)",39,0,0,1,40
1902718,1492501,2025-02-18,Senate,"Passed Senate (40-Y 0-N)",40,0,0,0,40
1902723,1475865,2025-01-28,House,"Subcommittee recommends reporting with substitute (8-Y 0-N)",8,0,0,1,9
1902723,1476283,2025-01-29,House,"Reported from Education with substitute (22-Y 0-N)",22,0,0,0,22
1902723,1479557,2025-02-04,House,"Read third time and passed House (97-Y 0-N)",97,0,0,3,100
1902723,1479558,2025-02-04,House,"Passed House (99-Y 0-N)",99,0,0,1,100
1902723,1489710,2025-02-13,Senate,"Reported from Education and Health (15-Y 0-N)",15,0,0,0,15
1902723,1491142,2025-02-17,Senate,"Constitutional reading dispensed (on 2nd reading)",39,0,0,1,40
1902723,1493112,2025-02-18,Senate,"Passed Senate (40-Y 0-N)",40,0,0,0,40
1902726,1473066,2025-01-22,House,"Subcommittee recommends reporting with substitute (8-Y 0-N)",8,0,0,1,9
1902726,1474694,2025-01-24,House,"Reported from Courts of Justice with substitute (21-Y 1-N)",21,1,0,0,22
1902726,1478580,2025-01-30,House,"Read third time and passed House (91-Y 5-N)",91,5,0,4,100
1902732,1475350,2025-01-28,House,"Subcommittee recommends reporting with amendment(s) and referring to Appropriations (8-Y 0-N)",8,0,0,1,9
1902732,1477189,2025-01-30,House,"Reported from Health and Human Services with amendment(s) and referred to Appropriations (21-Y 0-N)",21,0,0,1,22
1902732,1478457,2025-01-31,House,"Reported from Appropriations (22-Y 0-N)",22,0,0,0,22
1902732,1482491,2025-02-04,House,"Read third time and passed House (97-Y 0-N)",97,0,0,3,100
1902732,1482492,2025-02-04,House,"Passed House (99-Y 0-N)",99,0,0,1,100
1902732,1489809,2025-02-13,Senate,"Reported from Education and Health (13-Y 0-N)",13,0,0,2,15
1902732,1491431,2025-02-17,Senate,"Constitutional reading dispensed (on 2nd reading)",39,0,0,1,40
1902732,1492534,2025-02-18,Senate,"Passed Senate (40-Y 0-N)",40,0,0,0,40
1902737,1472544,2025-01-21,House,"Subcommittee recommends reporting with substitute (8-Y 0-N)",8,0,0,1,9
1902737,1473454,2025-01-23,House,"Reported from Health and Human Services with substitute (22-Y 0-N)",22,0,0,0,22
1902737,1477381,2025-01-29,House,"Read third time and passed House (97-Y 0-N)",97,0,0,3,100
1902737,1483118,2025-02-06,Senate,"Reported from Education and Health (14-Y 0-N)",14,0,0,1,15
1902737,1483883,2025-02-07,Senate,"Constitutional reading dispensed (on 2nd reading) (38-Y 0-N)",38,0,0,2,40
1902737,1484682,2025-02-10,Senate,"Passed Senate (39-Y 0-N)",39,0,0,1,40
1902743,1472405,2025-01-20,Senate,"Incorporated by Commerce and Labor (SB1301-McPike) (15-Y 0-N)",15,0,0,0,15
1902750,1474123,2025-01-23,House,"Subcommittee recommends laying on the table (8-Y 0-N)",8,0,0,1,9
1902755,1473864,2025-01-23,House,"Subcommittee recommends reporting (8-Y 0-N)",8,0,0,1,9
1902755,1476016,2025-01-28,House,"Reported from Health and Human Services (21-Y 0-N)",21,0,0,1,22
1902755,1478882,2025-02-03,House,"Read third time and passed House (98-Y 0-N)",98,0,0,2,100
1902755,1478883,2025-02-03,House,"Read third time and passed House (99-Y 0-N)",99,0,0,1,100
1902755,1489583,2025-02-13,Senate,"Reported from Education and Health (13-Y 0-N)",13,0,0,2,15
1902755,1491525,2025-02-17,Senate,"Constitutional reading dispensed (on 2nd reading)",39,0,0,1,40
1902755,1492732,2025-02-18,Senate,"Passed Senate (40-Y 0-N)",40,0,0,0,40
1902760,1474522,2025-01-24,House,"Subcommittee recommends striking from the docket (8-Y 0-N)",8,0,0,1,9
1902770,1476335,2025-01-29,Senate,"Reported from Courts of Justice with substitute (14-Y 0-N 1-A)",14,0,1,0,15
1902770,1478104,2025-01-31,Senate,"Constitutional reading dispensed (on 1st reading) (39-Y 0-N)",39,0,0,1,40
1902770,1482252,2025-02-04,Senate,"Read third time and passed Senate (40-Y 0-N)",40,0,0,0,40
1902770,1488083,2025-02-12,House,"Subcommittee recommends reporting and referring to Appropriations (8-Y 0-N)",8,0,0,1,9
1902774,1475032,2025-01-27,House,"Subcommittee recommends passing by indefinitely (7-Y 1-N)",7,1,0,1,9
1902782,1477629,2025-01-30,House,"Subcommittee recommends reporting with amendment(s) (5-Y 3-N)",5,3,0,1,9
1902782,1477709,2025-01-30,House,"Reported from General Laws with amendment(s) (12-Y 9-N)",12,9,0,1,22
1902782,1488179,2025-02-12,Senate,"Rereferred from General Laws and Technology to Courts of Justice (10-Y 0-N)",10,0,0,5,15
1902782,1490812,2025-02-17,Senate,"Reported from Courts of Justice (6-Y 4-N)",6,4,0,5,15
1902782,1493354,2025-02-18,Senate,"Constitutional reading dispensed (on 2nd reading) (39-Y 0-N)",39,0,0,1,40
1902782,1495741,2025-02-19,Senate,"Passed Senate (22-Y 18-N)",22,18,0,0,40
1902782,1495742,2025-02-19,Senate,"Reconsideration of Senate passage agreed to by Senate (39-Y 0-N)",39,0,0,1,40
1902782,1495743,2025-02-19,Senate,"Passed Senate (22-Y 18-N)",22,18,0,0,40
1902782,1564837,2025-02-04,House,"Read third time and passed House (51-Y 47-N)",51,47,0,2,100
1902786,1474153,2025-01-23,House,"Subcommittee recommends laying on the table (5-Y 2-N)",5,2,0,2,9
1902794,1471532,2025-01-13,Senate,"Reported from Commerce and Labor with substitute (12-Y 1-N 2-A)",12,1,2,0,15
1902794,1471711,2025-01-15,Senate,"Constitutional reading dispensed (on 1st reading) (38-Y 0-N)",38,0,0,0,38
1902794,1472381,2025-01-20,Senate,"Read third time and passed Senate (38-Y 2-N)",38,2,0,0,40
1902794,1483384,2025-02-06,House,"Reported from Labor and Commerce with substitute (17-Y 4-N)",17,4,0,1,22
1902794,1487542,2025-02-12,House,"Passed House with substitute (87-Y 10-N)",87,10,0,3,100
1902794,1490703,2025-02-14,Senate,"House substitute agreed to by Senate (35-Y 0-N)",35,0,0,5,40
1902797,1472406,2025-01-20,House,"Subcommittee recommends reporting with substitute (6-Y 0-N)",6,0,0,3,9
1902797,1474671,2025-01-24,House,"Reported from Courts of Justice with substitute (22-Y 0-N)",22,0,0,0,22
1902797,1478097,2025-01-30,House,"Read third time and passed House (96-Y 0-N)",96,0,0,4,100
1902797,1490840,2025-02-17,Senate,"Reported from Courts of Justice (15-Y 0-N)",15,0,0,0,15
1902797,1492019,2025-02-18,Senate,"Constitutional reading dispensed (on 2nd reading) (39-Y 0-N)",39,0,0,1,40
1902797,1494662,2025-02-19,Senate,"Passed Senate (40-Y 0-N)",40,0,0,0,40
1902802,1473926,2025-01-23,House,"Subcommittee recommends reporting with substitute (8-Y 0-N)",8,0,0,1,9
1902802,1475651,2025-01-28,House,"Reported from General Laws with substitute (17-Y 5-N)",17,5,0,0,22
1902802,1479845,2025-02-03,House,"Read third time and passed House (60-Y 39-N)",60,39,0,1,100
1902802,1488240,2025-02-12,Senate,"Reported from General Laws and Technology with substitute (10-Y 5-N)",10,5,0,0,15
1902802,1490335,2025-02-14,Senate,"Constitutional reading dispensed (on 2nd reading) (36-Y 0-N)",36,0,0,4,40
1902802,1492380,2025-02-18,Senate,"Passed Senate with substitute (23-Y 17-N)",23,17,0,0,40
1902802,1495381,2025-02-19,House,"Senate substitute agreed to by House (58-Y 39-N)",58,39,0,3,100
1902809,1471574,2025-01-14,House,"Subcommittee recommends reporting (8-Y 0-N)",8,0,0,1,9
1902809,1472468,2025-01-20,House,"Reported from Finance (22-Y 0-N)",22,0,0,0,22
1902809,1474442,2025-01-24,House,"Read third time and passed House (97-Y 0-N)",97,0,0,3,100
1902809,1486801,2025-02-11,Senate,"Reported from Finance and Appropriations (15-Y 0-N)",15,0,0,0,15
1902809,1486802,2025-02-11,Senate,"Constitutional reading dispensed (on 2nd reading) (40-Y 0-N)",40,0,0,0,40
1902809,1488143,2025-02-12,Senate,"Passed Senate (39-Y 0-N)",39,0,0,1,40
1902814,1472433,2025-01-20,House,"Subcommittee recommends reporting (10-Y 0-N)",10,0,0,1,11
1902814,1473145,2025-01-22,House,"Reported from Agriculture, Chesapeake and Natural Resources (22-Y 0-N)",22,0,0,0,22
1902814,1476462,2025-01-28,House,"Read third time and passed House (99-Y 0-N)",99,0,0,1,100
1902814,1486617,2025-02-11,Senate,"Reported from Agriculture, Conservation and Natural Resources and rereferred to Finance and Appropriations (15-Y 0-N)",15,0,0,0,15
1902814,1490182,2025-02-14,Senate,"Reported from Finance and Appropriations (14-Y 0-N)",14,0,0,1,15
1902814,1490956,2025-02-17,Senate,"Constitutional reading dispensed (on 2nd reading) (39-Y 0-N)",39,0,0,1,40
1902814,1492230,2025-02-18,Senate,"Passed Senate (40-Y 0-N)",40,0,0,0,40
1902818,1471894,2025-01-16,House,"Subcommittee recommends reporting with substitute (4-Y 2-N)",4,2,0,1,7
1902818,1472070,2025-01-17,House,"Reported from Public Safety with substitute (13-Y 9-N)",13,9,0,0,22
1902818,1476401,2025-01-29,House,"Subcommittee recommends reporting with substitute (5-Y 3-N)",5,3,0,1,9
1902818,1476797,2025-01-29,House,"Reported from Appropriations with substitute (14-Y 7-N)",14,7,0,1,22
1902818,1480582,2025-02-04,House,"Read third time and passed House (54-Y 43-N 1-A)",54,43,1,2,100
1902818,1483874,2025-02-07,Senate,"Reported from Rehabilitation and Social Services (9-Y 6-N)",9,6,0,0,15
1902818,1486247,2025-02-10,Senate,"Constitutional reading dispensed (on 2nd reading) (39-Y 0-N)",39,0,0,1,40
1902818,1487487,2025-02-12,Senate,"Passed Senate (22-Y 16-N)",22,16,0,2,40
1902818,1487488,2025-02-12,Senate,"Reconsideration of Senate passage agreed to by Senate (36-Y 0-N)",36,0,0,4,40
1902818,1487489,2025-02-12,Senate,"Passed Senate (24-Y 14-N)",24,14,0,2,40
1902824,1473902,2025-01-23,House,"Subcommittee recommends reporting and referring to Appropriations (5-Y 3-N)",5,3,0,3,11
1902824,1474239,2025-01-24,House,"Reported from Public Safety and referred to Appropriations (12-Y 10-N)",12,10,0,0,22
1902824,1476393,2025-01-29,House,"Subcommittee recommends reporting (5-Y 3-N)",5,3,0,1,9
1902824,1476792,2025-01-29,House,"Reported from Appropriations (12-Y 9-N)",12,9,0,1,22
1902824,1482235,2025-02-04,House,"Read third time and passed House 52-Y 46-N 0-A)",52,46,0,2,100
1902824,1484758,2025-02-10,Senate,"Reported from Courts of Justice with substitute and rereferred to Finance and Appropriations (9-Y 5-N)",9,5,0,1,15
1902824,1487386,2025-02-12,Senate,"Reported from Finance and Appropriations with substitute (10-Y 5-N)",10,5,0,0,15
1902824,1488925,2025-02-13,Senate,"Constitutional reading dispensed (on 2nd reading) (40-Y 0-N)",40,0,0,0,40
1902824,1493378,2025-02-18,Senate,"Passed Senate with substitute (22-Y 18-N)",22,18,0,0,40
1902824,1493379,2025-02-19,House,"Senate substitute agreed to by House (53-Y 44-N)",53,44,0,3,100
1902824,1536184,2025-04-02,House,"House sustained Governor's veto (50-Y 46-N)",50,46,0,4,100
1902828,1476688,2025-01-29,House,"Reported from Rules (11-Y 4-N)",11,4,0,3,18
1902828,1480185,2025-02-03,House,"Agreed to by House (50-Y 46-N)",50,46,0,4,100
1902828,1492136,2025-02-17,Senate,"Reported from Finance and Appropriations with substitute (10-Y 4-N)",10,4,0,1,15
1902828,1495224,2025-02-20,Senate,"Agreed to by Senate with substitute (20-Y 19-N)",20,19,0,1,40
1902828,1495875,2025-02-19,Senate,"Reading waived (on 2nd reading) (39-Y 0-N)",39,0,0,1,40
1902828,1495876,2025-02-20,House,"Senate substitute rejected by House (0-Y 95-N)",0,95,0,5,100
1902828,1495877,2025-02-20,Senate,"Senate insisted on substitute (38-Y 0-N)",38,0,0,2,40
1902828,1503764,2025-02-21,House,"Conference report agreed to by House (50-Y 46-N)",50,46,0,4,100
1902835,1473300,2025-01-22,Senate,"Incorporated by General Laws and Technology (SB996-Williams Graves) (15-Y 0-N)",15,0,0,0,15
1902846,1472789,2025-01-21,House,"Subcommittee recommends reporting with substitute (8-Y 2-N)",8,2,0,1,11
1902846,1474045,2025-01-23,House,"Reported from Labor and Commerce with substitute (22-Y 0-N)",22,0,0,0,22
1902846,1477349,2025-01-29,House,"Read third time and passed House (97-Y 0-N)",97,0,0,3,100
1902846,1491404,2025-02-17,Senate,"Reported from Commerce and Labor (15-Y 0-N)",15,0,0,0,15
1902846,1493407,2025-02-18,Senate,"Constitutional reading dispensed (on 2nd reading) (40-Y 0-N)",40,0,0,0,40
1902846,1495089,2025-02-19,Senate,"Passed Senate (40-Y 0-N)",40,0,0,0,40
1902852,1471641,2025-01-14,Senate,"Reported from Agriculture, Conservation and Natural Resources with amendments and rereferred to Finance and Appropriations (13-Y 0-N)",13,0,0,1,14
1902852,1472591,2025-01-21,Senate,"Reported from Finance and Appropriations (14-Y 0-N)",14,0,0,1,15
1902852,1473143,2025-01-22,Senate,"Constitutional reading dispensed (on 1st reading) (40-Y 0-N)",40,0,0,0,40
1902852,1474589,2025-01-24,Senate,"Read third time and passed Senate (38-Y 0-N)",38,0,0,2,40
1902852,1487364,2025-02-12,House,"Reported from Agriculture, Chesapeake and Natural Resources with amendment(s) (22-Y 0-N)",22,0,0,0,22
1902852,1490986,2025-02-17,House,"Passed House with amendments (89-Y 6-N)",89,6,0,5,100
1902852,1492248,2025-02-18,Senate,"House Amendments agreed to by Senate (40-Y 0-N)",40,0,0,0,40
1902858,1475864,2025-01-28,Senate,"Incorporated by Finance and Appropriations (SB782-Suetterlein) (15-Y 0-N)",15,0,0,0,15
1902868,1471662,2025-01-14,House,"Subcommittee recommends reporting with substitute (8-Y 0-N)",8,0,0,1,9
1902868,1471785,2025-01-15,House,"Reported from Education with substitute (21-Y 0-N)",21,0,0,1,22
1902868,1472843,2025-01-21,House,"Read third time and passed House (96-Y 0-N)",96,0,0,4,100
1902868,1489555,2025-02-13,Senate,"Reported from Education and Health (15-Y 0-N)",15,0,0,0,15
1902868,1491513,2025-02-17,Senate,"Constitutional reading dispensed (on 2nd reading)",39,0,0,1,40
1902868,1492322,2025-02-18,Senate,"Passed Senate (40-Y 0-N)",40,0,0,0,40
1902874,1473341,2025-01-22,House,"Subcommittee recommends reporting with substitute (8-Y 0-N)",8,0,0,1,9
1902874,1474668,2025-01-24,House,"Reported from Courts of Justice with substitute (22-Y 0-N)",22,0,0,0,22
1902874,1478481,2025-01-30,House,"Read third time and passed House (96-Y 0-N)",96,0,0,4,100
1902874,1488599,2025-02-12,Senate,"Reported from Courts of Justice with substitute (14-Y 1-N)",14,1,0,0,15
1902874,1490604,2025-02-14,Senate,"Constitutional reading dispensed (on 2nd reading) (36-Y 0-N)",36,0,0,4,40
1902874,1492524,2025-02-18,Senate,"Passed Senate with substitute (39-Y 0-N)",39,0,0,1,40
1902874,1492525,2025-02-18,Senate,"Reconsideration of Senate passage agreed to by Senate (39-Y 0-N)",40,0,0,0,40
1902874,1492526,2025-02-18,Senate,"Passed Senate with substitute (40-Y 0-N)",40,0,0,0,40
1902874,1494039,2025-02-19,House,"Senate substitute agreed to by House (96-Y 0-N)",96,0,0,4,100
1902879,1477675,2025-01-30,House,"Subcommittee recommends laying on the table (6-Y 2-N)",6,2,0,1,9
1902896,1476497,2025-01-29,Senate,"Reported from General Laws and Technology with substitute (15-Y 0-N)",15,0,0,0,15
1902896,1478599,2025-01-31,Senate,"Constitutional reading dispensed (on 1st reading) (39-Y 0-N)",39,0,0,1,40
1902896,1479926,2025-02-03,Senate,"Constitutional reading dispensed (on 3rd reading) (40-Y 0-N)",40,0,0,0,40
1902896,1479927,2025-02-03,Senate,"Passed Senate (40-Y 0-N)",40,0,0,0,40
1902896,1490751,2025-02-17,House,"Subcommittee recommends reporting with substitute (9-Y 0-N)",9,0,0,2,11
1902896,1490752,2025-02-17,House,"Reported from Communications, Technology and Innovation with substitute (22-Y 0-N)",22,0,0,0,22
1902896,1496566,2025-02-20,House,"Passed House with substitute (97-Y 0-N)",97,0,0,3,100
1902896,1496899,2025-02-20,Senate,"House substitute agreed to by Senate (39-Y 0-N)",39,0,0,1,40
1902896,1536790,2025-04-02,Senate,"Senate concurred in Governor's recommendation (40-Y 0-N)",40,0,0,0,40
1902907,1472796,2025-01-21,House,"Subcommittee recommends reporting with substitute (9-Y 1-N)",9,1,0,1,11
1902907,1473991,2025-01-23,House,"Reported from Labor and Commerce with substitute (22-Y 0-N)",22,0,0,0,22
1902907,1477370,2025-01-29,House,"Read third time and passed House (96-Y 0-N)",96,0,0,4,100
1902907,1491360,2025-02-17,Senate,"Reported from Commerce and Labor with amendments (8-Y 5-N)",8,5,0,2,15
1902907,1493347,2025-02-18,Senate,"Constitutional reading dispensed (on 2nd reading) (40-Y 0-N)",40,0,0,0,40
1902907,1495716,2025-02-19,Senate,"Passed Senate with amendments (23-Y 17-N)",23,17,0,0,40
1902907,1496683,2025-02-20,House,"Senate Amendments agreed to by House (58-Y 39-N)",58,39,0,3,100
1902907,1534909,2025-04-02,House,"House rejected Governor's recommendation (29-Y 67-N)",29,67,0,4,100
1902912,1472324,2025-01-20,House,"Subcommittee recommends reporting (10-Y 0-N)",10,0,0,1,11
1902912,1473016,2025-01-22,House,"Reported from Education (22-Y 0-N)",22,0,0,0,22
1902912,1476580,2025-01-28,House,"Read third time and passed House (99-Y 0-N)",99,0,0,1,100
1902912,1489523,2025-02-13,Senate,"Reported from Education and Health (15-Y 0-N)",15,0,0,0,15
1902912,1491011,2025-02-17,Senate,"Constitutional reading dispensed (on 2nd reading)",39,0,0,1,40
1902912,1492265,2025-02-18,Senate,"Passed Senate (40-Y 0-N)",40,0,0,0,40
1902921,1472773,2025-01-21,House,"Subcommittee recommends reporting with substitute and referred to Appropriations (7-Y 0-N)",7,0,0,1,8
1902921,1473981,2025-01-23,House,"Reported from Labor and Commerce with substitute and referred to Appropriations (22-Y 0-N)",22,0,0,0,22
1902921,1476613,2025-01-29,House,"Subcommittee recommends reporting (6-Y 0-N)",6,0,0,3,9
1902921,1478281,2025-01-31,House,"Reported from Appropriations (22-Y 0-N)",22,0,0,0,22
1902921,1482439,2025-02-04,House,"Read third time and passed House (97-Y 0-N)",97,0,0,3,100
1902921,1482440,2025-02-04,House,"Passed House (99-Y 0-N)",99,0,0,1,100
1902921,1485367,2025-02-10,Senate,"Reported from Commerce and Labor (15-Y 0-N)",15,0,0,0,15
1902921,1487711,2025-02-12,Senate,"Constitutional reading dispensed (on 2nd reading) (39-Y 0-N)",39,0,0,1,40
1902921,1490000,2025-02-13,Senate,"Passed Senate (40-Y 0-N)",40,0,0,0,40
1902926,1471915,2025-01-16,House,"Subcommittee recommends reporting and referred to Appropriations (8-Y 0-N)",8,0,0,1,9
1902926,1472612,2025-01-21,House,"Reported from Health and Human Services and referred to Appropriations (22-Y 0-N)",22,0,0,0,22
1902926,1476996,2025-01-29,House,"Subcommittee recommends laying on the table (5-Y 1-N)",5,1,0,3,9
1902931,1471846,2025-01-15,House,"Subcommittee recommends reporting (8-Y 0-N)",8,0,0,1,9
1902931,1472263,2025-01-17,House,"Reported from Courts of Justice (22-Y 0-N)",22,0,0,0,22
1902931,1473598,2025-01-23,House,"Read third time and passed House (97-Y 0-N)",97,0,0,3,100
1902931,1483030,2025-02-05,Senate,"Reported from Courts of Justice (14-Y 0-N)",14,0,0,1,15
1902931,1483908,2025-02-07,Senate,"Constitutional reading dispensed (on 2nd reading) (38-Y 0-N)",38,0,0,2,40
1902931,1485907,2025-02-10,Senate,"Passed Senate (39-Y 0-N)",39,0,0,1,40
1902947,1473728,2025-01-16,Senate,"Rereferred from Transportation to Commerce and Labor (14-Y 0-N)",14,0,0,1,15
1902947,1474643,2025-01-24,Senate,"Reported from Commerce and Labor and rereferred to Finance and Appropriations (9-Y 6-N)",9,6,0,0,15
1902947,1477092,2025-01-29,Senate,"Reported from Finance and Appropriations (10-Y 5-N)",10,5,0,0,15
1902947,1477894,2025-01-30,Senate,"Constitutional reading dispensed (on 1st reading) (39-Y 0-N 1-A)",39,0,1,0,40
1902947,1480252,2025-02-03,Senate,"Read third time and passed Senate (21-Y 19-N)",21,19,0,0,40
1902947,1489681,2025-02-13,House,"Reported from Labor and Commerce with substitute (12-Y 10-N)",12,10,0,0,22
1902947,1493034,2025-02-18,House,"Passed House with substitute (50-Y 47-N)",50,47,0,3,100
1902947,1494307,2025-02-19,Senate,"House substitute agreed to by Senate (23-Y 17-N)",23,17,0,0,40
1902947,1494308,2025-02-19,Senate,"Reconsideration of House substitute agreed to by Senate (40-Y 0-N)",40,0,0,0,40
1902947,1494309,2025-02-19,Senate,"House substitute agreed to by Senate (21-Y 19-N)",21,19,0,0,40
1902950,1473242,2025-01-22,Senate,"Incorporated by General Laws and Technology (SB996-Williams Graves) (15-Y 0-N)",15,0,0,0,15
1902954,1474485,2025-01-23,Senate,"Reported from Finance and Appropriations (9-Y 5-N)",9,5,0,1,15
1902954,1490810,2025-02-17,House,"Reported from Rules with amendment(s) (12-Y 6-N)",12,6,0,0,18
1902954,1496672,2025-02-20,House,"Agreed to by House with amendments (51-Y 47-N)",51,47,0,2,100
1902958,1471534,2025-01-13,Senate,"Reported from Local Government (13-Y 0-N)",13,0,0,0,13
1902958,1471535,2025-01-14,Senate,"Constitutional reading dispensed (on 1st reading) (37-Y 0-N)",37,0,0,1,38
1902958,1471945,2025-01-16,Senate,"Read third time and passed Senate (39-Y 0-N)",39,0,0,1,40
1902958,1487284,2025-02-12,House,"Subcommittee recommends reporting (8-Y 0-N)",8,0,0,1,9
1902958,1489983,2025-02-14,House,"Reported from Counties, Cities and Towns (21-Y 0-N)",21,0,0,1,22
1902958,1493155,2025-02-19,House,"Passed House (97-Y 0-N)",97,0,0,3,100
1902961,1471643,2025-01-14,Senate,"Passed by indefinitely in Agriculture, Conservation and Natural Resources (12-Y 1-N)",12,1,0,1,14
1902967,1471537,2025-01-13,Senate,"Passed by indefinitely in Commerce and Labor (8-Y 6-N 1-A)",8,6,1,0,15
1902970,1473742,2025-01-22,Senate,"Stricken at request of Patron in General Laws and Technology (11-Y 0-N)",11,0,0,4,15
1902975,1475050,2025-01-27,Senate,"Reported from Courts of Justice with substitute and rereferred to Finance and Appropriations (13-Y 1-N)",13,1,0,1,15
1902975,1477921,2025-01-29,Senate,"Reported from Finance and Appropriations with substitute (15-Y 0-N)",15,0,0,0,15
1902975,1477922,2025-01-30,Senate,"Constitutional reading dispensed (on 1st reading) (39-Y 0-N 1-A)",39,0,1,0,40
1902975,1479506,2025-02-03,Senate,"Read third time and passed Senate (39-Y 1-N)",39,1,0,0,40
1902975,1485054,2025-02-10,House,"Reported from Courts of Justice (22-Y 0-N)",22,0,0,0,22
1902975,1488890,2025-02-13,House,"Passed House (96-Y 0-N)",96,0,0,4,100
1902979,1476584,2025-01-28,Senate,"Reported from Agriculture, Conservation and Natural Resources (14-Y 0-N)",14,0,0,1,15
1902979,1477429,2025-01-30,Senate,"Constitutional reading dispensed (on 1st reading) (39-Y 0-N 1-A)",39,0,1,0,40
1902979,1479050,2025-01-31,Senate,"Constitutional reading dispensed (on 3rd reading) (40-Y 0-N)",40,0,0,0,40
1902979,1479051,2025-01-31,Senate,"Passed Senate (40-Y 0-N)",40,0,0,0,40
1902979,1487401,2025-02-12,House,"Reported from Agriculture, Chesapeake and Natural Resources (22-Y 0-N)",22,0,0,0,22
1902979,1491109,2025-02-17,House,"Passed House (95-Y 0-N)",95,0,0,5,100
1902979,1491110,2025-02-17,House,"Passed House (96-Y 0-N)",96,0,0,4,100
1902985,1471539,2025-01-13,Senate,"Reported from Commerce and Labor and rereferred to Finance and Appropriations (15-Y 0-N)",15,0,0,0,15
1902985,1475322,2025-01-28,Senate,"Reported from Finance and Appropriations (15-Y 0-N)",15,0,0,0,15
1902985,1476403,2025-01-29,Senate,"Constitutional reading dispensed (on 1st reading) (38-Y 0-N)",38,0,0,2,40
1902985,1477919,2025-01-30,Senate,"Read third time and passed Senate (40-Y 0-N)",40,0,0,0,40
1902985,1478520,2025-01-30,Senate,"Constitutional reading dispensed (on 3rd reading) (39-Y 1-N)",39,1,0,0,40
1902985,1478521,2025-01-30,Senate,"Passed Senate (40-Y 0-N)",39,1,0,0,40
1902985,1483623,2025-02-06,House,"Reported from Labor and Commerce (21-Y 0-N)",21,0,0,1,22
1902985,1486058,2025-02-11,House,"Passed House (94-Y 0-N)",94,0,0,6,100
1902987,1473768,2025-01-23,Senate,"Stricken at request of Patron in Transportation (14-Y 0-N)",14,0,0,1,15
1902994,1475285,2025-01-27,Senate,"Reported from Courts of Justice and rereferred to Finance and Appropriations (14-Y 0-N)",14,0,0,1,15
1902994,1477181,2025-01-29,Senate,"Reported from Finance and Appropriations with substitute (15-Y 0-N)",15,0,0,0,15
1902994,1477561,2025-01-30,Senate,"Constitutional reading dispensed (on 1st reading) (39-Y 0-N 1-A)",39,0,1,0,40
1902994,1479202,2025-01-31,Senate,"Constitutional reading dispensed (on 3rd reading) (40-Y 0-N)",40,0,0,0,40
1902994,1479203,2025-01-31,Senate,"Passed Senate (40-Y 0-N)",40,0,0,0,40
1902994,1485340,2025-02-10,House,"Reported from Courts of Justice with substitute (15-Y 7-N)",15,7,0,0,22
1902994,1489298,2025-02-13,House,"Passed House with substitute (57-Y 40-N)",57,40,0,3,100
1902994,1493230,2025-02-18,Senate,"House substitute rejected by Senate (0-Y 40-N)",0,40,0,0,40
1902994,1496581,2025-02-20,Senate,"Senate acceded to request (39-Y 0-N)",39,0,0,1,40
1902994,1497124,2025-02-22,House,"Conference report agreed to by House (64-Y 30-N)",64,30,0,6,100
1902994,1504111,2025-02-22,Senate,"Conference report agreed to by Senate (36-Y 3-N)",36,3,0,1,40
1902994,1534700,2025-04-02,Senate,"Senate concurred in Governor's recommendation (22-Y 18-N)",22,18,0,0,40
1902994,1536892,2025-04-02,House,"House concurred in Governor's recommendation (62-Y 34-N)",62,34,0,4,100
1902996,1471797,2025-01-15,Senate,"Incorporated by Courts of Justice (SB926-Stuart) (11-Y 0-N)",11,0,0,4,15
1903000,1477262,2025-01-30,Senate,"Reported from Education and Health (15-Y 0-N)",15,0,0,0,15
1903000,1478192,2025-01-31,Senate,"Constitutional reading dispensed (on 1st reading) (39-Y 0-N)",39,0,0,1,40
1903000,1479865,2025-02-03,Senate,"Constitutional reading dispensed (on 3rd reading)",40,0,0,0,40
1903000,1479866,2025-02-03,Senate,"Passed Senate (40-Y 0-N)",40,0,0,0,40
1903000,1487391,2025-02-12,House,"Reported from Education (21-Y 0-N)",21,0,0,1,22
1903000,1491087,2025-02-17,House,"Passed House (95-Y 0-N)",95,0,0,5,100
1903000,1491088,2025-02-17,House,"Passed House (96-Y 0-N)",96,0,0,4,100
1903000,1536637,2025-04-02,Senate,"Senate rejected Governor's recommendation (19-Y 21-N)",19,21,0,0,40
1903012,1471807,2025-01-15,Senate,"Reported from Courts of Justice with substitute and rereferred to Finance and Appropriations (10-Y 5-N)",10,5,0,0,15
1903012,1472975,2025-01-22,Senate,"Failed to report (defeated) in Finance and Appropriations (6-Y 9-N)",6,9,0,0,15
1903019,1474072,2025-01-20,Senate,"Stricken at request of Patron in Courts of Justice (14-Y 0-N)",14,0,0,1,15
1903021,1471758,2025-01-15,Senate,"Incorporated by Finance and Appropriations (SB1307-McPike) (12-Y 0-N)",12,0,0,3,15
1903024,1473230,2025-01-22,Senate,"Reported from General Laws and Technology (15-Y 0-N)",15,0,0,0,15
1903024,1474453,2025-01-24,Senate,"Constitutional reading dispensed (on 1st reading) (37-Y 0-N)",37,0,0,3,40
1903024,1476657,2025-01-28,Senate,"Read third time and passed Senate (39-Y 0-N)",39,0,0,1,40
1903024,1483725,2025-02-06,House,"Subcommittee recommends reporting (8-Y 0-N)",8,0,0,1,9
1903024,1486855,2025-02-11,House,"Reported from General Laws (19-Y 0-N)",19,0,0,3,22
1903024,1490469,2025-02-14,House,"Passed House (96-Y 0-N)",96,0,0,4,100
1903029,1471860,2025-01-15,Senate,"Reported from General Laws and Technology (10-Y 0-N 3-A)",10,0,3,2,15
1903029,1472611,2025-01-21,Senate,"Read third time and passed Senate (40-Y 0-N)",40,0,0,0,40
1903029,1473700,2025-01-17,Senate,"Constitutional reading dispensed (on 1st reading) (40-Y 0-N)",40,0,0,0,40
1903029,1483724,2025-02-06,House,"Reported from General Laws (21-Y 0-N)",21,0,0,1,22
1903029,1486059,2025-02-11,House,"Passed House (94-Y 0-N)",94,0,0,6,100
1903029,1535401,2025-04-02,Senate,"Senate concurred in Governor's recommendation (40-Y 0-N)",40,0,0,0,40
1903029,1535402,2025-04-02,House,"House concurred in Governor's recommendation (95-Y 0-N)",95,0,0,5,100
1903037,1476586,2025-01-29,Senate,"Reported from Courts of Justice (14-Y 0-N 1-A)",14,0,1,0,15
1903037,1478369,2025-01-31,Senate,"Constitutional reading dispensed (on 1st reading) (39-Y 0-N)",39,0,0,1,40
1903037,1482214,2025-02-04,Senate,"Read third time and passed Senate (39-Y 1-N)",39,1,0,0,40
1903037,1484871,2025-02-10,House,"Subcommittee recommends reporting (8-Y 0-N)",8,0,0,1,9
1903037,1490620,2025-02-14,House,"Reported from Courts of Justice (21-Y 0-N)",21,0,0,1,22
1903037,1494115,2025-02-19,House,"Passed House (97-Y 0-N)",97,0,0,3,100
1903044,1473933,2025-01-23,Senate,"Reported from Finance and Appropriations with substitute (13-Y 0-N)",13,0,0,2,15
1903044,1475084,2025-01-27,Senate,"Constitutional reading dispensed (on 1st reading) (36-Y 0-N)",36,0,0,4,40
1903044,1479394,2025-01-29,Senate,"Constitutional reading dispensed (on 3rd reading) (38-Y 0-N)",38,0,0,2,40
1903044,1479395,2025-01-29,Senate,"Passed Senate (38-Y 0-N)",38,0,0,2,40
1903044,1487948,2025-02-12,House,"Reported from Finance with substitute (22-Y 0-N)",22,0,0,0,22
1903044,1491541,2025-02-17,House,"Passed House with substitute (95-Y 0-N)",95,0,0,5,100
1903044,1491542,2025-02-17,House,"Passed House with substitute (96-Y 0-N)",96,0,0,4,100
1903044,1492754,2025-02-18,Senate,"House substitute rejected by Senate (0-Y 40-N)",0,40,0,0,40
1903044,1496937,2025-02-20,Senate,"Senate acceded to request (39-Y 0-N)",39,0,0,1,40
1903044,1497197,2025-02-22,House,"Conference report agreed to by House (95-Y 2-N)",95,2,0,3,100
1903044,1503181,2025-02-22,Senate,"Conference report agreed to by Senate (40-Y 0-N)",40,0,0,0,40
1903048,1472936,2025-01-22,Senate,"Reported from Finance and Appropriations (10-Y 5-N)",10,5,0,0,15
1903048,1473701,2025-01-17,Senate,"Reported from Courts of Justice with substitute and rereferred to Finance and Appropriations (9-Y 6-N)",9,6,0,0,15
1903048,1473702,2025-01-23,Senate,"Constitutional reading dispensed (on 1st reading) (39-Y 0-N)",39,0,0,1,40
1903048,1476449,2025-01-28,Senate,"Read third time and passed Senate (21-Y 18-N)",21,18,0,1,40
1903048,1483929,2025-02-07,House,"Reported from Public Safety (11-Y 10-N)",11,10,0,1,22
1903048,1487713,2025-02-12,House,"Passed House (50-Y 47-N)",50,47,0,3,100
1903053,1471536,2025-01-13,Senate,"Reported from Commerce and Labor and rereferred to Finance and Appropriations (9-Y 6-N)",9,6,0,0,15
1903053,1472674,2025-01-21,Senate,"Reported from Finance and Appropriations with amendment (10-Y 5-N)",10,5,0,0,15
1903053,1472954,2025-01-22,Senate,"Constitutional reading dispensed (on 1st reading) (40-Y 0-N)",40,0,0,0,40
1903053,1474287,2025-01-24,Senate,"Read third time and passed Senate (21-Y 17-N)",21,17,0,2,40
1903053,1483726,2025-02-06,House,"Reported from Labor and Commerce with amendment(s) (11-Y 10-N)",11,10,0,1,22
1903053,1489178,2025-02-12,House,"Passed House with amendment (50-Y 46-N)",50,46,0,4,100
1903053,1491784,2025-02-17,Senate,"House Amendment rejected by Senate (0-Y 39-N)",0,39,0,1,40
1903053,1495999,2025-02-19,Senate,"Senate acceded to request (40-Y 0-N)",40,0,0,0,40
1903053,1496463,2025-02-21,Senate,"Conference report agreed to by Senate (22-Y 18-N)",22,18,0,0,40
1903053,1504003,2025-02-21,House,"Conference report agreed to by House (50-Y 46-N)",50,46,0,4,100
1903058,1473840,2025-01-21,Senate,"Reported from Agriculture, Conservation and Natural Resources (14-Y 0-N)",14,0,0,1,15
1903058,1473841,2025-01-23,Senate,"Constitutional reading dispensed (on 1st reading) (39-Y 0-N)",39,0,0,1,40
1903058,1475408,2025-01-27,Senate,"Read third time and passed Senate (38-Y 0-N)",38,0,0,2,40
1903058,1487371,2025-02-12,House,"Reported from Agriculture, Chesapeake and Natural Resources (22-Y 0-N)",22,0,0,0,22
1903058,1491072,2025-02-17,House,"Passed House (95-Y 0-N)",95,0,0,5,100
1903058,1491073,2025-02-17,House,"Passed House (96-Y 0-N)",96,0,0,4,100
1903060,1475690,2025-01-28,Senate,"Reported from Privileges and Elections with substitute (15-Y 0-N)",15,0,0,0,15
1903060,1477289,2025-01-30,Senate,"Constitutional reading dispensed (on 1st reading) (39-Y 0-N 1-A)",39,0,1,0,40
1903060,1479266,2025-01-31,Senate,"Constitutional reading dispensed (on 3rd reading) (40-Y 0-N)",40,0,0,0,40
1903060,1479267,2025-01-31,Senate,"Passed Senate (40-Y 0-N)",40,0,0,0,40
1903060,1485338,2025-02-10,House,"Subcommittee recommends reporting with amendment(s) (8-Y 0-N)",8,0,0,1,9
1903060,1490031,2025-02-14,House,"Reported from Privileges and Elections with amendment(s) (20-Y 2-N)",20,2,0,0,22
1903060,1493258,2025-02-19,House,"Passed House with amendment (94-Y 2-N)",94,2,0,4,100
1903060,1494957,2025-02-20,Senate,"House Amendment agreed to by Senate (39-Y 0-N)",39,0,0,1,40
1903060,1536133,2025-04-02,Senate,"Senate rejected Governor's recommendation (17-Y 23-N)",17,23,0,0,40
1903069,1473630,2025-01-21,Senate,"Passed by indefinitely in Finance and Appropriations (14-Y 0-N)",14,0,0,1,15
1903072,1471540,2025-01-13,Senate,"Reported from Commerce and Labor with substitute (15-Y 0-N)",15,0,0,0,15
1903072,1471713,2025-01-15,Senate,"Constitutional reading dispensed (on 1st reading) (38-Y 0-N)",38,0,0,0,38
1903072,1472119,2025-01-17,Senate,"Read third time and passed Senate (40-Y 0-N)",40,0,0,0,40
1903072,1483377,2025-02-06,House,"Reported from Labor and Commerce (21-Y 0-N)",21,0,0,1,22
1903072,1486323,2025-02-11,House,"Passed House (94-Y 0-N)",94,0,0,6,100
1903078,1471642,2025-01-14,Senate,"Reported from Agriculture, Conservation and Natural Resources with substitute (13-Y 0-N)",13,0,0,1,14
1903078,1471900,2025-01-16,Senate,"Constitutional reading dispensed (on 1st reading) (39-Y 0-N)",39,0,0,1,40
1903078,1472360,2025-01-20,Senate,"Read third time and passed Senate (38-Y 0-N)",38,0,0,2,40
1903078,1472361,2025-01-20,Senate,"Reconsideration of passage agreed to by Senate",40,0,0,0,40
1903078,1472362,2025-01-20,Senate,"Passed Senate (40-Y 0-N)",40,0,0,0,40
1903078,1487376,2025-02-12,House,"Subcommittee recommends laying on the table (10-Y 0-N)",10,0,0,1,11
1903083,1471541,2025-01-13,Senate,"Reported from Local Government with amendments (6-Y 5-N 2-A)",6,5,2,0,13
1903083,1471542,2025-01-14,Senate,"Constitutional reading dispensed (on 1st reading) (37-Y 0-N)",37,0,0,1,38
1903083,1474782,2025-01-27,Senate,"Reported from Local Government with substitute (11-Y 4-N)",11,4,0,0,15
1903083,1478268,2025-01-30,Senate,"Read third time and passed Senate (30-Y 10-N)",30,10,0,0,40
1903083,1483000,2025-02-06,House,"Subcommittee recommends reporting (8-Y 0-N)",8,0,0,1,9
1903083,1483879,2025-02-07,House,"Reported from Counties, Cities and Towns (21-Y 0-N)",21,0,0,1,22
1903086,1474714,2025-01-27,Senate,"Reported from Local Government with substitute (7-Y 6-N 2-A)",7,6,2,0,15
1903086,1476815,2025-01-28,Senate,"Constitutional reading dispensed (on 1st reading) (39-Y 0-N)",39,0,0,1,40
1903086,1478152,2025-01-30,Senate,"Read third time and defeated by Senate (13-Y 26-N 1-A)",13,26,1,0,40
1903088,1475312,2025-01-28,Senate,"Passed by indefinitely in Education and Health (9-Y 6-N)",9,6,0,0,15
1903096,1471795,2025-01-15,Senate,"Reported from Courts of Justice (15-Y 0-N)",15,0,0,0,15
1903096,1472142,2025-01-17,Senate,"Constitutional reading dispensed (on 1st reading) (40-Y 0-N)",40,0,0,0,40
1903096,1472657,2025-01-21,Senate,"Read third time and passed Senate (40-Y 0-N)",40,0,0,0,40
1903096,1482794,2025-02-05,House,"Reported from Courts of Justice (22-Y 0-N)",22,0,0,0,22
1903096,1485869,2025-02-10,House,"Passed House (95-Y 0-N)",95,0,0,5,100
1903099,1474547,2025-01-23,Senate,"Reported from Finance and Appropriations (14-Y 0-N)",14,0,0,1,15
1903099,1475182,2025-01-27,Senate,"Constitutional reading dispensed (on 1st reading) (36-Y 0-N)",36,0,0,4,40
1903099,1476189,2025-01-29,Senate,"Read third time and passed Senate (38-Y 0-N)",38,0,0,2,40
1903099,1487696,2025-02-12,House,"Reported from Finance with substitute (21-Y 1-N)",21,1,0,0,22
1903099,1492253,2025-02-18,Senate,"House substitute rejected by Senate (0-Y 40-N)",0,40,0,0,40
1903099,1495111,2025-02-20,Senate,"Senate acceded to request (39-Y 0-N)",39,0,0,1,40
1903099,1496446,2025-02-21,Senate,"Conference report agreed to by Senate (40-Y 0-N)",40,0,0,0,40
1903099,1503950,2025-02-21,House,"Conference report agreed to by House (93-Y 3-N)",93,3,0,4,100
1903099,1565440,2025-02-17,House,"Passed House with substitute (92-Y 4-N)",92,4,0,4,100
1903103,1472212,2025-01-17,Senate,"Reported from Courts of Justice with substitute and rereferred to Finance and Appropriations (15-Y 0-N)",15,0,0,0,15
1903103,1473965,2025-01-22,Senate,"Reported from Finance and Appropriations (13-Y 0-N 1-A)",13,0,1,1,15
1903103,1473966,2025-01-23,Senate,"Constitutional reading dispensed (on 1st reading) (39-Y 0-N)",39,0,0,1,40
1903103,1474954,2025-01-27,Senate,"Read third time and passed Senate (38-Y 0-N)",38,0,0,2,40
1903103,1482798,2025-02-05,House,"Subcommittee recommends reporting and referring to Appropriations (8-Y 0-N)",8,0,0,1,9
1903103,1485010,2025-02-10,House,"Reported from Courts of Justice and referred to Appropriations (22-Y 0-N)",22,0,0,0,22
1903106,1474592,2025-01-24,Senate,"Reported from Rules with amendment and rereferred to Finance and Appropriations (13-Y 0-N)",13,0,0,2,15
1903109,1478916,2025-02-03,Senate,"Reported from Commerce and Labor with substitute (9-Y 6-N)",9,6,0,0,15
1903109,1479744,2025-02-04,Senate,"Constitutional reading dispensed (on 1st reading) (40-Y 0-N)",40,0,0,0,40
1903109,1479745,2025-02-04,Senate,"Constitutional reading dispensed (on 3rd reading) (40-Y 0-N)",40,0,0,0,40
1903109,1479746,2025-02-04,Senate,"Passed Senate (21-Y 19-N)",21,19,0,0,40
1903109,1486860,2025-02-11,House,"Subcommittee recommends reporting with substitute (6-Y 4-N)",6,4,0,1,11
1903109,1489411,2025-02-13,House,"Reported from Labor and Commerce with substitute (12-Y 10-N)",12,10,0,0,22
1903109,1491977,2025-02-18,House,"Passed House with substitute (50-Y 46-N)",50,46,0,4,100
1903109,1495767,2025-02-19,Senate,"House substitute agreed to by Senate (20-Y 19-N)",20,19,0,1,40
1903109,1564820,2025-02-18,House,"Defeated by House ( 44-Y 53-N )",44,53,0,3,100
1903114,1471982,2025-01-16,Senate,"Passed by indefinitely in Education and Health (13-Y 1-N)",13,1,0,1,15
1903122,1475698,2025-01-28,Senate,"Passed by indefinitely in Privileges and Elections (10-Y 5-N)",10,5,0,0,15
1903125,1472448,2025-01-20,Senate,"Reported from Courts of Justice with substitute (13-Y 1-N 1-A)",13,1,1,0,15
1903125,1472725,2025-01-21,Senate,"Constitutional reading dispensed (on 1st reading) (40-Y 0-N)",40,0,0,0,40
1903125,1474432,2025-01-24,Senate,"Engrossment reconsidered by Senate",37,0,0,3,40
1903125,1474433,2025-01-24,Senate,"Committee substitute reconsidered",37,0,0,3,40
1903125,1474956,2025-01-27,Senate,"Read third time and passed Senate (24-Y 13-N)",24,13,0,3,40
1903125,1474957,2025-01-27,Senate,"Reconsideration of passage agreed to by Senate",38,0,0,2,40
1903125,1474958,2025-01-27,Senate,"Passed Senate (25-Y 12-N 1-A)",25,12,1,2,40
1903125,1480768,2025-02-05,House,"Reported from Courts of Justice with amendment(s) (17-Y 4-N 1-A)",17,4,1,0,22
1903125,1484683,2025-02-10,House,"Passed House with amendments (57-Y 37-N 1-A)",57,37,1,5,100
1903125,1487710,2025-02-12,Senate,"House Amendments agreed to by Senate (30-Y 7-N)",30,7,0,3,40
1903125,1536173,2025-04-02,Senate,"Senate rejected Governor's recommendation (4-Y 36-N)",4,36,0,0,40
1903134,1472209,2025-01-17,Senate,"Reported from Courts of Justice and rereferred to Finance and Appropriations (8-Y 6-N 1-A)",8,6,1,0,15
1903134,1472945,2025-01-22,Senate,"Reported from Finance and Appropriations (10-Y 5-N)",10,5,0,0,15
1903134,1473734,2025-01-23,Senate,"Constitutional reading dispensed (on 1st reading) (39-Y 0-N)",39,0,0,1,40
1903134,1476218,2025-01-28,Senate,"Read third time and passed Senate (21-Y 17-N)",21,17,0,2,40
1903134,1476219,2025-01-28,Senate,"Reconsideration of passage agreed to by Senate (39-Y 0-N)",39,0,0,1,40
1903134,1476220,2025-01-28,Senate,"Passed Senate (23-Y 16-N)",23,16,0,1,40
1903134,1483253,2025-02-06,House,"Subcommittee recommends reporting with substitute and referring to Appropriations (6-Y 4-N)",6,4,0,1,11
1903134,1483985,2025-02-07,House,"Reported from Public Safety with substitute (11-Y 10-N)",11,10,0,1,22
1903134,1490811,2025-02-17,House,"Reported from Rules (13-Y 5-N)",13,5,0,0,18
1903134,1495770,2025-02-20,Senate,"House substitute rejected by Senate (0-Y 39-N)",0,39,0,1,40
1903134,1495771,2025-02-20,Senate,"Senate acceded to request (37-Y 0-N)",37,0,0,3,40
1903134,1496724,2025-02-20,House,"Passed House with substitute (52-Y 46-N)",52,46,0,2,100
1903134,1497132,2025-02-21,Senate,"Conference report agreed to by Senate (22-Y 18-N)",22,18,0,0,40
1903134,1503664,2025-02-21,House,"Conference report agreed to by House (51-Y 45-N)",51,45,0,4,100
1903138,1473519,2025-01-23,Senate,"Reported from Education and Health (15-Y 0-N)",15,0,0,0,15
1903138,1474571,2025-01-24,Senate,"Constitutional reading dispensed (on 1st reading) (37-Y 0-N)",37,0,0,3,40
1903138,1476964,2025-01-28,Senate,"Read third time and passed Senate (39-Y 0-N)",39,0,0,1,40
1903138,1485873,2025-02-11,House,"Subcommittee recommends laying on the table (4-Y 2-N)",4,2,0,3,9
1903139,1478030,2025-01-31,Senate,"Reported from Rehabilitation and Social Services (15-Y 0-N)",15,0,0,0,15
1903139,1479751,2025-02-03,Senate,"Constitutional reading dispensed (on 1st reading) (40-Y 0-N)",40,0,0,0,40
1903139,1479752,2025-02-04,Senate,"Constitutional reading dispensed (on 3rd reading) (39-Y 0-N)",39,0,0,1,40
1903139,1479753,2025-02-04,Senate,"Passed Senate (40-Y 0-N)",40,0,0,0,40
1903139,1485925,2025-02-11,House,"Reported from Health and Human Services (22-Y 0-N)",22,0,0,0,22
1903139,1490276,2025-02-14,House,"Passed House (96-Y 0-N)",96,0,0,4,100
1903147,1478023,2025-01-31,Senate,"Passed by indefinitely in Rehabilitation and Social Services (9-Y 5-N 1-A)",9,5,1,0,15
1903152,1473515,2025-01-23,Senate,"Reported from Education and Health and rereferred to Finance and Appropriations (14-Y 0-N 1-A)",14,0,1,0,15
1903152,1477083,2025-01-29,Senate,"Reported from Finance and Appropriations with amendments (15-Y 0-N)",15,0,0,0,15
1903152,1477437,2025-01-30,Senate,"Constitutional reading dispensed (on 1st reading) (39-Y 0-N 1-A)",39,0,1,0,40
1903152,1480292,2025-02-03,Senate,"Read third time and passed Senate (40-Y 0-N)",40,0,0,0,40
1903152,1485950,2025-02-11,House,"Reported from Health and Human Services with substitute (22-Y 0-N)",22,0,0,0,22
1903152,1490280,2025-02-14,House,"Passed House with substitute (96-Y 0-N)",96,0,0,4,100
1903152,1493113,2025-02-18,Senate,"House substitute rejected by Senate (0-Y 40-N)",0,40,0,0,40
1903152,1495391,2025-02-20,Senate,"Senate acceded to request (39-Y 0-N)",39,0,0,1,40
1903152,1497209,2025-02-22,House,"Conference report agreed to by House (92-Y 2-N)",92,2,0,6,100
1903152,1504037,2025-02-22,Senate,"Conference report agreed to by Senate (40-Y 0-N)",40,0,0,0,40
1903152,1536629,2025-04-02,Senate,"Senate rejected Governor's recommendation (13-Y 27-N)",13,27,0,0,40
1903152,1536630,2025-04-02,Senate,"Reconsideration of Governor's recommendation rejected (40-Y 0-N)",39,0,0,1,40
1903152,1536631,2025-04-02,Senate,"Senate rejected Governor's recommendation (0-Y 40-N)",0,40,0,0,40
1903152,1536632,2025-04-02,Senate,"Motion to pass in enrolled form rejected (21-Y 19-N)",21,19,0,0,40
1903156,1473730,2025-01-22,Senate,"Reported from General Laws and Technology with substitute and rereferred to Finance and Appropriations (12-Y 0-N)",12,0,0,3,15
1903156,1476202,2025-01-28,Senate,"Passed by indefinitely in Finance and Appropriations (10-Y 4-N)",10,4,0,1,15
1903159,1475825,2025-01-28,Senate,"Reported from Agriculture, Conservation and Natural Resources with substitute (13-Y 0-N 1-A)",13,0,1,1,15
1903159,1477454,2025-01-30,Senate,"Constitutional reading dispensed (on 1st reading) (39-Y 0-N 1-A)",39,0,1,0,40
1903159,1480102,2025-02-03,Senate,"Read third time and passed Senate (40-Y 0-N)",40,0,0,0,40
1903159,1487424,2025-02-12,House,"Subcommittee recommends reporting with amendment(s) (10-Y 0-N)",10,0,0,1,11
1903159,1487425,2025-02-12,House,"Reported from Agriculture, Chesapeake and Natural Resources with amendment(s) (22-Y 0-N)",22,0,0,0,22
1903159,1491178,2025-02-17,House,"Passed House with amendments (95-Y 0-N)",95,0,0,5,100
1903159,1491179,2025-02-17,House,"Passed House with amendments (96-Y 0-N)",96,0,0,4,100
1903159,1492396,2025-02-18,Senate,"House Amendments agreed to by Senate (40-Y 0-N)",40,0,0,0,40
1903159,1536705,2025-04-02,Senate,"Senate concurred in Governor's recommendation (23-Y 17-N)",23,17,0,0,40
1903159,1536706,2025-04-02,House,"House concurred in Governor's recommendation (94-Y 1-N)",94,1,0,5,100
1903162,1471781,2025-01-15,Senate,"Reported from Courts of Justice with substitute (15-Y 0-N)",15,0,0,0,15
1903162,1472197,2025-01-17,Senate,"Constitutional reading dispensed (on 1st reading) (40-Y 0-N)",40,0,0,0,40
1903162,1472716,2025-01-21,Senate,"Read third time and passed Senate (40-Y 0-N)",40,0,0,0,40
1903162,1485974,2025-02-10,House,"Subcommittee recommends reporting (8-Y 0-N)",8,0,0,1,9
1903162,1490616,2025-02-14,House,"Reported from Courts of Justice (21-Y 0-N)",21,0,0,1,22
1903162,1493674,2025-02-19,House,"Passed House (91-Y 4-N)",91,4,0,5,100
1903167,1473500,2025-01-23,Senate,"Reported from Education and Health (15-Y 0-N)",15,0,0,0,15
1903167,1474430,2025-01-24,Senate,"Constitutional reading dispensed (on 1st reading) (37-Y 0-N)",37,0,0,3,40
1903167,1476670,2025-01-28,Senate,"Read third time and passed Senate (39-Y 0-N)",39,0,0,1,40
1903167,1485882,2025-02-11,House,"Subcommittee recommends reporting (7-Y 0-N)",7,0,0,2,9
1903167,1490745,2025-02-17,House,"Reported from Education (19-Y 3-N)",19,3,0,0,22
1903167,1496574,2025-02-20,House,"Passed House (90-Y 7-N)",90,7,0,3,100
1903177,1475707,2025-01-28,Senate,"Reported from Privileges and Elections (15-Y 0-N)",15,0,0,0,15
1903177,1477298,2025-01-30,Senate,"Constitutional reading dispensed (on 1st reading) (39-Y 0-N 1-A)",39,0,1,0,40
1903177,1479281,2025-01-31,Senate,"Constitutional reading dispensed (on 3rd reading) (40-Y 0-N)",40,0,0,0,40
1903177,1479282,2025-01-31,Senate,"Passed Senate (40-Y 0-N)",40,0,0,0,40
1903177,1490039,2025-02-14,House,"Reported from Privileges and Elections with substitute (22-Y 0-N)",22,0,0,0,22
1903177,1493352,2025-02-19,House,"Passed House with substitute (97-Y 0-N)",97,0,0,3,100
1903177,1495069,2025-02-20,Senate,"House substitute agreed to by Senate (39-Y 0-N)",39,0,0,1,40
1903181,1472311,2025-01-20,Senate,"Reported from Courts of Justice and rereferred to Finance and Appropriations (8-Y 6-N 1-A)",8,6,1,0,15
1903181,1475362,2025-01-28,Senate,"Passed by indefinitely in Finance and Appropriations (9-Y 6-N)",9,6,0,0,15
1903186,1473557,2025-01-23,Senate,"Reported from Education and Health with substitute (15-Y 0-N)",15,0,0,0,15
1903186,1474582,2025-01-24,Senate,"Constitutional reading dispensed (on 1st reading) (37-Y 0-N)",37,0,0,3,40
1903186,1476342,2025-01-28,Senate,"Read third time and passed Senate (39-Y 0-N)",39,0,0,1,40
1903186,1485839,2025-02-11,House,"Subcommittee recommends reporting with substitute (7-Y 0-N)",7,0,0,2,9
1903186,1490764,2025-02-17,House,"Reported from Education with substitute (14-Y 8-N)",14,8,0,0,22
1903186,1495631,2025-02-20,Senate,"House substitute agreed to by Senate (39-Y 0-N)",39,0,0,1,40
1903186,1496613,2025-02-20,House,"Passed House with substitute (78-Y 18-N)",78,18,0,4,100
1903191,1473256,2025-01-22,Senate,"Read third time and passed Senate (40-Y 0-N)",40,0,0,0,40
1903191,1473936,2025-01-17,Senate,"Reported from Rules (15-Y 0-N)",15,0,0,0,15
1903191,1473937,2025-01-20,Senate,"Constitutional reading dispensed (on 1st reading) (40-Y 0-N)",40,0,0,0,40
1903191,1490778,2025-02-17,House,"Reported from Rules (17-Y 0-N)",17,0,0,1,18
1903191,1496803,2025-02-20,House,"Passed House (60-Y 38-N)",60,38,0,2,100
1903199,1478262,2025-01-31,Senate,"Reported from Rehabilitation and Social Services with substitute (7-Y 5-N 3-A)",7,5,3,0,15
1903199,1480591,2025-02-03,Senate,"Constitutional reading dispensed (on 1st reading) (40-Y 0-N)",40,0,0,0,40
1903199,1480592,2025-02-04,Senate,"Constitutional reading dispensed (on 3rd reading) (40-Y 0-N)",40,0,0,0,40
1903199,1480593,2025-02-04,Senate,"Passed Senate (40-Y 0-N)",40,0,0,0,40
1903199,1486429,2025-02-11,House,"Reported from Health and Human Services with amendment(s) (22-Y 0-N)",22,0,0,0,22
1903199,1490244,2025-02-14,House,"Passed House with amendment (96-Y 0-N)",96,0,0,4,100
1903199,1492374,2025-02-18,Senate,"House Amendment agreed to by Senate (40-Y 0-N)",40,0,0,0,40
1903203,1473733,2025-01-22,Senate,"Reported from Agriculture, Conservation and Natural Resources (14-Y 0-N)",14,0,0,1,15
1903203,1477162,2025-01-29,Senate,"Reported from Finance and Appropriations with substitute (15-Y 0-N)",15,0,0,0,15
1903203,1477541,2025-01-30,Senate,"Constitutional reading dispensed (on 1st reading) (39-Y 0-N 1-A)",39,0,1,0,40
1903203,1478125,2025-01-31,Senate,"Passed Senate (40-Y 0-N)",40,0,0,0,40
1903203,1484636,2025-02-10,House,"Reported from Appropriations with substitute (22-Y 0-N)",22,0,0,0,22
1903203,1489272,2025-02-13,House,"Passed House with substitute (96-Y 0-N)",96,0,0,4,100
1903203,1491251,2025-02-17,Senate,"House substitute rejected by Senate (0-Y 39-N)",0,39,0,1,40
1903203,1493958,2025-02-19,Senate,"Senate acceded to request (40-Y 0-N)",40,0,0,0,40
1903203,1496591,2025-02-21,Senate,"Conference report agreed to by Senate (40-Y 0-N)",40,0,0,0,40
1903203,1504126,2025-02-21,House,"Conference report agreed to by House (95-Y 0-N)",95,0,0,5,100
1903205,1471538,2025-01-13,Senate,"Passed by indefinitely in Commerce and Labor (9-Y 6-N)",9,6,0,0,15
1903210,1473838,2025-01-21,Senate,"Reported from Agriculture, Conservation and Natural Resources (14-Y 0-N)",14,0,0,1,15
1903215,1474185,2025-01-24,Senate,"Reported from Rehabilitation and Social Services with amendment and rereferred to Finance and Appropriations (15-Y 0-N)",15,0,0,0,15
1903215,1477163,2025-01-29,Senate,"Reported from Finance and Appropriations with amendment (15-Y 0-N)",15,0,0,0,15
1903215,1477534,2025-01-30,Senate,"Constitutional reading dispensed (on 1st reading) (39-Y 0-N 1-A)",39,0,1,0,40
1903215,1478112,2025-01-31,Senate,"Constitutional reading dispensed (on 3rd reading) (40-Y 0-N)",40,0,0,0,40
1903215,1478113,2025-01-31,Senate,"Passed Senate (40-Y 0-N)",40,0,0,0,40
1903215,1483983,2025-02-07,House,"Reported from Public Safety (21-Y 0-N)",21,0,0,1,22
1903215,1488848,2025-02-12,House,"Passed House (97-Y 0-N)",97,0,0,3,100
1903219,1473282,2025-01-22,Senate,"Passed by indefinitely in Courts of Justice with letter (8-Y 6-N)",8,6,0,1,15
1903227,1471808,2025-01-15,Senate,"Reported from General Laws and Technology (15-Y 0-N)",15,0,0,0,15
1903227,1472131,2025-01-17,Senate,"Constitutional reading dispensed (on 1st reading) (40-Y 0-N)",40,0,0,0,40
1903227,1472632,2025-01-21,Senate,"Read third time and passed Senate (40-Y 0-N)",40,0,0,0,40
1903227,1483723,2025-02-06,House,"Reported from General Laws (21-Y 0-N)",21,0,0,1,22
1903227,1490783,2025-02-17,House,"Reported from Rules (18-Y 0-N)",18,0,0,0,18
1903227,1496910,2025-02-20,House,"Passed House (98-Y 0-N)",98,0,0,2,100
1903231,1473795,2025-01-17,Senate,"Passed by indefinitely in Courts of Justice (8-Y 5-N)",8,5,0,2,15
1903234,1473627,2025-01-16,Senate,"Rereferred from Transportation to Courts of Justice (15-Y 0-N)",15,0,0,0,15
1903234,1474711,2025-01-27,Senate,"Passed by indefinitely in Courts of Justice (8-Y 6-N)",8,6,0,1,15
1903240,1472960,2025-01-22,Senate,"Reported from Finance and Appropriations (10-Y 5-N)",10,5,0,0,15
1903240,1473763,2025-01-17,Senate,"Reported from Courts of Justice and rereferred to Finance and Appropriations (9-Y 6-N)",9,6,0,0,15
1903240,1473764,2025-01-23,Senate,"Constitutional reading dispensed (on 1st reading) (39-Y 0-N)",39,0,0,1,40
1903240,1475411,2025-01-27,Senate,"Read third time and passed Senate (20-Y 18-N)",20,18,0,2,40
1903240,1483936,2025-02-07,House,"Reported from Public Safety (11-Y 10-N)",11,10,0,1,22
1903240,1487724,2025-02-12,House,"Passed House (50-Y 47-N)",50,47,0,3,100
1903243,1473374,2025-01-22,Senate,"Reported from Courts of Justice (14-Y 0-N)",14,0,0,1,15
1903243,1474569,2025-01-24,Senate,"Constitutional reading dispensed (on 1st reading) (37-Y 0-N)",37,0,0,3,40
1903243,1476248,2025-01-28,Senate,"Read third time and passed Senate (39-Y 0-N)",39,0,0,1,40
1903243,1482572,2025-02-05,House,"Reported from Courts of Justice (22-Y 0-N)",22,0,0,0,22
1903243,1484982,2025-02-10,House,"Passed House (95-Y 0-N)",95,0,0,5,100
1903250,1472305,2025-01-20,Senate,"Reported from Courts of Justice (15-Y 0-N)",15,0,0,0,15
1903250,1472864,2025-01-21,Senate,"Constitutional reading dispensed (on 1st reading) (40-Y 0-N)",40,0,0,0,40
1903250,1474233,2025-01-23,Senate,"Read third time and passed Senate (39-Y 0-N)",39,0,0,1,40
1903250,1482726,2025-02-05,House,"Reported from Courts of Justice (20-Y 2-N)",20,2,0,0,22
1903250,1485360,2025-02-10,House,"Passed House (87-Y 8-N)",87,8,0,5,100
1903253,1472188,2025-01-17,Senate,"Reported from Courts of Justice with substitute and rereferred to Finance and Appropriations (9-Y 6-N)",9,6,0,0,15
1903253,1472955,2025-01-22,Senate,"Reported from Finance and Appropriations (10-Y 5-N)",10,5,0,0,15
1903253,1473761,2025-01-23,Senate,"Constitutional reading dispensed (on 1st reading) (39-Y 0-N)",39,0,0,1,40
1903253,1476763,2025-01-28,Senate,"Read third time and passed Senate (21-Y 18-N)",21,18,0,1,40
1903253,1483260,2025-02-06,House,"Subcommittee recommends reporting (6-Y 4-N)",6,4,0,1,11
1903253,1483982,2025-02-07,House,"Reported from Public Safety (11-Y 10-N)",11,10,0,1,22
1903253,1490799,2025-02-17,House,"Reported from Rules (12-Y 6-N)",12,6,0,0,18
1903253,1496646,2025-02-20,House,"Passed House (51-Y 47-N)",51,47,0,2,100
1903259,1473913,2025-01-22,Senate,"Reported from General Laws and Technology with substitute and rereferred to Finance and Appropriations (12-Y 0-N)",12,0,0,3,15
1903259,1476167,2025-01-28,Senate,"Passed by indefinitely in Finance and Appropriations (8-Y 7-N)",8,7,0,0,15
1903264,1474446,2025-01-24,Senate,"Reported from Commerce and Labor with substitute and rereferred to Finance and Appropriations (9-Y 6-N)",9,6,0,0,15
1903264,1477157,2025-01-29,Senate,"Reported from Finance and Appropriations with substitute (10-Y 4-N)",10,4,0,1,15
1903264,1477539,2025-01-30,Senate,"Constitutional reading dispensed (on 1st reading) (39-Y 0-N 1-A)",39,0,1,0,40
1903264,1480521,2025-02-04,Senate,"Read third time and passed Senate (20-Y 19-N)",20,19,0,1,40
1903264,1489462,2025-02-13,House,"Reported from Labor and Commerce with substitute (12-Y 10-N)",12,10,0,0,22
1903264,1492003,2025-02-18,House,"Passed House with substitute (49-Y 48-N)",49,48,0,3,100
1903264,1492004,2025-02-18,House,"Passed House with substitute (50-Y 47-N)",50,47,0,3,100
1903264,1495797,2025-02-19,Senate,"House substitute rejected by Senate (0-Y 40-N)",0,40,0,0,40
1903264,1495798,2025-02-20,Senate,"Senate acceded to request (38-Y 0-N)",38,0,0,2,40
1903264,1497136,2025-02-22,House,"Conference report agreed to by House (51-Y 45-N)",51,45,0,4,100
1903264,1503677,2025-02-22,Senate,"Conference report agreed to by Senate (21-Y 19-N)",21,19,0,0,40
1903264,1564808,2025-02-03,Senate,"Senator Stanley, William M., Jr. Amendments rejected",19,21,0,0,40
1903267,1474082,2025-01-16,Senate,"Reported from Transportation and rereferred to Finance and Appropriations (15-Y 0-N)",15,0,0,0,15
1903267,1475354,2025-01-28,Senate,"Reported from Finance and Appropriations (14-Y 1-N)",14,1,0,0,15
1903267,1476222,2025-01-29,Senate,"Constitutional reading dispensed (on 1st reading) (38-Y 0-N)",38,0,0,2,40
1903267,1478596,2025-01-31,Senate,"Read third time and passed Senate (40-Y 0-N)",40,0,0,0,40
1903267,1486023,2025-02-11,House,"Reported from Transportation (19-Y 1-N)",19,1,0,2,22
1903267,1490474,2025-02-14,House,"Passed House (91-Y 4-N)",91,4,0,5,100
1903270,1473535,2025-01-23,Senate,"Reported from Education and Health with amendment (15-Y 0-N)",15,0,0,0,15
1903270,1473872,2025-01-14,Senate,"Rereferred from Agriculture, Conservation and Natural Resources (12-Y 1-N)",12,1,0,1,14
1903270,1474563,2025-01-24,Senate,"Constitutional reading dispensed (on 1st reading) (37-Y 0-N)",37,0,0,3,40
1903270,1476636,2025-01-28,Senate,"Read third time and passed Senate (39-Y 0-N)",39,0,0,1,40
1903270,1487426,2025-02-12,House,"Subcommittee recommends reporting (8-Y 2-N)",8,2,0,1,11
1903270,1487427,2025-02-12,House,"Reported from Agriculture, Chesapeake and Natural Resources (17-Y 5-N)",17,5,0,0,22
1903270,1491114,2025-02-17,House,"Passed House (75-Y 21-N)",75,21,0,4,100
1903276,1477258,2025-01-30,Senate,"Failed to report (defeated) in Education and Health (6-Y 9-N)",6,9,0,0,15
1903278,1472651,2025-01-21,Senate,"Reported from Finance and Appropriations with amendment (15-Y 0-N)",15,0,0,0,15
1903278,1473138,2025-01-22,Senate,"Constitutional reading dispensed (on 1st reading) (40-Y 0-N)",40,0,0,0,40
1903278,1474560,2025-01-24,Senate,"Read third time and passed Senate (38-Y 0-N)",38,0,0,2,40
1903278,1485456,2025-02-10,House,"Reported from Appropriations with substitute (22-Y 0-N)",22,0,0,0,22
1903278,1489550,2025-02-13,House,"Passed House with substitute (90-Y 7-N)",90,7,0,3,100
1903278,1491504,2025-02-17,Senate,"House substitute agreed to by Senate (39-Y 0-N)",39,0,0,1,40
1903284,1471842,2025-01-15,Senate,"Reported from General Laws and Technology with substitute (15-Y 0-N)",15,0,0,0,15
1903284,1472609,2025-01-21,Senate,"Read third time and passed Senate (40-Y 0-N)",40,0,0,0,40
1903284,1473685,2025-01-17,Senate,"Constitutional reading dispensed (on 1st reading) (40-Y 0-N)",40,0,0,0,40
1903284,1486856,2025-02-11,House,"Subcommittee recommends reporting with substitute (6-Y 1-N)",6,1,0,2,9
1903284,1489091,2025-02-13,House,"Reported from General Laws with substitute (18-Y 1-N)",18,1,0,3,22
1903284,1494859,2025-02-19,House,"Passed House with substitute (95-Y 2-N)",95,2,0,3,100
1903284,1496049,2025-02-20,Senate,"Senate acceded to request (38-Y 0-N)",38,0,0,2,40
1903284,1496768,2025-02-20,Senate,"House substitute rejected by Senate (2-Y 37-N)",2,37,0,1,40
1903284,1496769,2025-02-21,Senate,"Conference report agreed to by Senate (39-Y 0-N)",39,0,0,1,40
1903284,1503974,2025-02-21,House,"Conference report agreed to by House (92-Y 4-N)",92,4,0,4,100
1903288,1472934,2025-01-22,Senate,"Reported from Finance and Appropriations (10-Y 5-N)",10,5,0,0,15
1903288,1473726,2025-01-17,Senate,"Reported from Courts of Justice and rereferred to Finance and Appropriations (9-Y 6-N)",9,6,0,0,15
1903288,1473727,2025-01-23,Senate,"Constitutional reading dispensed (on 1st reading) (39-Y 0-N)",39,0,0,1,40
1903288,1475397,2025-01-27,Senate,"Read third time and passed Senate (20-Y 18-N)",20,18,0,2,40
1903288,1483923,2025-02-07,House,"Reported from Public Safety (11-Y 10-N)",11,10,0,1,22
1903288,1487692,2025-02-12,House,"Passed House (49-Y 47-N)",49,47,0,4,100
1903288,1534627,2025-04-02,Senate,"Senate concurred in Governor's recommendation (20-Y 20-N)",20,20,0,0,40
1903288,1534628,2025-04-02,Senate,"Reconsideration of Governor's recommendation agreed to (40-Y 0-N)",39,0,0,1,40
1903288,1534629,2025-04-02,Senate,"Senate rejected Governor's recommendation (19-Y 21-N)",19,21,0,0,40
1903293,1474599,2025-01-24,Senate,"Passed by indefinitely in Rules (8-Y 4-N)",8,4,0,3,15
1903296,1472443,2025-01-20,Senate,"Reported from Courts of Justice with amendments (8-Y 7-N)",8,7,0,0,15
1903296,1472769,2025-01-21,Senate,"Constitutional reading dispensed (on 1st reading) (40-Y 0-N)",40,0,0,0,40
1903296,1473672,2025-01-23,Senate,"Read third time and passed Senate (23-Y 16-N)",23,16,0,1,40
1903296,1482751,2025-02-05,House,"Subcommittee recommends laying on the table (8-Y 0-N)",8,0,0,1,9
1903305,1471830,2025-01-15,Senate,"Reported from General Laws and Technology (12-Y 0-N 2-A)",12,0,2,1,15
1903305,1472140,2025-01-17,Senate,"Constitutional reading dispensed (on 1st reading) (40-Y 0-N)",40,0,0,0,40
1903305,1472619,2025-01-21,Senate,"Motion to rerefer to committee rejected (19-Y 21-N)",19,21,0,0,40
1903305,1472620,2025-01-21,Senate,"Read third time and passed Senate (23-Y 17-N)",23,17,0,0,40
1903305,1472621,2025-01-21,Senate,"Reconsideration of passage agreed to by Senate",39,0,0,1,40
1903305,1472622,2025-01-21,Senate,"Read third time and passed Senate (25-Y 15-N)",25,15,0,0,40
1903305,1483376,2025-02-06,House,"Subcommittee recommends reporting with amendment(s) (6-Y 2-N)",6,2,0,1,9
1903305,1489283,2025-02-13,House,"Reported from General Laws with substitute (14-Y 5-N)",14,5,0,3,22
1903305,1491849,2025-02-18,House,"Passed House (63-Y 33-N)",63,33,0,4,100
1903305,1495620,2025-02-19,Senate,"House substitute agreed to by Senate (23-Y 15-N 1-A)",23,15,1,1,40
1903308,1475383,2025-01-28,Senate,"Reported from Education and Health and rereferred to Finance and Appropriations (12-Y 0-N 3-A)",12,0,3,0,15
1903308,1477073,2025-01-29,Senate,"Reported from Finance and Appropriations (14-Y 0-N 1-A)",14,0,1,0,15
1903308,1478206,2025-01-30,Senate,"Constitutional reading dispensed (on 1st reading) (39-Y 0-N 1-A)",39,0,1,0,40
1903308,1479867,2025-02-03,Senate,"Read third time and passed Senate (37-Y 3-N)",37,3,0,0,40
1903308,1488641,2025-02-13,House,"Reported from Health and Human Services and referred to Appropriations (20-Y 1-N)",20,1,0,1,22
1903308,1490156,2025-02-14,House,"Reported from Appropriations (18-Y 1-N)",18,1,0,3,22
1903308,1493444,2025-02-19,House,"Passed House (84-Y 13-N)",84,13,0,3,100
1903316,1471543,2025-01-13,Senate,"Reported from Local Government (13-Y 0-N)",13,0,0,0,13
1903316,1471634,2025-01-14,Senate,"Constitutional reading dispensed (on 1st reading) (37-Y 0-N)",37,0,0,1,38
1903316,1471932,2025-01-16,Senate,"Read third time and passed Senate (39-Y 0-N)",39,0,0,1,40
1903316,1489997,2025-02-14,House,"Reported from Counties, Cities and Towns (21-Y 0-N)",21,0,0,1,22
1903316,1494139,2025-02-19,House,"Passed House (97-Y 0-N)",97,0,0,3,100
1903320,1471757,2025-01-15,Senate,"Reported from General Laws and Technology with substitute and rereferred to Finance and Appropriations (14-Y 0-N)",14,0,0,1,15
1903320,1477240,2025-01-29,Senate,"Reported from Finance and Appropriations (14-Y 0-N)",14,0,0,1,15
1903320,1478163,2025-01-30,Senate,"Constitutional reading dispensed (on 1st reading) (39-Y 0-N 1-A)",39,0,1,0,40
1903320,1478164,2025-01-31,Senate,"Constitutional reading dispensed (on 3rd reading) (40-Y 0-N)",40,0,0,0,40
1903320,1478165,2025-01-31,Senate,"Passed Senate (40-Y 0-N)",40,0,0,0,40
1903320,1486511,2025-02-11,House,"Subcommittee recommends laying on the table (7-Y 0-N)",7,0,0,2,9
1903322,1475872,2025-01-28,Senate,"Reported from Agriculture, Conservation and Natural Resources with substitute and rereferred to Finance and Appropriations (14-Y 0-N)",14,0,0,1,15
1903356,1474065,2025-01-23,House,"Subcommittee recommends reporting and referring to Appropriations (7-Y 0-N)",7,0,0,2,9
1903356,1476004,2025-01-28,House,"Reported from General Laws and referred to Appropriations (22-Y 0-N)",22,0,0,0,22
1903356,1476421,2025-01-29,House,"Subcommittee recommends reporting (8-Y 0-N)",8,0,0,1,9
1903356,1477012,2025-01-29,House,"Reported from Appropriations (21-Y 0-N)",21,0,0,1,22
1903356,1480690,2025-02-04,House,"Read third time and passed House (97-Y 0-N)",97,0,0,3,100
1903356,1480691,2025-02-04,House,"Passed House (99-Y 0-N)",99,0,0,1,100
1903356,1488163,2025-02-12,Senate,"Reported from General Laws and Technology and rereferred to Finance and Appropriations (15-Y 0-N)",15,0,0,0,15
1903356,1492528,2025-02-17,Senate,"Passed by indefinitely in Finance and Appropriations (10-Y 4-N)",10,4,0,1,15
1903358,1474048,2025-01-23,House,"Subcommittee recommends reporting with substitute (7-Y 0-N)",7,0,0,2,9
1903358,1476026,2025-01-28,House,"Reported from General Laws with substitute (20-Y 2-N)",20,2,0,0,22
1903358,1479958,2025-02-03,House,"Read third time and passed House (94-Y 5-N)",94,5,0,1,100
1903358,1488202,2025-02-12,Senate,"Reported from General Laws and Technology (15-Y 0-N)",15,0,0,0,15
1903358,1490219,2025-02-14,Senate,"Constitutional reading dispensed (on 2nd reading) (36-Y 0-N)",36,0,0,4,40
1903358,1490930,2025-02-17,Senate,"Passed Senate with substitute (39-Y 0-N)",39,0,0,1,40
1903367,1472093,2025-01-17,House,"Subcommittee recommends laying on the table (5-Y 3-N)",5,3,0,1,9
1903373,1472352,2025-01-20,House,"Subcommittee recommends reporting (10-Y 0-N)",10,0,0,1,11
1903373,1472968,2025-01-22,House,"Reported from Education (22-Y 0-N)",22,0,0,0,22
1903373,1477867,2025-01-28,House,"Read third time and passed House (99-Y 0-N)",99,0,0,1,100
1903373,1483129,2025-02-06,Senate,"Reported from Education and Health (14-Y 0-N)",14,0,0,1,15
1903373,1484260,2025-02-07,Senate,"Constitutional reading dispensed (on 2nd reading) (38-Y 0-N)",38,0,0,2,40
1903373,1485484,2025-02-10,Senate,"Passed Senate (39-Y 0-N)",39,0,0,1,40
1903375,1473234,2025-01-22,House,"Subcommittee recommends reporting and referred to Appropriations (7-Y 1-N)",7,1,0,1,9
1903375,1476170,2025-01-29,House,"Reported from Education (20-Y 2-N)",20,2,0,0,22
1903375,1482886,2025-02-04,House,"Read third time and passed House (85-Y 12-N)",85,12,0,3,100
1903375,1489367,2025-02-13,Senate,"Reported from Education and Health and rereferred to Finance and Appropriations (14-Y 0-N)",14,0,0,1,15
1903375,1492551,2025-02-17,Senate,"Passed by indefinitely in Finance and Appropriations with letter (12-Y 2-N)",12,2,0,1,15
1903379,1474008,2025-01-23,House,"Subcommittee recommends reporting and referring to Appropriations (5-Y 3-N)",5,3,0,1,9
1903379,1475975,2025-01-28,House,"Reported from Labor and Commerce and referred to Appropriations (12-Y 10-N)",12,10,0,0,22
1903379,1476783,2025-01-29,House,"Subcommittee recommends reporting with amendment(s) (5-Y 3-N)",5,3,0,1,9
1903379,1476784,2025-01-29,House,"Reported from Appropriations with amendment(s) (11-Y 10-N)",11,10,0,1,22
1903379,1482357,2025-02-04,House,"Read third time and passed House (51-Y 47-N)",51,47,0,2,100
1903379,1485274,2025-02-10,Senate,"Reported from Commerce and Labor and rereferred to Finance and Appropriations (9-Y 6-N)",9,6,0,0,15
1903379,1492093,2025-02-17,Senate,"Reported from Finance and Appropriations (10-Y 4-N)",10,4,0,1,15
1903379,1495174,2025-02-20,Senate,"Reconsideration of defeat agreed to by Senate (39-Y 0-N)",38,0,0,2,40
1903379,1495175,2025-02-20,Senate,"Passed Senate (21-Y 16-N)",21,16,0,3,40
1903379,1495835,2025-02-19,Senate,"Constitutional reading dispensed (on 2nd reading) (40-Y 0-N)",40,0,0,0,40
1903379,1496281,2025-02-20,Senate,"Defeated by Senate (18-Y 20-N)",18,20,0,2,40
1903384,1474396,2025-01-24,House,"Subcommittee recommends reporting with substitute (5-Y 3-N)",5,3,0,1,9
1903384,1475060,2025-01-27,House,"Reported from Appropriations with substitute (13-Y 9-N)",13,9,0,0,22
1903384,1478606,2025-01-31,House,"Read third time and passed House (61-Y 34-N)",61,34,0,5,100
1903384,1486137,2025-02-11,Senate,"Passed by indefinitely in Finance and Appropriations (15-Y 0-N)",15,0,0,0,15
1903386,1472168,2025-01-17,House,"Subcommittee recommends reporting with substitute and referred to Appropriations (8-Y 0-N)",8,0,0,1,9
1903386,1474688,2025-01-24,House,"Reported from Courts of Justice with substitute and referred to Appropriations (22-Y 0-N)",22,0,0,0,22
1903386,1478181,2025-01-31,House,"Reported from Appropriations with substitute (22-Y 0-N)",22,0,0,0,22
1903386,1479822,2025-02-04,House,"Read third time and passed House (91-Y 7-N)",91,7,0,2,100
1903386,1484690,2025-02-10,Senate,"Reported from Courts of Justice with substitute and rereferred to Finance and Appropriations (15-Y 0-N)",15,0,0,0,15
1903386,1485936,2025-02-11,Senate,"Reported from Finance and Appropriations with substitute (14-Y 1-N)",14,1,0,0,15
1903386,1485937,2025-02-11,Senate,"Constitutional reading dispensed (on 2nd reading) (40-Y 0-N)",40,0,0,0,40
1903386,1488986,2025-02-12,Senate,"Passed Senate with substitute (38-Y 1-N)",38,1,0,1,40
1903386,1488987,2025-02-12,House,"Senate substitute rejected by House (5-Y 87-N)",5,87,0,8,100
1903386,1488988,2025-02-12,Senate,"Senate insisted on substitute (40-Y 0-N)",40,0,0,0,40
1903386,1496455,2025-02-21,Senate,"Conference report agreed to by Senate (36-Y 2-N)",36,2,0,2,40
1903386,1503931,2025-02-21,House,"Conference report agreed to by House (82-Y 8-N)",82,8,0,10,100
1903395,1473892,2025-01-23,House,"Subcommittee recommends reporting with substitute and referring to Appropriations (8-Y 0-N)",8,0,0,1,9
1903395,1475863,2025-01-28,House,"Reported from Health and Human Services with substitute and referred to Appropriations (22-Y 0-N)",22,0,0,0,22
1903395,1476681,2025-01-29,House,"Subcommittee recommends laying on the table (6-Y 0-N)",6,0,0,3,9
1903399,1472546,2025-01-21,House,"Subcommittee recommends reporting with substitute and referred to Appropriations (8-Y 0-N)",8,0,0,1,9
1903399,1473931,2025-01-23,House,"Reported from Health and Human Services with substitute and referred to Appropriations (22-Y 0-N)",22,0,0,0,22
1903399,1474414,2025-01-24,House,"Subcommittee recommends reporting with substitute (7-Y 0-N)",7,0,0,2,9
1903399,1475109,2025-01-27,House,"Reported from Appropriations with substitute (22-Y 0-N)",22,0,0,0,22
1903399,1478615,2025-01-31,House,"Read third time and passed House (96-Y 0-N)",96,0,0,4,100
1903399,1489532,2025-02-13,Senate,"Reported from Education and Health and rereferred to Finance and Appropriations (15-Y 0-N)",15,0,0,0,15
1903399,1490114,2025-02-14,Senate,"Reported from Finance and Appropriations (14-Y 0-N)",14,0,0,1,15
1903399,1492089,2025-02-17,Senate,"Constitutional reading dispensed (on 2nd reading) (39-Y 0-N)",39,0,0,1,40
1903399,1492090,2025-02-18,Senate,"Passed Senate (40-Y 0-N)",40,0,0,0,40
1903399,1535111,2025-04-02,House,"House rejected Governor's recommendation (16-Y 80-N)",16,80,0,4,100
1903399,1535112,2025-04-02,House,"Passed in enrolled form (94-Y 0-N)",94,0,0,6,100
1903408,1472530,2025-01-21,House,"Subcommittee recommends reporting with substitute and referred to Appropriations (8-Y 0-N)",8,0,0,1,9
1903408,1473317,2025-01-22,House,"Reported from Education with substitute (21-Y 1-N)",21,1,0,0,22
1903408,1476715,2025-01-28,House,"Read third time and passed House (95-Y 2-N)",95,2,0,3,100
1903408,1489688,2025-02-13,Senate,"Reported from Education and Health and rereferred to Finance and Appropriations (15-Y 0-N)",15,0,0,0,15
1903408,1490115,2025-02-14,Senate,"Reported from Finance and Appropriations (14-Y 0-N)",14,0,0,1,15
1903408,1492062,2025-02-17,Senate,"Constitutional reading dispensed (on 2nd reading) (39-Y 0-N)",39,0,0,1,40
1903408,1492063,2025-02-18,Senate,"Passed Senate (40-Y 0-N)",40,0,0,0,40
1903408,1535056,2025-04-02,Senate,"Senate concurred in Governor's recommendation (40-Y 0-N)",40,0,0,0,40
1903408,1536313,2025-04-02,House,"House concurred in Governor's recommendation (96-Y 0-N)",96,0,0,4,100
1903411,1475055,2025-01-27,House,"Subcommittee recommends passing by indefinitely (6-Y 2-N)",6,2,0,1,9
1903420,1472772,2025-01-21,House,"Subcommittee recommends striking from the docket (7-Y 0-N)",7,0,0,1,8
1903420,1474033,2025-01-23,House,"Stricken from docket by Labor and Commerce (22-Y 0-N)",22,0,0,0,22
1903423,1474020,2025-01-23,House,"Subcommittee recommends reporting (5-Y 3-N)",5,3,0,1,9
1903423,1475976,2025-01-28,House,"Reported from Labor and Commerce (12-Y 10-N)",12,10,0,0,22
1903423,1480076,2025-02-03,House,"Read third time and passed House (51-Y 48-N)",51,48,0,1,100
1903423,1491351,2025-02-17,Senate,"Reported from Commerce and Labor and rereferred to Finance and Appropriations (9-Y 6-N)",9,6,0,0,15
1903423,1492041,2025-02-17,Senate,"Reported from Finance and Appropriations with substitute (10-Y 4-N)",10,4,0,1,15
1903423,1495838,2025-02-20,House,"Senate substitute agreed to by House (51-Y 45-N)",51,45,0,4,100
1903423,1496278,2025-02-20,Senate,"Passed Senate with substitute with amendment (20-Y 19-N)",20,19,0,1,40
1903439,1473890,2025-01-23,House,"Subcommittee recommends reporting and referring to Appropriations (8-Y 0-N)",8,0,0,1,9
1903439,1475557,2025-01-28,House,"Reported from Health and Human Services and referred to Appropriations (21-Y 0-N)",21,0,0,1,22
1903439,1476617,2025-01-29,House,"Subcommittee recommends laying on the table (6-Y 0-N)",6,0,0,3,9
1903445,1473947,2025-01-23,House,"Subcommittee recommends reporting with substitute and referring to Appropriations (8-Y 0-N)",8,0,0,1,9
1903445,1475653,2025-01-28,House,"Reported from Health and Human Services with substitute and referred to Appropriations (21-Y 0-N)",21,0,0,1,22
1903445,1476619,2025-01-29,House,"Subcommittee recommends reporting (6-Y 0-N)",6,0,0,3,9
1903445,1478282,2025-01-31,House,"Reported from Appropriations (22-Y 0-N)",22,0,0,0,22
1903445,1479532,2025-02-04,House,"Read third time and passed House (97-Y 0-N)",97,0,0,3,100
1903445,1479533,2025-02-04,House,"Passed House (99-Y 0-N)",99,0,0,1,100
1903445,1483869,2025-02-07,Senate,"Reported from Rehabilitation and Social Services and rereferred to Finance and Appropriations (15-Y 0-N)",15,0,0,0,15
1903445,1485853,2025-02-11,Senate,"Passed by indefinitely in Finance and Appropriations (10-Y 5-N)",10,5,0,0,15
1903448,1473124,2025-01-22,House,"Subcommittee recommends reporting with substitute (8-Y 0-N)",8,0,0,1,9
1903448,1474318,2025-01-24,House,"Reported from Appropriations with substitute (22-Y 0-N)",22,0,0,0,22
1903448,1478261,2025-01-30,House,"Read third time and passed House (96-Y 0-N)",96,0,0,4,100
1903448,1486806,2025-02-11,Senate,"Passed by indefinitely in Finance and Appropriations (14-Y 0-N)",14,0,0,1,15
1903456,1472325,2025-01-20,House,"Subcommittee recommends reporting (5-Y 3-N)",5,3,0,1,9
1903456,1473183,2025-01-22,House,"Reported from Finance (12-Y 10-N)",12,10,0,0,22
1903456,1476563,2025-01-28,House,"Read third time and passed House (53-Y 46-N)",53,46,0,1,100
1903456,1486025,2025-02-11,Senate,"Reported from Finance and Appropriations (15-Y 0-N)",15,0,0,0,15
1903456,1486026,2025-02-11,Senate,"Constitutional reading dispensed (on 2nd reading) (40-Y 0-N)",40,0,0,0,40
1903456,1488884,2025-02-12,Senate,"Passed Senate (39-Y 0-N)",39,0,0,1,40
1903461,1473447,2025-01-23,House,"Subcommittee recommends reporting with substitute (8-Y 0-N)",8,0,0,1,9
1903461,1475623,2025-01-28,House,"Reported from Health and Human Services with substitute (22-Y 0-N)",22,0,0,0,22
1903461,1479709,2025-02-03,House,"Read third time and passed House (98-Y 0-N)",98,0,0,2,100
1903461,1479710,2025-02-03,House,"Read third time and passed House (99-Y 0-N)",99,0,0,1,100
1903461,1489626,2025-02-13,Senate,"Reported from Education and Health (13-Y 0-N)",13,0,0,2,15
1903461,1491093,2025-02-17,Senate,"Constitutional reading dispensed (on 2nd reading)",39,0,0,1,40
1903461,1492359,2025-02-18,Senate,"Passed Senate (40-Y 0-N)",40,0,0,0,40
1903468,1476037,2025-01-28,House,"Subcommittee recommends laying on the table (5-Y 2-N)",5,2,0,2,9
1903470,1472084,2025-01-17,House,"Reported from Public Safety (12-Y 10-N)",12,10,0,0,22
1903470,1484621,2025-02-10,Senate,"Reported from Courts of Justice (9-Y 4-N)",9,4,0,2,15
1903470,1486004,2025-02-11,Senate,"Constitutional reading dispensed (on 2nd reading) (40-Y 0-N)",40,0,0,0,40
1903470,1489782,2025-02-12,Senate,"Passed Senate (21-Y 18-N)",21,18,0,1,40
1903470,1565171,2025-01-27,House,"Read third time and passed House (50-Y 46-N)",50,46,0,4,100
1903477,1471484,2025-01-14,House,"Subcommittee recommends reporting (5-Y 2-N)",5,2,0,2,9
1903477,1471683,2025-01-15,House,"Reported from Education (11-Y 10-N)",11,10,0,1,22
1903477,1477330,2025-01-29,House,"Read third time and passed House (49-Y 48-N)",49,48,0,3,100
1903477,1489635,2025-02-13,Senate,"Reported from Education and Health with substitute (15-Y 0-N)",15,0,0,0,15
1903477,1491066,2025-02-17,Senate,"Constitutional reading dispensed (on 2nd reading)",39,0,0,1,40
1903477,1495335,2025-02-19,Senate,"Passed Senate with substitute (24-Y 16-N)",24,16,0,0,40
1903477,1496431,2025-02-20,House,"Senate substitute agreed to by House (51-Y 47-N)",51,47,0,2,100
1903481,1474157,2025-01-23,House,"Subcommittee recommends reporting with amendment(s) and referring to Appropriations (6-Y 2-N)",6,2,0,1,9
1903481,1476025,2025-01-28,House,"Reported from General Laws with amendment(s) and referred to Appropriations (12-Y 10-N)",12,10,0,0,22
1903481,1476415,2025-01-29,House,"Subcommittee recommends reporting (5-Y 3-N)",5,3,0,1,9
1903481,1477006,2025-01-29,House,"Reported from Appropriations (13-Y 8-N)",13,8,0,1,22
1903481,1482786,2025-02-04,House,"Read third time and passed House (54-Y 45-N)",54,45,0,1,100
1903481,1488567,2025-02-12,Senate,"Reported from General Laws and Technology (9-Y 6-N)",9,6,0,0,15
1903481,1490378,2025-02-14,Senate,"Constitutional reading dispensed (on 2nd reading) (36-Y 0-N)",36,0,0,4,40
1903481,1493974,2025-02-18,Senate,"Passed Senate (22-Y 18-N)",22,18,0,0,40
1903483,1475106,2025-01-27,House,"Subcommittee recommends laying on the table (7-Y 2-N)",7,2,0,2,11
1903493,1474707,2025-01-27,House,"Subcommittee recommends reporting (8-Y 0-N)",8,0,0,1,9
1903493,1476431,2025-01-29,House,"Reported from Finance (21-Y 1-N)",21,1,0,0,22
1903493,1482322,2025-02-04,House,"Read third time and passed House (97-Y 0-N)",97,0,0,3,100
1903493,1486816,2025-02-11,Senate,"Reported from Finance and Appropriations with amendment (15-Y 0-N)",15,0,0,0,15
1903493,1486817,2025-02-11,Senate,"Constitutional reading dispensed (on 2nd reading) (40-Y 0-N)",40,0,0,0,40
1903493,1488186,2025-02-12,Senate,"Passed Senate with amendment (39-Y 0-N)",39,0,0,1,40
1903493,1490577,2025-02-14,House,"Senate Amendment rejected by House (0-Y 92-N)",0,92,0,8,100
1903493,1493655,2025-02-18,Senate,"Senate insisted on amendment (40-Y 0-N)",40,0,0,0,40
1903493,1497164,2025-02-22,House,"Conference report agreed to by House (99-Y 0-N)",99,0,0,1,100
1903493,1504063,2025-02-22,Senate,"Conference report agreed to by Senate (40-Y 0-N)",40,0,0,0,40
1903493,1535567,2025-04-02,House,"House concurred in Governor's recommendation (96-Y 0-N)",96,0,0,4,100
1903493,1535568,2025-04-02,Senate,"Senate concurred in Governor's recommendation (40-Y 0-N)",40,0,0,0,40
1903504,1472859,2025-01-21,House,"Subcommittee recommends reporting with amendment(s) (7-Y 0-N)",7,0,0,2,9
1903504,1474111,2025-01-23,House,"Reported from General Laws with amendment(s) (21-Y 0-N)",21,0,0,1,22
1903504,1476813,2025-01-29,House,"Read third time and passed House (96-Y 1-N)",96,1,0,3,100
1903504,1482429,2025-02-05,Senate,"Reported from General Laws and Technology with substitute (15-Y 0-N)",15,0,0,0,15
1903504,1484048,2025-02-07,Senate,"Constitutional reading dispensed (on 2nd reading) (38-Y 0-N)",38,0,0,2,40
1903504,1484620,2025-02-10,Senate,"Passed Senate with substitute (39-Y 0-N)",39,0,0,1,40
1903504,1487921,2025-02-12,House,"Senate substitute agreed to by House (Y-96 N-1 A-0)",96,1,0,3,100
1903505,1475021,2025-01-27,House,"Subcommittee recommends reporting with substitute (4-Y 3-N)",4,3,0,2,9
1903505,1478018,2025-01-31,House,"Reported from Privileges and Elections with substitute (11-Y 10-N)",11,10,0,1,22
1903505,1482462,2025-02-04,House,"Read third time and passed House (56-Y 42-N)",56,42,0,2,100
1903505,1486334,2025-02-11,Senate,"Passed by indefinitely in Privileges and Elections (15-Y 0-N)",15,0,0,0,15
1903510,1471958,2025-01-16,House,"Reported from Labor and Commerce and referred to Appropriations (12-Y 10-N)",12,10,0,0,22
1903510,1473203,2025-01-22,House,"Subcommittee recommends reporting (5-Y 3-N)",5,3,0,1,9
1903510,1474256,2025-01-24,House,"Reported from Appropriations (12-Y 10-N)",12,10,0,0,22
1903510,1478221,2025-01-30,House,"Read third time and passed House (50-Y 46-N)",50,46,0,4,100
1903510,1485412,2025-02-10,Senate,"Reported from Commerce and Labor and rereferred to Finance and Appropriations (9-Y 6-N)",9,6,0,0,15
1903510,1490150,2025-02-14,Senate,"Reported from Finance and Appropriations (10-Y 4-N)",10,4,0,1,15
1903510,1492082,2025-02-17,Senate,"Constitutional reading dispensed (on 2nd reading) (39-Y 0-N)",39,0,0,1,40
1903510,1495842,2025-02-19,Senate,"Passed Senate (21-Y 19-N)",21,19,0,0,40
1903510,1536272,2025-04-02,House,"House sustained Governor's veto (50-Y 46-N)",50,46,0,4,100
1903517,1471608,2025-01-14,House,"Subcommittee recommends reporting with amendment(s) and referred to Appropriations (7-Y 0-N)",7,0,0,2,9
1903517,1471714,2025-01-15,House,"Reported from Education with amendment(s) and referred to Appropriations (13-Y 8-N)",13,8,0,1,22
1903517,1474501,2025-01-24,House,"Subcommittee recommends reporting (5-Y 3-N)",5,3,0,1,9
1903517,1475075,2025-01-27,House,"Reported from Appropriations (12-Y 9-N)",12,9,0,1,22
1903517,1478421,2025-01-31,House,"Read third time and passed House (52-Y 44-N)",52,44,0,4,100
1903517,1489879,2025-02-13,Senate,"Reported from Education and Health with substitute (15-Y 0-N)",15,0,0,0,15
1903517,1491596,2025-02-17,Senate,"Constitutional reading dispensed (on 2nd reading)",39,0,0,1,40
1903517,1493635,2025-02-18,Senate,"Passed Senate with substitute (40-Y 0-N)",40,0,0,0,40
1903517,1493636,2025-02-19,House,"Senate substitute agreed to by House (52-Y 43-N)",52,43,0,5,100
1903528,1475982,2025-01-28,House,"Subcommittee recommends reporting (5-Y 3-N)",5,3,0,1,9
1903528,1478003,2025-01-30,House,"Reported from General Laws (12-Y 9-N)",12,9,0,1,22
1903528,1482250,2025-02-04,House,"Read third time and passed House (50-Y 44-N)",50,44,0,6,100
1903528,1488211,2025-02-12,Senate,"Reported from General Laws and Technology and rereferred to Finance and Appropriations (9-Y 6-N)",9,6,0,0,15
1903528,1492562,2025-02-17,Senate,"Reported from Finance and Appropriations (10-Y 4-N)",10,4,0,1,15
1903528,1493935,2025-02-19,Senate,"Constitutional reading dispensed (on 2nd reading) (40-Y 0-N)",40,0,0,0,40
1903528,1496184,2025-02-20,Senate,"Passed Senate (20-Y 19-N)",20,19,0,1,40
1903538,1472534,2025-01-21,House,"Subcommittee recommends reporting and referred to Appropriations (7-Y 1-N)",7,1,0,1,9
1903538,1472916,2025-01-22,House,"Reported from Education and referred to Appropriations (15-Y 7-N)",15,7,0,0,22
1903538,1476432,2025-01-29,House,"Subcommittee recommends laying on the table (7-Y 0-N)",7,0,0,2,9
1903541,1475104,2025-01-27,House,"Subcommittee recommends striking from the docket (10-Y 0-N)",10,0,0,1,11
1903552,1471483,2025-01-14,House,"Subcommittee recommends reporting with amendment(s) (8-Y 0-N)",8,0,0,1,9
1903552,1471680,2025-01-15,House,"Reported from Education with amendment(s) (21-Y 0-N)",21,0,0,1,22
1903552,1472752,2025-01-21,House,"Read third time and passed House (96-Y 0-N)",96,0,0,4,100
1903552,1489780,2025-02-13,Senate,"Reported from Education and Health with amendment (15-Y 0-N)",15,0,0,0,15
1903552,1492289,2025-02-17,Senate,"Constitutional reading dispensed (on 2nd reading)",39,0,0,1,40
1903552,1492290,2025-02-18,Senate,"Passed Senate with amendment (40-Y 0-N)",40,0,0,0,40
1903552,1493630,2025-02-19,House,"Senate Amendment agreed to by House (96-Y 0-N)",96,0,0,4,100
1903554,1474083,2025-01-23,House,"Subcommittee recommends laying on the table (7-Y 0-N)",7,0,0,2,9
1903563,1475891,2025-01-28,House,"Subcommittee recommends reporting (7-Y 0-N)",7,0,0,1,8
1903563,1477749,2025-01-30,House,"Reported from Labor and Commerce (21-Y 1-N)",21,1,0,0,22
1903563,1482763,2025-02-04,House,"Read third time and passed House (95-Y 3-N)",95,3,0,2,100
1903563,1491595,2025-02-17,Senate,"Reported from Commerce and Labor with substitute (15-Y 0-N)",15,0,0,0,15
1903563,1492286,2025-02-18,Senate,"Constitutional reading dispensed (on 2nd reading) (40-Y 0-N)",40,0,0,0,40
1903563,1496016,2025-02-19,Senate,"Passed Senate with substitute (40-Y 0-N)",40,0,0,0,40
1903563,1496294,2025-02-20,House,"Senate substitute agreed to by House (89-Y 9-N)",89,9,0,2,100
1903567,1472060,2025-01-16,House,"Subcommittee recommends striking from the docket (7-Y 0-N)",7,0,0,2,9
1903567,1472866,2025-01-21,House,"Stricken from docket by Labor and Commerce (22-Y 0-N)",22,0,0,0,22
1903575,1471819,2025-01-15,House,"Subcommittee recommends reporting with substitute (8-Y 0-N)",8,0,0,1,9
1903575,1472267,2025-01-17,House,"Reported from Courts of Justice with substitute (22-Y 0-N)",22,0,0,0,22
1903575,1473711,2025-01-23,House,"Read third time and passed House (97-Y 0-N)",97,0,0,3,100
1903575,1483010,2025-02-05,Senate,"Reported from Courts of Justice (14-Y 0-N)",14,0,0,1,15
1903575,1484122,2025-02-07,Senate,"Constitutional reading dispensed (on 2nd reading) (38-Y 0-N)",38,0,0,2,40
1903575,1485188,2025-02-10,Senate,"Passed Senate (39-Y 0-N)",39,0,0,1,40
1903581,1473967,2025-01-23,House,"Subcommittee recommends reporting and referring to Appropriations (8-Y 0-N)",8,0,0,1,9
1903581,1475620,2025-01-28,House,"Reported from Health and Human Services with substitute and referred to Appropriations (19-Y 2-N)",19,2,0,1,22
1903581,1476610,2025-01-29,House,"Subcommittee recommends reporting (6-Y 0-N)",6,0,0,3,9
1903581,1478275,2025-01-31,House,"Reported from Appropriations (22-Y 0-N)",22,0,0,0,22
1903581,1482160,2025-02-04,House,"Read third time and passed House (83-Y 14-N)",83,14,0,3,100
1903581,1489698,2025-02-13,Senate,"Reported from Education and Health with substitute and rereferred to Finance and Appropriations (15-Y 0-N)",15,0,0,0,15
1903581,1492130,2025-02-17,Senate,"Reported from Finance and Appropriations with substitute (14-Y 0-N)",14,0,0,1,15
1903581,1495888,2025-02-19,Senate,"Constitutional reading dispensed (on 2nd reading) (40-Y 0-N)",40,0,0,0,40
1903581,1496339,2025-02-20,Senate,"Passed Senate with substitute (39-Y 0-N)",39,0,0,1,40
1903581,1496340,2025-02-20,Senate,"Reconsideration of Senate passage agreed to by Senate (39-Y 0-N)",39,0,0,1,40
1903581,1496341,2025-02-20,Senate,"Passed Senate with substitute (39-Y 0-N)",39,0,0,1,40
1903581,1496790,2025-02-20,House,"Senate substitute agreed to by House (83-Y 13-N)",83,13,0,4,100
1903581,1536403,2025-04-02,House,"Passed by for the day (47-Y 46-N)",47,46,0,7,100
1903589,1472678,2025-01-21,House,"Subcommittee recommends striking from the docket (7-Y 0-N)",7,0,0,2,9
1903589,1474095,2025-01-23,House,"Stricken from docket by General Laws (21-Y 0-N)",21,0,0,1,22
1903596,1472792,2025-01-21,House,"Subcommittee recommends reporting and referred to Appropriations (8-Y 2-N)",8,2,0,1,11
1903596,1473982,2025-01-23,House,"Reported from Labor and Commerce and referred to Appropriations (17-Y 5-N)",17,5,0,0,22
1903596,1476799,2025-01-29,House,"Subcommittee recommends reporting (6-Y 2-N)",6,2,0,1,9
1903596,1476800,2025-01-29,House,"Reported from Appropriations (13-Y 8-N)",13,8,0,1,22
1903596,1480590,2025-02-04,House,"Read third time and passed House (65-Y 33-N)",65,33,0,2,100
1903596,1485388,2025-02-10,Senate,"Reported from Commerce and Labor and rereferred to Finance and Appropriations (15-Y 0-N)",15,0,0,0,15
1903596,1492084,2025-02-17,Senate,"Reported from Finance and Appropriations (14-Y 0-N)",14,0,0,1,15
1903596,1495833,2025-02-19,Senate,"Constitutional reading dispensed (on 2nd reading) (40-Y 0-N)",40,0,0,0,40
1903596,1496273,2025-02-20,Senate,"Passed Senate (39-Y 0-N)",39,0,0,1,40
1903596,1496274,2025-02-20,Senate,"Reconsideration of Senate passage agreed to by Senate (39-Y 0-N)",39,0,0,1,40
1903596,1496275,2025-02-20,Senate,"Passed Senate (39-Y 0-N)",39,0,0,1,40
1903596,1536268,2025-04-02,House,"Passed by for the day (47-Y 46-N)",47,46,0,7,100
1903598,1472798,2025-01-21,House,"Subcommittee recommends reporting with substitute and referred to Appropriations (5-Y 2-N)",5,2,0,1,8
1903598,1474018,2025-01-23,House,"Reported from Labor and Commerce with substitute and referred to Appropriations (22-Y 0-N)",22,0,0,0,22
1903598,1476603,2025-01-29,House,"Subcommittee recommends reporting (6-Y 0-N)",6,0,0,3,9
1903598,1478276,2025-01-31,House,"Reported from Appropriations (22-Y 0-N)",22,0,0,0,22
1903598,1482154,2025-02-04,House,"Read third time and passed House (97-Y 0-N)",97,0,0,3,100
1903598,1482155,2025-02-04,House,"Passed House (99-Y 0-N)",99,0,0,1,100
1903598,1484963,2025-02-10,Senate,"Reported from Commerce and Labor with substitute (15-Y 0-N)",15,0,0,0,15
1903598,1488853,2025-02-12,Senate,"Constitutional reading dispensed (on 2nd reading) (39-Y 0-N)",39,0,0,1,40
1903598,1488854,2025-02-13,Senate,"Passed Senate with substitute (40-Y 0-N)",40,0,0,0,40
1903598,1491000,2025-02-17,House,"Senate substitute rejected by House (0-Y 96-N)",0,96,0,4,100
1903598,1492259,2025-02-18,Senate,"Senate insisted on substitute (40-Y 0-N)",40,0,0,0,40
1903598,1496442,2025-02-21,Senate,"Conference report agreed to by Senate (40-Y 0-N)",40,0,0,0,40
1903598,1503937,2025-02-21,House,"Conference report agreed to by House (96-Y 0-N)",96,0,0,4,100
1903598,1536586,2025-04-02,House,"House rejected Governor's recommendation (14-Y 81-N)",14,81,0,5,100
1903598,1536587,2025-04-02,House,"Passed in enrolled form (70-Y 24-N)",70,24,0,6,100
1903603,1471480,2025-01-14,House,"Subcommittee recommends reporting and referred to Appropriations (8-Y 0-N)",8,0,0,1,9
1903603,1471676,2025-01-15,House,"Reported from Education and referred to Appropriations (21-Y 0-N)",21,0,0,1,22
1903603,1472454,2025-01-20,House,"Subcommittee recommends laying on the table (5-Y 3-N)",5,3,0,1,9
1903614,1472428,2025-01-20,House,"Subcommittee recommends reporting and referred to Appropriations (8-Y 0-N)",8,0,0,1,9
1903614,1474706,2025-01-24,House,"Reported from Courts of Justice and referred to Appropriations (22-Y 0-N)",22,0,0,0,22
1903614,1475082,2025-01-27,House,"Subcommittee recommends reporting with substitute (7-Y 0-N)",7,0,0,2,9
1903614,1476758,2025-01-29,House,"Reported from Appropriations with substitute (20-Y 1-N)",20,1,0,1,22
1903614,1482634,2025-02-04,House,"Read third time and passed House (98-Y 0-N)",98,0,0,2,100
1903614,1485865,2025-02-10,Senate,"Reported from Courts of Justice and rereferred to Finance and Appropriations (15-Y 0-N)",15,0,0,0,15
1903614,1488246,2025-02-12,Senate,"Reported from Finance and Appropriations with substitute (15-Y 0-N)",15,0,0,0,15
1903614,1489638,2025-02-13,Senate,"Constitutional reading dispensed (on 2nd reading) (40-Y 0-N)",40,0,0,0,40
1903614,1490413,2025-02-14,Senate,"Passed Senate with substitute (36-Y 0-N)",36,0,0,4,40
1903614,1493091,2025-02-18,House,"Senate substitute rejected by House (0-Y 94-N)",0,94,0,6,100
1903614,1494362,2025-02-19,Senate,"Senate insisted on substitute (40-Y 0-N)",40,0,0,0,40
1903614,1497186,2025-02-22,House,"Conference report agreed to by House (99-Y 0-N)",99,0,0,1,100
1903614,1503104,2025-02-22,Senate,"Conference report agreed to by Senate (40-Y 0-N)",40,0,0,0,40
1903617,1475290,2025-01-28,House,"Subcommittee recommends reporting with substitute (6-Y 2-N)",6,2,0,1,9
1903617,1476279,2025-01-29,House,"Reported from Education with substitute (16-Y 6-N)",16,6,0,0,22
1903617,1480725,2025-02-04,House,"Read third time and passed House (69-Y 30-N)",69,30,0,1,100
1903617,1489529,2025-02-13,Senate,"Reported from Education and Health with substitute (9-Y 6-N)",9,6,0,0,15
1903617,1491033,2025-02-17,Senate,"Constitutional reading dispensed (on 1st reading) (39-Y 0-N)",39,0,0,1,40
1903617,1493759,2025-02-19,Senate,"Passed Senate with substitute (21-Y 19-N)",21,19,0,0,40
1903617,1496470,2025-02-20,House,"Senate substitute agreed to by House (75-Y 22-N)",75,22,0,3,100
1903617,1536812,2025-04-02,House,"House concurred in Governor's recommendation (96-Y 0-N)",96,0,0,4,100
1903617,1536813,2025-04-02,Senate,"Senate concurred in Governor's recommendation (40-Y 0-N)",40,0,0,0,40
1903620,1473028,2025-01-22,House,"Subcommittee recommends laying on the table (10-Y 0-N)",10,0,0,1,11
1903624,1472429,2025-01-20,House,"Subcommittee recommends reporting with amendment(s) and referred to Appropriations (10-Y 0-N)",10,0,0,1,11
1903624,1473121,2025-01-22,House,"Reported from Agriculture, Chesapeake and Natural Resources with amendment(s) and referred to Appropriations (22-Y 0-N)",22,0,0,0,22
1903624,1476527,2025-01-29,House,"Subcommittee recommends laying on the table (5-Y 3-N)",5,3,0,1,9
1903631,1476719,2025-01-29,House,"Tabled in Rules (14-Y 0-N)",14,0,0,4,18
1903633,1471968,2025-01-16,House,"Subcommittee recommends reporting with amendment(s) (8-Y 2-N)",8,2,0,1,11
1903633,1472787,2025-01-21,House,"Reported from Labor and Commerce with substitute (15-Y 7-N)",15,7,0,0,22
1903633,1476417,2025-01-29,House,"Subcommittee recommends reporting with amendment(s) (7-Y 1-N)",7,1,0,1,9
1903633,1476807,2025-01-29,House,"Reported from Appropriations with amendment(s) (14-Y 7-N)",14,7,0,1,22
1903633,1482375,2025-02-04,House,"Read third time and passed House (64-Y 34-N)",64,34,0,2,100
1903633,1488045,2025-02-12,Senate,"Reported from General Laws and Technology with amendments and rereferred to Finance and Appropriations (9-Y 6-N)",9,6,0,0,15
1903633,1492140,2025-02-17,Senate,"Reported from Finance and Appropriations (11-Y 3-N)",11,3,0,1,15
1903633,1493587,2025-02-19,Senate,"Constitutional reading dispensed (on 2nd reading) (40-Y 0-N)",40,0,0,0,40
1903633,1496300,2025-02-20,Senate,"Passed Senate with amendments (21-Y 18-N)",21,18,0,1,40
1903633,1496782,2025-02-20,House,"Senate Amendments agreed to by House (60-Y 35-N)",60,35,0,5,100
1903636,1472510,2025-01-20,House,"Subcommittee recommends reporting with amendment(s) (8-Y 0-N)",8,0,0,1,9
1903636,1474718,2025-01-24,House,"Reported from Courts of Justice with amendment(s) (22-Y 0-N)",22,0,0,0,22
1903636,1478244,2025-01-30,House,"Read third time and passed House (96-Y 0-N)",96,0,0,4,100
1903636,1485344,2025-02-10,Senate,"Reported from Courts of Justice with substitute and rereferred to Finance and Appropriations (14-Y 1-N)",14,1,0,0,15
1903636,1491759,2025-02-17,Senate,"Passed by indefinitely in Finance and Appropriations (13-Y 0-N 1-A)",13,0,1,1,15
1903641,1472169,2025-01-17,House,"Subcommittee recommends reporting with amendment(s) (8-Y 0-N)",8,0,0,1,9
1903641,1474670,2025-01-24,House,"Reported from Courts of Justice with amendment(s) (22-Y 0-N)",22,0,0,0,22
1903641,1478298,2025-01-30,House,"Read third time and passed House (96-Y 0-N)",96,0,0,4,100
1903641,1484853,2025-02-10,Senate,"Reported from Courts of Justice and rereferred to Finance and Appropriations (12-Y 0-N)",12,0,0,3,15
1903641,1487353,2025-02-12,Senate,"Reported from Finance and Appropriations with amendment (15-Y 0-N)",15,0,0,0,15
1903641,1488879,2025-02-13,Senate,"Constitutional reading dispensed (on 2nd reading) (40-Y 0-N)",40,0,0,0,40
1903641,1490204,2025-02-14,Senate,"Passed Senate with amendment (36-Y 0-N)",36,0,0,4,40
1903641,1492228,2025-02-18,House,"Senate Amendment rejected by House (2-Y 93-N)",2,93,0,5,100
1903641,1493667,2025-02-19,Senate,"Senate insisted on amendment (38-Y 0-N)",38,0,0,2,40
1903641,1497146,2025-02-21,Senate,"Conference report agreed to by Senate (40-Y 0-N)",40,0,0,0,40
1903641,1497147,2025-02-22,House,"Conference report agreed to by House (98-Y 0-N)",98,0,0,2,100
1903645,1472571,2025-01-21,House,"Subcommittee recommends reporting (8-Y 0-N)",8,0,0,1,9
1903645,1473255,2025-01-22,House,"Reported from Education (22-Y 0-N)",22,0,0,0,22
1903645,1476852,2025-01-28,House,"Read third time and passed House (99-Y 0-N)",99,0,0,1,100
1903645,1483120,2025-02-06,Senate,"Reported from Education and Health (14-Y 0-N)",14,0,0,1,15
1903645,1483885,2025-02-07,Senate,"Constitutional reading dispensed (on 2nd reading) (38-Y 0-N)",38,0,0,2,40
1903645,1484588,2025-02-10,Senate,"Passed Senate (39-Y 0-N)",39,0,0,1,40
1903649,1471725,2025-01-15,House,"Subcommittee recommends reporting (8-Y 0-N)",8,0,0,1,9
1903649,1472175,2025-01-17,House,"Reported from Appropriations (21-Y 0-N)",21,0,0,1,22
1903649,1473507,2025-01-23,House,"Read third time and passed House (97-Y 0-N)",97,0,0,3,100
1903649,1486692,2025-02-11,Senate,"Reported from Agriculture, Conservation and Natural Resources and rereferred to Finance and Appropriations (14-Y 0-N)",14,0,0,1,15
1903649,1492240,2025-02-17,Senate,"Reported from Finance and Appropriations (14-Y 0-N)",14,0,0,1,15
1903649,1493726,2025-02-19,Senate,"Constitutional reading dispensed (on 2nd reading) (40-Y 0-N)",40,0,0,0,40
1903649,1496425,2025-02-20,Senate,"Passed Senate (39-Y 0-N)",39,0,0,1,40
1903649,1496426,2025-02-20,Senate,"Reconsideration of Senate passage agreed to by Senate (39-Y 0-N)",39,0,0,1,40
1903649,1496427,2025-02-20,Senate,"Passed Senate (39-Y 0-N)",39,0,0,1,40
1903651,1475300,2025-01-28,House,"Subcommittee recommends reporting with substitute (6-Y 2-N)",6,2,0,1,9
1903651,1476131,2025-01-29,House,"Reported from Education with substitute (13-Y 9-N)",13,9,0,0,22
1903651,1480533,2025-02-04,House,"Read third time and passed House (62-Y 37-N)",62,37,0,1,100
1903651,1489654,2025-02-13,Senate,"Reported from Education and Health with substitute and rereferred to Finance and Appropriations (6-Y 4-N)",6,4,0,5,15
1903651,1492148,2025-02-17,Senate,"Reported from Finance and Appropriations (10-Y 4-N)",10,4,0,1,15
1903651,1493603,2025-02-19,Senate,"Constitutional reading dispensed (on 2nd reading) (40-Y 0-N)",40,0,0,0,40
1903651,1496331,2025-02-20,Senate,"Passed Senate with substitute (27-Y 12-N)",27,12,0,1,40
1903651,1496332,2025-02-20,Senate,"Reconsideration of Senate passage agreed to by Senate (39-Y 0-N)",39,0,0,1,40
1903651,1496333,2025-02-20,Senate,"Passed Senate with substitute (27-Y 12-N)",27,12,0,1,40
1903651,1535425,2025-04-02,Senate,"Senate concurred in Governor's recommendation (40-Y 0-N)",40,0,0,0,40
1903651,1536646,2025-04-02,House,"House concurred in Governor's recommendation #'s 2-12 (88-Y 5-N)",88,5,0,7,100
1903651,1564958,2025-02-20,House,"Senate substitute agreed to by House (59-Y 37-N)",59,37,0,4,100
1903651,1564959,2025-04-02,House,"House rejected Governor's recommendation #1 (33-Y 61-N)",33,61,0,6,100
1903655,1472204,2025-01-17,House,"Subcommittee recommends reporting (8-Y 0-N)",8,0,0,1,9
1903655,1474648,2025-01-24,House,"Reported from Courts of Justice (22-Y 0-N)",22,0,0,0,22
1903655,1478188,2025-01-30,House,"Read third time and passed House (96-Y 0-N)",96,0,0,4,100
1903655,1483027,2025-02-05,Senate,"Reported from Courts of Justice (14-Y 0-N)",14,0,0,1,15
1903655,1484224,2025-02-07,Senate,"Constitutional reading dispensed (on 2nd reading) (38-Y 0-N)",38,0,0,2,40
1903655,1485331,2025-02-10,Senate,"Passed Senate (39-Y 0-N)",39,0,0,1,40
1903664,1478136,2025-01-31,House,"Reported from Finance with substitute (19-Y 0-N)",19,0,0,3,22
1903664,1480778,2025-02-04,House,"Read third time and passed House (97-Y 0-N)",97,0,0,3,100
1903664,1480779,2025-02-04,House,"Passed House (99-Y 0-N)",99,0,0,1,100
1903664,1486590,2025-02-11,Senate,"Reported from Finance and Appropriations with substitute (15-Y 0-N)",15,0,0,0,15
1903664,1486591,2025-02-11,Senate,"Constitutional reading dispensed (on 2nd reading) (40-Y 0-N)",40,0,0,0,40
1903664,1487722,2025-02-12,Senate,"Passed Senate with substitute (39-Y 0-N)",39,0,0,1,40
1903664,1490250,2025-02-14,House,"Senate substitute rejected by House (0-Y 95-N)",0,95,0,5,100
1903664,1494346,2025-02-18,Senate,"Senate insisted on substitute (40-Y 0-N)",40,0,0,0,40
1903671,1471732,2025-01-15,House,"Subcommittee recommends reporting with substitute (9-Y 1-N)",9,1,0,1,11
1903671,1473133,2025-01-22,House,"Reported from Agriculture, Chesapeake and Natural Resources with substitute (21-Y 1-N)",21,1,0,0,22
1903671,1476460,2025-01-28,House,"Read third time and passed House (66-Y 33-N)",66,33,0,1,100
1903671,1486631,2025-02-11,Senate,"Reported from Agriculture, Conservation and Natural Resources with amendments (13-Y 1-N)",13,1,0,1,15
1903671,1489021,2025-02-13,Senate,"Constitutional reading dispensed (on 2nd reading) (40-Y 0-N)",40,0,0,0,40
1903671,1490284,2025-02-14,Senate,"Passed Senate with amendments (27-Y 9-N)",27,9,0,4,40
1903671,1492336,2025-02-18,House,"Senate Amendments agreed to by House (67-Y 28-N)",67,28,0,5,100
1903672,1472025,2025-01-16,House,"Subcommittee recommends reporting and referred to Appropriations (8-Y 0-N)",8,0,0,1,9
1903672,1472811,2025-01-21,House,"Reported from Labor and Commerce and referred to Appropriations (21-Y 0-N)",21,0,0,1,22
1903672,1475114,2025-01-27,House,"Subcommittee recommends reporting (7-Y 0-N)",7,0,0,2,9
1903672,1476389,2025-01-29,House,"Subcommittee recommends reporting with amendment(s) (7-Y 0-N)",7,0,0,2,9
1903672,1476995,2025-01-29,House,"Reported from Appropriations with amendment(s) (21-Y 0-N)",21,0,0,1,22
1903672,1479588,2025-02-04,House,"Read third time and passed House (97-Y 0-N)",97,0,0,3,100
1903672,1479589,2025-02-04,House,"Passed House (99-Y 0-N)",99,0,0,1,100
1903672,1485079,2025-02-10,Senate,"Reported from Commerce and Labor with substitute and rereferred to Finance and Appropriations (15-Y 0-N)",15,0,0,0,15
1903672,1490408,2025-02-14,Senate,"Reported from Finance and Appropriations with amendment (14-Y 0-N)",14,0,0,1,15
1903672,1491521,2025-02-17,Senate,"Constitutional reading dispensed (on 2nd reading) (39-Y 0-N)",39,0,0,1,40
1903672,1492503,2025-02-18,Senate,"Passed Senate with substitute with amendment (40-Y 0-N)",40,0,0,0,40
1903672,1493993,2025-02-19,House,"Senate substitute with amendment agreed to by House (96-Y 1-N 0-A)",97,0,0,3,100
1903678,1472401,2025-01-20,House,"Subcommittee recommends reporting (8-Y 0-N)",8,0,0,1,9
1903678,1474221,2025-01-24,House,"Reported from Privileges and Elections (21-Y 0-N)",21,0,0,1,22
1903678,1478306,2025-01-30,House,"Read third time and passed House (96-Y 0-N)",96,0,0,4,100
1903678,1486175,2025-02-11,Senate,"Passed by indefinitely in Privileges and Elections (8-Y 7-N)",8,7,0,0,15
1903682,1472553,2025-01-21,House,"Subcommittee recommends reporting with substitute (8-Y 0-N)",8,0,0,1,9
1903682,1473051,2025-01-22,House,"Reported from Education with substitute (17-Y 4-N)",17,4,0,1,22
1903682,1477273,2025-01-28,House,"Read third time and passed House (71-Y 28-N)",71,28,0,1,100
1903682,1489670,2025-02-13,Senate,"Reported from Education and Health (9-Y 6-N)",9,6,0,0,15
1903682,1491152,2025-02-17,Senate,"Constitutional reading dispensed (on 2nd reading) (39-Y 0-N)",39,0,0,1,40
1903682,1495380,2025-02-19,Senate,"Passed Senate (25-Y 15-N)",25,15,0,0,40
1903682,1535468,2025-04-02,Senate,"Senate concurred in Governor's recommendation (40-Y 0-N)",40,0,0,0,40
1903682,1536677,2025-04-02,House,"House concurred in Governor's recommendation (92-Y 2-N)",92,2,0,6,100
1903704,1472906,2025-01-22,House,"Subcommittee recommends reporting (5-Y 2-N)",5,2,0,2,9
1903704,1474275,2025-01-24,House,"Reported from Counties, Cities and Towns (13-Y 7-N)",13,7,0,2,22
1903704,1478259,2025-01-30,House,"Read third time and passed House (54-Y 42-N)",54,42,0,4,100
1903704,1484564,2025-02-10,Senate,"Reported from Local Government with substitute (8-Y 7-N)",8,7,0,0,15
1903704,1486143,2025-02-11,Senate,"Constitutional reading dispensed (on 2nd reading) (40-Y 0-N)",40,0,0,0,40
1903704,1488851,2025-02-12,Senate,"Passed Senate with substitute (21-Y 17-N)",21,17,0,2,40
1903704,1490168,2025-02-14,House,"Senate substitute agreed to by House (50-Y 46-N)",50,46,0,4,100
1903705,1477607,2025-01-30,House,"Subcommittee recommends reporting with substitute (5-Y 3-N)",5,3,0,1,9
1903705,1477727,2025-01-30,House,"Reported from General Laws with substitute (12-Y 9-N)",12,9,0,1,22
1903705,1488080,2025-02-12,Senate,"Reported from General Laws and Technology (9-Y 6-N)",9,6,0,0,15
1903705,1490227,2025-02-14,Senate,"Constitutional reading dispensed (on 2nd reading) (36-Y 0-N)",36,0,0,4,40
1903705,1492331,2025-02-18,Senate,"Passed Senate (21-Y 19-N)",21,19,0,0,40
1903705,1564946,2025-02-04,House,"Read third time and passed House (50-Y 47-N)",50,47,0,3,100
1903706,1472768,2025-01-21,House,"Subcommittee recommends reporting (5-Y 3-N)",5,3,0,1,9
1903706,1472932,2025-01-22,House,"Reported from Education (12-Y 10-N)",12,10,0,0,22
1903706,1476495,2025-01-28,House,"Read third time and passed House (51-Y 48-N)",51,48,0,1,100
1903706,1489713,2025-02-13,Senate,"Reported from Education and Health and rereferred to Finance and Appropriations (9-Y 6-N)",9,6,0,0,15
1903706,1490105,2025-02-14,Senate,"Passed by indefinitely in Finance and Appropriations (10-Y 4-N)",10,4,0,1,15
1903707,1472578,2025-01-21,House,"Subcommittee recommends reporting and referred to Appropriations (8-Y 0-N)",8,0,0,1,9
1903707,1473463,2025-01-23,House,"Reported from Health and Human Services and referred to Appropriations (22-Y 0-N)",22,0,0,0,22
1903707,1474404,2025-01-24,House,"Subcommittee recommends reporting with substitute (7-Y 0-N)",7,0,0,2,9
1903707,1475033,2025-01-27,House,"Reported from Appropriations with substitute (22-Y 0-N)",22,0,0,0,22
1903707,1478607,2025-01-31,House,"Read third time and passed House (96-Y 0-N)",96,0,0,4,100
1903707,1489581,2025-02-13,Senate,"Reported from Education and Health (15-Y 0-N)",15,0,0,0,15
1903707,1491062,2025-02-17,Senate,"Constitutional reading dispensed (on 2nd reading)",39,0,0,1,40
1903707,1492348,2025-02-18,Senate,"Passed Senate (40-Y 0-N)",40,0,0,0,40
1903708,1473457,2025-01-23,House,"Subcommittee recommends laying on the table (8-Y 0-N)",8,0,0,1,9
1903709,1471955,2025-01-16,House,"Subcommittee recommends laying on the table (10-Y 0-N)",10,0,0,1,11
1903710,1473060,2025-01-22,House,"Subcommittee recommends laying on the table (10-Y 0-N)",10,0,0,1,11
1903711,1472652,2025-01-21,House,"Subcommittee recommends reporting (8-Y 0-N)",8,0,0,1,9
1903711,1473777,2025-01-23,House,"Reported from Transportation (21-Y 0-N)",21,0,0,1,22
1903711,1478392,2025-01-31,House,"Read third time and passed House (96-Y 0-N)",96,0,0,4,100
1903711,1483527,2025-02-06,Senate,"Reported from Transportation and rereferred to Finance and Appropriations (11-Y 0-N)",11,0,0,4,15
1903711,1487730,2025-02-12,Senate,"Passed by indefinitely in Finance and Appropriations (15-Y 0-N)",15,0,0,0,15
1903712,1478011,2025-01-31,House,"Reported from Public Safety with substitute (12-Y 9-N)",12,9,0,1,22
1903712,1480780,2025-02-04,House,"Read third time and passed House (52-Y 46-N)",52,46,0,2,100
1903712,1484753,2025-02-10,Senate,"Reported from Courts of Justice and rereferred to Finance and Appropriations (9-Y 4-N)",9,4,0,2,15
1903712,1487360,2025-02-12,Senate,"Reported from Finance and Appropriations (10-Y 5-N)",10,5,0,0,15
1903712,1488876,2025-02-13,Senate,"Constitutional reading dispensed (on 2nd reading) (40-Y 0-N)",40,0,0,0,40
1903712,1490202,2025-02-14,Senate,"Passed Senate (21-Y 15-N)",21,15,0,4,40
1903712,1536738,2025-04-02,House,"House sustained Governor's veto (50-Y 46-N)",50,46,0,4,100
1903713,1471858,2025-01-15,House,"Subcommittee recommends laying on the table (5-Y 3-N)",5,3,0,1,9
1903714,1473989,2025-01-23,House,"Subcommittee recommends reporting with amendment(s) (5-Y 2-N)",5,2,0,2,9
1903714,1475796,2025-01-28,House,"Reported from Labor and Commerce with amendment(s) (12-Y 10-N)",12,10,0,0,22
1903714,1479551,2025-02-03,House,"Read third time and passed House (51-Y 48-N)",51,48,0,1,100
1903714,1484895,2025-02-10,Senate,"Reported from Commerce and Labor with substitute and rereferred to Finance and Appropriations (9-Y 6-N)",9,6,0,0,15
1903714,1490189,2025-02-14,Senate,"Passed by indefinitely in Finance and Appropriations (11-Y 2-N)",11,2,0,2,15
1903715,1471485,2025-01-14,House,"Subcommittee recommends reporting (7-Y 0-N)",7,0,0,2,9
1903715,1471682,2025-01-15,House,"Reported from Education (21-Y 0-N)",21,0,0,1,22
1903715,1472610,2025-01-21,House,"Read third time and passed House (93-Y 4-N)",93,4,0,3,100
1903715,1483003,2025-02-06,Senate,"Reported from Education and Health (14-Y 0-N)",14,0,0,1,15
1903715,1483890,2025-02-07,Senate,"Constitutional reading dispensed (on 2nd reading) (38-Y 0-N)",38,0,0,2,40
1903715,1484633,2025-02-10,Senate,"Passed Senate (39-Y 0-N)",39,0,0,1,40
1903717,1473042,2025-01-22,House,"Subcommittee recommends reporting with amendment(s) and referring to Appropriations (10-Y 0-N)",10,0,0,1,11
1903717,1476424,2025-01-29,House,"Reported from Agriculture, Chesapeake and Natural Resources with amendment(s) and referred to Appropriations (22-Y 0-N)",22,0,0,0,22
1903717,1478222,2025-01-31,House,"Reported from Appropriations (19-Y 3-N)",19,3,0,0,22
1903717,1486624,2025-02-11,Senate,"Reported from Agriculture, Conservation and Natural Resources and rereferred to Finance and Appropriations (15-Y 0-N)",15,0,0,0,15
1903717,1492171,2025-02-17,Senate,"Reported from Finance and Appropriations (14-Y 0-N)",14,0,0,1,15
1903717,1493593,2025-02-19,Senate,"Constitutional reading dispensed (on 2nd reading) (40-Y 0-N)",40,0,0,0,40
1903717,1496388,2025-02-20,Senate,"Passed Senate (39-Y 0-N)",39,0,0,1,40
1903717,1496389,2025-02-20,Senate,"Reconsideration of Senate passage agreed to by Senate (39-Y 0-N)",39,0,0,1,40
1903717,1496390,2025-02-20,Senate,"Passed Senate (39-Y 0-N)",39,0,0,1,40
1903717,1564900,2025-02-04,House,"Read third time and passed House (87-Y 11-N)",87,11,0,2,100
1903718,1471697,2025-01-15,House,"Subcommittee recommends striking from the docket (8-Y 0-N)",8,0,0,1,9
1903719,1475968,2025-01-28,House,"Subcommittee recommends reporting with substitute (4-Y 3-N)",4,3,0,2,9
1903719,1477911,2025-01-30,House,"Reported from General Laws with substitute (15-Y 6-N)",15,6,0,1,22
1903719,1480684,2025-02-04,House,"Read third time and passed House (69-Y 29-N)",69,29,0,2,100
1903719,1488053,2025-02-12,Senate,"Reported from General Laws and Technology (14-Y 0-N)",14,0,0,1,15
1903719,1490210,2025-02-14,Senate,"Constitutional reading dispensed (on 2nd reading) (36-Y 0-N)",36,0,0,4,40
1903719,1491362,2025-02-17,Senate,"Passed Senate (39-Y 0-N)",39,0,0,1,40
1903719,1534754,2025-04-02,House,"House concurred in Governor's recommendation (90-Y 4-N)",90,4,0,6,100
1903719,1534755,2025-04-02,Senate,"Senate concurred in Governor's recommendation (40-Y 0-N)",40,0,0,0,40
1903721,1477015,2025-01-29,House,"Reported from Rules (11-Y 2-N)",11,2,0,5,18
1903721,1478948,2025-02-03,House,"Agreed to by House (64-Y 31-N)",64,31,0,5,100
1903721,1491259,2025-02-17,Senate,"Reading waived (on 2nd reading) (39-Y 0-N)",39,0,0,1,40
1903722,1476057,2025-01-28,House,"Subcommittee recommends laying on the table (5-Y 3-N)",5,3,0,1,9
1903723,1472547,2025-01-21,House,"Subcommittee recommends reporting (8-Y 0-N)",8,0,0,1,9
1903723,1473472,2025-01-23,House,"Reported from Transportation (19-Y 2-N)",19,2,0,1,22
1903723,1483182,2025-02-06,Senate,"Reported from Transportation and rereferred to Finance and Appropriations (11-Y 0-N)",11,0,0,4,15
1903723,1487400,2025-02-12,Senate,"Reported from Finance and Appropriations (15-Y 0-N)",15,0,0,0,15
1903723,1489009,2025-02-13,Senate,"Constitutional reading dispensed (on 2nd reading) (40-Y 0-N)",40,0,0,0,40
1903723,1490285,2025-02-14,Senate,"Passed Senate (36-Y 0-N)",36,0,0,4,40
1903723,1564902,2025-01-29,House,"Read third time and passed House (83-Y 12-N)",83,12,0,5,100
1903724,1476331,2025-01-29,House,"Subcommittee recommends reporting with substitute and referring to Rules (6-Y 4-N)",6,4,0,1,11
1903724,1476332,2025-01-29,House,"Reported from Agriculture, Chesapeake and Natural Resources with substitute and referred to Rules (13-Y 9-N)",13,9,0,0,22
1903725,1474163,2025-01-24,House,"Subcommittee recommends laying on the table (8-Y 0-N)",8,0,0,1,9
1903726,1473961,2025-01-23,House,"Subcommittee recommends reporting and referring to Appropriations (8-Y 0-N)",8,0,0,1,9
1903726,1475626,2025-01-28,House,"Reported from Health and Human Services and referred to Appropriations (21-Y 0-N)",21,0,0,1,22
1903726,1476597,2025-01-29,House,"Subcommittee recommends laying on the table (6-Y 0-N)",6,0,0,3,9
1903727,1476447,2025-01-29,House,"Subcommittee recommends reporting (8-Y 0-N)",8,0,0,1,9
1903727,1478032,2025-01-31,House,"Reported from Counties, Cities and Towns (21-Y 1-N)",21,1,0,0,22
1903727,1484841,2025-02-10,Senate,"Reported from Local Government (14-Y 0-N)",14,0,0,1,15
1903727,1486313,2025-02-11,Senate,"Constitutional reading dispensed (on 2nd reading) (40-Y 0-N)",40,0,0,0,40
1903727,1487553,2025-02-12,Senate,"Passed Senate (39-Y 0-N)",39,0,0,1,40
1903727,1564806,2025-02-04,House,"Read third time and passed House (98-Y 0-N)",98,0,0,2,100
1903728,1476500,2025-01-29,House,"Subcommittee recommends laying on the table (8-Y 0-N)",8,0,0,1,9
1903729,1471959,2025-01-16,House,"Subcommittee recommends reporting (6-Y 4-N)",6,4,0,1,11
1903729,1474037,2025-01-23,House,,10,12,0,0,22
1903730,1475029,2025-01-27,House,"Subcommittee recommends laying on the table (9-Y 1-N)",9,1,0,1,11
1903731,1472561,2025-01-21,House,"Subcommittee recommends reporting with substitute (8-Y 0-N)",8,0,0,1,9
1903731,1473311,2025-01-22,House,"Reported from Education with substitute (17-Y 4-N)",17,4,0,1,22
1903731,1477174,2025-01-29,House,"Read third time and passed House (82-Y 15-N)",82,15,0,3,100
1903731,1489683,2025-02-13,Senate,"Reported from Education and Health (15-Y 0-N)",15,0,0,0,15
1903731,1491122,2025-02-17,Senate,"Constitutional reading dispensed (on 2nd reading)",39,0,0,1,40
1903731,1493081,2025-02-18,Senate,"Passed Senate (40-Y 0-N)",40,0,0,0,40
1903732,1472542,2025-01-21,House,"Subcommittee recommends striking from the docket (8-Y 0-N)",8,0,0,1,9
1903733,1472100,2025-01-17,House,"Subcommittee recommends reporting (8-Y 0-N)",8,0,0,1,9
1903733,1474301,2025-01-24,House,"Reported from Counties, Cities and Towns (18-Y 2-N)",18,2,0,2,22
1903733,1478418,2025-01-30,House,"Read third time and passed House (91-Y 5-N)",91,5,0,4,100
1903733,1485092,2025-02-10,Senate,"Passed by indefinitely in Local Government (9-Y 6-N)",9,6,0,0,15
1903734,1472387,2025-01-20,House,"Subcommittee failed to recommend reporting (2-Y 6-N)",2,6,0,1,9
1903735,1475038,2025-01-27,House,"Subcommittee recommends reporting (5-Y 3-N)",5,3,0,1,9
1903735,1478017,2025-01-31,House,"Reported from Privileges and Elections (12-Y 9-N)",12,9,0,1,22
1903735,1482405,2025-02-04,House,"Read third time and passed House (52-Y 46-N)",52,46,0,2,100
1903735,1486244,2025-02-11,Senate,"Reported from Privileges and Elections (8-Y 7-N)",8,7,0,0,15
1903735,1489097,2025-02-13,Senate,"Constitutional reading dispensed (on 2nd reading) (40-Y 0-N)",40,0,0,0,40
1903735,1490320,2025-02-14,Senate,"Passed Senate (21-Y 15-N)",21,15,0,4,40
1903735,1536772,2025-04-02,House,"House sustained Governor's veto (50-Y 46-N)",50,46,0,4,100
1903736,1476885,2025-01-29,House,"Tabled in Rules (14-Y 0-N)",14,0,0,4,18
1903737,1478527,2025-01-31,House,"Subcommittee recommends reporting with substitute (8-Y 0-N)",8,0,0,1,9
1903737,1478528,2025-01-31,House,"Reported from Courts of Justice with substitute (18-Y 2-N)",18,2,0,2,22
1903737,1480540,2025-02-04,House,"Read third time and passed House (98-Y 0-N)",98,0,0,2,100
1903737,1484612,2025-02-10,Senate,"Reported from Courts of Justice and rereferred to Finance and Appropriations (15-Y 0-N)",15,0,0,0,15
1903737,1488187,2025-02-12,Senate,"Reported from Finance and Appropriations (15-Y 0-N)",15,0,0,0,15
1903737,1489735,2025-02-13,Senate,"Constitutional reading dispensed (on 2nd reading) (40-Y 0-N)",40,0,0,0,40
1903737,1490720,2025-02-14,Senate,"Passed Senate (36-Y 0-N)",36,0,0,4,40
1903739,1476429,2025-01-29,House,"Subcommittee recommends reporting (8-Y 0-N)",8,0,0,1,9
1903739,1478087,2025-01-31,House,"Reported from Counties, Cities and Towns (21-Y 1-N)",21,1,0,0,22
1903739,1482698,2025-02-04,House,"Read third time and passed House (97-Y 0-N)",97,0,0,3,100
1903739,1485072,2025-02-10,Senate,"Reported from Local Government (14-Y 0-N)",14,0,0,1,15
1903739,1486457,2025-02-11,Senate,"Constitutional reading dispensed (on 2nd reading) (40-Y 0-N)",40,0,0,0,40
1903739,1487774,2025-02-12,Senate,"Passed Senate (39-Y 0-N)",39,0,0,1,40
1903740,1474421,2025-01-24,House,"Subcommittee recommends reporting with substitute (6-Y 0-N)",6,0,0,1,7
1903740,1475637,2025-01-28,House,"Reported from General Laws with substitute (19-Y 3-N)",19,3,0,0,22
1903740,1479721,2025-02-03,House,"Read third time and passed House (85-Y 14-N)",85,14,0,1,100
1903740,1489985,2025-02-14,Senate,"Reported from Rehabilitation and Social Services with substitute (12-Y 2-N)",12,2,0,1,15
1903740,1491279,2025-02-17,Senate,"Constitutional reading dispensed (on 2nd reading) (39-Y 0-N)",39,0,0,1,40
1903740,1495629,2025-02-19,Senate,"Passed Senate with substitute (30-Y 10-N)",30,10,0,0,40
1903740,1496624,2025-02-20,House,"Senate substitute agreed to by House (84-Y 14-N)",84,14,0,2,100
1903740,1536114,2025-04-02,House,"Passed by for the day (47-Y 46-N)",47,46,0,7,100
1903741,1471486,2025-01-14,House,"Subcommittee recommends reporting and referred to Appropriations (5-Y 2-N)",5,2,0,2,9
1903741,1471684,2025-01-15,House,"Reported from Education and referred to Appropriations (12-Y 9-N)",12,9,0,1,22
1903741,1472453,2025-01-20,House,"Subcommittee recommends reporting with substitute (8-Y 0-N)",8,0,0,1,9
1903741,1473168,2025-01-22,House,"Reported from Appropriations with substitute (22-Y 0-N)",22,0,0,0,22
1903741,1476514,2025-01-28,House,"Read third time and passed House (67-Y 31-N 1-A)",67,31,1,1,100
1903741,1489508,2025-02-13,Senate,"Reported from Education and Health and rereferred to Finance and Appropriations (9-Y 6-N)",9,6,0,0,15
1903741,1492138,2025-02-17,Senate,"Passed by indefinitely in Finance and Appropriations with letter (12-Y 1-N 1-A)",12,1,1,1,15
1903742,1475206,2025-01-27,House,"Subcommittee recommends reporting (9-Y 1-N)",9,1,0,1,11
1903742,1476914,2025-01-29,House,"Reported from Agriculture, Chesapeake and Natural Resources (21-Y 1-N)",21,1,0,0,22
1903742,1480536,2025-02-04,House,"Read third time and passed House 95-Y 4-N 0-A)",95,4,0,1,100
1903742,1486841,2025-02-11,Senate,"Reported from Agriculture, Conservation and Natural Resources (8-Y 6-N)",8,6,0,1,15
1903742,1489587,2025-02-13,Senate,"Constitutional reading dispensed (on 2nd reading) (40-Y 0-N)",40,0,0,0,40
1903742,1490534,2025-02-14,Senate,"Passed Senate (21-Y 15-N)",21,15,0,4,40
1903742,1535556,2025-04-02,House,"House rejected Governor's recommendation (14-Y 80-N)",14,80,0,6,100
1903743,1478021,2025-01-31,House,"Subcommittee recommends striking from the docket (8-Y 0-N)",8,0,0,1,9
1903745,1476673,2025-01-29,House,"Reported from Rules (11-Y 3-N)",11,3,0,4,18
1903745,1479567,2025-02-03,House,"Agreed to by House (57-Y 39-N)",57,39,0,4,100
1903745,1491141,2025-02-17,Senate,"Reading waived (on 2nd reading) (39-Y 0-N)",39,0,0,1,40
1903748,1472753,2025-01-21,House,"Subcommittee recommends laying on the table (5-Y 3-N)",5,3,0,1,9
1903749,1472799,2025-01-21,House,"Subcommittee recommends striking from the docket (10-Y 0-N)",10,0,0,1,11
1903749,1473988,2025-01-23,House,"Stricken from docket by Labor and Commerce (21-Y 1-N)",21,1,0,0,22
1903750,1475856,2025-01-28,House,"Subcommittee recommends reporting with substitute (5-Y 2-N)",5,2,0,2,9
1903750,1476969,2025-01-29,House,"Reported from Finance with substitute (12-Y 9-N)",12,9,0,1,22
1903750,1482233,2025-02-04,House,"Read third time and passed House (62-Y 36-N)",62,36,0,2,100
1903750,1486099,2025-02-11,Senate,"Passed by indefinitely in Finance and Appropriations with letter (15-Y 0-N)",15,0,0,0,15
1903751,1474928,2025-01-27,House,"Subcommittee recommends reporting and referring to Appropriations (7-Y 1-N)",7,1,0,1,9
1903751,1476164,2025-01-29,House,"Reported from Education and referred to Appropriations (17-Y 5-N)",17,5,0,0,22
1903751,1476909,2025-01-29,House,"Subcommittee recommends laying on the table (7-Y 0-N)",7,0,0,2,9
1903752,1475421,2025-01-28,House,"Subcommittee failed to recommend reporting (3-Y 5-N)",3,5,0,1,9
1903755,1472297,2025-01-20,House,"Subcommittee recommends reporting with amendment(s) (5-Y 3-N)",5,3,0,1,9
1903755,1473196,2025-01-22,House,"Reported from Finance with substitute (17-Y 5-N)",17,5,0,0,22
1903755,1477043,2025-01-28,House,"Read third time and passed House (94-Y 3-N)",94,3,0,3,100
1903755,1482591,2025-02-05,Senate,"Reported from Finance and Appropriations (12-Y 0-N)",12,0,0,3,15
1903755,1483358,2025-02-06,Senate,"Constitutional reading dispensed (on 2nd reading) (40-Y 0-N)",40,0,0,0,40
1903755,1484078,2025-02-07,Senate,"Passed Senate (39-Y 0-N)",39,0,0,1,40
1903757,1476137,2025-01-29,House,"Subcommittee recommends reporting with amendment(s) and referring to Appropriations (6-Y 4-N)",6,4,0,1,11
1903757,1476374,2025-01-29,House,"Reported from Agriculture, Chesapeake and Natural Resources with amendment(s) and referred to Appropriations (13-Y 9-N)",13,9,0,0,22
1903757,1478194,2025-01-31,House,"Tabled in Appropriations (22-Y 0-N)",22,0,0,0,22
1903760,1471553,2025-01-08,Senate,"Rules suspended (38-Y 0-N)",38,0,0,0,38
1903760,1471554,2025-01-08,Senate,"Agreed to by Senate (38-Y 0-N)",38,0,0,0,38
1903762,1476458,2025-01-29,House,"Subcommittee recommends reporting (8-Y 0-N)",8,0,0,1,9
1903762,1478075,2025-01-31,House,"Reported from Counties, Cities and Towns (21-Y 1-N)",21,1,0,0,22
1903762,1480730,2025-02-04,House,"Read third time and passed House (98-Y 0-N)",98,0,0,2,100
1903762,1485109,2025-02-10,Senate,"Reported from Local Government (14-Y 0-N)",14,0,0,1,15
1903762,1486493,2025-02-11,Senate,"Constitutional reading dispensed (on 2nd reading) (40-Y 0-N)",40,0,0,0,40
1903762,1487817,2025-02-12,Senate,"Passed Senate (39-Y 0-N)",39,0,0,1,40
1903763,1473023,2025-01-22,House,"Subcommittee recommends reporting with substitute (5-Y 3-N)",5,3,0,1,9
1903763,1476180,2025-01-29,House,"Reported from Education with substitute (12-Y 10-N)",12,10,0,0,22
1903763,1482852,2025-02-04,House,"Read third time and passed House (51-Y 47-N)",51,47,0,2,100
1903763,1489768,2025-02-13,Senate,"Reported from Education and Health and rereferred to Finance and Appropriations (9-Y 5-N)",9,5,0,1,15
1903763,1492476,2025-02-17,Senate,"Passed by indefinitely in Finance and Appropriations with letter (14-Y 0-N)",14,0,0,1,15
1903764,1473237,2025-01-22,House,"Subcommittee recommends reporting with substitute (8-Y 0-N)",8,0,0,1,9
1903764,1474253,2025-01-24,House,"Reported from Appropriations with substitute (22-Y 0-N)",22,0,0,0,22
1903764,1478231,2025-01-30,House,"Read third time and passed House (96-Y 0-N)",96,0,0,4,100
1903764,1480833,2025-02-05,Senate,"Reported from General Laws and Technology and rereferred to Finance and Appropriations (15-Y 0-N)",15,0,0,0,15
1903764,1487413,2025-02-12,Senate,"Passed by indefinitely in Finance and Appropriations (15-Y 0-N)",15,0,0,0,15
1903765,1472778,2025-01-21,House,"Subcommittee recommends reporting with substitute (8-Y 0-N)",8,0,0,1,9
1903765,1472951,2025-01-22,House,"Reported from Education with substitute (22-Y 0-N)",22,0,0,0,22
1903765,1476567,2025-01-28,House,"Read third time and passed House (99-Y 0-N)",99,0,0,1,100
1903765,1483132,2025-02-06,Senate,"Reported from Education and Health (14-Y 0-N)",14,0,0,1,15
1903765,1483889,2025-02-07,Senate,"Constitutional reading dispensed (on 2nd reading) (38-Y 0-N)",38,0,0,2,40
1903765,1484603,2025-02-10,Senate,"Passed Senate (39-Y 0-N)",39,0,0,1,40
1903765,1536657,2025-04-02,House,"House rejected Governor's recommendation (22-Y 73-N)",22,73,0,5,100
1903765,1536658,2025-04-02,House,"Motion to pass in enrolled form rejected (58-Y 36-N)",58,36,0,6,100
1903772,1476493,2025-01-29,Senate,"Stricken at request of Patron in General Laws and Technology (15-Y 0-N)",15,0,0,0,15
1903779,1472445,2025-01-20,House,"Subcommittee recommends reporting with amendment(s) (10-Y 0-N)",10,0,0,1,11
1903779,1473137,2025-01-22,House,"Reported from Agriculture, Chesapeake and Natural Resources with amendment(s) (22-Y 0-N)",22,0,0,0,22
1903779,1476459,2025-01-28,House,"Read third time and passed House (80-Y 18-N)",80,18,0,2,100
1903779,1486620,2025-02-11,Senate,"Reported from Agriculture, Conservation and Natural Resources (15-Y 0-N)",15,0,0,0,15
1903779,1490063,2025-02-13,Senate,"Constitutional reading dispensed (on 2nd reading) (40-Y 0-N)",40,0,0,0,40
1903779,1490064,2025-02-14,Senate,"Passed Senate (36-Y 0-N)",36,0,0,4,40
1903779,1535165,2025-04-02,Senate,"Senate concurred in Governor's recommendation (40-Y 0-N)",40,0,0,0,40
1903779,1536363,2025-04-02,House,"House concurred in Governor's recommendation (96-Y 0-N)",96,0,0,4,100
1903788,1473389,2025-01-22,Senate,"Reported from General Laws and Technology with substitute and rereferred to Finance and Appropriations (9-Y 6-N)",9,6,0,0,15
1903788,1475758,2025-01-28,Senate,"Reported from Finance and Appropriations (10-Y 5-N)",10,5,0,0,15
1903788,1476595,2025-01-29,Senate,"Constitutional reading dispensed (on 1st reading) (38-Y 0-N)",38,0,0,2,40
1903788,1478100,2025-01-31,Senate,"Read third time and passed Senate (21-Y 19-N)",21,19,0,0,40
1903788,1483300,2025-02-06,House,"Reported from General Laws with substitute (12-Y 9-N)",12,9,0,1,22
1903788,1487607,2025-02-12,House,"Passed House with substitute with amendment (50-Y 47-N)",50,47,0,3,100
1903788,1490391,2025-02-14,Senate,"House substitute with amendment agreed to by Senate (21-Y 15-N)",21,15,0,4,40
1903798,1473521,2025-01-23,Senate,"Reported from Education and Health and rereferred to Finance and Appropriations (14-Y 1-N)",14,1,0,0,15
1903808,1472762,2025-01-21,House,"Subcommittee recommends reporting (6-Y 2-N)",6,2,0,1,9
1903808,1473279,2025-01-22,House,"Reported from Finance (17-Y 5-N)",17,5,0,0,22
1903808,1476716,2025-01-28,House,"Read third time and passed House (92-Y 6-N)",92,6,0,2,100
1903808,1482600,2025-02-05,Senate,"Passed by indefinitely in Finance and Appropriations (10-Y 3-N)",10,3,0,2,15
1903817,1473559,2025-01-23,Senate,"Reported from Education and Health and rereferred to Finance and Appropriations (15-Y 0-N)",15,0,0,0,15
1903817,1477250,2025-01-29,Senate,"Reported from Finance and Appropriations with substitute (15-Y 0-N)",15,0,0,0,15
1903817,1478363,2025-01-30,Senate,"Constitutional reading dispensed (on 1st reading) (39-Y 0-N 1-A)",39,0,1,0,40
1903817,1479052,2025-01-31,Senate,"Constitutional reading dispensed (on 3rd reading) (40-Y 0-N)",40,0,0,0,40
1903817,1479053,2025-01-31,Senate,"Passed Senate (40-Y 0-N)",40,0,0,0,40
1903817,1485956,2025-02-11,House,"Subcommittee recommends reporting and referring to Appropriations (8-Y 0-N)",8,0,0,1,9
1903817,1488740,2025-02-13,House,"Reported from Health and Human Services (17-Y 4-N)",17,4,0,1,22
1903817,1492622,2025-02-18,House,"Passed House (81-Y 15-N)",81,15,0,4,100
1903827,1473469,2025-01-23,House,"Subcommittee recommends reporting with substitute (7-Y 1-N)",7,1,0,1,9
1903827,1474261,2025-01-24,House,"Reported from Counties, Cities and Towns with substitute (17-Y 3-N)",17,3,0,2,22
1903827,1484562,2025-02-10,Senate,"Reported from Local Government with amendments (8-Y 7-N)",8,7,0,0,15
1903827,1486161,2025-02-11,Senate,"Constitutional reading dispensed (on 2nd reading) (40-Y 0-N)",40,0,0,0,40
1903827,1487961,2025-02-12,Senate,"Passed Senate with amendments (21-Y 18-N)",21,18,0,1,40
1903827,1564802,2025-01-30,House,"Read third time and passed House (64-Y 32-N)",64,32,0,4,100
1903827,1564803,2025-02-14,House,"Senate Amendments agreed to by House (Y-62 N-34 A-0)",62,34,0,4,100
1903836,1473516,2025-01-23,Senate,"Reported from Education and Health with substitute and rereferred to Finance and Appropriations (15-Y 0-N)",15,0,0,0,15
1903836,1477131,2025-01-29,Senate,"Reported from Finance and Appropriations with substitute (14-Y 0-N)",14,0,0,1,15
1903836,1477514,2025-01-30,Senate,"Constitutional reading dispensed (on 1st reading) (39-Y 0-N 1-A)",39,0,1,0,40
1903836,1479162,2025-01-31,Senate,"Constitutional reading dispensed (on 3rd reading) (40-Y 0-N)",40,0,0,0,40
1903836,1479163,2025-01-31,Senate,"Passed Senate (40-Y 0-N)",40,0,0,0,40
1903836,1487399,2025-02-12,House,"Reported from Education with substitute (15-Y 6-N)",15,6,0,1,22
1903836,1491105,2025-02-17,House,"Passed House with substitute (84-Y 11-N)",84,11,0,5,100
1903836,1492367,2025-02-18,Senate,"House substitute rejected by Senate (0-Y 40-N)",0,40,0,0,40
1903836,1495356,2025-02-20,Senate,"Senate acceded to request (39-Y 0-N)",39,0,0,1,40
1903836,1496479,2025-02-21,Senate,"Conference report agreed to by Senate (40-Y 0-N)",40,0,0,0,40
1903836,1504013,2025-02-21,House,"Conference report agreed to by House (88-Y 8-N)",88,8,0,4,100
1903836,1536623,2025-04-02,Senate,"Senate rejected Governor's recommendation (19-Y 21-N)",19,21,0,0,40
1903848,1471544,2025-01-13,Senate,"Failed to report (defeated) in Commerce and Labor (6-Y 8-N 1-A)",6,8,1,0,15
1903858,1472999,2025-01-22,Senate,"Read third time and passed Senate (40-Y 0-N)",40,0,0,0,40
1903858,1474116,2025-01-16,Senate,"Reported from Transportation (13-Y 0-N)",13,0,0,2,15
1903858,1474117,2025-01-20,Senate,"Constitutional reading dispensed (on 1st reading) (40-Y 0-N)",40,0,0,0,40
1903858,1483013,2025-02-06,House,"Reported from Transportation (20-Y 0-N)",20,0,0,2,22
1903858,1486762,2025-02-11,House,"Passed House (94-Y 0-N)",94,0,0,6,100
1903869,1472755,2025-01-21,House,"Subcommittee recommends reporting (6-Y 1-N)",6,1,0,2,9
1903869,1474043,2025-01-23,House,"Reported from General Laws (15-Y 6-N)",15,6,0,1,22
1903869,1476276,2025-01-29,House,"Read third time and passed House (62-Y 34-N)",62,34,0,4,100
1903869,1483867,2025-02-07,Senate,"Reported from Rehabilitation and Social Services with substitute (14-Y 0-N 1-A)",14,0,1,0,15
1903869,1486207,2025-02-10,Senate,"Constitutional reading dispensed (on 2nd reading) (39-Y 0-N)",39,0,0,1,40
1903869,1489118,2025-02-12,Senate,"Passed Senate with substitute (38-Y 1-N)",38,1,0,1,40
1903869,1490323,2025-02-14,House,"Senate substitute agreed to by House (59-Y 35-N)",59,35,0,6,100
1903881,1473555,2025-01-23,Senate,"Reported from Education and Health (15-Y 0-N)",15,0,0,0,15
1903881,1474566,2025-01-24,Senate,"Constitutional reading dispensed (on 1st reading) (37-Y 0-N)",37,0,0,3,40
1903881,1476303,2025-01-28,Senate,"Read third time and passed Senate (39-Y 0-N)",39,0,0,1,40
1903881,1480748,2025-02-05,House,"Reported from Education (18-Y 2-N)",18,2,0,2,22
1903881,1484643,2025-02-10,House,"Passed House (89-Y 6-N)",89,6,0,5,100
1903891,1471786,2025-01-15,House,"Subcommittee recommends reporting with amendment(s) and referred to Courts of Justice (8-Y 0-N)",8,0,0,1,9
1903891,1471914,2025-01-16,House,"Reported from Transportation with amendment(s) and referred to Courts of Justice (20-Y 1-N)",20,1,0,1,22
1903891,1478347,2025-01-31,House,"Subcommittee recommends reporting with substitute (7-Y 1-N)",7,1,0,1,9
1903891,1478348,2025-01-31,House,"Reported from Courts of Justice with substitute (17-Y 3-N)",17,3,0,2,22
1903891,1482383,2025-02-04,House,"Read third time and passed House (84-Y 12-N)",84,12,0,4,100
1903891,1488442,2025-02-12,Senate,"Reported from Courts of Justice with substitute and rereferred to Finance and Appropriations (13-Y 2-N)",13,2,0,0,15
1903891,1490159,2025-02-14,Senate,"Reported from Finance and Appropriations (13-Y 1-N)",13,1,0,1,15
1903891,1492225,2025-02-17,Senate,"Constitutional reading dispensed (on 2nd reading) (39-Y 0-N)",39,0,0,1,40
1903891,1493676,2025-02-19,Senate,"Passed Senate with substitute (35-Y 5-N)",35,5,0,0,40
1903891,1496378,2025-02-20,House,"Senate substitute agreed to by House (92-Y 5-N)",92,5,0,3,100
1903891,1535405,2025-04-02,Senate,"Senate concurred in Governor's recommendation (36-Y 4-N)",36,4,0,0,40
1903891,1536588,2025-04-02,House,"House concurred in Governor's recommendation (96-Y 0-N)",96,0,0,4,100
1903904,1472802,2025-01-21,House,"Subcommittee recommends laying on the table (8-Y 0-N)",8,0,0,1,9
1903913,1473703,2025-01-21,Senate,"Reported from Agriculture, Conservation and Natural Resources (14-Y 0-N)",14,0,0,1,15
1903913,1473704,2025-01-23,Senate,"Constitutional reading dispensed (on 1st reading) (39-Y 0-N)",39,0,0,1,40
1903913,1475385,2025-01-27,Senate,"Read third time and passed Senate (38-Y 0-N)",38,0,0,2,40
1903913,1487392,2025-02-12,House,"Reported from Agriculture, Chesapeake and Natural Resources (22-Y 0-N)",22,0,0,0,22
1903913,1491116,2025-02-17,House,"Passed House (95-Y 0-N)",95,0,0,5,100
1903913,1491117,2025-02-17,House,"Passed House (96-Y 0-N)",96,0,0,4,100
1903924,1473597,2025-01-20,Senate,"Reading waived (on 1st reading) (40-Y 0-N)",40,0,0,0,40
1903924,1490773,2025-02-17,House,"Reported from Rules (18-Y 0-N)",18,0,0,0,18
1903924,1497182,2025-02-20,House,"Agreed to by House (97-Y 0-N)",97,0,0,3,100
1903935,1475256,2025-01-28,Senate,"Reported from Education and Health and rereferred to Finance and Appropriations (15-Y 0-N)",15,0,0,0,15
1903935,1477974,2025-01-30,Senate,"Reported from Finance and Appropriations with substitute (15-Y 0-N)",15,0,0,0,15
1903935,1479799,2025-02-03,Senate,"Constitutional reading dispensed (on 1st reading) (40-Y 0-N)",40,0,0,0,40
1903935,1479800,2025-02-04,Senate,"Constitutional reading dispensed (on 3rd reading) (39-Y 0-N)",39,0,0,1,40
1903935,1479801,2025-02-04,Senate,"Passed Senate (40-Y 0-N)",40,0,0,0,40
1903935,1485478,2025-02-10,House,"Subcommittee recommends reporting with substitute (10-Y 0-N)",10,0,0,1,11
1903935,1487778,2025-02-12,House,"Reported from Education with substitute (21-Y 0-N)",21,0,0,1,22
1903935,1491154,2025-02-17,House,"Passed House with substitute (95-Y 0-N)",95,0,0,5,100
1903935,1491155,2025-02-17,House,"Passed House with substitute (96-Y 0-N)",96,0,0,4,100
1903935,1492112,2025-02-18,Senate,"House substitute agreed to by Senate (37-Y 0-N)",37,0,0,3,40
1903946,1474603,2025-01-24,Senate,"Reported from Rules and rereferred to Finance and Appropriations (12-Y 0-N)",12,0,0,3,15
1903955,1473628,2025-01-17,Senate,"Reported from Rehabilitation and Social Services with substitute and rereferred to Finance and Appropriations (8-Y 7-N)",8,7,0,0,15
1903955,1475316,2025-01-28,Senate,"Reported from Finance and Appropriations (10-Y 5-N)",10,5,0,0,15
1903955,1476203,2025-01-29,Senate,"Constitutional reading dispensed (on 1st reading) (38-Y 0-N)",38,0,0,2,40
1903955,1478588,2025-01-31,Senate,"Read third time and passed Senate (21-Y 19-N)",21,19,0,0,40
1903955,1483240,2025-02-06,House,"Reported from General Laws (13-Y 8-N)",13,8,0,1,22
1903955,1488745,2025-02-12,House,"Passed House (53-Y 44-N)",53,44,0,3,100
1903969,1474896,2025-01-27,Senate,"Reported from Courts of Justice with substitute and rereferred to Finance and Appropriations (9-Y 3-N 2-A)",9,3,2,1,15
1903969,1476660,2025-01-29,Senate,"Reported from Finance and Appropriations (11-Y 2-N 1-A)",11,2,1,1,15
1903969,1477683,2025-01-30,Senate,"Constitutional reading dispensed (on 1st reading) (39-Y 0-N 1-A)",39,0,1,0,40
1903969,1479458,2025-02-03,Senate,"Read third time and passed Senate (33-Y 6-N)",33,6,0,1,40
1903969,1485373,2025-02-10,House,"Reported from Courts of Justice (20-Y 2-N)",20,2,0,0,22
1903969,1535557,2025-04-02,Senate,"Senate rejected Governor's recommendation (19-Y 21-N)",19,21,0,0,40
1903969,1564829,2025-02-13,House,"Passed House (91-Y 6-N)",91,6,0,3,100
1903980,1478981,2025-02-03,Senate,"Reported from Courts of Justice with substitute (14-Y 0-N 1-A)",14,0,1,0,15
1903980,1479966,2025-02-04,Senate,"Constitutional reading dispensed (on 1st reading) (40-Y 0-N)",40,0,0,0,40
1903980,1479967,2025-02-04,Senate,"Constitutional reading dispensed (on 3rd reading) (40-Y 0-N)",40,0,0,0,40
1903980,1479968,2025-02-04,Senate,"Passed Senate (39-Y 0-N)",39,0,0,1,40
1903980,1486050,2025-02-10,House,"Reported from Courts of Justice (22-Y 0-N)",22,0,0,0,22
1903980,1490584,2025-02-13,House,"Passed House (96-Y 0-N)",96,0,0,4,100
1903990,1472349,2025-01-20,Senate,"Failed to report (defeated) in Local Government (4-Y 8-N 3-A)",4,8,3,0,15
1904003,1474598,2025-01-24,Senate,"Reported from Rules (13-Y 0-N)",13,0,0,2,15
1904003,1474904,2025-01-27,Senate,"Constitutional reading dispensed (on 1st reading) (37-Y 1-N)",37,1,0,2,40
1904003,1477207,2025-01-29,Senate,"Read third time and passed Senate (38-Y 0-N)",38,0,0,2,40
1904003,1486331,2025-02-11,House,"Reported from General Laws with amendment(s) (19-Y 0-N)",19,0,0,3,22
1904003,1490287,2025-02-14,House,"Passed House with amendments (96-Y 0-N)",96,0,0,4,100
1904003,1493092,2025-02-18,Senate,"House Amendments agreed to by Senate (40-Y 0-N)",40,0,0,0,40
1904013,1472422,2025-01-20,Senate,"Passed by indefinitely in Commerce and Labor with letter (15-Y 0-N)",15,0,0,0,15
1904026,1471791,2025-01-15,Senate,"Passed by indefinitely in Courts of Justice (9-Y 5-N)",9,5,0,1,15
1904038,1475371,2025-01-27,Senate,"Reading waived (on 1st reading) (38-Y 0-N)",38,0,0,2,40
1904038,1491322,2025-02-17,House,"Passed by indefinitely in Rules (18-Y 0-N)",18,0,0,0,18
1904049,1473270,2025-01-22,Senate,"Reported from General Laws and Technology and rereferred to Finance and Appropriations (11-Y 3-N 1-A)",11,3,1,0,15
1904049,1475261,2025-01-28,Senate,"Reported from Finance and Appropriations (9-Y 6-N)",9,6,0,0,15
1904049,1476305,2025-01-29,Senate,"Constitutional reading dispensed (on 1st reading) (38-Y 0-N)",38,0,0,2,40
1904049,1482204,2025-02-04,Senate,"Read third time and passed Senate (24-Y 16-N)",24,16,0,0,40
1904060,1473717,2025-01-21,Senate,"Passed by indefinitely in Agriculture, Conservation and Natural Resources (8-Y 7-N)",8,7,0,0,15
1904071,1473697,2025-01-21,Senate,"Reported from Agriculture, Conservation and Natural Resources with substitute and rereferred to Finance and Appropriations (14-Y 0-N)",14,0,0,1,15
1904083,1472896,2025-01-22,House,"Subcommittee recommends reporting (7-Y 0-N)",7,0,0,2,9
1904083,1474314,2025-01-24,House,"Reported from Counties, Cities and Towns (20-Y 0-N)",20,0,0,2,22
1904083,1478407,2025-01-30,House,"Read third time and passed House (96-Y 0-N)",96,0,0,4,100
1904083,1485087,2025-02-10,Senate,"Reported from Local Government (15-Y 0-N)",15,0,0,0,15
1904083,1486471,2025-02-11,Senate,"Constitutional reading dispensed (on 2nd reading) (40-Y 0-N)",40,0,0,0,40
1904083,1487791,2025-02-12,Senate,"Passed Senate (39-Y 0-N)",39,0,0,1,40
1904105,1473400,2025-01-22,Senate,"Reported from Courts of Justice (13-Y 0-N 1-A)",13,0,1,1,15
1904105,1474419,2025-01-24,Senate,"Constitutional reading dispensed (on 1st reading) (37-Y 0-N)",37,0,0,3,40
1904105,1476678,2025-01-28,Senate,"Read third time and passed Senate (39-Y 0-N)",39,0,0,1,40
1904105,1489922,2025-02-14,House,"Reported from Public Safety with amendment(s) (21-Y 0-N)",21,0,0,1,22
1904105,1494146,2025-02-19,House,"Passed House with amendments (97-Y 0-N)",97,0,0,3,100
1904105,1495891,2025-02-20,Senate,"House amendments agreed to by Senate (39-Y 0-N)",39,0,0,1,40
1904109,1471876,2025-01-16,House,"Subcommittee recommends reporting (6-Y 0-N)",6,0,0,1,7
1904109,1472071,2025-01-17,House,"Reported from Public Safety (22-Y 0-N)",22,0,0,0,22
1904109,1474410,2025-01-24,House,"Reported from Public Safety and referred to Appropriations (22-Y 0-N)",22,0,0,0,22
1904109,1476416,2025-01-29,House,"Subcommittee recommends reporting (8-Y 0-N)",8,0,0,1,9
1904109,1477005,2025-01-29,House,"Reported from Appropriations (21-Y 0-N)",21,0,0,1,22
1904109,1479541,2025-02-04,House,"Read third time and passed House (97-Y 0-N)",97,0,0,3,100
1904109,1479542,2025-02-04,House,"Passed House (99-Y 0-N)",99,0,0,1,100
1904109,1483896,2025-02-07,Senate,"Reported from Rehabilitation and Social Services and rereferred to Finance and Appropriations (15-Y 0-N)",15,0,0,0,15
1904109,1487387,2025-02-12,Senate,"Reported from Finance and Appropriations (15-Y 0-N)",15,0,0,0,15
1904109,1488960,2025-02-13,Senate,"Constitutional reading dispensed (on 2nd reading) (40-Y 0-N)",40,0,0,0,40
1904109,1490243,2025-02-14,Senate,"Passed Senate (36-Y 0-N)",36,0,0,4,40
1904119,1473506,2025-01-23,Senate,"Reported from Education and Health with substitute and rereferred to Finance and Appropriations (15-Y 0-N)",15,0,0,0,15
1904119,1477253,2025-01-29,Senate,"Reported from Finance and Appropriations with amendment (15-Y 0-N)",15,0,0,0,15
1904119,1478105,2025-01-30,Senate,"Constitutional reading dispensed (on 1st reading) (39-Y 0-N 1-A)",39,0,1,0,40
1904119,1479326,2025-01-31,Senate,"Constitutional reading dispensed (on 3rd reading) (40-Y 0-N)",40,0,0,0,40
1904119,1479327,2025-01-31,Senate,"Passed Senate (40-Y 0-N)",40,0,0,0,40
1904119,1485492,2025-02-10,House,"Subcommittee recommends reporting (10-Y 0-N)",10,0,0,1,11
1904119,1488041,2025-02-12,House,"Reported from Education (21-Y 0-N)",21,0,0,1,22
1904119,1492685,2025-02-18,House,"Passed House with substitute (97-Y 0-N)",97,0,0,3,100
1904119,1494144,2025-02-19,Senate,"House substitute agreed to by Senate (40-Y 0-N)",40,0,0,0,40
1904130,1474444,2025-01-24,Senate,"Incorporated by Commerce and Labor (SB917-Surovell) (15-Y 0-N)",15,0,0,0,15
1904153,1472587,2025-01-21,Senate,"Reported from Finance and Appropriations with amendment (15-Y 0-N)",15,0,0,0,15
1904153,1473010,2025-01-22,Senate,"Constitutional reading dispensed (on 1st reading) (40-Y 0-N)",40,0,0,0,40
1904153,1474638,2025-01-24,Senate,"Read third time and passed Senate (38-Y 0-N)",38,0,0,2,40
1904153,1490507,2025-02-14,House,"Reported from Appropriations with substitute (21-Y 0-N)",21,0,0,1,22
1904153,1494114,2025-02-19,House,"Passed House with substitute (97-Y 0-N)",97,0,0,3,100
1904153,1495170,2025-02-20,Senate,"House substitute agreed to by Senate (39-Y 0-N)",39,0,0,1,40
1904166,1474693,2025-01-27,Senate,"Reported from Local Government with substitute (12-Y 2-N)",12,2,0,1,15
1904166,1476744,2025-01-28,Senate,"Constitutional reading dispensed (on 1st reading) (39-Y 0-N)",39,0,0,1,40
1904166,1478151,2025-01-30,Senate,"Read third time and passed Senate (35-Y 5-N)",35,5,0,0,40
1904166,1483113,2025-02-06,House,"Subcommittee recommends reporting with amendment(s) (8-Y 0-N)",8,0,0,1,9
1904166,1483872,2025-02-07,House,"Reported from Counties, Cities and Towns with amendment(s) (17-Y 4-N)",17,4,0,1,22
1904166,1487547,2025-02-12,House,"Passed House with amendments (89-Y 8-N)",89,8,0,3,100
1904166,1490701,2025-02-14,Senate,"House Amendments agreed to by Senate (30-Y 5-N)",30,5,0,5,40
1904178,1473532,2025-01-23,Senate,"Reported from Education and Health with substitute and rereferred to Finance and Appropriations (8-Y 7-N)",8,7,0,0,15
1904178,1477161,2025-01-29,Senate,"Reported from Finance and Appropriations (10-Y 5-N)",10,5,0,0,15
1904178,1477535,2025-01-30,Senate,"Constitutional reading dispensed (on 1st reading) (39-Y 0-N 1-A)",39,0,1,0,40
1904178,1480531,2025-02-04,Senate,"Read third time and defeated by Senate (17-Y 22-N)",17,22,0,1,40
1904188,1475279,2025-01-28,Senate,"Incorporated by Finance and Appropriations (SB782-Suetterlein) (15-Y 0-N)",15,0,0,0,15
1904198,1471695,2025-01-15,Senate,"Reported from Courts of Justice with amendments (15-Y 0-N)",15,0,0,0,15
1904198,1472127,2025-01-17,Senate,"Constitutional reading dispensed (on 1st reading) (40-Y 0-N)",40,0,0,0,40
1904198,1474090,2025-01-21,Senate,"Read third time and passed Senate (40-Y 0-N)",40,0,0,0,40
1904198,1484074,2025-02-07,House,"Subcommittee recommends reporting (8-Y 0-N)",8,0,0,1,9
1904198,1486370,2025-02-10,House,"Reported from Courts of Justice (22-Y 0-N)",22,0,0,0,22
1904198,1490609,2025-02-13,House,"Passed House (96-Y 0-N)",96,0,0,4,100
1904208,1475138,2025-01-27,Senate,"Reported from Commerce and Labor with substitute and rereferred to Finance and Appropriations (10-Y 5-N)",10,5,0,0,15
1904208,1477634,2025-01-30,Senate,"Reported from Finance and Appropriations with substitute (11-Y 4-N)",11,4,0,0,15
1904208,1479815,2025-02-04,Senate,"Constitutional reading dispensed (on 3rd reading) (40-Y 0-N)",40,0,0,0,40
1904208,1479816,2025-02-04,Senate,"Passed Senate (26-Y 13-N 1-A)",26,13,1,0,40
1904208,1480278,2025-02-03,Senate,"Constitutional reading dispensed (on 1st reading) (40-Y 0-N)",40,0,0,0,40
1904208,1486378,2025-02-11,House,"Subcommittee recommends reporting with substitute (6-Y 4-N)",6,4,0,1,11
1904208,1489404,2025-02-13,House,"Reported from Labor and Commerce with substitute (14-Y 8-N)",14,8,0,0,22
1904208,1491916,2025-02-18,House,"Passed House with substitute (62-Y 34-N)",62,34,0,4,100
1904208,1491917,2025-02-18,House,"Passed House with substitute (63-Y 34-N)",63,34,0,3,100
1904208,1495707,2025-02-19,Senate,"House substitute rejected by Senate (0-Y 40-N)",0,40,0,0,40
1904208,1495708,2025-02-20,Senate,"Senate acceded to request (38-Y 0-N)",38,0,0,2,40
1904217,1472567,2025-01-21,House,"Subcommittee recommends reporting (8-Y 0-N)",8,0,0,1,9
1904217,1472976,2025-01-22,House,"Reported from Education (22-Y 0-N)",22,0,0,0,22
1904217,1477604,2025-01-28,House,"Read third time and passed House (99-Y 0-N)",99,0,0,1,100
1904217,1489643,2025-02-13,Senate,"Reported from Education and Health (15-Y 0-N)",15,0,0,0,15
1904217,1491108,2025-02-17,Senate,"Constitutional reading dispensed (on 2nd reading)",39,0,0,1,40
1904217,1493085,2025-02-18,Senate,"Passed Senate (40-Y 0-N)",40,0,0,0,40
1904232,1474040,2025-01-23,House,"Subcommittee recommends striking from the docket (10-Y 0-N)",10,0,0,1,11
1904243,1472331,2025-01-20,Senate,"Constitutional reading dispensed (on 1st reading) (40-Y 0-N)",40,0,0,0,40
1904243,1473264,2025-01-22,Senate,"Read third time and passed Senate (40-Y 0-N)",40,0,0,0,40
1904243,1473957,2025-01-17,Senate,"Reported from Rules (15-Y 0-N)",15,0,0,0,15
1904243,1490771,2025-02-17,House,"Reported from Rules (18-Y 0-N)",18,0,0,0,18
1904243,1496174,2025-02-20,House,"Passed House (98-Y 0-N)",98,0,0,2,100
1904255,1472012,2025-01-16,Senate,"Reported from Education and Health and rereferred to Finance and Appropriations (11-Y 3-N)",11,3,0,1,15
1904266,1472379,2025-01-20,House,"Subcommittee recommends reporting (9-Y 1-N)",9,1,0,1,11
1904266,1472971,2025-01-22,House,"Reported from Education (22-Y 0-N)",22,0,0,0,22
1904266,1477609,2025-01-28,House,"Read third time and passed House (99-Y 0-N)",99,0,0,1,100
1904266,1489838,2025-02-13,Senate,"Reported from Education and Health and rereferred to Finance and Appropriations (15-Y 0-N)",15,0,0,0,15
1904266,1492624,2025-02-17,Senate,"Reported from Finance and Appropriations with substitute (14-Y 0-N)",14,0,0,1,15
1904266,1494086,2025-02-19,Senate,"Constitutional reading dispensed (on 2nd reading) (40-Y 0-N)",40,0,0,0,40
1904266,1495622,2025-02-20,Senate,"Passed Senate with substitute (39-Y 0-N)",39,0,0,1,40
1904266,1495623,2025-02-20,Senate,"Reconsideration of Senate passage agreed to by Senate (39-Y 0-N)",39,0,0,1,40
1904266,1495624,2025-02-20,Senate,"Passed Senate with substitute (39-Y 0-N)",39,0,0,1,40
1904266,1495625,2025-02-20,House,"Senate substitute rejected by House (0-Y 96-N)",0,96,0,4,100
1904266,1495626,2025-02-20,Senate,"Senate insisted on substitute (38-Y 0-N)",38,0,0,2,40
1904266,1497137,2025-02-22,House,"Conference report agreed to by House (98-Y 1-N)",98,1,0,1,100
1904266,1504034,2025-02-22,Senate,"Conference report agreed to by Senate (40-Y 0-N)",40,0,0,0,40
1904276,1471843,2025-01-15,Senate,"Reported from General Laws and Technology and rereferred to Finance and Appropriations (15-Y 0-N)",15,0,0,0,15
1904289,1476677,2025-01-29,House,"Reported from Rules with substitute (12-Y 2-N)",12,2,0,4,18
1904289,1478866,2025-02-03,House,"Agreed to by House (60-Y 37-N)",60,37,0,3,100
1904289,1492125,2025-02-17,Senate,"Reported from Finance and Appropriations (9-Y 4-N)",9,4,0,2,15
1904289,1495879,2025-02-19,Senate,"Reading waived (on 2nd reading) (39-Y 0-N)",39,0,0,1,40
1904313,1473356,2025-01-22,House,"Subcommittee recommends reporting with substitute and referring to Appropriations (8-Y 0-N)",8,0,0,1,9
1904313,1474742,2025-01-24,House,"Reported from Courts of Justice with substitute and referred to Appropriations (22-Y 0-N)",22,0,0,0,22
1904313,1476730,2025-01-29,House,"Subcommittee recommends reporting (6-Y 0-N)",6,0,0,3,9
1904313,1478486,2025-01-31,House,"Reported from Appropriations (22-Y 0-N)",22,0,0,0,22
1904313,1480142,2025-02-04,House,"Read third time and passed House (97-Y 0-N)",97,0,0,3,100
1904313,1480143,2025-02-04,House,"Passed House (99-Y 0-N)",99,0,0,1,100
1904313,1485042,2025-02-10,Senate,"Rereferred to Courts of Justice",12,0,0,3,15
1904313,1489160,2025-02-13,Senate,"Reported from Courts of Justice and rereferred to Finance and Appropriations (14-Y 0-N)",14,0,0,1,15
1904313,1492135,2025-02-17,Senate,"Reported from Finance and Appropriations (14-Y 0-N)",14,0,0,1,15
1904313,1495903,2025-02-19,Senate,"Constitutional reading dispensed (on 2nd reading) (40-Y 0-N)",40,0,0,0,40
1904313,1496327,2025-02-20,Senate,"Passed Senate (39-Y 0-N)",39,0,0,1,40
1904313,1496328,2025-02-20,Senate,"Reconsideration of Senate passage agreed to by Senate (39-Y 0-N)",39,0,0,1,40
1904313,1496329,2025-02-20,Senate,"Passed Senate (39-Y 0-N)",39,0,0,1,40
1904319,1475014,2025-01-27,House,"Subcommittee recommends reporting (5-Y 3-N)",5,3,0,1,9
1904319,1478118,2025-01-31,House,"Reported from Privileges and Elections with amendment(s) (13-Y 8-N)",13,8,0,1,22
1904319,1482384,2025-02-04,House,"Read third time and passed House (53-Y 45-N)",53,45,0,2,100
1904319,1486288,2025-02-11,Senate,"Reported from Privileges and Elections (8-Y 7-N)",8,7,0,0,15
1904319,1488943,2025-02-13,Senate,"Constitutional reading dispensed (on 2nd reading) (40-Y 0-N)",40,0,0,0,40
1904319,1490252,2025-02-14,Senate,"Passed Senate (21-Y 14-N)",21,14,0,5,40
1904319,1536565,2025-04-02,House,"House sustained Governor's veto (50-Y 44-N)",50,44,0,6,100
1904323,1473879,2025-01-21,Senate,"Reported from Privileges and Elections and rereferred to Finance and Appropriations (8-Y 7-N)",8,7,0,0,15
1904323,1477133,2025-01-29,Senate,"Reported from Finance and Appropriations (10-Y 4-N)",10,4,0,1,15
1904323,1477515,2025-01-30,Senate,"Constitutional reading dispensed (on 1st reading) (39-Y 0-N 1-A)",39,0,1,0,40
1904323,1479703,2025-02-03,Senate,"Read third time and passed Senate (21-Y 19-N)",21,19,0,0,40
1904323,1485192,2025-02-10,House,"Subcommittee recommends reporting with substitute (5-Y 3-N)",5,3,0,1,9
1904323,1490033,2025-02-14,House,"Reported from Privileges and Elections with substitute (12-Y 10-N)",12,10,0,0,22
1904323,1493353,2025-02-19,House,"Passed House with substitute (50-Y 46-N)",50,46,0,4,100
1904323,1495063,2025-02-20,Senate,"House substitute agreed to by Senate (20-Y 19-N)",20,19,0,1,40
1904326,1472743,2025-01-21,House,"Subcommittee recommends reporting (5-Y 2-N)",5,2,0,2,9
1904326,1474041,2025-01-23,House,"Reported from General Laws (20-Y 1-N)",20,1,0,1,22
1904326,1477388,2025-01-29,House,"Read third time and passed House (90-Y 6-N)",90,6,0,4,100
1904326,1483876,2025-02-07,Senate,"Reported from Rehabilitation and Social Services (15-Y 0-N)",15,0,0,0,15
1904326,1486235,2025-02-10,Senate,"Constitutional reading dispensed (on 2nd reading) (39-Y 0-N)",39,0,0,1,40
1904326,1487470,2025-02-12,Senate,"Passed Senate (38-Y 1-N)",38,1,0,1,40
1904330,1476875,2025-01-29,Senate,"Reported from Courts of Justice with substitute (15-Y 0-N)",15,0,0,0,15
1904330,1478443,2025-01-31,Senate,"Constitutional reading dispensed (on 1st reading) (39-Y 0-N)",39,0,0,1,40
1904330,1480465,2025-02-03,Senate,"Constitutional reading dispensed (on 3rd reading) (40-Y 0-N)",40,0,0,0,40
1904330,1480466,2025-02-03,Senate,"Passed Senate (40-Y 0-N)",40,0,0,0,40
1904330,1485993,2025-02-10,House,"Subcommittee recommends reporting with substitute (8-Y 0-N)",8,0,0,1,9
1904330,1490617,2025-02-14,House,"Reported from Courts of Justice with substitute (21-Y 0-N)",21,0,0,1,22
1904330,1493964,2025-02-19,House,"Passed House with substitute (97-Y 0-N)",97,0,0,3,100
1904330,1495686,2025-02-20,Senate,"House substitute rejected by Senate (0-Y 39-N)",0,39,0,1,40
1904330,1495687,2025-02-20,Senate,"Senate acceded to request (38-Y 0-N)",38,0,0,2,40
1904330,1496766,2025-02-21,Senate,"Conference report agreed to by Senate (40-Y 0-N)",40,0,0,0,40
1904330,1503240,2025-02-21,House,"Conference report agreed to by House (96-Y 0-N)",96,0,0,4,100
1904336,1473393,2025-01-22,House,"Subcommittee recommends reporting (8-Y 0-N)",8,0,0,1,9
1904336,1474686,2025-01-24,House,"Reported from Courts of Justice (22-Y 0-N)",22,0,0,0,22
1904336,1478315,2025-01-30,House,"Read third time and passed House (96-Y 0-N)",96,0,0,4,100
1904336,1488242,2025-02-12,Senate,"Reported from Courts of Justice (15-Y 0-N)",15,0,0,0,15
1904336,1490079,2025-02-14,Senate,"Constitutional reading dispensed (on 2nd reading) (36-Y 0-N)",36,0,0,4,40
1904336,1492728,2025-02-17,Senate,"Passed Senate (39-Y 0-N)",39,0,0,1,40
1904343,1476394,2025-01-29,Senate,"Reported from Courts of Justice (10-Y 5-N)",10,5,0,0,15
1904343,1478137,2025-01-31,Senate,"Constitutional reading dispensed (on 1st reading) (39-Y 0-N)",39,0,0,1,40
1904343,1479692,2025-02-04,Senate,"Read third time and passed Senate (23-Y 17-N)",23,17,0,0,40
1904343,1485200,2025-02-10,House,"Subcommittee recommends reporting (7-Y 1-N)",7,1,0,1,9
1904343,1490467,2025-02-14,House,"Reported from Courts of Justice with substitute (15-Y 5-N)",15,5,0,2,22
1904343,1493260,2025-02-19,House,"Passed House with substitute (53-Y 43-N)",53,43,0,4,100
1904343,1494964,2025-02-20,Senate,"House substitute agreed to by Senate (23-Y 16-N)",23,16,0,1,40
1904347,1472908,2025-01-22,House,"Subcommittee recommends laying on the table (10-Y 0-N)",10,0,0,1,11
1904351,1474128,2025-01-23,House,"Subcommittee recommends reporting and referring to Appropriations (8-Y 0-N)",8,0,0,1,9
1904351,1475585,2025-01-28,House,"Reported from Health and Human Services and referred to Appropriations (21-Y 0-N)",21,0,0,1,22
1904351,1476591,2025-01-29,House,"Subcommittee recommends reporting with substitute (6-Y 0-N)",6,0,0,3,9
1904351,1478297,2025-01-31,House,"Reported from Appropriations with substitute (22-Y 0-N)",22,0,0,0,22
1904351,1479534,2025-02-04,House,"Read third time and passed House (97-Y 0-N)",97,0,0,3,100
1904351,1479535,2025-02-04,House,"Passed House (99-Y 0-N)",99,0,0,1,100
1904351,1489716,2025-02-13,Senate,"Reported from Education and Health and rereferred to Finance and Appropriations (15-Y 0-N)",15,0,0,0,15
1904351,1492078,2025-02-17,Senate,"Passed by indefinitely in Finance and Appropriations (14-Y 0-N)",14,0,0,1,15
1904359,1473383,2025-01-22,Senate,"Reported from General Laws and Technology with amendment (15-Y 0-N)",15,0,0,0,15
1904359,1474586,2025-01-24,Senate,"Constitutional reading dispensed (on 1st reading) (37-Y 0-N)",37,0,0,3,40
1904359,1476207,2025-01-28,Senate,"Read third time and passed Senate (39-Y 0-N)",39,0,0,1,40
1904359,1486060,2025-02-11,House,"Subcommittee recommends reporting (6-Y 2-N)",6,2,0,1,9
1904359,1488736,2025-02-13,House,"Reported from Health and Human Services (22-Y 0-N)",22,0,0,0,22
1904359,1492994,2025-02-18,House,"Passed House (97-Y 0-N)",97,0,0,3,100
1904366,1471964,2025-01-16,House,"Reported from Labor and Commerce with substitute (22-Y 0-N)",22,0,0,0,22
1904366,1473651,2025-01-22,House,"Read third time and passed House (96-Y 0-N)",96,0,0,4,100
1904366,1473652,2025-01-22,House,"Passed House (97-Y 0-N)",97,0,0,3,100
1904366,1485313,2025-02-10,Senate,"Reported from Commerce and Labor (15-Y 0-N)",15,0,0,0,15
1904366,1487695,2025-02-12,Senate,"Constitutional reading dispensed (on 2nd reading) (39-Y 0-N)",39,0,0,1,40
1904366,1489996,2025-02-13,Senate,"Passed Senate (40-Y 0-N)",40,0,0,0,40
1904370,1472551,2025-01-21,House,"Subcommittee recommends reporting with amendment(s) (8-Y 0-N)",8,0,0,1,9
1904370,1473470,2025-01-23,House,"Reported from Transportation with substitute (21-Y 0-N)",21,0,0,1,22
1904370,1477418,2025-01-29,House,"Read third time and passed House (96-Y 0-N)",96,0,0,4,100
1904370,1483191,2025-02-06,Senate,"Reported from Transportation (15-Y 0-N)",15,0,0,0,15
1904370,1484666,2025-02-10,Senate,"Constitutional reading dispensed (on 2nd reading) (39-Y 0-N)",39,0,0,1,40
1904370,1487682,2025-02-12,Senate,"Passed Senate (39-Y 0-N)",39,0,0,1,40
1904373,1474816,2025-01-27,Senate,"Failed to report from Courts of Justice with substitute (7-Y 7-N)",7,7,0,1,15
1904379,1473275,2025-01-22,Senate,"Reported from Courts of Justice and rereferred to Finance and Appropriations (10-Y 3-N 1-A)",10,3,1,1,15
1904379,1477143,2025-01-29,Senate,"Reported from Finance and Appropriations (11-Y 3-N)",11,3,0,1,15
1904379,1477516,2025-01-30,Senate,"Constitutional reading dispensed (on 1st reading) (39-Y 0-N 1-A)",39,0,1,0,40
1904379,1479681,2025-02-03,Senate,"Read third time and passed Senate (32-Y 8-N)",32,8,0,0,40
1904379,1485387,2025-02-10,House,"Subcommittee recommends reporting (8-Y 0-N)",8,0,0,1,9
1904379,1490062,2025-02-14,House,"Reported from Courts of Justice (21-Y 0-N)",21,0,0,1,22
1904379,1493449,2025-02-19,House,"Passed House (97-Y 0-N)",97,0,0,3,100
1904379,1534905,2025-04-02,House,"House concurred in Governor's recommendation (94-Y 0-N)",94,0,0,6,100
1904379,1536210,2025-04-02,Senate,"Senate concurred in Governor's recommendation (39-Y 1-N)",39,1,0,0,40
1904383,1471545,2025-01-13,Senate,"Reported from Local Government (13-Y 0-N)",13,0,0,0,13
1904383,1471637,2025-01-14,Senate,"Constitutional reading dispensed (on 1st reading) (37-Y 0-N)",37,0,0,1,38
1904383,1471931,2025-01-16,Senate,"Read third time and passed Senate (39-Y 0-N)",39,0,0,1,40
1904383,1487286,2025-02-12,House,"Subcommittee recommends reporting (8-Y 0-N)",8,0,0,1,9
1904383,1489990,2025-02-14,House,"Reported from Counties, Cities and Towns (21-Y 0-N)",21,0,0,1,22
1904383,1493787,2025-02-19,House,"Passed House (97-Y 0-N)",97,0,0,3,100
1904388,1472793,2025-01-21,House,"Subcommittee recommends reporting with substitute (6-Y 0-N)",6,0,0,2,8
1904388,1473985,2025-01-23,House,"Reported from Labor and Commerce with substitute (22-Y 0-N)",22,0,0,0,22
1904388,1477275,2025-01-29,House,"Read third time and passed House (97-Y 0-N)",97,0,0,3,100
1904388,1485393,2025-02-10,Senate,"Reported from Commerce and Labor (15-Y 0-N)",15,0,0,0,15
1904388,1487775,2025-02-12,Senate,"Constitutional reading dispensed (on 2nd reading) (39-Y 0-N)",39,0,0,1,40
1904388,1490015,2025-02-13,Senate,"Passed Senate (40-Y 0-N)",40,0,0,0,40
1904391,1477317,2025-01-30,House,"Subcommittee recommends reporting with amendment(s) and referring to Appropriations (5-Y 3-N)",5,3,0,1,9
1904391,1477786,2025-01-30,House,"Reported from Labor and Commerce with amendment(s) and referred to Appropriations (12-Y 10-N)",12,10,0,0,22
1904391,1478322,2025-01-31,House,"Reported from Appropriations (12-Y 10-N)",12,10,0,0,22
1904391,1482292,2025-02-04,House,"Read third time and passed House (50-Y 47-N)",50,47,0,3,100
1904391,1485413,2025-02-10,Senate,"Passed by indefinitely in Commerce and Labor (8-Y 7-N)",8,7,0,0,15
1904394,1477135,2025-01-30,House,"Subcommittee recommends reporting with substitute (7-Y 0-N)",7,0,0,0,7
1904394,1478022,2025-01-31,House,"Reported from Public Safety with substitute (21-Y 0-N)",21,0,0,1,22
1904394,1480552,2025-02-04,House,"Read third time and passed House (97-Y 0-N)",97,0,0,3,100
1904394,1480553,2025-02-04,House,"Passed House (99-Y 0-N)",99,0,0,1,100
1904394,1488100,2025-02-12,Senate,"Rereferred from General Laws and Technology to Finance and Appropriations (10-Y 0-N)",10,0,0,5,15
1904394,1492189,2025-02-17,Senate,"Reported from Finance and Appropriations with substitute (14-Y 0-N)",14,0,0,1,15
1904394,1493585,2025-02-19,Senate,"Constitutional reading dispensed (on 2nd reading) (40-Y 0-N)",40,0,0,0,40
1904394,1495906,2025-02-20,Senate,"Senate insisted on substitute (38-Y 0-N)",38,0,0,2,40
1904394,1496352,2025-02-20,Senate,"Passed Senate with substitute (39-Y 0-N)",39,0,0,1,40
1904394,1496353,2025-02-20,Senate,"Reconsideration of Senate passage agreed to by Senate (39-Y 0-N)",39,0,0,1,40
1904394,1496354,2025-02-20,Senate,"Passed Senate with substitute (39-Y 0-N)",39,0,0,1,40
1904394,1496799,2025-02-20,House,"Senate substitute rejected by House (1-Y 95-N)",1,95,0,4,100
1904394,1497154,2025-02-21,Senate,"Conference report agreed to by Senate (38-Y 0-N)",38,0,0,2,40
1904394,1503893,2025-02-21,House,"Conference report agreed to by House (95-Y 0-N)",95,0,0,5,100
1904397,1473857,2025-01-23,House,"Subcommittee recommends reporting with amendment(s) (7-Y 0-N)",7,0,0,2,9
1904397,1475917,2025-01-28,House,"Reported from General Laws with amendment(s) (22-Y 0-N)",22,0,0,0,22
1904397,1479408,2025-02-03,House,"Read third time and passed House (98-Y 0-N)",98,0,0,2,100
1904397,1479409,2025-02-03,House,"Read third time and passed House (99-Y 0-N)",99,0,0,1,100
1904397,1488537,2025-02-12,Senate,"Reported from General Laws and Technology with amendments and rereferred to Finance and Appropriations (15-Y 0-N)",15,0,0,0,15
1904397,1492554,2025-02-17,Senate,"Passed by indefinitely in Finance and Appropriations (13-Y 1-N)",13,1,0,1,15
1904401,1474632,2025-01-24,Senate,"Reported from Rules with substitute (11-Y 1-N)",11,1,0,3,15
1904401,1475168,2025-01-27,Senate,"Constitutional reading dispensed (on 1st reading) (37-Y 1-N)",37,1,0,2,40
1904401,1476399,2025-01-29,Senate,"Read third time and passed Senate (35-Y 2-N 1-A)",35,2,1,2,40
1904401,1483719,2025-02-06,House,"Reported from General Laws (16-Y 5-N)",16,5,0,1,22
1904401,1564836,2025-02-12,House,"Passed House (54-Y 43-N)",54,43,0,3,100
1904406,1474093,2025-01-23,House,"Subcommittee recommends laying on the table (4-Y 3-N)",4,3,0,2,9
1904408,1475574,2025-01-28,House,"Subcommittee recommends reporting with substitute (8-Y 0-N)",8,0,0,1,9
1904408,1477271,2025-01-30,House,"Reported from Health and Human Services with substitute (21-Y 0-N)",21,0,0,1,22
1904408,1480659,2025-02-04,House,"Read third time and passed House (97-Y 0-N)",97,0,0,3,100
1904408,1480660,2025-02-04,House,"Passed House (99-Y 0-N)",99,0,0,1,100
1904408,1489168,2025-02-13,Senate,"Reported from Education and Health (13-Y 0-N)",13,0,0,2,15
1904408,1491213,2025-02-17,Senate,"Constitutional reading dispensed (on 2nd reading)",39,0,0,1,40
1904408,1493157,2025-02-18,Senate,"Passed Senate (40-Y 0-N)",40,0,0,0,40
1904413,1477748,2025-01-30,House,"Subcommittee recommends laying on the table (4-Y 1-N)",4,1,0,1,6
1904416,1471546,2025-01-13,Senate,"Reported from Local Government (12-Y 0-N 1-A)",12,0,1,0,13
1904416,1471547,2025-01-14,Senate,"Constitutional reading dispensed (on 1st reading) (37-Y 0-N)",37,0,0,1,38
1904416,1471960,2025-01-16,Senate,"Read third time and passed Senate (39-Y 0-N)",39,0,0,1,40
1904416,1488601,2025-02-13,House,"Subcommittee recommends reporting with amendment(s) (8-Y 0-N)",8,0,0,1,9
1904416,1489947,2025-02-14,House,"Reported from Counties, Cities and Towns with amendment(s) (21-Y 0-N)",21,0,0,1,22
1904416,1495193,2025-02-19,House,"Passed House with amendment (97-Y 0-N)",97,0,0,3,100
1904416,1495194,2025-02-20,Senate,"House Amendment agreed to by Senate (39-Y 0-N)",39,0,0,1,40
1904419,1473293,2025-01-22,House,"Subcommittee recommends reporting (10-Y 0-N)",10,0,0,1,11
1904419,1476932,2025-01-29,House,"Reported from Agriculture, Chesapeake and Natural Resources (22-Y 0-N)",22,0,0,0,22
1904419,1480020,2025-02-04,House,"Read third time and passed House (97-Y 0-N)",97,0,0,3,100
1904419,1480021,2025-02-04,House,"Passed House (99-Y 0-N)",99,0,0,1,100
1904419,1484629,2025-02-10,Senate,"Rereferred from Courts of Justice to Agriculture, Conservation and Natural Resources (9-Y 0-N)",9,0,0,6,15
1904419,1486844,2025-02-11,Senate,"Reported from Agriculture, Conservation and Natural Resources (15-Y 0-N)",15,0,0,0,15
1904419,1489575,2025-02-13,Senate,"Constitutional reading dispensed (on 2nd reading) (40-Y 0-N)",40,0,0,0,40
1904419,1490541,2025-02-14,Senate,"Passed Senate (36-Y 0-N)",36,0,0,4,40
1904421,1472535,2025-01-21,House,"Subcommittee recommends reporting with substitute (8-Y 0-N)",8,0,0,1,9
1904421,1472924,2025-01-22,House,"Reported from Education with substitute (22-Y 0-N)",22,0,0,0,22
1904421,1477055,2025-01-28,House,"Read third time and passed House (99-Y 0-N)",99,0,0,1,100
1904421,1483501,2025-02-06,Senate,"Reported from Education and Health with substitute (14-Y 0-N)",14,0,0,1,15
1904421,1483984,2025-02-07,Senate,"Constitutional reading dispensed (on 2nd reading) (38-Y 0-N)",38,0,0,2,40
1904421,1485013,2025-02-10,Senate,"Passed Senate with substitute (39-Y 0-N)",39,0,0,1,40
1904421,1489040,2025-02-12,House,"Senate substitute agreed to by House (Y-97 N-0 A-0)",97,0,0,3,100
1904429,1473536,2025-01-23,Senate,"Reported from Education and Health and rereferred to Finance and Appropriations (14-Y 1-N)",14,1,0,0,15
1904435,1472541,2025-01-20,House,"Subcommittee recommends reporting with amendment(s) (8-Y 0-N)",8,0,0,1,9
1904435,1474735,2025-01-24,House,"Reported from Courts of Justice with amendment(s) (22-Y 0-N)",22,0,0,0,22
1904435,1478224,2025-01-30,House,"Read third time and passed House (96-Y 0-N)",96,0,0,4,100
1904435,1490838,2025-02-17,Senate,"Reported from Courts of Justice with amendment (15-Y 0-N)",15,0,0,0,15
1904435,1492036,2025-02-18,Senate,"Constitutional reading dispensed (on 2nd reading) (39-Y 0-N)",39,0,0,1,40
1904435,1495209,2025-02-19,Senate,"Passed Senate with amendment (40-Y 0-N)",40,0,0,0,40
1904435,1496752,2025-02-20,House,"Senate Amendment agreed to by House (96-Y 0-N)",96,0,0,4,100
1904438,1472083,2025-01-17,House,"Subcommittee recommends laying on the table (5-Y 3-N)",5,3,0,1,9
1904445,1472794,2025-01-21,House,"Subcommittee recommends laying on the table (4-Y 3-N)",4,3,0,1,8
1904448,1473796,2025-01-23,House,"Subcommittee recommends reporting with amendment(s) and referring to Appropriations (8-Y 0-N)",8,0,0,1,9
1904448,1475930,2025-01-28,House,"Reported from General Laws with amendment(s) and referred to Appropriations (22-Y 0-N)",22,0,0,0,22
1904448,1478498,2025-01-31,House,"Reported from Appropriations (22-Y 0-N)",22,0,0,0,22
1904448,1479868,2025-02-04,House,"Read third time and passed House (97-Y 0-N)",97,0,0,3,100
1904448,1479869,2025-02-04,House,"Passed House (99-Y 0-N)",99,0,0,1,100
1904448,1488172,2025-02-12,Senate,"Reported from General Laws and Technology and rereferred to Finance and Appropriations (14-Y 0-N)",14,0,0,1,15
1904448,1492535,2025-02-17,Senate,"Passed by indefinitely in Finance and Appropriations (12-Y 2-N)",12,2,0,1,15
1904454,1472899,2025-01-22,House,"Subcommittee recommends reporting with amendment(s) (8-Y 0-N)",8,0,0,1,9
1904454,1474302,2025-01-24,House,VOTE:,20,0,0,2,22
1904454,1474303,2025-01-24,House,"Reported from Counties, Cities and Towns with amendment(s) (20-Y 0-N)",20,0,0,2,22
1904454,1478230,2025-01-30,House,"Read third time and passed House (96-Y 0-N)",96,0,0,4,100
1904454,1485125,2025-02-10,Senate,"Reported from Local Government (15-Y 0-N)",15,0,0,0,15
1904454,1486498,2025-02-11,Senate,"Constitutional reading dispensed (on 2nd reading) (40-Y 0-N)",40,0,0,0,40
1904454,1487823,2025-02-12,Senate,"Passed Senate (39-Y 0-N)",39,0,0,1,40
1904458,1474657,2025-01-27,House,"Subcommittee recommends laying on the table (10-Y 0-N)",10,0,0,1,11
1904462,1475302,2025-01-28,House,"Subcommittee recommends reporting (8-Y 0-N)",8,0,0,1,9
1904462,1476129,2025-01-29,House,"Reported from Education (22-Y 0-N)",22,0,0,0,22
1904462,1482319,2025-02-04,House,"Read third time and passed House (97-Y 0-N)",97,0,0,3,100
1904462,1489143,2025-02-13,Senate,"Reported from Education and Health (14-Y 0-N)",14,0,0,1,15
1904462,1491198,2025-02-17,Senate,"Constitutional reading dispensed (on 2nd reading)",39,0,0,1,40
1904462,1493142,2025-02-18,Senate,"Passed Senate (40-Y 0-N)",40,0,0,0,40
1904465,1472568,2025-01-21,House,"Subcommittee recommends reporting with substitute (8-Y 0-N)",8,0,0,1,9
1904465,1473296,2025-01-22,House,"Reported from Education with substitute (22-Y 0-N)",22,0,0,0,22
1904465,1477045,2025-01-28,House,"Read third time and passed House (99-Y 0-N)",99,0,0,1,100
1904465,1489591,2025-02-13,Senate,"Reported from Education and Health (15-Y 0-N)",15,0,0,0,15
1904465,1491055,2025-02-17,Senate,"Constitutional reading dispensed (on 2nd reading)",39,0,0,1,40
1904465,1492334,2025-02-18,Senate,"Passed Senate (40-Y 0-N)",40,0,0,0,40
1904468,1473827,2025-01-21,Senate,"Reported from Agriculture, Conservation and Natural Resources (14-Y 0-N)",14,0,0,1,15
1904468,1473828,2025-01-23,Senate,"Constitutional reading dispensed (on 1st reading) (39-Y 0-N)",39,0,0,1,40
1904468,1474825,2025-01-27,Senate,"Read third time and passed Senate (38-Y 0-N)",38,0,0,2,40
1904468,1487383,2025-02-12,House,"Subcommittee recommends reporting (10-Y 0-N)",10,0,0,1,11
1904468,1487384,2025-02-12,House,"Reported from Agriculture, Chesapeake and Natural Resources (22-Y 0-N)",22,0,0,0,22
1904468,1491024,2025-02-17,House,"Passed House (95-Y 0-N)",95,0,0,5,100
1904468,1491025,2025-02-17,House,"Passed House (96-Y 0-N)",96,0,0,4,100
1904472,1471723,2025-01-15,House,"Subcommittee recommends reporting with substitute (8-Y 0-N)",8,0,0,1,9
1904472,1472171,2025-01-17,House,"Reported from Appropriations with substitute (21-Y 0-N)",21,0,0,1,22
1904472,1473485,2025-01-23,House,"Read third time and passed House (90-Y 6-N)",90,6,0,4,100
1904472,1480478,2025-02-05,Senate,"Reported from Finance and Appropriations with substitute (13-Y 0-N)",13,0,0,2,15
1904472,1483233,2025-02-06,Senate,"Constitutional reading dispensed (on 2nd reading) (40-Y 0-N)",40,0,0,0,40
1904472,1483964,2025-02-07,Senate,"Passed Senate with substitute (39-Y 0-N)",39,0,0,1,40
1904472,1486071,2025-02-11,House,"Senate substitute rejected by House (0-Y 93-N)",0,93,0,7,100
1904472,1490082,2025-02-13,Senate,"Senate insisted on substitute (40-Y 0-N)",40,0,0,0,40
1904472,1496277,2025-02-20,Senate,"Conference report agreed to by Senate (38-Y 0-N)",38,0,0,2,40
1904472,1496751,2025-02-20,House,"Conference report agreed to by House (91-Y 7-N)",91,7,0,2,100
1904476,1472759,2025-01-21,House,"Subcommittee recommends reporting (5-Y 3-N)",5,3,0,1,9
1904476,1473268,2025-01-22,House,"Reported from Finance (12-Y 10-N)",12,10,0,0,22
1904476,1477970,2025-01-28,House,"Read third time and passed House (52-Y 46-N)",52,46,0,2,100
1904476,1486361,2025-02-11,Senate,"Passed by indefinitely in Finance and Appropriations (15-Y 0-N)",15,0,0,0,15
1904480,1472774,2025-01-21,House,"Subcommittee recommends reporting (6-Y 4-N)",6,4,0,1,11
1904480,1474011,2025-01-23,House,"Reported from Labor and Commerce with substitute (12-Y 10-N)",12,10,0,0,22
1904480,1477327,2025-01-29,House,"Read third time and passed House (52-Y 43-N)",52,43,0,5,100
1904480,1491326,2025-02-17,Senate,"Reported from Commerce and Labor with substitute (9-Y 6-N)",9,6,0,0,15
1904480,1493308,2025-02-18,Senate,"Constitutional reading dispensed (on 2nd reading) (40-Y 0-N)",40,0,0,0,40
1904480,1495657,2025-02-19,Senate,"Passed Senate with substitute (21-Y 18-N)",21,18,0,1,40
1904480,1496629,2025-02-20,House,"Senate substitute agreed to by House (51-Y 44-N)",51,44,0,5,100
1904484,1475894,2025-01-28,House,"Subcommittee recommends laying on the table (5-Y 3-N)",5,3,0,1,9
1904486,1472862,2025-01-21,House,"Subcommittee recommends laying on the table (5-Y 3-N)",5,3,0,1,9
1904494,1472781,2025-01-21,House,"Subcommittee recommends reporting with amendment(s) (8-Y 0-N)",8,0,0,1,9
1904494,1476870,2025-01-29,House,"Reported from Education with amendment(s) (22-Y 0-N)",22,0,0,0,22
1904494,1480656,2025-02-04,House,"Read third time and passed House (97-Y 0-N)",97,0,0,3,100
1904494,1480657,2025-02-04,House,"Passed House (99-Y 0-N)",99,0,0,1,100
1904494,1489773,2025-02-13,Senate,"Reported from Education and Health (14-Y 0-N)",14,0,0,1,15
1904494,1491106,2025-02-17,Senate,"Constitutional reading dispensed (on 2nd reading)",39,0,0,1,40
1904494,1494348,2025-02-19,Senate,"Amendment by Senator Stuart reconsidered",39,0,1,0,40
1904494,1494349,2025-02-19,Senate,"Senator Stuart Amendment rejected (19-Y 20-N 1-A)",19,20,1,0,40
1904494,1494350,2025-02-19,Senate,"Passed Senate (40-Y 0-N)",40,0,0,0,40
1904494,1535569,2025-04-02,House,"House rejected Governor's recommendation (45-Y 50-N)",45,50,0,5,100
1904499,1474024,2025-01-23,House,"Subcommittee recommends reporting with substitute (5-Y 3-N)",5,3,0,1,9
1904499,1475840,2025-01-28,House,"Reported from Labor and Commerce with substitute (12-Y 10-N)",12,10,0,0,22
1904499,1479543,2025-02-03,House,"Read third time and passed House (50-Y 48-N)",50,48,0,2,100
1904499,1491353,2025-02-17,Senate,"Reported from Commerce and Labor and rereferred to Finance and Appropriations (9-Y 6-N)",9,6,0,0,15
1904499,1491983,2025-02-17,Senate,"Reported from Finance and Appropriations with amendment (10-Y 4-N)",10,4,0,1,15
1904499,1495094,2025-02-20,Senate,"Passed Senate with amendment (20-Y 19-N)",20,19,0,1,40
1904499,1495749,2025-02-20,House,"Senate Amendment agreed to by House (51-Y 44-N)",51,44,0,5,100
1904504,1474007,2025-01-24,House,"Subcommittee recommends reporting (6-Y 4-N)",6,4,0,1,11
1904504,1475807,2025-01-28,House,"Reported from Labor and Commerce with substitute (12-Y 10-N)",12,10,0,0,22
1904504,1482174,2025-02-04,House,"Read third time and passed House (54-Y 44-N 0-A",54,44,0,2,100
1904504,1491374,2025-02-17,Senate,"Reported from Commerce and Labor with substitute (7-Y 6-N 2-A)",7,6,2,0,15
1904504,1493396,2025-02-18,Senate,"Constitutional reading dispensed (on 2nd reading) (40-Y 0-N)",40,0,0,0,40
1904504,1495060,2025-02-20,Senate,"Passed Senate with substitute with amendments (32-Y 7-N)",32,7,0,1,40
1904504,1495704,2025-02-20,House,"Senate substitute agreed to by House (60-Y 36-N)",60,36,0,4,100
1904504,1536237,2025-04-02,House,"Passed by for the day (47-Y 46-N)",47,46,0,7,100
1904509,1475927,2025-01-28,House,"Subcommittee recommends laying on the table (5-Y 2-N)",5,2,0,2,9
1904512,1473442,2025-01-23,House,"Subcommittee recommends reporting with substitute (8-Y 0-N)",8,0,0,1,9
1904512,1475779,2025-01-28,House,"Reported from Health and Human Services with substitute (21-Y 0-N)",21,0,0,1,22
1904512,1478935,2025-02-03,House,"Read third time and passed House (87-Y 12-N)",87,12,0,1,100
1904512,1489334,2025-02-13,Senate,"Reported from Education and Health with substitute (15-Y 0-N)",15,0,0,0,15
1904512,1491113,2025-02-17,Senate,"Constitutional reading dispensed (on 2nd reading)",39,0,0,1,40
1904512,1494340,2025-02-18,Senate,"Passed Senate with substitute (40-Y 0-N)",40,0,0,0,40
1904512,1494341,2025-02-19,House,"Senate substitute agreed to by House (88-Y 7-N)",88,7,0,5,100
1904512,1535478,2025-04-02,House,"House concurred in Governor's recommendation (91-Y 3-N)",91,3,0,6,100
1904512,1535479,2025-04-02,Senate,"Senate concurred in Governor's recommendation (40-Y 0-N)",40,0,0,0,40
1904518,1471762,2025-01-15,House,"Subcommittee recommends reporting with substitute (8-Y 0-N)",8,0,0,1,9
1904518,1471997,2025-01-16,House,"Reported from Transportation with substitute (21-Y 0-N)",21,0,0,1,22
1904518,1473024,2025-01-22,House,"Read third time and passed House (96-Y 0-N)",96,0,0,4,100
1904518,1473025,2025-01-22,House,"Passed House (97-Y 0-N)",97,0,0,3,100
1904518,1483754,2025-02-06,Senate,"Reported from Transportation (14-Y 0-N)",14,0,0,1,15
1904518,1485866,2025-02-10,Senate,"Constitutional reading dispensed (on 2nd reading) (39-Y 0-N)",39,0,0,1,40
1904518,1487847,2025-02-12,Senate,"Passed Senate (39-Y 0-N)",39,0,0,1,40
1904520,1474494,2025-01-24,Senate,"Reported from General Laws and Technology with amendment and rereferred to Finance and Appropriations (14-Y 0-N)",14,0,0,1,15
1904520,1477422,2025-01-29,Senate,"Passed by indefinitely in Finance and Appropriations (10-Y 4-N)",10,4,0,1,15
1904525,1475705,2025-01-28,Senate,"Failed to report (defeated) in Privileges and Elections (7-Y 8-N)",7,8,0,0,15
1904529,1473954,2025-01-23,Senate,"Reported from Transportation with substitute and rereferred to Finance and Appropriations (14-Y 0-N)",14,0,0,1,15
1904529,1475315,2025-01-28,Senate,"Reported from Finance and Appropriations (14-Y 0-N 1-A)",14,0,1,0,15
1904529,1477194,2025-01-29,Senate,"Constitutional reading dispensed (on 1st reading) (38-Y 0-N)",38,0,0,2,40
1904529,1478142,2025-01-31,Senate,"Read third time and passed Senate (37-Y 2-N 1-A)",37,2,1,0,40
1904529,1486009,2025-02-11,House,"Subcommittee recommends reporting (6-Y 2-N)",6,2,0,1,9
1904536,1478506,2025-01-31,House,"Subcommittee recommends reporting with substitute (7-Y 1-N)",7,1,0,1,9
1904536,1478507,2025-01-31,House,"Reported from Courts of Justice with substitute (18-Y 2-N)",18,2,0,2,22
1904536,1482995,2025-02-04,House,"Read third time and passed House (95-Y 0-N)",95,0,0,5,100
1904536,1488587,2025-02-12,Senate,"Reported from Courts of Justice with substitute and rereferred to Finance and Appropriations (11-Y 1-N 1-A)",11,1,1,2,15
1904536,1490312,2025-02-14,Senate,"Reported from Finance and Appropriations (13-Y 0-N)",13,0,0,2,15
1904536,1491551,2025-02-17,Senate,"Constitutional reading dispensed (on 2nd reading) (39-Y 0-N)",39,0,0,1,40
1904536,1494247,2025-02-19,Senate,"Passed Senate with substitute (38-Y 2-N)",38,2,0,0,40
1904536,1496808,2025-02-20,House,"Senate substitute agreed to by House (97-Y 0-N)",97,0,0,3,100
1904538,1475711,2025-01-28,Senate,"Stricken at request of Patron in Privileges and Elections (15-Y 0-N)",15,0,0,0,15
1904542,1477433,2025-01-21,House,"Subcommittee recommends striking from the docket (8-Y 0-N)",8,0,0,1,9
1904545,1471956,2025-01-16,House,"Subcommittee recommends reporting and referred to Appropriations (7-Y 3-N)",7,3,0,1,11
1904545,1472797,2025-01-21,House,"Reported from Labor and Commerce and referred to Appropriations (15-Y 7-N)",15,7,0,0,22
1904545,1478186,2025-01-31,House,"Reported from Appropriations with substitute (16-Y 6-N)",16,6,0,0,22
1904545,1480705,2025-02-04,House,"Read third time and passed House (68-Y 30-N)",68,30,0,2,100
1904545,1485439,2025-02-10,Senate,"Reported from Commerce and Labor with amendment and rereferred to Finance and Appropriations (14-Y 0-N 1-A)",14,0,1,0,15
1904545,1492178,2025-02-17,Senate,"Reported from Finance and Appropriations (14-Y 0-N)",14,0,0,1,15
1904545,1493641,2025-02-19,Senate,"Constitutional reading dispensed (on 2nd reading) (40-Y 0-N)",40,0,0,0,40
1904545,1496403,2025-02-20,Senate,"Passed Senate with amendment (39-Y 0-N)",39,0,0,1,40
1904545,1496819,2025-02-20,House,"Senate Amendment agreed to by House (65-Y 31-N)",65,31,0,4,100
1904557,1472808,2025-01-21,House,"Subcommittee recommends reporting with substitute (6-Y 0-N)",6,0,0,2,8
1904557,1474038,2025-01-23,House,"Reported from Labor and Commerce with substitute (22-Y 0-N)",22,0,0,0,22
1904557,1477386,2025-01-29,House,"Read third time and passed House (97-Y 0-N)",97,0,0,3,100
1904557,1491389,2025-02-17,Senate,"Reported from Commerce and Labor (15-Y 0-N)",15,0,0,0,15
1904557,1493437,2025-02-18,Senate,"Constitutional reading dispensed (on 2nd reading) (40-Y 0-N)",40,0,0,0,40
1904557,1495091,2025-02-19,Senate,"Passed Senate (40-Y 0-N)",40,0,0,0,40
1904560,1473388,2025-01-22,Senate,"Reported from General Laws and Technology with substitute and rereferred to Finance and Appropriations (15-Y 0-N)",15,0,0,0,15
1904560,1477208,2025-01-29,Senate,"Passed by indefinitely in Finance and Appropriations (14-Y 0-N)",14,0,0,1,15
1904564,1471776,2025-01-15,House,"Subcommittee recommends reporting with amendment(s) (8-Y 0-N)",8,0,0,1,9
1904564,1471895,2025-01-16,House,"Reported from Transportation with amendment(s) (16-Y 4-N 1-A)",16,4,1,1,22
1904564,1473046,2025-01-22,House,"Read third time and passed House (81-Y 16-N)",81,16,0,3,100
1904564,1483436,2025-02-06,Senate,"Reported from Transportation with substitute and rereferred to Finance and Appropriations (11-Y 2-N 2-A)",11,2,2,0,15
1904564,1487394,2025-02-12,Senate,"Reported from Finance and Appropriations with substitute (15-Y 0-N)",15,0,0,0,15
1904564,1488940,2025-02-13,Senate,"Constitutional reading dispensed (on 2nd reading) (40-Y 0-N)",40,0,0,0,40
1904564,1490224,2025-02-14,Senate,"Passed Senate with substitute (33-Y 3-N)",33,3,0,4,40
1904564,1535118,2025-04-02,House,"House concurred in Governor's recommendation (86-Y 9-N)",86,9,0,5,100
1904564,1535119,2025-04-02,Senate,"Senate concurred in Governor's recommendation (40-Y 0-N)",40,0,0,0,40
1904564,1564885,2025-02-18,House,"Senate substitute agreed to by (85-Y 12-N)",85,12,0,3,100
1904566,1472600,2025-01-21,House,"Subcommittee recommends reporting (8-Y 0-N)",8,0,0,1,9
1904566,1473547,2025-01-23,House,"Reported from Transportation (21-Y 0-N)",21,0,0,1,22
1904566,1477314,2025-01-29,House,"Read third time and passed House (96-Y 1-N)",96,1,0,3,100
1904566,1483379,2025-02-06,Senate,"Reported from Transportation with amendments and rereferred to Finance and Appropriations (14-Y 0-N)",14,0,0,1,15
1904566,1487377,2025-02-12,Senate,"Passed by indefinitely in Finance and Appropriations with letter (10-Y 5-N)",10,5,0,0,15
1904570,1474155,2025-01-23,House,"Subcommittee recommends reporting with amendment(s) (7-Y 0-N)",7,0,0,2,9
1904570,1475890,2025-01-28,House,"Reported from General Laws with amendment(s) (22-Y 0-N)",22,0,0,0,22
1904570,1479017,2025-02-03,House,"Read third time and passed House (98-Y 0-N)",98,0,0,2,100
1904570,1479018,2025-02-03,House,"Read third time and passed House (99-Y 0-N)",99,0,0,1,100
1904570,1488150,2025-02-12,Senate,"Reported from General Laws and Technology (14-Y 0-N)",14,0,0,1,15
1904570,1490135,2025-02-14,Senate,"Constitutional reading dispensed (on 2nd reading) (36-Y 0-N)",36,0,0,4,40
1904570,1491299,2025-02-17,Senate,"Passed Senate (39-Y 0-N)",39,0,0,1,40
1904572,1475417,2025-01-27,Senate,"Reading waived (on 1st reading) (38-Y 0-N)",38,0,0,2,40
1904572,1490790,2025-02-17,House,"Reported from Rules (18-Y 0-N)",18,0,0,0,18
1904572,1495922,2025-02-20,House,"Agreed to by House (97-Y 0-N)",97,0,0,3,100
1904575,1473316,2025-01-22,Senate,"Reported from General Laws and Technology with substitute and rereferred to Finance and Appropriations (15-Y 0-N)",15,0,0,0,15
1904575,1477185,2025-01-29,Senate,"Reported from Finance and Appropriations (14-Y 0-N)",14,0,0,1,15
1904575,1477925,2025-01-30,Senate,"Constitutional reading dispensed (on 1st reading) (39-Y 0-N 1-A)",39,0,1,0,40
1904575,1479340,2025-01-31,Senate,"Constitutional reading dispensed (on 3rd reading) (40-Y 0-N)",40,0,0,0,40
1904575,1479341,2025-01-31,Senate,"Passed Senate (40-Y 0-N)",40,0,0,0,40
1904575,1483698,2025-02-06,House,"Reported from General Laws (21-Y 0-N)",21,0,0,1,22
1904575,1565403,2025-02-12,House,"Passed House (97-Y 0-N)",97,0,0,3,100
1904579,1475672,2025-01-28,Senate,"Reported from Privileges and Elections and rereferred to Finance and Appropriations (13-Y 2-N)",13,2,0,0,15
1904579,1477633,2025-01-30,Senate,"Reported from Finance and Appropriations (11-Y 0-N 4-A)",11,0,4,0,15
1904579,1479849,2025-02-04,Senate,"Constitutional reading dispensed (on 3rd reading) (40-Y 0-N)",40,0,0,0,40
1904579,1479850,2025-02-04,Senate,"Passed Senate (36-Y 4-N)",36,4,0,0,40
1904579,1480294,2025-02-03,Senate,"Constitutional reading dispensed (on 1st reading) (40-Y 0-N)",40,0,0,0,40
1904579,1490040,2025-02-14,House,"Reported from Privileges and Elections (22-Y 0-N)",22,0,0,0,22
1904579,1493380,2025-02-19,House,"Passed House (97-Y 0-N)",97,0,0,3,100
1904583,1472788,2025-01-21,House,"Subcommittee recommends passing by indefinitely (4-Y 3-N)",4,3,0,1,8
1904589,1474498,2025-01-24,Senate,"Reported from General Laws and Technology (15-Y 0-N)",15,0,0,0,15
1904589,1476864,2025-01-29,Senate,"Passed Senate (38-Y 0-N)",38,0,0,2,40
1904589,1477031,2025-01-28,Senate,"Constitutional reading dispensed (on 1st reading) (39-Y 0-N)",39,0,0,1,40
1904589,1479356,2025-01-29,Senate,"Constitutional reading dispensed (on 3rd reading) (38-Y 0-N)",38,0,0,2,40
1904589,1489158,2025-02-13,House,"Subcommittee recommends reporting (6-Y 1-N)",6,1,0,2,9
1904589,1489159,2025-02-13,House,"Reported from General Laws (14-Y 5-N)",14,5,0,3,22
1904589,1492477,2025-02-18,House,"Passed House (52-Y 45-N)",52,45,0,3,100
1904595,1472804,2025-01-21,House,"Subcommittee recommends reporting with substitute (7-Y 0-N)",7,0,0,1,8
1904595,1474032,2025-01-23,House,"Reported from Labor and Commerce with substitute (22-Y 0-N)",22,0,0,0,22
1904595,1477430,2025-01-29,House,"Read third time and passed House (97-Y 0-N)",97,0,0,3,100
1904595,1485337,2025-02-10,Senate,"Reported from Commerce and Labor (15-Y 0-N)",15,0,0,0,15
1904595,1487675,2025-02-12,Senate,"Constitutional reading dispensed (on 2nd reading) (39-Y 0-N)",39,0,0,1,40
1904595,1490004,2025-02-13,Senate,"Passed Senate (40-Y 0-N)",40,0,0,0,40
1904599,1473048,2025-01-22,House,"Subcommittee recommends reporting (9-Y 1-N)",9,1,0,1,11
1904599,1474722,2025-01-27,House,"Reported from Communications, Technology and Innovation (20-Y 2-N)",20,2,0,0,22
1904599,1478419,2025-01-31,House,"Read third time and passed House (87-Y 9-N)",87,9,0,4,100
1904599,1484979,2025-02-10,Senate,"Reported from Courts of Justice with amendment (15-Y 0-N)",15,0,0,0,15
1904599,1486412,2025-02-11,Senate,"Constitutional reading dispensed (on 2nd reading) (40-Y 0-N)",40,0,0,0,40
1904599,1489193,2025-02-12,Senate,"Passed Senate with amendment (39-Y 0-N)",39,0,0,1,40
1904599,1490099,2025-02-14,House,"Senate Amendment agreed to by House (Y-88 N-7 A-0)",88,7,0,5,100
1904604,1474655,2025-01-27,House,"Subcommittee recommends reporting and referring to Appropriations (8-Y 0-N)",8,0,0,1,9
1904604,1476866,2025-01-29,House,"Reported from Finance and referred to Appropriations (21-Y 0-N)",21,0,0,1,22
1904607,1472040,2025-01-16,House,"Subcommittee recommends reporting and referred to Appropriations (8-Y 0-N)",8,0,0,1,9
1904607,1472817,2025-01-21,House,"Reported from Labor and Commerce and referred to Appropriations (20-Y 1-N)",20,1,0,1,22
1904607,1476781,2025-01-29,House,"Subcommittee recommends reporting with amendment(s) (7-Y 0-N)",7,0,0,2,9
1904607,1476782,2025-01-29,House,"Reported from Appropriations with amendment(s) (21-Y 0-N)",21,0,0,1,22
1904607,1484922,2025-02-10,Senate,"Reported from Commerce and Labor and rereferred to Finance and Appropriations (15-Y 0-N)",15,0,0,0,15
1904607,1492087,2025-02-17,Senate,"Passed by indefinitely in Finance and Appropriations (11-Y 3-N)",11,3,0,1,15
1904607,1564926,2025-02-04,House,"Read third time and passed House (99-Y 0-N)",99,0,0,1,100
1904614,1472806,2025-01-21,House,"Subcommittee recommends laying on the table (5-Y 3-N)",5,3,0,1,9
1904618,1475624,2025-01-28,House,"Subcommittee recommends reporting and referring to Appropriations (7-Y 1-N)",7,1,0,1,9
1904618,1477674,2025-01-30,House,"Reported from Health and Human Services (20-Y 1-N)",20,1,0,1,22
1904618,1482290,2025-02-04,House,"Read third time and passed House (98-Y 0-N)",98,0,0,2,100
1904618,1489847,2025-02-13,Senate,"Reported from Education and Health with amendments (15-Y 0-N)",15,0,0,0,15
1904618,1491350,2025-02-17,Senate,"Constitutional reading dispensed (on 2nd reading)",39,0,0,1,40
1904618,1492280,2025-02-18,Senate,"Passed Senate with amendment (40-Y 0-N)",40,0,0,0,40
1904618,1493716,2025-02-19,House,"Senate Amendments agreed to by House (96-Y 1-N)",96,1,0,3,100
1904618,1535505,2025-04-02,House,"VOTE: Pass by for the day - Adoption (47-Y 46-N)",47,46,0,7,100
1904621,1472309,2025-01-20,House,"Subcommittee recommends laying on the table (5-Y 3-N)",5,3,0,1,9
1904624,1475498,2025-01-28,House,"Subcommittee recommends reporting (8-Y 0-N)",8,0,0,1,9
1904624,1477228,2025-01-30,House,"Reported from Health and Human Services (21-Y 0-N)",21,0,0,1,22
1904624,1480567,2025-02-04,House,"Read third time and passed House (97-Y 0-N)",97,0,0,3,100
1904624,1480568,2025-02-04,House,"Passed House (99-Y 0-N)",99,0,0,1,100
1904624,1489715,2025-02-13,Senate,"Reported from Education and Health (13-Y 0-N)",13,0,0,2,15
1904624,1491174,2025-02-17,Senate,"Constitutional reading dispensed (on 2nd reading)",39,0,0,1,40
1904624,1492355,2025-02-18,Senate,"Passed Senate (40-Y 0-N)",40,0,0,0,40
1904624,1535426,2025-04-02,Senate,"Senate concurred in Governor's recommendation (40-Y 0-N)",40,0,0,0,40
1904624,1536624,2025-04-02,House,"House concurred in Governor's recommendation (95-Y 0-N)",95,0,0,5,100
1904628,1471502,2025-01-13,Senate,"Reported from Local Government (12-Y 1-N)",12,1,0,0,13
1904628,1471503,2025-01-14,Senate,"Constitutional reading dispensed (on 1st reading) (37-Y 0-N)",37,0,0,1,38
1904628,1471897,2025-01-16,Senate,"Read third time and passed Senate (39-Y 0-N)",39,0,0,1,40
1904628,1483102,2025-02-06,House,"Subcommittee recommends reporting (8-Y 0-N)",8,0,0,1,9
1904628,1483952,2025-02-07,House,"Reported from Counties, Cities and Towns (21-Y 0-N)",21,0,0,1,22
1904628,1490787,2025-02-17,House,"Reported from Rules (11-Y 6-N)",11,6,0,1,18
1904628,1496216,2025-02-20,House,"Passed House (67-Y 31-N)",67,31,0,2,100
1904633,1473367,2025-01-22,Senate,"Reported from Courts of Justice with substitute (14-Y 0-N)",14,0,0,1,15
1904633,1474495,2025-01-24,Senate,"Constitutional reading dispensed (on 1st reading) (37-Y 0-N)",37,0,0,3,40
1904633,1476867,2025-01-28,Senate,"Read third time and passed Senate (39-Y 0-N)",39,0,0,1,40
1904633,1484083,2025-02-07,House,"Subcommittee recommends reporting with substitute (8-Y 0-N)",8,0,0,1,9
1904633,1485457,2025-02-10,House,"Reported from Courts of Justice with substitute (22-Y 0-N)",22,0,0,0,22
1904633,1488797,2025-02-13,House,"Passed House with substitute (96-Y 0-N)",96,0,0,4,100
1904633,1491610,2025-02-17,Senate,"House substitute agreed to by Senate (39-Y 0-N)",39,0,0,1,40
1904636,1472150,2025-01-17,House,"Reported from Counties, Cities and Towns (20-Y 2-N)",20,2,0,0,22
1904636,1473709,2025-01-23,House,"Read third time and passed House (75-Y 21-N)",75,21,0,4,100
1904636,1482759,2025-02-05,Senate,"Rereferred from General Laws and Technology to Local Government (12-Y 0-N)",12,0,0,3,15
1904636,1484599,2025-02-10,Senate,"Reported from Local Government (14-Y 1-N)",14,1,0,0,15
1904636,1485967,2025-02-11,Senate,"Constitutional reading dispensed (on 2nd reading) (40-Y 0-N)",40,0,0,0,40
1904636,1488056,2025-02-12,Senate,"Passed Senate (35-Y 3-N)",35,3,0,2,40
1904638,1475089,2025-01-27,House,"Subcommittee recommends reporting with substitute (10-Y 0-N)",10,0,0,1,11
1904638,1476362,2025-01-29,House,"Reported from Agriculture, Chesapeake and Natural Resources with substitute (22-Y 0-N)",22,0,0,0,22
1904638,1482372,2025-02-04,House,"Read third time and passed House (98-Y 0-N)",98,0,0,2,100
1904638,1486575,2025-02-11,Senate,"Reported from Agriculture, Conservation and Natural Resources with substitute and rereferred to Finance and Appropriations (11-Y 4-N)",11,4,0,0,15
1904638,1492131,2025-02-17,Senate,"Reported from Finance and Appropriations (13-Y 1-N)",13,1,0,1,15
1904638,1495915,2025-02-19,Senate,"Constitutional reading dispensed (on 2nd reading) (40-Y 0-N)",40,0,0,0,40
1904638,1496362,2025-02-20,Senate,"Passed Senate with substitute with amendments (38-Y 0-N)",38,0,0,2,40
1904638,1496809,2025-02-20,House,"Senate substitute agreed to by House (95-Y 0-N)",95,0,0,5,100
1904638,1535343,2025-04-02,Senate,"Senate concurred in Governor's recommendation (40-Y 0-N)",40,0,0,0,40
1904638,1536516,2025-04-02,House,"House concurred in Governor's recommendation (96-Y 0-N)",96,0,0,4,100
1904641,1474077,2025-01-23,House,"Subcommittee recommends reporting with substitute (8-Y 0-N)",8,0,0,1,9
1904641,1475812,2025-01-28,House,"Reported from General Laws with substitute (19-Y 3-N)",19,3,0,0,22
1904641,1480212,2025-02-03,House,"Read third time and passed House (75-Y 24-N 0-A",75,24,0,1,100
1904641,1488238,2025-02-12,Senate,"Reported from General Laws and Technology with amendment (10-Y 5-N)",10,5,0,0,15
1904641,1490548,2025-02-14,Senate,"Constitutional reading dispensed (on 2nd reading) (36-Y 0-N)",36,0,0,4,40
1904641,1494183,2025-02-18,Senate,"Passed Senate with amendment (22-Y 18-N)",22,18,0,0,40
1904641,1565141,2025-02-19,House,"Senate Amendment agreed to by House (70-Y 27-N)",70,27,0,3,100
1904645,1474665,2025-01-27,House,"Subcommittee recommends reporting with substitute and referring to Appropriations (6-Y 4-N)",6,4,0,1,11
1904645,1474826,2025-01-27,House,"Reported from Communications, Technology and Innovation with substitute and referred to Appropriations (12-Y 10-N)",12,10,0,0,22
1904645,1478199,2025-01-31,House,"Reported from Appropriations with substitute (12-Y 10-N)",12,10,0,0,22
1904645,1482455,2025-02-04,House,"Read third time and passed House (51-Y 47-N)",51,47,0,2,100
1904645,1488064,2025-02-12,Senate,"Reported from General Laws and Technology with substitute and rereferred to Finance and Appropriations (9-Y 3-N 3-A)",9,3,3,0,15
1904645,1490157,2025-02-14,Senate,"Reported from Finance and Appropriations (9-Y 4-N)",9,4,0,2,15
1904645,1492143,2025-02-17,Senate,"Constitutional reading dispensed (on 2nd reading) (39-Y 0-N)",39,0,0,1,40
1904645,1493628,2025-02-19,Senate,"Passed Senate with substitute (21-Y 19-N)",21,19,0,0,40
1904645,1496800,2025-02-20,House,"Senate substitute agreed to by House (52-Y 46-N)",52,46,0,2,100
1904653,1477730,2025-01-30,House,"Subcommittee recommends laying on the table (5-Y 0-N)",5,0,0,1,6
1904658,1473191,2025-01-22,House,"Subcommittee recommends reporting with substitute (5-Y 3-N)",5,3,0,1,9
1904658,1477245,2025-01-30,House,"Reported from Transportation with substitute (12-Y 10-N)",12,10,0,0,22
1904658,1480650,2025-02-04,House,"Read third time and passed House (54-Y 44-N)",54,44,0,2,100
1904658,1489617,2025-02-13,Senate,"Failed to report from Transportation with substitute (6-Y 9-N)",6,9,0,0,15
1904661,1476694,2025-01-29,House,"Subcommittee recommends reporting with substitute (8-Y 0-N)",8,0,0,1,9
1904661,1478379,2025-01-31,House,"Reported from Courts of Justice with substitute (20-Y 0-N)",20,0,0,2,22
1904661,1480121,2025-02-04,House,"Read third time and passed House (97-Y 0-N)",97,0,0,3,100
1904661,1480123,2025-02-04,House,"Passed House (99-Y 0-N)",99,0,0,1,100
1904661,1485467,2025-02-10,Senate,"Reported from Courts of Justice with substitute (15-Y 0-N)",15,0,0,0,15
1904661,1486794,2025-02-11,Senate,"Constitutional reading dispensed (on 2nd reading) (40-Y 0-N)",40,0,0,0,40
1904661,1488069,2025-02-12,Senate,"Passed Senate with substitute (39-Y 0-N)",39,0,0,1,40
1904661,1490860,2025-02-17,House,"Senate substitute rejected by House (2-Y 94-N)",2,94,0,4,100
1904661,1492752,2025-02-18,Senate,"Senate insisted on substitute (40-Y 0-N)",40,0,0,0,40
1904661,1497189,2025-02-21,Senate,"Conference report agreed to by Senate (39-Y 0-N)",39,0,0,1,40
1904661,1504251,2025-02-21,House,"Conference report agreed to by House (96-Y 0-N)",96,0,0,4,100
1904665,1477439,2025-01-30,House,"Subcommittee recommends laying on the table (6-Y 2-N)",6,2,0,1,9
1904667,1475010,2025-01-27,Senate,"Reported from Commerce and Labor with substitute and rereferred to Finance and Appropriations (14-Y 0-N 1-A)",14,0,1,0,15
1904667,1477734,2025-01-30,Senate,"Reported from Finance and Appropriations with substitute (15-Y 0-N)",15,0,0,0,15
1904667,1479643,2025-02-04,Senate,"Constitutional reading dispensed (on 3rd reading) (40-Y 0-N)",40,0,0,0,40
1904667,1479644,2025-02-04,Senate,"Passed Senate (40-Y 0-N)",40,0,0,0,40
1904667,1480429,2025-02-03,Senate,"Constitutional reading dispensed (on 1st reading) (40-Y 0-N)",40,0,0,0,40
1904667,1489446,2025-02-13,House,"Reported from Labor and Commerce with substitute (12-Y 10-N)",12,10,0,0,22
1904667,1492011,2025-02-18,House,"Passed House with substitute (54-Y 43-N)",54,43,0,3,100
1904667,1495794,2025-02-19,Senate,"House substitute agreed to by Senate (40-Y 0-N)",40,0,0,0,40
1904667,1536230,2025-04-02,Senate,"Senate concurred in Governor's recommendation (20-Y 19-N)",20,19,0,1,40
1904667,1536231,2025-04-02,Senate,"Reconsideration of Governor's recommendation agreed to (40-Y 0-N)",40,0,0,0,40
1904667,1536232,2025-04-02,Senate,"Senate rejected Governor's recommendation (19-Y 21-N)",19,21,0,0,40
1904674,1474667,2025-01-27,House,"Subcommittee recommends reporting with substitute and referring to Appropriations (5-Y 4-N 1-A)",5,4,1,1,11
1904674,1474824,2025-01-27,House,"Reported from Communications, Technology and Innovation with substitute and referred to Appropriations (12-Y 10-N)",12,10,0,0,22
1904674,1478210,2025-01-31,House,"Reported from Appropriations (12-Y 10-N)",12,10,0,0,22
1904674,1480676,2025-02-04,House,"Read third time and passed House (51-Y 47-N)",51,47,0,2,100
1904674,1488001,2025-02-12,Senate,"Reported from General Laws and Technology with substitute and rereferred to Finance and Appropriations (15-Y 0-N)",15,0,0,0,15
1904674,1490147,2025-02-14,Senate,"Reported from Finance and Appropriations (14-Y 0-N)",14,0,0,1,15
1904674,1492092,2025-02-17,Senate,"Constitutional reading dispensed (on 2nd reading) (39-Y 0-N)",39,0,0,1,40
1904676,1473861,2025-01-21,Senate,"Reported from Agriculture, Conservation and Natural Resources with substitute and rereferred to Finance and Appropriations (13-Y 0-N)",13,0,0,2,15
1904680,1471548,2025-01-13,Senate,"Reported from Local Government (13-Y 0-N)",13,0,0,0,13
1904680,1471549,2025-01-14,Senate,"Constitutional reading dispensed (on 1st reading) (37-Y 0-N)",37,0,0,1,38
1904680,1471978,2025-01-16,Senate,"Read third time and passed Senate (39-Y 0-N)",39,0,0,1,40
1904680,1483109,2025-02-06,House,"Subcommittee recommends reporting (8-Y 0-N)",8,0,0,1,9
1904680,1483958,2025-02-07,House,"Reported from Counties, Cities and Towns (21-Y 0-N)",21,0,0,1,22
1904680,1488805,2025-02-12,House,"Passed House (97-Y 0-N)",97,0,0,3,100
1904682,1474158,2025-01-23,House,"Subcommittee recommends reporting (8-Y 0-N)",8,0,0,1,9
1904682,1476006,2025-01-28,House,"Reported from General Laws (22-Y 0-N)",22,0,0,0,22
1904682,1479660,2025-02-03,House,"Read third time and passed House (98-Y 0-N)",98,0,0,2,100
1904682,1479661,2025-02-03,House,"Read third time and passed House (99-Y 0-N)",99,0,0,1,100
1904682,1488132,2025-02-12,Senate,"Reported from General Laws and Technology (15-Y 0-N)",15,0,0,0,15
1904682,1490529,2025-02-14,Senate,"Constitutional reading dispensed (on 2nd reading) (36-Y 0-N)",36,0,0,4,40
1904682,1491217,2025-02-17,Senate,"Passed Senate (39-Y 0-N)",39,0,0,1,40
1904686,1471966,2025-01-16,House,"Subcommittee recommends reporting (7-Y 4-N)",7,4,0,0,11
1904686,1474028,2025-01-23,House,"Reported from Labor and Commerce with substitute (15-Y 7-N)",15,7,0,0,22
1904686,1477328,2025-01-29,House,"Read third time and passed House (61-Y 35-N)",61,35,0,4,100
1904686,1491368,2025-02-17,Senate,"Reported from Commerce and Labor with substitute (9-Y 6-N)",9,6,0,0,15
1904686,1493293,2025-02-18,Senate,"Constitutional reading dispensed (on 2nd reading) (40-Y 0-N)",40,0,0,0,40
1904686,1495684,2025-02-19,Senate,"Passed Senate with substitute (24-Y 16-N)",24,16,0,0,40
1904686,1495685,2025-02-20,Senate,"Senate insisted on substitute (39-Y 0-N)",39,0,0,1,40
1904686,1496647,2025-02-20,House,"Senate substitute rejected by House (4-Y 94-N)",4,94,0,2,100
1904686,1497127,2025-02-22,House,"Conference report agreed to by House (67-Y 32-N)",67,32,0,1,100
1904686,1503576,2025-02-22,Senate,"Conference report agreed to by Senate (23-Y 17-N)",23,17,0,0,40
1904690,1474943,2025-01-27,House,"Subcommittee recommends reporting with substitute (8-Y 0-N)",8,0,0,1,9
1904690,1476583,2025-01-29,House,"Reported from Education with substitute (15-Y 7-N)",15,7,0,0,22
1904690,1482520,2025-02-04,House,"Read third time and passed House (66-Y 32-N)",66,32,0,2,100
1904690,1489398,2025-02-13,Senate,"Reported from Education and Health and rereferred to Finance and Appropriations (8-Y 5-N 1-A)",8,5,1,1,15
1904690,1490495,2025-02-14,Senate,"Reported from Finance and Appropriations (10-Y 4-N)",10,4,0,1,15
1904690,1491567,2025-02-17,Senate,"Constitutional reading dispensed (on 2nd reading) (39-Y 0-N)",39,0,0,1,40
1904690,1493671,2025-02-19,Senate,"Passed Senate with substitute (21-Y 19-N)",21,19,0,0,40
1904690,1496711,2025-02-20,House,"Senate substitute agreed to by House (64-Y 33-N)",64,33,0,3,100
1904693,1477550,2025-01-30,House,"Subcommittee recommends laying on the table (8-Y 0-N)",8,0,0,1,9
1904699,1471779,2025-01-15,Senate,"Reported from General Laws and Technology (15-Y 0-N)",15,0,0,0,15
1904699,1472211,2025-01-17,Senate,"Constitutional reading dispensed (on 1st reading) (40-Y 0-N)",40,0,0,0,40
1904699,1473593,2025-01-21,Senate,"Read third time and passed Senate (40-Y 0-N)",40,0,0,0,40
1904699,1483742,2025-02-06,House,"Reported from General Laws with substitute (21-Y 0-N)",21,0,0,1,22
1904699,1486800,2025-02-11,House,"Passed House with substitute (94-Y 0-N)",94,0,0,6,100
1904699,1489066,2025-02-13,Senate,"House substitute agreed to by Senate (40-Y 0-N)",40,0,0,0,40
1904703,1475721,2025-01-28,House,"Subcommittee recommends reporting and referring to Appropriations (7-Y 0-N)",7,0,0,2,9
1904703,1476974,2025-01-29,House,"Reported from Finance and referred to Appropriations (20-Y 2-N)",20,2,0,0,22
1904706,1472357,2025-01-20,House,"Subcommittee recommends reporting and referred to Appropriations (10-Y 0-N)",10,0,0,1,11
1904706,1472949,2025-01-22,House,"Reported from Education and referred to Appropriations (22-Y 0-N)",22,0,0,0,22
1904706,1478434,2025-01-31,House,"Reported from Appropriations (22-Y 0-N)",22,0,0,0,22
1904706,1479580,2025-02-04,House,"Read third time and passed House (97-Y 0-N)",97,0,0,3,100
1904706,1479581,2025-02-04,House,"Passed House (99-Y 0-N)",99,0,0,1,100
1904706,1489605,2025-02-13,Senate,"Passed by indefinitely in Education and Health (7-Y 6-N)",7,6,0,2,15
1904709,1473249,2025-01-22,Senate,"Read third time and passed Senate (40-Y 0-N)",40,0,0,0,40
1904709,1473775,2025-01-17,Senate,"Reported from Transportation with amendments (14-Y 0-N)",14,0,0,1,15
1904709,1473776,2025-01-20,Senate,"Constitutional reading dispensed (on 1st reading) (40-Y 0-N)",40,0,0,0,40
1904709,1483098,2025-02-06,House,"Reported from Transportation (20-Y 0-N)",20,0,0,2,22
1904709,1486469,2025-02-11,House,"Passed House (94-Y 0-N)",94,0,0,6,100
1904714,1473456,2025-01-23,House,"Subcommittee recommends reporting with substitute (6-Y 2-N)",6,2,0,1,9
1904714,1475614,2025-01-28,House,"Reported from Health and Human Services with substitute (22-Y 0-N)",22,0,0,0,22
1904714,1479670,2025-02-03,House,"Read third time and passed House (98-Y 0-N)",98,0,0,2,100
1904714,1479671,2025-02-03,House,"Read third time and passed House (99-Y 0-N)",99,0,0,1,100
1904717,1474605,2025-01-24,Senate,"Reported from Rules (13-Y 0-N)",13,0,0,2,15
1904717,1474925,2025-01-27,Senate,"Constitutional reading dispensed (on 1st reading) (37-Y 1-N)",37,1,0,2,40
1904717,1476322,2025-01-29,Senate,"Read third time and passed Senate (38-Y 0-N)",38,0,0,2,40
1904717,1486163,2025-02-11,House,"Reported from Health and Human Services (22-Y 0-N)",22,0,0,0,22
1904717,1490544,2025-02-14,House,"Passed House (96-Y 0-N)",96,0,0,4,100
1904720,1472582,2025-01-20,House,"Subcommittee recommends reporting with amendment(s) (8-Y 0-N)",8,0,0,1,9
1904720,1474737,2025-01-24,House,"Reported from Courts of Justice with amendment(s) (22-Y 0-N)",22,0,0,0,22
1904720,1478114,2025-01-30,House,"Read third time and passed House (96-Y 0-N)",96,0,0,4,100
1904720,1491255,2025-02-17,Senate,"Reported from Courts of Justice (15-Y 0-N)",15,0,0,0,15
1904720,1492295,2025-02-18,Senate,"Constitutional reading dispensed (on 2nd reading) (39-Y 0-N)",39,0,0,1,40
1904720,1493730,2025-02-19,Senate,"Passed Senate (40-Y 0-N)",40,0,0,0,40
1904726,1471829,2025-01-15,Senate,"Reported from Courts of Justice (15-Y 0-N)",15,0,0,0,15
1904726,1472229,2025-01-17,Senate,"Constitutional reading dispensed (on 1st reading) (40-Y 0-N)",40,0,0,0,40
1904726,1472807,2025-01-21,Senate,"Read third time and passed Senate (40-Y 0-N)",40,0,0,0,40
1904726,1484968,2025-02-10,House,"Subcommittee recommends reporting with substitute (8-Y 0-N)",8,0,0,1,9
1904726,1490622,2025-02-14,House,"Reported from Courts of Justice with substitute (21-Y 0-N)",21,0,0,1,22
1904726,1494945,2025-02-19,House,"Passed House with substitute (97-Y 0-N)",97,0,0,3,100
1904726,1494946,2025-02-20,Senate,"House substitute agreed to by Senate (37-Y 2-N)",37,2,0,1,40
1904732,1472767,2025-01-21,House,"Subcommittee failed to recommend reporting (2-Y 4-N)",2,4,0,2,8
1904736,1471892,2025-01-16,House,"Subcommittee recommends reporting with substitute (4-Y 2-N)",4,2,0,1,7
1904736,1472069,2025-01-17,House,"Reported from Public Safety with substitute (21-Y 1-N)",21,1,0,0,22
1904736,1473618,2025-01-23,House,"Read third time and passed House (97-Y 0-N)",97,0,0,3,100
1904736,1489978,2025-02-14,Senate,"Reported from Rehabilitation and Social Services with substitute (14-Y 0-N)",14,0,0,1,15
1904736,1491254,2025-02-17,Senate,"Constitutional reading dispensed (on 2nd reading)",39,0,0,1,40
1904736,1493205,2025-02-18,Senate,"Passed Senate with substitute (40-Y 0-N)",40,0,0,0,40
1904736,1493206,2025-02-19,House,"Senate substitute agreed to by House (95-Y 0-N)",95,0,0,5,100
1904738,1475858,2025-01-28,House,"Subcommittee recommends reporting with substitute and referring to Appropriations (5-Y 2-N)",5,2,0,2,9
1904738,1476739,2025-01-29,House,"Reported from Finance with substitute and referred to Appropriations (12-Y 10-N)",12,10,0,0,22
1904738,1478326,2025-01-31,House,"Reported from Appropriations with substitute (14-Y 8-N)",14,8,0,0,22
1904738,1480672,2025-02-04,House,"Read third time and passed House (54-Y 44-N)",54,44,0,2,100
1904738,1486574,2025-02-11,Senate,"Passed by indefinitely in Finance and Appropriations (15-Y 0-N)",15,0,0,0,15
1904742,1472644,2025-01-21,House,"Subcommittee recommends laying on the table (7-Y 0-N)",7,0,0,2,9
1904752,1475801,2025-01-28,House,"Subcommittee recommends laying on the table (5-Y 2-N)",5,2,0,2,9
1904755,1475815,2025-01-28,House,"Subcommittee recommends reporting with substitute (5-Y 1-N)",5,1,0,2,8
1904755,1477722,2025-01-30,House,"Reported from Labor and Commerce with substitute (17-Y 5-N)",17,5,0,0,22
1904755,1480822,2025-02-04,House,"Read third time and passed House (82-Y 15-N)",82,15,0,3,100
1904755,1484945,2025-02-10,Senate,"Reported from Commerce and Labor (10-Y 5-N)",10,5,0,0,15
1904755,1487919,2025-02-12,Senate,"Constitutional reading dispensed (on 2nd reading) (39-Y 0-N)",39,0,0,1,40
1904755,1488811,2025-02-13,Senate,"Passed Senate (27-Y 10-N)",27,10,0,3,40
1904759,1473870,2025-01-23,House,"Subcommittee recommends reporting (5-Y 3-N)",5,3,0,3,11
1904759,1474237,2025-01-24,House,"Reported from Public Safety (12-Y 10-N)",12,10,0,0,22
1904759,1478213,2025-01-30,House,"Read third time and passed House (50-Y 46-N)",50,46,0,4,100
1904759,1488256,2025-02-12,Senate,"Reported from Courts of Justice (9-Y 6-N)",9,6,0,0,15
1904759,1490313,2025-02-14,Senate,"Constitutional reading dispensed (on 2nd reading) (36-Y 0-N)",36,0,0,4,40
1904759,1492407,2025-02-18,Senate,"Passed Senate (20-Y 19-N)",20,19,0,1,40
1904762,1472744,2025-01-21,House,"Subcommittee recommends reporting with substitute (6-Y 1-N)",6,1,0,1,8
1904762,1474156,2025-01-23,House,"Reported from Labor and Commerce with substitute and referred to Appropriations (19-Y 3-N)",19,3,0,0,22
1904767,1471731,2025-01-15,House,"Subcommittee recommends reporting with amendment(s) (8-Y 0-N)",8,0,0,1,9
1904767,1472226,2025-01-17,House,"Reported from Courts of Justice with amendment(s) (22-Y 0-N)",22,0,0,0,22
1904767,1473749,2025-01-23,House,"Read third time and passed House (97-Y 0-N)",97,0,0,3,100
1904767,1483215,2025-02-05,Senate,"Reported from Courts of Justice (14-Y 0-N)",14,0,0,1,15
1904767,1484046,2025-02-07,Senate,"Constitutional reading dispensed (on 2nd reading) (38-Y 0-N)",38,0,0,2,40
1904767,1484859,2025-02-10,Senate,"Passed Senate (39-Y 0-N)",39,0,0,1,40
1904771,1474934,2025-01-27,Senate,"Reading waived (on 1st reading) (38-Y 0-N)",38,0,0,2,40
1904771,1491594,2025-02-17,House,"Passed by indefinitely in Rules (18-Y 0-N)",18,0,0,0,18
1904779,1473829,2025-01-21,Senate,"Reported from Privileges and Elections (15-Y 0-N)",15,0,0,0,15
1904779,1473830,2025-01-23,Senate,"Constitutional reading dispensed (on 1st reading) (39-Y 0-N)",39,0,0,1,40
1904779,1474827,2025-01-27,Senate,"Read third time and passed Senate (38-Y 0-N)",38,0,0,2,40
1904779,1483913,2025-02-07,House,"Reported from Privileges and Elections (21-Y 1-N)",21,1,0,0,22
1904779,1487623,2025-02-12,House,"Passed House (89-Y 8-N)",89,8,0,3,100
1904782,1474152,2025-01-23,House,"Subcommittee recommends reporting with amendment(s) (8-Y 0-N)",8,0,0,1,9
1904782,1476009,2025-01-28,House,"Reported from General Laws with amendment(s) (22-Y 0-N)",22,0,0,0,22
1904782,1479421,2025-02-03,House,"Read third time and passed House (98-Y 0-N)",98,0,0,2,100
1904782,1479422,2025-02-03,House,"Read third time and passed House (99-Y 0-N)",99,0,0,1,100
1904782,1488558,2025-02-12,Senate,"Reported from General Laws and Technology (15-Y 0-N)",15,0,0,0,15
1904782,1490081,2025-02-14,Senate,"Constitutional reading dispensed (on 2nd reading) (36-Y 0-N)",36,0,0,4,40
1904782,1491544,2025-02-17,Senate,"Passed Senate (39-Y 0-N)",39,0,0,1,40
1904785,1471891,2025-01-16,House,"Subcommittee recommends reporting with amendment(s) (4-Y 2-N)",4,2,0,1,7
1904785,1472081,2025-01-17,House,"Reported from Public Safety (12-Y 10-N)",12,10,0,0,22
1904785,1474252,2025-01-24,House,"Reported from Public Safety and referred to Appropriations (13-Y 9-N)",13,9,0,0,22
1904785,1476408,2025-01-29,House,"Subcommittee recommends reporting (8-Y 0-N)",8,0,0,1,9
1904785,1476806,2025-01-29,House,"Reported from Appropriations (21-Y 0-N)",21,0,0,1,22
1904785,1480575,2025-02-04,House,"Read third time and passed House (63-Y 35-N)",63,35,0,2,100
1904785,1488162,2025-02-12,Senate,"Reported from General Laws and Technology with amendments and rereferred to Finance and Appropriations (15-Y 0-N)",15,0,0,0,15
1904785,1492184,2025-02-17,Senate,"Reported from Finance and Appropriations (14-Y 0-N)",14,0,0,1,15
1904785,1493590,2025-02-19,Senate,"Constitutional reading dispensed (on 2nd reading) (40-Y 0-N)",40,0,0,0,40
1904785,1496408,2025-02-20,Senate,"Passed Senate with amendments (39-Y 0-N)",39,0,0,1,40
1904785,1496409,2025-02-20,Senate,"Reconsideration of Senate passage agreed to by Senate (39-Y 0-N)",39,0,0,1,40
1904785,1496410,2025-02-20,Senate,"Passed Senate with amendments (39-Y 0-N)",39,0,0,1,40
1904785,1496820,2025-02-20,House,"Senate Amendments agreed to by House (61-Y 35-N)",61,35,0,4,100
1904805,1473977,2025-01-23,House,"Subcommittee recommends reporting with amendment(s) (8-Y 0-N)",8,0,0,1,9
1904805,1475853,2025-01-28,House,"Reported from General Laws with amendment(s) (22-Y 0-N)",22,0,0,0,22
1904805,1488159,2025-02-12,Senate,"Reported from General Laws and Technology (15-Y 0-N)",15,0,0,0,15
1904805,1490288,2025-02-14,Senate,"Constitutional reading dispensed (on 2nd reading) (36-Y 0-N)",36,0,0,4,40
1904805,1491100,2025-02-17,Senate,"Passed Senate (39-Y 0-N)",39,0,0,1,40
1904805,1564883,2025-02-03,House,"Read third time and passed House (98-Y 1-N)",98,1,0,1,100
1904816,1472650,2025-01-21,House,"Subcommittee recommends reporting (8-Y 0-N)",8,0,0,1,9
1904816,1473589,2025-01-23,House,"Reported from Transportation (21-Y 0-N)",21,0,0,1,22
1904816,1476376,2025-01-29,House,"Read third time and passed House (97-Y 0-N)",97,0,0,3,100
1904816,1483716,2025-02-06,Senate,"Reported from Transportation (8-Y 6-N)",8,6,0,1,15
1904816,1485926,2025-02-10,Senate,"Constitutional reading dispensed (on 2nd reading) (39-Y 0-N)",39,0,0,1,40
1904816,1489660,2025-02-12,Senate,"Defeated by Senate (12-Y 25-N)",12,25,0,3,40
1904816,1489661,2025-02-12,Senate,"Reconsideration of defeated action agreed to by Senate (38-Y 0-N)",38,0,0,2,40
1904816,1490220,2025-02-13,Senate,"Defeated by Senate (18-Y 19-N 1-A)",18,19,1,2,40
1904816,1490221,2025-02-13,Senate,"Reconsideration of defeated action agreed to by Senate (40-Y 0-N)",40,0,0,0,40
1904816,1490222,2025-02-13,Senate,"Passed Senate (20-Y 19-N)",20,19,0,1,40
1904816,1490223,2025-02-13,Senate,"Reconsideration of Senate passage agreed to by Senate (39-Y 0-N)",39,0,0,1,40
1904842,1473945,2025-01-23,House,"Subcommittee recommends reporting and referring to Appropriations (8-Y 0-N)",8,0,0,1,9
1904842,1475638,2025-01-28,House,"Reported from Health and Human Services and referred to Appropriations (21-Y 0-N)",21,0,0,1,22
1904842,1476598,2025-01-29,House,"Subcommittee recommends reporting (6-Y 0-N)",6,0,0,3,9
1904842,1478293,2025-01-31,House,"Reported from Appropriations (22-Y 0-N)",22,0,0,0,22
1904842,1482182,2025-02-04,House,"Read third time and passed House (97-Y 0-N)",97,0,0,3,100
1904842,1482183,2025-02-04,House,"Passed House (99-Y 0-N)",99,0,0,1,100
1904842,1489690,2025-02-13,Senate,"Reported from Education and Health and rereferred to Finance and Appropriations (15-Y 0-N)",15,0,0,0,15
1904842,1492113,2025-02-17,Senate,"Passed by indefinitely in Finance and Appropriations (14-Y 0-N)",14,0,0,1,15
1904855,1475645,2025-01-28,House,"Subcommittee recommends reporting with amendment(s) (6-Y 2-N)",6,2,0,1,9
1904855,1477666,2025-01-30,House,"Reported from General Laws with amendment(s) (21-Y 0-N)",21,0,0,1,22
1904855,1480740,2025-02-04,House,"Read third time and passed House (97-Y 0-N)",97,0,0,3,100
1904855,1480741,2025-02-04,House,"Passed House (99-Y 0-N)",99,0,0,1,100
1904855,1488121,2025-02-12,Senate,"Reported from General Laws and Technology (15-Y 0-N)",15,0,0,0,15
1904855,1490268,2025-02-14,Senate,"Constitutional reading dispensed (on 2nd reading) (36-Y 0-N)",36,0,0,4,40
1904855,1490959,2025-02-17,Senate,"Passed Senate with substitute (39-Y 0-N)",39,0,0,1,40
1904868,1472123,2025-01-17,House,"Subcommittee recommends laying on the table (5-Y 3-N)",5,3,0,1,9
1904881,1474182,2025-01-24,House,"Subcommittee recommends laying on the table (5-Y 3-N)",5,3,0,1,9
1904894,1472386,2025-01-20,House,"Subcommittee recommends reporting and referred to Appropriations (10-Y 0-N)",10,0,0,1,11
1904894,1472927,2025-01-22,House,"Reported from Education and referred to Appropriations (22-Y 0-N)",22,0,0,0,22
1904894,1478174,2025-01-31,House,"Reported from Appropriations with amendment(s) (22-Y 0-N)",22,0,0,0,22
1904894,1480601,2025-02-04,House,"Read third time and passed House (97-Y 0-N)",97,0,0,3,100
1904894,1480602,2025-02-04,House,"Passed House (99-Y 0-N)",99,0,0,1,100
1904894,1489521,2025-02-13,Senate,"Reported from Education and Health (15-Y 0-N)",15,0,0,0,15
1904894,1490963,2025-02-17,Senate,"Constitutional reading dispensed (on 2nd reading)",39,0,0,1,40
1904894,1492257,2025-02-18,Senate,"Passed Senate (40-Y 0-N)",40,0,0,0,40
1904894,1536639,2025-04-02,House,"Passed by for the day (47-Y 46-N)",47,46,0,7,100
1904906,1472884,2025-01-21,House,"Subcommittee recommends reporting and referred to Appropriations (8-Y 0-N)",8,0,0,1,9
1904906,1474096,2025-01-23,House,"Reported from General Laws and referred to Appropriations (21-Y 0-N)",21,0,0,1,22
1904906,1475180,2025-01-27,House,"Subcommittee recommends reporting (8-Y 0-N)",8,0,0,1,9
1904906,1476769,2025-01-29,House,"Reported from Appropriations (20-Y 1-N)",20,1,0,1,22
1904906,1482702,2025-02-04,House,"Read third time and passed House (97-Y 2-N)",97,2,0,1,100
1904906,1488214,2025-02-12,Senate,"Reported from General Laws and Technology and rereferred to Finance and Appropriations (15-Y 0-N)",15,0,0,0,15
1904906,1492548,2025-02-17,Senate,"Reported from Finance and Appropriations (14-Y 0-N)",14,0,0,1,15
1904906,1493755,2025-02-19,Senate,"Constitutional reading dispensed (on 2nd reading) (40-Y 0-N)",40,0,0,0,40
1904906,1495433,2025-02-20,Senate,"Passed Senate (39-Y 0-N)",39,0,0,1,40
1904906,1495434,2025-02-20,Senate,"Reconsideration of Senate passage agreed to by Senate (39-Y 0-N)",39,0,0,1,40
1904906,1495435,2025-02-20,Senate,"Passed Senate (39-Y 0-N)",39,0,0,1,40
1904919,1472449,2025-01-20,House,"Subcommittee recommends laying on the table (6-Y 4-N)",6,4,0,1,11
1904945,1477099,2025-01-30,House,"Subcommittee recommends laying on the table (5-Y 3-N)",5,3,0,1,9
1904958,1472373,2025-01-20,House,"Subcommittee recommends reporting with substitute (10-Y 0-N)",10,0,0,1,11
1904958,1472987,2025-01-22,House,"Reported from Education with substitute (22-Y 0-N)",22,0,0,0,22
1904958,1476736,2025-01-28,House,"Read third time and passed House (98-Y 1-N)",98,1,0,1,100
1904958,1489552,2025-02-13,Senate,"Reported from Education and Health and rereferred to Finance and Appropriations (15-Y 0-N)",15,0,0,0,15
1904958,1490333,2025-02-14,Senate,"Reported from Finance and Appropriations with substitute (14-Y 0-N)",14,0,0,1,15
1904958,1491420,2025-02-17,Senate,"Constitutional reading dispensed (on 2nd reading) (39-Y 0-N)",39,0,0,1,40
1904958,1493409,2025-02-18,Senate,"Passed Senate with substitute (40-Y 0-N)",40,0,0,0,40
1904958,1493410,2025-02-19,House,"Senate substitute agreed to by House (96-Y 0-N)",96,0,0,4,100
1904971,1477625,2025-01-30,House,"Subcommittee recommends reporting with substitute (6-Y 2-N)",6,2,0,1,9
1904971,1477713,2025-01-30,House,"Reported from General Laws with substitute (14-Y 7-N)",14,7,0,1,22
1904971,1480829,2025-02-04,House,"Read third time and passed House (52-Y 45-N)",52,45,0,3,100
1904971,1488189,2025-02-12,Senate,"Reported from General Laws and Technology with substitute (9-Y 6-N)",9,6,0,0,15
1904971,1490247,2025-02-14,Senate,"Constitutional reading dispensed (on 2nd reading) (36-Y 0-N)",36,0,0,4,40
1904971,1492366,2025-02-18,Senate,"Passed Senate with substitute (21-Y 19-N)",21,19,0,0,40
1904971,1495367,2025-02-19,House,"Senate substitute agreed to by House (52-Y 45-N)",52,45,0,3,100
1904971,1535366,2025-04-02,House,"House concurred in Governor's recommendation (84-Y 12-N)",84,12,0,4,100
1904971,1535367,2025-04-02,Senate,"Senate concurred in Governor's recommendation (35-Y 5-N)",35,5,0,0,40
1904984,1473865,2025-01-23,House,"Subcommittee recommends laying on the table (8-Y 0-N)",8,0,0,3,11
1904996,1475167,2025-01-27,House,"Subcommittee recommends reporting with substitute (8-Y 0-N)",8,0,0,1,9
1904996,1476970,2025-01-29,House,"Reported from Courts of Justice with substitute (22-Y 0-N)",22,0,0,0,22
1904996,1479685,2025-02-04,House,"Read third time and passed House (97-Y 0-N)",97,0,0,3,100
1904996,1479686,2025-02-04,House,"Passed House (99-Y 0-N)",99,0,0,1,100
1904996,1488588,2025-02-12,Senate,"Reported from Courts of Justice with amendments (15-Y 0-N)",15,0,0,0,15
1904996,1490459,2025-02-14,Senate,"Constitutional reading dispensed (on 2nd reading) (36-Y 0-N)",36,0,0,4,40
1904996,1491498,2025-02-17,Senate,"Passed Senate with amendments (39-Y 0-N)",39,0,0,1,40
1904996,1492673,2025-02-18,House,"Senate Amendments agreed to by House (97-Y 0-N)",97,0,0,3,100
1905009,1472892,2025-01-22,House,"Subcommittee recommends reporting and referred to Appropriations (8-Y 0-N)",8,0,0,1,9
1905009,1474212,2025-01-24,House,"Reported from Privileges and Elections (21-Y 0-N)",21,0,0,1,22
1905009,1478089,2025-01-30,House,"Read third time and passed House (96-Y 0-N)",96,0,0,4,100
1905009,1486159,2025-02-11,Senate,"Reported from Privileges and Elections and rereferred to Finance and Appropriations (15-Y 0-N)",15,0,0,0,15
1905009,1492091,2025-02-17,Senate,"Passed by indefinitely in Finance and Appropriations (8-Y 6-N)",8,6,0,1,15
1905022,1474285,2025-01-24,House,"Subcommittee recommends laying on the table (5-Y 3-N)",5,3,0,1,9
1905035,1473944,2025-01-23,House,"Subcommittee recommends reporting (8-Y 0-N)",8,0,0,1,9
1905035,1475910,2025-01-28,House,"Reported from General Laws (22-Y 0-N)",22,0,0,0,22
1905035,1479630,2025-02-03,House,"Read third time and passed House (98-Y 0-N)",98,0,0,2,100
1905035,1479631,2025-02-03,House,"Read third time and passed House (99-Y 0-N)",99,0,0,1,100
1905035,1488055,2025-02-12,Senate,"Reported from General Laws and Technology and rereferred to Finance and Appropriations (14-Y 0-N)",14,0,0,1,15
1905035,1492153,2025-02-17,Senate,"Reported from Finance and Appropriations with substitute (14-Y 0-N)",14,0,0,1,15
1905035,1493611,2025-02-19,Senate,"Constitutional reading dispensed (on 2nd reading) (40-Y 0-N)",40,0,0,0,40
1905035,1496315,2025-02-20,Senate,"Passed Senate with substitute (39-Y 0-N)",39,0,0,1,40
1905035,1496316,2025-02-20,Senate,"Reconsideration of Senate passage agreed to by Senate (39-Y 0-N)",39,0,0,1,40
1905035,1496317,2025-02-20,Senate,"Passed Senate with substitute (39-Y 0-N)",39,0,0,1,40
1905035,1496783,2025-02-20,House,"Senate substitute agreed to by House (96-Y 0-N)",96,0,0,4,100
1905035,1536426,2025-04-02,House,"Passed by for the day (47-Y 46-N)",47,46,0,7,100
1905048,1473371,2025-01-22,House,"Subcommittee recommends laying on the table (5-Y 2-N)",5,2,0,2,9
1905060,1474316,2025-01-24,House,"Subcommittee recommends reporting and referring to Appropriations (8-Y 0-N)",8,0,0,1,9
1905060,1477028,2025-01-29,House,"Reported from Courts of Justice and referred to Appropriations (21-Y 0-N)",21,0,0,1,22
1905060,1478501,2025-01-31,House,"Reported from Appropriations (22-Y 0-N)",22,0,0,0,22
1905060,1482744,2025-02-04,House,"Read third time and passed House (97-Y 0-N)",97,0,0,3,100
1905060,1482745,2025-02-04,House,"Passed House (99-Y 0-N)",99,0,0,1,100
1905060,1488586,2025-02-12,Senate,"Reported from Courts of Justice and rereferred to Finance and Appropriations (13-Y 0-N)",13,0,0,2,15
1905060,1492110,2025-02-17,Senate,"Reported from Finance and Appropriations (14-Y 0-N)",14,0,0,1,15
1905060,1494021,2025-02-19,Senate,"Constitutional reading dispensed (on 2nd reading) (40-Y 0-N)",40,0,0,0,40
1905060,1495726,2025-02-20,Senate,"Passed Senate (39-Y 0-N)",39,0,0,1,40
1905060,1495727,2025-02-20,Senate,"Reconsideration of Senate passage agreed to by Senate (39-Y 0-N)",39,0,0,1,40
1905060,1495728,2025-02-20,Senate,"Passed Senate (39-Y 0-N)",39,0,0,1,40
1905073,1472577,2025-01-21,House,"Subcommittee recommends striking from the docket (8-Y 0-N)",8,0,0,1,9
1905086,1472380,2025-01-20,House,"Subcommittee recommends reporting with substitute (10-Y 0-N)",10,0,0,1,11
1905086,1472998,2025-01-22,House,"Reported from Education with substitute (22-Y 0-N)",22,0,0,0,22
1905086,1477870,2025-01-28,House,"Read third time and passed House (99-Y 0-N)",99,0,0,1,100
1905086,1483020,2025-02-06,Senate,"Reported from Education and Health and rereferred to Finance and Appropriations (14-Y 0-N)",14,0,0,1,15
1905086,1486596,2025-02-11,Senate,"Reported from Finance and Appropriations (13-Y 0-N)",13,0,0,2,15
1905086,1486597,2025-02-11,Senate,"Constitutional reading dispensed (on 2nd reading) (40-Y 0-N)",40,0,0,0,40
1905086,1488168,2025-02-12,Senate,"Passed Senate (39-Y 0-N)",39,0,0,1,40
1905086,1535539,2025-04-02,House,"VOTE: Pass by for the day - Adoption (47-Y 46-N)",47,46,0,7,100
1905098,1472764,2025-01-21,House,"Subcommittee recommends reporting with substitute and referred to Appropriations (6-Y 4-N)",6,4,0,1,11
1905098,1474009,2025-01-23,House,"Reported from Labor and Commerce with substitute and referred to Appropriations (12-Y 10-N)",12,10,0,0,22
1905098,1475034,2025-01-27,House,"Subcommittee recommends reporting (6-Y 2-N)",6,2,0,1,9
1905098,1476630,2025-01-29,House,"Reported from Appropriations (17-Y 4-N)",17,4,0,1,22
1905098,1482226,2025-02-04,House,"Read third time and passed House (56-Y 43-N)",56,43,0,1,100
1905098,1485316,2025-02-10,Senate,"Reported from Commerce and Labor with amendment and rereferred to Finance and Appropriations (9-Y 6-N)",9,6,0,0,15
1905098,1490109,2025-02-14,Senate,"Reported from Finance and Appropriations with amendment (10-Y 4-N)",10,4,0,1,15
1905098,1492032,2025-02-17,Senate,"Constitutional reading dispensed (on 2nd reading) (39-Y 0-N)",39,0,0,1,40
1905098,1495817,2025-02-19,Senate,"Passed Senate with amendments (23-Y 17-N)",23,17,0,0,40
1905098,1496746,2025-02-20,House,"Senate Amendments agreed to by House (56-Y 42-N)",56,42,0,2,100
1905111,1474134,2025-01-23,House,"Subcommittee recommends reporting (5-Y 3-N)",5,3,0,1,9
1905111,1476096,2025-01-28,House,"Reported from Labor and Commerce and referred to Appropriations (12-Y 10-N)",12,10,0,0,22
1905111,1476727,2025-01-29,House,"Subcommittee recommends laying on the table (6-Y 2-N)",6,2,0,1,9
1905124,1471896,2025-01-16,House,"Subcommittee recommends reporting (8-Y 0-N)",8,0,0,1,9
1905124,1472146,2025-01-17,House,"Reported from Counties, Cities and Towns (21-Y 1-N)",21,1,0,0,22
1905124,1473539,2025-01-23,House,"Read third time and passed House (86-Y 11-N)",86,11,0,3,100
1905124,1484656,2025-02-10,Senate,"Reported from Local Government (15-Y 0-N)",15,0,0,0,15
1905124,1485914,2025-02-11,Senate,"Constitutional reading dispensed (on 2nd reading) (40-Y 0-N)",40,0,0,0,40
1905124,1487684,2025-02-12,Senate,"Passed Senate (39-Y 0-N)",39,0,0,1,40
1905137,1473175,2025-01-22,House,"Subcommittee recommends laying on the table (5-Y 2-N)",5,2,0,2,9
1905163,1474138,2025-01-23,House,"Subcommittee recommends reporting with amendment(s) and referring to Appropriations (8-Y 0-N)",8,0,0,1,9
1905163,1476013,2025-01-28,House,"Reported from General Laws with amendment(s) and referred to Appropriations (20-Y 2-N)",20,2,0,0,22
1905163,1476414,2025-01-29,House,"Subcommittee recommends reporting (7-Y 1-N)",7,1,0,1,9
1905163,1476977,2025-01-29,House,"Reported from Appropriations (15-Y 6-N)",15,6,0,1,22
1905163,1482135,2025-02-04,House,"Read third time and passed House (70-Y 29-N)",70,29,0,1,100
1905163,1488184,2025-02-12,Senate,"Reported from General Laws and Technology and rereferred to Finance and Appropriations (15-Y 0-N)",15,0,0,0,15
1905163,1492543,2025-02-17,Senate,"Passed by indefinitely in Finance and Appropriations (13-Y 0-N 1-A)",13,0,1,1,15
1905176,1475062,2025-01-27,House,"Subcommittee recommends reporting with amendment(s) (8-Y 0-N)",8,0,0,1,9
1905176,1476488,2025-01-29,House,"Reported from Education with amendment(s) (16-Y 6-N)",16,6,0,0,22
1905176,1482695,2025-02-04,House,"Read third time and passed House (81-Y 18-N)",81,18,0,1,100
1905176,1489689,2025-02-13,Senate,"Reported from Education and Health with amendments and rereferred to Finance and Appropriations (15-Y 0-N)",15,0,0,0,15
1905176,1492393,2025-02-17,Senate,"Reported from Finance and Appropriations with substitute (14-Y 0-N)",14,0,0,1,15
1905176,1493840,2025-02-19,Senate,"Constitutional reading dispensed (on 2nd reading) (40-Y 0-N)",40,0,0,0,40
1905176,1495882,2025-02-20,House,"Senate substitute rejected by House (0-Y 96-N)",0,96,0,4,100
1905176,1495883,2025-02-20,Senate,"Senate insisted on substitute (38-Y 0-N)",38,0,0,2,40
1905176,1496324,2025-02-20,Senate,"Passed Senate with substitute (39-Y 0-N)",39,0,0,1,40
1905176,1496325,2025-02-20,Senate,"Reconsideration of Senate passage agreed to by Senate (39-Y 0-N)",39,0,0,1,40
1905176,1496326,2025-02-20,Senate,"Passed Senate with substitute (39-Y 0-N)",39,0,0,1,40
1905176,1497152,2025-02-21,Senate,"Conference report agreed to by Senate (39-Y 0-N)",39,0,0,1,40
1905176,1503777,2025-02-21,House,"Conference report agreed to by House (81-Y 13-N)",81,13,0,6,100
1905176,1536546,2025-04-02,House,"Passed by for the day (47-Y 46-N)",47,46,0,7,100
1905201,1474154,2025-01-23,House,"Subcommittee recommends reporting (7-Y 1-N)",7,1,0,1,9
1905201,1476021,2025-01-28,House,"Reported from General Laws (21-Y 1-N)",21,1,0,0,22
1905201,1478990,2025-02-03,House,"Read third time and passed House (98-Y 1-N)",98,1,0,1,100
1905201,1488235,2025-02-12,Senate,"Reported from General Laws and Technology (15-Y 0-N)",15,0,0,0,15
1905201,1490017,2025-02-14,Senate,"Constitutional reading dispensed (on 2nd reading) (36-Y 0-N)",36,0,0,4,40
1905201,1491815,2025-02-17,Senate,"Passed Senate (39-Y 0-N)",39,0,0,1,40
1905214,1471883,2025-01-16,House,"Subcommittee recommends reporting (6-Y 1-N)",6,1,0,2,9
1905214,1472151,2025-01-17,House,"Reported from Counties, Cities and Towns (22-Y 0-N)",22,0,0,0,22
1905214,1473636,2025-01-23,House,"Read third time and passed House (86-Y 9-N)",86,9,0,5,100
1905214,1485053,2025-02-10,Senate,"Reported from Local Government (15-Y 0-N)",15,0,0,0,15
1905214,1486446,2025-02-11,Senate,"Constitutional reading dispensed (on 2nd reading) (40-Y 0-N)",40,0,0,0,40
1905214,1487745,2025-02-12,Senate,"Passed Senate (39-Y 0-N)",39,0,0,1,40
1905227,1474319,2025-01-24,House,"Subcommittee recommends laying on the table (5-Y 3-N)",5,3,0,1,9
1905240,1477702,2025-01-30,House,"Subcommittee recommends reporting with substitute (8-Y 0-N)",8,0,0,1,9
1905240,1477703,2025-01-30,House,"Reported from General Laws with substitute (21-Y 0-N)",21,0,0,1,22
1905240,1480010,2025-02-04,House,"Read third time and passed House (97-Y 0-N)",97,0,0,3,100
1905240,1480011,2025-02-04,House,"Passed House (99-Y 0-N)",99,0,0,1,100
1905240,1488180,2025-02-12,Senate,"Reported from General Laws and Technology with amendments and rereferred to Finance and Appropriations (15-Y 0-N)",15,0,0,0,15
1905240,1492546,2025-02-17,Senate,"Reported from Finance and Appropriations (14-Y 0-N)",14,0,0,1,15
1905240,1494053,2025-02-19,Senate,"Constitutional reading dispensed (on 2nd reading) (40-Y 0-N)",40,0,0,0,40
1905240,1495291,2025-02-20,Senate,"Passed Senate with amendments (39-Y 0-N)",39,0,0,1,40
1905240,1495292,2025-02-20,Senate,"Reconsideration of Senate passage agreed to by Senate (39-Y 0-N)",39,0,0,1,40
1905240,1495293,2025-02-20,Senate,"Passed Senate with amendments (39-Y 0-N)",39,0,0,1,40
1905240,1496931,2025-02-20,House,"Senate Amendments agreed to by House (94-Y 1-N)",94,1,0,5,100
1905240,1496932,2025-02-20,House,"Senate Amendments agreed to by House (94-Y 2-N)",94,2,0,4,100
1905253,1472478,2025-01-20,House,"Subcommittee recommends passing by indefinitely (7-Y 1-N)",7,1,0,1,9
1905323,1476707,2025-01-29,House,"Subcommittee failed to recommend reporting (3-Y 5-N)",3,5,0,1,9
1905325,1475655,2025-01-28,House,"Subcommittee recommends reporting with substitute (8-Y 0-N)",8,0,0,1,9
1905325,1477203,2025-01-30,House,"Reported from Transportation with substitute (22-Y 0-N)",22,0,0,0,22
1905325,1480096,2025-02-04,House,"Read third time and passed House (97-Y 0-N)",97,0,0,3,100
1905325,1480097,2025-02-04,House,"Passed House (99-Y 0-N)",99,0,0,1,100
1905325,1489599,2025-02-13,Senate,"Reported from Transportation (15-Y 0-N)",15,0,0,0,15
1905325,1491515,2025-02-17,Senate,"Constitutional reading dispensed (on 2nd reading)",39,0,0,1,40
1905325,1492729,2025-02-18,Senate,"Passed Senate (40-Y 0-N)",40,0,0,0,40
1905326,1477426,2025-01-30,House,"Subcommittee recommends reporting (7-Y 1-N)",7,1,0,1,9
1905326,1477427,2025-01-30,House,"Reported from Health and Human Services (19-Y 1-N 1-A)",19,1,1,1,22
1905326,1480647,2025-02-04,House,"Read third time and passed House (96-Y 0-N 1-A)",96,0,1,3,100
1905326,1489145,2025-02-13,Senate,"Reported from Education and Health (15-Y 0-N)",15,0,0,0,15
1905326,1491552,2025-02-17,Senate,"Constitutional reading dispensed (on 2nd reading)",39,0,0,1,40
1905326,1492797,2025-02-18,Senate,"Passed Senate (40-Y 0-N)",40,0,0,0,40
1905328,1474030,2025-01-23,House,"Subcommittee recommends passing by indefinitely (4-Y 3-N)",4,3,0,2,9
1905329,1472369,2025-01-20,House,"Subcommittee recommends reporting (8-Y 0-N)",8,0,0,1,9
1905329,1474730,2025-01-24,House,"Reported from Courts of Justice with amendment(s) (22-Y 0-N)",22,0,0,0,22
1905329,1478135,2025-01-30,House,"Read third time and passed House (96-Y 0-N)",96,0,0,4,100
1905329,1488224,2025-02-12,Senate,"Reported from Courts of Justice (15-Y 0-N)",15,0,0,0,15
1905329,1490550,2025-02-14,Senate,"Constitutional reading dispensed (on 2nd reading) (36-Y 0-N)",36,0,0,4,40
1905329,1491508,2025-02-17,Senate,"Passed Senate (39-Y 0-N)",39,0,0,1,40
1905332,1473885,2025-01-23,House,"Subcommittee recommends passing by indefinitely (5-Y 3-N)",5,3,0,3,11
1905334,1475027,2025-01-27,House,"Subcommittee recommends laying on the table (8-Y 2-N)",8,2,0,1,11
1905335,1476954,2025-01-29,House,"Subcommittee recommends laying on the table (5-Y 1-N)",5,1,0,3,9
1905344,1477244,2025-01-30,House,"Subcommittee recommends striking from the docket (6-Y 0-N)",6,0,0,1,7
1905347,1473227,2025-01-22,House,"Subcommittee recommends laying on the table (7-Y 3-N)",7,3,0,1,11
1905354,1472411,2025-01-20,House,"Subcommittee recommends striking from the docket (8-Y 0-N)",8,0,0,1,9
1905357,1473298,2025-01-22,House,"Subcommittee recommends reporting with amendment(s) and referring to Appropriations (10-Y 0-N)",10,0,0,1,11
1905357,1476929,2025-01-29,House,"Reported from Agriculture, Chesapeake and Natural Resources with amendment(s) and referred to Appropriations (22-Y 0-N)",22,0,0,0,22
1905357,1478458,2025-01-31,House,"Reported from Appropriations (22-Y 0-N)",22,0,0,0,22
1905357,1480850,2025-02-04,House,"Read third time and passed House (97-Y 0-N)",97,0,0,3,100
1905357,1480851,2025-02-04,House,"Passed House (99-Y 0-N)",99,0,0,1,100
1905357,1487005,2025-02-11,Senate,"Reported from Agriculture, Conservation and Natural Resources and rereferred to Finance and Appropriations (12-Y 0-N 3-A)",12,0,3,0,15
1905357,1491818,2025-02-17,Senate,"Reported from Finance and Appropriations with substitute (12-Y 0-N 2-A)",12,0,2,1,15
1905357,1494123,2025-02-19,Senate,"Constitutional reading dispensed (on 2nd reading) (40-Y 0-N)",40,0,0,0,40
1905360,1478005,2025-01-31,House,"Subcommittee recommends laying on the table (5-Y 3-N)",5,3,0,1,9
1905362,1478513,2025-01-31,House,"Subcommittee recommends reporting with substitute (8-Y 0-N)",8,0,0,1,9
1905362,1478514,2025-01-31,House,"Reported from Courts of Justice (20-Y 0-N)",20,0,0,2,22
1905362,1479707,2025-02-04,House,"Read third time and passed House (97-Y 0-N)",97,0,0,3,100
1905362,1479708,2025-02-04,House,"Passed House (99-Y 0-N)",99,0,0,1,100
1905362,1485258,2025-02-10,Senate,"Reported from Courts of Justice and rereferred to Finance and Appropriations (12-Y 0-N)",12,0,0,3,15
1905362,1488158,2025-02-12,Senate,"Reported from Finance and Appropriations (15-Y 0-N)",15,0,0,0,15
1905362,1489177,2025-02-13,Senate,"Constitutional reading dispensed (on 2nd reading) (40-Y 0-N)",40,0,0,0,40
1905362,1490257,2025-02-14,Senate,"Passed Senate (36-Y 0-N)",36,0,0,4,40
1905363,1474142,2025-01-23,House,"Subcommittee recommends reporting (8-Y 0-N)",8,0,0,1,9
1905363,1476005,2025-01-28,House,"Reported from Health and Human Services (21-Y 0-N)",21,0,0,1,22
1905363,1479573,2025-02-03,House,"Read third time and passed House (98-Y 0-N)",98,0,0,2,100
1905363,1479574,2025-02-03,House,"Read third time and passed House (99-Y 0-N)",99,0,0,1,100
1905363,1490293,2025-02-14,Senate,"Reported from Rehabilitation and Social Services (14-Y 0-N)",14,0,0,1,15
1905363,1491651,2025-02-17,Senate,"Constitutional reading dispensed (on 2nd reading)",39,0,0,1,40
1905363,1494406,2025-02-18,Senate,"Passed Senate (40-Y 0-N)",40,0,0,0,40
1905367,1473950,2025-01-23,House,"Subcommittee recommends laying on the table (7-Y 1-N)",7,1,0,1,9
1905370,1475449,2025-01-28,House,"Subcommittee recommends reporting (8-Y 0-N)",8,0,0,1,9
1905370,1477260,2025-01-30,House,"Reported from Health and Human Services (21-Y 0-N)",21,0,0,1,22
1905370,1480738,2025-02-04,House,"Read third time and passed House (97-Y 0-N)",97,0,0,3,100
1905370,1480739,2025-02-04,House,"Passed House (99-Y 0-N)",99,0,0,1,100
1905370,1489525,2025-02-13,Senate,"Reported from Education and Health (13-Y 0-N)",13,0,0,2,15
1905370,1491049,2025-02-17,Senate,"Constitutional reading dispensed (on 2nd reading)",39,0,0,1,40
1905370,1492342,2025-02-18,Senate,"Passed Senate (40-Y 0-N)",40,0,0,0,40
1905373,1472848,2025-01-21,House,"Subcommittee recommends laying on the table (5-Y 3-N)",5,3,0,1,9
1905374,1472867,2025-01-21,House,"Subcommittee recommends reporting with substitute (6-Y 1-N)",6,1,0,2,9
1905374,1474094,2025-01-23,House,"Reported from General Laws with substitute (21-Y 0-N)",21,0,0,1,22
1905374,1476770,2025-01-29,House,"Read third time and passed House (96-Y 1-N)",96,1,0,3,100
1905374,1482701,2025-02-05,Senate,"Reported from General Laws and Technology and rereferred to Finance and Appropriations (15-Y 0-N)",15,0,0,0,15
1905374,1486238,2025-02-11,Senate,"Passed by indefinitely in Finance and Appropriations (11-Y 4-N)",11,4,0,0,15
1905380,1475030,2025-01-27,House,"Subcommittee recommends reporting (5-Y 3-N)",5,3,0,1,9
1905380,1478126,2025-01-31,House,"Reported from Privileges and Elections with substitute (12-Y 9-N)",12,9,0,1,22
1905380,1482412,2025-02-04,House,"Read third time and passed House (51-Y 47-N)",51,47,0,2,100
1905380,1486354,2025-02-11,Senate,"Reported from Privileges and Elections (8-Y 7-N)",8,7,0,0,15
1905380,1488966,2025-02-13,Senate,"Constitutional reading dispensed (on 2nd reading) (40-Y 0-N)",40,0,0,0,40
1905380,1490245,2025-02-14,Senate,"Passed Senate (21-Y 14-N)",21,14,0,5,40
1905382,1472902,2025-01-22,House,"Subcommittee recommends reporting with substitute (8-Y 0-N)",8,0,0,1,9
1905382,1475080,2025-01-27,House,"Reported from Privileges and Elections with substitute and referred to Appropriations (20-Y 0-N)",20,0,0,2,22
1905382,1478212,2025-01-31,House,"Reported from Appropriations (22-Y 0-N)",22,0,0,0,22
1905382,1480696,2025-02-04,House,"Read third time and passed House (97-Y 0-N)",97,0,0,3,100
1905382,1480697,2025-02-04,House,"Passed House (99-Y 0-N)",99,0,0,1,100
1905382,1486437,2025-02-11,Senate,"Reported from Privileges and Elections and rereferred to Finance and Appropriations (14-Y 1-N)",14,1,0,0,15
1905382,1490172,2025-02-14,Senate,"Reported from Finance and Appropriations (14-Y 0-N)",14,0,0,1,15
1905382,1492160,2025-02-17,Senate,"Constitutional reading dispensed (on 2nd reading) (39-Y 0-N)",39,0,0,1,40
1905382,1493623,2025-02-19,Senate,"Passed Senate (40-Y 0-N)",40,0,0,0,40
1905384,1474026,2025-01-24,House,"Subcommittee recommends reporting with amendment(s) (6-Y 4-N)",6,4,0,1,11
1905384,1475979,2025-01-28,House,"Reported from Labor and Commerce with amendment(s) and referred to Appropriations (17-Y 5-N)",17,5,0,0,22
1905384,1476790,2025-01-29,House,"Subcommittee recommends reporting with amendment(s) (7-Y 1-N)",7,1,0,1,9
1905384,1476791,2025-01-29,House,"Reported from Appropriations with amendment(s) (17-Y 4-N)",17,4,0,1,22
1905384,1480566,2025-02-04,House,"Read third time and passed House (91-Y 8-N)",91,8,0,1,100
1905384,1484937,2025-02-10,Senate,"Reported from Commerce and Labor with amendment and rereferred to Finance and Appropriations (12-Y 2-N 1-A)",12,2,1,0,15
1905384,1492103,2025-02-17,Senate,"Reported from Finance and Appropriations with amendment (10-Y 3-N 1-A)",10,3,1,1,15
1905384,1495212,2025-02-20,Senate,"Passed Senate with amendment (23-Y 15-N 1-A)",23,15,1,1,40
1905384,1495867,2025-02-19,Senate,"Constitutional reading dispensed (on 2nd reading) (40-Y 0-N)",40,0,0,0,40
1905384,1495868,2025-02-20,House,"Senate Amendment agreed to by House (90-Y 6-N)",90,6,0,4,100
1905384,1536594,2025-04-02,House,"House rejected Governor's recommendation (27-Y 69-N)",27,69,0,4,100
1905386,1473131,2025-01-22,House,"Subcommittee recommends reporting (8-Y 0-N)",8,0,0,1,9
1905386,1474336,2025-01-24,House,"Reported from Appropriations (22-Y 0-N)",22,0,0,0,22
1905386,1478331,2025-01-30,House,"Read third time and passed House (88-Y 7-N)",88,7,0,5,100
1905386,1482587,2025-02-05,Senate,"Reported from Finance and Appropriations (13-Y 0-N)",13,0,0,2,15
1905386,1483541,2025-02-06,Senate,"Constitutional reading dispensed (on 2nd reading) (40-Y 0-N)",40,0,0,0,40
1905386,1484069,2025-02-07,Senate,"Passed Senate (39-Y 0-N)",39,0,0,1,40
1905390,1472739,2025-01-21,House,"Subcommittee recommends laying on the table (5-Y 3-N)",5,3,0,1,9
1905392,1472564,2025-01-21,House,"Subcommittee recommends reporting (8-Y 0-N)",8,0,0,1,9
1905392,1472956,2025-01-22,House,"Reported from Education (22-Y 0-N)",22,0,0,0,22
1905392,1476395,2025-01-28,House,"Read third time and passed House (99-Y 0-N)",99,0,0,1,100
1905392,1489722,2025-02-13,Senate,"Reported from Education and Health (15-Y 0-N)",15,0,0,0,15
1905392,1491175,2025-02-17,Senate,"Constitutional reading dispensed (on 2nd reading)",39,0,0,1,40
1905392,1493106,2025-02-18,Senate,"Passed Senate (40-Y 0-N)",40,0,0,0,40
1905394,1472736,2025-01-21,House,"Subcommittee recommends laying on the table (5-Y 3-N)",5,3,0,1,9
1905395,1472529,2025-01-21,House,"Subcommittee recommends reporting (8-Y 0-N)",8,0,0,1,9
1905395,1474677,2025-01-24,House,"Reported from Courts of Justice (22-Y 0-N)",22,0,0,0,22
1905395,1478376,2025-01-30,House,"Read third time and passed House (96-Y 0-N)",96,0,0,4,100
1905395,1485864,2025-02-10,Senate,"Reported from Courts of Justice (13-Y 0-N 1-A)",13,0,1,1,15
1905395,1486785,2025-02-11,Senate,"Constitutional reading dispensed (on 2nd reading) (40-Y 0-N)",40,0,0,0,40
1905395,1488134,2025-02-12,Senate,"Passed Senate (38-Y 0-N)",38,0,0,2,40
1905397,1474918,2025-01-27,House,"Subcommittee recommends laying on the table (5-Y 3-N)",5,3,0,1,9
1905408,1474017,2025-01-24,House,"Subcommittee recommends laying on the table (5-Y 3-N)",5,3,0,3,11
1905414,1472400,2025-01-20,House,"Subcommittee recommends striking from the docket (8-Y 0-N)",8,0,0,1,9
1905418,1472390,2025-01-20,House,"Subcommittee failed to recommend reporting (3-Y 5-N)",3,5,0,1,9
1905426,1473294,2025-01-22,House,"Subcommittee recommends reporting with substitute (8-Y 0-N)",8,0,0,1,9
1905426,1474659,2025-01-24,House,"Reported from Courts of Justice with substitute (22-Y 0-N)",22,0,0,0,22
1905426,1478357,2025-01-30,House,"Read third time and passed House (96-Y 0-N)",96,0,0,4,100
1905426,1490884,2025-02-17,Senate,"Reported from Courts of Justice with amendments (15-Y 0-N)",15,0,0,0,15
1905426,1493244,2025-02-18,Senate,"Constitutional reading dispensed (on 2nd reading) (39-Y 0-N)",39,0,0,1,40
1905426,1495077,2025-02-19,Senate,"Passed Senate with amendments (40-Y 0-N)",40,0,0,0,40
1905426,1496852,2025-02-20,House,"Senate Amendments agreed to by House (96-Y 1-N)",96,1,0,3,100
1905429,1474145,2025-01-23,House,"Subcommittee recommends reporting and referring to Appropriations (5-Y 3-N)",5,3,0,1,9
1905429,1475861,2025-01-28,House,"Reported from Health and Human Services and referred to Appropriations (21-Y 0-N)",21,0,0,1,22
1905430,1474527,2025-01-24,House,"Subcommittee recommends striking from the docket (8-Y 0-N)",8,0,0,1,9
1905432,1477248,2025-01-30,House,"Subcommittee recommends laying on the table (4-Y 2-N)",4,2,0,1,7
1905433,1476229,2025-01-29,House,"Subcommittee failed to recommend reporting (3-Y 5-N)",3,5,0,1,9
1905435,1475803,2025-01-28,House,"Subcommittee recommends reporting with amendment(s) and referring to Appropriations (5-Y 1-N)",5,1,0,2,8
1905435,1477717,2025-01-30,House,"Reported from Labor and Commerce with amendment(s) and referred to Appropriations (15-Y 7-N)",15,7,0,0,22
1905435,1478323,2025-01-31,House,"Reported from Appropriations (18-Y 3-N)",18,3,0,1,22
1905435,1482435,2025-02-04,House,"Read third time and passed House (70-Y 27-N)",70,27,0,3,100
1905435,1485359,2025-02-10,Senate,"Reported from Commerce and Labor and rereferred to Finance and Appropriations (9-Y 6-N)",9,6,0,0,15
1905435,1490175,2025-02-14,Senate,"Reported from Finance and Appropriations with substitute (11-Y 3-N)",11,3,0,1,15
1905435,1492158,2025-02-17,Senate,"Constitutional reading dispensed (on 2nd reading) (39-Y 0-N)",39,0,0,1,40
1905435,1495919,2025-02-19,Senate,"Passed Senate (24-Y 16-N)",24,16,0,0,40
1905435,1536669,2025-04-02,House,"House rejected Governor's recommendation (18-Y 78-N)",18,78,0,4,100
1905435,1536670,2025-04-02,House,"Motion to pass in enrolled form rejected (59-Y 37-N)",59,37,0,4,100
1905438,1476594,2025-01-29,House,"Subcommittee recommends reporting (6-Y 0-N)",6,0,0,3,9
1905438,1477393,2025-01-30,House,"Reported from Transportation (22-Y 0-N)",22,0,0,0,22
1905438,1481186,2025-02-04,House,"Read third time and passed House (97-Y 0-N)",97,0,0,3,100
1905438,1481188,2025-02-04,House,"Passed House (99-Y 0-N)",99,0,0,1,100
1905438,1489680,2025-02-13,Senate,"Reported from Transportation with amendment (13-Y 0-N)",13,0,0,2,15
1905438,1491134,2025-02-17,Senate,"Constitutional reading dispensed (on 2nd reading)",39,0,0,1,40
1905438,1493088,2025-02-18,Senate,"Passed Senate with amendments (40-Y 0-N)",40,0,0,0,40
1905438,1564952,2025-02-19,House,"Senate Amendments agreed to by House",96,0,0,4,100
1905441,1474042,2025-01-24,House,"Subcommittee recommends laying on the table (6-Y 4-N)",6,4,0,1,11
1905443,1475835,2025-01-28,House,"Subcommittee recommends laying on the table (7-Y 0-N)",7,0,0,1,8
1905445,1473556,2025-01-23,House,"Subcommittee recommends striking from the docket (6-Y 0-N)",6,0,0,1,7
1905446,1474682,2025-01-24,House,"Stricken from docket by Courts of Justice (22-Y 0-N)",22,0,0,0,22
1905452,1473492,2025-01-23,House,"Subcommittee recommends reporting (4-Y 2-N)",4,2,0,1,7
1905452,1474217,2025-01-24,House,"Reported from Public Safety (12-Y 10-N)",12,10,0,0,22
1905452,1478463,2025-01-30,House,"Read third time and passed House (50-Y 46-N)",50,46,0,4,100
1905452,1482177,2025-02-05,Senate,"Reported from General Laws and Technology with amendment and rereferred to Finance and Appropriations (14-Y 0-N)",14,0,0,1,15
1905452,1487348,2025-02-12,Senate,"Reported from Finance and Appropriations (15-Y 0-N)",15,0,0,0,15
1905452,1488928,2025-02-13,Senate,"Constitutional reading dispensed (on 2nd reading) (40-Y 0-N)",40,0,0,0,40
1905452,1490215,2025-02-14,Senate,"Passed Senate with amendment (36-Y 0-N)",36,0,0,4,40
1905452,1492310,2025-02-18,House,"Senate Amendment agreed to by House (52-Y 45-N)",52,45,0,3,100
1905452,1536547,2025-04-02,House,"House rejected Governor's recommendation (20-Y 75-N)",20,75,0,5,100
1905457,1474070,2025-01-23,House,"Subcommittee recommends reporting (5-Y 3-N)",5,3,0,1,9
1905457,1476087,2025-01-28,House,"Reported from Labor and Commerce and referred to Appropriations (12-Y 10-N)",12,10,0,0,22
1905457,1476413,2025-01-29,House,"Subcommittee recommends reporting with amendment(s) (5-Y 3-N)",5,3,0,1,9
1905457,1477003,2025-01-29,House,"Reported from Appropriations with amendment(s) (11-Y 10-N)",11,10,0,1,22
1905457,1482797,2025-02-04,House,"Read third time and passed House (51-Y 47-N 1-A)",51,47,1,1,100
1905457,1491664,2025-02-17,Senate,"Reported from Commerce and Labor with amendment (9-Y 6-N)",9,6,0,0,15
1905457,1494291,2025-02-18,Senate,"Constitutional reading dispensed (on 2nd reading) (40-Y 0-N)",40,0,0,0,40
1905457,1494292,2025-02-19,Senate,"Passed Senate with amendment (22-Y 18-N)",22,18,0,0,40
1905457,1495627,2025-02-20,House,"Senate Amendment agreed to by House (50-Y 46-N)",50,46,0,4,100
1905458,1476606,2025-01-29,House,"Subcommittee recommends reporting with amendment(s) (6-Y 0-N)",6,0,0,3,9
1905458,1477187,2025-01-30,House,"Reported from Transportation with amendment(s) (22-Y 0-N)",22,0,0,0,22
1905458,1480502,2025-02-04,House,"Read third time and passed House (97-Y 0-N)",97,0,0,3,100
1905458,1480503,2025-02-04,House,"Passed House (99-Y 0-N)",99,0,0,1,100
1905458,1491170,2025-02-17,Senate,"Reported from Courts of Justice with substitute (9-Y 6-N)",9,6,0,0,15
1905458,1492760,2025-02-18,Senate,"Constitutional reading dispensed (on 2nd reading) (39-Y 0-N)",39,0,0,1,40
1905458,1494246,2025-02-19,Senate,"Committee substitute reconsidered (40-Y 0-N)",40,0,0,0,40
1905458,1495304,2025-02-20,Senate,"Passed Senate (24-Y 15-N)",24,15,0,1,40
1905462,1473397,2025-01-22,House,"Subcommittee recommends laying on the table (5-Y 3-N)",5,3,0,1,9
1905464,1474852,2025-01-27,House,"Subcommittee recommends reporting with amendment(s) and referring to Appropriations (8-Y 0-N)",8,0,0,1,9
1905464,1476732,2025-01-29,House,"Reported from Courts of Justice with amendment(s) and referred to Appropriations (21-Y 0-N)",21,0,0,1,22
1905471,1472905,2025-01-22,House,"Subcommittee recommends reporting with amendment(s) (5-Y 3-N)",5,3,0,1,9
1905471,1478124,2025-01-31,House,"Reported from Counties, Cities and Towns with amendment(s) (11-Y 10-N)",11,10,0,1,22
1905475,1475028,2025-01-27,House,"Subcommittee recommends laying on the table (5-Y 3-N)",5,3,0,1,9
1905479,1475849,2025-01-28,House,"Subcommittee recommends reporting (7-Y 0-N)",7,0,0,1,8
1905479,1477672,2025-01-30,House,"Reported from Labor and Commerce (22-Y 0-N)",22,0,0,0,22
1905479,1482463,2025-02-04,House,"Read third time and passed House (97-Y 0-N)",97,0,0,3,100
1905479,1482464,2025-02-04,House,"Passed House (99-Y 0-N)",99,0,0,1,100
1905479,1485270,2025-02-10,Senate,"Reported from Commerce and Labor (15-Y 0-N)",15,0,0,0,15
1905479,1487677,2025-02-12,Senate,"Constitutional reading dispensed (on 2nd reading) (39-Y 0-N)",39,0,0,1,40
1905479,1490006,2025-02-13,Senate,"Passed Senate (40-Y 0-N)",40,0,0,0,40
1905481,1475641,2025-01-28,House,"Subcommittee recommends reporting with substitute (8-Y 0-N)",8,0,0,1,9
1905481,1477088,2025-01-30,House,"Reported from Transportation with substitute (22-Y 0-N)",22,0,0,0,22
1905481,1482293,2025-02-04,House,"Read third time and passed House (97-Y 0-N)",97,0,0,3,100
1905481,1482294,2025-02-04,House,"Passed House (99-Y 0-N)",99,0,0,1,100
1905481,1489607,2025-02-13,Senate,"Reported from Transportation with amendment (13-Y 0-N 2-A)",13,0,2,0,15
1905481,1491264,2025-02-17,Senate,"Constitutional reading dispensed (on 2nd reading) (39-Y 0-N)",39,0,0,1,40
1905481,1495856,2025-02-20,Senate,"Passed Senate with amendments (33-Y 6-N)",33,6,0,1,40
1905481,1495857,2025-02-20,House,"Senate Amendments agreed to by House (92-Y 3-N)",92,3,0,5,100
1905481,1535547,2025-04-02,House,"House rejected Governor's amendment #1 (45-Y 51-N)",45,51,0,4,100
1905481,1564817,2025-04-02,House,"House rejected Governor's amendments #'s 2-7 (46-Y 50-N)",46,50,0,4,100
1905486,1475291,2025-01-28,House,"Subcommittee recommends reporting (5-Y 3-N)",5,3,0,1,9
1905486,1476346,2025-01-29,House,"Reported from Education (12-Y 10-N)",12,10,0,0,22
1905486,1482404,2025-02-04,House,"Read third time and passed House (52-Y 47-N)",52,47,0,1,100
1905486,1489534,2025-02-13,Senate,"Reported from Education and Health with substitute (9-Y 5-N)",9,5,0,1,15
1905486,1491045,2025-02-17,Senate,"Constitutional reading dispensed (on 1st reading) (39-Y 0-N)",39,0,0,1,40
1905486,1493738,2025-02-19,Senate,"Passed Senate with substitute (21-Y 19-N)",21,19,0,0,40
1905486,1496456,2025-02-20,House,"Senate substitute agreed to by House (51-Y 47-N)",51,47,0,2,100
1905493,1475744,2025-01-28,House,"Subcommittee recommends reporting (8-Y 0-N)",8,0,0,1,9
1905493,1477220,2025-01-30,House,"Reported from Transportation (22-Y 0-N)",22,0,0,0,22
1905493,1480798,2025-02-04,House,"Read third time and passed House (97-Y 0-N)",97,0,0,3,100
1905493,1480799,2025-02-04,House,"Passed House (99-Y 0-N)",99,0,0,1,100
1905493,1489379,2025-02-13,Senate,"Reported from Transportation (15-Y 0-N)",15,0,0,0,15
1905493,1491433,2025-02-17,Senate,"Constitutional reading dispensed (on 2nd reading)",39,0,0,1,40
1905493,1492537,2025-02-18,Senate,"Passed Senate (40-Y 0-N)",40,0,0,0,40
1905495,1478081,2025-01-31,House,"Subcommittee recommends laying on the table (5-Y 3-N)",5,3,0,1,9
1905496,1475296,2025-01-28,House,"Subcommittee recommends reporting (6-Y 2-N)",6,2,0,1,9
1905496,1476173,2025-01-29,House,"Reported from Education (21-Y 1-N)",21,1,0,0,22
1905496,1482707,2025-02-04,House,"Read third time and passed House (98-Y 0-N)",98,0,0,2,100
1905496,1489630,2025-02-13,Senate,"Reported from Education and Health and rereferred to Finance and Appropriations (14-Y 0-N)",14,0,0,1,15
1905496,1492152,2025-02-17,Senate,"Reported from Finance and Appropriations (14-Y 0-N)",14,0,0,1,15
1905496,1495912,2025-02-19,Senate,"Constitutional reading dispensed (on 2nd reading) (40-Y 0-N)",40,0,0,0,40
1905496,1496373,2025-02-20,Senate,"Passed Senate (39-Y 0-N)",39,0,0,1,40
1905496,1496374,2025-02-20,Senate,"Reconsideration of Senate passage agreed to by Senate (39-Y 0-N)",39,0,0,1,40
1905496,1496375,2025-02-20,Senate,"Passed Senate (39-Y 0-N)",39,0,0,1,40
1905497,1474151,2025-01-23,House,"Subcommittee recommends reporting with substitute (8-Y 0-N)",8,0,0,1,9
1905497,1476012,2025-01-28,House,"Reported from General Laws with substitute (22-Y 0-N)",22,0,0,0,22
1905497,1479415,2025-02-03,House,"Read third time and passed House (98-Y 0-N)",98,0,0,2,100
1905497,1479416,2025-02-03,House,"Read third time and passed House (99-Y 0-N)",99,0,0,1,100
1905497,1488136,2025-02-12,Senate,"Reported from General Laws and Technology with amendments (14-Y 0-N)",14,0,0,1,15
1905497,1490497,2025-02-14,Senate,"Constitutional reading dispensed (on 2nd reading) (36-Y 0-N)",36,0,0,4,40
1905497,1491069,2025-02-17,Senate,"Passed Senate with amendments (39-Y 0-N)",39,0,0,1,40
1905497,1491795,2025-02-18,House,"Senate Amendments agreed to by House (97-Y 0-N)",97,0,0,3,100
1905500,1477673,2025-01-30,House,"Subcommittee recommends laying on the table (5-Y 0-N)",5,0,0,1,6
1905501,1474873,2025-01-27,House,"Subcommittee recommends reporting with amendment(s) and referring to Appropriations (5-Y 3-N)",5,3,0,0,8
1905501,1476539,2025-01-29,House,"Reported from Finance with amendment(s) and referred to Appropriations (12-Y 10-N)",12,10,0,0,22
1905506,1477027,2025-01-29,House,"Reported from Courts of Justice with substitute and referred to Appropriations (22-Y 0-N)",22,0,0,0,22
1905506,1478511,2025-01-31,House,"Reported from Appropriations (22-Y 0-N)",22,0,0,0,22
1905506,1480775,2025-02-04,House,"Read third time and passed House (97-Y 0-N)",97,0,0,3,100
1905506,1480776,2025-02-04,House,"Passed House (99-Y 0-N)",99,0,0,1,100
1905506,1488218,2025-02-12,Senate,"Reported from Courts of Justice (15-Y 0-N)",15,0,0,0,15
1905506,1490154,2025-02-14,Senate,"Constitutional reading dispensed (on 2nd reading) (36-Y 0-N)",36,0,0,4,40
1905506,1491365,2025-02-17,Senate,"Passed Senate (39-Y 0-N)",39,0,0,1,40
1905507,1476047,2025-01-28,House,"Subcommittee recommends laying on the table (5-Y 3-N)",5,3,0,1,9
1905511,1473972,2025-01-23,House,"Subcommittee recommends reporting with amendment(s) (5-Y 3-N)",5,3,0,1,9
1905511,1475627,2025-01-28,House,"Reported from General Laws with substitute (12-Y 10-N)",12,10,0,0,22
1905511,1479796,2025-02-03,House,"Read third time and passed House (51-Y 48-N)",51,48,0,1,100
1905511,1488227,2025-02-12,Senate,"Reported from General Laws and Technology (15-Y 0-N)",15,0,0,0,15
1905511,1490305,2025-02-14,Senate,"Constitutional reading dispensed (on 2nd reading) (36-Y 0-N)",36,0,0,4,40
1905511,1491162,2025-02-17,Senate,"Passed Senate (38-Y 1-N)",38,1,0,1,40
1905511,1536765,2025-04-02,House,"House concurred in Governor's recommendation (90-Y 4-N)",90,4,0,6,100
1905511,1536766,2025-04-02,Senate,"Senate concurred in Governor's recommendation (40-Y 0-N)",40,0,0,0,40
1905513,1476780,2025-01-29,House,"Subcommittee recommends reporting with substitute (8-Y 0-N)",8,0,0,1,9
1905513,1478529,2025-01-31,House,"Reported from Courts of Justice with substitute (17-Y 0-N)",17,0,0,5,22
1905513,1480804,2025-02-04,House,"Read third time and passed House (97-Y 0-N)",97,0,0,3,100
1905513,1480805,2025-02-04,House,"Passed House (99-Y 0-N)",99,0,0,1,100
1905513,1488234,2025-02-12,Senate,"Reported from General Laws and Technology (15-Y 0-N)",15,0,0,0,15
1905513,1490546,2025-02-14,Senate,"Constitutional reading dispensed (on 2nd reading) (36-Y 0-N)",36,0,0,4,40
1905513,1491276,2025-02-17,Senate,"Passed Senate (39-Y 0-N)",39,0,0,1,40
1905516,1472891,2025-01-22,House,"Subcommittee recommends reporting (8-Y 0-N)",8,0,0,1,9
1905516,1474335,2025-01-24,House,"Reported from Counties, Cities and Towns (20-Y 0-N)",20,0,0,2,22
1905516,1478539,2025-01-30,House,"Read third time and passed House (96-Y 0-N)",96,0,0,4,100
1905516,1485098,2025-02-10,Senate,"Reported from Local Government (15-Y 0-N)",15,0,0,0,15
1905516,1486477,2025-02-11,Senate,"Constitutional reading dispensed (on 2nd reading) (40-Y 0-N)",40,0,0,0,40
1905516,1489564,2025-02-12,Senate,"Passed Senate (39-Y 0-N)",39,0,0,1,40
1905518,1474689,2025-01-27,House,"Subcommittee recommends laying on the table (4-Y 3-N)",4,3,0,2,9
1905529,1472533,2025-01-20,House,"Subcommittee recommends reporting (5-Y 3-N)",5,3,0,1,9
1905529,1474652,2025-01-24,House,"Reported from Courts of Justice and referred to Appropriations (12-Y 10-N)",12,10,0,0,22
1905533,1472596,2025-01-21,House,"Reported from Health and Human Services with amendment(s) (22-Y 0-N)",22,0,0,0,22
1905533,1475335,2025-01-27,House,"Read third time and passed House (97-Y 0-N)",97,0,0,3,100
1905533,1489694,2025-02-13,Senate,"Reported from Education and Health (14-Y 0-N)",14,0,0,1,15
1905533,1491138,2025-02-17,Senate,"Constitutional reading dispensed (on 2nd reading)",39,0,0,1,40
1905533,1493100,2025-02-18,Senate,"Passed Senate (40-Y 0-N)",40,0,0,0,40
1905537,1474525,2025-01-24,House,"Subcommittee recommends reporting with amendment(s) (8-Y 0-N)",8,0,0,1,9
1905537,1477016,2025-01-29,House,"Reported from Courts of Justice with amendment(s) (22-Y 0-N)",22,0,0,0,22
1905537,1479938,2025-02-04,House,"Passed House (51-Y 46-N)",51,46,0,3,100
1905537,1484618,2025-02-10,Senate,"Reported from Courts of Justice (15-Y 0-N)",15,0,0,0,15
1905537,1485990,2025-02-11,Senate,"Constitutional reading dispensed (on 2nd reading) (40-Y 0-N)",40,0,0,0,40
1905537,1488809,2025-02-12,Senate,"Passed Senate (39-Y 0-N)",39,0,0,1,40
1905537,1564805,2025-02-04,House,"Read third time and passed House (56-Y 41-N)",56,41,0,3,100
1905541,1477555,2025-01-30,House,"Subcommittee recommends reporting with amendment(s) (8-Y 0-N)",8,0,0,1,9
1905541,1477707,2025-01-30,House,"Reported from General Laws with amendment(s) (20-Y 1-N)",20,1,0,1,22
1905541,1480828,2025-02-04,House,"Read third time and passed House (73-Y 24-N)",73,24,0,3,100
1905541,1488049,2025-02-12,Senate,"Reported from General Laws and Technology (10-Y 5-N)",10,5,0,0,15
1905541,1490197,2025-02-14,Senate,"Constitutional reading dispensed (on 2nd reading) (36-Y 0-N)",36,0,0,4,40
1905541,1492258,2025-02-18,Senate,"Passed Senate (21-Y 19-N)",21,19,0,0,40
1905542,1477118,2025-01-30,House,"Subcommittee recommends reporting (7-Y 1-N)",7,1,0,1,9
1905542,1477119,2025-01-30,House,"Reported from Health and Human Services (19-Y 2-N)",19,2,0,1,22
1905542,1482347,2025-02-04,House,"Read third time and passed House (84-Y 13-N)",84,13,0,3,100
1905542,1489535,2025-02-13,Senate,"Reported from Education and Health (15-Y 0-N)",15,0,0,0,15
1905542,1491021,2025-02-17,Senate,"Constitutional reading dispensed (on 2nd reading)",39,0,0,1,40
1905542,1492260,2025-02-18,Senate,"Passed Senate (40-Y 0-N)",40,0,0,0,40
1905544,1472747,2025-01-21,House,"Subcommittee recommends reporting (8-Y 0-N)",8,0,0,1,9
1905544,1472944,2025-01-22,House,"Reported from Education (22-Y 0-N)",22,0,0,0,22
1905544,1476494,2025-01-28,House,"Read third time and passed House (99-Y 0-N)",99,0,0,1,100
1905544,1489548,2025-02-13,Senate,"Reported from Education and Health (15-Y 0-N)",15,0,0,0,15
1905544,1491017,2025-02-17,Senate,"Constitutional reading dispensed (on 2nd reading)",39,0,0,1,40
1905544,1492238,2025-02-18,Senate,"Passed Senate (40-Y 0-N)",40,0,0,0,40
1905544,1535373,2025-04-02,Senate,"Senate concurred in Governor's recommendation (40-Y 0-N)",40,0,0,0,40
1905544,1536583,2025-04-02,House,"House concurred in Governor's recommendation (96-Y 0-N)",96,0,0,4,100
1905545,1476370,2025-01-29,House,"Subcommittee recommends reporting with substitute (10-Y 0-N)",10,0,0,1,11
1905545,1476371,2025-01-29,House,"Reported from Agriculture, Chesapeake and Natural Resources with substitute (22-Y 0-N)",22,0,0,0,22
1905545,1480528,2025-02-04,House,"Read third time and passed House (97-Y 0-N)",97,0,0,3,100
1905545,1480529,2025-02-04,House,"Passed House (99-Y 0-N)",99,0,0,1,100
1905545,1486622,2025-02-11,Senate,"Reported from Agriculture, Conservation and Natural Resources and rereferred to Finance and Appropriations (14-Y 0-N)",14,0,0,1,15
1905545,1490141,2025-02-14,Senate,"Passed by indefinitely in Finance and Appropriations (10-Y 4-N)",10,4,0,1,15
1905552,1473486,2025-01-23,House,"Subcommittee recommends reporting (8-Y 0-N)",8,0,0,1,9
1905552,1475661,2025-01-28,House,"Reported from Health and Human Services (21-Y 0-N)",21,0,0,1,22
1905552,1479837,2025-02-03,House,"Read third time and passed House (98-Y 0-N)",98,0,0,2,100
1905552,1479838,2025-02-03,House,"Read third time and passed House (99-Y 0-N)",99,0,0,1,100
1905552,1489639,2025-02-13,Senate,"Reported from Education and Health (15-Y 0-N)",15,0,0,0,15
1905552,1491065,2025-02-17,Senate,"Constitutional reading dispensed (on 2nd reading)",39,0,0,1,40
1905552,1492347,2025-02-18,Senate,"Passed Senate (40-Y 0-N)",40,0,0,0,40
1905554,1477678,2025-01-30,House,"Subcommittee recommends reporting (8-Y 0-N)",8,0,0,1,9
1905554,1477679,2025-01-30,House,"Reported from General Laws (21-Y 0-N)",21,0,0,1,22
1905554,1480154,2025-02-04,House,"Read third time and passed House (97-Y 0-N)",97,0,0,3,100
1905554,1480155,2025-02-04,House,"Passed House (99-Y 0-N)",99,0,0,1,100
1905554,1488199,2025-02-12,Senate,"Reported from General Laws and Technology (14-Y 0-N)",14,0,0,1,15
1905554,1490538,2025-02-14,Senate,"Constitutional reading dispensed (on 2nd reading) (36-Y 0-N)",36,0,0,4,40
1905554,1491837,2025-02-17,Senate,"Passed Senate (39-Y 0-N)",39,0,0,1,40
1905554,1535526,2025-04-02,House,"House concurred in Governor's recommendation (95-Y 0-N)",95,0,0,5,100
1905554,1535527,2025-04-02,Senate,"Senate concurred in Governor's recommendation (40-Y 0-N)",40,0,0,0,40
1905556,1472364,2025-01-20,House,"Subcommittee recommends reporting (8-Y 0-N)",8,0,0,1,9
1905556,1474646,2025-01-24,House,"Reported from Courts of Justice (22-Y 0-N)",22,0,0,0,22
1905556,1478269,2025-01-30,House,"Read third time and passed House (96-Y 0-N)",96,0,0,4,100
1905556,1484624,2025-02-10,Senate,"Reported from Courts of Justice (12-Y 0-N)",12,0,0,3,15
1905556,1486002,2025-02-11,Senate,"Constitutional reading dispensed (on 2nd reading) (40-Y 0-N)",40,0,0,0,40
1905556,1488814,2025-02-12,Senate,"Passed Senate (39-Y 0-N)",39,0,0,1,40
1905559,1472585,2025-01-20,House,"Subcommittee recommends reporting (8-Y 0-N)",8,0,0,1,9
1905559,1474705,2025-01-24,House,"Reported from Courts of Justice and referred to Appropriations (22-Y 0-N)",22,0,0,0,22
1905559,1476468,2025-01-29,House,"Reported from Appropriations (21-Y 0-N)",21,0,0,1,22
1905559,1482488,2025-02-04,House,"Read third time and passed House (97-Y 0-N)",97,0,0,3,100
1905559,1482489,2025-02-04,House,"Passed House (99-Y 0-N)",99,0,0,1,100
1905559,1488492,2025-02-12,Senate,"Reported from Courts of Justice and rereferred to Finance and Appropriations (15-Y 0-N)",15,0,0,0,15
1905559,1492285,2025-02-17,Senate,"Reported from Finance and Appropriations with substitute (14-Y 0-N)",14,0,0,1,15
1905559,1494355,2025-02-19,Senate,"Constitutional reading dispensed (on 2nd reading) (40-Y 0-N)",40,0,0,0,40
1905559,1496043,2025-02-20,House,"Senate substitute rejected by House (0-Y 96-N)",0,96,0,4,100
1905559,1496044,2025-02-20,Senate,"Senate insisted on substitute (38-Y 0-N)",38,0,0,2,40
1905559,1496915,2025-02-20,Senate,"Passed Senate with substitute (39-Y 0-N)",39,0,0,1,40
1905559,1496916,2025-02-20,Senate,"Reconsideration of Senate passage agreed to by Senate (39-Y 0-N)",39,0,0,1,40
1905559,1496917,2025-02-20,Senate,"Passed Senate with substitute (39-Y 0-N)",39,0,0,1,40
1905559,1497193,2025-02-22,House,"Conference report agreed to by House (98-Y 0-N)",98,0,0,2,100
1905559,1503141,2025-02-22,Senate,"Conference report agreed to by Senate (40-Y 0-N)",40,0,0,0,40
1905563,1473955,2025-01-23,House,"Subcommittee recommends reporting with substitute (8-Y 0-N)",8,0,0,1,9
1905563,1475662,2025-01-28,House,"Reported from General Laws with substitute (20-Y 2-N)",20,2,0,0,22
1905563,1479883,2025-02-03,House,"Read third time and passed House (87-Y 12-N)",87,12,0,1,100
1905563,1488155,2025-02-12,Senate,"Reported from General Laws and Technology with amendment (11-Y 4-N)",11,4,0,0,15
1905563,1490289,2025-02-14,Senate,"Constitutional reading dispensed (on 2nd reading) (36-Y 0-N)",36,0,0,4,40
1905563,1492401,2025-02-18,Senate,"Passed Senate with amendment (22-Y 18-N)",22,18,0,0,40
1905563,1495394,2025-02-19,House,"Senate Amendment agreed to by House (81-Y 16-N)",81,16,0,3,100
1905566,1476721,2025-01-29,House,"Subcommittee recommends reporting (7-Y 0-N 1-A)",7,0,1,1,9
1905566,1477145,2025-01-30,House,"Reported from Health and Human Services and referred to Appropriations (13-Y 8-N)",13,8,0,1,22
1905568,1474803,2025-01-27,House,"Subcommittee recommends reporting (8-Y 0-N)",8,0,0,1,9
1905568,1476557,2025-01-29,House,"Reported from Education (22-Y 0-N)",22,0,0,0,22
1905568,1480057,2025-02-04,House,"Read third time and passed House (97-Y 0-N)",97,0,0,3,100
1905568,1480058,2025-02-04,House,"Passed House (99-Y 0-N)",99,0,0,1,100
1905568,1490855,2025-02-17,Senate,"Reported from Courts of Justice with amendment (15-Y 0-N)",15,0,0,0,15
1905568,1492801,2025-02-18,Senate,"Constitutional reading dispensed (on 2nd reading) (39-Y 0-N)",39,0,0,1,40
1905568,1495004,2025-02-19,Senate,"Passed Senate with amendment (40-Y 0-N)",40,0,0,0,40
1905568,1496935,2025-02-20,House,"Senate Amendment agreed to by House (98-Y 0-N)",98,0,0,2,100
1905569,1472879,2025-01-21,House,"Subcommittee recommends striking from the docket (8-Y 0-N)",8,0,0,1,9
1905569,1474085,2025-01-23,House,"Stricken from docket by General Laws (21-Y 0-N)",21,0,0,1,22
1905573,1477155,2025-01-30,House,"Subcommittee recommends reporting (5-Y 0-N)",5,0,0,2,7
1905573,1478116,2025-01-31,House,"Reported from Public Safety (20-Y 0-N)",20,0,0,2,22
1905573,1480544,2025-02-04,House,"Read third time and passed House (97-Y 0-N)",97,0,0,3,100
1905573,1480545,2025-02-04,House,"Passed House (99-Y 0-N)",99,0,0,1,100
1905573,1488046,2025-02-12,Senate,"Passed by indefinitely in General Laws and Technology (9-Y 6-N)",9,6,0,0,15
1905576,1473299,2025-01-22,House,"Subcommittee recommends reporting (8-Y 1-N 1-A)",8,1,1,1,11
1905576,1476923,2025-01-29,House,"Reported from Agriculture, Chesapeake and Natural Resources (22-Y 0-N)",22,0,0,0,22
1905576,1480507,2025-02-04,House,"Read third time and passed House (97-Y 0-N)",97,0,0,3,100
1905576,1480508,2025-02-04,House,"Passed House (99-Y 0-N)",99,0,0,1,100
1905576,1487163,2025-02-11,Senate,"Reported from Agriculture, Conservation and Natural Resources with substitute and rereferred to Finance and Appropriations (15-Y 0-N)",15,0,0,0,15
1905576,1490271,2025-02-14,Senate,"Reported from Finance and Appropriations (14-Y 0-N)",14,0,0,1,15
1905576,1491225,2025-02-17,Senate,"Constitutional reading dispensed (on 2nd reading) (39-Y 0-N)",39,0,0,1,40
1905576,1492227,2025-02-18,Senate,"Passed Senate with substitute (40-Y 0-N)",40,0,0,0,40
1905576,1493669,2025-02-19,House,"Senate substitute agreed to by House (97-Y 0-N)",97,0,0,3,100
1905581,1472502,2025-01-20,House,"Subcommittee recommends striking from the docket (8-Y 0-N)",8,0,0,1,9
1905581,1473362,2025-01-22,House,"Stricken from docket by Appropriations (22-Y 0-N)",22,0,0,0,22
1905582,1472780,2025-01-21,House,"Subcommittee recommends reporting (8-Y 0-N)",8,0,0,1,9
1905582,1472946,2025-01-22,House,"Reported from Education (22-Y 0-N)",22,0,0,0,22
1905582,1476482,2025-01-28,House,"Read third time and passed House (99-Y 0-N)",99,0,0,1,100
1905582,1489584,2025-02-13,Senate,"Reported from Education and Health and rereferred to Finance and Appropriations (15-Y 0-N)",15,0,0,0,15
1905582,1492159,2025-02-17,Senate,"Reported from Finance and Appropriations (14-Y 0-N)",14,0,0,1,15
1905582,1495824,2025-02-19,Senate,"Constitutional reading dispensed (on 2nd reading) (40-Y 0-N)",40,0,0,0,40
1905582,1496257,2025-02-20,Senate,"Passed Senate (39-Y 0-N)",39,0,0,1,40
1905582,1496258,2025-02-20,Senate,"Reconsideration of Senate passage agreed to by Senate (39-Y 0-N)",39,0,0,1,40
1905582,1496259,2025-02-20,Senate,"Passed Senate (39-Y 0-N)",39,0,0,1,40
1905584,1472583,2025-01-20,House,"Subcommittee recommends laying on the table (5-Y 3-N)",5,3,0,1,9
1905589,1473204,2025-01-22,House,"Subcommittee recommends reporting with substitute and referring to Appropriations (10-Y 0-N)",10,0,0,1,11
1905589,1476368,2025-01-29,House,"Reported from Agriculture, Chesapeake and Natural Resources with substitute and referred to Appropriations (22-Y 0-N)",22,0,0,0,22
1905589,1478189,2025-01-31,House,"Reported from Appropriations (22-Y 0-N)",22,0,0,0,22
1905589,1479909,2025-02-04,House,"Read third time and passed House (72-Y 26-N)",72,26,0,2,100
1905589,1486612,2025-02-11,Senate,"Reported from Agriculture, Conservation and Natural Resources with substitute (15-Y 0-N)",15,0,0,0,15
1905589,1490092,2025-02-13,Senate,"Constitutional reading dispensed (on 2nd reading) (40-Y 0-N)",40,0,0,0,40
1905589,1490093,2025-02-14,Senate,"Passed Senate with substitute (36-Y 0-N)",36,0,0,4,40
1905589,1491968,2025-02-18,House,"Senate substitute agreed to by House (70-Y 27-N)",70,27,0,3,100
1905589,1534968,2025-04-02,House,"House concurred in Governor's recommendation (79-Y 15-N)",79,15,0,6,100
1905589,1534969,2025-04-02,Senate,"Senate concurred in Governor's recommendation (40-Y 0-N)",40,0,0,0,40
1905593,1472754,2025-01-21,House,"Subcommittee recommends laying on the table (7-Y 0-N)",7,0,0,2,9
1905594,1473339,2025-01-22,House,"Subcommittee recommends striking from the docket (8-Y 0-N)",8,0,0,1,9
1905598,1472580,2025-01-20,House,"Subcommittee recommends reporting with substitute (8-Y 0-N)",8,0,0,1,9
1905598,1474679,2025-01-24,House,"Reported from Courts of Justice with substitute (22-Y 0-N)",22,0,0,0,22
1905598,1478233,2025-01-30,House,"Read third time and passed House (96-Y 0-N)",96,0,0,4,100
1905598,1484769,2025-02-10,Senate,"Reported from Courts of Justice (14-Y 0-N 1-A)",14,0,1,0,15
1905598,1486031,2025-02-11,Senate,"Constitutional reading dispensed (on 2nd reading) (40-Y 0-N)",40,0,0,0,40
1905598,1487828,2025-02-12,Senate,"Passed Senate (37-Y 1-N)",37,1,0,2,40
1905600,1472694,2025-01-21,House,"Stricken from docket by General Laws (21-Y 0-N)",21,0,0,1,22
1905602,1478339,2025-01-31,House,"Subcommittee recommends laying on the table (8-Y 0-N)",8,0,0,1,9
1905603,1476048,2025-01-28,House,"Subcommittee recommends laying on the table (4-Y 3-N)",4,3,0,2,9
1905606,1473501,2025-01-23,House,"Subcommittee recommends reporting (6-Y 0-N)",6,0,0,1,7
1905606,1477592,2025-01-30,House,"Subcommittee recommends passing by indefinitely (6-Y 4-N)",6,4,0,1,11
1905610,1474295,2025-01-24,House,"Subcommittee recommends laying on the table (5-Y 3-N)",5,3,0,1,9
1905613,1474669,2025-01-27,House,"Subcommittee recommends laying on the table (9-Y 1-N)",9,1,0,1,11
1905614,1473193,2025-01-22,House,"Subcommittee recommends reporting (6-Y 4-N)",6,4,0,1,11
1905614,1476917,2025-01-29,House,"Reported from Agriculture, Chesapeake and Natural Resources (13-Y 9-N)",13,9,0,0,22
1905614,1486778,2025-02-11,Senate,"Passed by indefinitely in Agriculture, Conservation and Natural Resources with letter (12-Y 3-N)",12,3,0,0,15
1905614,1565428,2025-02-04,House,"Read third time and passed House (52-Y 45-N)",52,45,0,3,100
1905616,1476911,2025-01-29,House,"Subcommittee recommends reporting (8-Y 0-N)",8,0,0,1,9
1905616,1478526,2025-01-31,House,"Reported from Courts of Justice (17-Y 0-N)",17,0,0,5,22
1905616,1482413,2025-02-04,House,"Read third time and passed House (97-Y 0-N)",97,0,0,3,100
1905616,1482414,2025-02-04,House,"Passed House (99-Y 0-N)",99,0,0,1,100
1905616,1485999,2025-02-10,Senate,"Reported from Courts of Justice with substitute (14-Y 1-N)",14,1,0,0,15
1905616,1486000,2025-02-11,Senate,"Constitutional reading dispensed (on 2nd reading) (40-Y 0-N)",40,0,0,0,40
1905616,1488284,2025-02-12,Senate,"Passed Senate with substitute (27-Y 12-N)",27,12,0,1,40
1905616,1490120,2025-02-14,House,"Senate substitute agreed to by House (63-Y 32-N)",63,32,0,5,100
1905616,1535576,2025-04-02,House,"VOTE: Pass by for the day - Adoption (47-Y 46-N)",47,46,0,7,100
1905619,1474214,2025-01-24,House,"Reported from Privileges and Elections with substitute and referred to Appropriations (13-Y 8-N)",13,8,0,1,22
1905619,1475054,2025-01-27,House,"Subcommittee recommends reporting (7-Y 1-N)",7,1,0,1,9
1905619,1476647,2025-01-29,House,"Reported from Appropriations (16-Y 5-N)",16,5,0,1,22
1905619,1482271,2025-02-04,House,"Read third time and passed House (56-Y 42-N)",56,42,0,2,100
1905619,1486165,2025-02-11,Senate,"Reported from Privileges and Elections and rereferred to Finance and Appropriations (8-Y 7-N)",8,7,0,0,15
1905619,1492214,2025-02-17,Senate,"Reported from Finance and Appropriations with substitute (10-Y 4-N)",10,4,0,1,15
1905619,1493692,2025-02-19,Senate,"Constitutional reading dispensed (on 2nd reading) (40-Y 0-N)",40,0,0,0,40
1905619,1495946,2025-02-20,Senate,"Senate insisted on substitute (38-Y 0-N)",38,0,0,2,40
1905619,1496419,2025-02-20,Senate,"Passed Senate with substitute (20-Y 18-N 1-A)",20,18,1,1,40
1905619,1496420,2025-02-20,Senate,"Reconsideration of Senate passage agreed to by Senate (39-Y 0-N)",39,0,0,1,40
1905619,1496421,2025-02-20,Senate,"Passed Senate with substitute (20-Y 18-N)",20,18,0,2,40
1905619,1496422,2025-02-21,Senate,"Conference report agreed to by Senate (22-Y 18-N)",22,18,0,0,40
1905619,1496829,2025-02-20,House,"Senate substitute rejected by House (0-Y 96-N)",0,96,0,4,100
1905619,1503832,2025-02-21,House,"Conference report agreed to by House (54-Y 41-N)",54,41,0,5,100
1905620,1473676,2025-01-23,House,"Subcommittee recommends reporting (8-Y 0-N)",8,0,0,1,9
1905620,1474267,2025-01-24,House,"Reported from Counties, Cities and Towns (20-Y 0-N)",20,0,0,2,22
1905620,1478313,2025-01-30,House,"Read third time and passed House (96-Y 0-N)",96,0,0,4,100
1905620,1485089,2025-02-10,Senate,"Passed by indefinitely in Local Government (8-Y 7-N)",8,7,0,0,15
1905623,1472607,2025-01-20,House,"Subcommittee recommends reporting with substitute (7-Y 1-N)",7,1,0,1,9
1905623,1474651,2025-01-24,House,"Reported from Courts of Justice with substitute (14-Y 8-N)",14,8,0,0,22
1905623,1478344,2025-01-30,House,"Read third time and passed House (51-Y 44-N)",51,44,0,5,100
1905623,1483019,2025-02-05,Senate,"Reported from Courts of Justice and rereferred to Finance and Appropriations (14-Y 0-N)",14,0,0,1,15
1905623,1486045,2025-02-11,Senate,"Passed by indefinitely in Finance and Appropriations (15-Y 0-N)",15,0,0,0,15
1905626,1473460,2025-01-23,House,"Subcommittee recommends striking from the docket (8-Y 0-N)",8,0,0,1,9
1905627,1474910,2025-01-27,House,"Subcommittee recommends reporting with amendment(s) (7-Y 1-N)",7,1,0,1,9
1905627,1476518,2025-01-29,House,"Reported from Education with amendment(s) (18-Y 4-N)",18,4,0,0,22
1905627,1482260,2025-02-04,House,"Read third time and passed House (72-Y 27-N)",72,27,0,1,100
1905627,1489848,2025-02-13,Senate,"Reported from Education and Health and rereferred to Finance and Appropriations (14-Y 1-N)",14,1,0,0,15
1905627,1490490,2025-02-14,Senate,"Reported from Finance and Appropriations with substitute (14-Y 0-N)",14,0,0,1,15
1905627,1490960,2025-02-17,Senate,"Constitutional reading dispensed (on 2nd reading) (39-Y 0-N)",39,0,0,1,40
1905627,1495299,2025-02-19,Senate,"Passed Senate with substitute (37-Y 3-N)",37,3,0,0,40
1905627,1496587,2025-02-20,House,"Senate substitute agreed to by House (74-Y 24-N)",74,24,0,2,100
1905640,1473205,2025-01-22,House,"Subcommittee recommends reporting (8-Y 0-N)",8,0,0,1,9
1905640,1474268,2025-01-24,House,"Reported from Appropriations (22-Y 0-N)",22,0,0,0,22
1905640,1478246,2025-01-30,House,"Read third time and passed House (96-Y 0-N)",96,0,0,4,100
1905640,1480481,2025-02-05,Senate,"Reported from Finance and Appropriations with substitute (13-Y 0-N)",13,0,0,2,15
1905640,1483973,2025-02-06,Senate,"Constitutional reading dispensed (on 2nd reading) (40-Y 0-N)",40,0,0,0,40
1905640,1483974,2025-02-07,Senate,"Passed Senate with substitute (39-Y 0-N)",39,0,0,1,40
1905640,1485922,2025-02-11,House,"Senate substitute rejected by House (0-Y 94-N)",0,94,0,6,100
1905640,1490013,2025-02-13,Senate,"Senate insisted on substitute (39-Y 0-N)",39,0,0,1,40
1905640,1496621,2025-02-21,Senate,"Conference report agreed to by Senate (38-Y 0-N)",38,0,0,2,40
1905640,1504159,2025-02-21,House,"Conference report agreed to by House (94-Y 0-N)",94,0,0,6,100
1905645,1476905,2025-01-29,House,"Subcommittee recommends laying on the table (5-Y 3-N)",5,3,0,1,9
1905648,1474716,2025-01-27,House,"Subcommittee recommends reporting with amendment(s) (10-Y 0-N)",10,0,0,1,11
1905648,1476473,2025-01-29,House,"Reported from Education with amendment(s) (22-Y 0-N)",22,0,0,0,22
1905648,1480722,2025-02-04,House,"Read third time and passed House (97-Y 0-N)",97,0,0,3,100
1905648,1480723,2025-02-04,House,"Passed House (99-Y 0-N)",99,0,0,1,100
1905648,1489737,2025-02-13,Senate,"Reported from Education and Health (15-Y 0-N)",15,0,0,0,15
1905648,1491533,2025-02-17,Senate,"Constitutional reading dispensed (on 2nd reading)",39,0,0,1,40
1905648,1492751,2025-02-18,Senate,"Passed Senate (40-Y 0-N)",40,0,0,0,40
1905650,1472893,2025-01-22,House,"Subcommittee recommends reporting (8-Y 0-N)",8,0,0,1,9
1905650,1474333,2025-01-24,House,"Reported from Counties, Cities and Towns (20-Y 0-N)",20,0,0,2,22
1905650,1478149,2025-01-30,House,"Read third time and passed House (96-Y 0-N)",96,0,0,4,100
1905650,1485127,2025-02-10,Senate,"Reported from Local Government (14-Y 0-N)",14,0,0,1,15
1905650,1486500,2025-02-11,Senate,"Constitutional reading dispensed (on 2nd reading) (40-Y 0-N)",40,0,0,0,40
1905650,1487873,2025-02-12,Senate,"Passed Senate (39-Y 0-N)",39,0,0,1,40
1905653,1475798,2025-01-28,House,"Subcommittee recommends reporting (8-Y 0-N)",8,0,0,1,9
1905653,1477249,2025-01-30,House,"Reported from Transportation (22-Y 0-N)",22,0,0,0,22
1905653,1482131,2025-02-04,House,"Read third time and passed House (97-Y 0-N)",97,0,0,3,100
1905653,1482132,2025-02-04,House,"Passed House (99-Y 0-N)",99,0,0,1,100
1905653,1489502,2025-02-13,Senate,"Reported from Transportation (13-Y 0-N)",13,0,0,2,15
1905653,1490938,2025-02-17,Senate,"Constitutional reading dispensed (on 2nd reading)",39,0,0,1,40
1905653,1492245,2025-02-18,Senate,"Passed Senate (40-Y 0-N)",40,0,0,0,40
1905656,1474710,2025-01-27,House,"Subcommittee recommends laying on the table (5-Y 3-N)",5,3,0,1,9
1905656,1476796,2025-01-29,House,"Reported from Finance (22-Y 0-N)",22,0,0,0,22
1905656,1480077,2025-02-04,House,"Read third time and passed House (97-Y 0-N)",97,0,0,3,100
1905656,1480078,2025-02-04,House,"Passed House (99-Y 0-N)",99,0,0,1,100
1905656,1492305,2025-02-17,Senate,"Passed by indefinitely in Finance and Appropriations (10-Y 4-N)",10,4,0,1,15
1905659,1476897,2025-01-29,House,"Subcommittee recommends reporting (6-Y 0-N)",6,0,0,3,9
1905659,1477172,2025-01-30,House,"Reported from Transportation (22-Y 0-N)",22,0,0,0,22
1905659,1480169,2025-02-04,House,"Read third time and passed House (97-Y 0-N)",97,0,0,3,100
1905659,1480170,2025-02-04,House,"Passed House (99-Y 0-N)",99,0,0,1,100
1905659,1489573,2025-02-13,Senate,"Reported from Transportation (15-Y 0-N)",15,0,0,0,15
1905659,1491112,2025-02-17,Senate,"Constitutional reading dispensed (on 2nd reading)",39,0,0,1,40
1905659,1492733,2025-02-18,Senate,"Passed Senate (40-Y 0-N)",40,0,0,0,40
1905660,1475791,2025-01-28,House,"Subcommittee recommends reporting and referring to Appropriations (8-Y 0-N)",8,0,0,1,9
1905660,1477771,2025-01-30,House,"Reported from Health and Human Services with substitute and referred to Appropriations (21-Y 0-N)",21,0,0,1,22
1905660,1478455,2025-01-31,House,"Reported from Appropriations (22-Y 0-N)",22,0,0,0,22
1905660,1480074,2025-02-04,House,"Read third time and passed House (97-Y 0-N)",97,0,0,3,100
1905660,1480075,2025-02-04,House,"Passed House (99-Y 0-N)",99,0,0,1,100
1905660,1489837,2025-02-13,Senate,"Reported from Education and Health and rereferred to Finance and Appropriations (13-Y 0-N)",13,0,0,2,15
1905660,1490226,2025-02-14,Senate,"Reported from Finance and Appropriations (14-Y 0-N)",14,0,0,1,15
1905660,1490974,2025-02-17,Senate,"Constitutional reading dispensed (on 2nd reading) (39-Y 0-N)",39,0,0,1,40
1905660,1493303,2025-02-18,Senate,"Passed Senate (40-Y 0-N)",40,0,0,0,40
1905661,1475501,2025-01-28,House,"Subcommittee recommends reporting (8-Y 0-N)",8,0,0,1,9
1905661,1477270,2025-01-30,House,"Reported from Health and Human Services (21-Y 0-N)",21,0,0,1,22
1905661,1480616,2025-02-04,House,"Read third time and passed House (97-Y 0-N)",97,0,0,3,100
1905661,1480617,2025-02-04,House,"Passed House (99-Y 0-N)",99,0,0,1,100
1905661,1489603,2025-02-13,Senate,"Reported from Education and Health (15-Y 0-N)",15,0,0,0,15
1905661,1491074,2025-02-17,Senate,"Constitutional reading dispensed (on 2nd reading)",39,0,0,1,40
1905661,1492330,2025-02-18,Senate,"Passed Senate (40-Y 0-N)",40,0,0,0,40
1905673,1477025,2025-01-29,House,"Subcommittee recommends laying on the table (8-Y 0-N)",8,0,0,1,9
1905676,1474146,2025-01-23,House,"Subcommittee recommends laying on the table (5-Y 3-N)",5,3,0,1,9
1905681,1475230,2025-01-28,House,"Subcommittee recommends laying on the table (5-Y 3-N)",5,3,0,1,9
1905684,1474166,2025-01-24,House,"Subcommittee recommends reporting (5-Y 3-N)",5,3,0,1,9
1905684,1478134,2025-01-31,House,"Reported from Counties, Cities and Towns (15-Y 7-N)",15,7,0,0,22
1905684,1482532,2025-02-04,House,"Read third time and passed House (81-Y 17-N)",81,17,0,2,100
1905684,1484555,2025-02-10,Senate,"Reported from Local Government with amendment (15-Y 0-N)",15,0,0,0,15
1905684,1486134,2025-02-11,Senate,"Constitutional reading dispensed (on 2nd reading) (40-Y 0-N)",40,0,0,0,40
1905684,1488844,2025-02-12,Senate,"Passed Senate with amendments (39-Y 0-N)",39,0,0,1,40
1905684,1490187,2025-02-14,House,"Senate Amendments agreed to by House (91-Y 5-N)",91,5,0,4,100
1905686,1474107,2025-01-23,House,"Subcommittee recommends reporting (5-Y 3-N)",5,3,0,1,9
1905686,1476093,2025-01-28,House,"Reported from Labor and Commerce (11-Y 10-N)",11,10,0,1,22
1905686,1478983,2025-02-03,House,"Read third time and passed House (53-Y 46-N)",53,46,0,1,100
1905686,1486001,2025-02-10,Senate,"Reported from Commerce and Labor with substitute and rereferred to Finance and Appropriations (15-Y 0-N)",15,0,0,0,15
1905686,1490618,2025-02-14,Senate,"Reported from Finance and Appropriations with substitute (14-Y 0-N)",14,0,0,1,15
1905686,1491628,2025-02-17,Senate,"Constitutional reading dispensed (on 2nd reading) (39-Y 0-N)",39,0,0,1,40
1905686,1494356,2025-02-18,Senate,"Passed Senate with substitute (40-Y 0-N)",40,0,0,0,40
1905686,1494357,2025-02-19,House,"Senate substitute rejected by House (1-Y 96-N)",1,96,0,3,100
1905686,1495791,2025-02-20,Senate,"Senate insisted on substitute (39-Y 0-N)",39,0,0,1,40
1905686,1496759,2025-02-21,Senate,"Conference report agreed to by Senate (38-Y 1-N)",38,1,0,1,40
1905686,1503966,2025-02-21,House,"Conference report agreed to by House (52-Y 44-N)",52,44,0,4,100
1905686,1536571,2025-04-02,House,"Passed by for the day (47-Y 46-N)",47,46,0,7,100
1905694,1473291,2025-01-22,House,"Subcommittee recommends reporting with amendment(s) (7-Y 1-N)",7,1,0,1,9
1905694,1474645,2025-01-24,House,"Reported from Courts of Justice with amendment(s) (15-Y 7-N)",15,7,0,0,22
1905694,1478577,2025-01-30,House,"Read third time and passed House (56-Y 40-N)",56,40,0,4,100
1905694,1485007,2025-02-10,Senate,"Reported from Courts of Justice with substitute and rereferred to Finance and Appropriations (15-Y 0-N)",15,0,0,0,15
1905694,1488175,2025-02-12,Senate,"Reported from Finance and Appropriations (15-Y 0-N)",15,0,0,0,15
1905694,1490447,2025-02-13,Senate,"Constitutional reading dispensed (on 2nd reading) (40-Y 0-N)",40,0,0,0,40
1905694,1495971,2025-02-19,Senate,"Passed Senate with substitute (35-Y 4-N)",35,4,0,1,40
1905694,1495972,2025-02-20,House,"Senate substitute rejected by House (3-Y 95-N)",3,95,0,2,100
1905694,1495973,2025-02-20,Senate,"Senate insisted on substitute (39-Y 0-N)",39,0,0,1,40
1905694,1497199,2025-02-22,House,"Conference report agreed to by House (67-Y 30-N)",67,30,0,3,100
1905694,1503861,2025-02-22,Senate,"Conference report agreed to by Senate (40-Y 0-N)",40,0,0,0,40
1905694,1535399,2025-04-02,House,"House concurred in Governor's recommendation (73-Y 22-N)",73,22,0,5,100
1905694,1535400,2025-04-02,Senate,"Senate concurred in Governor's recommendation (23-Y 17-N)",23,17,0,0,40
1905698,1477105,2025-01-30,House,"Subcommittee recommends reporting with substitute (8-Y 0-N)",8,0,0,1,9
1905698,1477106,2025-01-30,House,"Reported from Health and Human Services with substitute (21-Y 0-N)",21,0,0,1,22
1905698,1479585,2025-02-04,House,"Read third time and passed House (97-Y 0-N)",97,0,0,3,100
1905698,1479586,2025-02-04,House,"Passed House (99-Y 0-N)",99,0,0,1,100
1905698,1489417,2025-02-13,Senate,"Reported from Education and Health with substitute (15-Y 0-N)",15,0,0,0,15
1905698,1491998,2025-02-17,Senate,"Constitutional reading dispensed (on 2nd reading)",39,0,0,1,40
1905698,1491999,2025-02-18,Senate,"Passed Senate with substitute (40-Y 0-N)",40,0,0,0,40
1905698,1493476,2025-02-19,House,"Senate substitute agreed to by House (97-Y 0-N)",97,0,0,3,100
1905699,1475432,2025-01-28,House,"Subcommittee recommends reporting with substitute (5-Y 3-N)",5,3,0,1,9
1905699,1477225,2025-01-30,House,"Reported from Transportation with substitute (12-Y 10-N)",12,10,0,0,22
1905699,1482411,2025-02-04,House,"Read third time and passed House (58-Y 40-N)",58,40,0,2,100
1905699,1489657,2025-02-13,Senate,"Reported from Transportation with amendment and rereferred to Finance and Appropriations (14-Y 0-N 1-A)",14,0,1,0,15
1905699,1492132,2025-02-17,Senate,"Reported from Finance and Appropriations (14-Y 0-N)",14,0,0,1,15
1905699,1495226,2025-02-20,Senate,"Passed Senate with amendment (39-Y 0-N)",39,0,0,1,40
1905699,1495897,2025-02-19,Senate,"Constitutional reading dispensed (on 2nd reading) (40-Y 0-N)",40,0,0,0,40
1905699,1495898,2025-02-20,House,"Senate Amendment agreed to by House (56-Y 39-N)",56,39,0,5,100
1905699,1536408,2025-04-02,House,"House sustained Governor's veto (54-Y 39-N)",54,39,0,7,100
1905701,1476654,2025-01-29,House,"Tabled in Rules (14-Y 0-N)",14,0,0,4,18
1905702,1475561,2025-01-28,House,"Subcommittee recommends reporting (8-Y 0-N)",8,0,0,1,9
1905702,1477184,2025-01-30,House,"Reported from Transportation (22-Y 0-N)",22,0,0,0,22
1905702,1479683,2025-02-04,House,"Read third time and passed House (97-Y 0-N)",97,0,0,3,100
1905702,1479684,2025-02-04,House,"Passed House (99-Y 0-N)",99,0,0,1,100
1905702,1489649,2025-02-13,Senate,"Reported from Transportation (13-Y 0-N)",13,0,0,2,15
1905702,1491387,2025-02-17,Senate,"Constitutional reading dispensed (on 2nd reading)",39,0,0,1,40
1905702,1492481,2025-02-18,Senate,"Passed Senate (40-Y 0-N)",40,0,0,0,40
1905704,1476709,2025-01-29,House,"Subcommittee recommends reporting (8-Y 0-N)",8,0,0,1,9
1905704,1477744,2025-01-30,House,"Reported from Health and Human Services (21-Y 0-N)",21,0,0,1,22
1905704,1480191,2025-02-04,House,"Read third time and passed House (97-Y 0-N)",97,0,0,3,100
1905704,1480192,2025-02-04,House,"Passed House (99-Y 0-N)",99,0,0,1,100
1905704,1488137,2025-02-12,Senate,"Reported from General Laws and Technology with amendment (15-Y 0-N)",15,0,0,0,15
1905704,1490479,2025-02-14,Senate,"Constitutional reading dispensed (on 2nd reading) (36-Y 0-N)",36,0,0,4,40
1905704,1491530,2025-02-17,Senate,"Passed Senate with amendment (39-Y 0-N)",39,0,0,1,40
1905704,1492748,2025-02-18,House,"Senate Amendment agreed to by House (96-Y 0-N)",96,0,0,4,100
1905706,1473358,2025-01-22,House,"Subcommittee recommends reporting with amendment(s) (8-Y 0-N)",8,0,0,1,9
1905706,1474298,2025-01-24,House,"Reported from Appropriations with amendment(s) (22-Y 0-N)",22,0,0,0,22
1905706,1478225,2025-01-30,House,"Read third time and passed House (90-Y 6-N)",90,6,0,4,100
1905706,1482595,2025-02-05,Senate,"Reported from Finance and Appropriations with substitute (13-Y 0-N)",13,0,0,2,15
1905706,1483573,2025-02-06,Senate,"Constitutional reading dispensed (on 2nd reading) (40-Y 0-N)",40,0,0,0,40
1905706,1484523,2025-02-07,Senate,"Passed Senate with substitute (39-Y 0-N)",39,0,0,1,40
1905706,1486759,2025-02-11,House,"Senate substitute agreed to by House (84-Y 9-N)",84,9,0,7,100
1905707,1472550,2025-01-21,House,"Subcommittee recommends reporting with amendment(s) (8-Y 0-N)",8,0,0,1,9
1905707,1473063,2025-01-22,House,"Reported from Education with amendment(s) (22-Y 0-N)",22,0,0,0,22
1905707,1476422,2025-01-28,House,"Read third time and passed House (99-Y 0-N)",99,0,0,1,100
1905707,1489718,2025-02-13,Senate,"Reported from Education and Health with amendments (15-Y 0-N)",15,0,0,0,15
1905707,1491183,2025-02-17,Senate,"Constitutional reading dispensed (on 2nd reading)",39,0,0,1,40
1905707,1493121,2025-02-18,Senate,"Passed Senate with amendments (40-Y 0-N)",40,0,0,0,40
1905707,1495410,2025-02-19,House,"Senate Amendments agreed to by House (96-Y 0-N)",96,0,0,4,100
1905714,1472434,2025-01-20,House,"Subcommittee recommends laying on the table (8-Y 2-N)",8,2,0,1,11
1905716,1475851,2025-01-28,House,"Subcommittee recommends reporting with substitute (5-Y 3-N)",5,3,0,1,9
1905716,1476265,2025-01-29,House,"Reported from Education with substitute (12-Y 10-N)",12,10,0,0,22
1905716,1482239,2025-02-04,House,"Read third time and passed House (51-Y 48-N)",51,48,0,1,100
1905716,1489162,2025-02-13,Senate,"Reported from Education and Health (9-Y 5-N)",9,5,0,1,15
1905716,1491246,2025-02-17,Senate,"Constitutional reading dispensed (on 2nd reading) (39-Y 0-N)",39,0,0,1,40
1905716,1495487,2025-02-19,Senate,"Passed Senate (21-Y 19-N)",21,19,0,0,40
1905721,1476553,2025-01-29,House,"Subcommittee recommends reporting with substitute (7-Y 1-N)",7,1,0,1,9
1905721,1478358,2025-01-31,House,"Reported from Courts of Justice with substitute (13-Y 7-N)",13,7,0,2,22
1905721,1482389,2025-02-04,House,"Read third time and passed House (54-Y 44-N)",54,44,0,2,100
1905721,1487966,2025-02-12,Senate,"Rereferred from General Laws and Technology to Courts of Justice (10-Y 0-N)",10,0,0,5,15
1905721,1490818,2025-02-17,Senate,"Reported from Courts of Justice with substitute (10-Y 0-N)",10,0,0,5,15
1905721,1493357,2025-02-18,Senate,"Constitutional reading dispensed (on 2nd reading) (39-Y 0-N)",39,0,0,1,40
1905721,1495058,2025-02-19,Senate,"Passed Senate with substitute (40-Y 0-N)",40,0,0,0,40
1905721,1496651,2025-02-20,House,"Senate substitute agreed to by House (54-Y 44-N)",54,44,0,2,100
1905721,1536112,2025-04-02,House,"Passed by for the day (47-Y 46-N)",47,46,0,7,100
1905724,1475905,2025-01-28,House,"Subcommittee recommends reporting and referring to Appropriations (6-Y 2-N)",6,2,0,1,9
1905724,1477620,2025-01-30,House,"Reported from Transportation and referred to Appropriations (12-Y 10-N)",12,10,0,0,22
1905728,1472353,2025-01-20,House,"Subcommittee recommends reporting (5-Y 3-N)",5,3,0,1,9
1905728,1473280,2025-01-22,House,"Reported from Finance (13-Y 9-N)",13,9,0,0,22
1905728,1476858,2025-01-28,House,"Read third time and passed House (59-Y 39-N)",59,39,0,2,100
1905728,1486776,2025-02-11,Senate,"Passed by indefinitely in Finance and Appropriations (14-Y 1-N)",14,1,0,0,15
1905732,1473863,2025-01-23,House,"Subcommittee failed to recommend reporting (3-Y 6-N)",3,6,0,2,11
1905735,1473387,2025-01-22,House,"Subcommittee recommends reporting with substitute (8-Y 0-N)",8,0,0,1,9
1905735,1474753,2025-01-24,House,"Reported from Courts of Justice with substitute (22-Y 0-N)",22,0,0,0,22
1905735,1478173,2025-01-30,House,"Read third time and passed House (96-Y 0-N)",96,0,0,4,100
1905735,1491403,2025-02-17,Senate,"Reported from Courts of Justice with amendment (15-Y 0-N)",15,0,0,0,15
1905735,1492509,2025-02-18,Senate,"Constitutional reading dispensed (on 2nd reading) (39-Y 0-N)",39,0,0,1,40
1905735,1494000,2025-02-19,Senate,"Passed Senate with amendment (40-Y 0-N)",40,0,0,0,40
1905735,1495720,2025-02-20,House,"Senate Amendment agreed to by House (92-Y 1-N)",92,1,0,7,100
1905736,1477699,2025-01-30,House,"Subcommittee recommends reporting with substitute (8-Y 0-N)",8,0,0,1,9
1905736,1477700,2025-01-30,House,"Reported from General Laws with substitute (21-Y 0-N)",21,0,0,1,22
1905736,1480681,2025-02-04,House,"Read third time and passed House (97-Y 0-N)",97,0,0,3,100
1905736,1480682,2025-02-04,House,"Passed House (99-Y 0-N)",99,0,0,1,100
1905736,1488022,2025-02-12,Senate,"Reported from General Laws and Technology (15-Y 0-N)",15,0,0,0,15
1905736,1490190,2025-02-14,Senate,"Constitutional reading dispensed (on 2nd reading) (36-Y 0-N)",36,0,0,4,40
1905736,1492243,2025-02-17,Senate,"Passed Senate (39-Y 0-N)",39,0,0,1,40
1905737,1472760,2025-01-21,House,"Subcommittee recommends reporting with amendment(s) (5-Y 3-N)",5,3,0,1,9
1905737,1473182,2025-01-22,House,"Reported from Finance with amendment(s) and referred to Appropriations (12-Y 10-N)",12,10,0,0,22
1905737,1475179,2025-01-27,House,"Subcommittee recommends reporting (8-Y 0-N)",8,0,0,1,9
1905737,1476994,2025-01-29,House,"Reported from Appropriations (19-Y 2-N)",19,2,0,1,22
1905737,1482967,2025-02-04,House,"Read third time and passed House (63-Y 36-N)",63,36,0,1,100
1905737,1486780,2025-02-11,Senate,"Reported from Finance and Appropriations (10-Y 5-N)",10,5,0,0,15
1905737,1486781,2025-02-11,Senate,"Constitutional reading dispensed (on 2nd reading) (40-Y 0-N)",40,0,0,0,40
1905737,1488237,2025-02-12,Senate,"Passed Senate (21-Y 18-N)",21,18,0,1,40
1905740,1477230,2025-01-30,House,"Subcommittee failed to recommend reporting (3-Y 3-N)",3,3,0,1,7
1905741,1473487,2025-01-23,House,"Subcommittee recommends reporting with amendment(s) and referring to Appropriations (4-Y 2-N)",4,2,0,1,7
1905741,1474210,2025-01-24,House,"Reported from Public Safety with amendment(s) and referred to Appropriations (12-Y 10-N)",12,10,0,0,22
1905741,1476405,2025-01-29,House,"Subcommittee recommends reporting (5-Y 3-N)",5,3,0,1,9
1905741,1476802,2025-01-29,House,"Reported from Appropriations (12-Y 9-N)",12,9,0,1,22
1905741,1480603,2025-02-04,House,"Read third time and passed House 55-Y 44-N 0-A)",55,44,0,1,100
1905741,1483870,2025-02-07,Senate,"Passed by indefinitely in Rehabilitation and Social Services with letter (15-Y 0-N)",15,0,0,0,15
1905746,1475048,2025-01-27,House,"Subcommittee recommends passing by indefinitely (5-Y 3-N)",5,3,0,1,9
1905748,1471501,2025-01-08,House,"Agreed to by House (95-Y 0-N)",95,0,0,4,99
1905749,1472786,2025-01-21,House,"Subcommittee recommends reporting (8-Y 0-N)",8,0,0,1,9
1905749,1476179,2025-01-29,House,"Reported from Education with amendment(s) (21-Y 1-N)",21,1,0,0,22
1905749,1489627,2025-02-13,Senate,"Reported from Education and Health (14-Y 0-N)",14,0,0,1,15
1905749,1491522,2025-02-17,Senate,"Constitutional reading dispensed (on 2nd reading)",39,0,0,1,40
1905749,1492737,2025-02-18,Senate,"Passed Senate (40-Y 0-N)",40,0,0,0,40
1905749,1564905,2025-02-04,House,"Read third time and passed House (99-Y 0-N)",99,0,0,1,100
1905754,1475219,2025-01-27,House,"Subcommittee recommends laying on the table (7-Y 2-N)",7,2,0,2,11
1905756,1473394,2025-01-22,House,"Subcommittee recommends reporting (8-Y 0-N)",8,0,0,1,9
1905756,1474649,2025-01-24,House,"Reported from Courts of Justice (21-Y 1-N)",21,1,0,0,22
1905756,1478437,2025-01-30,House,"Read third time and passed House (89-Y 5-N)",89,5,0,6,100
1905756,1490823,2025-02-17,Senate,"Reported from Courts of Justice (12-Y 0-N 3-A)",12,0,3,0,15
1905756,1494353,2025-02-18,Senate,"Constitutional reading dispensed (on 2nd reading) (39-Y 0-N)",39,0,0,1,40
1905756,1494354,2025-02-19,Senate,"Passed Senate (30-Y 9-N)",30,9,0,1,40
1905760,1474051,2025-01-23,House,"Subcommittee recommends reporting with substitute and referring to Appropriations (5-Y 3-N)",5,3,0,1,9
1905760,1475782,2025-01-28,House,"Reported from Labor and Commerce with substitute and referred to Appropriations (12-Y 10-N)",12,10,0,0,22
1905760,1476412,2025-01-29,House,"Subcommittee recommends reporting (5-Y 3-N)",5,3,0,1,9
1905760,1476801,2025-01-29,House,"Reported from Appropriations (11-Y 10-N)",11,10,0,1,22
1905760,1482385,2025-02-04,House,"Read third time and passed House (51-Y 48-N)",51,48,0,1,100
1905760,1484863,2025-02-10,Senate,"Reported from Commerce and Labor and rereferred to Finance and Appropriations (9-Y 6-N)",9,6,0,0,15
1905760,1490151,2025-02-14,Senate,"Reported from Finance and Appropriations (10-Y 4-N)",10,4,0,1,15
1905760,1490947,2025-02-17,Senate,"Constitutional reading dispensed (on 2nd reading) (39-Y 0-N)",39,0,0,1,40
1905760,1493732,2025-02-19,Senate,"Passed Senate (21-Y 19-N)",21,19,0,0,40
1905761,1474004,2025-01-24,House,"Subcommittee recommends laying on the table (6-Y 4-N)",6,4,0,1,11
1905762,1476993,2025-01-29,House,"Reported from Rules and referred to Appropriations (14-Y 0-N)",14,0,0,4,18
1905762,1478497,2025-01-31,House,"Reported from Appropriations (22-Y 0-N)",22,0,0,0,22
1905762,1480717,2025-02-04,House,"Read third time and passed House (85-Y 11-N)",85,11,0,4,100
1905762,1490144,2025-02-14,Senate,"Reported from Rules and rereferred to Finance and Appropriations (15-Y 0-N)",15,0,0,0,15
1905762,1492108,2025-02-17,Senate,"Reported from Finance and Appropriations (14-Y 0-N)",14,0,0,1,15
1905762,1495295,2025-02-19,Senate,"Constitutional reading dispensed (on 2nd reading) (40-Y 0-N)",40,0,0,0,40
1905762,1495296,2025-02-20,Senate,"Passed Senate (39-Y 0-N)",39,0,0,1,40
1905762,1495297,2025-02-20,Senate,"Reconsideration of Senate passage agreed to by Senate (39-Y 0-N)",39,0,0,1,40
1905762,1495298,2025-02-20,Senate,"Passed Senate (39-Y 0-N)",39,0,0,1,40
1905763,1478080,2025-01-31,House,"Subcommittee recommends laying on the table (5-Y 3-N)",5,3,0,1,9
1905765,1477168,2025-01-30,House,"Subcommittee recommends reporting with substitute (6-Y 0-N)",6,0,0,1,7
1905765,1478020,2025-01-31,House,"Reported from Public Safety with substitute (21-Y 0-N)",21,0,0,1,22
1905765,1480550,2025-02-04,House,"Read third time and passed House (97-Y 0-N)",97,0,0,3,100
1905765,1480551,2025-02-04,House,"Passed House (99-Y 0-N)",99,0,0,1,100
1905765,1483864,2025-02-07,Senate,"Reported from Rehabilitation and Social Services with amendments and rereferred to Finance and Appropriations (15-Y 0-N)",15,0,0,0,15
1905765,1487380,2025-02-12,Senate,"Reported from Finance and Appropriations with amendments (10-Y 5-N)",10,5,0,0,15
1905765,1488905,2025-02-13,Senate,"Constitutional reading dispensed (on 2nd reading) (40-Y 0-N)",40,0,0,0,40
1905765,1490206,2025-02-14,Senate,"Passed Senate with amendments (20-Y 15-N)",20,15,0,5,40
1905765,1492179,2025-02-18,House,"Senate Amendments agreed to by House (96-Y 1-N)",96,1,0,3,100
1905765,1535449,2025-04-02,Senate,"Senate concurred in Governor's recommendation (39-Y 1-N)",39,1,0,0,40
1905765,1536659,2025-04-02,House,"House concurred in Governor's recommendation (95-Y 0-N)",95,0,0,5,100
1905768,1472299,2025-01-20,House,"Subcommittee recommends reporting (7-Y 1-N)",7,1,0,1,9
1905768,1473158,2025-01-22,House,"Reported from Finance (20-Y 2-N)",20,2,0,0,22
1905768,1476536,2025-01-28,House,"Read third time and passed House (94-Y 5-N)",94,5,0,1,100
1905768,1480484,2025-02-05,Senate,"Reported from Finance and Appropriations (13-Y 0-N)",13,0,0,2,15
1905768,1483223,2025-02-06,Senate,"Constitutional reading dispensed (on 2nd reading) (40-Y 0-N)",40,0,0,0,40
1905768,1483954,2025-02-07,Senate,"Passed Senate (39-Y 0-N)",39,0,0,1,40
1905769,1474944,2025-01-27,House,"Subcommittee recommends laying on the table (6-Y 4-N)",6,4,0,1,11
1905771,1473956,2025-01-23,House,"Subcommittee recommends reporting with amendment(s) (5-Y 3-N)",5,3,0,1,9
1905771,1475646,2025-01-28,House,"Failed to report from Health and Human Services with amendment(s) (9-Y 9-N)",9,9,0,4,22
1905772,1473939,2025-01-23,House,"Subcommittee recommends reporting and referring to Appropriations (7-Y 1-N)",7,1,0,1,9
1905772,1475606,2025-01-28,House,"Reported from Health and Human Services and referred to Appropriations (20-Y 1-N)",20,1,0,1,22
1905772,1476618,2025-01-29,House,"Subcommittee recommends laying on the table (4-Y 2-N)",4,2,0,3,9
1905775,1477167,2025-01-30,House,"Subcommittee recommends reporting with substitute (5-Y 1-N)",5,1,0,1,7
1905775,1478078,2025-01-31,House,"Reported from Public Safety with substitute (21-Y 0-N)",21,0,0,1,22
1905775,1479544,2025-02-04,House,"Read third time and passed House (97-Y 0-N)",97,0,0,3,100
1905775,1479545,2025-02-04,House,"Passed House (99-Y 0-N)",99,0,0,1,100
1905775,1484995,2025-02-10,Senate,"Rereferred to Courts of Justice (12-Y 0-N)",12,0,0,3,15
1905775,1488892,2025-02-13,Senate,"Reported from Courts of Justice and rereferred to Finance and Appropriations (14-Y 0-N)",14,0,0,1,15
1905775,1492194,2025-02-17,Senate,"Reported from Finance and Appropriations (14-Y 0-N)",14,0,0,1,15
1905775,1495905,2025-02-19,Senate,"Constitutional reading dispensed (on 2nd reading) (40-Y 0-N)",40,0,0,0,40
1905775,1496336,2025-02-20,Senate,"Passed Senate (39-Y 0-N)",39,0,0,1,40
1905775,1496337,2025-02-20,Senate,"Reconsideration of Senate passage agreed to by Senate (39-Y 0-N)",39,0,0,1,40
1905775,1496338,2025-02-20,Senate,"Passed Senate (39-Y 0-N)",39,0,0,1,40
1905777,1472572,2025-01-21,House,"Subcommittee recommends reporting with substitute and referred to Appropriations (8-Y 0-N)",8,0,0,1,9
1905777,1472918,2025-01-22,House,"Reported from Education with substitute and referred to Appropriations (22-Y 0-N)",22,0,0,0,22
1905777,1474499,2025-01-24,House,"Subcommittee recommends laying on the table (7-Y 1-N)",7,1,0,1,9
1905783,1472392,2025-01-20,House,"Subcommittee recommends passing by indefinitely (6-Y 2-N)",6,2,0,1,9
1905786,1474002,2025-01-23,House,"Subcommittee recommends laying on the table (6-Y 4-N)",6,4,0,1,11
1905790,1475304,2025-01-28,House,"Subcommittee recommends reporting with substitute (5-Y 3-N)",5,3,0,1,9
1905790,1476363,2025-01-29,House,"Reported from Education with substitute (12-Y 10-N)",12,10,0,0,22
1905790,1482330,2025-02-04,House,"Read third time and passed House (51-Y 48-N)",51,48,0,1,100
1905790,1489620,2025-02-13,Senate,"Reported from Education and Health with substitute and rereferred to Finance and Appropriations (9-Y 6-N)",9,6,0,0,15
1905790,1490116,2025-02-14,Senate,"Passed by indefinitely in Finance and Appropriations (13-Y 1-N)",13,1,0,1,15
1905791,1473489,2025-01-23,House,"Subcommittee recommends reporting with substitute (6-Y 0-N)",6,0,0,1,7
1905791,1474213,2025-01-24,House,"Reported from Public Safety with substitute (22-Y 0-N)",22,0,0,0,22
1905791,1478301,2025-01-30,House,"Read third time and passed House (96-Y 0-N)",96,0,0,4,100
1905791,1483858,2025-02-07,Senate,"Reported from Rehabilitation and Social Services with amendments (15-Y 0-N)",15,0,0,0,15
1905791,1485091,2025-02-10,Senate,"Constitutional reading dispensed (on 2nd reading) (39-Y 0-N)",39,0,0,1,40
1905791,1489058,2025-02-12,Senate,"Passed Senate with amendments (39-Y 0-N)",39,0,0,1,40
1905791,1490317,2025-02-14,House,"Senate Amendments agreed to by House (96-Y 0-N)",96,0,0,4,100
1905791,1536697,2025-04-02,House,"Passed by for the day (47-Y 46-N)",47,46,0,7,100
1905795,1474159,2025-01-23,House,"Subcommittee recommends reporting (8-Y 0-N)",8,0,0,1,9
1905795,1476029,2025-01-28,House,"Reported from General Laws (22-Y 0-N)",22,0,0,0,22
1905795,1479537,2025-02-03,House,"Read third time and passed House (98-Y 0-N)",98,0,0,2,100
1905795,1479538,2025-02-03,House,"Read third time and passed House (99-Y 0-N)",99,0,0,1,100
1905795,1488190,2025-02-12,Senate,"Reported from General Laws and Technology (14-Y 0-N)",14,0,0,1,15
1905795,1490537,2025-02-14,Senate,"Constitutional reading dispensed (on 2nd reading) (36-Y 0-N)",36,0,0,4,40
1905795,1491514,2025-02-17,Senate,"Passed Senate (39-Y 0-N)",39,0,0,1,40
1905796,1475857,2025-01-28,House,"Subcommittee recommends laying on the table (5-Y 3-N)",5,3,0,1,9
1905802,1474029,2025-01-23,House,"Subcommittee recommends laying on the table (7-Y 4-N)",7,4,0,0,11
1905803,1475314,2025-01-27,House,"Subcommittee recommends reporting with substitute (7-Y 1-N)",7,1,0,1,9
1905803,1477009,2025-01-29,House,"Reported from Courts of Justice with substitute (21-Y 1-N)",21,1,0,0,22
1905803,1482991,2025-02-04,House,"Read third time and passed House (98-Y 1-N)",98,1,0,1,100
1905803,1490865,2025-02-17,Senate,"Reported from Courts of Justice (15-Y 0-N)",15,0,0,0,15
1905803,1493816,2025-02-18,Senate,"Constitutional reading dispensed (on 2nd reading) (39-Y 0-N)",39,0,0,1,40
1905803,1493817,2025-02-19,Senate,"Passed Senate (40-Y 0-N)",40,0,0,0,40
1905803,1534748,2025-04-02,House,"VOTE: Pass by for the day - Adoption (47-Y 46-N)",47,46,0,7,100
1905806,1474126,2025-01-23,House,"Subcommittee recommends striking from the docket (7-Y 0-N)",7,0,0,2,9
1905807,1477233,2025-01-30,House,"Subcommittee recommends laying on the table (4-Y 2-N)",4,2,0,1,7
1905812,1475631,2025-01-28,House,"Subcommittee recommends reporting with substitute (8-Y 0-N)",8,0,0,1,9
1905812,1477660,2025-01-30,House,"Reported from General Laws with substitute (21-Y 0-N)",21,0,0,1,22
1905812,1482585,2025-02-04,House,"Read third time and passed House (89-Y 8-N)",89,8,0,3,100
1905812,1488115,2025-02-12,Senate,"Reported from General Laws and Technology and rereferred to Finance and Appropriations (14-Y 0-N)",14,0,0,1,15
1905813,1477175,2025-01-30,House,"Subcommittee recommends laying on the table (4-Y 2-N)",4,2,0,1,7
1905815,1472783,2025-01-21,House,"Subcommittee recommends reporting (8-Y 0-N)",8,0,0,1,9
1905815,1476357,2025-01-29,House,"Reported from Education with substitute (22-Y 0-N)",22,0,0,0,22
1905815,1480555,2025-02-04,House,"Read third time and passed House (97-Y 0-N)",97,0,0,3,100
1905815,1480556,2025-02-04,House,"Passed House (99-Y 0-N)",99,0,0,1,100
1905815,1489674,2025-02-13,Senate,"Reported from Education and Health with substitute (14-Y 0-N)",14,0,0,1,15
1905815,1491146,2025-02-17,Senate,"Constitutional reading dispensed (on 2nd reading)",39,0,0,1,40
1905815,1493114,2025-02-18,Senate,"Passed Senate with substitute (40-Y 0-N)",40,0,0,0,40
1905815,1495398,2025-02-19,House,"Senate substitute agreed to by House (97-Y 0-N)",97,0,0,3,100
1905817,1474326,2025-01-24,House,"Subcommittee recommends laying on the table (5-Y 3-N)",5,3,0,1,9
1905819,1473929,2025-01-23,House,"Subcommittee recommends laying on the table (4-Y 2-N)",4,2,0,1,7
1905821,1475040,2025-01-27,House,"Subcommittee failed to recommend reporting (2-Y 6-N)",2,6,0,1,9
1905822,1472499,2025-01-20,House,"Subcommittee recommends laying on the table (8-Y 0-N)",8,0,0,1,9
1905827,1475811,2025-01-28,House,"Subcommittee recommends reporting with substitute and referring to Appropriations (4-Y 3-N)",4,3,0,1,8
1905827,1477741,2025-01-30,House,"Reported from Labor and Commerce with substitute and referred to Appropriations (12-Y 10-N)",12,10,0,0,22
1905830,1476899,2025-01-29,House,"Subcommittee recommends reporting (4-Y 1-N)",4,1,0,4,9
1905830,1477242,2025-01-30,House,"Reported from Transportation (12-Y 10-N)",12,10,0,0,22
1905830,1482965,2025-02-04,House,"Read third time and passed House (65-Y 33-N)",65,33,0,2,100
1905830,1489597,2025-02-13,Senate,"Reported from Transportation (11-Y 3-N 1-A)",11,3,1,0,15
1905830,1491330,2025-02-17,Senate,"Constitutional reading dispensed (on 2nd reading) (39-Y 0-N)",39,0,0,1,40
1905830,1495033,2025-02-19,Senate,"Passed Senate (22-Y 17-N)",22,17,0,1,40
1905833,1473283,2025-01-22,House,"Subcommittee recommends reporting with substitute (8-Y 0-N)",8,0,0,1,9
1905833,1474675,2025-01-24,House,"Reported from Courts of Justice with substitute (22-Y 0-N)",22,0,0,0,22
1905833,1478143,2025-01-30,House,"Read third time and passed House (96-Y 0-N)",96,0,0,4,100
1905833,1484611,2025-02-10,Senate,"Reported from Courts of Justice (15-Y 0-N)",15,0,0,0,15
1905833,1485984,2025-02-11,Senate,"Constitutional reading dispensed (on 2nd reading) (40-Y 0-N)",40,0,0,0,40
1905833,1488036,2025-02-12,Senate,"Passed Senate (39-Y 0-N)",39,0,0,1,40
1905833,1534654,2025-04-02,Senate,"Senate concurred in Governor's recommendation (40-Y 0-N)",40,0,0,0,40
1905833,1536402,2025-04-02,House,"House concurred in Governor's recommendation (96-Y 0-N)",96,0,0,4,100
1905836,1476658,2025-01-29,House,"Subcommittee recommends reporting with substitute and referring to Appropriations (8-Y 0-N)",8,0,0,1,9
1905836,1477144,2025-01-30,House,"Reported from Health and Human Services with substitute and referred to Appropriations (21-Y 0-N)",21,0,0,1,22
1905836,1478183,2025-01-31,House,"Reported from Appropriations (22-Y 0-N)",22,0,0,0,22
1905836,1480621,2025-02-04,House,"Read third time and passed House (97-Y 0-N)",97,0,0,3,100
1905836,1480622,2025-02-04,House,"Passed House (99-Y 0-N)",99,0,0,1,100
1905836,1489646,2025-02-13,Senate,"Reported from Education and Health and rereferred to Finance and Appropriations (15-Y 0-N)",15,0,0,0,15
1905836,1492219,2025-02-17,Senate,"Reported from Finance and Appropriations with substitute (14-Y 0-N)",14,0,0,1,15
1905836,1493645,2025-02-19,Senate,"Constitutional reading dispensed (on 2nd reading) (40-Y 0-N)",40,0,0,0,40
1905836,1495938,2025-02-20,Senate,"Senate insisted on substitute (38-Y 0-N)",38,0,0,2,40
1905836,1496391,2025-02-20,Senate,"Passed Senate with substitute (39-Y 0-N)",39,0,0,1,40
1905836,1496392,2025-02-20,Senate,"Reconsideration of Senate passage agreed to by Senate (39-Y 0-N)",39,0,0,1,40
1905836,1496393,2025-02-20,Senate,"Passed Senate with substitute (39-Y 0-N)",39,0,0,1,40
1905836,1496813,2025-02-20,House,"Senate substitute rejected by House (0-Y 96-N)",0,96,0,4,100
1905836,1497157,2025-02-22,House,"Conference report agreed to by House (99-Y 0-N)",99,0,0,1,100
1905836,1503165,2025-02-22,Senate,"Conference report agreed to by Senate (40-Y 0-N)",40,0,0,0,40
1905846,1472391,2025-01-20,House,"Subcommittee recommends reporting (6-Y 2-N)",6,2,0,1,9
1905846,1474215,2025-01-24,House,"Reported from Privileges and Elections (20-Y 1-N)",20,1,0,1,22
1905846,1478611,2025-01-31,House,"Read third time and passed House (94-Y 1-N)",94,1,0,5,100
1905846,1486142,2025-02-11,Senate,"Passed by indefinitely in Privileges and Elections (8-Y 7-N)",8,7,0,0,15
1905847,1475595,2025-01-28,House,"Subcommittee recommends reporting (8-Y 0-N)",8,0,0,1,9
1905847,1477183,2025-01-30,House,"Reported from Transportation (22-Y 0-N)",22,0,0,0,22
1905847,1480049,2025-02-04,House,"Read third time and passed House (97-Y 0-N)",97,0,0,3,100
1905847,1480050,2025-02-04,House,"Passed House (99-Y 0-N)",99,0,0,1,100
1905847,1489588,2025-02-13,Senate,"Reported from Transportation (13-Y 0-N)",13,0,0,2,15
1905847,1492875,2025-02-17,Senate,"Constitutional reading dispensed (on 2nd reading)",39,0,0,1,40
1905847,1493178,2025-02-18,Senate,"Passed Senate (40-Y 0-N)",40,0,0,0,40
1905848,1472389,2025-01-20,House,"Subcommittee recommends laying on the table (6-Y 2-N)",6,2,0,1,9
1905850,1476028,2025-01-28,House,"Subcommittee recommends laying on the table (5-Y 2-N)",5,2,0,2,9
1905852,1475551,2025-01-27,House,"Subcommittee recommends reporting with substitute (8-Y 0-N)",8,0,0,1,9
1905852,1477023,2025-01-29,House,"Reported from Courts of Justice with substitute (22-Y 0-N)",22,0,0,0,22
1905852,1480785,2025-02-04,House,"Read third time and passed House (97-Y 0-N)",97,0,0,3,100
1905852,1480786,2025-02-04,House,"Passed House (99-Y 0-N)",99,0,0,1,100
1905852,1484694,2025-02-10,Senate,"Reported from Courts of Justice with substitute (15-Y 0-N)",15,0,0,0,15
1905852,1486126,2025-02-11,Senate,"Constitutional reading dispensed (on 2nd reading) (40-Y 0-N)",40,0,0,0,40
1905852,1489249,2025-02-12,Senate,"Passed Senate with substitute (39-Y 0-N)",39,0,0,1,40
1905852,1490011,2025-02-14,House,"Senate substitute rejected by House (0-Y 96-N)",0,96,0,4,100
1905852,1494009,2025-02-18,Senate,"Senate insisted on substitute (40-Y 0-N)",40,0,0,0,40
1905852,1496805,2025-02-21,Senate,"Conference report agreed to by Senate (38-Y 0-N)",38,0,0,2,40
1905852,1504070,2025-02-21,House,"Conference report agreed to by House (95-Y 1-N)",95,1,0,4,100
1905856,1475980,2025-01-28,House,"Subcommittee recommends laying on the table (5-Y 3-N)",5,3,0,1,9
1905857,1473132,2025-01-22,House,"Stricken from docket by Agriculture, Chesapeake and Natural Resources (22-Y 0-N)",22,0,0,0,22
1905859,1475086,2025-01-27,House,"Subcommittee recommends laying on the table (8-Y 2-N)",8,2,0,1,11
1905860,1473481,2025-01-23,House,"Subcommittee recommends reporting (8-Y 0-N)",8,0,0,1,9
1905860,1475633,2025-01-28,House,"Reported from Health and Human Services with amendment(s) (21-Y 0-N)",21,0,0,1,22
1905860,1479687,2025-02-03,House,"Read third time and passed House (98-Y 0-N)",98,0,0,2,100
1905860,1479688,2025-02-03,House,"Read third time and passed House (99-Y 0-N)",99,0,0,1,100
1905860,1489624,2025-02-13,Senate,"Reported from Education and Health (15-Y 0-N)",15,0,0,0,15
1905860,1491128,2025-02-17,Senate,"Constitutional reading dispensed (on 2nd reading)",39,0,0,1,40
1905860,1493097,2025-02-18,Senate,"Passed Senate (40-Y 0-N)",40,0,0,0,40
1905863,1474985,2025-01-27,House,"Subcommittee recommends laying on the table (4-Y 3-N)",4,3,0,2,9
1905864,1474704,2025-01-27,House,"Subcommittee recommends reporting with amendment(s) (8-Y 0-N)",8,0,0,1,9
1905864,1476738,2025-01-29,House,"Reported from Finance with amendment(s) (22-Y 0-N)",22,0,0,0,22
1905864,1480106,2025-02-04,House,"Read third time and passed House (97-Y 0-N)",97,0,0,3,100
1905864,1480107,2025-02-04,House,"Passed House (99-Y 0-N)",99,0,0,1,100
1905864,1486311,2025-02-11,Senate,"Reported from Finance and Appropriations (15-Y 0-N)",15,0,0,0,15
1905864,1486312,2025-02-11,Senate,"Constitutional reading dispensed (on 2nd reading) (40-Y 0-N)",40,0,0,0,40
1905864,1488169,2025-02-12,Senate,"Passed Senate (39-Y 0-N)",39,0,0,1,40
1905864,1535512,2025-04-02,House,"House concurred in Governor's recommendation (96-Y 0-N)",96,0,0,4,100
1905864,1535513,2025-04-02,Senate,"Senate concurred in Governor's recommendation (40-Y 0-N)",40,0,0,0,40
1905868,1472573,2025-01-21,House,"Subcommittee recommends reporting with amendment(s) (8-Y 0-N)",8,0,0,1,9
1905868,1472978,2025-01-22,House,"Reported from Education with amendment(s) (17-Y 5-N)",17,5,0,0,22
1905868,1476377,2025-01-28,House,"Read third time and passed House (57-Y 42-N)",57,42,0,1,100
1905868,1489611,2025-02-13,Senate,"Reported from Education and Health and rereferred to Finance and Appropriations (9-Y 6-N)",9,6,0,0,15
1905868,1492541,2025-02-17,Senate,"Reported from Finance and Appropriations (10-Y 4-N)",10,4,0,1,15
1905868,1494054,2025-02-19,Senate,"Constitutional reading dispensed (on 2nd reading) (40-Y 0-N)",40,0,0,0,40
1905868,1495135,2025-02-20,Senate,"Passed Senate (20-Y 19-N)",20,19,0,1,40
1905869,1475873,2025-01-28,House,"Subcommittee recommends laying on the table (5-Y 3-N)",5,3,0,1,9
1905870,1472742,2025-01-21,House,"Subcommittee recommends reporting and referred to Appropriations (8-Y 0-N)",8,0,0,1,9
1905870,1472938,2025-01-22,House,"Reported from Education (22-Y 0-N)",22,0,0,0,22
1905870,1476501,2025-01-28,House,"Read third time and passed House (77-Y 22-N)",77,22,0,1,100
1905870,1489637,2025-02-13,Senate,"Reported from Education and Health and rereferred to Finance and Appropriations (10-Y 5-N)",10,5,0,0,15
1905870,1492172,2025-02-17,Senate,"Passed by indefinitely in Finance and Appropriations (14-Y 0-N)",14,0,0,1,15
1905874,1477999,2025-01-31,House,"Subcommittee recommends striking from the docket (8-Y 0-N)",8,0,0,1,9
1905878,1475630,2025-01-28,House,"Subcommittee recommends laying on the table (5-Y 3-N)",5,3,0,1,9
1905881,1476094,2025-01-28,House,"Subcommittee recommends striking from the docket (7-Y 0-N)",7,0,0,1,8
1905884,1475064,2025-01-27,House,"Subcommittee recommends passing by indefinitely (5-Y 3-N)",5,3,0,1,9
1905886,1472751,2025-01-21,House,"Subcommittee recommends laying on the table (5-Y 2-N)",5,2,0,2,9
1905888,1475859,2025-01-28,House,"Subcommittee recommends reporting (5-Y 2-N)",5,2,0,1,8
1905888,1477680,2025-01-30,House,"Reported from Labor and Commerce with substitute (18-Y 4-N)",18,4,0,0,22
1905888,1480746,2025-02-04,House,"Read third time and passed House (88-Y 9-N)",88,9,0,3,100
1905888,1491361,2025-02-17,Senate,"Reported from Commerce and Labor (15-Y 0-N)",15,0,0,0,15
1905888,1493349,2025-02-18,Senate,"Constitutional reading dispensed (on 2nd reading) (40-Y 0-N)",40,0,0,0,40
1905888,1495702,2025-02-19,Senate,"Passed Senate (40-Y 0-N)",40,0,0,0,40
1905894,1474654,2025-01-27,House,"Subcommittee recommends reporting and referring to Appropriations (5-Y 4-N 1-A)",5,4,1,1,11
1905894,1474774,2025-01-27,House,"Reported from Communications, Technology and Innovation and referred to Appropriations (12-Y 10-N)",12,10,0,0,22
1905896,1472566,2025-01-21,House,"Subcommittee recommends reporting with amendment(s) (6-Y 1-N)",6,1,0,2,9
1905896,1472959,2025-01-22,House,"Reported from Education with amendment(s) (13-Y 9-N)",13,9,0,0,22
1905896,1476892,2025-01-28,House,"Read third time and passed House (53-Y 46-N)",53,46,0,1,100
1905896,1489671,2025-02-13,Senate,"Reported from Education and Health and rereferred to Finance and Appropriations (13-Y 2-N)",13,2,0,0,15
1905896,1492128,2025-02-17,Senate,"Reported from Finance and Appropriations with substitute (14-Y 0-N)",14,0,0,1,15
1905896,1493639,2025-02-19,Senate,"Constitutional reading dispensed (on 2nd reading) (40-Y 0-N)",40,0,0,0,40
1905896,1495916,2025-02-20,Senate,"Senate insisted on substitute (38-Y 0-N)",38,0,0,2,40
1905896,1496370,2025-02-20,Senate,"Passed Senate with substitute (37-Y 0-N)",37,0,0,3,40
1905896,1496804,2025-02-20,House,"Senate substitute rejected by House (0-Y 95-N)",0,95,0,5,100
1905896,1497155,2025-02-22,House,"Conference report agreed to by House (53-Y 42-N)",53,42,0,5,100
1905896,1503917,2025-02-22,Senate,"Conference report agreed to by Senate (40-Y 0-N)",40,0,0,0,40
1905898,1473993,2025-01-23,House,"Subcommittee recommends laying on the table (6-Y 4-N)",6,4,0,1,11
1905907,1473875,2025-01-23,House,"Subcommittee recommends reporting with substitute (5-Y 3-N)",5,3,0,3,11
1905907,1478013,2025-01-31,House,"Reported from Public Safety with substitute (12-Y 9-N)",12,9,0,1,22
1905907,1482421,2025-02-04,House,"Read third time and passed House (50-Y 47-N)",50,47,0,3,100
1905907,1488530,2025-02-12,Senate,"Reported from Courts of Justice with substitute and rereferred to Finance and Appropriations (9-Y 6-N)",9,6,0,0,15
1905907,1490155,2025-02-14,Senate,"Reported from Finance and Appropriations (10-Y 4-N)",10,4,0,1,15
1905907,1492173,2025-02-17,Senate,"Constitutional reading dispensed (on 2nd reading) (39-Y 0-N)",39,0,0,1,40
1905907,1493595,2025-02-19,Senate,"Passed Senate with substitute (21-Y 19-N)",21,19,0,0,40
1905907,1496789,2025-02-20,House,"Senate substitute agreed to by House (50-Y 47-N)",50,47,0,3,100
1905909,1473373,2025-01-22,House,"Subcommittee recommends striking from the docket (8-Y 0-N)",8,0,0,1,9
1905911,1474012,2025-01-24,House,"Subcommittee recommends reporting (8-Y 2-N)",8,2,0,1,11
1905911,1475818,2025-01-28,House,"Reported from Labor and Commerce (16-Y 6-N)",16,6,0,0,22
1905911,1479518,2025-02-03,House,"Read third time and passed House (78-Y 21-N)",78,21,0,1,100
1905911,1491354,2025-02-17,Senate,"Reported from Commerce and Labor with substitute (9-Y 6-N)",9,6,0,0,15
1905911,1493356,2025-02-18,Senate,"Constitutional reading dispensed (on 2nd reading) (40-Y 0-N)",40,0,0,0,40
1905911,1495734,2025-02-19,Senate,"Passed Senate with substitute (21-Y 18-N)",21,18,0,1,40
1905911,1496684,2025-02-20,House,"Senate substitute agreed to by House (53-Y 45-N)",53,45,0,2,100
1905914,1475455,2025-01-28,House,"Subcommittee recommends laying on the table (6-Y 2-N)",6,2,0,1,9
1905916,1473403,2025-01-22,House,"Subcommittee recommends reporting (8-Y 0-N)",8,0,0,1,9
1905916,1474650,2025-01-24,House,"Reported from Courts of Justice (22-Y 0-N)",22,0,0,0,22
1905916,1478059,2025-01-30,House,"Read third time and passed House (96-Y 0-N)",96,0,0,4,100
1905916,1488583,2025-02-12,Senate,"Reported from Courts of Justice (15-Y 0-N)",15,0,0,0,15
1905916,1490446,2025-02-14,Senate,"Constitutional reading dispensed (on 2nd reading) (36-Y 0-N)",36,0,0,4,40
1905916,1491409,2025-02-17,Senate,"Passed Senate (39-Y 0-N)",39,0,0,1,40
1905917,1476919,2025-01-29,House,"Subcommittee recommends laying on the table (5-Y 3-N)",5,3,0,1,9
1905920,1474662,2025-01-27,House,"Subcommittee recommends reporting with substitute (7-Y 3-N)",7,3,0,1,11
1905920,1475020,2025-01-27,House,"Reported from Communications, Technology and Innovation with substitute (12-Y 10-N)",12,10,0,0,22
1905920,1478274,2025-01-31,House,"Read third time and passed House (55-Y 41-N)",55,41,0,4,100
1905920,1490857,2025-02-17,Senate,"Reported from Courts of Justice with substitute (10-Y 5-N)",10,5,0,0,15
1905920,1492114,2025-02-18,Senate,"Constitutional reading dispensed (on 2nd reading) (39-Y 0-N)",39,0,0,1,40
1905920,1495908,2025-02-19,Senate,"Passed Senate with substitute (22-Y 17-N)",22,17,0,1,40
1905920,1496793,2025-02-20,House,"Senate substitute rejected by House (1-Y 97-N)",1,97,0,2,100
1905920,1496794,2025-02-20,Senate,"Senate insisted on substitute (39-Y 0-N)",39,0,0,1,40
1905921,1474050,2025-01-23,House,"Subcommittee recommends reporting with substitute (5-Y 2-N)",5,2,0,2,9
1905921,1475841,2025-01-28,House,"Reported from General Laws with substitute (13-Y 9-N)",13,9,0,0,22
1905921,1479547,2025-02-03,House,"Read third time and passed House (56-Y 43-N)",56,43,0,1,100
1905921,1486347,2025-02-11,Senate,"Reported from Finance and Appropriations (15-Y 0-N)",15,0,0,0,15
1905921,1486348,2025-02-11,Senate,"Constitutional reading dispensed (on 2nd reading) (40-Y 0-N)",40,0,0,0,40
1905921,1488204,2025-02-12,Senate,"Passed Senate (39-Y 0-N)",39,0,0,1,40
1905929,1475871,2025-01-28,House,"Subcommittee recommends reporting with substitute (5-Y 3-N)",5,3,0,1,9
1905929,1476764,2025-01-29,House,"Reported from Education with substitute (12-Y 10-N)",12,10,0,0,22
1905929,1480797,2025-02-04,House,"Read third time and passed House (57-Y 41-N)",57,41,0,2,100
1905929,1489511,2025-02-13,Senate,"Reported from Education and Health with substitute (15-Y 0-N)",15,0,0,0,15
1905929,1491001,2025-02-17,Senate,"Constitutional reading dispensed (on 2nd reading)",39,0,0,1,40
1905929,1492301,2025-02-18,Senate,"Committee substitute reconsidered (40-Y 0-N)",40,0,0,0,40
1905929,1492302,2025-02-18,Senate,"Passed Senate (40-Y 0-N)",40,0,0,0,40
1905931,1472350,2025-01-20,House,"Subcommittee recommends reporting (8-Y 0-N)",8,0,0,1,9
1905931,1474734,2025-01-24,House,"Reported from Courts of Justice (21-Y 1-N)",21,1,0,0,22
1905931,1484625,2025-02-10,Senate,"Reported from Courts of Justice and rereferred to Finance and Appropriations (14-Y 0-N 1-A)",14,0,1,0,15
1905931,1490241,2025-02-14,Senate,"Reported from Finance and Appropriations (14-Y 0-N)",14,0,0,1,15
1905931,1491034,2025-02-17,Senate,"Constitutional reading dispensed (on 2nd reading) (39-Y 0-N)",39,0,0,1,40
1905931,1493700,2025-02-19,Senate,"Passed Senate (37-Y 3-N)",37,3,0,0,40
1905931,1564925,2025-01-30,House,"Read third time and passed House (94-Y 2-N)",94,2,0,4,100
1905933,1474034,2025-01-23,House,"Subcommittee recommends reporting with substitute (7-Y 3-N)",7,3,0,1,11
1905933,1475781,2025-01-28,House,"Reported from Labor and Commerce with substitute (14-Y 8-N)",14,8,0,0,22
1905933,1479524,2025-02-03,House,"Read third time and passed House (57-Y 41-N)",57,41,0,2,100
1905933,1484943,2025-02-10,Senate,"Reported from Commerce and Labor with substitute (9-Y 6-N)",9,6,0,0,15
1905933,1487932,2025-02-12,Senate,"Constitutional reading dispensed (on 2nd reading) (39-Y 0-N)",39,0,0,1,40
1905933,1488831,2025-02-13,Senate,"Passed Senate with substitute (20-Y 17-N)",20,17,0,3,40
1905933,1490848,2025-02-17,House,"Senate substitute agreed to by House (58-Y 38-N)",58,38,0,4,100
1905933,1534901,2025-04-02,House,"House concurred in Governor's recommendation (85-Y 9-N)",85,9,0,6,100
1905933,1534902,2025-04-02,Senate,"Senate concurred in Governor's recommendation (40-Y 0-N)",40,0,0,0,40
1905936,1474323,2025-01-24,House,"Subcommittee recommends reporting (8-Y 0-N)",8,0,0,1,9
1905936,1476711,2025-01-29,House,"Reported from Courts of Justice with substitute (22-Y 0-N)",22,0,0,0,22
1905936,1479561,2025-02-04,House,"Read third time and passed House (97-Y 0-N)",97,0,0,3,100
1905936,1479562,2025-02-04,House,"Passed House (99-Y 0-N)",99,0,0,1,100
1905936,1490834,2025-02-17,Senate,"Reported from Courts of Justice with amendments (15-Y 0-N)",15,0,0,0,15
1905936,1492022,2025-02-18,Senate,"Constitutional reading dispensed (on 2nd reading) (39-Y 0-N)",39,0,0,1,40
1905936,1495221,2025-02-19,Senate,"Passed Senate with amendments (40-Y 0-N)",40,0,0,0,40
1905936,1496770,2025-02-20,House,"Senate Amendments agreed to by House (97-Y 0-N)",97,0,0,3,100
1905940,1472554,2025-01-21,House,"Subcommittee recommends reporting and referred to Appropriations (7-Y 1-N)",7,1,0,1,9
1905940,1473045,2025-01-22,House,"Reported from Education and referred to Appropriations (17-Y 4-N 1-A)",17,4,1,0,22
1905940,1474400,2025-01-24,House,"Subcommittee recommends laying on the table (8-Y 0-N)",8,0,0,1,9
1905942,1475445,2025-01-28,House,"Subcommittee recommends reporting with substitute and referring to Appropriations (8-Y 0-N)",8,0,0,1,9
1905942,1477223,2025-01-30,House,"Reported from Health and Human Services with substitute and referred to Appropriations (21-Y 0-N)",21,0,0,1,22
1905942,1478204,2025-01-31,House,"Reported from Appropriations (22-Y 0-N)",22,0,0,0,22
1905942,1480735,2025-02-04,House,"Read third time and passed House (97-Y 0-N)",97,0,0,3,100
1905942,1480736,2025-02-04,House,"Passed House (99-Y 0-N)",99,0,0,1,100
1905942,1489522,2025-02-13,Senate,"Reported from Education and Health and rereferred to Finance and Appropriations (15-Y 0-N)",15,0,0,0,15
1905942,1490117,2025-02-14,Senate,"Reported from Finance and Appropriations (14-Y 0-N)",14,0,0,1,15
1905942,1492025,2025-02-17,Senate,"Constitutional reading dispensed (on 2nd reading) (39-Y 0-N)",39,0,0,1,40
1905942,1492026,2025-02-18,Senate,"Passed Senate (40-Y 0-N)",40,0,0,0,40
1905943,1473455,2025-01-23,House,"Subcommittee recommends reporting (7-Y 1-N)",7,1,0,1,9
1905943,1474254,2025-01-24,House,"Reported from Counties, Cities and Towns (12-Y 8-N)",12,8,0,2,22
1905943,1491325,2025-02-17,Senate,"Failed to report (defeated) in Commerce and Labor (7-Y 7-N 1-A)",7,7,1,0,15
1905943,1564828,2025-01-30,House,"Read third time and passed House (48-Y 46-N)",48,46,0,6,100
1905945,1474756,2025-01-27,House,"Subcommittee recommends laying on the table (5-Y 3-N)",5,3,0,1,9
1905947,1476675,2025-01-29,House,"Tabled in Rules (14-Y 0-N)",14,0,0,4,18
1905949,1474990,2025-01-27,House,"Subcommittee recommends laying on the table (10-Y 0-N)",10,0,0,1,11
1905952,1474003,2025-01-24,House,"Subcommittee recommends reporting with substitute (7-Y 3-N)",7,3,0,1,11
1905952,1475926,2025-01-28,House,"Reported from Labor and Commerce with substitute (16-Y 6-N)",16,6,0,0,22
1905952,1479821,2025-02-03,House,"Read third time and passed House (71-Y 27-N)",71,27,0,2,100
1905952,1485269,2025-02-10,Senate,"Reported from Commerce and Labor with substitute (9-Y 6-N)",9,6,0,0,15
1905952,1487915,2025-02-12,Senate,"Constitutional reading dispensed (on 2nd reading) (39-Y 0-N)",39,0,0,1,40
1905952,1488816,2025-02-13,Senate,"Passed Senate with substitute (21-Y 19-N)",21,19,0,0,40
1905952,1490854,2025-02-17,House,"Senate substitute agreed to by House (68-Y 27-N 1-A)",68,27,1,4,100
1905952,1536717,2025-04-02,House,"House rejected Governor's recommendation (10-Y 85-N)",10,85,0,5,100
1905952,1536718,2025-04-02,House,"Motion to pass in enrolled form rejected (53-Y 41-N)",53,41,0,6,100
1905953,1472432,2025-01-20,House,"Subcommittee recommends laying on the table (7-Y 3-N)",7,3,0,1,11
1905956,1473139,2025-01-22,House,"Subcommittee recommends striking from the docket (8-Y 0-N)",8,0,0,1,9
1905956,1474497,2025-01-24,House,"Stricken from docket by Appropriations (22-Y 0-N)",22,0,0,0,22
1905959,1475011,2025-01-27,House,"Subcommittee failed to recommend reporting (4-Y 4-N)",4,4,0,1,9
1905961,1475272,2025-01-28,House,"Subcommittee recommends reporting with substitute (8-Y 0-N)",8,0,0,1,9
1905961,1476680,2025-01-29,House,"Reported from Education with substitute (22-Y 0-N)",22,0,0,0,22
1905961,1480703,2025-02-04,House,"Read third time and passed House (97-Y 0-N)",97,0,0,3,100
1905961,1480704,2025-02-04,House,"Passed House (99-Y 0-N)",99,0,0,1,100
1905961,1489693,2025-02-13,Senate,"Reported from Education and Health with substitute and rereferred to Finance and Appropriations (14-Y 0-N 1-A)",14,0,1,0,15
1905961,1492133,2025-02-17,Senate,"Passed by indefinitely in Finance and Appropriations (13-Y 0-N 1-A)",13,0,1,1,15
1905965,1472910,2025-01-22,House,"Subcommittee recommends reporting with amendment(s) (7-Y 2-N)",7,2,0,2,11
1905965,1474804,2025-01-27,House,"Reported from Communications, Technology and Innovation with amendment(s) and referred to Appropriations (12-Y 10-N)",12,10,0,0,22
1905967,1474755,2025-01-27,House,"Subcommittee recommends reporting with amendment(s) (8-Y 2-N)",8,2,0,1,11
1905967,1476853,2025-01-29,House,"Reported from Education with amendment(s) (20-Y 2-N)",20,2,0,0,22
1905967,1482553,2025-02-04,House,"Read third time and passed House (95-Y 4-N)",95,4,0,1,100
1905967,1489317,2025-02-13,Senate,"Reported from Education and Health and rereferred to Finance and Appropriations (15-Y 0-N)",15,0,0,0,15
1905967,1490489,2025-02-14,Senate,"Reported from Finance and Appropriations (14-Y 0-N)",14,0,0,1,15
1905967,1490943,2025-02-17,Senate,"Constitutional reading dispensed (on 2nd reading) (39-Y 0-N)",39,0,0,1,40
1905967,1494424,2025-02-18,Senate,"Passed Senate (40-Y 0-N)",40,0,0,0,40
1905970,1472894,2025-01-22,House,"Subcommittee recommends reporting (8-Y 0-N)",8,0,0,1,9
1905970,1474315,2025-01-24,House,"Reported from Counties, Cities and Towns (20-Y 0-N)",20,0,0,2,22
1905970,1478396,2025-01-30,House,"Read third time and passed House (96-Y 0-N)",96,0,0,4,100
1905970,1485082,2025-02-10,Senate,"Reported from Local Government (14-Y 0-N)",14,0,0,1,15
1905970,1486461,2025-02-11,Senate,"Constitutional reading dispensed (on 2nd reading) (40-Y 0-N)",40,0,0,0,40
1905970,1487769,2025-02-12,Senate,"Passed Senate (39-Y 0-N)",39,0,0,1,40
1905970,1536360,2025-04-02,House,"House concurred in Governor's recommendation (96-Y 0-N)",96,0,0,4,100
1905970,1536361,2025-04-02,Senate,"Senate concurred in Governor's recommendation (40-Y 0-N)",40,0,0,0,40
1905971,1476705,2025-01-29,House,"Subcommittee recommends reporting and referring to Appropriations (8-Y 0-N)",8,0,0,1,9
1905971,1477745,2025-01-30,House,"Reported from Health and Human Services and referred to Appropriations (21-Y 0-N)",21,0,0,1,22
1905971,1478351,2025-01-31,House,"Reported from Appropriations (22-Y 0-N)",22,0,0,0,22
1905971,1479942,2025-02-04,House,"Read third time and passed House (97-Y 0-N)",97,0,0,3,100
1905971,1479943,2025-02-04,House,"Passed House (99-Y 0-N)",99,0,0,1,100
1905971,1489545,2025-02-13,Senate,"Reported from Education and Health with amendment and rereferred to Finance and Appropriations (15-Y 0-N)",15,0,0,0,15
1905971,1490496,2025-02-14,Senate,"Reported from Finance and Appropriations (14-Y 0-N)",14,0,0,1,15
1905971,1491348,2025-02-17,Senate,"Constitutional reading dispensed (on 2nd reading) (39-Y 0-N)",39,0,0,1,40
1905971,1491997,2025-02-18,Senate,"Passed Senate with amendment (40-Y 0-N)",40,0,0,0,40
1905971,1493364,2025-02-19,House,"Senate Amendment agreed to by House (97-Y 0-N)",97,0,0,3,100
1905971,1535458,2025-04-02,House,"House rejected Governor's recommendation (18-Y 78-N)",18,78,0,4,100
1905971,1535459,2025-04-02,House,"Passed in enrolled form (93-Y 0-N)",93,0,0,7,100
1905973,1475999,2025-01-28,House,"Subcommittee recommends laying on the table (5-Y 3-N)",5,3,0,1,9
1905975,1477046,2025-01-29,House,"Subcommittee failed to recommend reporting (3-Y 4-N)",3,4,0,2,9
1905976,1472785,2025-01-21,House,"Subcommittee recommends reporting (6-Y 2-N)",6,2,0,1,9
1905976,1473019,2025-01-22,House,"Reported from Education (12-Y 10-N)",12,10,0,0,22
1905976,1476735,2025-01-28,House,"Read third time and passed House (52-Y 46-N)",52,46,0,2,100
1905976,1483130,2025-02-06,Senate,"Reported from Education and Health (14-Y 0-N)",14,0,0,1,15
1905976,1483887,2025-02-07,Senate,"Constitutional reading dispensed (on 2nd reading) (38-Y 0-N)",38,0,0,2,40
1905976,1487597,2025-02-12,Senate,"Passed Senate (39-Y 0-N)",39,0,0,1,40
1905976,1536109,2025-04-02,House,"Passed by for the day (47-Y 46-N)",47,46,0,7,100
1905979,1474698,2025-01-27,House,"Subcommittee recommends reporting with substitute (5-Y 3-N)",5,3,0,1,9
1905979,1476340,2025-01-29,House,"Reported from Finance with substitute (15-Y 7-N)",15,7,0,0,22
1905979,1482834,2025-02-04,House,"Read third time and passed House (74-Y 25-N)",74,25,0,1,100
1905979,1486185,2025-02-11,Senate,"Reported from Finance and Appropriations (15-Y 0-N)",15,0,0,0,15
1905979,1486186,2025-02-11,Senate,"Constitutional reading dispensed (on 2nd reading) (40-Y 0-N)",40,0,0,0,40
1905979,1487635,2025-02-12,Senate,"Passed Senate (35-Y 4-N)",35,4,0,1,40
1905980,1475052,2025-01-27,House,"Subcommittee recommends reporting with amendment(s) (9-Y 0-N)",9,0,0,2,11
1905980,1476345,2025-01-29,House,"Reported from Agriculture, Chesapeake and Natural Resources with amendment(s) (22-Y 0-N)",22,0,0,0,22
1905980,1479648,2025-02-04,House,"Read third time and passed House (97-Y 0-N)",97,0,0,3,100
1905980,1479651,2025-02-04,House,"Passed House (99-Y 0-N)",99,0,0,1,100
1905980,1486589,2025-02-11,Senate,"Reported from Agriculture, Conservation and Natural Resources with substitute (15-Y 0-N)",15,0,0,0,15
1905980,1490048,2025-02-13,Senate,"Constitutional reading dispensed (on 2nd reading) (40-Y 0-N)",40,0,0,0,40
1905980,1490049,2025-02-14,Senate,"Passed Senate with substitute (36-Y 0-N)",36,0,0,4,40
1905980,1491921,2025-02-18,House,"Senate substitute agreed to by House (97-Y 0-N)",97,0,0,3,100
1905982,1475238,2025-01-28,House,"Subcommittee recommends striking from the docket (8-Y 0-N)",8,0,0,1,9
1905983,1475231,2025-01-27,House,"Subcommittee recommends reporting (8-Y 0-N)",8,0,0,1,9
1905983,1476693,2025-01-29,House,"Reported from Courts of Justice (22-Y 0-N)",22,0,0,0,22
1905983,1480743,2025-02-04,House,"Read third time and passed House (97-Y 0-N)",97,0,0,3,100
1905983,1480744,2025-02-04,House,"Passed House (99-Y 0-N)",99,0,0,1,100
1905983,1484749,2025-02-10,Senate,"Reported from Courts of Justice (12-Y 0-N)",12,0,0,3,15
1905983,1486024,2025-02-11,Senate,"Constitutional reading dispensed (on 2nd reading) (40-Y 0-N)",40,0,0,0,40
1905983,1488705,2025-02-12,Senate,"Passed Senate (39-Y 0-N)",39,0,0,1,40
1905986,1472897,2025-01-22,House,"Subcommittee recommends reporting and referred to Appropriations (8-Y 0-N)",8,0,0,1,9
1905986,1476157,2025-01-29,House,"Reported from Education and referred to Appropriations (22-Y 0-N)",22,0,0,0,22
1905986,1476903,2025-01-29,House,"Subcommittee recommends laying on the table (7-Y 0-N)",7,0,0,2,9
1905988,1474187,2025-01-24,House,"Subcommittee recommends striking from the docket (8-Y 0-N)",8,0,0,1,9
1905989,1472527,2025-01-20,House,"Subcommittee recommends reporting (8-Y 0-N)",8,0,0,1,9
1905989,1473366,2025-01-22,House,"Reported from Appropriations (22-Y 0-N)",22,0,0,0,22
1905989,1476650,2025-01-28,House,"Read third time and passed House (99-Y 0-N)",99,0,0,1,100
1905989,1482583,2025-02-05,Senate,"Reported from Finance and Appropriations (13-Y 0-N)",13,0,0,2,15
1905989,1483263,2025-02-06,Senate,"Constitutional reading dispensed (on 2nd reading) (40-Y 0-N)",40,0,0,0,40
1905989,1484068,2025-02-07,Senate,"Passed Senate (39-Y 0-N)",39,0,0,1,40
1905991,1476684,2025-01-29,House,"Subcommittee recommends reporting with substitute and referring to Appropriations (8-Y 0-N)",8,0,0,1,9
1905991,1477103,2025-01-30,House,"Reported from Health and Human Services with substitute and referred to Appropriations (20-Y 0-N 1-A)",20,0,1,1,22
1905991,1478193,2025-01-31,House,"Tabled in Appropriations (12-Y 10-N)",12,10,0,0,22
1905993,1476720,2025-01-29,House,"Subcommittee recommends reporting with substitute (8-Y 0-N)",8,0,0,1,9
1905993,1477754,2025-01-30,House,"Reported from Health and Human Services with substitute (20-Y 1-N)",20,1,0,1,22
1905993,1482682,2025-02-04,House,"Read third time and passed House (98-Y 0-N)",98,0,0,2,100
1905993,1489823,2025-02-13,Senate,"Reported from Education and Health (15-Y 0-N)",15,0,0,0,15
1905993,1491848,2025-02-17,Senate,"Constitutional reading dispensed (on 2nd reading)",39,0,0,1,40
1905993,1493221,2025-02-18,Senate,"Passed Senate (40-Y 0-N)",40,0,0,0,40
1905999,1476372,2025-01-29,House,"Reported from Agriculture, Chesapeake and Natural Resources with substitute (13-Y 9-N)",13,9,0,0,22
1906001,1474148,2025-01-23,House,"Subcommittee recommends laying on the table (5-Y 3-N)",5,3,0,1,9
1906002,1475313,2025-01-27,House,"Subcommittee recommends reporting with amendment(s) (8-Y 0-N)",8,0,0,1,9
1906002,1476859,2025-01-29,House,"Reported from Courts of Justice with amendment(s) (22-Y 0-N)",22,0,0,0,22
1906002,1479569,2025-02-04,House,"Read third time and passed House (97-Y 0-N)",97,0,0,3,100
1906002,1479570,2025-02-04,House,"Passed House (99-Y 0-N)",99,0,0,1,100
1906002,1488507,2025-02-12,Senate,"Reported from Courts of Justice (15-Y 0-N)",15,0,0,0,15
1906002,1490218,2025-02-14,Senate,"Constitutional reading dispensed (on 2nd reading) (36-Y 0-N)",36,0,0,4,40
1906002,1491084,2025-02-17,Senate,"Passed Senate (39-Y 0-N)",39,0,0,1,40
1906004,1475068,2025-01-27,House,"Subcommittee recommends striking from the docket (8-Y 0-N)",8,0,0,1,9
1907240,1477731,2025-01-30,House,"Subcommittee recommends reporting with amendment(s) (8-Y 0-N)",8,0,0,1,9
1907240,1477732,2025-01-30,House,"Reported from General Laws with amendment(s) (21-Y 0-N)",21,0,0,1,22
1907240,1482302,2025-02-04,House,"Read third time and passed House (97-Y 0-N)",97,0,0,3,100
1907240,1482303,2025-02-04,House,"Passed House (99-Y 0-N)",99,0,0,1,100
1907240,1488144,2025-02-12,Senate,"Rereferred from General Laws and Technology to Transportation (10-Y 0-N)",10,0,0,5,15
1907240,1489798,2025-02-13,Senate,"Reported from Transportation (13-Y 0-N)",13,0,0,2,15
1907240,1491446,2025-02-17,Senate,"Constitutional reading dispensed (on 2nd reading)",39,0,0,1,40
1907240,1492569,2025-02-18,Senate,"Passed Senate (40-Y 0-N)",40,0,0,0,40
1907242,1475838,2025-01-28,House,"Subcommittee recommends reporting (7-Y 0-N)",7,0,0,1,8
1907242,1477691,2025-01-30,House,"Reported from Labor and Commerce (22-Y 0-N)",22,0,0,0,22
1907242,1480750,2025-02-04,House,"Read third time and passed House (97-Y 0-N)",97,0,0,3,100
1907242,1480751,2025-02-04,House,"Passed House (99-Y 0-N)",99,0,0,1,100
1907242,1491340,2025-02-17,Senate,"Reported from Commerce and Labor (15-Y 0-N)",15,0,0,0,15
1907242,1493296,2025-02-18,Senate,"Constitutional reading dispensed (on 2nd reading) (40-Y 0-N)",40,0,0,0,40
1907242,1495654,2025-02-19,Senate,"Passed Senate (40-Y 0-N)",40,0,0,0,40
1907248,1475043,2025-01-27,House,"Subcommittee recommends passing by indefinitely (6-Y 2-N)",6,2,0,1,9
1907253,1475897,2025-01-28,House,"Subcommittee recommends reporting (8-Y 0-N)",8,0,0,1,9
1907253,1477923,2025-01-30,House,"Reported from General Laws (21-Y 0-N)",21,0,0,1,22
1907253,1480104,2025-02-04,House,"Read third time and passed House (86-Y 12-N)",86,12,0,2,100
1907253,1488554,2025-02-12,Senate,"Reported from General Laws and Technology (13-Y 1-N 1-A)",13,1,1,0,15
1907253,1490022,2025-02-14,Senate,"Constitutional reading dispensed (on 2nd reading) (36-Y 0-N)",36,0,0,4,40
1907253,1492715,2025-02-18,Senate,"Passed Senate (21-Y 19-N)",21,19,0,0,40
1907253,1535270,2025-04-02,House,"House concurred in Governor's recommendation (89-Y 7-N)",89,7,0,4,100
1907253,1535271,2025-04-02,Senate,"Senate concurred in Governor's recommendation (30-Y 8-N)",30,8,0,2,40
1907263,1475912,2025-01-28,House,"Subcommittee recommends reporting with substitute (8-Y 0-N)",8,0,0,1,9
1907263,1477657,2025-01-30,House,"Reported from General Laws with substitute and referred to Appropriations (21-Y 0-N)",21,0,0,1,22
1907269,1475635,2025-01-28,House,"Subcommittee recommends reporting with substitute (5-Y 3-N)",5,3,0,1,9
1907269,1477924,2025-01-30,House,"Reported from General Laws with substitute (12-Y 9-N)",12,9,0,1,22
1907269,1482148,2025-02-04,House,"Read third time and passed House (55-Y 43-N)",55,43,0,2,100
1907269,1488375,2025-02-12,Senate,"Reported from General Laws and Technology with amendment and rereferred to Finance and Appropriations (9-Y 6-N)",9,6,0,0,15
1907269,1492545,2025-02-17,Senate,"Reported from Finance and Appropriations (10-Y 4-N)",10,4,0,1,15
1907269,1494018,2025-02-19,Senate,"Constitutional reading dispensed (on 2nd reading) (40-Y 0-N)",40,0,0,0,40
1907269,1495731,2025-02-20,Senate,"Passed Senate with amendment (20-Y 19-N)",20,19,0,1,40
1907269,1495732,2025-02-20,House,"Senate Amendment agreed to by House (51-Y 44-N)",51,44,0,5,100
1907276,1476095,2025-01-28,House,"Subcommittee recommends reporting and referring to Appropriations (5-Y 2-N)",5,2,0,1,8
1907276,1477951,2025-01-30,House,"Reported from Labor and Commerce and referred to Appropriations (13-Y 9-N)",13,9,0,0,22
1907281,1473198,2025-01-22,House,"Subcommittee recommends striking from the docket (10-Y 0-N)",10,0,0,1,11
1907290,1473752,2025-01-23,House,"Subcommittee recommends laying on the table (5-Y 3-N)",5,3,0,1,9
1907299,1475200,2025-01-27,House,"Subcommittee recommends laying on the table (5-Y 3-N)",5,3,0,1,9
1907303,1476070,2025-01-28,House,"Stricken from docket by General Laws (22-Y 0-N)",22,0,0,0,22
1907309,1476072,2025-01-28,House,"Subcommittee recommends laying on the table (5-Y 1-N)",5,1,0,3,9
1907316,1475007,2025-01-27,House,"Subcommittee recommends reporting with substitute with amendment(s) (10-Y 0-N)",10,0,0,1,11
1907316,1476354,2025-01-29,House,"Reported from Agriculture, Chesapeake and Natural Resources with substitute (21-Y 1-N)",21,1,0,0,22
1907316,1482418,2025-02-04,House,"Read third time and passed House (82-Y 17-N)",82,17,0,1,100
1907316,1486635,2025-02-11,Senate,"Reported from Agriculture, Conservation and Natural Resources with amendments (15-Y 0-N)",15,0,0,0,15
1907316,1490085,2025-02-13,Senate,"Constitutional reading dispensed (on 2nd reading) (40-Y 0-N)",40,0,0,0,40
1907316,1490086,2025-02-14,Senate,"Passed Senate with amendments (36-Y 0-N)",36,0,0,4,40
1907316,1492007,2025-02-18,House,"Senate Amendments agreed to by House (94-Y 3-N)",94,3,0,3,100
1907321,1474189,2025-01-24,House,"Subcommittee recommends laying on the table (5-Y 3-N)",5,3,0,1,9
1907325,1474502,2025-01-24,House,"Subcommittee recommends reporting (7-Y 0-N)",7,0,0,2,9
1907325,1475177,2025-01-27,House,"Reported from Appropriations (22-Y 0-N)",22,0,0,0,22
1907325,1478249,2025-01-31,House,"Read third time and passed House (96-Y 0-N)",96,0,0,4,100
1907325,1487421,2025-02-12,Senate,"Reported from Finance and Appropriations (15-Y 0-N)",15,0,0,0,15
1907325,1489064,2025-02-13,Senate,"Constitutional reading dispensed (on 2nd reading) (40-Y 0-N)",40,0,0,0,40
1907325,1490319,2025-02-14,Senate,"Passed Senate (36-Y 0-N)",36,0,0,4,40
1907333,1473434,2025-01-22,House,"Subcommittee recommends laying on the table (6-Y 4-N)",6,4,0,1,11
1907339,1475036,2025-01-27,House,"Subcommittee recommends reporting (8-Y 0-N)",8,0,0,1,9
1907339,1478015,2025-01-31,House,"Reported from Privileges and Elections (21-Y 0-N)",21,0,0,1,22
1907339,1479657,2025-02-04,House,"Read third time and passed House (78-Y 19-N)",78,19,0,3,100
1907339,1486216,2025-02-11,Senate,"Passed by indefinitely in Privileges and Elections (8-Y 7-N)",8,7,0,0,15
1907358,1477301,2025-01-30,House,"Subcommittee recommends reporting (5-Y 3-N)",5,3,0,1,9
1907358,1477794,2025-01-30,House,"Reported from Labor and Commerce (12-Y 10-N)",12,10,0,0,22
1907358,1481749,2025-02-04,House,"Read third time and passed House (54-Y 44-N)",54,44,0,2,100
1907358,1485349,2025-02-10,Senate,"Passed by indefinitely in Commerce and Labor (10-Y 5-N)",10,5,0,0,15
1907372,1475846,2025-01-28,House,"Subcommittee recommends reporting with substitute and referring to Appropriations (6-Y 4-N)",6,4,0,1,11
1907372,1477671,2025-01-30,House,"Reported from Labor and Commerce with substitute and referred to Appropriations (12-Y 10-N)",12,10,0,0,22
1907372,1478321,2025-01-31,House,"Reported from Appropriations (12-Y 10-N)",12,10,0,0,22
1907372,1482376,2025-02-04,House,"Read third time and passed House (52-Y 46-N)",52,46,0,2,100
1907372,1485302,2025-02-10,Senate,"Reported from Commerce and Labor and rereferred to Finance and Appropriations (9-Y 6-N)",9,6,0,0,15
1907372,1492206,2025-02-17,Senate,"Passed by indefinitely in Finance and Appropriations (13-Y 0-N 1-A)",13,0,1,1,15
1907375,1476030,2025-01-28,House,"Subcommittee recommends reporting with substitute (8-Y 0-N)",8,0,0,1,9
1907375,1477930,2025-01-30,House,"Reported from General Laws with substitute (21-Y 0-N)",21,0,0,1,22
1907375,1482416,2025-02-04,House,"Read third time and passed House (97-Y 0-N)",97,0,0,3,100
1907375,1482417,2025-02-04,House,"Passed House (99-Y 0-N)",99,0,0,1,100
1907375,1488559,2025-02-12,Senate,"Reported from General Laws and Technology (9-Y 6-N)",9,6,0,0,15
1907375,1490606,2025-02-14,Senate,"Constitutional reading dispensed (on 2nd reading) (36-Y 0-N)",36,0,0,4,40
1907375,1492649,2025-02-18,Senate,"Passed Senate (24-Y 13-N)",24,13,0,3,40
1907375,1492650,2025-02-18,Senate,"Reconsideration of Senate passage agreed to by Senate (39-Y 0-N)",39,1,0,0,40
1907375,1492651,2025-02-18,Senate,"Passed Senate (30-Y 7-N)",30,7,0,3,40
1907389,1477656,2025-01-30,House,"Subcommittee recommends laying on the table (3-Y 2-N)",3,2,0,1,6
1907393,1475073,2025-01-27,House,"Subcommittee recommends laying on the table (8-Y 0-N)",8,0,0,1,9
1907399,1476987,2025-01-29,House,"Tabled in Rules (13-Y 0-N)",13,0,0,5,18
1907406,1474972,2025-01-24,House,"Stricken from docket by Courts of Justice (22-Y 0-N)",22,0,0,0,22
1907427,1478115,2025-01-31,House,"Reported from Privileges and Elections (19-Y 2-N)",19,2,0,1,22
1907427,1482423,2025-02-04,House,"Read third time and passed House (80-Y 18-N)",80,18,0,2,100
1907427,1486220,2025-02-11,Senate,"Reported from Privileges and Elections with substitute (8-Y 7-N)",8,7,0,0,15
1907427,1488950,2025-02-13,Senate,"Constitutional reading dispensed (on 2nd reading) (40-Y 0-N)",40,0,0,0,40
1907427,1490242,2025-02-14,Senate,"Passed Senate with substitute (23-Y 13-N)",23,13,0,4,40
1907427,1492375,2025-02-18,House,"Senate substitute rejected by House (0-Y 96-N)",0,96,0,4,100
1907427,1493776,2025-02-19,Senate,"Senate insisted on substitute (38-Y 2-N)",38,2,0,0,40
1907427,1497208,2025-02-22,House,"Conference report agreed to by House (76-Y 22-N)",76,22,0,2,100
1907427,1504005,2025-02-22,Senate,"Conference report agreed to by Senate (23-Y 17-N)",23,17,0,0,40
1907433,1475002,2025-01-27,House,"Subcommittee recommends reporting (9-Y 0-N)",9,0,0,2,11
1907433,1476383,2025-01-29,House,"Reported from Agriculture, Chesapeake and Natural Resources (22-Y 0-N)",22,0,0,0,22
1907433,1480576,2025-02-04,House,"Read third time and passed House (97-Y 0-N)",97,0,0,3,100
1907433,1480577,2025-02-04,House,"Passed House (99-Y 0-N)",99,0,0,1,100
1907433,1486664,2025-02-11,Senate,"Reported from Agriculture, Conservation and Natural Resources and rereferred to Finance and Appropriations (15-Y 0-N)",15,0,0,0,15
1907433,1492200,2025-02-17,Senate,"Reported from Finance and Appropriations (14-Y 0-N)",14,0,0,1,15
1907433,1493632,2025-02-19,Senate,"Constitutional reading dispensed (on 2nd reading) (40-Y 0-N)",40,0,0,0,40
1907433,1496398,2025-02-20,Senate,"Passed Senate (39-Y 0-N)",39,0,0,1,40
1907433,1496399,2025-02-20,Senate,"Reconsideration of Senate passage agreed to by Senate (39-Y 0-N)",39,0,0,1,40
1907433,1496400,2025-02-20,Senate,"Passed Senate (39-Y 0-N)",39,0,0,1,40
1907442,1477739,2025-01-30,House,"Subcommittee recommends striking from the docket (5-Y 0-N)",5,0,0,1,6
1907448,1473412,2025-01-22,House,"Subcommittee recommends laying on the table (8-Y 0-N)",8,0,0,1,9
1907464,1473201,2025-01-22,House,"Subcommittee recommends striking from the docket (10-Y 0-N)",10,0,0,1,11
1907469,1474653,2025-01-27,House,"Subcommittee recommends striking from the docket (8-Y 0-N)",8,0,0,1,9
1907482,1474413,2025-01-24,House,"Subcommittee recommends reporting with substitute and referring to Appropriations (5-Y 1-N)",5,1,0,1,7
1907482,1475600,2025-01-28,House,"Reported from General Laws with substitute and referred to Appropriations (14-Y 8-N)",14,8,0,0,22
1907482,1476404,2025-01-29,House,"Subcommittee recommends reporting (5-Y 3-N)",5,3,0,1,9
1907482,1476809,2025-01-29,House,"Reported from Appropriations (13-Y 8-N)",13,8,0,1,22
1907482,1480585,2025-02-04,House,"Read third time and passed House (53-Y 46-N)",53,46,0,1,100
1907482,1483868,2025-02-07,Senate,"Reported from Rehabilitation and Social Services and rereferred to Finance and Appropriations (8-Y 6-N)",8,6,0,1,15
1907482,1485845,2025-02-11,Senate,"Reported from Finance and Appropriations (10-Y 5-N)",10,5,0,0,15
1907482,1486208,2025-02-11,Senate,"Constitutional reading dispensed (on 2nd reading) (40-Y 0-N)",40,0,0,0,40
1907482,1488915,2025-02-12,Senate,"Passed Senate (21-Y 18-N)",21,18,0,1,40
1907488,1474673,2025-01-27,House,"Subcommittee recommends striking from the docket (8-Y 0-N)",8,0,0,1,9
1907493,1473231,2025-01-22,House,"Subcommittee recommends laying on the table (6-Y 4-N)",6,4,0,1,11
1907500,1475972,2025-01-28,House,"Subcommittee recommends reporting (8-Y 0-N)",8,0,0,1,9
1907500,1477216,2025-01-30,House,"Reported from Transportation (22-Y 0-N)",22,0,0,0,22
1907500,1479944,2025-02-04,House,"Read third time and passed House (97-Y 0-N)",97,0,0,3,100
1907500,1479945,2025-02-04,House,"Passed House (99-Y 0-N)",99,0,0,1,100
1907500,1489484,2025-02-13,Senate,"Reported from Transportation with substitute and rereferred to Finance and Appropriations (14-Y 0-N)",14,0,0,1,15
1907500,1490173,2025-02-14,Senate,"Reported from Finance and Appropriations (14-Y 0-N)",14,0,0,1,15
1907500,1490999,2025-02-17,Senate,"Constitutional reading dispensed (on 2nd reading) (39-Y 0-N)",39,0,0,1,40
1907500,1492229,2025-02-18,Senate,"Passed Senate with substitute (40-Y 0-N)",40,0,0,0,40
1907500,1493706,2025-02-19,House,"Senate substitute agreed to by House (97-Y 0-N)",97,0,0,3,100
1907500,1535441,2025-04-02,Senate,"Senate concurred in Governor's recommendation (39-Y 1-N)",39,1,0,0,40
1907500,1536664,2025-04-02,House,"House concurred in Governor's recommendation (96-Y 0-N)",96,0,0,4,100
1907504,1472779,2025-01-21,House,"Subcommittee recommends reporting and referred to Appropriations (8-Y 0-N)",8,0,0,1,9
1907504,1473026,2025-01-22,House,"Reported from Education and referred to Appropriations (22-Y 0-N)",22,0,0,0,22
1907504,1474500,2025-01-24,House,"Subcommittee recommends reporting (8-Y 0-N)",8,0,0,1,9
1907504,1475178,2025-01-27,House,"Reported from Appropriations (21-Y 0-N)",21,0,0,1,22
1907504,1478426,2025-01-31,House,"Read third time and passed House (96-Y 0-N)",96,0,0,4,100
1907504,1483123,2025-02-06,Senate,"Reported from Education and Health and rereferred to Finance and Appropriations (14-Y 0-N)",14,0,0,1,15
1907504,1488259,2025-02-12,Senate,"Passed by indefinitely in Finance and Appropriations (15-Y 0-N)",15,0,0,0,15
1907508,1477787,2025-01-30,House,"Subcommittee recommends reporting with substitute (3-Y 2-N)",3,2,0,1,6
1907508,1477788,2025-01-30,House,"Reported from Labor and Commerce with substitute (12-Y 9-N)",12,9,0,1,22
1907508,1482436,2025-02-04,House,"Read third time and passed House (51-Y 47-N)",51,47,0,2,100
1907508,1488142,2025-02-12,Senate,"Reported from General Laws and Technology (10-Y 5-N)",10,5,0,0,15
1907508,1490283,2025-02-14,Senate,"Constitutional reading dispensed (on 2nd reading) (36-Y 0-N)",36,0,0,4,40
1907508,1492384,2025-02-18,Senate,"Passed Senate (25-Y 15-N)",25,15,0,0,40
1907508,1536650,2025-04-02,House,"House rejected Governor's recommendation (30-Y 65-N)",30,65,0,5,100
1907519,1473473,2025-01-23,House,"Subcommittee recommends reporting (8-Y 0-N)",8,0,0,1,9
1907519,1475629,2025-01-28,House,"Reported from Health and Human Services (21-Y 0-N)",21,0,0,1,22
1907519,1479649,2025-02-03,House,"Read third time and passed House (98-Y 0-N)",98,0,0,2,100
1907519,1479650,2025-02-03,House,"Read third time and passed House (99-Y 0-N)",99,0,0,1,100
1907519,1489526,2025-02-13,Senate,"Reported from Education and Health (15-Y 0-N)",15,0,0,0,15
1907519,1491076,2025-02-17,Senate,"Constitutional reading dispensed (on 2nd reading)",39,0,0,1,40
1907519,1493068,2025-02-18,Senate,"Passed Senate (40-Y 0-N)",40,0,0,0,40
1907529,1475904,2025-01-28,House,"Subcommittee recommends laying on the table (5-Y 0-N)",5,0,0,4,9
1907532,1477084,2025-01-30,House,"Subcommittee recommends reporting with substitute (4-Y 2-N)",4,2,0,1,7
1907532,1478303,2025-01-31,House,"Reported from Public Safety with substitute (18-Y 3-N)",18,3,0,1,22
1907532,1482410,2025-02-04,House,"Read third time and passed House (93-Y 3-N)",93,3,0,4,100
1907532,1488012,2025-02-12,Senate,"Reported from General Laws and Technology and rereferred to Finance and Appropriations (11-Y 2-N 2-A)",11,2,2,0,15
1907532,1492181,2025-02-17,Senate,"Reported from Finance and Appropriations with substitute (14-Y 0-N)",14,0,0,1,15
1907532,1493596,2025-02-19,Senate,"Constitutional reading dispensed (on 2nd reading) (40-Y 0-N)",40,0,0,0,40
1907532,1495901,2025-02-20,House,"Senate substitute rejected by House (0-Y 95-N)",0,95,0,5,100
1907532,1495902,2025-02-20,Senate,"Senate insisted on substitute (38-Y 0-N)",38,0,0,2,40
1907532,1496335,2025-02-20,Senate,"Passed Senate with substitute (39-Y 0-N)",39,0,0,1,40
1907532,1497148,2025-02-21,Senate,"Conference report agreed to by Senate (39-Y 0-N)",39,0,0,1,40
1907532,1497149,2025-02-22,House,"Conference report agreed to by House (49-Y 47-N)",49,47,0,4,100
1907532,1535318,2025-04-02,House,"House rejected Governor's recommendation (35-Y 61-N)",35,61,0,4,100
1907532,1535319,2025-04-02,House,"Motion to pass in enrolled form rejected (51-Y 44-N)",51,44,0,5,100
1907859,1475823,2025-01-28,House,"Subcommittee recommends reporting (6-Y 0-N)",6,0,0,5,11
1907859,1477755,2025-01-30,House,"Tabled in Labor and Commerce (16-Y 6-N)",16,6,0,0,22
1908254,1475428,2025-01-28,House,"Subcommittee recommends laying on the table (8-Y 0-N)",8,0,0,1,9
1908403,1474027,2025-01-23,House,"Subcommittee recommends reporting and referring to Appropriations (6-Y 3-N)",6,3,0,0,9
1908403,1475793,2025-01-28,House,"Reported from Labor and Commerce and referred to Appropriations (12-Y 10-N)",12,10,0,0,22
1908403,1478170,2025-01-31,House,"Reported from Appropriations with substitute (12-Y 10-N)",12,10,0,0,22
1908403,1482468,2025-02-04,House,"Read third time and passed House (51-Y 47-N)",51,47,0,2,100
1908403,1485430,2025-02-10,Senate,"Reported from Commerce and Labor and rereferred to Finance and Appropriations (9-Y 6-N)",9,6,0,0,15
1908403,1485959,2025-02-11,Senate,"Reported from Finance and Appropriations (10-Y 5-N)",10,5,0,0,15
1908403,1485960,2025-02-11,Senate,"Constitutional reading dispensed (on 2nd reading) (40-Y 0-N)",40,0,0,0,40
1908403,1489022,2025-02-12,Senate,"Passed Senate (22-Y 17-N)",22,17,0,1,40
1908403,1489023,2025-02-12,Senate,"Reconsideration of Senate passage agreed to by Senate (39-Y 0-N)",39,0,0,1,40
1908403,1489024,2025-02-12,Senate,"Passed Senate (21-Y 18-N)",21,18,0,1,40
1908403,1536564,2025-04-02,House,"House sustained Governor's veto (50-Y 46-N)",50,46,0,4,100
1908535,1473729,2025-01-23,House,"Subcommittee recommends reporting with substitute (8-Y 0-N)",8,0,0,1,9
1908535,1474307,2025-01-24,House,"Reported from Counties, Cities and Towns with substitute (20-Y 0-N)",20,0,0,2,22
1908535,1478220,2025-01-30,House,"Read third time and passed House (96-Y 0-N)",96,0,0,4,100
1908535,1484566,2025-02-10,Senate,"Reported from Local Government with substitute (12-Y 3-N)",12,3,0,0,15
1908535,1486160,2025-02-11,Senate,"Constitutional reading dispensed (on 2nd reading) (40-Y 0-N)",40,0,0,0,40
1908535,1488834,2025-02-12,Senate,"Passed Senate with substitute (25-Y 13-N)",25,13,0,2,40
1908535,1490142,2025-02-14,House,"Senate substitute agreed to by House (96-Y 0-N)",96,0,0,4,100
1908552,1473386,2025-01-22,House,"Subcommittee recommends reporting (8-Y 0-N)",8,0,0,1,9
1908552,1474729,2025-01-24,House,"Reported from Courts of Justice (22-Y 0-N)",22,0,0,0,22
1908552,1478144,2025-01-30,House,"Read third time and passed House (96-Y 0-N)",96,0,0,4,100
1908552,1490836,2025-02-17,Senate,"Reported from Courts of Justice (15-Y 0-N)",15,0,0,0,15
1908552,1493188,2025-02-18,Senate,"Constitutional reading dispensed (on 2nd reading) (39-Y 0-N)",39,0,0,1,40
1908552,1494971,2025-02-19,Senate,"Passed Senate (40-Y 0-N)",40,0,0,0,40
1908606,1475992,2025-01-28,House,"Subcommittee recommends reporting with substitute (8-Y 2-N)",8,2,0,1,11
1908606,1477698,2025-01-30,House,"Reported from Labor and Commerce with substitute (17-Y 5-N)",17,5,0,0,22
1908606,1480729,2025-02-04,House,"Read third time and passed House (54-Y 44-N)",54,44,0,2,100
1908606,1484993,2025-02-10,Senate,"Reported from Commerce and Labor with substitute and rereferred to Finance and Appropriations (9-Y 6-N)",9,6,0,0,15
1908606,1491735,2025-02-17,Senate,"Reported from Finance and Appropriations (10-Y 4-N)",10,4,0,1,15
1908606,1493686,2025-02-19,Senate,"Constitutional reading dispensed (on 2nd reading) (40-Y 0-N)",40,0,0,0,40
1908606,1496381,2025-02-20,Senate,"Passed Senate with substitute (20-Y 19-N)",20,19,0,1,40
1908606,1496807,2025-02-20,House,"Senate substitute agreed to by House (56-Y 40-N)",56,40,0,4,100
1908606,1535092,2025-04-02,House,"House rejected Governor's recommendation (47-Y 49-N)",47,49,0,4,100
1908641,1475234,2025-01-27,House,"Subcommittee recommends striking from the docket (8-Y 0-N)",8,0,0,1,9
1908699,1473943,2025-01-23,House,"Subcommittee recommends reporting with substitute (8-Y 0-N)",8,0,0,1,9
1908699,1475607,2025-01-28,House,"Reported from Health and Human Services with substitute (21-Y 0-N)",21,0,0,1,22
1908699,1479429,2025-02-03,House,"Read third time and passed House (98-Y 0-N)",98,0,0,2,100
1908699,1479430,2025-02-03,House,"Read third time and passed House (99-Y 0-N)",99,0,0,1,100
1908699,1489543,2025-02-13,Senate,"Reported from Education and Health (13-Y 0-N)",13,0,0,2,15
1908699,1491102,2025-02-17,Senate,"Constitutional reading dispensed (on 2nd reading)",39,0,0,1,40
1908699,1493063,2025-02-18,Senate,"Passed Senate (40-Y 0-N)",40,0,0,0,40
1909084,1473245,2025-01-22,House,"Subcommittee recommends reporting and referred to Appropriations (6-Y 2-N)",6,2,0,1,9
1909084,1476605,2025-01-29,House,"Reported from Education with amendment(s) (15-Y 7-N)",15,7,0,0,22
1909084,1480626,2025-02-04,House,"Read third time and passed House (71-Y 28-N)",71,28,0,1,100
1909084,1489556,2025-02-13,Senate,"Reported from Education and Health with substitute and rereferred to Finance and Appropriations (15-Y 0-N)",15,0,0,0,15
1909084,1492193,2025-02-17,Senate,"Passed by indefinitely in Finance and Appropriations with letter (14-Y 0-N)",14,0,0,1,15
1910236,1473932,2025-01-23,House,"Subcommittee recommends reporting and referring to Appropriations (8-Y 0-N)",8,0,0,1,9
1910236,1475605,2025-01-28,House,"Reported from Health and Human Services and referred to Appropriations (21-Y 0-N)",21,0,0,1,22
1910236,1476604,2025-01-29,House,"Subcommittee recommends reporting (6-Y 0-N)",6,0,0,3,9
1910236,1478277,2025-01-31,House,"Reported from Appropriations (22-Y 0-N)",22,0,0,0,22
1910236,1482169,2025-02-04,House,"Read third time and passed House (97-Y 0-N)",97,0,0,3,100
1910236,1482170,2025-02-04,House,"Passed House (99-Y 0-N)",99,0,0,1,100
1910236,1489540,2025-02-13,Senate,"Reported from Education and Health with amendment and rereferred to Finance and Appropriations (15-Y 0-N)",15,0,0,0,15
1910236,1492197,2025-02-17,Senate,"Reported from Finance and Appropriations (14-Y 0-N)",14,0,0,1,15
1910236,1493634,2025-02-19,Senate,"Constitutional reading dispensed (on 2nd reading) (40-Y 0-N)",40,0,0,0,40
1910236,1496363,2025-02-20,Senate,"Passed Senate with amendment (39-Y 0-N)",39,0,0,1,40
1910236,1496364,2025-02-20,Senate,"Reconsideration of Senate passage agreed to by Senate (39-Y 0-N)",39,0,0,1,40
1910236,1496365,2025-02-20,Senate,"Passed Senate with amendment (39-Y 0-N)",39,0,0,1,40
1910236,1496787,2025-02-20,House,"Senate Amendment agreed to by House (95-Y 1-N)",95,1,0,4,100
1910308,1474125,2025-01-23,House,"Subcommittee recommends laying on the table (5-Y 3-N)",5,3,0,1,9
1910378,1478296,2025-01-31,House,"Reported from Finance (18-Y 1-N)",18,1,0,3,22
1910378,1482898,2025-02-04,House,"Read third time and passed House (90-Y 7-N)",90,7,0,3,100
1910378,1486035,2025-02-11,Senate,"Passed by indefinitely in Finance and Appropriations (15-Y 0-N)",15,0,0,0,15
1910451,1473348,2025-01-22,House,"Subcommittee recommends reporting with amendment(s) (8-Y 0-N)",8,0,0,1,9
1910451,1474270,2025-01-24,House,"Reported from Appropriations with amendment(s) (22-Y 0-N)",22,0,0,0,22
1910451,1478234,2025-01-30,House,"Read third time and passed House (90-Y 6-N)",90,6,0,4,100
1910451,1480477,2025-02-05,Senate,"Reported from Finance and Appropriations (13-Y 0-N)",13,0,0,2,15
1910451,1483238,2025-02-06,Senate,"Constitutional reading dispensed (on 2nd reading) (40-Y 0-N)",40,0,0,0,40
1910451,1483959,2025-02-07,Senate,"Passed Senate (39-Y 0-N)",39,0,0,1,40
1910526,1472565,2025-01-21,House,"Subcommittee recommends reporting (8-Y 0-N)",8,0,0,1,9
1910526,1473326,2025-01-22,House,"Reported from Education (22-Y 0-N)",22,0,0,0,22
1910526,1476817,2025-01-29,House,"Read third time and passed House (97-Y 0-N)",97,0,0,3,100
1910526,1483111,2025-02-06,Senate,"Reported from Education and Health (14-Y 0-N)",14,0,0,1,15
1910526,1483871,2025-02-07,Senate,"Constitutional reading dispensed (on 1st reading) (38-Y 0-N)",38,0,0,2,40
1910526,1486270,2025-02-10,Senate,"Passed Senate (39-Y 0-N)",39,0,0,1,40
1910526,1535341,2025-04-02,Senate,"Senate concurred in Governor's recommendation (40-Y 0-N)",40,0,0,0,40
1910526,1536581,2025-04-02,House,"House concurred in Governor's recommendation (96-Y 0-N)",96,0,0,4,100
1910597,1472914,2025-01-22,House,"Subcommittee recommends reporting with substitute and referring to Appropriations (9-Y 0-N)",9,0,0,2,11
1910597,1475131,2025-01-27,House,"Reported from Communications, Technology and Innovation with substitute and referred to Appropriations (19-Y 3-N)",19,3,0,0,22
1910597,1478412,2025-01-31,House,"Reported from Appropriations with substitute (22-Y 0-N)",22,0,0,0,22
1910597,1480862,2025-02-04,House,"Read third time and passed House (98-Y 0-N)",98,0,0,2,100
1910597,1488315,2025-02-12,Senate,"Reported from General Laws and Technology with amendments and rereferred to Finance and Appropriations (15-Y 0-N)",15,0,0,0,15
1910597,1492020,2025-02-17,Senate,"Reported from Finance and Appropriations (14-Y 0-N)",14,0,0,1,15
1910597,1495799,2025-02-19,Senate,"Constitutional reading dispensed (on 2nd reading) (40-Y 0-N)",40,0,0,0,40
1910597,1495800,2025-02-20,House,"Senate Amendments agreed to by House (96-Y 0-N)",96,0,0,4,100
1910597,1496268,2025-02-20,Senate,"Passed Senate with amendments (39-Y 0-N)",39,0,0,1,40
1910597,1496269,2025-02-20,Senate,"Reconsideration of Senate passage agreed to by Senate (39-Y 0-N)",39,0,0,1,40
1910597,1496270,2025-02-20,Senate,"Passed Senate with amendments (39-Y 0-N)",39,0,0,1,40
1910678,1472215,2025-01-17,Senate,"Passed by indefinitely in Courts of Justice (9-Y 6-N)",9,6,0,0,15
1910682,1474106,2025-01-16,Senate,"Reported from Transportation and rereferred to Finance and Appropriations (12-Y 0-N)",12,0,0,3,15
1910682,1475422,2025-01-28,Senate,"Passed by indefinitely in Finance and Appropriations (11-Y 4-N)",11,4,0,0,15
1910686,1472279,2025-01-17,Senate,"Reported from Courts of Justice with substitute and rereferred to Finance and Appropriations (8-Y 6-N 1-A)",8,6,1,0,15
1910686,1473679,2025-01-22,Senate,"Reported from Finance and Appropriations (10-Y 5-N)",10,5,0,0,15
1910686,1473680,2025-01-23,Senate,"Constitutional reading dispensed (on 1st reading) (39-Y 0-N)",39,0,0,1,40
1910686,1475003,2025-01-27,Senate,"Read third time and passed Senate (19-Y 19-N)",19,19,0,2,40
1910686,1475004,2025-01-27,Senate,"Reconsideration of passage agreed to by Senate",37,1,0,2,40
1910686,1475005,2025-01-27,Senate,"Passed Senate (20-Y 18-N)",20,18,0,2,40
1910686,1484241,2025-02-07,House,"Reported from Public Safety (11-Y 10-N)",11,10,0,1,22
1910686,1487644,2025-02-12,House,"Passed House (51-Y 46-N)",51,46,0,3,100
1910690,1474053,2025-01-23,Senate,"Reported from Transportation with substitute and rereferred to Courts of Justice (13-Y 0-N 1-A)",13,0,1,1,15
1910690,1478640,2025-02-03,Senate,"Reported from Courts of Justice with substitute (13-Y 1-N 1-A)",13,1,1,0,15
1910690,1479728,2025-02-04,Senate,"Constitutional reading dispensed (on 1st reading) (40-Y 0-N)",40,0,0,0,40
1910690,1479729,2025-02-04,Senate,"Constitutional reading dispensed (on 3rd reading) (40-Y 0-N)",40,0,0,0,40
1910690,1479730,2025-02-04,Senate,"Passed Senate (40-Y 0-N)",40,0,0,0,40
1910695,1475126,2025-01-27,Senate,"Reported from Commerce and Labor with amendment and rereferred to Finance and Appropriations (9-Y 6-N)",9,6,0,0,15
1910695,1477961,2025-01-30,Senate,"Reported from Finance and Appropriations (10-Y 5-N)",10,5,0,0,15
1910695,1480220,2025-02-04,Senate,"Constitutional reading dispensed (on 3rd reading) (40-Y 0-N)",40,0,0,0,40
1910695,1480221,2025-02-04,Senate,"Passed Senate (21-Y 17-N)",21,17,0,2,40
1910695,1480430,2025-02-03,Senate,"Constitutional reading dispensed (on 1st reading) (40-Y 0-N)",40,0,0,0,40
1910695,1486381,2025-02-11,House,"Subcommittee recommends reporting (5-Y 4-N)",5,4,0,2,11
1910695,1489432,2025-02-13,House,"Reported from Labor and Commerce (12-Y 9-N)",12,9,0,1,22
1910695,1491864,2025-02-18,House,"Passed House (53-Y 44-N)",53,44,0,3,100
1910701,1472498,2025-01-20,Senate,"Reported from Commerce and Labor (9-Y 6-N)",9,6,0,0,15
1910701,1472977,2025-01-22,Senate,"Constitutional reading dispensed (on 1st reading) (40-Y 0-N)",40,0,0,0,40
1910701,1477060,2025-01-28,Senate,"Read third time and passed Senate (21-Y 18-N)",21,18,0,1,40
1910701,1486851,2025-02-11,House,"Subcommittee recommends reporting (5-Y 3-N)",5,3,0,1,9
1910701,1489636,2025-02-13,House,"Reported from Labor and Commerce (12-Y 10-N)",12,10,0,0,22
1910701,1491895,2025-02-18,House,"Passed House (49-Y 47-N 1-A)",49,47,1,3,100
1910712,1476517,2025-01-29,Senate,"Reported from General Laws and Technology (12-Y 3-N)",12,3,0,0,15
1910712,1478602,2025-01-31,Senate,"Constitutional reading dispensed (on 1st reading) (39-Y 0-N)",39,0,0,1,40
1910712,1480823,2025-02-04,Senate,"Read third time and passed Senate (35-Y 5-N)",35,5,0,0,40
1910712,1490763,2025-02-17,House,"Subcommittee recommends laying on the table (6-Y 4-N)",6,4,0,1,11
1910716,1472495,2025-01-20,Senate,"Failed to report (defeated) in Commerce and Labor (3-Y 11-N)",3,11,0,1,15
1910716,1479371,2025-02-03,Senate,"Reported from Commerce and Labor with substitute (8-Y 7-N)",8,7,0,0,15
1910716,1479748,2025-02-04,Senate,"Constitutional reading dispensed (on 1st reading) (40-Y 0-N)",40,0,0,0,40
1910716,1479749,2025-02-04,Senate,"Constitutional reading dispensed (on 3rd reading) (40-Y 0-N)",40,0,0,0,40
1910716,1479750,2025-02-04,Senate,"Passed Senate (34-Y 6-N)",34,6,0,0,40
1910716,1489812,2025-02-13,House,"Reported from Labor and Commerce (17-Y 5-N)",17,5,0,0,22
1910716,1491822,2025-02-18,House,"Passed House (80-Y 17-N)",80,17,0,3,100
1910723,1475852,2025-01-28,Senate,"Rereferred from Agriculture, Conservation and Natural Resources to Courts of Justice (13-Y 1-N)",13,1,0,1,15
1910723,1478636,2025-02-03,Senate,"Reported from Courts of Justice with substitute (13-Y 0-N)",13,0,0,2,15
1910723,1479676,2025-02-04,Senate,"Constitutional reading dispensed (on 1st reading) (40-Y 0-N)",40,0,0,0,40
1910723,1479677,2025-02-04,Senate,"Constitutional reading dispensed (on 3rd reading) (40-Y 0-N)",40,0,0,0,40
1910723,1479678,2025-02-04,Senate,"Passed Senate (39-Y 0-N)",39,0,0,1,40
1910723,1487390,2025-02-12,House,"Reported from Agriculture, Chesapeake and Natural Resources (15-Y 7-N)",15,7,0,0,22
1910723,1491078,2025-02-17,House,"Passed House (63-Y 32-N)",63,32,0,5,100
1910723,1536687,2025-04-02,Senate,"Senate concurred in Governor's recommendation (40-Y 0-N)",40,0,0,0,40
1910723,1536688,2025-04-02,House,"House concurred in Governor's recommendation (75-Y 16-N)",75,16,0,9,100
1910729,1475294,2025-01-28,Senate,"Reported from Education and Health and rereferred to Finance and Appropriations (15-Y 0-N)",15,0,0,0,15
1910729,1477649,2025-01-30,Senate,"Stricken at request of Patron in Finance and Appropriations (15-Y 0-N)",15,0,0,0,15
1910733,1473513,2025-01-23,Senate,"Reported from Education and Health (15-Y 0-N)",15,0,0,0,15
1910733,1474390,2025-01-24,Senate,"Constitutional reading dispensed (on 1st reading) (37-Y 0-N)",37,0,0,3,40
1910733,1477068,2025-01-28,Senate,"Read third time and passed Senate (39-Y 0-N)",39,0,0,1,40
1910733,1483142,2025-02-06,House,"Subcommittee recommends reporting (8-Y 0-N)",8,0,0,1,9
1910733,1483143,2025-02-06,House,"Reported from Health and Human Services (22-Y 0-N)",22,0,0,0,22
1910733,1490775,2025-02-17,House,"Reported from Rules (17-Y 1-N)",17,1,0,0,18
1910733,1495706,2025-02-20,House,"Passed House (86-Y 10-N)",86,10,0,4,100
1910737,1473518,2025-01-23,Senate,"Reported from Education and Health (15-Y 0-N)",15,0,0,0,15
1910737,1474585,2025-01-24,Senate,"Constitutional reading dispensed (on 1st reading) (37-Y 0-N)",37,0,0,3,40
1910737,1476983,2025-01-28,Senate,"Read third time and passed Senate (39-Y 0-N)",39,0,0,1,40
1910737,1483264,2025-02-06,House,"Reported from Health and Human Services (22-Y 0-N)",22,0,0,0,22
1910737,1487315,2025-02-11,House,"Passed House (94-Y 0-N)",94,0,0,6,100
1910746,1473511,2025-01-23,Senate,"Reported from Education and Health with amendment and rereferred to Finance and Appropriations (15-Y 0-N)",15,0,0,0,15
1910746,1477148,2025-01-29,Senate,"Reported from Finance and Appropriations (15-Y 0-N)",15,0,0,0,15
1910746,1477520,2025-01-30,Senate,"Constitutional reading dispensed (on 1st reading) (39-Y 0-N 1-A)",39,0,1,0,40
1910746,1479273,2025-01-31,Senate,"Constitutional reading dispensed (on 3rd reading) (40-Y 0-N)",40,0,0,0,40
1910746,1479274,2025-01-31,Senate,"Passed Senate (40-Y 0-N)",40,0,0,0,40
1910746,1484572,2025-02-10,House,"Subcommittee recommends reporting with amendment(s) (10-Y 0-N)",10,0,0,1,11
1910746,1487346,2025-02-12,House,"Reported from Education with amendment(s) and referred to Appropriations (21-Y 0-N)",21,0,0,1,22
1910746,1490170,2025-02-14,House,"Reported from Appropriations (21-Y 0-N)",21,0,0,1,22
1910746,1495272,2025-02-19,House,"Passed House with amendments (97-Y 0-N)",97,0,0,3,100
1910746,1495935,2025-02-20,Senate,"Senate acceded to request (38-Y 0-N)",38,0,0,2,40
1910746,1497159,2025-02-21,Senate,"Conference report agreed to by Senate (40-Y 0-N)",40,0,0,0,40
1910746,1503869,2025-02-21,House,"Conference report agreed to by House (95-Y 0-N)",95,0,0,5,100
1910746,1564848,2025-02-20,Senate,"House Amendments rejected by Senate (0-Y 39-N)",0,39,0,1,40
1910751,1473528,2025-01-23,Senate,"Passed by indefinitely in Education and Health (9-Y 6-N)",9,6,0,0,15
1910755,1476819,2025-01-28,Senate,"Reported from Agriculture, Conservation and Natural Resources (14-Y 0-N)",14,0,0,1,15
1910755,1478162,2025-01-30,Senate,"Constitutional reading dispensed (on 1st reading) (39-Y 0-N 1-A)",39,0,1,0,40
1910755,1479206,2025-01-31,Senate,"Constitutional reading dispensed (on 3rd reading) (40-Y 0-N)",40,0,0,0,40
1910755,1479207,2025-01-31,Senate,"Passed Senate (40-Y 0-N)",40,0,0,0,40
1910755,1487385,2025-02-12,House,"Reported from Agriculture, Chesapeake and Natural Resources (14-Y 8-N)",14,8,0,0,22
1910755,1491083,2025-02-17,House,"Passed House (92-Y 4-N)",92,4,0,4,100
1910768,1473236,2025-01-22,Senate,"Reported from General Laws and Technology with amendment and rereferred to Finance and Appropriations (15-Y 0-N)",15,0,0,0,15
1910768,1477781,2025-01-29,Senate,"Passed by indefinitely in Finance and Appropriations (13-Y 1-N)",13,1,0,1,15
1910773,1473801,2025-01-23,Senate,"Reported from Education and Health (9-Y 6-N)",9,6,0,0,15
1910773,1474634,2025-01-24,Senate,"Constitutional reading dispensed (on 1st reading) (37-Y 0-N)",37,0,0,3,40
1910773,1476572,2025-01-28,Senate,"Read third time and passed Senate (19-Y 19-N)",19,19,0,2,40
1910773,1476573,2025-01-28,Senate,"Reconsideration of passage agreed to by Senate (39-Y 0-N)",39,0,0,1,40
1910773,1476574,2025-01-28,Senate,"Passed Senate (21-Y 18-N)",21,18,0,1,40
1910773,1485902,2025-02-11,House,"Reported from Health and Human Services with substitute (15-Y 7-N)",15,7,0,0,22
1910773,1490303,2025-02-14,House,"Passed House with substitute (54-Y 41-N)",54,41,0,5,100
1910773,1493152,2025-02-18,Senate,"House substitute agreed to by Senate (21-Y 19-N)",21,19,0,0,40
1910773,1536725,2025-04-02,Senate,"Senate rejected Governor's recommendation (19-Y 21-N)",19,21,0,0,40
1910780,1473938,2025-01-17,Senate,"Reported from Rules and rereferred to Finance and Appropriations (15-Y 0-N)",15,0,0,0,15
1910780,1474551,2025-01-23,Senate,"Reported from Finance and Appropriations with amendment (13-Y 0-N)",13,0,0,2,15
1910780,1475933,2025-01-27,Senate,"Constitutional reading dispensed (on 1st reading) (36-Y 0-N)",36,0,0,4,40
1910780,1478471,2025-01-30,Senate,"Read third time and passed Senate (37-Y 2-N 1-A)",37,2,1,0,40
1910780,1490782,2025-02-17,House,"Reported from Rules with amendment(s) (14-Y 4-N)",14,4,0,0,18
1910780,1496027,2025-02-20,Senate,"House Amendments agreed to by Senate (37-Y 2-N)",37,2,0,1,40
1910780,1496209,2025-02-20,House,"Passed House with amendments (64-Y 34-N)",64,34,0,2,100
1910780,1496210,2025-02-20,House,"Passed House with amendments (Y-58 N-39 A-0)",58,39,0,3,100
1910780,1534787,2025-04-02,Senate,"Senate rejected Governor's recommendation (18-Y 22-N)",18,22,0,0,40
1910785,1472301,2025-01-20,Senate,"Reported from Courts of Justice with amendment (15-Y 0-N)",15,0,0,0,15
1910785,1472628,2025-01-21,Senate,"Constitutional reading dispensed (on 1st reading) (40-Y 0-N)",40,0,0,0,40
1910785,1473640,2025-01-23,Senate,"Engrossment reconsidered by Senate",39,0,0,1,40
1910785,1473641,2025-01-23,Senate,"Constitutional reading dispensed (on 3rd reading)",39,0,0,1,40
1910785,1473642,2025-01-23,Senate,"Passed Senate",39,0,0,1,40
1910785,1482684,2025-02-05,House,"Subcommittee recommends reporting with substitute (7-Y 1-N)",7,1,0,1,9
1910785,1485979,2025-02-10,House,"Reported from Courts of Justice (22-Y 0-N)",22,0,0,0,22
1910785,1488825,2025-02-13,House,"Passed House (89-Y 8-N)",89,8,0,3,100
1910795,1473747,2025-01-20,Senate,"Rereferred from Local Government and Rereferred to Commerce and Labor (13-Y 1-N)",13,1,0,1,15
1910795,1474452,2025-01-24,Senate,"Incorporated by Commerce and Labor (SB1190-Deeds) (15-Y 0-N)",15,0,0,0,15
1910799,1473546,2025-01-23,Senate,"Reported from Education and Health and rereferred to Finance and Appropriations (13-Y 1-N)",13,1,0,1,15
1910799,1477170,2025-01-29,Senate,"Reported from Finance and Appropriations with substitute (15-Y 0-N)",15,0,0,0,15
1910799,1477556,2025-01-30,Senate,"Constitutional reading dispensed (on 1st reading) (39-Y 0-N 1-A)",39,0,1,0,40
1910799,1480269,2025-02-03,Senate,"Read third time and passed Senate (40-Y 0-N)",40,0,0,0,40
1910799,1491329,2025-02-17,House,"Passed by indefinitely in Rules (18-Y 0-N)",18,0,0,0,18
1910805,1473446,2025-01-23,Senate,"Reported from Education and Health with amendments (15-Y 0-N)",15,0,0,0,15
1910805,1474289,2025-01-24,Senate,"Constitutional reading dispensed (on 1st reading) (37-Y 0-N)",37,0,0,3,40
1910805,1476908,2025-01-28,Senate,"Read third time and passed Senate (39-Y 0-N)",39,0,0,1,40
1910805,1488744,2025-02-13,House,"Reported from Health and Human Services (21-Y 0-N)",21,0,0,1,22
1910805,1492512,2025-02-18,House,"Passed House (97-Y 0-N)",97,0,0,3,100
1910814,1478449,2025-01-30,Senate,"Reported from Education and Health with substitute and rereferred to Finance and Appropriations (12-Y 0-N 3-A)",12,0,3,0,15
1910820,1474702,2025-01-27,Senate,"Rereferred from Local Government to General Laws and Technology (14-Y 0-N)",14,0,0,1,15
1910820,1476499,2025-01-29,Senate,"Failed to report from General Laws and Technology with amendments (6-Y 6-N 3-A)",6,6,3,0,15
1910824,1478254,2025-01-31,Senate,"Reported from Rehabilitation and Social Services (15-Y 0-N)",15,0,0,0,15
1910824,1479902,2025-02-03,Senate,"Constitutional reading dispensed (on 1st reading) (40-Y 0-N)",40,0,0,0,40
1910824,1479903,2025-02-04,Senate,"Constitutional reading dispensed (on 3rd reading) (39-Y 0-N)",39,0,0,1,40
1910824,1479904,2025-02-04,Senate,"Passed Senate (40-Y 0-N)",40,0,0,0,40
1910824,1489488,2025-02-13,House,"Subcommittee recommends reporting (5-Y 1-N)",5,1,0,1,7
1910824,1489923,2025-02-14,House,"Reported from Public Safety (16-Y 5-N)",16,5,0,1,22
1910824,1493508,2025-02-19,House,"Passed House (81-Y 15-N)",81,15,0,4,100
1910830,1477219,2025-01-30,Senate,"Reported from Education and Health with substitute (15-Y 0-N)",15,0,0,0,15
1910830,1478139,2025-01-31,Senate,"Constitutional reading dispensed (on 1st reading) (39-Y 0-N)",39,0,0,1,40
1910830,1480250,2025-02-03,Senate,"Constitutional reading dispensed (on 3rd reading) (40-Y 0-N)",40,0,0,0,40
1910830,1480251,2025-02-03,Senate,"Passed Senate (40-Y 0-N)",40,0,0,0,40
1910830,1487454,2025-02-12,House,"Reported from Education with amendment(s) (12-Y 9-N)",12,9,0,1,22
1910830,1491182,2025-02-17,House,"Passed House with amendments (50-Y 46-N)",50,46,0,4,100
1910830,1492414,2025-02-18,Senate,"House Amendments agreed to by Senate (40-Y 0-N)",40,0,0,0,40
1910835,1473790,2025-01-23,Senate,"Reported from Education and Health with substitute (15-Y 0-N)",15,0,0,0,15
1910835,1474355,2025-01-24,Senate,"Constitutional reading dispensed (on 1st reading) (37-Y 0-N)",37,0,0,3,40
1910835,1476540,2025-01-28,Senate,"Read third time and passed Senate (39-Y 0-N)",39,0,0,1,40
1910835,1485906,2025-02-11,House,"Reported from Health and Human Services (21-Y 1-N)",21,1,0,0,22
1910835,1490225,2025-02-14,House,"Passed House (91-Y 3-N)",91,3,0,6,100
1910841,1475732,2025-01-27,Senate,"Passed by indefinitely in Commerce and Labor with letter (13-Y 2-N)",13,2,0,0,15
1910846,1471812,2025-01-15,Senate,"Reported from General Laws and Technology with substitute (15-Y 0-N)",15,0,0,0,15
1910846,1472202,2025-01-17,Senate,"Constitutional reading dispensed (on 1st reading) (40-Y 0-N)",40,0,0,0,40
1910846,1472840,2025-01-21,Senate,"Read third time and passed Senate (40-Y 0-N)",40,0,0,0,40
1910846,1483310,2025-02-06,House,"Reported from General Laws (21-Y 0-N)",21,0,0,1,22
1910846,1486508,2025-02-11,House,"Passed House (94-Y 0-N)",94,0,0,6,100
1910853,1473820,2025-01-23,Senate,"Reported from Education and Health (15-Y 0-N)",15,0,0,0,15
1910853,1474356,2025-01-24,Senate,"Constitutional reading dispensed (on 1st reading) (37-Y 0-N)",37,0,0,3,40
1910853,1476453,2025-01-28,Senate,"Read third time and passed Senate (39-Y 0-N)",39,0,0,1,40
1910853,1483018,2025-02-06,House,"Reported from Health and Human Services (22-Y 0-N)",22,0,0,0,22
1910853,1485971,2025-02-11,House,"Passed House (94-Y 0-N)",94,0,0,6,100
1910858,1475718,2025-01-27,Senate,"Failed to report (defeated) in Commerce and Labor (4-Y 11-N)",4,11,0,0,15
1910864,1475616,2025-01-28,Senate,"Reported from Education and Health and rereferred to Finance and Appropriations (14-Y 1-N)",14,1,0,0,15
1910864,1477975,2025-01-30,Senate,"Reported from Finance and Appropriations with amendment (15-Y 0-N)",15,0,0,0,15
1910864,1479792,2025-02-03,Senate,"Constitutional reading dispensed (on 1st reading) (40-Y 0-N)",40,0,0,0,40
1910864,1479793,2025-02-04,Senate,"Constitutional reading dispensed (on 3rd reading) (40-Y 0-N)",40,0,0,0,40
1910864,1479794,2025-02-04,Senate,"Passed Senate (39-Y 1-N)",39,1,0,0,40
1910864,1485182,2025-02-10,House,"Subcommittee recommends reporting with substitute (7-Y 3-N)",7,3,0,1,11
1910864,1488207,2025-02-12,House,"Reported from Education with substitute (16-Y 5-N)",16,5,0,1,22
1910864,1491418,2025-02-17,House,"Passed House with substitute (69-Y 27-N)",69,27,0,4,100
1910864,1492339,2025-02-18,Senate,"House substitute rejected by Senate (0-Y 40-N)",0,40,0,0,40
1910864,1495371,2025-02-20,Senate,"Senate acceded to request (39-Y 0-N)",39,0,0,1,40
1910864,1496576,2025-02-21,Senate,"Conference report agreed to by Senate (39-Y 1-N)",39,1,0,0,40
1910864,1504074,2025-02-21,House,"Conference report agreed to by House (70-Y 26-N)",70,26,0,4,100
1910873,1472414,2025-01-20,Senate,"Reported from Commerce and Labor with substitute (15-Y 0-N)",15,0,0,0,15
1910873,1472943,2025-01-22,Senate,"Constitutional reading dispensed (on 1st reading) (40-Y 0-N)",40,0,0,0,40
1910873,1474594,2025-01-24,Senate,"Read third time and passed Senate (38-Y 0-N)",38,0,0,2,40
1910873,1483364,2025-02-06,House,"Reported from Labor and Commerce (21-Y 0-N)",21,0,0,1,22
1910873,1486242,2025-02-11,House,"Passed House (94-Y 0-N)",94,0,0,6,100
1910885,1473634,2025-01-22,Senate,"Reported from General Laws and Technology with amendment and rereferred to Finance and Appropriations (15-Y 0-N)",15,0,0,0,15
1910885,1475580,2025-01-28,Senate,"Reported from Finance and Appropriations with substitute (15-Y 0-N)",15,0,0,0,15
1910885,1476381,2025-01-29,Senate,"Constitutional reading dispensed (on 1st reading) (38-Y 0-N)",38,0,0,2,40
1910885,1477407,2025-01-30,Senate,"Read third time and passed Senate (40-Y 0-N)",40,0,0,0,40
1910885,1478493,2025-01-30,Senate,"Constitutional reading dispensed (on 3rd reading) (39-Y 1-N)",39,1,0,0,40
1910885,1485020,2025-02-10,House,"Reported from Appropriations with substitute (22-Y 0-N)",22,0,0,0,22
1910885,1489335,2025-02-13,House,"Passed House with substitute (84-Y 12-N)",84,12,0,4,100
1910885,1491797,2025-02-17,Senate,"House substitute rejected by Senate (0-Y 38-N)",0,38,0,2,40
1910885,1494401,2025-02-19,Senate,"Senate acceded to request (40-Y 0-N)",40,0,0,0,40
1910885,1497114,2025-02-21,Senate,"Conference report agreed to by Senate (40-Y 0-N)",40,0,0,0,40
1910885,1497200,2025-02-22,House,"Conference report agreed to by House (92-Y 3-N)",92,3,0,5,100
1910890,1477277,2025-01-30,Senate,"Failed to report (defeated) in Education and Health (2-Y 8-N 5-A)",2,8,5,0,15
1910895,1475883,2025-01-28,Senate,"Reported from Education and Health with substitute and rereferred to Finance and Appropriations (15-Y 0-N)",15,0,0,0,15
1910895,1477704,2025-01-30,Senate,"Reported from Finance and Appropriations with substitute (15-Y 0-N)",15,0,0,0,15
1910895,1480054,2025-02-03,Senate,"Constitutional reading dispensed (on 1st reading) (40-Y 0-N)",40,0,0,0,40
1910895,1480055,2025-02-04,Senate,"Constitutional reading dispensed (on 3rd reading) (39-Y 0-N)",39,0,0,1,40
1910895,1480056,2025-02-04,Senate,"Passed Senate (40-Y 0-N)",40,0,0,0,40
1910895,1485491,2025-02-10,House,"Subcommittee recommends reporting with substitute (10-Y 0-N)",10,0,0,1,11
1910895,1488038,2025-02-12,House,"Reported from Education with substitute (21-Y 0-N)",21,0,0,1,22
1910895,1490819,2025-02-17,House,"Passed House with substitute (96-Y 0-N)",96,0,0,4,100
1910895,1492863,2025-02-18,Senate,"House substitute agreed to by Senate (40-Y 0-N)",40,0,0,0,40
1910900,1475370,2025-01-28,Senate,"Reported from Education and Health with substitute and rereferred to Finance and Appropriations (15-Y 0-N)",15,0,0,0,15
1910905,1474015,2025-01-23,Senate,"Reported from Transportation (9-Y 5-N)",9,5,0,1,15
1910905,1475092,2025-01-27,Senate,"Constitutional reading dispensed (on 1st reading) (36-Y 0-N)",36,0,0,4,40
1910905,1478133,2025-01-30,Senate,"Read third time and passed Senate (24-Y 15-N)",24,15,0,1,40
1910905,1487671,2025-02-12,House,"Subcommittee recommends reporting with substitute (5-Y 3-N)",5,3,0,1,9
1910905,1488597,2025-02-13,House,"Reported from Transportation with substitute (11-Y 9-N)",11,9,0,2,22
1910905,1493062,2025-02-18,House,"Passed House with substitute (52-Y 44-N)",52,44,0,4,100
1910905,1493764,2025-02-19,Senate,"House substitute rejected by Senate (1-Y 39-N)",1,39,0,0,40
1910905,1496847,2025-02-20,Senate,"Senate acceded to request (38-Y 0-N)",38,0,0,2,40
1910905,1497167,2025-02-22,House,"Conference report agreed to by House (54-Y 40-N)",54,40,0,6,100
1910905,1503971,2025-02-22,Senate,"Conference report agreed to by Senate (25-Y 15-N)",25,15,0,0,40
1910914,1472282,2025-01-17,Senate,"Reported from Courts of Justice and rereferred to Finance and Appropriations (9-Y 6-N)",9,6,0,0,15
1910914,1474000,2025-01-22,Senate,"Reported from Finance and Appropriations (10-Y 4-N)",10,4,0,1,15
1910914,1474001,2025-01-23,Senate,"Constitutional reading dispensed (on 1st reading) (39-Y 0-N)",39,0,0,1,40
1910914,1476672,2025-01-28,Senate,"Read third time and passed Senate (21-Y 18-N)",21,18,0,1,40
1910914,1483965,2025-02-07,House,"Reported from Public Safety (11-Y 10-N)",11,10,0,1,22
1910914,1488760,2025-02-12,House,"Passed House (50-Y 47-N)",50,47,0,3,100
1910919,1473286,2025-01-22,Senate,"Reported from General Laws and Technology with substitute (14-Y 1-N)",14,1,0,0,15
1910919,1474635,2025-01-24,Senate,"Constitutional reading dispensed (on 1st reading) (37-Y 0-N)",37,0,0,3,40
1910919,1477079,2025-01-28,Senate,"Read third time and passed Senate (37-Y 1-N)",37,1,0,2,40
1910919,1486813,2025-02-11,House,"Reported from General Laws with substitute (19-Y 0-N)",19,0,0,3,22
1910919,1490578,2025-02-14,House,"Passed House (96-Y 0-N)",96,0,0,4,100
1910925,1473504,2025-01-23,Senate,"Incorporated by Education and Health (SB1037-Pekarsky) (15-Y 0-N)",15,0,0,0,15
1910929,1474463,2025-01-24,Senate,"Reported from Commerce and Labor with substitute and rereferred to Finance and Appropriations (9-Y 6-N)",9,6,0,0,15
1910929,1477166,2025-01-29,Senate,"Reported from Finance and Appropriations with amendment (10-Y 4-N)",10,4,0,1,15
1910929,1477551,2025-01-30,Senate,"Constitutional reading dispensed (on 1st reading) (39-Y 0-N 1-A)",39,0,1,0,40
1910929,1479741,2025-02-03,Senate,"Read third time and passed Senate (21-Y 19-N)",21,19,0,0,40
1910929,1489399,2025-02-13,House,"Reported from Labor and Commerce with substitute (14-Y 8-N)",14,8,0,0,22
1910929,1492016,2025-02-18,House,"Passed House with substitute (74-Y 23-N)",74,23,0,3,100
1910929,1495755,2025-02-19,Senate,"House substitute rejected by Senate (0-Y 40-N)",0,40,0,0,40
1910929,1495756,2025-02-20,Senate,"Senate acceded to request (38-Y 0-N)",38,0,0,2,40
1910929,1496701,2025-02-21,Senate,"Conference report agreed to by Senate (21-Y 19-N)",21,19,0,0,40
1910929,1503655,2025-02-21,House,"Conference report agreed to by House (65-Y 31-N)",65,31,0,4,100
1910933,1477132,2025-01-30,Senate,"Reported from Education and Health with substitute and rereferred to Finance and Appropriations (15-Y 0-N)",15,0,0,0,15
1910946,1472300,2025-01-20,Senate,"Reported from Courts of Justice and rereferred to Finance and Appropriations (15-Y 0-N)",15,0,0,0,15
1910946,1475317,2025-01-28,Senate,"Reported from Finance and Appropriations (15-Y 0-N)",15,0,0,0,15
1910946,1476434,2025-01-29,Senate,"Constitutional reading dispensed (on 1st reading) (38-Y 0-N)",38,0,0,2,40
1910946,1477493,2025-01-30,Senate,"Read third time and passed Senate (40-Y 0-N)",40,0,0,0,40
1910946,1478503,2025-01-30,Senate,"Constitutional reading dispensed (on 3rd reading) (39-Y 1-N)",39,1,0,0,40
1910946,1478504,2025-01-30,Senate,"Passed Senate (40-Y 0-N)",39,1,0,0,40
1910946,1482475,2025-02-05,House,"Reported from Courts of Justice (22-Y 0-N)",22,0,0,0,22
1910946,1484681,2025-02-10,House,"Passed House (95-Y 0-N)",95,0,0,5,100
1910951,1471838,2025-01-15,Senate,"Reported from General Laws and Technology and rereferred to Finance and Appropriations (15-Y 0-N)",15,0,0,0,15
1910951,1477795,2025-01-29,Senate,"Reported from Finance and Appropriations (14-Y 0-N)",14,0,0,1,15
1910951,1477796,2025-01-30,Senate,"Constitutional reading dispensed (on 1st reading) (39-Y 0-N 1-A)",39,0,1,0,40
1910951,1479286,2025-01-31,Senate,"Constitutional reading dispensed (on 3rd reading) (40-Y 0-N)",40,0,0,0,40
1910951,1479287,2025-01-31,Senate,"Passed Senate (40-Y 0-N)",40,0,0,0,40
1910951,1483779,2025-02-06,House,"Reported from General Laws (21-Y 0-N)",21,0,0,1,22
1910951,1486805,2025-02-11,House,"Passed House (94-Y 0-N)",94,0,0,6,100
1910958,1471804,2025-01-15,Senate,"Reported from Courts of Justice with substitute and rereferred to Finance and Appropriations (15-Y 0-N)",15,0,0,0,15
1910958,1472581,2025-01-21,Senate,"Reported from Finance and Appropriations with amendments (15-Y 0-N)",15,0,0,0,15
1910958,1473008,2025-01-22,Senate,"Constitutional reading dispensed (on 1st reading) (40-Y 0-N)",40,0,0,0,40
1910958,1474352,2025-01-24,Senate,"Read third time and passed Senate (38-Y 0-N)",38,0,0,2,40
1910958,1485115,2025-02-10,House,"Reported from Appropriations with amendment(s) (22-Y 0-N)",22,0,0,0,22
1910958,1489280,2025-02-13,House,"Passed House with amendments (96-Y 0-N)",96,0,0,4,100
1910958,1491497,2025-02-17,Senate,"House Amendments agreed to by Senate (39-Y 0-N)",39,0,0,1,40
1910963,1475151,2025-01-27,Senate,"Reported from Commerce and Labor with substitute (15-Y 0-N)",15,0,0,0,15
1910963,1476441,2025-01-29,Senate,"Constitutional reading dispensed (on 1st reading) (38-Y 0-N)",38,0,0,2,40
1910963,1479185,2025-01-30,Senate,"Constitutional reading dispensed (on 3rd reading) (39-Y 1-N)",39,1,0,0,40
1910963,1479186,2025-01-30,Senate,"Passed Senate (40-Y 0-N)",39,1,0,0,40
1910963,1486861,2025-02-11,House,"Subcommittee recommends reporting (8-Y 0-N)",8,0,0,1,9
1910963,1489725,2025-02-13,House,"Reported from Labor and Commerce (12-Y 10-N)",12,10,0,0,22
1910963,1491907,2025-02-18,House,"Passed House (49-Y 47-N)",49,47,0,4,100
1910970,1474876,2025-01-27,House,"Subcommittee recommends reporting with amendment(s) (8-Y 0-N)",8,0,0,1,9
1910970,1476192,2025-01-29,House,"Reported from Education with amendment(s) (22-Y 0-N)",22,0,0,0,22
1910970,1480645,2025-02-04,House,"Read third time and passed House (97-Y 0-N)",97,0,0,3,100
1910970,1480646,2025-02-04,House,"Passed House (99-Y 0-N)",99,0,0,1,100
1910970,1489615,2025-02-13,Senate,"Reported from Education and Health with substitute and rereferred to Finance and Appropriations (15-Y 0-N)",15,0,0,0,15
1910970,1490499,2025-02-14,Senate,"Reported from Finance and Appropriations with substitute (14-Y 0-N)",14,0,0,1,15
1910970,1491061,2025-02-17,Senate,"Constitutional reading dispensed (on 2nd reading) (39-Y 0-N)",39,0,0,1,40
1910970,1492017,2025-02-18,Senate,"Passed Senate with amendment (40-Y 0-N)",40,0,0,0,40
1910970,1493199,2025-02-19,House,"Senate substitute agreed to by House (97-Y 0-N)",97,0,0,3,100
1910974,1478927,2025-02-03,Senate,"Reported from Commerce and Labor (11-Y 0-N 4-A)",11,0,4,0,15
1910974,1479757,2025-02-04,Senate,"Constitutional reading dispensed (on 1st reading) (40-Y 0-N)",40,0,0,0,40
1910974,1479758,2025-02-04,Senate,"Constitutional reading dispensed (on 3rd reading) (40-Y 0-N)",40,0,0,0,40
1910974,1479759,2025-02-04,Senate,"Passed Senate (39-Y 1-N)",39,1,0,0,40
1910974,1489438,2025-02-13,House,"Reported from Labor and Commerce with substitute (20-Y 1-N)",20,1,0,1,22
1910974,1492024,2025-02-18,House,"Passed House with substitute (81-Y 15-N)",81,15,0,4,100
1910974,1495831,2025-02-19,Senate,"House substitute rejected by Senate (0-Y 40-N)",0,40,0,0,40
1910974,1495832,2025-02-20,Senate,"Senate acceded to request (38-Y 0-N)",38,0,0,2,40
1910974,1497138,2025-02-22,House,"Conference report agreed to by House (97-Y 0-N)",97,0,0,3,100
1910974,1503727,2025-02-22,Senate,"Conference report agreed to by Senate (39-Y 0-N)",39,0,0,1,40
1910980,1473392,2025-01-22,Senate,"Reported from General Laws and Technology and rereferred to Finance and Appropriations (14-Y 1-N)",14,1,0,0,15
1910980,1477782,2025-01-29,Senate,"Reported from Finance and Appropriations with amendments (14-Y 0-N)",14,0,0,1,15
1910980,1477783,2025-01-30,Senate,"Constitutional reading dispensed (on 1st reading) (39-Y 0-N 1-A)",39,0,1,0,40
1910980,1480353,2025-02-03,Senate,"Read third time and passed Senate (38-Y 2-N)",38,2,0,0,40
1910980,1486895,2025-02-11,House,"Subcommittee recommends reporting (6-Y 1-N)",6,1,0,2,9
1910980,1489854,2025-02-13,House,"Reported from General Laws (16-Y 3-N)",16,3,0,3,22
1910985,1473974,2025-01-16,Senate,"Rereferred from Transportation to Finance and Appropriations (15-Y 0-N)",15,0,0,0,15
1910985,1475389,2025-01-28,Senate,"Reported from Finance and Appropriations with substitute (15-Y 0-N)",15,0,0,0,15
1910985,1476261,2025-01-29,Senate,"Constitutional reading dispensed (on 1st reading) (38-Y 0-N)",38,0,0,2,40
1910985,1477772,2025-01-30,Senate,"Read third time and passed Senate (40-Y 0-N)",40,0,0,0,40
1910985,1478414,2025-01-30,Senate,"Constitutional reading dispensed (on 3rd reading) (39-Y 1-N)",39,1,0,0,40
1910985,1478415,2025-01-30,Senate,"Passed Senate (40-Y 0-N)",39,1,0,0,40
1910985,1484648,2025-02-10,House,"Reported from Appropriations with amendment(s) (22-Y 0-N)",22,0,0,0,22
1910985,1488413,2025-02-12,Senate,"House Amendment rejected by Senate (0-Y 39-N)",0,39,0,1,40
1910985,1488414,2025-02-12,Senate,"Senate acceded to request (40-Y 0-N)",40,0,0,0,40
1910985,1488713,2025-02-12,House,"Constitutional reading dispensed (on 3rd reading) (95-Y 0-N)",95,0,0,5,100
1910985,1488714,2025-02-12,House,"Passed House with amendment (95-Y 0-N)",95,0,0,5,100
1910985,1495139,2025-02-20,Senate,"Conference report agreed to by Senate (39-Y 0-N)",39,0,0,1,40
1910985,1496488,2025-02-20,House,"Conference report agreed to by House (95-Y 1-N)",95,1,0,4,100
1910991,1472302,2025-01-20,Senate,"Reported from Courts of Justice with substitute and rereferred to Finance and Appropriations (15-Y 0-N)",15,0,0,0,15
1910991,1475346,2025-01-28,Senate,"Reported from Finance and Appropriations (15-Y 0-N)",15,0,0,0,15
1910991,1476165,2025-01-29,Senate,"Constitutional reading dispensed (on 1st reading) (38-Y 0-N)",38,0,0,2,40
1910991,1478383,2025-01-30,Senate,"Constitutional reading dispensed (on 3rd reading) (39-Y 1-N)",39,1,0,0,40
1910991,1478384,2025-01-30,Senate,"Passed Senate (40-Y 0-N)",39,1,0,0,40
1910991,1482358,2025-02-05,House,"Subcommittee recommends laying on the table (5-Y 3-N)",5,3,0,1,9
1910996,1473587,2025-01-20,Senate,"Rereferred from Commerce Labor and Rereferred to Finance and Appropriations (12-Y 0-N)",12,0,0,3,15
1910996,1475369,2025-01-28,Senate,"Reported from Finance and Appropriations with amendment (15-Y 0-N)",15,0,0,0,15
1910996,1476193,2025-01-29,Senate,"Constitutional reading dispensed (on 1st reading) (38-Y 0-N)",38,0,0,2,40
1910996,1477290,2025-01-30,Senate,"Read third time and passed Senate (40-Y 0-N)",40,0,0,0,40
1910996,1478223,2025-01-30,Senate,"Constitutional reading dispensed (on 3rd reading) (39-Y 1-N)",39,1,0,0,40
1910996,1484647,2025-02-10,House,"Reported from Appropriations (22-Y 0-N)",22,0,0,0,22
1910996,1489289,2025-02-13,House,"Passed House (90-Y 6-N)",90,6,0,4,100
1911002,1475299,2025-01-27,Senate,"Reported from Courts of Justice and rereferred to Finance and Appropriations (14-Y 0-N)",14,0,0,1,15
1911002,1476578,2025-01-29,Senate,"Reported from Finance and Appropriations (15-Y 0-N)",15,0,0,0,15
1911002,1477636,2025-01-30,Senate,"Constitutional reading dispensed (on 1st reading) (39-Y 0-N 1-A)",39,0,1,0,40
1911002,1479358,2025-01-31,Senate,"Constitutional reading dispensed (on 3rd reading) (40-Y 0-N)",40,0,0,0,40
1911002,1479359,2025-01-31,Senate,"Passed Senate (40-Y 0-N)",40,0,0,0,40
1911002,1484080,2025-02-07,House,"Subcommittee recommends reporting with substitute and referring to Appropriations (8-Y 0-N)",8,0,0,1,9
1911002,1486379,2025-02-10,House,"Reported from Courts of Justice with substitute and referred to Appropriations (22-Y 0-N)",22,0,0,0,22
1911007,1472763,2025-01-21,House,"Subcommittee recommends reporting with substitute (5-Y 3-N)",5,3,0,1,9
1911007,1473036,2025-01-22,House,"Reported from Finance with substitute (12-Y 10-N)",12,10,0,0,22
1911007,1476873,2025-01-28,House,"Read third time and passed House (52-Y 47-N)",52,47,0,1,100
1911007,1486793,2025-02-11,Senate,"Passed by indefinitely in Finance and Appropriations with letter (15-Y 0-N)",15,0,0,0,15
1911015,1475688,2025-01-28,Senate,"Rereferred from Privileges and Elections to Rules (15-Y 0-N)",15,0,0,0,15
1911020,1476762,2025-01-29,Senate,"Passed by indefinitely in Courts of Justice (9-Y 6-N)",9,6,0,0,15
1911025,1473534,2025-01-23,Senate,"Reported from Education and Health with substitute and rereferred to Finance and Appropriations (15-Y 0-N)",15,0,0,0,15
1911025,1477150,2025-01-29,Senate,"Reported from Finance and Appropriations (14-Y 0-N)",14,0,0,1,15
1911025,1477527,2025-01-30,Senate,"Constitutional reading dispensed (on 1st reading) (39-Y 0-N 1-A)",39,0,1,0,40
1911025,1479151,2025-01-31,Senate,"Constitutional reading dispensed (on 3rd reading) (40-Y 0-N)",40,0,0,0,40
1911025,1479152,2025-01-31,Senate,"Passed Senate (40-Y 0-N)",40,0,0,0,40
1911025,1485843,2025-02-11,House,"Subcommittee recommends laying on the table (6-Y 1-N)",6,1,0,2,9
1911025,1490815,2025-02-17,House,"Reported from Education with substitute (13-Y 9-N)",13,9,0,0,22
1911025,1496645,2025-02-20,House,"Passed House (52-Y 46-N)",52,46,0,2,100
1911030,1474179,2025-01-24,Senate,"Passed by indefinitely in Rehabilitation and Social Services (8-Y 7-N)",8,7,0,0,15
1911036,1474397,2025-01-24,Senate,"Reported from General Laws and Technology with substitute and rereferred to Finance and Appropriations (14-Y 0-N)",14,0,0,1,15
1911036,1477628,2025-01-30,Senate,"Reported from Finance and Appropriations with amendment (15-Y 0-N)",15,0,0,0,15
1911036,1479797,2025-02-04,Senate,"Constitutional reading dispensed (on 3rd reading) (39-Y 0-N)",39,0,0,1,40
1911036,1479798,2025-02-04,Senate,"Passed Senate (40-Y 0-N)",40,0,0,0,40
1911036,1480275,2025-02-03,Senate,"Constitutional reading dispensed (on 1st reading) (40-Y 0-N)",40,0,0,0,40
1911036,1484716,2025-02-10,House,"Subcommittee recommends reporting and referring to Appropriations (7-Y 3-N)",7,3,0,1,11
1911036,1484717,2025-02-10,House,"Reported from Communications, Technology and Innovation and referred to Appropriations (13-Y 8-N)",13,8,0,1,22
1911043,1475053,2025-01-27,Senate,"Failed to report (defeated) in Local Government (5-Y 10-N)",5,10,0,0,15
1911050,1473979,2025-01-23,Senate,"Reported from Education and Health (13-Y 2-N)",13,2,0,0,15
1911050,1474354,2025-01-24,Senate,"Constitutional reading dispensed (on 1st reading) (37-Y 0-N)",37,0,0,3,40
1911050,1477064,2025-01-28,Senate,"Read third time and passed Senate (35-Y 4-N)",35,4,0,1,40
1911050,1486057,2025-02-11,House,"Subcommittee recommends reporting (5-Y 2-N)",5,2,0,2,9
1911050,1490758,2025-02-17,House,"Reported from Education with amendment(s) (13-Y 9-N)",13,9,0,0,22
1911050,1496572,2025-02-20,House,"Passed House with amendments (58-Y 39-N)",58,39,0,3,100
1911050,1496907,2025-02-20,Senate,"House Amendments agreed to by Senate (35-Y 4-N)",35,4,0,1,40
1911055,1471799,2025-01-15,Senate,"Stricken at request of Patron in Courts of Justice (11-Y 0-N)",11,0,0,4,15
1911060,1476321,2025-01-29,Senate,"Reported from Courts of Justice with substitute (15-Y 0-N)",15,0,0,0,15
1911060,1478312,2025-01-31,Senate,"Constitutional reading dispensed (on 1st reading) (39-Y 0-N)",39,0,0,1,40
1911060,1480386,2025-02-03,Senate,"Constitutional reading dispensed (on 3rd reading) (40-Y 0-N)",40,0,0,0,40
1911060,1480387,2025-02-03,Senate,"Passed Senate (40-Y 0-N)",40,0,0,0,40
1911060,1485986,2025-02-10,House,"Reported from Courts of Justice with substitute and referred to Appropriations (21-Y 1-N)",21,1,0,0,22
1911071,1471789,2025-01-15,Senate,"Reported from Courts of Justice (15-Y 0-N)",15,0,0,0,15
1911071,1472139,2025-01-17,Senate,"Constitutional reading dispensed (on 1st reading) (40-Y 0-N)",40,0,0,0,40
1911071,1474084,2025-01-21,Senate,"Read third time and passed Senate (40-Y 0-N)",40,0,0,0,40
1911071,1482604,2025-02-05,House,"Reported from Courts of Justice (22-Y 0-N)",22,0,0,0,22
1911071,1485275,2025-02-10,House,"Passed House (95-Y 0-N)",95,0,0,5,100
1911075,1472054,2025-01-16,Senate,"Rereferred from Education and Health",14,0,0,1,15
1911075,1472055,2025-01-16,Senate,"Rereferred from Education and Health to Courts of Justice (14-Y 0-N)",14,0,0,1,15
1911075,1473354,2025-01-22,Senate,"Reported from Courts of Justice with substitute and rereferred to Finance and Appropriations (14-Y 0-N)",14,0,0,1,15
1911075,1477075,2025-01-29,Senate,"Reported from Finance and Appropriations with substitute (15-Y 0-N)",15,0,0,0,15
1911075,1477761,2025-01-30,Senate,"Constitutional reading dispensed (on 1st reading) (39-Y 0-N 1-A)",39,0,1,0,40
1911075,1480406,2025-02-03,Senate,"Constitutional reading dispensed (on 3rd reading) (40-Y 0-N)",40,0,0,0,40
1911075,1480407,2025-02-03,Senate,"Passed Senate (40-Y 0-N)",40,0,0,0,40
1911075,1486177,2025-02-10,House,"Reported from Courts of Justice (22-Y 0-N)",22,0,0,0,22
1911075,1490619,2025-02-13,House,"Passed House (96-Y 0-N)",96,0,0,4,100
1911080,1473553,2025-01-23,Senate,"Reported from Education and Health and rereferred to Finance and Appropriations (9-Y 6-N)",9,6,0,0,15
1911080,1476373,2025-01-29,Senate,"Incorporated by Finance and Appropriations (SB917-Surovell) (14-Y 0-N)",14,0,0,1,15
1911086,1471844,2025-01-15,Senate,"Rereferred from General Laws and Technology to Local Government (15-Y 0-N)",15,0,0,0,15
1911086,1472385,2025-01-20,Senate,"Reported from Local Government with substitute and rereferred to Finance and Appropriations (12-Y 3-N)",12,3,0,0,15
1911091,1476701,2025-01-29,Senate,"Incorporated by General Laws and Technology (SB1424-VanValkenburg) (14-Y 0-N)",14,0,0,1,15
1911096,1477390,2025-01-29,Senate,"Reported from Finance and Appropriations with amendment (15-Y 0-N)",15,0,0,0,15
1911096,1477391,2025-01-30,Senate,"Constitutional reading dispensed (on 1st reading) (39-Y 0-N 1-A)",39,0,1,0,40
1911096,1479305,2025-01-31,Senate,"Constitutional reading dispensed (on 3rd reading) (40-Y 0-N)",40,0,0,0,40
1911096,1479306,2025-01-31,Senate,"Passed Senate (40-Y 0-N)",40,0,0,0,40
1911096,1485268,2025-02-10,House,"Reported from Finance with substitute (20-Y 0-N)",20,0,0,2,22
1911096,1488866,2025-02-13,House,"Passed House with substitute (96-Y 0-N)",96,0,0,4,100
1911096,1492674,2025-02-17,Senate,"House substitute rejected by Senate (2-Y 36-N)",2,36,0,2,40
1911096,1494400,2025-02-19,Senate,"Senate acceded to request (40-Y 0-N)",40,0,0,0,40
1911096,1497191,2025-02-22,House,"Conference report agreed to by House (95-Y 0-N)",95,0,0,5,100
1911096,1503116,2025-02-22,Senate,"Conference report agreed to by Senate (40-Y 0-N)",40,0,0,0,40
1911096,1536152,2025-04-02,Senate,"Senate concurred in Governor's recommendation (40-Y 0-N)",40,0,0,0,40
1911096,1536153,2025-04-02,House,"House concurred in Governor's recommendation (94-Y 0-N)",94,0,0,6,100
1911103,1475308,2025-01-27,Senate,"Reported from Courts of Justice with substitute and rereferred to Finance and Appropriations (9-Y 2-N 3-A)",9,2,3,1,15
1911108,1478029,2025-01-30,Senate,"Reported from Education and Health with substitute (15-Y 0-N)",15,0,0,0,15
1911108,1478160,2025-01-31,Senate,"Constitutional reading dispensed (on 1st reading) (39-Y 0-N)",39,0,0,1,40
1911108,1479760,2025-02-03,Senate,"Constitutional reading dispensed (on 3rd reading) (40-Y 0-N)",40,0,0,0,40
1911108,1479761,2025-02-03,Senate,"Passed Senate (40-Y 0-N)",40,0,0,0,40
1911108,1485918,2025-02-11,House,"Subcommittee recommends reporting (7-Y 1-N)",7,1,0,1,9
1911108,1488803,2025-02-13,House,"Reported from Health and Human Services (17-Y 5-N)",17,5,0,0,22
1911108,1492079,2025-02-18,House,"Passed House (54-Y 43-N)",54,43,0,3,100
1911113,1475686,2025-01-28,Senate,"Reported from Privileges and Elections with amendment (8-Y 7-N)",8,7,0,0,15
1911113,1477286,2025-01-30,Senate,"Constitutional reading dispensed (on 1st reading) (39-Y 0-N 1-A)",39,0,1,0,40
1911113,1479471,2025-02-03,Senate,"Motion to recommit to committee rejected (11-Y 29-N)",11,29,0,0,40
1911119,1474086,2025-01-20,Senate,"Reading waived (on 1st reading) (40-Y 0-N)",40,0,0,0,40
1911119,1490802,2025-02-17,House,"Reported from Rules (18-Y 0-N)",18,0,0,0,18
1911119,1496730,2025-02-20,House,"Agreed to by House (97-Y 0-N)",97,0,0,3,100
1911126,1472702,2025-01-21,Senate,"Reported from Privileges and Elections with amendment (15-Y 0-N)",15,0,0,0,15
1911126,1474348,2025-01-23,Senate,"Constitutional reading dispensed (on 1st reading) (39-Y 0-N)",39,0,0,1,40
1911126,1474847,2025-01-27,Senate,"Read third time and passed Senate (38-Y 0-N)",38,0,0,2,40
1911126,1485065,2025-02-10,House,"Subcommittee recommends reporting (8-Y 0-N)",8,0,0,1,9
1911126,1490038,2025-02-14,House,"Reported from Privileges and Elections (22-Y 0-N)",22,0,0,0,22
1911126,1493384,2025-02-19,House,"Passed House (97-Y 0-N)",97,0,0,3,100
1911132,1471847,2025-01-15,Senate,"Reported from General Laws and Technology (15-Y 0-N)",15,0,0,0,15
1911132,1472253,2025-01-17,Senate,"Constitutional reading dispensed (on 1st reading) (40-Y 0-N)",40,0,0,0,40
1911132,1473952,2025-01-21,Senate,"Read third time and passed Senate (40-Y 0-N)",40,0,0,0,40
1911132,1483578,2025-02-06,House,"Subcommittee recommends reporting with amendment(s) (8-Y 0-N)",8,0,0,1,9
1911132,1486766,2025-02-11,House,"Reported from General Laws with amendment(s) (19-Y 0-N)",19,0,0,3,22
1911132,1490560,2025-02-14,House,"Passed House with amendments (96-Y 0-N)",96,0,0,4,100
1911132,1492745,2025-02-18,Senate,"House Amendments agreed to by Senate (21-Y 19-N)",40,0,0,0,40
1911136,1472608,2025-01-20,House,"Subcommittee recommends reporting with substitute (7-Y 1-N)",7,1,0,1,9
1911136,1474732,2025-01-24,House,"Reported from Courts of Justice with substitute (22-Y 0-N)",22,0,0,0,22
1911136,1478378,2025-01-30,House,"Read third time and passed House (96-Y 0-N)",96,0,0,4,100
1911136,1490825,2025-02-17,Senate,"Reported from Courts of Justice with amendments (15-Y 0-N)",15,0,0,0,15
1911136,1493467,2025-02-18,Senate,"Constitutional reading dispensed (on 2nd reading) (39-Y 0-N)",39,0,0,1,40
1911136,1495109,2025-02-19,Senate,"Passed Senate with amendments (40-Y 0-N)",40,0,0,0,40
1911136,1496738,2025-02-20,House,"Senate Amendments agreed to by House (97-Y 0-N)",97,0,0,3,100
1911141,1473920,2025-01-16,Senate,"Reported from Transportation with amendment and rereferred to Finance and Appropriations (15-Y 0-N)",15,0,0,0,15
1911141,1475255,2025-01-28,Senate,"Reported from Finance and Appropriations (15-Y 0-N)",15,0,0,0,15
1911141,1476307,2025-01-29,Senate,"Constitutional reading dispensed (on 1st reading) (38-Y 0-N)",38,0,0,2,40
1911141,1477513,2025-01-30,Senate,"Read third time and passed Senate (40-Y 0-N)",40,0,0,0,40
1911141,1478007,2025-01-30,Senate,"Passed Senate (40-Y 0-N)",39,1,0,0,40
1911141,1485932,2025-02-11,House,"Subcommittee recommends reporting (6-Y 1-N)",6,1,0,2,9
1911141,1488609,2025-02-13,House,"Reported from Transportation (16-Y 4-N)",16,4,0,2,22
1911141,1491785,2025-02-18,House,"Passed House (71-Y 26-N)",71,26,0,3,100
1911150,1472424,2025-01-20,Senate,"Reported from Commerce and Labor and rereferred to Finance and Appropriations (15-Y 0-N)",15,0,0,0,15
1911150,1476238,2025-01-28,Senate,"Reported from Finance and Appropriations (15-Y 0-N)",15,0,0,0,15
1911150,1476239,2025-01-29,Senate,"Constitutional reading dispensed (on 1st reading) (38-Y 0-N)",38,0,0,2,40
1911150,1477412,2025-01-30,Senate,"Read third time and passed Senate (40-Y 0-N)",40,0,0,0,40
1911150,1478294,2025-01-30,Senate,"Constitutional reading dispensed (on 3rd reading) (39-Y 1-N)",39,1,0,0,40
1911150,1478295,2025-01-30,Senate,"Passed Senate (40-Y 0-N)",39,1,0,0,40
1911150,1486764,2025-02-11,House,"Subcommittee recommends reporting (6-Y 2-N)",6,2,0,1,9
1911150,1489444,2025-02-13,House,"Reported from Labor and Commerce (12-Y 10-N)",12,10,0,0,22
1911150,1492201,2025-02-18,House,"Passed House (49-Y 47-N)",49,47,0,4,100
1911150,1492202,2025-02-18,House,"Passed House (50-Y 47-N)",50,47,0,3,100
1911155,1473567,2025-01-23,Senate,"Reported from Education and Health with substitute and rereferred to Finance and Appropriations (15-Y 0-N)",15,0,0,0,15
1911161,1471753,2025-01-15,Senate,"Reported from General Laws and Technology with amendment and rereferred to Finance and Appropriations (15-Y 0-N)",15,0,0,0,15
1911161,1477140,2025-01-29,Senate,"Reported from Finance and Appropriations (14-Y 0-N)",14,0,0,1,15
1911161,1477523,2025-01-30,Senate,"Constitutional reading dispensed (on 1st reading) (39-Y 0-N 1-A)",39,0,1,0,40
1911161,1479178,2025-01-31,Senate,"Constitutional reading dispensed (on 3rd reading) (40-Y 0-N)",40,0,0,0,40
1911161,1479179,2025-01-31,Senate,"Passed Senate (40-Y 0-N)",40,0,0,0,40
1911161,1483239,2025-02-06,House,"Reported from General Laws (21-Y 0-N)",21,0,0,1,22
1911161,1486062,2025-02-11,House,"Passed House (94-Y 0-N)",94,0,0,6,100
1911165,1477266,2025-01-30,Senate,"Reported from Education and Health (15-Y 0-N)",15,0,0,0,15
1911165,1478179,2025-01-31,Senate,"Constitutional reading dispensed (on 1st reading) (39-Y 0-N)",39,0,0,1,40
1911165,1479874,2025-02-03,Senate,"Constitutional reading dispensed (on 3rd reading) (40-Y 0-N)",40,0,0,0,40
1911165,1479875,2025-02-03,Senate,"Passed Senate (40-Y 0-N)",40,0,0,0,40
1911165,1485905,2025-02-11,House,"Subcommittee recommends laying on the table (5-Y 2-N)",5,2,0,2,9
1911169,1478055,2025-01-31,Senate,"Passed by indefinitely in Rehabilitation and Social Services (15-Y 0-N)",15,0,0,0,15
1911176,1471793,2025-01-15,Senate,"Reported from Courts of Justice and rereferred to Finance and Appropriations (15-Y 0-N)",15,0,0,0,15
1911176,1472700,2025-01-21,Senate,"Reported from Finance and Appropriations (15-Y 0-N)",15,0,0,0,15
1911176,1473030,2025-01-22,Senate,"Constitutional reading dispensed (on 1st reading) (40-Y 0-N)",40,0,0,0,40
1911176,1474630,2025-01-24,Senate,"Read third time and passed Senate (38-Y 0-N)",38,0,0,2,40
1911182,1472488,2025-01-20,Senate,"Constitutional reading dispensed (on 1st reading) (40-Y 0-N)",40,0,0,0,40
1911182,1472952,2025-01-22,Senate,"Read third time and passed Senate (40-Y 0-N)",40,0,0,0,40
1911182,1473877,2025-01-17,Senate,"Reported from Rules (15-Y 0-N)",15,0,0,0,15
1911182,1490792,2025-02-17,House,"Tabled in Rules (16-Y 1-N)",16,1,0,1,18
1911186,1472436,2025-01-20,Senate,"Reported from Commerce and Labor and rereferred to Finance and Appropriations (15-Y 0-N)",15,0,0,0,15
1911186,1475284,2025-01-28,Senate,"Reported from Finance and Appropriations (15-Y 0-N)",15,0,0,0,15
1911186,1476327,2025-01-29,Senate,"Constitutional reading dispensed (on 1st reading) (38-Y 0-N)",38,0,0,2,40
1911186,1477511,2025-01-30,Senate,"Read third time and passed Senate (40-Y 0-N)",40,0,0,0,40
1911186,1478006,2025-01-30,Senate,"Constitutional reading dispensed (on 3rd reading) (40-Y 0-N)",39,1,0,0,40
1911186,1483374,2025-02-06,House,"Reported from Labor and Commerce with amendment(s) (12-Y 9-N)",12,9,0,1,22
1911186,1487501,2025-02-12,House,"Passed House with amendments (49-Y 47-N)",49,47,0,4,100
1911186,1490699,2025-02-14,Senate,"House Amendments rejected by Senate (1-Y 35-N)",1,35,0,4,40
1911186,1492430,2025-02-18,Senate,"Senate acceded to request (40-Y 0-N)",40,0,0,0,40
1911186,1497211,2025-02-22,House,"Conference report agreed to by House (51-Y 46-N)",51,46,0,3,100
1911186,1503472,2025-02-22,Senate,"Conference report agreed to by Senate (37-Y 3-N)",37,3,0,0,40
1911186,1534741,2025-04-02,Senate,"Senate concurred in Governor's recommendation (40-Y 0-N)",40,0,0,0,40
1911186,1534743,2025-04-02,House,"House concurred in Governor's recommendation (58-Y 37-N)",58,37,0,5,100
1911196,1472382,2025-01-20,Senate,"Constitutional reading dispensed (on 1st reading) (40-Y 0-N)",40,0,0,0,40
1911196,1473038,2025-01-22,Senate,"Read third time and passed Senate (40-Y 0-N)",40,0,0,0,40
1911196,1473637,2025-01-17,Senate,"Reported from Rules (15-Y 0-N)",15,0,0,0,15
1911196,1490785,2025-02-17,House,"Tabled in Rules (12-Y 6-N)",12,6,0,0,18
1911201,1472377,2025-01-20,Senate,"Constitutional reading dispensed (on 1st reading) (40-Y 0-N)",40,0,0,0,40
1911201,1472939,2025-01-22,Senate,"Read third time and passed Senate (40-Y 0-N)",40,0,0,0,40
1911201,1474100,2025-01-16,Senate,"Reported from Transportation (15-Y 0-N)",15,0,0,0,15
1911201,1485998,2025-02-11,House,"Subcommittee recommends reporting (8-Y 0-N)",8,0,0,1,9
1911205,1473533,2025-01-23,Senate,"Passed by indefinitely in Education and Health (9-Y 6-N)",9,6,0,0,15
1911210,1472426,2025-01-20,Senate,"Failed to report (defeated) in Commerce and Labor (5-Y 10-N)",5,10,0,0,15
1911215,1472189,2025-01-17,Senate,"Reported from Courts of Justice with substitute and rereferred to Finance and Appropriations (9-Y 6-N)",9,6,0,0,15
1911215,1473043,2025-01-22,Senate,"Reported from Finance and Appropriations with substitute (10-Y 4-N)",10,4,0,1,15
1911215,1473668,2025-01-23,Senate,"Constitutional reading dispensed (on 1st reading) (39-Y 0-N)",39,0,0,1,40
1911215,1477063,2025-01-28,Senate,"Read third time and passed Senate (21-Y 18-N)",21,18,0,1,40
1911215,1484094,2025-02-07,House,"Reported from Public Safety (11-Y 10-N)",11,10,0,1,22
1911215,1488864,2025-02-12,House,"Passed House (50-Y 46-N)",50,46,0,4,100
1911221,1478796,2025-02-03,Senate,"Reported from Courts of Justice with substitute (15-Y 0-N)",15,0,0,0,15
1911221,1480308,2025-02-04,Senate,"Constitutional reading dispensed (on 1st reading) (40-Y 0-N)",40,0,0,0,40
1911221,1480309,2025-02-04,Senate,"Constitutional reading dispensed (on 3rd reading) (40-Y 0-N)",40,0,0,0,40
1911221,1480310,2025-02-04,Senate,"Passed Senate (40-Y 0-N)",40,0,0,0,40
1911221,1485335,2025-02-10,House,"Reported from Courts of Justice with substitute (17-Y 5-N)",17,5,0,0,22
1911221,1489310,2025-02-13,House,"Passed House with substitute (59-Y 37-N)",59,37,0,4,100
1911221,1491272,2025-02-17,Senate,"House substitute rejected by Senate (2-Y 37-N)",2,37,0,1,40
1911221,1494024,2025-02-19,Senate,"Senate acceded to request (39-Y 0-N)",39,0,0,1,40
1911221,1497122,2025-02-22,House,"Conference report agreed to by House (58-Y 39-N)",58,39,0,3,100
1911221,1504099,2025-02-22,Senate,"Conference report agreed to by Senate (39-Y 0-N)",39,0,0,1,40
1911221,1534821,2025-04-02,Senate,"Senate concurred in Governor's recommendation (40-Y 0-N)",40,0,0,0,40
1911221,1534822,2025-04-02,House,"House concurred in Governor's recommendation (89-Y 7-N)",89,7,0,4,100
1911228,1477658,2025-01-30,Senate,"Reported from Education and Health with substitute (15-Y 0-N)",15,0,0,0,15
1911228,1478375,2025-01-31,Senate,"Constitutional reading dispensed (on 1st reading) (39-Y 0-N)",39,0,0,1,40
1911228,1479856,2025-02-03,Senate,"Passed Senate (40-Y 0-N)",40,0,0,0,40
1911228,1480453,2025-02-03,Senate,"Constitutional reading dispensed (on 3rd reading) (40-Y 0-N)",40,0,0,0,40
1911228,1486796,2025-02-11,House,"Subcommittee recommends reporting with amendment(s) (6-Y 1-N)",6,1,0,2,9
1911228,1490850,2025-02-17,House,"Reported from Education with amendment(s) (19-Y 3-N)",19,3,0,0,22
1911228,1495694,2025-02-20,House,"Passed House with amendments (97-Y 0-N 1-A)",97,0,1,2,100
1911228,1495695,2025-02-20,Senate,"House Amendments agreed to by Senate (39-Y 0-N)",39,0,0,1,40
1911232,1473712,2025-01-23,Senate,"Reported from Education and Health with substitute (15-Y 0-N)",15,0,0,0,15
1911232,1474409,2025-01-24,Senate,"Constitutional reading dispensed (on 1st reading) (37-Y 0-N)",37,0,0,3,40
1911232,1476275,2025-01-28,Senate,"Read third time and passed Senate (39-Y 0-N)",39,0,0,1,40
1911232,1485868,2025-02-11,House,"Subcommittee recommends reporting (5-Y 2-N)",5,2,0,2,9
1911232,1490766,2025-02-17,House,"Reported from Education with substitute (20-Y 2-N)",20,2,0,0,22
1911232,1495590,2025-02-20,Senate,"House substitute agreed to by Senate (39-Y 0-N)",39,0,0,1,40
1911232,1496598,2025-02-20,House,"Passed House with substitute (86-Y 12-N)",86,12,0,2,100
1911236,1474398,2025-01-24,Senate,"Reported from General Laws and Technology with substitute (15-Y 0-N)",15,0,0,0,15
1911236,1476168,2025-01-29,Senate,"Constitutional reading dispensed (on 1st reading) (38-Y 0-N)",38,0,0,2,40
1911236,1476169,2025-01-29,Senate,"Passed Senate (38-Y 0-N)",38,0,0,2,40
1911236,1476829,2025-01-28,Senate,"Constitutional reading dispensed (on 1st reading) (39-Y 0-N)",39,0,0,1,40
1911236,1483414,2025-02-06,House,"Reported from General Laws with substitute (13-Y 8-N)",13,8,0,1,22
1911236,1487651,2025-02-12,House,"Passed House with substitute (50-Y 47-N)",50,47,0,3,100
1911236,1490708,2025-02-14,Senate,"House substitute agreed to by Senate (22-Y 14-N)",22,14,0,4,40
1911245,1472307,2025-01-20,Senate,"Reported from Courts of Justice with substitute and rereferred to Finance and Appropriations (15-Y 0-N)",15,0,0,0,15
1911245,1477078,2025-01-29,Senate,"Reported from Finance and Appropriations with substitute (14-Y 0-N 1-A)",14,0,1,0,15
1911245,1477300,2025-01-30,Senate,"Constitutional reading dispensed (on 1st reading) (39-Y 0-N 1-A)",39,0,1,0,40
1911245,1479810,2025-02-03,Senate,"Read third time and passed Senate (39-Y 1-N)",39,1,0,0,40
1911245,1485310,2025-02-10,House,"Reported from Courts of Justice with substitute (22-Y 0-N)",22,0,0,0,22
1911245,1487666,2025-02-12,House,"Constitutional reading dispensed (on 3rd reading) (95-Y 0-N)",95,0,0,5,100
1911245,1487667,2025-02-12,House,"Passed House with substitute (86-Y 10-N)",86,10,0,4,100
1911245,1487668,2025-02-12,Senate,"House substitute rejected by Senate (4-Y 33-N)",4,33,0,3,40
1911245,1487669,2025-02-12,Senate,"Senate acceded to request (40-Y 0-N)",40,0,0,0,40
1911245,1496579,2025-02-21,Senate,"Conference report agreed to by Senate (40-Y 0-N)",40,0,0,0,40
1911245,1504094,2025-02-21,House,"Conference report agreed to by House (80-Y 15-N)",80,15,0,5,100
1911250,1472590,2025-01-21,Senate,"Reported from Finance and Appropriations with substitute (10-Y 5-N)",10,5,0,0,15
1911250,1472953,2025-01-22,Senate,"Constitutional reading dispensed (on 1st reading) (40-Y 0-N)",40,0,0,0,40
1911250,1476579,2025-01-28,Senate,"Read third time and passed Senate (21-Y 18-N)",21,18,0,1,40
1911250,1484667,2025-02-10,House,"Reported from Appropriations (12-Y 10-N)",12,10,0,0,22
1911250,1487715,2025-02-12,House,"Constitutional reading dispensed (on 3rd reading) (95-Y 0-N)",95,0,0,5,100
1911250,1565153,2025-02-12,House,"Defeated by House - 51 votes required for passage (49-Y 48-N)",49,48,0,3,100
1911254,1471839,2025-01-15,Senate,"Rereferred from General Laws and Technology to Courts of Justice (15-Y 0-N)",15,0,0,0,15
1911254,1473430,2025-01-22,Senate,"Reported from Courts of Justice with substitute (14-Y 0-N)",14,0,0,1,15
1911254,1474513,2025-01-24,Senate,"Constitutional reading dispensed (on 1st reading) (37-Y 0-N)",37,0,0,3,40
1911254,1476456,2025-01-28,Senate,"Read third time and passed Senate (39-Y 0-N)",39,0,0,1,40
1911254,1485345,2025-02-10,House,"Reported from Courts of Justice with substitute (14-Y 8-N)",14,8,0,0,22
1911254,1489319,2025-02-13,House,"Passed House with substitute (56-Y 41-N)",56,41,0,3,100
1911254,1491296,2025-02-17,Senate,"House substitute agreed to by Senate (37-Y 2-N)",37,2,0,1,40
1911254,1491297,2025-02-17,Senate,"Reconsideration of House substitute agreed to by Senate (39-Y 0-N)",39,0,0,1,40
1911254,1491298,2025-02-17,Senate,"House substitute agreed to by Senate (39-Y 0-N)",39,0,0,1,40
1911254,1534780,2025-04-02,Senate,"Senate rejected Governor's recommendation (19-Y 21-N)",19,21,0,0,40
1911258,1472257,2025-01-17,Senate,"Reported from Courts of Justice with substitute and rereferred to Finance and Appropriations (11-Y 4-N)",11,4,0,0,15
1911258,1473687,2025-01-22,Senate,"Reported from Finance and Appropriations with substitute (15-Y 0-N)",15,0,0,0,15
1911258,1473688,2025-01-23,Senate,"Constitutional reading dispensed (on 1st reading) (39-Y 0-N)",39,0,0,1,40
1911274,1473566,2025-01-23,Senate,"Reported from Education and Health and rereferred to Finance and Appropriations (15-Y 0-N)",15,0,0,0,15
1911278,1471756,2025-01-15,Senate,"Rereferred from General Laws and Technology to Commerce and Labor (15-Y 0-N)",15,0,0,0,15
1911278,1474431,2025-01-24,Senate,"Reported from Commerce and Labor with substitute and rereferred to Finance and Appropriations (9-Y 6-N)",9,6,0,0,15
1911278,1477687,2025-01-29,Senate,"Reported from Finance and Appropriations with substitute (10-Y 4-N)",10,4,0,1,15
1911278,1477688,2025-01-30,Senate,"Constitutional reading dispensed (on 1st reading) (39-Y 0-N 1-A)",39,0,1,0,40
1911278,1480363,2025-02-03,Senate,"Read third time and defeated by Senate (19-Y 20-N)",19,20,0,1,40
1911278,1480364,2025-02-03,Senate,"Reconsideration of defeated action agreed to by Senate",40,0,0,0,40
1911283,1475714,2025-01-27,Senate,"Reported from Commerce and Labor with substitute (9-Y 6-N)",9,6,0,0,15
1911283,1476205,2025-01-29,Senate,"Constitutional reading dispensed (on 1st reading) (38-Y 0-N)",38,0,0,2,40
1911283,1478600,2025-01-31,Senate,"Read third time and passed Senate (26-Y 14-N)",26,14,0,0,40
1911283,1489396,2025-02-13,House,"Reported from Labor and Commerce with amendment(s) (21-Y 1-N)",21,1,0,0,22
1911283,1491981,2025-02-18,House,"Passed House with amendment (97-Y 0-N)",97,0,0,3,100
1911283,1495783,2025-02-19,Senate,"House Amendment agreed to by Senate (40-Y 0-N)",40,0,0,0,40
1911283,1495784,2025-02-19,Senate,"Reconsideration of House amendment agreed to by Senate (40-Y 0-N)",40,0,0,0,40
1911283,1495785,2025-02-19,Senate,"House Amendment agreed to by Senate (23-Y 17-N)",23,17,0,0,40
1911283,1536180,2025-04-02,Senate,"Senate rejected Governor's recommendation (19-Y 21-N)",19,21,0,0,40
1911289,1471505,2025-01-13,Senate,"Reported from Local Government (13-Y 0-N)",13,0,0,0,13
1911289,1471506,2025-01-14,Senate,"Constitutional reading dispensed (on 1st reading) (37-Y 0-N)",37,0,0,1,38
1911289,1471926,2025-01-16,Senate,"Read third time and passed Senate (39-Y 0-N)",39,0,0,1,40
1911289,1483970,2025-02-07,House,"Reported from Counties, Cities and Towns (21-Y 0-N)",21,0,0,1,22
1911289,1488369,2025-02-12,House,"Passed House (97-Y 0-N)",97,0,0,3,100
1911296,1473732,2025-01-16,Senate,"Reported from Transportation with amendment and rereferred to Finance and Appropriations (15-Y 0-N)",15,0,0,0,15
1911296,1476114,2025-01-28,Senate,"Reported from Finance and Appropriations (15-Y 0-N)",15,0,0,0,15
1911296,1476666,2025-01-29,Senate,"Constitutional reading dispensed (on 1st reading) (38-Y 0-N)",38,0,0,2,40
1911296,1477706,2025-01-30,Senate,"Read third time and passed Senate (40-Y 0-N)",40,0,0,0,40
1911296,1478381,2025-01-30,Senate,"Constitutional reading dispensed (on 3rd reading) (39-Y 1-N)",39,1,0,0,40
1911296,1478382,2025-01-30,Senate,"Passed Senate (40-Y 0-N)",39,1,0,0,40
1911296,1484665,2025-02-10,House,"Reported from Appropriations (22-Y 0-N)",22,0,0,0,22
1911296,1490124,2025-02-13,House,"Passed House (96-Y 0-N)",96,0,0,4,100
1911300,1473897,2025-01-23,Senate,"Reported from Education and Health with amendment and rereferred to Finance and Appropriations (15-Y 0-N)",15,0,0,0,15
1911300,1477668,2025-01-29,Senate,"Reported from Finance and Appropriations with substitute (15-Y 0-N)",15,0,0,0,15
1911300,1477669,2025-01-30,Senate,"Constitutional reading dispensed (on 1st reading) (39-Y 0-N 1-A)",39,0,1,0,40
1911300,1479256,2025-01-31,Senate,"Constitutional reading dispensed (on 3rd reading) (40-Y 0-N)",40,0,0,0,40
1911300,1479257,2025-01-31,Senate,"Passed Senate (40-Y 0-N)",40,0,0,0,40
1911300,1490780,2025-02-17,House,"Tabled in Rules (18-Y 0-N)",18,0,0,0,18
1911307,1473240,2025-01-22,Senate,"Stricken at request of Patron in General Laws and Technology (15-Y 0-N)",15,0,0,0,15
1911311,1475368,2025-01-28,Senate,"Reported from Education and Health with substitute and rereferred to Finance and Appropriations (9-Y 6-N)",9,6,0,0,15
1911311,1477647,2025-01-30,Senate,"Passed by indefinitely in Finance and Appropriations (13-Y 2-N)",13,2,0,0,15
1911318,1473705,2025-01-20,Senate,"Reported from Commerce and Labor with amendment and rereferred to Finance and Appropriations (9-Y 6-N)",9,6,0,0,15
1911323,1473549,2025-01-23,Senate,"Reported from Education and Health (14-Y 1-N)",14,1,0,0,15
1911323,1474580,2025-01-24,Senate,"Constitutional reading dispensed (on 1st reading) (37-Y 0-N)",37,0,0,3,40
1911323,1476747,2025-01-28,Senate,"Read third time and passed Senate (38-Y 1-N)",38,1,0,1,40
1911323,1480757,2025-02-05,House,"Reported from Education (10-Y 9-N)",10,9,0,3,22
1911323,1484646,2025-02-10,House,"Passed House (50-Y 45-N)",50,45,0,5,100
1911326,1473560,2025-01-23,Senate,"Reported from Education and Health with substitute and rereferred to Finance and Appropriations (15-Y 0-N)",15,0,0,0,15
1911326,1477197,2025-01-29,Senate,"Reported from Finance and Appropriations with substitute (15-Y 0-N)",15,0,0,0,15
1911326,1478145,2025-01-30,Senate,"Constitutional reading dispensed (on 1st reading) (39-Y 0-N 1-A)",39,0,1,0,40
1911326,1479240,2025-01-31,Senate,"Constitutional reading dispensed (on 3rd reading) (40-Y 0-N)",40,0,0,0,40
1911326,1479241,2025-01-31,Senate,"Passed Senate (40-Y 0-N)",40,0,0,0,40
1911326,1486367,2025-02-11,House,"Subcommittee recommends reporting with substitute (7-Y 0-N)",7,0,0,1,8
1911326,1489436,2025-02-13,House,"Reported from Labor and Commerce with substitute and referred to Appropriations (20-Y 1-N)",20,1,0,1,22
1911331,1476018,2025-01-28,Senate,"Reported from Agriculture, Conservation and Natural Resources (10-Y 0-N 4-A)",10,0,4,1,15
1911331,1477643,2025-01-30,Senate,"Constitutional reading dispensed (on 1st reading) (39-Y 0-N 1-A)",39,0,1,0,40
1911331,1480285,2025-02-03,Senate,"Read third time and passed Senate (22-Y 18-N)",22,18,0,0,40
1911331,1488157,2025-02-12,House,"Reported from Agriculture, Chesapeake and Natural Resources (21-Y 1-N)",21,1,0,0,22
1911331,1491245,2025-02-17,House,"Passed House (87-Y 9-N)",87,9,0,4,100
1911331,1534695,2025-04-02,Senate,"Senate concurred in Governor's recommendation (24-Y 15-N)",24,15,0,1,40
1911331,1534696,2025-04-02,Senate,"Reconsideration of Governor's recommendation rejected (40-Y 0-N)",40,0,0,0,40
1911331,1534697,2025-04-02,Senate,"Senate rejected Governor's recommendation (19-Y 21-N)",19,21,0,0,40
1911341,1472685,2025-01-21,Senate,"Reported from Finance and Appropriations (15-Y 0-N)",15,0,0,0,15
1911341,1473033,2025-01-22,Senate,"Constitutional reading dispensed (on 1st reading) (40-Y 0-N)",40,0,0,0,40
1911341,1474637,2025-01-24,Senate,"Read third time and passed Senate (38-Y 0-N)",38,0,0,2,40
1911341,1485859,2025-02-10,House,"Reported from Appropriations (22-Y 0-N)",22,0,0,0,22
1911341,1489752,2025-02-13,House,"Passed House (96-Y 0-N)",96,0,0,4,100
1911345,1479191,2025-02-03,Senate,"Reported from Commerce and Labor with substitute (9-Y 6-N)",9,6,0,0,15
1911345,1479695,2025-02-04,Senate,"Constitutional reading dispensed (on 1st reading) (40-Y 0-N)",40,0,0,0,40
1911345,1479696,2025-02-04,Senate,"Constitutional reading dispensed (on 3rd reading) (40-Y 0-N)",40,0,0,0,40
1911345,1479697,2025-02-04,Senate,"Passed Senate (21-Y 18-N)",21,18,0,1,40
1911345,1489414,2025-02-13,House,"Reported from Labor and Commerce with substitute (19-Y 3-N)",19,3,0,0,22
1911345,1492077,2025-02-18,House,"Passed House with substitute (87-Y 9-N)",87,9,0,4,100
1911345,1495849,2025-02-19,Senate,"House substitute agreed to by Senate (21-Y 19-N)",21,19,0,0,40
1911345,1495850,2025-02-19,Senate,"Reconsideration of House substitute agreed to by Senate (40-Y 0-N)",40,0,0,0,40
1911345,1495851,2025-02-19,Senate,"House substitute agreed to by Senate (22-Y 18-N)",22,18,0,0,40
1911345,1535214,2025-04-02,House,"House concurred in Governor's recommendation (93-Y 2-N)",93,2,0,5,100
1911345,1536362,2025-04-02,Senate,"Senate concurred in Governor's recommendation (39-Y 0-N)",39,0,0,1,40
1911351,1473531,2025-01-23,Senate,"Reported from Education and Health (15-Y 0-N)",15,0,0,0,15
1911351,1474578,2025-01-24,Senate,"Constitutional reading dispensed (on 1st reading) (37-Y 0-N)",37,0,0,3,40
1911351,1476316,2025-01-28,Senate,"Read third time and passed Senate (39-Y 0-N)",39,0,0,1,40
1911351,1485916,2025-02-11,House,"Subcommittee recommends reporting (8-Y 0-N)",8,0,0,1,9
1911351,1488783,2025-02-13,House,"Reported from Health and Human Services (22-Y 0-N)",22,0,0,0,22
1911351,1492060,2025-02-18,House,"Passed House (97-Y 0-N)",97,0,0,3,100
1911358,1472303,2025-01-20,Senate,"Reported from Courts of Justice with amendment and rereferred to Finance and Appropriations (15-Y 0-N)",15,0,0,0,15
1911358,1476341,2025-01-29,Senate,"Reported from Finance and Appropriations with substitute (14-Y 0-N)",14,0,0,1,15
1911358,1478530,2025-01-30,Senate,"Constitutional reading dispensed (on 1st reading) (39-Y 0-N 1-A)",39,0,1,0,40
1911358,1479153,2025-01-31,Senate,"Constitutional reading dispensed (on 3rd reading) (40-Y 0-N)",40,0,0,0,40
1911358,1479154,2025-01-31,Senate,"Passed Senate (40-Y 0-N)",40,0,0,0,40
1911358,1483946,2025-02-07,House,"Subcommittee recommends reporting with amendment(s) (8-Y 0-N)",8,0,0,1,9
1911358,1485004,2025-02-10,House,"Reported from Courts of Justice with amendment(s) (22-Y 0-N)",22,0,0,0,22
1911358,1489736,2025-02-13,House,"Passed House with amendments (96-Y 0-N)",96,0,0,4,100
1911358,1491779,2025-02-17,Senate,"House Amendments agreed to by Senate (39-Y 0-N)",39,0,0,1,40
1911362,1479197,2025-02-03,Senate,"Reported from Commerce and Labor (15-Y 0-N)",15,0,0,0,15
1911362,1479723,2025-02-04,Senate,"Constitutional reading dispensed (on 1st reading) (40-Y 0-N)",40,0,0,0,40
1911362,1479724,2025-02-04,Senate,"Constitutional reading dispensed (on 3rd reading) (40-Y 0-N)",40,0,0,0,40
1911362,1479725,2025-02-04,Senate,"Passed Senate (40-Y 0-N)",40,0,0,0,40
1911362,1489451,2025-02-13,House,"Reported from Labor and Commerce (19-Y 3-N)",19,3,0,0,22
1911362,1492061,2025-02-18,House,"Passed House (74-Y 23-N)",74,23,0,3,100
1911362,1536511,2025-04-02,Senate,"Senate rejected Governor's recommendation (19-Y 21-N)",19,21,0,0,40
1911366,1472707,2025-01-21,Senate,"Passed by indefinitely in Privileges and Elections (8-Y 7-N)",8,7,0,0,15
1911377,1473552,2025-01-23,Senate,"Reported from Education and Health (9-Y 6-N)",9,6,0,0,15
1911377,1474574,2025-01-24,Senate,"Constitutional reading dispensed (on 1st reading) (37-Y 0-N)",37,0,0,3,40
1911377,1476668,2025-01-28,Senate,"Read third time and passed Senate (21-Y 18-N)",21,18,0,1,40
1911377,1485842,2025-02-11,House,"Subcommittee recommends reporting (5-Y 1-N)",5,1,0,3,9
1911377,1490749,2025-02-17,House,"Reported from Education (16-Y 6-N)",16,6,0,0,22
1911377,1496599,2025-02-20,House,"Passed House (80-Y 18-N)",80,18,0,2,100
1911386,1478328,2025-01-30,Senate,"Stricken at request of Patron in Education and Health (15-Y 0-N)",15,0,0,0,15
1911391,1478044,2025-01-30,Senate,"Reported from Education and Health with substitute (15-Y 0-N)",15,0,0,0,15
1911391,1478211,2025-01-31,Senate,"Constitutional reading dispensed (on 1st reading) (39-Y 0-N)",39,0,0,1,40
1911391,1480322,2025-02-03,Senate,"Constitutional reading dispensed (on 3rd reading) (40-Y 0-N)",40,0,0,0,40
1911391,1480323,2025-02-03,Senate,"Passed Senate (40-Y 0-N)",40,0,0,0,40
1911391,1485904,2025-02-11,House,"Subcommittee recommends reporting (4-Y 3-N)",4,3,0,2,9
1911391,1488747,2025-02-13,House,"Reported from Health and Human Services (14-Y 8-N)",14,8,0,0,22
1911391,1491914,2025-02-18,House,"Passed House (51-Y 45-N)",51,45,0,4,100
1911398,1479110,2025-02-03,Senate,"Passed by indefinitely in Courts of Justice (8-Y 7-N)",8,7,0,0,15
1911406,1473379,2025-01-22,Senate,"Passed by indefinitely in Courts of Justice (11-Y 4-N)",11,4,0,0,15
1911413,1476643,2025-01-29,House,"Subcommittee recommends reporting with substitute (5-Y 3-N)",5,3,0,1,9
1911413,1477379,2025-01-30,House,"Reported from Transportation with substitute (12-Y 10-N)",12,10,0,0,22
1911413,1480861,2025-02-04,House,"Read third time and passed House (54-Y 44-N)",54,44,0,2,100
1911413,1489672,2025-02-13,Senate,"Reported from Transportation with amendment and rereferred to Finance and Appropriations (8-Y 6-N)",8,6,0,1,15
1911413,1492073,2025-02-17,Senate,"Reported from Finance and Appropriations with substitute (10-Y 4-N)",10,4,0,1,15
1911413,1495198,2025-02-20,Senate,"Passed Senate with substitute (21-Y 17-N)",21,17,0,2,40
1911413,1495844,2025-02-19,Senate,"Constitutional reading dispensed (on 2nd reading) (40-Y 0-N)",40,0,0,0,40
1911413,1495845,2025-02-20,House,"Senate substitute rejected by House (0-Y 96-N)",0,96,0,4,100
1911413,1495846,2025-02-20,Senate,"Senate insisted on substitute (38-Y 0-N)",38,0,0,2,40
1911413,1497143,2025-02-22,House,"Conference report agreed to by House (53-Y 45-N)",53,45,0,2,100
1911413,1503725,2025-02-22,Senate,"Conference report agreed to by Senate (24-Y 16-N)",24,16,0,0,40
1911418,1473808,2025-01-21,Senate,"Passed by indefinitely in Privileges and Elections (8-Y 7-N)",8,7,0,0,15
1911430,1474971,2025-01-27,Senate,"Failed to report from Local Government with substitute (5-Y 6-N 4-A)",5,6,4,0,15
1911435,1473235,2025-01-22,Senate,"Reported from General Laws and Technology (9-Y 6-N)",9,6,0,0,15
1911435,1474509,2025-01-24,Senate,"Constitutional reading dispensed (on 1st reading) (37-Y 0-N)",37,0,0,3,40
1911435,1476986,2025-01-28,Senate,"Read third time and passed Senate (36-Y 3-N)",36,3,0,1,40
1911435,1491454,2025-02-17,House,"Passed by indefinitely in Rules (18-Y 0-N)",18,0,0,0,18
1911440,1471679,2025-01-15,Senate,"Reported from Finance and Appropriations (13-Y 0-N)",13,0,0,2,15
1911440,1472028,2025-01-16,Senate,"Constitutional reading dispensed (on 1st reading) (39-Y 0-N)",39,0,0,1,40
1911440,1474112,2025-01-20,Senate,"Read third time and passed Senate (40-Y 0-N)",40,0,0,0,40
1911440,1484715,2025-02-10,House,"Reported from Appropriations (22-Y 0-N)",22,0,0,0,22
1911440,1487458,2025-02-12,House,"Constitutional reading dispensed (on 3rd reading) (95-Y 0-N)",95,0,0,5,100
1911440,1487459,2025-02-12,House,"Passed House (93-Y 4-N)",93,4,0,3,100
1911446,1475839,2025-01-28,House,"Subcommittee recommends laying on the table (10-Y 0-N)",10,0,0,1,11
1911451,1473744,2025-01-21,Senate,"Passed by indefinitely in Finance and Appropriations (14-Y 0-N)",14,0,0,1,15
1911455,1473893,2025-01-20,Senate,"Stricken at request of Patron in Local Government (14-Y 0-N)",14,0,0,1,15
1911466,1471848,2025-01-15,Senate,"Reported from General Laws and Technology with amendment (15-Y 0-N)",15,0,0,0,15
1911466,1472232,2025-01-17,Senate,"Constitutional reading dispensed (on 1st reading) (40-Y 0-N)",40,0,0,0,40
1911466,1474091,2025-01-21,Senate,"Read third time and passed Senate (40-Y 0-N)",40,0,0,0,40
1911466,1483708,2025-02-06,House,"Reported from Labor and Commerce with amendment(s) (21-Y 0-N)",21,0,0,1,22
1911466,1485911,2025-02-11,House,"Passed House with amendments (94-Y 0-N)",94,0,0,6,100
1911466,1490612,2025-02-13,Senate,"House Amendments rejected by Senate (0-Y 40-N)",0,40,0,0,40
1911466,1492762,2025-02-18,Senate,"Senate acceded to request (40-Y 0-N)",40,0,0,0,40
1911466,1496886,2025-02-21,Senate,"Conference report agreed to by Senate (40-Y 0-N)",40,0,0,0,40
1911466,1504283,2025-02-21,House,"Conference report agreed to by House (96-Y 0-N)",96,0,0,4,100
1911471,1475687,2025-01-27,Senate,"Passed by indefinitely in Commerce and Labor (9-Y 6-N)",9,6,0,0,15
1911476,1473398,2025-01-22,Senate,"Reported from General Laws and Technology and rereferred to Finance and Appropriations (15-Y 0-N)",15,0,0,0,15
1911476,1477651,2025-01-29,Senate,"Reported from Finance and Appropriations (15-Y 0-N)",15,0,0,0,15
1911476,1477652,2025-01-30,Senate,"Constitutional reading dispensed (on 1st reading) (39-Y 0-N 1-A)",39,0,1,0,40
1911476,1479291,2025-01-31,Senate,"Constitutional reading dispensed (on 3rd reading) (40-Y 0-N)",40,0,0,0,40
1911476,1479292,2025-01-31,Senate,"Passed Senate (40-Y 0-N)",40,0,0,0,40
1911476,1483312,2025-02-06,House,"Reported from General Laws with amendment(s) (21-Y 0-N)",21,0,0,1,22
1911476,1488324,2025-02-12,House,"Passed House with amendment (92-Y 5-N)",92,5,0,3,100
1911476,1490680,2025-02-14,Senate,"House Amendment agreed to by Senate (36-Y 0-N)",36,0,0,4,40
1911483,1471803,2025-01-15,Senate,"Reported from Courts of Justice (15-Y 0-N)",15,0,0,0,15
1911483,1474098,2025-01-17,Senate,"Constitutional reading dispensed (on 1st reading) (40-Y 0-N)",40,0,0,0,40
1911483,1474099,2025-01-21,Senate,"Read third time and passed Senate (40-Y 0-N)",40,0,0,0,40
1911483,1482781,2025-02-05,House,"Reported from Courts of Justice (22-Y 0-N)",22,0,0,0,22
1911483,1485100,2025-02-10,House,"Passed House (95-Y 0-N)",95,0,0,5,100
1911490,1473302,2025-01-22,Senate,"Reported from General Laws and Technology with substitute and rereferred to Finance and Appropriations (15-Y 0-N)",15,0,0,0,15
1911490,1475830,2025-01-28,Senate,"Passed by indefinitely in Finance and Appropriations (10-Y 5-N)",10,5,0,0,15
1911496,1473851,2025-01-21,Senate,"Reported from Privileges and Elections with amendment and rereferred to Finance and Appropriations (15-Y 0-N)",15,0,0,0,15
1911496,1477138,2025-01-29,Senate,"Reported from Finance and Appropriations (14-Y 0-N)",14,0,0,1,15
1911496,1477517,2025-01-30,Senate,"Constitutional reading dispensed (on 1st reading) (39-Y 0-N 1-A)",39,0,1,0,40
1911496,1479145,2025-01-31,Senate,"Constitutional reading dispensed (on 3rd reading) (40-Y 0-N)",40,0,0,0,40
1911496,1479146,2025-01-31,Senate,"Passed Senate (40-Y 0-N)",40,0,0,0,40
1911496,1485121,2025-02-10,House,"Subcommittee recommends reporting with amendment(s) (6-Y 1-N 1-A)",6,1,1,1,9
1911496,1490042,2025-02-14,House,"Reported from Privileges and Elections (22-Y 0-N)",22,0,0,0,22
1911496,1493255,2025-02-19,House,"Passed House (97-Y 0-N)",97,0,0,3,100
1911502,1476743,2025-01-29,Senate,"Passed by indefinitely in General Laws and Technology with letter (12-Y 0-N)",12,0,0,3,15
1911506,1472631,2025-01-21,Senate,"Constitutional reading dispensed (on 1st reading) (40-Y 0-N)",40,0,0,0,40
1911506,1473836,2025-01-20,Senate,"Reported from Courts of Justice with substitute (15-Y 0-N)",15,0,0,0,15
1911506,1473837,2025-01-23,Senate,"Read third time and passed Senate (39-Y 0-N)",39,0,0,1,40
1911506,1485975,2025-02-10,House,"Subcommittee recommends laying on the table (5-Y 3-N)",5,3,0,1,9
1911524,1477202,2025-01-30,Senate,"Reported from Education and Health with substitute (15-Y 0-N)",15,0,0,0,15
1911524,1478065,2025-01-31,Senate,"Constitutional reading dispensed (on 1st reading) (39-Y 0-N)",39,0,0,1,40
1911524,1480314,2025-02-03,Senate,"Constitutional reading dispensed (on 3rd reading) (40-Y 0-N)",40,0,0,0,40
1911524,1480315,2025-02-03,Senate,"Passed Senate (40-Y 0-N)",40,0,0,0,40
1911524,1487900,2025-02-12,House,"Reported from Education with substitute (21-Y 0-N)",21,0,0,1,22
1911524,1490832,2025-02-17,House,"Passed House with substitute (95-Y 0-N)",95,0,0,5,100
1911524,1490833,2025-02-17,House,"Passed House with substitute (96-Y 0-N)",96,0,0,4,100
1911524,1492379,2025-02-18,Senate,"House substitute agreed to by Senate (40-Y 0-N)",40,0,0,0,40
1911530,1473402,2025-01-22,Senate,"Reported from General Laws and Technology (15-Y 0-N)",15,0,0,0,15
1911530,1474623,2025-01-24,Senate,"Constitutional reading dispensed (on 1st reading) (37-Y 0-N)",37,0,0,3,40
1911530,1477057,2025-01-28,Senate,"Read third time and passed Senate (39-Y 0-N)",39,0,0,1,40
1911530,1479933,2025-02-04,House,"Reported from General Laws (21-Y 0-N)",21,0,0,1,22
1911530,1483928,2025-02-07,House,"Passed House (94-Y 0-N)",94,0,0,6,100
1911535,1475822,2025-01-28,Senate,"Reported from Agriculture, Conservation and Natural Resources with amendments and rereferred to Finance and Appropriations (11-Y 3-N)",11,3,0,1,15
1911540,1471809,2025-01-15,Senate,"Reported from General Laws and Technology with substitute (15-Y 0-N)",15,0,0,0,15
1911540,1472148,2025-01-17,Senate,"Constitutional reading dispensed (on 1st reading) (40-Y 0-N)",40,0,0,0,40
1911540,1473601,2025-01-21,Senate,"Read third time and passed Senate (40-Y 0-N)",40,0,0,0,40
1911540,1483368,2025-02-06,House,"Reported from General Laws (17-Y 4-N)",17,4,0,1,22
1911540,1487497,2025-02-12,House,"Passed House (62-Y 34-N)",62,34,0,4,100
1911546,1472335,2025-01-20,Senate,"Reported from Courts of Justice with substitute and rereferred to Finance and Appropriations (15-Y 0-N)",15,0,0,0,15
1911546,1477593,2025-01-29,Senate,"Reported from Finance and Appropriations with amendment (14-Y 0-N)",14,0,0,1,15
1911546,1477594,2025-01-30,Senate,"Constitutional reading dispensed (on 1st reading) (39-Y 0-N 1-A)",39,0,1,0,40
1911546,1479375,2025-01-31,Senate,"Constitutional reading dispensed (on 3rd reading) (40-Y 0-N)",40,0,0,0,40
1911546,1479376,2025-01-31,Senate,"Passed Senate (40-Y 0-N)",40,0,0,0,40
1911546,1485483,2025-02-10,House,"Reported from Courts of Justice with substitute (22-Y 0-N)",22,0,0,0,22
1911546,1489667,2025-02-13,House,"Passed House with substitute (96-Y 0-N)",96,0,0,4,100
1911546,1491488,2025-02-17,Senate,"House substitute agreed to by Senate (39-Y 0-N)",39,0,0,1,40
1911552,1472356,2025-01-20,Senate,"Constitutional reading dispensed (on 1st reading) (40-Y 0-N)",40,0,0,0,40
1911552,1472931,2025-01-22,Senate,"Read third time and passed Senate (40-Y 0-N)",40,0,0,0,40
1911552,1473888,2025-01-17,Senate,"Reported from Rehabilitation and Social Services (15-Y 0-N)",15,0,0,0,15
1911552,1483314,2025-02-06,House,"Subcommittee recommends reporting with amendment(s) (8-Y 0-N)",8,0,0,1,9
1911552,1483315,2025-02-06,House,"Reported from Health and Human Services with amendment(s) (21-Y 1-N)",21,1,0,0,22
1911552,1487926,2025-02-12,House,"Passed House with amendments (81-Y 16-N)",81,16,0,3,100
1911552,1490698,2025-02-14,Senate,"House Amendments agreed to by Senate (36-Y 0-N)",36,0,0,4,40
1911556,1474069,2025-01-23,Senate,"Stricken at request of Patron in Transportation (12-Y 0-N)",12,0,0,3,15
1911575,1475326,2025-01-28,Senate,"Incorporated by Finance and Appropriations (SB1083-Perry) (15-Y 0-N)",15,0,0,0,15
1911580,1471857,2025-01-15,Senate,"Reported from General Laws and Technology with amendment (9-Y 4-N 2-A)",9,4,2,0,15
1911580,1473921,2025-01-17,Senate,"Constitutional reading dispensed (on 1st reading) (40-Y 0-N)",40,0,0,0,40
1911580,1473922,2025-01-21,Senate,"Read third time and passed Senate (21-Y 19-N)",21,19,0,0,40
1911580,1483100,2025-02-06,House,"Subcommittee recommends reporting with amendment(s) (8-Y 0-N)",8,0,0,1,9
1911580,1484015,2025-02-07,House,"Reported from Counties, Cities and Towns with amendment(s) (18-Y 3-N)",18,3,0,1,22
1911580,1490809,2025-02-17,House,"Reported from Rules (14-Y 4-N)",14,4,0,0,18
1911580,1495721,2025-02-20,Senate,"House Amendments agreed to by Senate (23-Y 16-N)",23,16,0,1,40
1911580,1496669,2025-02-20,House,"Passed House with amendments (56-Y 42-N)",56,42,0,2,100
1911587,1478897,2025-02-03,Senate,"Passed by indefinitely in Commerce and Labor (9-Y 6-N)",9,6,0,0,15
1911592,1475847,2025-01-28,Senate,"Reported from Agriculture, Conservation and Natural Resources with amendments (14-Y 0-N)",14,0,0,1,15
1911592,1477632,2025-01-30,Senate,"Reported from Finance and Appropriations (15-Y 0-N)",15,0,0,0,15
1911592,1479863,2025-02-04,Senate,"Constitutional reading dispensed (on 3rd reading) (39-Y 0-N)",39,0,0,1,40
1911592,1479864,2025-02-04,Senate,"Passed Senate (40-Y 0-N)",40,0,0,0,40
1911592,1480321,2025-02-03,Senate,"Constitutional reading dispensed (on 1st reading) (40-Y 0-N)",40,0,0,0,40
1911592,1487365,2025-02-12,House,"Subcommittee recommends reporting with amendment(s) (10-Y 0-N)",10,0,0,1,11
1911592,1487366,2025-02-12,House,"Reported from Agriculture, Chesapeake and Natural Resources with amendment(s) (22-Y 0-N)",22,0,0,0,22
1911592,1491005,2025-02-17,House,"Passed House with amendments (95-Y 0-N)",95,0,0,5,100
1911592,1491006,2025-02-17,House,"Passed House with amendments (96-Y 0-N)",96,0,0,4,100
1911592,1492251,2025-02-18,Senate,"House Amendments agreed to by Senate (40-Y 0-N)",40,0,0,0,40
1911597,1473338,2025-01-22,Senate,"Reported from General Laws and Technology (15-Y 0-N)",15,0,0,0,15
1911597,1474411,2025-01-24,Senate,"Constitutional reading dispensed (on 1st reading) (37-Y 0-N)",37,0,0,3,40
1911597,1477065,2025-01-28,Senate,"Read third time and passed Senate (39-Y 0-N)",39,0,0,1,40
1911597,1480116,2025-02-04,House,"Reported from General Laws (21-Y 0-N)",21,0,0,1,22
1911597,1483912,2025-02-07,House,"Passed House (94-Y 0-N)",94,0,0,6,100
1911601,1473380,2025-01-22,Senate,"Reported from General Laws and Technology (8-Y 0-N 6-A)",8,0,6,1,15
1911601,1474496,2025-01-24,Senate,"Constitutional reading dispensed (on 1st reading) (37-Y 0-N)",37,0,0,3,40
1911601,1476886,2025-01-28,Senate,"Read third time and passed Senate (21-Y 18-N)",21,18,0,1,40
1911601,1486448,2025-02-11,House,"Subcommittee recommends reporting (5-Y 3-N)",5,3,0,1,9
1911601,1489433,2025-02-13,House,"Reported from Labor and Commerce (12-Y 10-N)",12,10,0,0,22
1911601,1492076,2025-02-18,House,"Passed House (50-Y 47-N)",50,47,0,3,100
1911607,1473328,2025-01-22,Senate,"Reported from General Laws and Technology with substitute and rereferred to Finance and Appropriations (15-Y 0-N)",15,0,0,0,15
1911612,1472974,2025-01-22,Senate,"Reported from Finance and Appropriations (10-Y 4-N)",10,4,0,1,15
1911612,1473786,2025-01-17,Senate,"Reported from Courts of Justice with substitute and rereferred to Finance and Appropriations (9-Y 6-N)",9,6,0,0,15
1911612,1473787,2025-01-23,Senate,"Constitutional reading dispensed (on 1st reading) (39-Y 0-N)",39,0,0,1,40
1911612,1475441,2025-01-27,Senate,"Read third time and passed Senate (20-Y 18-N)",20,18,0,2,40
1911612,1483939,2025-02-07,House,"Reported from Public Safety (11-Y 10-N)",11,10,0,1,22
1911612,1487763,2025-02-12,House,"Passed House with substitute (50-Y 47-N)",50,47,0,3,100
1911612,1490023,2025-02-14,Senate,"House substitute agreed to by Senate (21-Y 15-N)",21,15,0,4,40
1911620,1473502,2025-01-23,Senate,"Reported from Education and Health with substitute (9-Y 6-N)",9,6,0,0,15
1911620,1474278,2025-01-24,Senate,"Constitutional reading dispensed (on 1st reading) (37-Y 0-N)",37,0,0,3,40
1911620,1480014,2025-02-03,Senate,"Engrossment reconsidered by Senate",40,0,0,0,40
1911620,1480015,2025-02-03,Senate,"Committee substitute reconsidered",40,0,0,0,40
1911620,1480016,2025-02-03,Senate,"Constitutional reading dispensed (on 3rd reading) (38-Y 0-N)",38,0,0,2,40
1911620,1480017,2025-02-03,Senate,"Passed Senate (21-Y 19-N)",21,19,0,0,40
1911620,1564916,2025-02-03,Senate,"Education and Health Substitute rejected",19,21,0,0,40
1911626,1473527,2025-01-23,Senate,"Passed by indefinitely in Education and Health (9-Y 6-N)",9,6,0,0,15
1911631,1473953,2025-01-17,Senate,"Reported from Rules and rereferred to Finance and Appropriations (15-Y 0-N)",15,0,0,0,15
1911631,1476314,2025-01-29,Senate,"Reported from Finance and Appropriations with substitute (15-Y 0-N)",15,0,0,0,15
1911631,1477351,2025-01-30,Senate,"Constitutional reading dispensed (on 1st reading) (39-Y 0-N 1-A)",39,0,1,0,40
1911631,1479308,2025-01-31,Senate,"Constitutional reading dispensed (on 3rd reading) (40-Y 0-N)",40,0,0,0,40
1911631,1479309,2025-01-31,Senate,"Passed Senate (40-Y 0-N)",40,0,0,0,40
1911631,1484641,2025-02-10,House,"Reported from Appropriations with amendment(s) (22-Y 0-N)",22,0,0,0,22
1911631,1489753,2025-02-13,House,"Passed House with amendment (96-Y 0-N)",96,0,0,4,100
1911631,1491613,2025-02-17,Senate,"House Amendment agreed to by Senate (39-Y 0-N)",39,0,0,1,40
1911636,1473545,2025-01-23,Senate,"Reported from Education and Health (15-Y 0-N)",15,0,0,0,15
1911636,1474577,2025-01-24,Senate,"Constitutional reading dispensed (on 1st reading) (37-Y 0-N)",37,0,0,3,40
1911636,1476301,2025-01-28,Senate,"Read third time and passed Senate (39-Y 0-N)",39,0,0,1,40
1911636,1480770,2025-02-05,House,"Reported from Education with amendment(s) (20-Y 0-N)",20,0,0,2,22
1911636,1484657,2025-02-10,House,"Passed House with amendment (95-Y 0-N)",95,0,0,5,100
1911636,1487703,2025-02-12,Senate,"House Amendments rejected by Senate (0-Y 39-N)",0,39,0,1,40
1911636,1491290,2025-02-17,Senate,"Senate acceded to request (39-Y 0-N)",39,0,0,1,40
1911636,1496600,2025-02-21,Senate,"Conference report agreed to by Senate (40-Y 0-N)",40,0,0,0,40
1911636,1504120,2025-02-21,House,"Conference report agreed to by House (95-Y 0-N)",95,0,0,5,100
1911640,1475996,2025-01-28,House,"Subcommittee recommends reporting with substitute (6-Y 4-N)",6,4,0,1,11
1911640,1477746,2025-01-30,House,,7,15,0,0,22
1911646,1473550,2025-01-23,Senate,"Reported from Education and Health (10-Y 5-N)",10,5,0,0,15
1911646,1474573,2025-01-24,Senate,"Constitutional reading dispensed (on 1st reading) (37-Y 0-N)",37,0,0,3,40
1911646,1476686,2025-01-28,Senate,"Read third time and passed Senate (21-Y 18-N)",21,18,0,1,40
1911646,1480713,2025-02-05,House,"Reported from Education (14-Y 6-N)",14,6,0,2,22
1911646,1487674,2025-02-12,House,"Passed House (54-Y 42-N)",54,42,0,4,100
1911652,1473514,2025-01-23,Senate,"Reported from Education and Health (15-Y 0-N)",15,0,0,0,15
1911652,1474633,2025-01-24,Senate,"Constitutional reading dispensed (on 1st reading) (37-Y 0-N)",37,0,0,3,40
1911652,1476369,2025-01-28,Senate,"Read third time and passed Senate (39-Y 0-N)",39,0,0,1,40
1911652,1486081,2025-02-11,House,"Subcommittee recommends reporting (8-Y 0-N)",8,0,0,1,9
1911652,1488723,2025-02-13,House,"Reported from Health and Human Services (22-Y 0-N)",22,0,0,0,22
1911652,1493025,2025-02-18,House,"Passed House (97-Y 0-N)",97,0,0,3,100
1911661,1473917,2025-01-20,Senate,"Reported from Commerce and Labor and rereferred to Finance and Appropriations (9-Y 6-N)",9,6,0,0,15
1911665,1477221,2025-01-30,Senate,"Reported from Education and Health with substitute (15-Y 0-N)",15,0,0,0,15
1911665,1478157,2025-01-31,Senate,"Constitutional reading dispensed (on 1st reading) (39-Y 0-N)",39,0,0,1,40
1911665,1480304,2025-02-03,Senate,"Constitutional reading dispensed (on 3rd reading) (40-Y 0-N)",40,0,0,0,40
1911665,1480305,2025-02-03,Senate,"Passed Senate (40-Y 0-N)",40,0,0,0,40
1911665,1485962,2025-02-11,House,"Reported from Health and Human Services (22-Y 0-N)",22,0,0,0,22
1911665,1490691,2025-02-14,House,"Passed House (96-Y 0-N)",96,0,0,4,100
1911671,1474186,2025-01-24,Senate,"Passed by indefinitely in Rehabilitation and Social Services (8-Y 7-N)",8,7,0,0,15
1911679,1473250,2025-01-22,Senate,"Reported from General Laws and Technology and rereferred to Finance and Appropriations (13-Y 1-N)",13,1,0,1,15
1911684,1473376,2025-01-22,Senate,"Reported from General Laws and Technology (15-Y 0-N)",15,0,0,0,15
1911684,1474604,2025-01-24,Senate,"Constitutional reading dispensed (on 1st reading) (37-Y 0-N)",37,0,0,3,40
1911684,1476365,2025-01-28,Senate,"Read third time and passed Senate (39-Y 0-N)",39,0,0,1,40
1911684,1486779,2025-02-11,House,"Reported from General Laws (19-Y 0-N)",19,0,0,3,22
1911684,1490685,2025-02-14,House,"Passed House (96-Y 0-N)",96,0,0,4,100
1911690,1471701,2025-01-15,Senate,"Reported from Courts of Justice (13-Y 0-N 2-A)",13,0,2,0,15
1911690,1472236,2025-01-17,Senate,"Constitutional reading dispensed (on 1st reading) (40-Y 0-N)",40,0,0,0,40
1911690,1472733,2025-01-21,Senate,"Read third time and passed Senate (40-Y 0-N)",40,0,0,0,40
1911690,1482784,2025-02-05,House,"Reported from Courts of Justice (22-Y 0-N)",22,0,0,0,22
1911690,1484706,2025-02-10,House,"Passed House (95-Y 0-N)",95,0,0,5,100
1911695,1473900,2025-01-22,Senate,"Reported from General Laws and Technology with substitute (15-Y 0-N)",15,0,0,0,15
1911695,1474584,2025-01-24,Senate,"Constitutional reading dispensed (on 1st reading) (37-Y 0-N)",37,0,0,3,40
1911695,1476209,2025-01-28,Senate,"Read third time and passed Senate (39-Y 0-N)",39,0,0,1,40
1911695,1483388,2025-02-06,House,"Reported from Labor and Commerce with substitute (12-Y 9-N)",12,9,0,1,22
1911695,1487504,2025-02-12,House,"Passed House with substitute (50-Y 47-N)",50,47,0,3,100
1911695,1490693,2025-02-14,Senate,"House substitute agreed to by Senate (36-Y 0-N)",36,0,0,4,40
1911695,1534667,2025-04-02,Senate,"Senate rejected Governor's recommendation (17-Y 23-N)",17,23,0,0,40
1911701,1472274,2025-01-17,Senate,"Passed by indefinitely in Courts of Justice with letter (15-Y 0-N)",15,0,0,0,15
1911705,1473891,2025-01-17,Senate,"Passed by indefinitely in Rules (10-Y 5-N)",10,5,0,0,15
1911711,1475824,2025-01-28,Senate,"Reported from Agriculture, Conservation and Natural Resources with substitute (8-Y 5-N 1-A)",8,5,1,1,15
1911711,1477435,2025-01-30,Senate,"Constitutional reading dispensed (on 1st reading) (39-Y 0-N 1-A)",39,0,1,0,40
1911711,1482234,2025-02-04,Senate,"Read third time and passed Senate (21-Y 18-N)",21,18,0,1,40
1911711,1487461,2025-02-12,House,"Subcommittee recommends reporting with substitute (6-Y 4-N)",6,4,0,1,11
1911711,1487462,2025-02-12,House,"Reported from Agriculture, Chesapeake and Natural Resources with substitute (15-Y 7-N)",15,7,0,0,22
1911711,1491166,2025-02-17,House,"Passed House with substitute (55-Y 41-N)",55,41,0,4,100
1911711,1492361,2025-02-18,Senate,"House substitute agreed to by Senate (22-Y 17-N)",22,17,0,1,40
1911719,1471507,2025-01-13,Senate,"Reported from Local Government (13-Y 0-N)",13,0,0,0,13
1911719,1471508,2025-01-14,Senate,"Constitutional reading dispensed (on 1st reading) (37-Y 0-N)",37,0,0,1,38
1911719,1471981,2025-01-16,Senate,"Read third time and passed Senate (39-Y 0-N)",39,0,0,1,40
1911719,1487288,2025-02-12,House,"Subcommittee recommends reporting (8-Y 0-N)",8,0,0,1,9
1911719,1489944,2025-02-14,House,"Reported from Counties, Cities and Towns (21-Y 0-N)",21,0,0,1,22
1911719,1494653,2025-02-19,House,"Passed House (97-Y 0-N)",97,0,0,3,100
1911726,1473873,2025-01-21,Senate,"Passed by indefinitely in Privileges and Elections (8-Y 7-N)",8,7,0,0,15
1911730,1475652,2025-01-27,Senate,"Reported from Commerce and Labor with substitute (13-Y 2-N)",13,2,0,0,15
1911730,1477224,2025-01-29,Senate,"Constitutional reading dispensed (on 1st reading) (38-Y 0-N)",38,0,0,2,40
1911730,1478150,2025-01-31,Senate,"Read third time and passed Senate (22-Y 18-N)",22,18,0,0,40
1911730,1489471,2025-02-13,House,"Reported from Labor and Commerce with substitute (17-Y 5-N)",17,5,0,0,22
1911730,1491920,2025-02-18,House,"Passed House with substitute (70-Y 26-N)",70,26,0,4,100
1911730,1495729,2025-02-19,Senate,"House substitute agreed to by Senate (21-Y 19-N)",21,19,0,0,40
1911730,1536291,2025-04-02,Senate,"Senate rejected Governor's recommendation (19-Y 21-N)",19,21,0,0,40
1911735,1473715,2025-01-22,Senate,"Reported from General Laws and Technology and rereferred to Finance and Appropriations (15-Y 0-N)",15,0,0,0,15
1911735,1477752,2025-01-29,Senate,"Reported from Finance and Appropriations (14-Y 0-N)",14,0,0,1,15
1911735,1477753,2025-01-30,Senate,"Constitutional reading dispensed (on 1st reading) (39-Y 0-N 1-A)",39,0,1,0,40
1911735,1479180,2025-01-31,Senate,"Constitutional reading dispensed (on 3rd reading) (40-Y 0-N)",40,0,0,0,40
1911735,1479181,2025-01-31,Senate,"Passed Senate (40-Y 0-N)",40,0,0,0,40
1911735,1483497,2025-02-06,House,"Reported from General Laws (21-Y 0-N)",21,0,0,1,22
1911735,1486807,2025-02-11,House,"Passed House (94-Y 0-N)",94,0,0,6,100
1911740,1473419,2025-01-22,Senate,"Reported from Courts of Justice with amendments and rereferred to Finance and Appropriations (10-Y 5-N)",10,5,0,0,15
1911745,1476925,2025-01-29,Senate,"Reported from Courts of Justice with amendment (15-Y 0-N)",15,0,0,0,15
1911745,1478591,2025-01-31,Senate,"Constitutional reading dispensed (on 1st reading) (39-Y 0-N)",39,0,0,1,40
1911745,1480496,2025-02-03,Senate,"Constitutional reading dispensed (on 3rd reading) (40-Y 0-N)",40,0,0,0,40
1911745,1480497,2025-02-03,Senate,"Passed Senate (40-Y 0-N)",40,0,0,0,40
1911745,1485104,2025-02-10,House,"Reported from Courts of Justice (22-Y 0-N)",22,0,0,0,22
1911745,1490436,2025-02-13,House,"Passed House (96-Y 0-N)",96,0,0,4,100
1911752,1473853,2025-01-21,Senate,"Passed by indefinitely in Privileges and Elections (8-Y 7-N)",8,7,0,0,15
1911757,1473542,2025-01-23,Senate,"Reported from Education and Health (15-Y 0-N)",15,0,0,0,15
1911757,1474570,2025-01-24,Senate,"Constitutional reading dispensed (on 1st reading) (37-Y 0-N)",37,0,0,3,40
1911757,1476304,2025-01-28,Senate,"Read third time and passed Senate (39-Y 0-N)",39,0,0,1,40
1911757,1485901,2025-02-11,House,"Reported from Health and Human Services (22-Y 0-N)",22,0,0,0,22
1911757,1490311,2025-02-14,House,"Passed House (96-Y 0-N)",96,0,0,4,100
1911763,1475699,2025-01-27,Senate,"Passed by indefinitely in Commerce and Labor with letter (15-Y 0-N)",15,0,0,0,15
1911770,1473297,2025-01-22,Senate,"Reported from Courts of Justice with substitute (15-Y 0-N)",15,0,0,0,15
1911770,1474587,2025-01-24,Senate,"Constitutional reading dispensed (on 1st reading) (37-Y 0-N)",37,0,0,3,40
1911770,1476344,2025-01-28,Senate,"Read third time and passed Senate (39-Y 0-N)",39,0,0,1,40
1911770,1484053,2025-02-07,House,"Subcommittee recommends laying on the table (5-Y 3-N)",5,3,0,1,9
1911774,1474959,2025-01-27,Senate,"Incorporated by Courts of Justice (SB746-McDougle) (14-Y 0-N)",14,0,0,1,15
1911779,1472588,2025-01-21,Senate,"Stricken at request of Patron in Finance and Appropriations (14-Y 0-N)",14,0,0,1,15
1911786,1473731,2025-01-20,Senate,"Rereferred from Commerce and Labor and Rereferred to Finance and Appropriations to Finance and Appropriations (12-Y 0-N)",12,0,0,3,15
1911786,1475666,2025-01-28,Senate,"Reported from Finance and Appropriations (15-Y 0-N)",15,0,0,0,15
1911786,1476528,2025-01-29,Senate,"Constitutional reading dispensed (on 1st reading) (38-Y 0-N)",38,0,0,2,40
1911786,1477552,2025-01-30,Senate,"Read third time and passed Senate (40-Y 0-N)",40,0,0,0,40
1911786,1479344,2025-01-30,Senate,"Constitutional reading dispensed (on 3rd reading) (39-Y 1-N)",39,1,0,0,40
1911786,1479345,2025-01-30,Senate,"Passed Senate (40-Y 0-N)",39,1,0,0,40
1911786,1484645,2025-02-10,House,"Reported from Appropriations (22-Y 0-N)",22,0,0,0,22
1911786,1489991,2025-02-13,House,"Passed House (88-Y 9-N)",88,9,0,3,100
1911791,1471801,2025-01-15,Senate,"Stricken at request of Patron in Courts of Justice (11-Y 0-N)",11,0,0,4,15
1911795,1475836,2025-01-28,Senate,"Passed by indefinitely in Agriculture, Conservation and Natural Resources with letter (11-Y 2-N 1-A)",11,2,1,1,15
1911801,1473512,2025-01-23,Senate,"Reported from Education and Health with substitute (15-Y 0-N)",15,0,0,0,15
1911801,1474568,2025-01-24,Senate,"Constitutional reading dispensed (on 1st reading) (37-Y 0-N)",37,0,0,3,40
1911801,1476655,2025-01-28,Senate,"Read third time and passed Senate (39-Y 0-N)",39,0,0,1,40
1911801,1486122,2025-02-11,House,"Subcommittee recommends reporting (6-Y 1-N)",6,1,0,2,9
1911801,1490767,2025-02-17,House,"Reported from Education (13-Y 9-N)",13,9,0,0,22
1911801,1496561,2025-02-20,House,"Passed House (59-Y 39-N)",59,39,0,2,100
1911807,1473573,2025-01-23,Senate,"Reported from Education and Health with amendments and rereferred to Finance and Appropriations (15-Y 0-N)",15,0,0,0,15
1911812,1475140,2025-01-27,Senate,"Reported from Commerce and Labor and rereferred to Finance and Appropriations (15-Y 0-N)",15,0,0,0,15
1911812,1477626,2025-01-30,Senate,"Reported from Finance and Appropriations (15-Y 0-N)",15,0,0,0,15
1911812,1479834,2025-02-04,Senate,"Constitutional reading dispensed (on 3rd reading) (39-Y 0-N)",39,0,0,1,40
1911812,1479835,2025-02-04,Senate,"Passed Senate (40-Y 0-N)",40,0,0,0,40
1911812,1480303,2025-02-03,Senate,"Constitutional reading dispensed (on 1st reading) (40-Y 0-N)",40,0,0,0,40
1911812,1489424,2025-02-13,House,"Reported from Labor and Commerce with amendment(s) (22-Y 0-N)",22,0,0,0,22
1911812,1492066,2025-02-18,House,"Passed House with amendment (97-Y 0-N)",97,0,0,3,100
1911812,1495854,2025-02-19,Senate,"House Amendment agreed to by Senate (40-Y 0-N)",40,0,0,0,40
1911819,1473327,2025-01-22,Senate,"Reported from Courts of Justice with amendments and rereferred to Finance and Appropriations (14-Y 0-N)",14,0,0,1,15
1911823,1476916,2025-01-29,Senate,"Reported from Courts of Justice (10-Y 4-N 1-A)",10,4,1,0,15
1911823,1478617,2025-01-31,Senate,"Constitutional reading dispensed (on 1st reading) (39-Y 0-N)",39,0,0,1,40
1911823,1479980,2025-02-04,Senate,"Read third time and passed Senate (21-Y 19-N)",21,19,0,0,40
1911823,1485124,2025-02-10,House,"Subcommittee recommends reporting (7-Y 1-N)",7,1,0,1,9
1911823,1490615,2025-02-14,House,"Reported from Courts of Justice (17-Y 4-N)",17,4,0,1,22
1911823,1494734,2025-02-19,House,"Passed House (67-Y 30-N)",67,30,0,3,100
1911828,1478031,2025-01-30,Senate,"Reported from Education and Health with amendments (7-Y 6-N 2-A)",7,6,2,0,15
1911828,1478159,2025-01-31,Senate,"Constitutional reading dispensed (on 1st reading) (39-Y 0-N)",39,0,0,1,40
1911828,1479717,2025-02-04,Senate,"Read third time and passed Senate (21-Y 19-N)",21,19,0,0,40
1911834,1478054,2025-01-30,Senate,"Reported from Education and Health (15-Y 0-N)",15,0,0,0,15
1911834,1478618,2025-01-31,Senate,"Constitutional reading dispensed (on 1st reading) (39-Y 0-N)",39,0,0,1,40
1911834,1480381,2025-02-03,Senate,"Constitutional reading dispensed (on 3rd reading) (40-Y 0-N)",40,0,0,0,40
1911834,1480382,2025-02-03,Senate,"Passed Senate (40-Y 0-N)",40,0,0,0,40
1911834,1490794,2025-02-17,House,"Reported from Education (15-Y 7-N)",15,7,0,0,22
1911834,1496692,2025-02-20,House,"Passed House (66-Y 31-N)",66,31,0,3,100
1911838,1473812,2025-01-21,Senate,"Reported from Privileges and Elections (8-Y 6-N 1-A)",8,6,1,0,15
1911838,1473813,2025-01-23,Senate,"Constitutional reading dispensed (on 1st reading) (39-Y 0-N)",39,0,0,1,40
1911838,1475469,2025-01-27,Senate,"Engrossment reconsidered by Senate",38,0,0,2,40
1911838,1475470,2025-01-27,Senate,"Passed Senate (27-Y 11-N)",27,11,0,2,40
1911838,1483914,2025-02-07,House,"Reported from Privileges and Elections (16-Y 6-N)",16,6,0,0,22
1911838,1487683,2025-02-12,House,"Passed House (55-Y 42-N)",55,42,0,3,100
1911841,1473907,2025-01-17,Senate,"Reported from Rules and rereferred to Finance and Appropriations (15-Y 0-N)",15,0,0,0,15
1911913,1473428,2025-01-22,Senate,"Reported from Courts of Justice with substitute and rereferred to Finance and Appropriations (14-Y 0-N)",14,0,0,1,15
1911913,1477152,2025-01-29,Senate,"Reported from Finance and Appropriations (15-Y 0-N)",15,0,0,0,15
1911913,1477540,2025-01-30,Senate,"Constitutional reading dispensed (on 1st reading) (39-Y 0-N 1-A)",39,0,1,0,40
1911913,1478861,2025-01-31,Senate,"Constitutional reading dispensed (on 3rd reading)",40,0,0,0,40
1911913,1478862,2025-01-31,Senate,"Passed Senate",40,0,0,0,40
1911913,1487989,2025-02-12,House,"Subcommittee recommends reporting with substitute (8-Y 0-N)",8,0,0,1,9
1911913,1490462,2025-02-14,House,"Reported from Courts of Justice with substitute (21-Y 0-N)",21,0,0,1,22
1911913,1493254,2025-02-19,House,"Passed House with substitute (97-Y 0-N)",97,0,0,3,100
1911913,1494966,2025-02-20,Senate,"House substitute agreed to by Senate (38-Y 1-N)",38,1,0,1,40
1911913,1534646,2025-04-02,Senate,"Senate concurred in Governor's recommendation (40-Y 0-N)",40,0,0,0,40
1911913,1536894,2025-04-02,House,"House concurred in Governor's recommendation (96-Y 0-N)",96,0,0,4,100
1911916,1477627,2025-01-30,Senate,"Reported from Education and Health (13-Y 2-N)",13,2,0,0,15
1911916,1478354,2025-01-31,Senate,"Constitutional reading dispensed (on 1st reading) (39-Y 0-N)",39,0,0,1,40
1911916,1480208,2025-02-04,Senate,"Read third time and passed Senate (39-Y 1-N)",39,1,0,0,40
1911916,1490741,2025-02-17,House,"Reported from Education with amendment(s) (22-Y 0-N)",22,0,0,0,22
1911916,1495998,2025-02-20,Senate,"House Amendments agreed to by Senate (39-Y 0-N)",39,0,0,1,40
1911916,1496189,2025-02-20,House,"Passed House with amendments (98-Y 0-N)",98,0,0,2,100
1911921,1477852,2025-01-30,Senate,"Passed by indefinitely in Transportation with letter (15-Y 0-N)",15,0,0,0,15
1911924,1476912,2025-01-29,Senate,"Reported from Courts of Justice (15-Y 0-N)",15,0,0,0,15
1911924,1478590,2025-01-31,Senate,"Constitutional reading dispensed (on 1st reading) (39-Y 0-N)",39,0,0,1,40
1911924,1480262,2025-02-03,Senate,"Constitutional reading dispensed (on 3rd reading) (40-Y 0-N)",40,0,0,0,40
1911924,1480263,2025-02-03,Senate,"Passed Senate (40-Y 0-N)",40,0,0,0,40
1911924,1485262,2025-02-10,House,"Reported from Courts of Justice (22-Y 0-N)",22,0,0,0,22
1911924,1489439,2025-02-13,House,"Passed House (96-Y 0-N)",96,0,0,4,100
1911930,1474110,2025-01-16,Senate,"Reported from Transportation to Finance and Appropriations (15-Y 0-N)",15,0,0,0,15
1911936,1475132,2025-01-27,Senate,"Reported from Commerce and Labor with substitute (9-Y 6-N)",9,6,0,0,15
1911936,1476191,2025-01-29,Senate,"Constitutional reading dispensed (on 1st reading) (38-Y 0-N)",38,0,0,2,40
1911936,1479956,2025-02-03,Senate,"Read third time and passed Senate (34-Y 6-N)",34,6,0,0,40
1911936,1486546,2025-02-11,House,"Subcommittee recommends reporting with amendment(s) (4-Y 3-N)",4,3,0,1,8
1911936,1489393,2025-02-13,House,"Reported from Labor and Commerce with amendment(s) (12-Y 10-N)",12,10,0,0,22
1911936,1491857,2025-02-18,House,"Passed House with amendment (50-Y 47-N)",50,47,0,3,100
1911936,1494063,2025-02-19,Senate,"House Amendment agreed to by Senate (39-Y 1-N)",39,1,0,0,40
1911936,1494064,2025-02-19,Senate,"House amendment agreed to by Senate (29-Y 10-N 1-A)",29,10,1,0,40
1911936,1564811,2025-02-19,Senate,"Reconsideration of (40-Y 0-N)",40,0,0,0,40
1911940,1471772,2025-01-15,Senate,"Rereferred from General Laws and Technology to Finance and Appropriations (15-Y 0-N)",15,0,0,0,15
1911940,1475357,2025-01-28,Senate,"Reported from Finance and Appropriations (15-Y 0-N)",15,0,0,0,15
1911940,1476176,2025-01-29,Senate,"Constitutional reading dispensed (on 1st reading) (38-Y 0-N)",38,0,0,2,40
1911940,1477284,2025-01-30,Senate,"Read third time and passed Senate (40-Y 0-N)",40,0,0,0,40
1911940,1479258,2025-01-30,Senate,"Constitutional reading dispensed (on 3rd reading) (39-Y 1-N)",39,1,0,0,40
1911940,1479259,2025-01-30,Senate,"Passed Senate (40-Y 0-N)",39,1,0,0,40
1911947,1474075,2025-01-20,Senate,"Reported from Commerce and Labor and rereferred to Finance and Appropriations (15-Y 0-N)",15,0,0,0,15
1911947,1475338,2025-01-28,Senate,"Reported from Finance and Appropriations (14-Y 0-N 1-A)",14,0,1,0,15
1911947,1476211,2025-01-29,Senate,"Constitutional reading dispensed (on 1st reading) (38-Y 0-N)",38,0,0,2,40
1911947,1478417,2025-01-31,Senate,"Read third time and passed Senate (40-Y 0-N)",40,0,0,0,40
1911947,1483299,2025-02-06,House,"Reported from Labor and Commerce (21-Y 0-N)",21,0,0,1,22
1911947,1486782,2025-02-11,House,"Passed House (94-Y 0-N)",94,0,0,6,100
1911953,1472348,2025-01-20,Senate,"Constitutional reading dispensed (on 1st reading) (40-Y 0-N)",40,0,0,0,40
1911953,1473821,2025-01-16,Senate,"Reported from Transportation with amendment (14-Y 0-N)",14,0,0,1,15
1911953,1473822,2025-01-23,Senate,"Read third time and passed Senate (39-Y 0-N)",39,0,0,1,40
1911953,1486849,2025-02-11,House,"Reported from General Laws with amendment(s) (19-Y 0-N)",19,0,0,3,22
1911953,1490558,2025-02-14,House,"Passed House (96-Y 0-N)",96,0,0,4,100
1911958,1477151,2025-01-30,Senate,"Reported from Education and Health with substitute (15-Y 0-N)",15,0,0,0,15
1911958,1478067,2025-01-31,Senate,"Constitutional reading dispensed (on 1st reading) (39-Y 0-N)",39,0,0,1,40
1911958,1480008,2025-02-03,Senate,"Constitutional reading dispensed (on 3rd reading) (40-Y 0-N)",40,0,0,0,40
1911958,1480009,2025-02-03,Senate,"Passed Senate (40-Y 0-N)",40,0,0,0,40
1911958,1486735,2025-02-11,House,"Subcommittee recommends reporting (6-Y 1-N)",6,1,0,2,9
1911958,1491493,2025-02-17,House,"Reported from Education (22-Y 0-N)",22,0,0,0,22
1911958,1496295,2025-02-20,House,"Passed House (98-Y 0-N)",98,0,0,2,100
1911964,1472395,2025-01-20,Senate,"Reading waived (on 1st reading) (40-Y 0-N)",40,0,0,0,40
1911964,1490791,2025-02-17,House,"Reported from Rules (18-Y 0-N)",18,0,0,0,18
1911964,1495664,2025-02-20,House,"Agreed to by House (97-Y 0-N)",97,0,0,3,100
1911969,1473905,2025-01-22,Senate,"Reported from Courts of Justice with substitute and rereferred to Finance and Appropriations (15-Y 0-N)",15,0,0,0,15
1911969,1475325,2025-01-28,Senate,"Reported from Finance and Appropriations (15-Y 0-N)",15,0,0,0,15
1911969,1477232,2025-01-29,Senate,"Constitutional reading dispensed (on 1st reading) (38-Y 0-N)",38,0,0,2,40
1911969,1478168,2025-01-30,Senate,"Constitutional reading dispensed (on 3rd reading) (39-Y 1-N)",39,1,0,0,40
1911969,1478169,2025-01-30,Senate,"Read third time and passed Senate (40-Y 0-N)",40,0,0,0,40
1911969,1480796,2025-02-05,House,"Subcommittee recommends reporting (7-Y 1-N)",7,1,0,1,9
1911969,1490047,2025-02-14,House,"Reported from Courts of Justice with amendment(s) (21-Y 0-N)",21,0,0,1,22
1911969,1493343,2025-02-19,House,"Passed House with amendments (97-Y 0-N)",97,0,0,3,100
1911969,1495036,2025-02-20,Senate,"House Amendments agreed to by Senate (39-Y 0-N)",39,0,0,1,40
1911969,1534774,2025-04-02,Senate,"Senate concurred in Governor's recommendation (40-Y 0-N)",40,0,0,0,40
1911969,1564816,2025-04-02,House,"House concurred in Governor's recommendation (96-Y 0-N)",96,0,0,4,100
1911978,1472322,2025-01-20,Senate,"Reported from Local Government (8-Y 7-N)",8,7,0,0,15
1911978,1472655,2025-01-21,Senate,"Constitutional reading dispensed (on 1st reading) (40-Y 0-N)",40,0,0,0,40
1911978,1474288,2025-01-23,Senate,"Read third time and passed Senate (20-Y 19-N)",20,19,0,1,40
1911978,1483099,2025-02-06,House,"Subcommittee recommends reporting (5-Y 3-N)",5,3,0,1,9
1911978,1484013,2025-02-07,House,"Reported from Counties, Cities and Towns (12-Y 9-N)",12,9,0,1,22
1911978,1487468,2025-02-12,House,"Passed House (50-Y 47-N)",50,47,0,3,100
1911987,1474325,2025-01-24,Senate,"Reported from Rehabilitation and Social Services with substitute and rereferred to Courts of Justice (15-Y 0-N)",15,0,0,0,15
1911987,1476608,2025-01-29,Senate,"Reported from Courts of Justice (15-Y 0-N)",15,0,0,0,15
1911987,1478373,2025-01-31,Senate,"Constitutional reading dispensed (on 1st reading) (39-Y 0-N)",39,0,0,1,40
1911987,1480301,2025-02-03,Senate,"Constitutional reading dispensed (on 3rd reading) (40-Y 0-N)",40,0,0,0,40
1911987,1480302,2025-02-03,Senate,"Passed Senate (40-Y 0-N)",40,0,0,0,40
1911987,1489921,2025-02-14,House,"Reported from Public Safety with substitute (11-Y 10-N)",11,10,0,1,22
1911987,1493435,2025-02-19,House,"Passed House with substitute (54-Y 43-N)",54,43,0,3,100
1911987,1495215,2025-02-20,Senate,"House substitute rejected by Senate (0-Y 39-N)",0,39,0,1,40
1911987,1496120,2025-02-20,Senate,"Senate acceded to request (38-Y 0-N)",38,0,0,2,40
1911994,1478040,2025-01-30,Senate,"Reported from Education and Health (15-Y 0-N)",15,0,0,0,15
1911994,1478180,2025-01-31,Senate,"Constitutional reading dispensed (on 1st reading) (39-Y 0-N)",39,0,0,1,40
1911994,1479888,2025-02-03,Senate,"Constitutional reading dispensed (on 3rd reading) (40-Y 0-N)",40,0,0,0,40
1911994,1479889,2025-02-03,Senate,"Passed Senate (40-Y 0-N)",40,0,0,0,40
1911994,1485958,2025-02-11,House,"Reported from Health and Human Services (22-Y 0-N)",22,0,0,0,22
1911994,1490260,2025-02-14,House,"Passed House (96-Y 0-N)",96,0,0,4,100
1911994,1536740,2025-04-02,Senate,"Senate concurred in Governor's recommendation (40-Y 0-N)",40,0,0,0,40
1911994,1536741,2025-04-02,House,"House concurred in Governor's recommendation (95-Y 0-N)",95,0,0,5,100
1911998,1476478,2025-01-29,Senate,"Passed by indefinitely in Courts of Justice with letter (15-Y 0-N)",15,0,0,0,15
1912004,1474713,2025-01-27,Senate,"Incorporated by Local Government (SB932-Salim) (14-Y 1-N)",14,1,0,0,15
1912012,1478038,2025-01-30,Senate,"Reported from Education and Health with substitute (15-Y 0-N)",15,0,0,0,15
1912012,1478187,2025-01-31,Senate,"Constitutional reading dispensed (on 1st reading) (39-Y 0-N)",39,0,0,1,40
1912012,1479916,2025-02-03,Senate,"Constitutional reading dispensed (on 3rd reading) (40-Y 0-N)",40,0,0,0,40
1912012,1479917,2025-02-03,Senate,"Passed Senate (40-Y 0-N)",40,0,0,0,40
1912012,1485970,2025-02-11,House,"Subcommittee recommends reporting with substitute (8-Y 0-N)",8,0,0,1,9
1912012,1488763,2025-02-13,House,"Reported from Health and Human Services with substitute (21-Y 0-N)",21,0,0,1,22
1912012,1492101,2025-02-18,House,"Passed House with substitute (97-Y 0-N)",97,0,0,3,100
1912012,1495904,2025-02-19,Senate,"House substitute agreed to by Senate (39-Y 0-N)",39,0,0,1,40
1912015,1475704,2025-01-27,Senate,"Passed by indefinitely in Commerce and Labor with letter (8-Y 7-N)",8,7,0,0,15
1912022,1475837,2025-01-28,Senate,"Incorporated by Finance and Appropriations (SB1083-Perry) (15-Y 0-N)",15,0,0,0,15
1912026,1477231,2025-01-30,Senate,"Reported from Education and Health with substitute (15-Y 0-N)",15,0,0,0,15
1912026,1478141,2025-01-31,Senate,"Constitutional reading dispensed (on 1st reading) (39-Y 0-N)",39,0,0,1,40
1912026,1480290,2025-02-03,Senate,"Constitutional reading dispensed (on 3rd reading) (40-Y 0-N)",40,0,0,0,40
1912026,1480291,2025-02-03,Senate,"Passed Senate (40-Y 0-N)",40,0,0,0,40
1912026,1488754,2025-02-13,House,"Reported from Health and Human Services (21-Y 0-N)",21,0,0,1,22
1912026,1491985,2025-02-18,House,"Passed House (97-Y 0-N)",97,0,0,3,100
1912031,1472437,2025-01-20,Senate,"Passed by indefinitely in Commerce and Labor (9-Y 6-N)",9,6,0,0,15
1912039,1472615,2025-01-21,Senate,"Constitutional reading dispensed (on 1st reading) (40-Y 0-N)",40,0,0,0,40
1912039,1473843,2025-01-20,Senate,"Reported from Courts of Justice with amendment (14-Y 0-N)",14,0,0,1,15
1912039,1473844,2025-01-23,Senate,"Read third time and passed Senate (39-Y 0-N)",39,0,0,1,40
1912039,1482598,2025-02-05,House,"Reported from Courts of Justice with substitute (19-Y 3-N)",19,3,0,0,22
1912039,1484619,2025-02-10,House,"Passed House with substitute (66-Y 29-N)",66,29,0,5,100
1912039,1488160,2025-02-12,Senate,"House substitute agreed to by Senate (39-Y 0-N)",39,0,0,1,40
1912044,1473624,2025-01-21,Senate,"Reported from Agriculture, Conservation and Natural Resources with substitute (12-Y 1-N)",12,1,0,2,15
1912044,1473625,2025-01-23,Senate,"Constitutional reading dispensed (on 1st reading) (39-Y 0-N)",39,0,0,1,40
1912044,1475360,2025-01-27,Senate,"Read third time and passed Senate (29-Y 9-N)",29,9,0,2,40
1912044,1487369,2025-02-12,House,"Reported from Agriculture, Chesapeake and Natural Resources with amendment(s) (17-Y 5-N)",17,5,0,0,22
1912044,1491067,2025-02-17,House,"Passed House with amendment (62-Y 33-N)",62,33,0,5,100
1912044,1492345,2025-02-18,Senate,"House Amendment agreed to by Senate (33-Y 7-N)",33,7,0,0,40
1912052,1472336,2025-01-20,Senate,"Constitutional reading dispensed (on 1st reading) (40-Y 0-N)",40,0,0,0,40
1912052,1472942,2025-01-22,Senate,"Read third time and passed Senate (40-Y 0-N)",40,0,0,0,40
1912052,1474104,2025-01-16,Senate,"Reported from Transportation (14-Y 0-N)",14,0,0,1,15
1912052,1483012,2025-02-06,House,"Reported from Transportation (20-Y 0-N)",20,0,0,2,22
1912052,1486120,2025-02-11,House,"Passed House (94-Y 0-N)",94,0,0,6,100
1912067,1472310,2025-01-20,Senate,"Reported from Local Government (11-Y 2-N 1-A)",11,2,1,1,15
1912067,1472731,2025-01-21,Senate,"Constitutional reading dispensed (on 1st reading) (40-Y 0-N)",40,0,0,0,40
1912067,1474310,2025-01-23,Senate,"Read third time and passed Senate (39-Y 0-N)",39,0,0,1,40
1912067,1480561,2025-02-05,House,"Subcommittee recommends reporting (7-Y 0-N)",7,0,0,2,9
1912067,1483957,2025-02-07,House,"Reported from Counties, Cities and Towns (21-Y 0-N)",21,0,0,1,22
1912067,1488305,2025-02-12,House,"Passed House (97-Y 0-N)",97,0,0,3,100
1912072,1471729,2025-01-15,Senate,"Reported from General Laws and Technology with substitute and rereferred to Finance and Appropriations (15-Y 0-N)",15,0,0,0,15
1912072,1473607,2025-01-22,Senate,"Reported from Finance and Appropriations with substitute (15-Y 0-N)",15,0,0,0,15
1912072,1473608,2025-01-23,Senate,"Constitutional reading dispensed (on 1st reading) (39-Y 0-N)",39,0,0,1,40
1912072,1475025,2025-01-27,Senate,"Read third time and passed Senate (38-Y 0-N)",38,0,0,2,40
1912072,1483387,2025-02-06,House,"Subcommittee recommends reporting (8-Y 0-N)",8,0,0,1,9
1912072,1486318,2025-02-11,House,"Reported from General Laws (19-Y 0-N)",19,0,0,3,22
1912072,1490279,2025-02-14,House,"Passed House (96-Y 0-N)",96,0,0,4,100
1912078,1473375,2025-01-22,Senate,"Passed by indefinitely in Courts of Justice (9-Y 6-N)",9,6,0,0,15
1912084,1472321,2025-01-20,Senate,"Failed to report (defeated) in Local Government (3-Y 12-N)",3,12,0,0,15
1912088,1475757,2025-01-28,Senate,"Reported from Education and Health and rereferred to Finance and Appropriations (15-Y 0-N)",15,0,0,0,15
1912095,1475831,2025-01-28,Senate,"Reported from Agriculture, Conservation and Natural Resources with amendment (13-Y 0-N 1-A)",13,0,1,1,15
1912101,1473537,2025-01-23,Senate,"Reported from Education and Health and rereferred to Finance and Appropriations (15-Y 0-N)",15,0,0,0,15
1912108,1478260,2025-01-31,Senate,"Reported from Rehabilitation and Social Services with substitute (15-Y 0-N)",15,0,0,0,15
1912108,1480289,2025-02-03,Senate,"Constitutional reading dispensed (on 1st reading) (40-Y 0-N)",40,0,0,0,40
1912108,1480834,2025-02-04,Senate,"Constitutional reading dispensed (on 3rd reading) (39-Y 0-N)",39,0,0,1,40
1912108,1480835,2025-02-04,Senate,"Passed Senate (40-Y 0-N)",40,0,0,0,40
1912108,1486784,2025-02-11,House,"Subcommittee recommends reporting (8-Y 0-N)",8,0,0,1,9
1912108,1488724,2025-02-13,House,"Reported from Health and Human Services (22-Y 0-N)",22,0,0,0,22
1912108,1494288,2025-02-18,House,"Passed House (97-Y 0-N)",97,0,0,3,100
1912108,1536279,2025-04-02,Senate,"Senate concurred in Governor's recommendation (40-Y 0-N)",40,0,0,0,40
1912108,1536280,2025-04-02,House,"House concurred in Governor's recommendation (96-Y 0-N)",96,0,0,4,100
1912115,1472402,2025-01-20,Senate,"Reported from Commerce and Labor with substitute and rereferred to Finance and Appropriations (14-Y 0-N 1-A)",14,0,1,0,15
1912119,1474504,2025-01-24,Senate,"Reported from General Laws and Technology with substitute and rereferred to Finance and Appropriations (15-Y 0-N)",15,0,0,0,15
1912119,1476317,2025-01-29,Senate,"Reported from Finance and Appropriations (15-Y 0-N)",15,0,0,0,15
1912119,1477346,2025-01-30,Senate,"Constitutional reading dispensed (on 1st reading) (39-Y 0-N 1-A)",39,0,1,0,40
1912119,1483284,2025-02-06,House,"Reported from General Laws (21-Y 0-N)",21,0,0,1,22
1912119,1489748,2025-02-12,House,"Passed House with amendments (95-Y 2-N)",95,2,0,3,100
1912119,1490682,2025-02-14,Senate,"House Amendments agreed to by Senate (36-Y 0-N)",36,0,0,4,40
1912123,1477263,2025-01-30,Senate,"Reported from Education and Health (11-Y 1-N 2-A)",11,1,2,1,15
1912123,1478208,2025-01-31,Senate,"Constitutional reading dispensed (on 1st reading) (39-Y 0-N)",39,0,0,1,40
1912123,1480711,2025-02-04,Senate,"Read third time and passed Senate (40-Y 0-N)",40,0,0,0,40
1912123,1484565,2025-02-10,House,"Subcommittee recommends reporting with amendment(s) (10-Y 0-N)",10,0,0,1,11
1912123,1487441,2025-02-12,House,"Reported from Education with amendment(s) (21-Y 0-N)",21,0,0,1,22
1912123,1491172,2025-02-17,House,"Passed House with amendment (95-Y 0-N)",95,0,0,5,100
1912123,1491173,2025-02-17,House,"Passed House with amendment (96-Y 0-N)",96,0,0,4,100
1912123,1492413,2025-02-18,Senate,"House Amendment agreed to by Senate (40-Y 0-N)",40,0,0,0,40
1912133,1474701,2025-01-27,Senate,"Reported from Local Government (15-Y 0-N)",15,0,0,0,15
1912133,1476803,2025-01-28,Senate,"Constitutional reading dispensed (on 1st reading) (39-Y 0-N)",39,0,0,1,40
1912133,1479198,2025-01-29,Senate,"Constitutional reading dispensed (on 3rd reading) (38-Y 0-N)",38,0,0,2,40
1912133,1479199,2025-01-29,Senate,"Passed Senate (38-Y 0-N)",38,0,0,2,40
1912133,1482999,2025-02-06,House,"Subcommittee recommends reporting (8-Y 0-N)",8,0,0,1,9
1912133,1484018,2025-02-07,House,"Reported from Counties, Cities and Towns (21-Y 0-N)",21,0,0,1,22
1912133,1487498,2025-02-12,House,"Passed House (97-Y 0-N)",97,0,0,3,100
1912137,1478818,2025-02-03,Senate,"Incorporated by Courts of Justice (SB1395-Peake) (14-Y 0-N)",14,0,0,1,15
1912141,1472341,2025-01-20,Senate,"Reported from Courts of Justice with substitute (15-Y 0-N)",15,0,0,0,15
1912141,1472681,2025-01-21,Senate,"Constitutional reading dispensed (on 1st reading) (40-Y 0-N)",40,0,0,0,40
1912141,1474224,2025-01-23,Senate,"Read third time and passed Senate (39-Y 0-N)",39,0,0,1,40
1912141,1482538,2025-02-05,House,"Reported from Courts of Justice with substitute (22-Y 0-N)",22,0,0,0,22
1912141,1484602,2025-02-10,House,"Passed House with substitute (95-Y 0-N)",95,0,0,5,100
1912141,1488697,2025-02-12,Senate,"House substitute agreed to by Senate (38-Y 0-N)",38,0,0,2,40
1912145,1478033,2025-01-30,Senate,"Reported from Education and Health with substitute (14-Y 0-N 1-A)",14,0,1,0,15
1912145,1478161,2025-01-31,Senate,"Constitutional reading dispensed (on 1st reading) (39-Y 0-N)",39,0,0,1,40
1912145,1480615,2025-02-04,Senate,"Read third time and passed Senate (40-Y 0-N)",40,0,0,0,40
1912145,1485949,2025-02-11,House,"Subcommittee recommends reporting with substitute (8-Y 0-N)",8,0,0,1,9
1912145,1488810,2025-02-13,House,"Reported from Health and Human Services with substitute (22-Y 0-N)",22,0,0,0,22
1912145,1492121,2025-02-18,House,"Passed House with substitute (97-Y 0-N)",97,0,0,3,100
1912145,1495865,2025-02-19,Senate,"House substitute agreed to by Senate (40-Y 0-N)",40,0,0,0,40
1912152,1471833,2025-01-15,Senate,"Rereferred from General Laws and Technology to Rehabilitation and Social Services (15-Y 0-N)",15,0,0,0,15
1912152,1474338,2025-01-24,Senate,"Reported from Rehabilitation and Social Services with substitute and rereferred to Finance and Appropriations (15-Y 0-N)",15,0,0,0,15
1912152,1477156,2025-01-29,Senate,"Reported from Finance and Appropriations with substitute (15-Y 0-N)",15,0,0,0,15
1912152,1477545,2025-01-30,Senate,"Constitutional reading dispensed (on 1st reading) (39-Y 0-N 1-A)",39,0,1,0,40
1912152,1479200,2025-01-31,Senate,"Constitutional reading dispensed (on 3rd reading) (40-Y 0-N)",40,0,0,0,40
1912152,1479201,2025-01-31,Senate,"Passed Senate (40-Y 0-N)",40,0,0,0,40
1912152,1483950,2025-02-07,House,"Reported from Public Safety with substitute (21-Y 0-N)",21,0,0,1,22
1912152,1488721,2025-02-12,House,"Passed House with substitute (97-Y 0-N)",97,0,0,3,100
1912152,1491931,2025-02-17,Senate,"House substitute agreed to by Senate (38-Y 0-N)",38,0,0,2,40
1912152,1491932,2025-02-17,Senate,"Reconsideration of House substitute agreed to by Senate (39-Y 0-N)",39,0,0,1,40
1912152,1491933,2025-02-17,Senate,"House substitute agreed to by Senate (39-Y 0-N)",39,0,0,1,40
1912158,1473407,2025-01-22,Senate,"Reported from Courts of Justice and rereferred to Finance and Appropriations (14-Y 0-N)",14,0,0,1,15
1912158,1477792,2025-01-29,Senate,"Reported from Finance and Appropriations (15-Y 0-N)",15,0,0,0,15
1912158,1477793,2025-01-30,Senate,"Constitutional reading dispensed (on 1st reading) (39-Y 0-N 1-A)",39,0,1,0,40
1912158,1479397,2025-01-31,Senate,"Constitutional reading dispensed (on 3rd reading) (40-Y 0-N)",40,0,0,0,40
1912158,1479398,2025-01-31,Senate,"Passed Senate (40-Y 0-N)",40,0,0,0,40
1912158,1484017,2025-02-07,House,"Subcommittee recommends reporting (8-Y 0-N)",8,0,0,1,9
1912158,1485318,2025-02-10,House,"Reported from Courts of Justice (22-Y 0-N)",22,0,0,0,22
1912158,1489301,2025-02-13,House,"Passed House (96-Y 0-N)",96,0,0,4,100
1912165,1474921,2025-01-27,Senate,"Reading waived (on 1st reading) (38-Y 0-N)",38,0,0,2,40
1912165,1490759,2025-02-17,House,"Reported from Rules with substitute (18-Y 0-N)",18,0,0,0,18
1912165,1565078,2025-02-20,House,"Agreed to by House with substitute (66-Y 31-N)",66,31,0,3,100
1912171,1475235,2025-01-27,Senate,"Passed by indefinitely in Courts of Justice (8-Y 6-N)",8,6,0,1,15
1912176,1475826,2025-01-28,Senate,"Reported from Agriculture, Conservation and Natural Resources and rereferred to Finance and Appropriations (14-Y 0-N)",14,0,0,1,15
1912181,1472363,2025-01-20,Senate,"Constitutional reading dispensed (on 1st reading) (40-Y 0-N)",40,0,0,0,40
1912181,1473062,2025-01-22,Senate,"Read third time and passed Senate (40-Y 0-N)",40,0,0,0,40
1912181,1473903,2025-01-17,Senate,"Reported from Rules (15-Y 0-N)",15,0,0,0,15
1912181,1490805,2025-02-17,House,"Reported from Rules with substitute (18-Y 0-N)",18,0,0,0,18
1912181,1495678,2025-02-20,Senate,"House substitute agreed to by Senate (39-Y 0-N)",39,0,0,1,40
1912181,1496638,2025-02-20,House,"Passed House with substitute (98-Y 0-N)",98,0,0,2,100
1912188,1472421,2025-01-20,Senate,"Reported from Commerce and Labor (15-Y 0-N)",15,0,0,0,15
1912188,1473044,2025-01-22,Senate,"Constitutional reading dispensed (on 1st reading) (40-Y 0-N)",40,0,0,0,40
1912188,1474640,2025-01-24,Senate,"Read third time and passed Senate (38-Y 0-N)",38,0,0,2,40
1912188,1483641,2025-02-06,House,"Reported from Labor and Commerce (21-Y 0-N)",21,0,0,1,22
1912188,1486804,2025-02-11,House,"Passed House (94-Y 0-N)",94,0,0,6,100
1912192,1472491,2025-01-20,Senate,"Reported from Commerce and Labor with amendment (15-Y 0-N)",15,0,0,0,15
1912192,1473217,2025-01-22,Senate,"Constitutional reading dispensed (on 1st reading) (40-Y 0-N)",40,0,0,0,40
1912192,1474639,2025-01-24,Senate,"Read third time and passed Senate (38-Y 0-N)",38,0,0,2,40
1912192,1486783,2025-02-11,House,"Subcommittee recommends reporting (7-Y 0-N)",7,0,0,1,8
1912192,1489811,2025-02-13,House,"Reported from Labor and Commerce (22-Y 0-N)",22,0,0,0,22
1912192,1492226,2025-02-18,House,"Passed House (97-Y 0-N)",97,0,0,3,100
1912198,1475901,2025-01-28,Senate,"Passed by indefinitely in Education and Health (9-Y 6-N)",9,6,0,0,15
1912205,1476022,2025-01-28,Senate,"Reported from Agriculture, Conservation and Natural Resources with amendment (14-Y 0-N)",14,0,0,1,15
1912205,1477662,2025-01-30,Senate,"Constitutional reading dispensed (on 1st reading) (39-Y 0-N 1-A)",39,0,1,0,40
1912205,1479298,2025-01-31,Senate,"Constitutional reading dispensed (on 3rd reading) (40-Y 0-N)",40,0,0,0,40
1912205,1479299,2025-01-31,Senate,"Passed Senate (40-Y 0-N)",40,0,0,0,40
1912205,1488232,2025-02-12,House,"Reported from Agriculture, Chesapeake and Natural Resources (22-Y 0-N)",22,0,0,0,22
1912205,1491013,2025-02-17,House,"Passed House (95-Y 0-N)",95,0,0,5,100
1912205,1491014,2025-02-17,House,"Passed House (96-Y 0-N)",96,0,0,4,100
1912208,1478028,2025-01-31,Senate,"Reported from Rehabilitation and Social Services with substitute (14-Y 1-N)",14,1,0,0,15
1912208,1479705,2025-02-04,Senate,"Constitutional reading dispensed (on 3rd reading) (40-Y 0-N)",40,0,0,0,40
1912208,1479706,2025-02-04,Senate,"Passed Senate (36-Y 4-N)",36,4,0,0,40
1912208,1480244,2025-02-03,Senate,"Constitutional reading dispensed (on 1st reading) (40-Y 0-N)",40,0,0,0,40
1912216,1475888,2025-01-28,Senate,"Passed by indefinitely in Education and Health (9-Y 6-N)",9,6,0,0,15
1912221,1474313,2025-01-24,Senate,"Reported from Rehabilitation and Social Services and rereferred to Finance and Appropriations (15-Y 0-N)",15,0,0,0,15
1912221,1477791,2025-01-29,Senate,"Passed by indefinitely in Finance and Appropriations (10-Y 5-N)",10,5,0,0,15
1912228,1475150,2025-01-27,Senate,"Incorporated by Commerce and Labor (SB960-Perry) (15-Y 0-N)",15,0,0,0,15
1912234,1478639,2025-02-03,Senate,"Passed by indefinitely in Courts of Justice (9-Y 6-N)",9,6,0,0,15
1912238,1473800,2025-01-23,Senate,"Reported from Education and Health (15-Y 0-N)",15,0,0,0,15
1912238,1474362,2025-01-24,Senate,"Constitutional reading dispensed (on 1st reading) (37-Y 0-N)",37,0,0,3,40
1912238,1476272,2025-01-28,Senate,"Read third time and passed Senate (39-Y 0-N)",39,0,0,1,40
1912238,1486442,2025-02-11,House,"Subcommittee recommends reporting (8-Y 0-N)",8,0,0,1,9
1912238,1488626,2025-02-13,House,"Reported from Health and Human Services (21-Y 0-N)",21,0,0,1,22
1912238,1492694,2025-02-18,House,"Passed House (97-Y 0-N)",97,0,0,3,100
1912245,1473572,2025-01-23,Senate,"Reported from Education and Health with substitute and rereferred to Finance and Appropriations (9-Y 6-N)",9,6,0,0,15
1912256,1474550,2025-01-23,Senate,"Passed by indefinitely in Finance and Appropriations (9-Y 5-N)",9,5,0,1,15
1912262,1474919,2025-01-27,Senate,"Reading waived (on 1st reading) (38-Y 0-N)",38,0,0,2,40
1912262,1491598,2025-02-17,House,"Passed by indefinitely in Rules (18-Y 0-N)",18,0,0,0,18
1912266,1471854,2025-01-15,Senate,"Reported from General Laws and Technology (15-Y 0-N)",15,0,0,0,15
1912266,1474088,2025-01-17,Senate,"Constitutional reading dispensed (on 1st reading) (40-Y 0-N)",40,0,0,0,40
1912266,1474089,2025-01-21,Senate,"Read third time and passed Senate (40-Y 0-N)",40,0,0,0,40
1912266,1483568,2025-02-06,House,"Subcommittee recommends reporting with substitute (8-Y 0-N)",8,0,0,1,9
1912266,1486845,2025-02-11,House,"Reported from General Laws with substitute (19-Y 0-N)",19,0,0,3,22
1912266,1490400,2025-02-14,House,"Passed House with substitute (96-Y 0-N)",96,0,0,4,100
1912266,1492390,2025-02-18,Senate,"House substitute agreed to by Senate",40,0,0,0,40
1912273,1471504,2025-01-13,Senate,"Reported from Local Government (13-Y 0-N)",13,0,0,0,13
1912273,1471605,2025-01-14,Senate,"Constitutional reading dispensed (on 1st reading) (37-Y 0-N)",37,0,0,1,38
1912273,1471948,2025-01-16,Senate,"Read third time and passed Senate (39-Y 0-N)",39,0,0,1,40
1912273,1483955,2025-02-07,House,"Reported from Counties, Cities and Towns (21-Y 0-N)",21,0,0,1,22
1912273,1488285,2025-02-12,House,"Passed House (97-Y 0-N)",97,0,0,3,100
1912279,1473292,2025-01-22,Senate,"Reported from General Laws and Technology with substitute (15-Y 0-N)",15,0,0,0,15
1912279,1474562,2025-01-24,Senate,"Constitutional reading dispensed (on 1st reading) (37-Y 0-N)",37,0,0,3,40
1912279,1476587,2025-01-28,Senate,"Read third time and passed Senate (39-Y 0-N)",39,0,0,1,40
1912279,1483422,2025-02-06,House,"Reported from General Laws (16-Y 5-N)",16,5,0,1,22
1912279,1490804,2025-02-17,House,"Reported from Rules (12-Y 5-N)",12,5,0,1,18
1912279,1496670,2025-02-20,House,"Passed House (63-Y 35-N)",63,35,0,2,100
1912279,1534802,2025-04-02,House,"House concurred in Governor's recommendation (81-Y 15-N)",81,15,0,4,100
1912279,1536148,2025-04-02,Senate,"Senate concurred in Governor's recommendation (40-Y 0-N)",40,0,0,0,40
1912282,1473852,2025-01-22,Senate,"Reported from General Laws and Technology with substitute (15-Y 0-N)",15,0,0,0,15
1912282,1474565,2025-01-24,Senate,"Constitutional reading dispensed (on 1st reading) (37-Y 0-N)",37,0,0,3,40
1912282,1476293,2025-01-28,Senate,"Read third time and passed Senate (39-Y 0-N)",39,0,0,1,40
1912282,1486214,2025-02-11,House,"Subcommittee recommends reporting (7-Y 0-N)",7,0,0,2,9
1912282,1489258,2025-02-13,House,"Reported from General Laws (19-Y 0-N)",19,0,0,3,22
1912282,1491846,2025-02-18,House,"Passed House (97-Y 0-N)",97,0,0,3,100
1912291,1476702,2025-01-29,Senate,"Reported from General Laws and Technology with substitute and rereferred to Finance and Appropriations (10-Y 5-N)",10,5,0,0,15
1912296,1472003,2025-01-16,Senate,"Rereferred from Education and Health",14,0,0,1,15
1912296,1472004,2025-01-16,Senate,"Rereferred from Education and Health to Courts of Justice (14-Y 0-N)",14,0,0,1,15
1912296,1476918,2025-01-29,Senate,"Reported from Courts of Justice (15-Y 0-N)",15,0,0,0,15
1912296,1478592,2025-01-31,Senate,"Constitutional reading dispensed (on 1st reading) (39-Y 0-N)",39,0,0,1,40
1912296,1480273,2025-02-03,Senate,"Constitutional reading dispensed (on 3rd reading) (40-Y 0-N)",40,0,0,0,40
1912296,1480274,2025-02-03,Senate,"Passed Senate (40-Y 0-N)",40,0,0,0,40
1912296,1490770,2025-02-17,House,"Reported from Rules with amendment(s) (18-Y 0-N)",18,0,0,0,18
1912296,1496041,2025-02-20,Senate,"House Amendments rejected by Senate (0-Y 39-N)",0,39,0,1,40
1912296,1496042,2025-02-20,Senate,"Senate acceded to request (37-Y 0-N)",37,0,0,3,40
1912296,1496215,2025-02-20,House,"Passed House with amendments (98-Y 0-N)",98,0,0,2,100
1912296,1497194,2025-02-22,House,"Conference report agreed to by House (97-Y 0-N)",97,0,0,3,100
1912296,1503137,2025-02-22,Senate,"Conference report agreed to by Senate (40-Y 0-N)",40,0,0,0,40
1912301,1472418,2025-01-20,Senate,"Passed by indefinitely in Commerce and Labor with letter (15-Y 0-N)",15,0,0,0,15
1912307,1474016,2025-01-23,Senate,"Reported from Education and Health with substitute (15-Y 0-N)",15,0,0,0,15
1912307,1474474,2025-01-24,Senate,"Constitutional reading dispensed (on 1st reading) (37-Y 0-N)",37,0,0,3,40
1912307,1477004,2025-01-28,Senate,"Read third time and passed Senate (39-Y 0-N)",39,0,0,1,40
1912307,1491382,2025-02-17,House,"Reported from Education with substitute (22-Y 0-N)",22,0,0,0,22
1912307,1495710,2025-02-20,House,"Passed House with substitute (97-Y 1-N)",97,1,0,2,100
1912307,1495711,2025-02-20,Senate,"House substitute rejected by Senate (2-Y 37-N)",2,37,0,1,40
1912307,1495712,2025-02-20,Senate,"Senate acceded to request (37-Y 0-N)",37,0,0,3,40
1912307,1497203,2025-02-22,House,"Conference report agreed to by House (96-Y 1-N)",96,1,0,3,100
1912307,1503956,2025-02-22,Senate,"Conference report agreed to by Senate (40-Y 0-N)",40,0,0,0,40
1912312,1473390,2025-01-22,Senate,"Reported from General Laws and Technology with amendment and rereferred to Finance and Appropriations (15-Y 0-N)",15,0,0,0,15
1912312,1476126,2025-01-28,Senate,"Reported from Finance and Appropriations (15-Y 0-N)",15,0,0,0,15
1912312,1476533,2025-01-29,Senate,"Constitutional reading dispensed (on 1st reading) (38-Y 0-N)",38,0,0,2,40
1912312,1477557,2025-01-30,Senate,"Read third time and passed Senate (40-Y 0-N)",40,0,0,0,40
1912312,1478330,2025-01-30,Senate,"Constitutional reading dispensed (on 3rd reading) (39-Y 1-N)",39,1,0,0,40
1912312,1489179,2025-02-13,House,"Subcommittee recommends reporting (7-Y 0-N)",7,0,0,2,9
1912312,1489180,2025-02-13,House,"Reported from General Laws (18-Y 0-N 1-A)",18,0,1,3,22
1912312,1492764,2025-02-18,House,"Passed House (95-Y 0-N)",95,0,0,5,100
1912318,1474505,2025-01-24,Senate,"Reported from General Laws and Technology and rereferred to Finance and Appropriations (15-Y 0-N)",15,0,0,0,15
1912324,1475136,2025-01-27,Senate,"Incorporated by Commerce and Labor (SB1436-Perry) (15-Y 0-N)",15,0,0,0,15
1912330,1474416,2025-01-24,Senate,"Passed by indefinitely in General Laws and Technology with letter (15-Y 0-N)",15,0,0,0,15
1912336,1475115,2025-01-27,Senate,"Reported from Courts of Justice with substitute and rereferred to Finance and Appropriations (13-Y 1-N)",13,1,0,1,15
1912336,1477689,2025-01-29,Senate,"Reported from Finance and Appropriations (13-Y 0-N 2-A)",13,0,2,0,15
1912336,1477690,2025-01-30,Senate,"Constitutional reading dispensed (on 1st reading) (39-Y 0-N 1-A)",39,0,1,0,40
1912336,1480175,2025-02-03,Senate,"Read third time and passed Senate (40-Y 0-N)",40,0,0,0,40
1912336,1486222,2025-02-10,House,"Reported from Courts of Justice with substitute (22-Y 0-N)",22,0,0,0,22
1912336,1490480,2025-02-13,House,"Passed House with substitute (96-Y 0-N)",96,0,0,4,100
1912336,1491592,2025-02-17,Senate,"House substitute rejected by Senate (0-Y 39-N)",0,39,0,1,40
1912336,1493681,2025-02-19,Senate,"Senate acceded to request (40-Y 0-N)",40,0,0,0,40
1912336,1496928,2025-02-21,Senate,"Conference report agreed to by Senate (40-Y 0-N)",40,0,0,0,40
1912336,1503149,2025-02-21,House,"Conference report agreed to by House (96-Y 0-N)",96,0,0,4,100
1912339,1476506,2025-01-29,Senate,"Passed by indefinitely in General Laws and Technology (12-Y 2-N 1-A)",12,2,1,0,15
1912344,1473322,2025-01-22,Senate,"Reported from General Laws and Technology with substitute (14-Y 0-N)",14,0,0,1,15
1912344,1474360,2025-01-24,Senate,"Constitutional reading dispensed (on 1st reading) (37-Y 0-N)",37,0,0,3,40
1912344,1476944,2025-01-28,Senate,"Read third time and passed Senate (39-Y 0-N)",39,0,0,1,40
1912344,1483756,2025-02-06,House,"Reported from General Laws (21-Y 0-N)",21,0,0,1,22
1912344,1486310,2025-02-11,House,"Passed House (94-Y 0-N)",94,0,0,6,100
1912394,1472416,2025-01-20,Senate,"Reported from Local Government (8-Y 6-N 1-A)",8,6,1,0,15
1912394,1474079,2025-01-21,Senate,"Constitutional reading dispensed (on 1st reading) (40-Y 0-N)",40,0,0,0,40
1912394,1474510,2025-01-23,Senate,"Read third time and passed Senate (20-Y 19-N)",20,19,0,1,40
1912394,1483035,2025-02-06,House,"Subcommittee recommends reporting (6-Y 2-N)",6,2,0,1,9
1912394,1484273,2025-02-07,House,"Reported from Counties, Cities and Towns (12-Y 9-N)",12,9,0,1,22
1912394,1487889,2025-02-12,House,"Passed House (50-Y 47-N)",50,47,0,3,100
1912395,1472523,2025-01-20,Senate,"Reported from Commerce and Labor with substitute and rereferred to Finance and Appropriations (11-Y 3-N 1-A)",11,3,1,0,15
1912395,1475254,2025-01-28,Senate,"Reported from Finance and Appropriations with substitute (10-Y 5-N)",10,5,0,0,15
1912395,1476235,2025-01-29,Senate,"Constitutional reading dispensed (on 1st reading) (38-Y 0-N)",38,0,0,2,40
1912395,1478584,2025-01-31,Senate,"Read third time and passed Senate (26-Y 14-N)",26,14,0,0,40
1912396,1473258,2025-01-22,Senate,"Failed to report from General Laws and Technology with substitute (7-Y 8-N)",7,8,0,0,15
1912397,1476581,2025-01-28,Senate,"Reported from Agriculture, Conservation and Natural Resources with substitute (14-Y 0-N)",14,0,0,1,15
1912397,1477413,2025-01-30,Senate,"Constitutional reading dispensed (on 1st reading) (39-Y 0-N 1-A)",39,0,1,0,40
1912397,1479101,2025-01-31,Senate,"Constitutional reading dispensed (on 3rd reading) (40-Y 0-N)",40,0,0,0,40
1912397,1479102,2025-01-31,Senate,"Passed Senate (40-Y 0-N)",40,0,0,0,40
1912397,1487411,2025-02-12,House,"Reported from Agriculture, Chesapeake and Natural Resources with amendment(s) (16-Y 6-N)",16,6,0,0,22
1912397,1490991,2025-02-17,House,"Passed House with amendment (69-Y 27-N)",69,27,0,4,100
1912397,1492217,2025-02-18,Senate,"House Amendment agreed to by Senate (40-Y 0-N)",40,0,0,0,40
1912398,1473372,2025-01-22,Senate,"Reported from Courts of Justice (14-Y 0-N)",14,0,0,1,15
1912398,1474636,2025-01-24,Senate,"Constitutional reading dispensed (on 1st reading) (37-Y 0-N)",37,0,0,3,40
1912398,1477061,2025-01-28,Senate,"Read third time and passed Senate (39-Y 0-N)",39,0,0,1,40
1912398,1484079,2025-02-07,House,"Subcommittee recommends reporting (8-Y 0-N)",8,0,0,1,9
1912398,1485543,2025-02-10,House,"Reported from Courts of Justice (22-Y 0-N)",22,0,0,0,22
1912398,1489474,2025-02-13,House,"Passed House (96-Y 0-N)",96,0,0,4,100
1912399,1474553,2025-01-23,Senate,"Passed by indefinitely in Finance and Appropriations (7-Y 6-N)",7,6,0,2,15
1912400,1473259,2025-01-22,Senate,"Reported from General Laws and Technology with substitute and rereferred to Finance and Appropriations (13-Y 2-N)",13,2,0,0,15
1912401,1471805,2025-01-15,Senate,"Reported from Finance and Appropriations with substitute (11-Y 2-N)",11,2,0,2,15
1912401,1472006,2025-01-16,Senate,"Constitutional reading dispensed (on 1st reading) (39-Y 0-N)",39,0,0,1,40
1912401,1472383,2025-01-20,Senate,"Read third time and passed Senate (27-Y 13-N)",27,13,0,0,40
1912401,1484761,2025-02-10,House,"Reported from Finance with substitute (13-Y 7-N)",13,7,0,2,22
1912401,1490055,2025-02-13,House,"Passed House with substitute (62-Y 33-N)",62,33,0,5,100
1912401,1491358,2025-02-17,Senate,"House substitute agreed to by Senate (27-Y 12-N)",27,12,0,1,40
1912402,1478043,2025-01-30,Senate,"Reported from Education and Health with amendments and rereferred to Finance and Appropriations (15-Y 0-N)",15,0,0,0,15
1912403,1473284,2025-01-22,Senate,"Reported from General Laws and Technology and rereferred to Finance and Appropriations (14-Y 0-N 1-A)",14,0,1,0,15
1912403,1475292,2025-01-28,Senate,"Passed by indefinitely in Finance and Appropriations (10-Y 5-N)",10,5,0,0,15
1912404,1472423,2025-01-20,Senate,"Reported from Commerce and Labor with amendments (14-Y 0-N)",14,0,0,1,15
1912404,1473002,2025-01-22,Senate,"Constitutional reading dispensed (on 1st reading) (40-Y 0-N)",40,0,0,0,40
1912404,1474561,2025-01-24,Senate,"Read third time and passed Senate (38-Y 0-N)",38,0,0,2,40
1912404,1483389,2025-02-06,House,"Reported from Labor and Commerce (21-Y 0-N)",21,0,0,1,22
1912404,1486324,2025-02-11,House,"Passed House (94-Y 0-N)",94,0,0,6,100
1912405,1475307,2025-01-27,Senate,"Stricken at request of Patron in Courts of Justice (14-Y 0-N)",14,0,0,1,15
1912406,1473381,2025-01-22,Senate,"Reported from Courts of Justice with substitute and rereferred to Finance and Appropriations (15-Y 0-N)",15,0,0,0,15
1912407,1472339,2025-01-20,Senate,"Constitutional reading dispensed (on 1st reading) (40-Y 0-N)",40,0,0,0,40
1912407,1473110,2025-01-22,Senate,"Read third time and passed Senate (21-Y 19-N)",21,19,0,0,40
1912407,1473693,2025-01-16,Senate,"Reported from Transportation (8-Y 7-N)",8,7,0,0,15
1912407,1486092,2025-02-11,House,"Subcommittee recommends reporting (4-Y 3-N)",4,3,0,2,9
1912408,1471850,2025-01-15,Senate,"Reported from General Laws and Technology with substitute (13-Y 0-N)",13,0,0,2,15
1912408,1472250,2025-01-17,Senate,"Constitutional reading dispensed (on 1st reading) (40-Y 0-N)",40,0,0,0,40
1912408,1474220,2025-01-23,Senate,"Read third time and passed Senate (39-Y 0-N)",39,0,0,1,40
1912408,1483720,2025-02-06,House,"Reported from General Laws (21-Y 0-N)",21,0,0,1,22
1912408,1486613,2025-02-11,House,"Passed House (94-Y 0-N)",94,0,0,6,100
1912409,1478039,2025-01-30,Senate,"Reported from Education and Health with substitute (15-Y 0-N)",15,0,0,0,15
1912409,1478436,2025-01-31,Senate,"Constitutional reading dispensed (on 1st reading) (39-Y 0-N)",39,0,0,1,40
1912409,1480084,2025-02-03,Senate,"Constitutional reading dispensed (on 3rd reading) (40-Y 0-N)",40,0,0,0,40
1912409,1480085,2025-02-03,Senate,"Passed Senate (40-Y 0-N)",40,0,0,0,40
1912409,1486423,2025-02-11,House,"Reported from Health and Human Services (22-Y 0-N)",22,0,0,0,22
1912409,1490556,2025-02-14,House,"Passed House (96-Y 0-N)",96,0,0,4,100
1912410,1474114,2025-01-23,Senate,"Reported from Transportation (14-Y 0-N)",14,0,0,1,15
1912410,1475515,2025-01-27,Senate,"Constitutional reading dispensed (on 1st reading) (36-Y 0-N)",36,0,0,4,40
1912410,1476423,2025-01-29,Senate,"Read third time and passed Senate (38-Y 0-N)",38,0,0,2,40
1912410,1486017,2025-02-11,House,"Subcommittee recommends reporting (8-Y 0-N)",8,0,0,1,9
1912410,1488595,2025-02-13,House,"Reported from Transportation (20-Y 0-N)",20,0,0,2,22
1912410,1492445,2025-02-18,House,"Passed House (97-Y 0-N)",97,0,0,3,100
1912411,1474188,2025-01-24,Senate,"Reported from Rehabilitation and Social Services with amendments and rereferred to Finance and Appropriations (15-Y 0-N)",15,0,0,0,15
1912411,1477107,2025-01-29,Senate,"Reported from Finance and Appropriations with substitute (15-Y 0-N)",15,0,0,0,15
1912411,1477498,2025-01-30,Senate,"Constitutional reading dispensed (on 1st reading) (39-Y 0-N 1-A)",39,0,1,0,40
1912411,1479578,2025-02-03,Senate,"Constitutional reading dispensed (on 3rd reading) (40-Y 0-N)",40,0,0,0,40
1912411,1479579,2025-02-03,Senate,"Passed Senate (40-Y 0-N)",40,0,0,0,40
1912411,1488893,2025-02-13,House,"Subcommittee recommends reporting (6-Y 0-N)",6,0,0,1,7
1912411,1489940,2025-02-14,House,"Reported from Public Safety (21-Y 0-N)",21,0,0,1,22
1912411,1495362,2025-02-19,House,"Passed House (97-Y 0-N)",97,0,0,3,100
1912412,1472460,2025-01-20,Senate,"Reported from Commerce and Labor with substitute and rereferred to Finance and Appropriations (15-Y 0-N)",15,0,0,0,15
1912413,1478227,2025-01-30,Senate,"Reported from Education and Health with amendments (15-Y 0-N)",15,0,0,0,15
1912413,1478228,2025-01-31,Senate,"Constitutional reading dispensed (on 1st reading) (39-Y 0-N)",39,0,0,1,40
1912413,1480081,2025-02-03,Senate,"Constitutional reading dispensed (on 3rd reading) (40-Y 0-N)",40,0,0,0,40
1912413,1480082,2025-02-03,Senate,"Passed Senate (40-Y 0-N)",40,0,0,0,40
1912413,1486771,2025-02-11,House,"Subcommittee recommends reporting with substitute (8-Y 0-N)",8,0,0,1,9
1912413,1489531,2025-02-13,House,"Reported from Health and Human Services with substitute (13-Y 9-N)",13,9,0,0,22
1912413,1495279,2025-02-19,House,"Passed House with substitute (88-Y 9-N)",88,9,0,3,100
1912413,1495280,2025-02-20,Senate,"House substitute agreed to by Senate (39-Y 0-N)",39,0,0,1,40
1912413,1535220,2025-04-02,House,"House concurred in Governor's recommendation (96-Y 0-N)",96,0,0,4,100
1912413,1536389,2025-04-02,Senate,"Senate concurred in Governor's recommendation (40-Y 0-N)",40,0,0,0,40
1912417,1473760,2025-01-16,Senate,"Reported from Transportation and rereferred to Finance and Appropriations (15-Y 0-N)",15,0,0,0,15
1912418,1475763,2025-01-27,Senate,"Passed by indefinitely in Courts of Justice (8-Y 6-N)",8,6,0,1,15
1912419,1472455,2025-01-20,Senate,"Reported from Local Government (15-Y 0-N)",15,0,0,0,15
1912419,1472800,2025-01-21,Senate,"Constitutional reading dispensed (on 1st reading) (40-Y 0-N)",40,0,0,0,40
1912419,1473736,2025-01-23,Senate,"Read third time and passed Senate (39-Y 0-N)",39,0,0,1,40
1912419,1480558,2025-02-05,House,"Subcommittee recommends reporting (8-Y 0-N)",8,0,0,1,9
1912419,1483962,2025-02-07,House,"Reported from Counties, Cities and Towns (21-Y 0-N)",21,0,0,1,22
1912419,1488309,2025-02-12,House,"Passed House (97-Y 0-N)",97,0,0,3,100
1912419,1536208,2025-04-02,Senate,"Senate concurred in Governor's recommendation (40-Y 0-N)",40,0,0,0,40
1912419,1536209,2025-04-02,House,"House concurred in Governor's recommendation (96-Y 0-N)",96,0,0,4,100
1912420,1477479,2025-01-30,Senate,"Reported from Education and Health with amendments (15-Y 0-N)",15,0,0,0,15
1912420,1478338,2025-01-31,Senate,"Constitutional reading dispensed (on 1st reading) (39-Y 0-N)",39,0,0,1,40
1912420,1480349,2025-02-03,Senate,"Constitutional reading dispensed (on 3rd reading) (40-Y 0-N)",40,0,0,0,40
1912420,1480350,2025-02-03,Senate,"Passed Senate (40-Y 0-N)",40,0,0,0,40
1912420,1490755,2025-02-17,House,"Reported from Education (22-Y 0-N)",22,0,0,0,22
1912420,1496632,2025-02-20,House,"Passed House (98-Y 0-N)",98,0,0,2,100
1912421,1477423,2025-01-30,Senate,"Reported from Transportation with substitute (15-Y 0-N)",15,0,0,0,15
1912421,1480109,2025-02-04,Senate,"Constitutional reading dispensed (on 3rd reading) (39-Y 0-N)",39,0,0,1,40
1912421,1480110,2025-02-04,Senate,"Passed Senate (40-Y 0-N)",40,0,0,0,40
1912421,1480428,2025-02-03,Senate,"Constitutional reading dispensed (on 1st reading) (40-Y 0-N)",40,0,0,0,40
1912421,1486003,2025-02-11,House,"Reported from Transportation (19-Y 0-N 1-A)",19,0,1,2,22
1912421,1490422,2025-02-14,House,"Passed House (95-Y 0-N)",95,0,0,5,100
1912422,1478903,2025-02-03,Senate,"Passed by indefinitely in Commerce and Labor with letter (15-Y 0-N)",15,0,0,0,15
1912423,1475393,2025-01-28,Senate,"Reported from Education and Health and rereferred to Finance and Appropriations (15-Y 0-N)",15,0,0,0,15
1912423,1477638,2025-01-30,Senate,"Reported from Finance and Appropriations with substitute (15-Y 0-N)",15,0,0,0,15
1912423,1479768,2025-02-03,Senate,"Constitutional reading dispensed (on 1st reading) (40-Y 0-N)",40,0,0,0,40
1912423,1479769,2025-02-04,Senate,"Constitutional reading dispensed (on 3rd reading) (39-Y 0-N)",39,0,0,1,40
1912423,1479770,2025-02-04,Senate,"Passed Senate (40-Y 0-N)",40,0,0,0,40
1912423,1485875,2025-02-11,House,"Subcommittee recommends reporting (6-Y 0-N)",6,0,0,3,9
1912423,1490757,2025-02-17,House,"Reported from Education (22-Y 0-N)",22,0,0,0,22
1912423,1496586,2025-02-20,House,"Passed House (98-Y 0-N)",98,0,0,2,100
1912424,1471851,2025-01-15,Senate,"Reported from General Laws and Technology with amendments (13-Y 0-N)",13,0,0,2,15
1912424,1472246,2025-01-17,Senate,"Constitutional reading dispensed (on 1st reading) (40-Y 0-N)",40,0,0,0,40
1912424,1473983,2025-01-21,Senate,"Read third time and passed Senate (40-Y 0-N)",40,0,0,0,40
1912424,1483361,2025-02-06,House,"Reported from General Laws with amendment(s) (21-Y 0-N)",21,0,0,1,22
1912424,1486268,2025-02-11,House,"Passed House with amendment (94-Y 0-N)",94,0,0,6,100
1912424,1489170,2025-02-13,Senate,"House Amendment agreed to by Senate (40-Y 0-N)",40,0,0,0,40
1912425,1477251,2025-01-30,Senate,"Reported from Education and Health (10-Y 2-N 3-A)",10,2,3,0,15
1912425,1478092,2025-01-31,Senate,"Constitutional reading dispensed (on 1st reading) (39-Y 0-N)",39,0,0,1,40
1912425,1482138,2025-02-04,Senate,"Read third time and passed Senate (36-Y 3-N 1-A)",36,3,1,0,40
1912425,1490750,2025-02-17,House,"Reported from Education with substitute (22-Y 0-N)",22,0,0,0,22
1912425,1495583,2025-02-20,Senate,"House substitute rejected by Senate (0-Y 39-N)",0,39,0,1,40
1912425,1495584,2025-02-20,Senate,"Senate acceded to request (37-Y 0-N)",37,0,0,3,40
1912425,1496601,2025-02-20,House,"Passed House with substitute (98-Y 0-N)",98,0,0,2,100
1912425,1496602,2025-02-21,Senate,"Conference report agreed to by Senate (40-Y 0-N)",40,0,0,0,40
1912425,1497125,2025-02-22,House,"Conference report agreed to by House (96-Y 1-N)",96,1,0,3,100
1912426,1472525,2025-01-20,Senate,"Reported from Commerce and Labor (15-Y 0-N)",15,0,0,0,15
1912426,1473254,2025-01-22,Senate,"Constitutional reading dispensed (on 1st reading) (40-Y 0-N)",40,0,0,0,40
1912426,1474602,2025-01-24,Senate,"Read third time and passed Senate (38-Y 0-N)",38,0,0,2,40
1912426,1483370,2025-02-06,House,"Reported from Labor and Commerce (21-Y 0-N)",21,0,0,1,22
1912426,1486319,2025-02-11,House,"Passed House (94-Y 0-N)",94,0,0,6,100
1912427,1477654,2025-01-30,Senate,"Passed by indefinitely in Education and Health (9-Y 5-N)",9,5,0,1,15
1912428,1472666,2025-01-21,Senate,"Reported from Finance and Appropriations with amendments (9-Y 5-N)",9,5,0,1,15
1912428,1473324,2025-01-22,Senate,"Constitutional reading dispensed (on 1st reading) (40-Y 0-N)",40,0,0,0,40
1912428,1474370,2025-01-24,Senate,"Read third time and passed Senate (20-Y 18-N)",20,18,0,2,40
1912428,1485487,2025-02-10,House,"Reported from Finance (12-Y 8-N)",12,8,0,2,22
1912428,1489570,2025-02-13,House,"Passed House",59,37,0,4,100
1912429,1474557,2025-01-24,Senate,"Stricken at request of Patron in Rehabilitation and Social Services (11-Y 0-N)",11,0,0,4,15
1912430,1477204,2025-01-30,Senate,"Reported from Education and Health with substitute and rereferred to Finance and Appropriations (15-Y 0-N)",15,0,0,0,15
1912430,1477915,2025-01-30,Senate,"Reported from Finance and Appropriations (15-Y 0-N)",15,0,0,0,15
1912430,1480376,2025-02-03,Senate,"Constitutional reading dispensed (on 1st reading) (40-Y 0-N)",40,0,0,0,40
1912430,1482815,2025-02-04,Senate,"Constitutional reading dispensed (on 3rd reading) (39-Y 0-N)",39,0,0,1,40
1912430,1482816,2025-02-04,Senate,"Passed Senate (40-Y 0-N)",40,0,0,0,40
1912430,1490748,2025-02-17,House,"Reported from Education with substitute (14-Y 8-N)",14,8,0,0,22
1912430,1495579,2025-02-20,Senate,"House substitute agreed to by Senate (39-Y 0-N)",39,0,0,1,40
1912430,1496584,2025-02-20,House,"Passed House with substitute (55-Y 43-N)",55,43,0,2,100
1912431,1478915,2025-02-03,Senate,"Reported from Commerce and Labor with substitute (15-Y 0-N)",15,0,0,0,15
1912431,1479772,2025-02-04,Senate,"Constitutional reading dispensed (on 1st reading) (40-Y 0-N)",40,0,0,0,40
1912431,1479773,2025-02-04,Senate,"Constitutional reading dispensed (on 3rd reading) (40-Y 0-N)",40,0,0,0,40
1912431,1479774,2025-02-04,Senate,"Passed Senate (40-Y 0-N)",40,0,0,0,40
1912431,1486400,2025-02-11,House,"Subcommittee recommends reporting (9-Y 1-N)",9,1,0,1,11
1912431,1489406,2025-02-13,House,"Reported from Labor and Commerce (21-Y 1-N)",21,1,0,0,22
1912431,1491976,2025-02-18,House,"Passed House (94-Y 2-N)",94,2,0,4,100
1912431,1536335,2025-04-02,Senate,"Senate rejected Governor's recommendation (19-Y 21-N)",19,21,0,0,40
1912432,1472345,2025-01-20,Senate,"Reported from Local Government with substitute (13-Y 2-N)",13,2,0,0,15
1912432,1473810,2025-01-21,Senate,"Constitutional reading dispensed (on 1st reading) (40-Y 0-N)",40,0,0,0,40
1912432,1473811,2025-01-23,Senate,"Read third time and passed Senate (35-Y 3-N)",35,3,0,2,40
1912432,1489946,2025-02-14,House,"Subcommittee recommends laying on the table (6-Y 2-N)",6,2,0,1,9
1912433,1472579,2025-01-21,Senate,"Reported from Finance and Appropriations with substitute (15-Y 0-N)",15,0,0,0,15
1912433,1473221,2025-01-22,Senate,"Constitutional reading dispensed (on 1st reading) (40-Y 0-N)",40,0,0,0,40
1912433,1474264,2025-01-24,Senate,"Read third time and passed Senate (38-Y 0-N)",38,0,0,2,40
1914819,1472827,2025-01-21,House,"Stricken from docket by Labor and Commerce (20-Y 0-N)",20,0,0,2,22
1914821,1475886,2025-01-28,House,"Subcommittee recommends laying on the table (5-Y 2-N)",5,2,0,2,9
1914840,1474750,2025-01-27,House,"Subcommittee recommends reporting with substitute (6-Y 2-N)",6,2,0,1,9
1914840,1476141,2025-01-29,House,"Reported from Education with substitute (19-Y 3-N)",19,3,0,0,22
1914840,1480554,2025-02-04,House,"Read third time and passed House (68-Y 31-N)",68,31,0,1,100
1914840,1489699,2025-02-13,Senate,"Reported from Education and Health with substitute (15-Y 0-N)",15,0,0,0,15
1914840,1491192,2025-02-17,Senate,"Constitutional reading dispensed (on 2nd reading)",39,0,0,1,40
1914840,1493139,2025-02-18,Senate,"Passed Senate with substitute (40-Y 0-N)",40,0,0,0,40
1914840,1493140,2025-02-19,House,"Senate substitute rejected by House (0-Y 95-N)",0,95,0,5,100
1914840,1496534,2025-02-20,Senate,"Senate insisted on substitute (39-Y 0-N)",39,0,0,1,40
1914840,1496535,2025-02-21,Senate,"Conference report agreed to by Senate (38-Y 0-N)",38,0,0,2,40
1914840,1504061,2025-02-21,House,"Conference report agreed to by House (77-Y 18-N)",77,18,0,5,100
1914844,1477473,2025-01-30,House,"Subcommittee recommends reporting with substitute (8-Y 0-N)",8,0,0,1,9
1914844,1477677,2025-01-30,House,"Reported from General Laws with substitute (21-Y 0-N)",21,0,0,1,22
1914844,1480587,2025-02-04,House,"Read third time and passed House (97-Y 0-N)",97,0,0,3,100
1914844,1480588,2025-02-04,House,"Passed House (99-Y 0-N)",99,0,0,1,100
1914844,1489839,2025-02-13,Senate,"Reported from Education and Health (14-Y 0-N 1-A)",14,0,1,0,15
1914844,1490951,2025-02-17,Senate,"Constitutional reading dispensed (on 1st reading) (39-Y 0-N)",39,0,0,1,40
1914844,1494229,2025-02-19,Senate,"Passed Senate (40-Y 0-N)",40,0,0,0,40
1914844,1494230,2025-02-19,Senate,"Reconsideration of Senate passage agreed to by Senate",39,0,0,1,40
1914844,1494231,2025-02-19,Senate,"Passed Senate (38-Y 1-N)",38,1,0,1,40
1914847,1475288,2025-01-28,House,"Subcommittee recommends reporting with substitute and referring to Appropriations (5-Y 3-N)",5,3,0,1,9
1914847,1476160,2025-01-29,House,"Reported from Education with substitute and referred to Appropriations (12-Y 10-N)",12,10,0,0,22
1914847,1476787,2025-01-29,House,"Subcommittee recommends reporting with amendment(s) (4-Y 3-N)",4,3,0,2,9
1914847,1478489,2025-01-31,House,"Reported from Appropriations with amendment(s) (12-Y 10-N)",12,10,0,0,22
1914847,1482824,2025-02-04,House,"Read third time and passed House (56-Y 41-N)",56,41,0,3,100
1914847,1489877,2025-02-13,Senate,"Reported from Education and Health with amendment (14-Y 0-N)",14,0,0,1,15
1914847,1492789,2025-02-17,Senate,"Constitutional reading dispensed (on 2nd reading)",39,0,0,1,40
1914847,1492790,2025-02-18,Senate,"Passed Senate with amendment (40-Y 0-N)",40,0,0,0,40
1914847,1494269,2025-02-19,House,"Senate amendment agreed to by House",57,40,0,3,100
1914853,1472634,2025-01-20,House,"Subcommittee recommends reporting with substitute (7-Y 1-N)",7,1,0,1,9
1914853,1474738,2025-01-24,House,"Reported from Courts of Justice with substitute (14-Y 8-N)",14,8,0,0,22
1914853,1478146,2025-01-30,House,"Read third time and passed House (51-Y 44-N)",51,44,0,5,100
1914853,1484784,2025-02-10,Senate,"Reported from Courts of Justice and rereferred to Finance and Appropriations (9-Y 6-N)",9,6,0,0,15
1914853,1487375,2025-02-12,Senate,"Reported from Finance and Appropriations (10-Y 5-N)",10,5,0,0,15
1914853,1488907,2025-02-13,Senate,"Constitutional reading dispensed (on 2nd reading) (40-Y 0-N)",40,0,0,0,40
1914853,1490207,2025-02-14,Senate,"Passed Senate (21-Y 15-N)",21,15,0,4,40
1914853,1536519,2025-04-02,House,"House sustained Governor's veto (50-Y 46-N)",50,46,0,4,100
1914856,1476748,2025-01-29,House,"Subcommittee recommends laying on the table (5-Y 3-N)",5,3,0,1,9
1914861,1472784,2025-01-21,House,"Subcommittee recommends reporting with substitute (8-Y 0-N)",8,0,0,1,9
1914861,1473029,2025-01-22,House,"Reported from Finance with substitute (22-Y 0-N)",22,0,0,0,22
1914861,1477066,2025-01-28,House,"Read third time and passed House (97-Y 2-N)",97,2,0,1,100
1914861,1477067,2025-01-28,House,"Passed House (99-Y 0-N)",99,0,0,1,100
1914861,1480519,2025-02-05,Senate,"Reported from Finance and Appropriations (13-Y 0-N)",13,0,0,2,15
1914861,1483446,2025-02-06,Senate,"Constitutional reading dispensed (on 2nd reading) (40-Y 0-N)",40,0,0,0,40
1914861,1484267,2025-02-07,Senate,"Passed Senate (39-Y 0-N)",39,0,0,1,40
1914866,1474345,2025-01-24,House,"Subcommittee recommends reporting with substitute (8-Y 0-N)",8,0,0,1,9
1914866,1476988,2025-01-29,House,"Reported from Courts of Justice with substitute (21-Y 0-N)",21,0,0,1,22
1914866,1482679,2025-02-04,House,"Read third time and passed House (72-Y 24-N)",72,24,0,4,100
1914866,1490800,2025-02-17,Senate,"Reported from Courts of Justice with amendment (15-Y 0-N)",15,0,0,0,15
1914866,1492444,2025-02-18,Senate,"Constitutional reading dispensed (on 2nd reading) (39-Y 0-N)",39,0,0,1,40
1914866,1493910,2025-02-19,Senate,"Passed Senate with amendment (40-Y 0-N)",40,0,0,0,40
1914866,1496537,2025-02-20,House,"Senate Amendment agreed to by House (96-Y 1-N)",96,1,0,3,100
1914885,1476851,2025-01-29,House,"Subcommittee recommends striking from the docket (6-Y 0-N)",6,0,0,3,9
1914889,1477405,2025-01-30,House,"Subcommittee recommends reporting with substitute (5-Y 3-N)",5,3,0,1,9
1914889,1477910,2025-01-30,House,"Reported from Labor and Commerce with substitute (12-Y 10-N)",12,10,0,0,22
1914889,1482808,2025-02-04,House,"Read third time and passed House (51-Y 46-N)",51,46,0,3,100
1914889,1484574,2025-02-10,Senate,"Reported from Local Government with substitute and rereferred to Finance and Appropriations (8-Y 7-N)",8,7,0,0,15
1914889,1487329,2025-02-12,Senate,"Reported from Finance and Appropriations (10-Y 5-N)",10,5,0,0,15
1914889,1490075,2025-02-13,Senate,"Constitutional reading dispensed (on 2nd reading) (40-Y 0-N)",40,0,0,0,40
1914889,1490076,2025-02-14,Senate,"Passed Senate with substitute (21-Y 15-N)",21,15,0,4,40
1914889,1492798,2025-02-18,House,"Senate substitute agreed to by House (51-Y 45-N)",51,45,0,4,100
1914889,1492799,2025-02-18,House,"Senate substitute agreed to by House (50-Y 46-N)",50,46,0,4,100
1914899,1475195,2025-01-27,House,"Subcommittee recommends reporting with substitute and referring to Appropriations (8-Y 0-N)",8,0,0,1,9
1914899,1476895,2025-01-29,House,"Reported from Courts of Justice with substitute and referred to Appropriations (21-Y 0-N)",21,0,0,1,22
1914899,1478364,2025-01-31,House,"Reported from Appropriations (22-Y 0-N)",22,0,0,0,22
1914899,1480148,2025-02-04,House,"Read third time and passed House (97-Y 0-N)",97,0,0,3,100
1914899,1480149,2025-02-04,House,"Passed House (99-Y 0-N)",99,0,0,1,100
1914899,1488592,2025-02-12,Senate,"Reported from Courts of Justice (15-Y 0-N)",15,0,0,0,15
1914899,1490145,2025-02-14,Senate,"Constitutional reading dispensed (on 2nd reading) (36-Y 0-N)",36,0,0,4,40
1914899,1491481,2025-02-17,Senate,"Passed Senate (39-Y 0-N)",39,0,0,1,40
1914903,1472646,2025-01-20,House,"Subcommittee recommends laying on the table (5-Y 3-N)",5,3,0,1,9
1914903,1473423,2025-01-22,House,"Subcommittee recommends reporting with amendment(s) (5-Y 3-N)",5,3,0,1,9
1914903,1474733,2025-01-24,House,"Reported from Courts of Justice with amendment(s) and referred to Appropriations (16-Y 6-N)",16,6,0,0,22
1914907,1477485,2025-01-30,House,"Subcommittee recommends laying on the table (6-Y 2-N)",6,2,0,1,9
1914911,1476075,2025-01-28,House,"Subcommittee recommends laying on the table (6-Y 2-N)",6,2,0,1,9
1914931,1474143,2025-01-23,House,"Subcommittee recommends reporting with substitute (7-Y 1-N)",7,1,0,1,9
1914931,1475957,2025-01-28,House,"Reported from Health and Human Services with substitute (21-Y 0-N)",21,0,0,1,22
1914931,1479455,2025-02-03,House,"Read third time and passed House (99-Y 0-N)",99,0,0,1,100
1914931,1483951,2025-02-07,Senate,"Reported from Rehabilitation and Social Services with amendments (15-Y 0-N)",15,0,0,0,15
1914931,1484926,2025-02-10,Senate,"Constitutional reading dispensed (on 2nd reading) (39-Y 0-N)",39,0,0,1,40
1914931,1487678,2025-02-12,Senate,"Passed Senate with amendments (39-Y 0-N)",39,0,0,1,40
1914931,1491766,2025-02-17,House,"Senate Amendments agreed to by House (95-Y 0-N)",95,0,0,5,100
1914942,1475460,2025-01-27,House,"Subcommittee recommends reporting and referring to Appropriations (7-Y 1-N)",7,1,0,1,9
1914942,1476833,2025-01-29,House,"Reported from Courts of Justice and referred to Appropriations (21-Y 1-N)",21,1,0,0,22
1914945,1475854,2025-01-28,House,"Subcommittee recommends reporting with substitute (8-Y 0-N)",8,0,0,1,9
1914945,1476601,2025-01-29,House,"Reported from Education with substitute (22-Y 0-N)",22,0,0,0,22
1914945,1480492,2025-02-04,House,"Read third time and passed House (97-Y 0-N)",97,0,0,3,100
1914945,1480493,2025-02-04,House,"Passed House (99-Y 0-N)",99,0,0,1,100
1914945,1489853,2025-02-13,Senate,"Reported from Education and Health (14-Y 0-N)",14,0,0,1,15
1914945,1491327,2025-02-17,Senate,"Constitutional reading dispensed (on 2nd reading)",39,0,0,1,40
1914945,1492424,2025-02-18,Senate,"Passed Senate (40-Y 0-N)",40,0,0,0,40
1914951,1474917,2025-01-27,House,"Subcommittee recommends laying on the table (6-Y 2-N)",6,2,0,1,9
1914956,1474193,2025-01-24,House,"Subcommittee recommends laying on the table (7-Y 1-N)",7,1,0,1,9
1914964,1473999,2025-01-23,House,"Subcommittee recommends reporting (5-Y 3-N)",5,3,0,1,9
1914964,1475792,2025-01-28,House,"Reported from Labor and Commerce (12-Y 10-N)",12,10,0,0,22
1914964,1479504,2025-02-03,House,"Read third time and passed House (51-Y 48-N)",51,48,0,1,100
1914964,1491390,2025-02-17,Senate,"Reported from Commerce and Labor (9-Y 6-N)",9,6,0,0,15
1914964,1493397,2025-02-18,Senate,"Constitutional reading dispensed (on 2nd reading) (40-Y 0-N)",40,0,0,0,40
1914964,1495769,2025-02-19,Senate,"Passed Senate (21-Y 19-N)",21,19,0,0,40
1914968,1472907,2025-01-22,House,"Subcommittee recommends laying on the table (8-Y 1-N)",8,1,0,2,11
1914975,1477750,2025-01-30,House,"Subcommittee recommends laying on the table (4-Y 1-N)",4,1,0,1,6
1914983,1475037,2025-01-27,House,"Subcommittee recommends reporting with substitute and referring to Appropriations (6-Y 4-N)",6,4,0,1,11
1914983,1476177,2025-01-29,House,"Reported from Education with substitute and referred to Appropriations (14-Y 8-N)",14,8,0,0,22
1914999,1477489,2025-01-30,House,"Subcommittee recommends reporting (8-Y 0-N)",8,0,0,1,9
1914999,1477686,2025-01-30,House,"Reported from General Laws (21-Y 0-N)",21,0,0,1,22
1914999,1480146,2025-02-04,House,"Read third time and passed House (97-Y 0-N)",97,0,0,3,100
1914999,1480147,2025-02-04,House,"Passed House (99-Y 0-N)",99,0,0,1,100
1914999,1487909,2025-02-12,Senate,"Reported from General Laws and Technology (14-Y 0-N)",14,0,0,1,15
1914999,1490452,2025-02-14,Senate,"Constitutional reading dispensed (on 2nd reading) (36-Y 0-N)",36,0,0,4,40
1914999,1491308,2025-02-17,Senate,"Passed Senate (39-Y 0-N)",39,0,0,1,40
1915007,1474197,2025-01-24,House,"Subcommittee recommends passing by indefinitely (5-Y 3-N)",5,3,0,1,9
1915047,1473281,2025-01-22,House,"Subcommittee recommends laying on the table (6-Y 4-N)",6,4,0,1,11
1915050,1477164,2025-01-30,House,"Subcommittee recommends striking from the docket (8-Y 0-N)",8,0,0,1,9
1915057,1477401,2025-01-30,House,"Subcommittee recommends reporting with substitute (8-Y 0-N)",8,0,0,1,9
1915057,1477723,2025-01-30,House,"Reported from General Laws with substitute (21-Y 0-N)",21,0,0,1,22
1915057,1479953,2025-02-04,House,"Read third time and passed House (97-Y 0-N)",97,0,0,3,100
1915057,1479954,2025-02-04,House,"Passed House (99-Y 0-N)",99,0,0,1,100
1915057,1488228,2025-02-12,Senate,"Reported from General Laws and Technology (15-Y 0-N)",15,0,0,0,15
1915057,1490209,2025-02-14,Senate,"Constitutional reading dispensed (on 2nd reading) (36-Y 0-N)",36,0,0,4,40
1915057,1491181,2025-02-17,Senate,"Passed Senate (39-Y 0-N)",39,0,0,1,40
1915066,1473336,2025-01-22,House,"Subcommittee recommends reporting with amendment(s) and referring to Appropriations (7-Y 1-N)",7,1,0,1,9
1915066,1474712,2025-01-24,House,"Reported from Courts of Justice with substitute and referred to Appropriations (22-Y 0-N)",22,0,0,0,22
1915066,1475181,2025-01-27,House,"Subcommittee recommends reporting (8-Y 0-N)",8,0,0,1,9
1915066,1476742,2025-01-29,House,"Reported from Appropriations (21-Y 0-N)",21,0,0,1,22
1915066,1480604,2025-02-04,House,"Read third time and passed House (97-Y 0-N)",97,0,0,3,100
1915066,1480605,2025-02-04,House,"Passed House (99-Y 0-N)",99,0,0,1,100
1915066,1490835,2025-02-17,Senate,"Reported from Courts of Justice with substitute (10-Y 0-N)",10,0,0,5,15
1915066,1492824,2025-02-18,Senate,"Constitutional reading dispensed (on 2nd reading) (39-Y 0-N)",39,0,0,1,40
1915066,1494811,2025-02-19,Senate,"Passed Senate with substitute (40-Y 0-N)",40,0,0,0,40
1915066,1496021,2025-02-20,Senate,"Senate insisted on substitute (39-Y 0-N)",39,0,0,1,40
1915066,1496204,2025-02-20,House,"Senate substitute rejected by House (0-Y 98-N)",0,98,0,2,100
1915066,1496877,2025-02-21,Senate,"Conference report agreed to by Senate (40-Y 0-N)",40,0,0,0,40
1915066,1497188,2025-02-22,House,"Conference report agreed to by House (97-Y 0-N)",97,0,0,3,100
1915073,1476978,2025-01-29,House,"Reported from Rules (15-Y 0-N)",15,0,0,3,18
1915073,1478852,2025-02-03,House,"Agreed to by House (96-Y 0-N)",96,0,0,4,100
1915073,1491159,2025-02-17,Senate,"Reading waived (on 2nd reading) (39-Y 0-N)",39,0,0,1,40
1915087,1475550,2025-01-27,House,"Subcommittee recommends reporting (8-Y 0-N)",8,0,0,1,9
1915087,1477017,2025-01-29,House,"Reported from Courts of Justice (22-Y 0-N)",22,0,0,0,22
1915087,1482627,2025-02-04,House,"Read third time and passed House (97-Y 0-N)",97,0,0,3,100
1915087,1482628,2025-02-04,House,"Passed House (99-Y 0-N)",99,0,0,1,100
1915087,1488524,2025-02-12,Senate,"Reported from Courts of Justice with amendment (15-Y 0-N)",15,0,0,0,15
1915087,1490036,2025-02-14,Senate,"Constitutional reading dispensed (on 2nd reading) (36-Y 0-N)",36,0,0,4,40
1915087,1491227,2025-02-17,Senate,"Passed Senate with amendment (23-Y 15-N)",23,15,0,2,40
1915087,1491828,2025-02-18,House,"Senate Amendment agreed to by House (92-Y 3-N)",92,3,0,5,100
1915090,1476124,2025-01-29,House,"Subcommittee failed to recommend reporting (3-Y 5-N)",3,5,0,1,9
1915094,1473984,2025-01-23,House,"Subcommittee recommends striking from the docket (8-Y 0-N)",8,0,0,1,9
1915107,1477104,2025-01-30,House,"Subcommittee recommends laying on the table (5-Y 3-N)",5,3,0,1,9
1915110,1473968,2025-01-23,House,"Subcommittee recommends reporting with substitute and referring to Appropriations (7-Y 1-N)",7,1,0,1,9
1915110,1475592,2025-01-28,House,"Reported from Health and Human Services with substitute and referred to Appropriations (20-Y 1-N)",20,1,0,1,22
1915110,1478201,2025-01-31,House,"Reported from Appropriations with substitute (22-Y 0-N)",22,0,0,0,22
1915110,1482457,2025-02-04,House,"Read third time and passed House (98-Y 0-N)",98,0,0,2,100
1915110,1489708,2025-02-13,Senate,"Reported from Education and Health with substitute and rereferred to Finance and Appropriations (15-Y 0-N)",15,0,0,0,15
1915110,1490108,2025-02-14,Senate,"Reported from Finance and Appropriations with amendment (14-Y 0-N)",14,0,0,1,15
1915110,1491437,2025-02-17,Senate,"Constitutional reading dispensed (on 2nd reading) (39-Y 0-N)",39,0,0,1,40
1915110,1492008,2025-02-18,Senate,"Passed Senate with substitute with amendment (40-Y 0-N)",40,0,0,0,40
1915110,1496698,2025-02-20,House,"Senate substitute with amendment rejected by House (Y-6 N-92 A-0)",6,92,0,2,100
1915110,1496699,2025-02-20,Senate,"Senate insisted on substitute with amendments (39-Y 0-N)",39,0,0,1,40
1915110,1497133,2025-02-22,House,"Conference report agreed to by House (95-Y 2-N)",95,2,0,3,100
1915110,1503692,2025-02-22,Senate,"Conference report agreed to by Senate (40-Y 0-N)",40,0,0,0,40
1915110,1536118,2025-04-02,House,"Passed by for the day (47-Y 46-N)",47,46,0,7,100
1915123,1472574,2025-01-21,House,"Subcommittee recommends reporting with substitute and referred to Appropriations (7-Y 1-N)",7,1,0,1,9
1915123,1472983,2025-01-22,House,"Reported from Education with substitute and referred to Appropriations (15-Y 7-N)",15,7,0,0,22
1915123,1474488,2025-01-24,House,"Subcommittee recommends reporting with substitute (7-Y 1-N)",7,1,0,1,9
1915123,1475171,2025-01-27,House,"Reported from Appropriations with substitute (22-Y 0-N)",22,0,0,0,22
1915123,1479584,2025-02-03,House,"Read third time and passed House (79-Y 20-N)",79,20,0,1,100
1915123,1489586,2025-02-13,Senate,"Reported from Education and Health and rereferred to Finance and Appropriations (13-Y 0-N 1-A)",13,0,1,1,15
1915123,1492204,2025-02-17,Senate,"Reported from Finance and Appropriations (14-Y 0-N)",14,0,0,1,15
1915123,1493648,2025-02-19,Senate,"Constitutional reading dispensed (on 2nd reading) (40-Y 0-N)",40,0,0,0,40
1915123,1496416,2025-02-20,Senate,"Passed Senate (36-Y 3-N)",36,3,0,1,40
1915127,1473497,2025-01-23,House,"Subcommittee recommends reporting with substitute (5-Y 1-N)",5,1,0,1,7
1915127,1474248,2025-01-24,House,"Reported from Public Safety with substitute (13-Y 9-N)",13,9,0,0,22
1915127,1474249,2025-01-24,House,"Reported from Public Safety with substitute and referred to Appropriations (13-Y 7-N)",13,7,0,2,22
1915127,1476997,2025-01-29,House,"Subcommittee recommends reporting (7-Y 1-N)",7,1,0,1,9
1915127,1476998,2025-01-29,House,"Reported from Appropriations (15-Y 6-N)",15,6,0,1,22
1915127,1482741,2025-02-04,House,"Read third time and passed House (74-Y 23-N)",74,23,0,3,100
1915127,1488461,2025-02-12,Senate,"Reported from Courts of Justice and rereferred to Finance and Appropriations (14-Y 1-N)",14,1,0,0,15
1915127,1492208,2025-02-17,Senate,"Reported from Finance and Appropriations with substitute (14-Y 0-N)",14,0,0,1,15
1915127,1493683,2025-02-19,Senate,"Constitutional reading dispensed (on 2nd reading) (40-Y 0-N)",40,0,0,0,40
1915127,1495262,2025-02-20,Senate,"Passed Senate with substitute (39-Y 0-N)",39,0,0,1,40
1915127,1495918,2025-02-20,Senate,"Senate insisted on substitute (38-Y 0-N)",38,0,0,2,40
1915127,1496801,2025-02-20,House,"Senate substitute rejected by House (0-Y 96-N)",0,96,0,4,100
1915127,1497153,2025-02-22,House,"Conference report agreed to by House (83-Y 16-N)",83,16,0,1,100
1915127,1503871,2025-02-22,Senate,"Conference report agreed to by Senate (40-Y 0-N)",40,0,0,0,40
1915127,1535285,2025-04-02,House,"House concurred in Governor's recommendation (87-Y 9-N)",87,9,0,4,100
1915127,1535286,2025-04-02,Senate,"Senate concurred in Governor's recommendation (39-Y 1-N)",39,1,0,0,40
1915131,1475867,2025-01-28,House,"Subcommittee recommends striking from the docket (10-Y 0-N)",10,0,0,1,11
1915160,1475042,2025-01-27,House,"Subcommittee recommends passing by indefinitely (7-Y 1-N)",7,1,0,1,9
1915162,1475602,2025-01-28,House,"Subcommittee recommends reporting and referring to Appropriations (5-Y 3-N)",5,3,0,1,9
1915162,1476166,2025-01-29,House,"Reported from Education and referred to Appropriations (12-Y 10-N)",12,10,0,0,22
1915277,1473562,2025-01-23,Senate,"Passed by indefinitely in Education and Health (9-Y 6-N)",9,6,0,0,15
1915290,1474405,2025-01-24,Senate,"Passed by indefinitely in General Laws and Technology (11-Y 3-N)",11,3,0,1,15
1915317,1475118,2025-01-27,House,"Subcommittee recommends reporting (5-Y 3-N)",5,3,0,1,9
1915317,1476942,2025-01-29,House,"Reported from Courts of Justice (13-Y 9-N)",13,9,0,0,22
1915317,1480620,2025-02-04,House,"Read third time and passed House (50-Y 48-N)",50,48,0,2,100
1915317,1488212,2025-02-12,Senate,"Reported from Courts of Justice (12-Y 3-N)",12,3,0,0,15
1915317,1490307,2025-02-14,Senate,"Constitutional reading dispensed (on 2nd reading) (36-Y 0-N)",36,0,0,4,40
1915317,1492378,2025-02-18,Senate,"Passed Senate (26-Y 14-N)",26,14,0,0,40
1915331,1472306,2025-01-20,Senate,"Passed by indefinitely in Courts of Justice with letter (8-Y 7-N)",8,7,0,0,15
1915343,1476689,2025-01-29,House,"Subcommittee failed to recommend reporting with substitute (3-Y 5-N)",3,5,0,1,9
1915358,1473385,2025-01-22,Senate,"Reported from Courts of Justice and rereferred to Finance and Appropriations (13-Y 0-N)",13,0,0,2,15
1915358,1475492,2025-01-28,Senate,"Reported from Finance and Appropriations (15-Y 0-N)",15,0,0,0,15
1915358,1476198,2025-01-29,Senate,"Constitutional reading dispensed (on 1st reading) (38-Y 0-N)",38,0,0,2,40
1915358,1477354,2025-01-30,Senate,"Read third time and passed Senate (40-Y 0-N)",40,0,0,0,40
1915358,1478525,2025-01-30,Senate,"Constitutional reading dispensed (on 3rd reading) (39-Y 1-N)",39,1,0,0,40
1915358,1482681,2025-02-05,House,"Reported from Courts of Justice with substitute (22-Y 0-N)",22,0,0,0,22
1915358,1485343,2025-02-10,House,"Passed House with substitute (95-Y 0-N)",95,0,0,5,100
1915358,1488063,2025-02-12,Senate,"House substitute rejected by Senate (2-Y 36-N)",2,36,0,2,40
1915358,1491233,2025-02-17,Senate,"Senate acceded to request (39-Y 0-N)",39,0,0,1,40
1915358,1494690,2025-02-19,Senate,"Conference report agreed to by Senate (40-Y 0-N)",40,0,0,0,40
1915358,1494691,2025-02-19,House,"Conference report agreed to by House (96-Y 0-N)",96,0,0,4,100
1915371,1472653,2025-01-21,Senate,"Passed by indefinitely in Finance and Appropriations with letter (15-Y 0-N)",15,0,0,0,15
1915383,1473223,2025-01-22,House,"Subcommittee recommends laying on the table (6-Y 4-N)",6,4,0,1,11
1915399,1475245,2025-01-28,House,"Subcommittee recommends reporting with amendment(s) and referring to Appropriations (8-Y 0-N)",8,0,0,1,9
1915399,1477265,2025-01-30,House,"Reported from Health and Human Services with amendment(s) and referred to Appropriations (21-Y 0-N)",21,0,0,1,22
1915399,1478190,2025-01-31,House,"Tabled in Appropriations (12-Y 10-N)",12,10,0,0,22
1915412,1474081,2025-01-23,House,"Stricken from docket by General Laws (21-Y 0-N)",21,0,0,1,22
1915427,1477014,2025-01-29,House,"Reported from Rules (15-Y 0-N)",15,0,0,3,18
1915427,1478954,2025-02-03,House,"Agreed to by House (96-Y 0-N)",96,0,0,4,100
1915427,1491553,2025-02-17,Senate,"Reading waived (on 2nd reading) (39-Y 0-N)",39,0,0,1,40
1915440,1477394,2025-01-30,House,"Subcommittee recommends laying on the table (7-Y 1-N)",7,1,0,1,9
1915454,1474102,2025-01-23,House,"Subcommittee recommends reporting (6-Y 3-N)",6,3,0,0,9
1915454,1475881,2025-01-28,House,"Reported from Labor and Commerce (12-Y 10-N)",12,10,0,0,22
1915454,1479559,2025-02-03,House,"Read third time and passed House (50-Y 48-N)",50,48,0,2,100
1915454,1484917,2025-02-10,Senate,"Reported from Commerce and Labor with substitute (9-Y 6-N)",9,6,0,0,15
1915454,1487908,2025-02-12,Senate,"Constitutional reading dispensed (on 2nd reading) (39-Y 0-N)",39,0,0,1,40
1915454,1490111,2025-02-13,Senate,"Passed Senate with substitute (21-Y 19-N)",21,19,0,0,40
1915454,1490837,2025-02-17,House,"Senate substitute agreed to by House (50-Y 46-N)",50,46,0,4,100
1915467,1472444,2025-01-20,Senate,"Reported from Commerce and Labor (15-Y 0-N)",15,0,0,0,15
1915467,1473021,2025-01-22,Senate,"Constitutional reading dispensed (on 1st reading) (40-Y 0-N)",40,0,0,0,40
1915467,1474835,2025-01-27,Senate,"Read third time and passed Senate (38-Y 0-N)",38,0,0,2,40
1915467,1484678,2025-02-10,House,"Subcommittee recommends reporting (10-Y 0-N)",10,0,0,1,11
1915467,1484679,2025-02-10,House,"Reported from Communications, Technology and Innovation (20-Y 0-N 1-A)",20,0,1,1,22
1915467,1489293,2025-02-13,House,"Passed House (96-Y 0-N)",96,0,0,4,100
1915467,1534666,2025-04-02,Senate,"Senate concurred in Governor's recommendation (40-Y 0-N)",40,0,0,0,40
1915467,1536884,2025-04-02,House,"House concurred in Governor's recommendation (96-Y 0-N)",96,0,0,4,100
1915483,1473992,2025-01-22,Senate,"Reported from Courts of Justice (8-Y 4-N 2-A)",8,4,2,1,15
1915483,1474424,2025-01-24,Senate,"Constitutional reading dispensed (on 1st reading) (37-Y 0-N)",37,0,0,3,40
1915483,1476343,2025-01-29,Senate,"Read third time and passed Senate (30-Y 8-N)",30,8,0,2,40
1915483,1486018,2025-02-10,House,"Reported from Courts of Justice with substitute and referred to Appropriations (20-Y 2-N)",20,2,0,0,22
1915494,1473644,2025-01-22,Senate,"Passed by indefinitely in Courts of Justice (9-Y 6-N)",9,6,0,0,15
1915536,1472243,2025-01-17,Senate,"Reported from Courts of Justice and rereferred to Finance and Appropriations (9-Y 6-N)",9,6,0,0,15
1915536,1473632,2025-01-22,Senate,"Reported from Finance and Appropriations (10-Y 5-N)",10,5,0,0,15
1915536,1473633,2025-01-23,Senate,"Constitutional reading dispensed (on 1st reading) (39-Y 0-N)",39,0,0,1,40
1915536,1475154,2025-01-27,Senate,"Read third time and passed Senate (20-Y 18-N)",20,18,0,2,40
1915536,1483293,2025-02-06,House,"Subcommittee recommends reporting with substitute (6-Y 4-N)",6,4,0,1,11
1915536,1483898,2025-02-07,House,"Reported from Public Safety with substitute (11-Y 10-N)",11,10,0,1,22
1915536,1487951,2025-02-12,House,"Passed House with substitute (50-Y 47-N)",50,47,0,3,100
1915536,1491417,2025-02-17,Senate,"House substitute rejected by Senate (0-Y 39-N)",0,39,0,1,40
1915536,1495276,2025-02-19,Senate,"Senate acceded to request (40-Y 0-N)",40,0,0,0,40
1915536,1497205,2025-02-22,House,"Conference report agreed to by House (51-Y 46-N)",51,46,0,3,100
1915536,1503935,2025-02-22,Senate,"Conference report agreed to by Senate (21-Y 19-N)",21,19,0,0,40
1915550,1475984,2025-01-28,House,"Subcommittee recommends laying on the table (7-Y 0-N)",7,0,0,1,8
1915563,1476350,2025-01-29,Senate,"Reported from Courts of Justice with amendments (9-Y 6-N)",9,6,0,0,15
1915563,1478110,2025-01-31,Senate,"Constitutional reading dispensed (on 1st reading) (39-Y 0-N)",39,0,0,1,40
1915563,1479653,2025-02-04,Senate,"Read third time and passed Senate (21-Y 19-N)",21,19,0,0,40
1915563,1485232,2025-02-10,House,"Subcommittee recommends reporting (5-Y 3-N)",5,3,0,1,9
1915563,1490468,2025-02-14,House,"Reported from Courts of Justice (12-Y 9-N)",12,9,0,1,22
1915563,1493251,2025-02-19,House,"Passed House (51-Y 45-N)",51,45,0,4,100
1915581,1474473,2025-01-24,Senate,"Incorporated by Rules (SB1326-Perry) (10-Y 0-N)",10,0,0,5,15
1915594,1477013,2025-01-29,House,"Reported from Rules and referred to Appropriations (14-Y 0-N)",14,0,0,4,18
1915594,1478491,2025-01-31,House,"Reported from Appropriations with substitute (22-Y 0-N)",22,0,0,0,22
1915594,1480144,2025-02-04,House,"Read third time and passed House (97-Y 0-N)",97,0,0,3,100
1915594,1480145,2025-02-04,House,"Passed House (99-Y 0-N)",99,0,0,1,100
1915594,1490450,2025-02-14,Senate,"Reported from Rules with amendment (15-Y 0-N)",15,0,0,0,15
1915594,1491129,2025-02-17,Senate,"Constitutional reading dispensed (on 2nd reading)",39,0,0,1,40
1915594,1492461,2025-02-18,Senate,"Passed Senate with amendment (40-Y 0-N)",40,0,0,0,40
1915594,1493717,2025-02-19,House,"Senate Amendment agreed to by House (96-Y 0-N)",96,0,0,4,100
1915607,1474512,2025-01-23,Senate,"Reported from Finance and Appropriations (13-Y 0-N)",13,0,0,2,15
1915607,1474886,2025-01-27,Senate,"Constitutional reading dispensed (on 1st reading) (36-Y 0-N)",36,0,0,4,40
1915607,1477217,2025-01-29,Senate,"Read third time and passed Senate (38-Y 0-N)",38,0,0,2,40
1915607,1484767,2025-02-10,House,"Reported from Finance (13-Y 7-N)",13,7,0,2,22
1915607,1487845,2025-02-12,House,"Passed House (53-Y 42-N)",53,42,0,5,100
1915607,1488720,2025-02-12,House,"Constitutional reading dispensed (on 3rd reading) (95-Y 0-N)",95,0,0,5,100
1915607,1536299,2025-04-02,Senate,"Senate rejected Governor's recommendation (19-Y 21-N)",19,21,0,0,40
1915621,1477940,2025-01-30,Senate,"Reported from Transportation with substitute (15-Y 0-N)",15,0,0,0,15
1915621,1480033,2025-02-03,Senate,"Constitutional reading dispensed (on 1st reading) (40-Y 0-N)",40,0,0,0,40
1915621,1480034,2025-02-04,Senate,"Constitutional reading dispensed (on 3rd reading) (39-Y 0-N)",39,0,0,1,40
1915621,1480035,2025-02-04,Senate,"Passed Senate (40-Y 0-N)",40,0,0,0,40
1915621,1485871,2025-02-11,House,"Reported from Transportation (13-Y 7-N)",13,7,0,2,22
1915621,1490585,2025-02-14,House,"Passed House (55-Y 41-N)",55,41,0,4,100
1915633,1474607,2025-01-24,Senate,"Reported from Commerce and Labor with substitute and rereferred to Finance and Appropriations (15-Y 0-N)",15,0,0,0,15
1915633,1477136,2025-01-29,Senate,"Reported from Finance and Appropriations (11-Y 3-N)",11,3,0,1,15
1915633,1477524,2025-01-30,Senate,"Constitutional reading dispensed (on 1st reading) (39-Y 0-N 1-A)",39,0,1,0,40
1915633,1479618,2025-02-03,Senate,"Read third time and passed Senate (36-Y 4-N)",36,4,0,0,40
1915633,1487697,2025-02-12,House,"Subcommittee recommends reporting (6-Y 2-N)",6,2,0,1,9
1915633,1488594,2025-02-13,House,"Reported from Transportation (18-Y 2-N)",18,2,0,2,22
1915633,1496467,2025-02-20,House,"Passed House (53-Y 43-N)",53,43,0,4,100
1915633,1535407,2025-04-02,House,"House concurred in Governor's recommendation (80-Y 15-N)",80,15,0,5,100
1915633,1536574,2025-04-02,Senate,"Senate concurred in Governor's recommendation (38-Y 2-N)",38,2,0,0,40
1915649,1473248,2025-01-22,Senate,"Reported from General Laws and Technology with substitute and rereferred to Finance and Appropriations (9-Y 6-N)",9,6,0,0,15
1915663,1474591,2025-01-24,Senate,"Reported from Rules (12-Y 0-N)",12,0,0,3,15
1915663,1475364,2025-01-27,Senate,"Constitutional reading dispensed (on 1st reading) (37-Y 1-N)",37,1,0,2,40
1915663,1476185,2025-01-29,Senate,"Read third time and passed Senate (38-Y 0-N)",38,0,0,2,40
1915663,1490807,2025-02-17,House,"Tabled in Rules (18-Y 0-N)",18,0,0,0,18
1915675,1475862,2025-01-28,House,"Subcommittee recommends reporting with substitute (7-Y 1-N)",7,1,0,1,9
1915675,1476294,2025-01-29,House,"Reported from Education with substitute (13-Y 9-N)",13,9,0,0,22
1915675,1482189,2025-02-04,House,"Read third time and passed House (56-Y 43-N)",56,43,0,1,100
1915675,1489653,2025-02-13,Senate,"Reported from Education and Health with substitute (9-Y 5-N)",9,5,0,1,15
1915675,1491089,2025-02-17,Senate,"Constitutional reading dispensed (on 1st reading) (39-Y 0-N)",39,0,0,1,40
1915675,1493718,2025-02-19,Senate,"Passed Senate with substitute (22-Y 18-N)",22,18,0,0,40
1915675,1535387,2025-04-02,Senate,"Senate concurred in Governor's recommendation (40-Y 0-N)",40,0,0,0,40
1915675,1536591,2025-04-02,House,"House concurred in Governor's recommendation (91-Y 3-N)",91,3,0,6,100
1915675,1564982,2025-02-20,House,"Senate substitute agreed to by House (57-Y 40-N)",57,40,0,3,100
1915690,1478071,2025-01-30,Senate,"Reported from Education and Health with substitute and rereferred to Finance and Appropriations (15-Y 0-N)",15,0,0,0,15
1915703,1473713,2025-01-21,Senate,"Reported from Agriculture, Conservation and Natural Resources (13-Y 0-N)",13,0,0,2,15
1915703,1473714,2025-01-23,Senate,"Constitutional reading dispensed (on 1st reading) (39-Y 0-N)",39,0,0,1,40
1915703,1475363,2025-01-27,Senate,"Read third time and passed Senate (38-Y 0-N)",38,0,0,2,40
1915703,1483365,2025-02-06,House,"Reported from Labor and Commerce (21-Y 0-N)",21,0,0,1,22
1915703,1486291,2025-02-11,House,"Passed House (94-Y 0-N)",94,0,0,6,100
1915717,1478061,2025-01-30,Senate,"Reported from Education and Health with substitute and rereferred to Finance and Appropriations (15-Y 0-N)",15,0,0,0,15
1915730,1474597,2025-01-24,Senate,"Rereferred from Rules to Commerce and Labor (12-Y 0-N)",12,0,0,3,15
1915730,1475134,2025-01-27,Senate,"Reported from Commerce and Labor with substitute (9-Y 5-N 1-A)",9,5,1,0,15
1915730,1476188,2025-01-29,Senate,"Constitutional reading dispensed (on 1st reading) (38-Y 0-N)",38,0,0,2,40
1915730,1478598,2025-01-31,Senate,"Read third time and passed Senate (24-Y 16-N)",24,16,0,0,40
1915730,1489426,2025-02-13,House,"Reported from Labor and Commerce (17-Y 5-N)",17,5,0,0,22
1915730,1491994,2025-02-18,House,"Passed House (70-Y 27-N)",70,27,0,3,100
1915745,1479074,2025-02-03,Senate,"Failed to report from Courts of Justice with amendments (6-Y 9-N)",6,9,0,0,15
1915758,1474862,2025-01-27,House,"Subcommittee recommends striking from the docket (8-Y 0-N)",8,0,0,1,9
1915774,1474567,2025-01-24,Senate,"Reported from Rules with substitute and rereferred to Finance and Appropriations (12-Y 0-N)",12,0,0,3,15
1915774,1477077,2025-01-29,Senate,"Reported from Finance and Appropriations (14-Y 0-N)",14,0,0,1,15
1915774,1477804,2025-01-30,Senate,"Constitutional reading dispensed (on 1st reading) (39-Y 0-N 1-A)",39,0,1,0,40
1915774,1479379,2025-01-31,Senate,"Constitutional reading dispensed (on 3rd reading) (40-Y 0-N)",40,0,0,0,40
1915774,1479380,2025-01-31,Senate,"Passed Senate (40-Y 0-N)",40,0,0,0,40
1915774,1490774,2025-02-17,House,"Tabled in Rules (18-Y 0-N)",18,0,0,0,18
1915799,1473765,2025-01-23,Senate,"Reported from Transportation (14-Y 0-N)",14,0,0,1,15
1915799,1474940,2025-01-27,Senate,"Constitutional reading dispensed (on 1st reading) (36-Y 0-N)",36,0,0,4,40
1915799,1476592,2025-01-29,Senate,"Read third time and passed Senate (38-Y 0-N)",38,0,0,2,40
1915799,1483011,2025-02-06,House,"Reported from Transportation (20-Y 0-N)",20,0,0,2,22
1915799,1486768,2025-02-11,House,"Passed House (94-Y 0-N)",94,0,0,6,100
1915814,1475866,2025-01-28,House,"Subcommittee recommends reporting with amendment(s) (6-Y 2-N)",6,2,0,1,9
1915814,1476277,2025-01-29,House,"Reported from Education with amendment(s) (16-Y 6-N)",16,6,0,0,22
1915840,1476723,2025-01-29,Senate,"Passed by indefinitely in General Laws and Technology with letter (15-Y 0-N)",15,0,0,0,15
1915855,1475998,2025-01-28,House,"Subcommittee recommends reporting with substitute (9-Y 0-N)",9,0,0,2,11
1915855,1477676,2025-01-30,House,"Reported from Labor and Commerce with substitute (21-Y 1-N)",21,1,0,0,22
1915855,1480733,2025-02-04,House,"Read third time and passed House (81-Y 17-N)",81,17,0,2,100
1915855,1491395,2025-02-17,Senate,"Reported from Commerce and Labor with substitute (15-Y 0-N)",15,0,0,0,15
1915855,1493391,2025-02-18,Senate,"Constitutional reading dispensed (on 2nd reading) (40-Y 0-N)",40,0,0,0,40
1915855,1495065,2025-02-19,Senate,"Passed Senate with substitute (40-Y 0-N)",40,0,0,0,40
1915855,1495713,2025-02-20,Senate,"Senate insisted on substitute (39-Y 0-N)",39,0,0,1,40
1915855,1496656,2025-02-20,House,"Senate substitute rejected by House (0-Y 98-N)",0,98,0,2,100
1915855,1497131,2025-02-22,House,"Conference report agreed to by House (98-Y 0-N)",98,0,0,2,100
1915855,1503662,2025-02-22,Senate,"Conference report agreed to by Senate (38-Y 0-N)",38,0,0,2,40
1915855,1503663,2025-02-22,Senate,"Conference report agreed to by Senate (39-Y 0-N)",39,0,0,1,40
1915855,1564881,2025-02-22,Senate,"Reconsideration of conference report (39-Y 0-N)",39,0,0,1,40
1915867,1475848,2025-01-28,Senate,"Reported from Agriculture, Conservation and Natural Resources with substitute and rereferred to Finance and Appropriations (14-Y 0-N)",14,0,0,1,15
1915890,1475850,2025-01-28,Senate,"Reported from Agriculture, Conservation and Natural Resources with amendments and rereferred to Finance and Appropriations (12-Y 0-N 2-A)",12,0,2,1,15
1915890,1477644,2025-01-30,Senate,"Reported from Finance and Appropriations (15-Y 0-N)",15,0,0,0,15
1915890,1479861,2025-02-04,Senate,"Constitutional reading dispensed (on 3rd reading) (40-Y 0-N)",40,0,0,0,40
1915890,1479862,2025-02-04,Senate,"Passed Senate (40-Y 0-N)",40,0,0,0,40
1915890,1480333,2025-02-03,Senate,"Constitutional reading dispensed (on 1st reading) (40-Y 0-N)",40,0,0,0,40
1915890,1484688,2025-02-10,House,"Reported from Appropriations with substitute (22-Y 0-N)",22,0,0,0,22
1915890,1489327,2025-02-13,House,"Passed House with substitute (89-Y 8-N)",89,8,0,3,100
1915890,1491331,2025-02-17,Senate,"House substitute agreed to by Senate (39-Y 0-N)",39,0,0,1,40
1915906,1476355,2025-01-29,House,"Subcommittee recommends reporting (10-Y 0-N)",10,0,0,1,11
1915906,1476356,2025-01-29,House,"Reported from Agriculture, Chesapeake and Natural Resources (22-Y 0-N)",22,0,0,0,22
1915906,1482311,2025-02-04,House,"Read third time and passed House (63-Y 35-N)",63,35,0,2,100
1915906,1486641,2025-02-11,Senate,"Reported from Agriculture, Conservation and Natural Resources (10-Y 4-N)",10,4,0,1,15
1915906,1490094,2025-02-13,Senate,"Constitutional reading dispensed (on 2nd reading) (40-Y 0-N)",40,0,0,0,40
1915906,1490095,2025-02-14,Senate,"Passed Senate (27-Y 9-N)",27,9,0,4,40
1915915,1477199,2025-01-30,Senate,"Reported from Education and Health with amendments (10-Y 3-N 2-A)",10,3,2,0,15
1915915,1478074,2025-01-31,Senate,"Constitutional reading dispensed (on 1st reading) (39-Y 0-N)",39,0,0,1,40
1915915,1480051,2025-02-04,Senate,"Read third time and passed Senate (35-Y 5-N)",35,5,0,0,40
1915915,1486040,2025-02-11,House,"Subcommittee recommends reporting with amendment(s) (6-Y 2-N)",6,2,0,1,9
1915915,1488818,2025-02-13,House,"Reported from Health and Human Services with substitute (19-Y 3-N)",19,3,0,0,22
1915915,1492105,2025-02-18,House,"Passed House with substitute (66-Y 30-N)",66,30,0,4,100
1915915,1495840,2025-02-19,Senate,"House substitute agreed to by Senate (28-Y 12-N)",28,12,0,0,40
1915925,1474596,2025-01-24,Senate,"Reported from Rules (12-Y 0-N)",12,0,0,3,15
1915925,1474872,2025-01-27,Senate,"Constitutional reading dispensed (on 1st reading) (37-Y 1-N)",37,1,0,2,40
1915925,1476862,2025-01-29,Senate,"Read third time and passed Senate (38-Y 0-N)",38,0,0,2,40
1915925,1490776,2025-02-17,House,"Tabled in Rules (18-Y 0-N)",18,0,0,0,18
1915936,1477205,2025-01-30,Senate,"Reported from Education and Health (15-Y 0-N)",15,0,0,0,15
1915936,1478084,2025-01-31,Senate,"Constitutional reading dispensed (on 1st reading) (39-Y 0-N)",39,0,0,1,40
1915936,1480210,2025-02-03,Senate,"Constitutional reading dispensed (on 3rd reading) (40-Y 0-N)",40,0,0,0,40
1915936,1480211,2025-02-03,Senate,"Passed Senate (40-Y 0-N)",40,0,0,0,40
1915936,1486078,2025-02-11,House,"Reported from Health and Human Services (22-Y 0-N)",22,0,0,0,22
1915936,1490579,2025-02-14,House,"Passed House (96-Y 0-N)",96,0,0,4,100
1915949,1476629,2025-01-29,House,"Subcommittee recommends reporting with substitute (8-Y 0-N)",8,0,0,1,9
1915949,1477375,2025-01-30,House,"Reported from Transportation with substitute (22-Y 0-N)",22,0,0,0,22
1915949,1480836,2025-02-04,House,"Read third time and passed House (97-Y 0-N)",97,0,0,3,100
1915949,1480837,2025-02-04,House,"Passed House (99-Y 0-N)",99,0,0,1,100
1915949,1490211,2025-02-14,Senate,"Reported from Rules (15-Y 0-N)",15,0,0,0,15
1915949,1491009,2025-02-17,Senate,"Constitutional reading dispensed (on 2nd reading)",39,0,0,1,40
1915949,1492269,2025-02-18,Senate,"Passed Senate with amendment (40-Y 0-N)",40,0,0,0,40
1915949,1493731,2025-02-19,House,"Senate Amendment rejected by House (4-Y 92-N)",4,92,0,4,100
1915949,1495301,2025-02-20,Senate,"Senate insisted on amendment (39-Y 0-N)",39,0,0,1,40
1915949,1497160,2025-02-22,House,"Conference report agreed to by House (97-Y 0-N)",97,0,0,3,100
1915949,1503909,2025-02-22,Senate,"Conference report agreed to by Senate (40-Y 0-N)",40,0,0,0,40
1915961,1475066,2025-01-27,House,"Subcommittee recommends reporting (8-Y 0-N)",8,0,0,1,9
1915961,1477018,2025-01-29,House,"Reported from Courts of Justice (22-Y 0-N)",22,0,0,0,22
1915961,1480598,2025-02-04,House,"Read third time and passed House (97-Y 0-N)",97,0,0,3,100
1915961,1480599,2025-02-04,House,"Passed House (99-Y 0-N)",99,0,0,1,100
1915961,1490743,2025-02-17,Senate,"Reported from Courts of Justice (15-Y 0-N)",15,0,0,0,15
1915961,1492791,2025-02-18,Senate,"Constitutional reading dispensed (on 2nd reading) (39-Y 0-N)",39,0,0,1,40
1915961,1494688,2025-02-19,Senate,"Passed Senate with amendments (40-Y 0-N)",40,0,0,0,40
1915961,1496667,2025-02-20,House,"Senate Amendments agreed to by House (98-Y 0-N)",98,0,0,2,100
1915972,1478082,2025-01-30,Senate,"Reported from Education and Health with substitute (13-Y 0-N 2-A)",13,0,2,0,15
1915972,1478083,2025-01-31,Senate,"Constitutional reading dispensed (on 1st reading) (39-Y 0-N)",39,0,0,1,40
1915972,1480509,2025-02-04,Senate,"Read third time and passed Senate (40-Y 0-N)",40,0,0,0,40
1915972,1486772,2025-02-11,House,"Reported from Health and Human Services (22-Y 0-N)",22,0,0,0,22
1915972,1490315,2025-02-14,House,"Passed House (96-Y 0-N)",96,0,0,4,100
1915982,1477261,2025-01-30,Senate,"Reported from Education and Health (15-Y 0-N)",15,0,0,0,15
1915982,1478197,2025-01-31,Senate,"Constitutional reading dispensed (on 1st reading) (39-Y 0-N)",39,0,0,1,40
1915982,1480343,2025-02-03,Senate,"Constitutional reading dispensed (on 3rd reading) (40-Y 0-N)",40,0,0,0,40
1915982,1480344,2025-02-03,Senate,"Passed Senate (40-Y 0-N)",40,0,0,0,40
1915982,1487396,2025-02-12,House,"Reported from Education (21-Y 0-N)",21,0,0,1,22
1915982,1491123,2025-02-17,House,"Passed House (95-Y 0-N)",95,0,0,5,100
1915982,1491124,2025-02-17,House,"Passed House (96-Y 0-N)",96,0,0,4,100
1915996,1474491,2025-01-23,Senate,"Reported from Finance and Appropriations (13-Y 0-N)",13,0,0,2,15
1915996,1474894,2025-01-27,Senate,"Constitutional reading dispensed (on 1st reading) (36-Y 0-N)",36,0,0,4,40
1915996,1477176,2025-01-29,Senate,"Read third time and passed Senate (38-Y 0-N)",38,0,0,2,40
1915996,1487851,2025-02-12,House,"Reported from Finance with substitute (22-Y 0-N)",22,0,0,0,22
1915996,1490820,2025-02-17,House,"Passed House with substitute (95-Y 0-N)",95,0,0,5,100
1915996,1490821,2025-02-17,House,"Passed House with substitute (96-Y 0-N)",96,0,0,4,100
1915996,1493370,2025-02-18,Senate,"House substitute rejected by Senate (2-Y 38-N)",2,38,0,0,40
1915996,1495039,2025-02-20,Senate,"Senate acceded to request (39-Y 0-N)",39,0,0,1,40
1915996,1496657,2025-02-21,Senate,"Conference report agreed to by Senate (39-Y 0-N)",39,0,0,1,40
1915996,1504121,2025-02-21,House,"Conference report agreed to by House (96-Y 0-N)",96,0,0,4,100
1916011,1473212,2025-01-22,House,"Subcommittee recommends laying on the table (6-Y 4-N)",6,4,0,1,11
1916023,1475819,2025-01-28,Senate,"Stricken at request of Patron in Agriculture, Conservation and Natural Resources (14-Y 0-N)",14,0,0,1,15
1916035,1475723,2025-01-27,Senate,"Passed by indefinitely in Commerce and Labor (11-Y 3-N)",11,3,0,1,15
1916048,1475123,2025-01-27,House,"Subcommittee recommends laying on the table (5-Y 3-N)",5,3,0,1,9
1916060,1477222,2025-01-30,Senate,"Reported from Education and Health with substitute (15-Y 0-N)",15,0,0,0,15
1916060,1478140,2025-01-31,Senate,"Constitutional reading dispensed (on 1st reading) (39-Y 0-N)",39,0,0,1,40
1916060,1480255,2025-02-03,Senate,"Constitutional reading dispensed (on 3rd reading) (40-Y 0-N)",40,0,0,0,40
1916060,1480256,2025-02-03,Senate,"Passed Senate (40-Y 0-N)",40,0,0,0,40
1916060,1485991,2025-02-11,House,"Subcommittee recommends reporting and referring to Appropriations (8-Y 0-N)",8,0,0,1,9
1916060,1488781,2025-02-13,House,"Reported from Health and Human Services and referred to Appropriations (22-Y 0-N)",22,0,0,0,22
1916060,1490143,2025-02-14,House,"Reported from Appropriations (21-Y 0-N)",21,0,0,1,22
1916060,1495204,2025-02-19,House,"Passed House (97-Y 0-N)",97,0,0,3,100
1916071,1473361,2025-01-22,Senate,"Stricken at request of Patron in General Laws and Technology (15-Y 0-N)",15,0,0,0,15
1916082,1477241,2025-01-30,Senate,"Reported from Education and Health with substitute (15-Y 0-N)",15,0,0,0,15
1916082,1478167,2025-01-31,Senate,"Constitutional reading dispensed (on 1st reading) (39-Y 0-N)",39,0,0,1,40
1916082,1480281,2025-02-03,Senate,"Constitutional reading dispensed (on 3rd reading) (40-Y 0-N)",40,0,0,0,40
1916082,1480282,2025-02-03,Senate,"Passed Senate (40-Y 0-N)",40,0,0,0,40
1916082,1485939,2025-02-11,House,"Subcommittee recommends reporting (8-Y 0-N)",8,0,0,1,9
1916082,1488772,2025-02-13,House,"Reported from Health and Human Services (22-Y 0-N)",22,0,0,0,22
1916082,1492067,2025-02-18,House,"Passed House (97-Y 0-N)",97,0,0,3,100
1916095,1476752,2025-01-29,Senate,"Reported from General Laws and Technology (15-Y 0-N)",15,0,0,0,15
1916095,1478400,2025-01-31,Senate,"Constitutional reading dispensed (on 1st reading) (39-Y 0-N)",39,0,0,1,40
1916095,1480311,2025-02-03,Senate,"Constitutional reading dispensed (on 3rd reading) (40-Y 0-N)",40,0,0,0,40
1916095,1480312,2025-02-03,Senate,"Passed Senate (40-Y 0-N)",40,0,0,0,40
1916109,1477279,2025-01-30,Senate,"Stricken at request of Patron in Education and Health (15-Y 0-N)",15,0,0,0,15
1916121,1475795,2025-01-28,Senate,"Passed by indefinitely in Finance and Appropriations (15-Y 0-N)",15,0,0,0,15
1916132,1472425,2025-01-20,Senate,"Reported from Commerce and Labor (9-Y 6-N)",9,6,0,0,15
1916132,1473000,2025-01-22,Senate,"Constitutional reading dispensed (on 1st reading) (40-Y 0-N)",40,0,0,0,40
1916132,1476520,2025-01-28,Senate,"Read third time and passed Senate (22-Y 17-N)",22,17,0,1,40
1916132,1486600,2025-02-11,House,"Subcommittee recommends reporting (5-Y 3-N)",5,3,0,1,9
1916132,1489467,2025-02-13,House,"Reported from Labor and Commerce with substitute (12-Y 10-N)",12,10,0,0,22
1916132,1492182,2025-02-18,House,"Passed House with substitute (50-Y 46-N)",50,46,0,4,100
1916132,1493586,2025-02-19,Senate,"House substitute agreed to by Senate (25-Y 14-N)",25,14,0,1,40
1916132,1535170,2025-04-02,House,"House concurred in Governor's recommendation (90-Y 6-N)",90,6,0,4,100
1916132,1536355,2025-04-02,Senate,"Senate concurred in Governor's recommendation (40-Y 0-N)",40,0,0,0,40
1916147,1475372,2025-01-28,Senate,"Reported from Education and Health and rereferred to Finance and Appropriations (15-Y 0-N)",15,0,0,0,15
1916159,1476751,2025-01-29,Senate,"Reported from General Laws and Technology and rereferred to Finance and Appropriations (15-Y 0-N)",15,0,0,0,15
1916159,1477733,2025-01-30,Senate,"Reported from Finance and Appropriations with amendment (15-Y 0-N)",15,0,0,0,15
1916159,1480186,2025-02-03,Senate,"Constitutional reading dispensed (on 1st reading) (40-Y 0-N)",40,0,0,0,40
1916159,1480187,2025-02-04,Senate,"Constitutional reading dispensed (on 3rd reading) (39-Y 0-N)",39,0,0,1,40
1916159,1480188,2025-02-04,Senate,"Passed Senate (40-Y 0-N)",40,0,0,0,40
1916159,1489487,2025-02-13,House,"Subcommittee recommends reporting with substitute (4-Y 2-N)",4,2,0,1,7
1916159,1490138,2025-02-14,House,"Reported from Public Safety with substitute (11-Y 10-N)",11,10,0,1,22
1916159,1494214,2025-02-19,House,"Passed House with substitute (51-Y 45-N)",51,45,0,4,100
1916159,1495953,2025-02-20,Senate,"House substitute agreed to by Senate (39-Y 0-N)",39,0,0,1,40
1916159,1536193,2025-04-02,Senate,"Senate rejected Governor's recommendation (18-Y 22-N)",18,22,0,0,40
1916171,1473396,2025-01-22,Senate,"Reported from General Laws and Technology (15-Y 0-N)",15,0,0,0,15
1916171,1474641,2025-01-24,Senate,"Constitutional reading dispensed (on 1st reading) (37-Y 0-N)",37,0,0,3,40
1916171,1476910,2025-01-28,Senate,"Read third time and passed Senate (39-Y 0-N)",39,0,0,1,40
1916171,1489863,2025-02-13,House,"Stricken from docket by General Laws (19-Y 0-N)",19,0,0,3,22
1916184,1473508,2025-01-23,Senate,"Reported from Education and Health (15-Y 0-N)",15,0,0,0,15
1916184,1474361,2025-01-24,Senate,"Constitutional reading dispensed (on 1st reading) (37-Y 0-N)",37,0,0,3,40
1916184,1477050,2025-01-28,Senate,"Read third time and passed Senate (37-Y 2-N)",37,2,0,1,40
1916184,1477051,2025-01-28,Senate,"Reconsideration of passage agreed to by Senate (38-Y 0-N)",38,0,0,2,40
1916184,1477052,2025-01-28,Senate,"Passed Senate (39-Y 0-N)",39,0,0,1,40
1916184,1487444,2025-02-12,House,"Reported from Education (21-Y 0-N)",21,0,0,1,22
1916184,1491196,2025-02-17,House,"Passed House (95-Y 0-N)",95,0,0,5,100
1916184,1491197,2025-02-17,House,"Passed House (96-Y 0-N)",96,0,0,4,100
1916184,1535363,2025-04-02,House,"House concurred in Governor's recommendation (96-Y 0-N)",96,0,0,4,100
1916184,1536557,2025-04-02,Senate,"Senate concurred in Governor's recommendation (40-Y 0-N)",40,0,0,0,40
1916195,1475097,2025-01-27,Senate,"Failed to report (defeated) in Commerce and Labor (5-Y 9-N 1-A)",5,9,1,0,15
1916210,1474615,2025-01-24,Senate,"Reported from Rules (11-Y 0-N)",11,0,0,4,15
1916210,1475070,2025-01-27,Senate,"Constitutional reading dispensed (on 1st reading) (37-Y 1-N)",37,1,0,2,40
1916210,1476546,2025-01-29,Senate,"Read third time and passed Senate (38-Y 0-N)",38,0,0,2,40
1916210,1491444,2025-02-17,House,"Tabled in Rules (18-Y 0-N)",18,0,0,0,18
1916221,1478352,2025-01-30,Senate,"Reported from Education and Health with amendments and rereferred to Finance and Appropriations (15-Y 0-N)",15,0,0,0,15
1916234,1474367,2025-01-24,House,"Subcommittee recommends laying on the table (5-Y 3-N)",5,3,0,1,9
1916244,1474118,2025-01-22,Senate,"Reported from Courts of Justice with amendment and rereferred to Finance and Appropriations (10-Y 1-N)",10,1,0,4,15
1916244,1475378,2025-01-28,Senate,"Reported from Finance and Appropriations (12-Y 3-N)",12,3,0,0,15
1916244,1476249,2025-01-29,Senate,"Constitutional reading dispensed (on 1st reading) (38-Y 0-N)",38,0,0,2,40
1916244,1478420,2025-01-31,Senate,"Read third time and passed Senate (40-Y 0-N)",40,0,0,0,40
1916244,1485537,2025-02-10,House,"Reported from Finance (20-Y 0-N)",20,0,0,2,22
1916244,1489539,2025-02-13,House,"Passed House (96-Y 0-N)",96,0,0,4,100
1916260,1475722,2025-01-27,Senate,"Reported from Commerce and Labor with substitute (15-Y 0-N)",15,0,0,0,15
1916260,1476216,2025-01-29,Senate,"Constitutional reading dispensed (on 1st reading) (38-Y 0-N)",38,0,0,2,40
1916260,1477334,2025-01-30,Senate,"Read third time and passed Senate (40-Y 0-N)",40,0,0,0,40
1916260,1479262,2025-01-30,Senate,"Constitutional reading dispensed (on 3rd reading) (39-Y 1-N)",39,1,0,0,40
1916260,1479263,2025-01-30,Senate,"Passed Senate (40-Y 0-N)",39,1,0,0,40
1916260,1486532,2025-02-11,House,"Subcommittee recommends reporting (8-Y 0-N)",8,0,0,1,9
1916260,1489405,2025-02-13,House,"Reported from Labor and Commerce (12-Y 10-N)",12,10,0,0,22
1916260,1493457,2025-02-19,House,"Passed House (63-Y 33-N)",63,33,0,4,100
1916260,1535034,2025-04-02,House,"House concurred in Governor's recommendation (76-Y 20-N)",76,20,0,4,100
1916260,1536290,2025-04-02,Senate,"Senate concurred in Governor's recommendation (40-Y 0-N)",40,0,0,0,40
1916270,1476745,2025-01-29,Senate,"Passed by indefinitely in General Laws and Technology (14-Y 1-N)",14,1,0,0,15
1916283,1473658,2025-01-23,House,"Subcommittee recommends reporting (8-Y 0-N)",8,0,0,1,9
1916283,1474311,2025-01-24,House,"Reported from Counties, Cities and Towns (20-Y 0-N)",20,0,0,2,22
1916283,1478325,2025-01-30,House,"Read third time and passed House (96-Y 0-N)",96,0,0,4,100
1916283,1484907,2025-02-10,Senate,"Reported from Local Government (15-Y 0-N)",15,0,0,0,15
1916283,1486374,2025-02-11,Senate,"Constitutional reading dispensed (on 2nd reading) (40-Y 0-N)",40,0,0,0,40
1916283,1489802,2025-02-12,Senate,"Passed Senate (39-Y 0-N)",39,0,0,1,40
1916294,1478036,2025-01-31,House,"Reported from Public Safety (12-Y 9-N)",12,9,0,1,22
1916294,1482576,2025-02-04,House,"Read third time and passed House (51-Y 47-N)",51,47,0,2,100
1916294,1484755,2025-02-10,Senate,"Reported from Courts of Justice and rereferred to Finance and Appropriations (9-Y 4-N)",9,4,0,2,15
1916294,1487434,2025-02-12,Senate,"Reported from Finance and Appropriations (10-Y 5-N)",10,5,0,0,15
1916294,1489048,2025-02-13,Senate,"Constitutional reading dispensed (on 2nd reading) (40-Y 0-N)",40,0,0,0,40
1916294,1490318,2025-02-14,Senate,"Passed Senate (21-Y 15-N)",21,15,0,4,40
1916309,1474299,2025-01-23,Senate,"Rereferred from Education and Health and Rereferred to Rules (15-Y 0-N)",15,0,0,0,15
1916309,1474644,2025-01-24,Senate,"Reported from Rules with substitute (12-Y 0-N)",12,0,0,3,15
1916309,1475187,2025-01-27,Senate,"Constitutional reading dispensed (on 1st reading) (37-Y 1-N)",37,1,0,2,40
1916309,1476361,2025-01-29,Senate,"Read third time and passed Senate (38-Y 0-N)",38,0,0,2,40
1916309,1487942,2025-02-12,House,"Reported from Education (21-Y 0-N)",21,0,0,1,22
1916309,1491546,2025-02-17,House,"Passed House (95-Y 0-N)",95,0,0,5,100
1916309,1491547,2025-02-17,House,"Passed House (96-Y 0-N)",96,0,0,4,100
1916320,1475295,2025-01-28,Senate,"Reported from Education and Health and rereferred to Finance and Appropriations (15-Y 0-N)",15,0,0,0,15
1916320,1477738,2025-01-30,Senate,"Reported from Finance and Appropriations (15-Y 0-N)",15,0,0,0,15
1916320,1480335,2025-02-03,Senate,"Constitutional reading dispensed (on 1st reading) (40-Y 0-N)",40,0,0,0,40
1916320,1482647,2025-02-04,Senate,"Constitutional reading dispensed (on 3rd reading) (39-Y 0-N)",39,0,0,1,40
1916320,1482648,2025-02-04,Senate,"Passed Senate (40-Y 0-N)",40,0,0,0,40
1916320,1487024,2025-02-11,House,"Subcommittee recommends reporting (8-Y 0-N)",8,0,0,1,9
1916320,1488730,2025-02-13,House,"Reported from Health and Human Services (21-Y 0-N)",21,0,0,1,22
1916320,1492454,2025-02-18,House,"Passed House (97-Y 0-N)",97,0,0,3,100
1916333,1477201,2025-01-30,Senate,"Reported from Education and Health with substitute and rereferred to Finance and Appropriations (15-Y 0-N)",15,0,0,0,15
1916333,1477916,2025-01-30,Senate,"Reported from Finance and Appropriations (15-Y 0-N)",15,0,0,0,15
1916333,1480204,2025-02-03,Senate,"Constitutional reading dispensed (on 1st reading) (40-Y 0-N)",40,0,0,0,40
1916333,1480205,2025-02-04,Senate,"Constitutional reading dispensed (on 3rd reading) (39-Y 0-N)",39,0,0,1,40
1916333,1480206,2025-02-04,Senate,"Passed Senate (40-Y 0-N)",40,0,0,0,40
1916333,1486441,2025-02-11,House,"Reported from Health and Human Services with substitute (22-Y 0-N)",22,0,0,0,22
1916333,1490488,2025-02-14,House,"Passed House with substitute with amendment (80-Y 16-N)",80,16,0,4,100
1916333,1492689,2025-02-18,Senate,"Reconsideration of House substitute with amendment rejected by Senate(40-Y 0-N)",40,0,0,0,40
1916333,1492690,2025-02-18,Senate,"House substitute with amendment agreed to by Senate (40-Y 0-N)",40,0,0,0,40
1916333,1492691,2025-02-18,Senate,"Reconsideration of House substitute with amendment agreed to by Senate (40-Y 0-N)",40,0,0,0,40
1916333,1493037,2025-02-18,Senate,"House substitute with amendment rejected by Senate (1-Y 37-N)",1,37,0,2,40
1916333,1494799,2025-02-19,Senate,"House substitute with amendment rejected by Senate (1-Y 38-N)",1,38,0,1,40
1916333,1496011,2025-02-20,Senate,"Senate acceded to request (38-Y 0-N)",38,0,0,2,40
1916333,1504065,2025-02-22,Senate,"Conference report agreed to by Senate (40-Y 0-N)",40,0,0,0,40
1916333,1564896,2025-02-22,House,"Conference report agreed to by House (81-Y 15-N)",81,15,0,4,100
1916345,1473206,2025-01-22,House,"Subcommittee recommends reporting with substitute (4-Y 3-N 2-A)",4,3,2,2,11
1916345,1476347,2025-01-29,House,"Tabled in Agriculture, Chesapeake and Natural Resources (12-Y 10-N)",12,10,0,0,22
1916357,1475874,2025-01-28,House,"Subcommittee recommends reporting (10-Y 0-N)",10,0,0,1,11
1916357,1477701,2025-01-30,House,"Reported from Labor and Commerce (22-Y 0-N)",22,0,0,0,22
1916357,1480840,2025-02-04,House,"Read third time and passed House (97-Y 0-N)",97,0,0,3,100
1916357,1480841,2025-02-04,House,"Passed House (99-Y 0-N)",99,0,0,1,100
1916357,1487437,2025-02-12,Senate,"Passed by indefinitely in Finance and Appropriations (9-Y 6-N)",9,6,0,0,15
1916367,1476741,2025-01-29,Senate,"Reported from General Laws and Technology and rereferred to Finance and Appropriations (15-Y 0-N)",15,0,0,0,15
1916367,1477708,2025-01-30,Senate,"Reported from Finance and Appropriations (15-Y 0-N)",15,0,0,0,15
1916367,1480326,2025-02-03,Senate,"Constitutional reading dispensed (on 1st reading) (40-Y 0-N)",40,0,0,0,40
1916367,1482761,2025-02-04,Senate,"Constitutional reading dispensed (on 3rd reading) (39-Y 0-N)",39,0,0,1,40
1916367,1482762,2025-02-04,Senate,"Passed Senate (40-Y 0-N)",40,0,0,0,40
1916367,1484608,2025-02-10,House,"Subcommittee recommends reporting and referring to Appropriations (10-Y 0-N)",10,0,0,1,11
1916367,1484609,2025-02-10,House,"Reported from Communications, Technology and Innovation and referred to Appropriations (21-Y 0-N)",21,0,0,1,22
1916383,1478035,2025-01-30,Senate,"Reported from Education and Health with substitute (15-Y 0-N)",15,0,0,0,15
1916383,1478166,2025-01-31,Senate,"Constitutional reading dispensed (on 1st reading) (39-Y 0-N)",39,0,0,1,40
1916383,1479781,2025-02-03,Senate,"Constitutional reading dispensed (on 3rd reading) (40-Y 0-N)",40,0,0,0,40
1916383,1479782,2025-02-03,Senate,"Passed Senate (40-Y 0-N)",40,0,0,0,40
1916383,1485940,2025-02-11,House,"Reported from Health and Human Services (22-Y 0-N)",22,0,0,0,22
1916383,1490184,2025-02-14,House,"Passed House (96-Y 0-N)",96,0,0,4,100
1916395,1474611,2025-01-24,Senate,"Reported from Rules (12-Y 0-N)",12,0,0,3,15
1916395,1475026,2025-01-27,Senate,"Constitutional reading dispensed (on 1st reading) (37-Y 1-N)",37,1,0,2,40
1916395,1476869,2025-01-29,Senate,"Read third time and passed Senate (38-Y 0-N)",38,0,0,2,40
1916395,1490796,2025-02-17,House,"Tabled in Rules (18-Y 0-N)",18,0,0,0,18
1916409,1475379,2025-01-28,House,"Subcommittee recommends reporting (8-Y 0-N)",8,0,0,1,9
1916409,1477190,2025-01-30,House,"Reported from Health and Human Services (21-Y 0-N)",21,0,0,1,22
1916409,1480523,2025-02-04,House,"Read third time and passed House (97-Y 0-N)",97,0,0,3,100
1916409,1480524,2025-02-04,House,"Passed House (99-Y 0-N)",99,0,0,1,100
1916409,1489437,2025-02-13,Senate,"Reported from Education and Health with substitute and rereferred to Finance and Appropriations (15-Y 0-N)",15,0,0,0,15
1916409,1490107,2025-02-14,Senate,"Reported from Finance and Appropriations (14-Y 0-N)",14,0,0,1,15
1916409,1492039,2025-02-17,Senate,"Constitutional reading dispensed (on 2nd reading) (39-Y 0-N)",39,0,0,1,40
1916409,1492040,2025-02-18,Senate,"Passed Senate with substitute (40-Y 0-N)",40,0,0,0,40
1916409,1493506,2025-02-19,House,"Senate substitute agreed to by House (97-Y 0-N)",97,0,0,3,100
1916422,1473724,2025-01-17,Senate,"Rereferred from Rules to Rehabilitation and Social Services (15-Y 0-N)",15,0,0,0,15
1916422,1474304,2025-01-24,Senate,"Reported from Rehabilitation and Social Services with substitute (15-Y 0-N)",15,0,0,0,15
1916422,1475099,2025-01-27,Senate,"Constitutional reading dispensed (on 1st reading) (36-Y 0-N)",36,0,0,4,40
1916422,1476448,2025-01-29,Senate,"Read third time and passed Senate (38-Y 0-N)",38,0,0,2,40
1916422,1482643,2025-02-05,House,"Reported from Courts of Justice (22-Y 0-N)",22,0,0,0,22
1916422,1484659,2025-02-10,House,"Passed House (95-Y 0-N)",95,0,0,5,100
1916433,1475821,2025-01-28,Senate,"Reported from Agriculture, Conservation and Natural Resources with substitute and rereferred to Finance and Appropriations (9-Y 5-N)",9,5,0,1,15
1916444,1475675,2025-01-28,House,"Subcommittee recommends striking from the docket (8-Y 0-N)",8,0,0,1,9
1916456,1475061,2025-01-27,Senate,"Incorporated by Courts of Justice (SB963-Carroll Foy) (14-Y 0-N)",14,0,0,1,15
1916469,1477254,2025-01-30,Senate,"Reported from Education and Health (14-Y 0-N)",14,0,0,1,15
1916469,1478203,2025-01-31,Senate,"Constitutional reading dispensed (on 1st reading) (39-Y 0-N)",39,0,0,1,40
1916469,1480287,2025-02-03,Senate,"Constitutional reading dispensed (on 3rd reading) (40-Y 0-N)",40,0,0,0,40
1916469,1480288,2025-02-03,Senate,"Passed Senate (40-Y 0-N)",40,0,0,0,40
1916469,1487358,2025-02-12,House,"Reported from Education (21-Y 0-N)",21,0,0,1,22
1916469,1493064,2025-02-18,House,"Passed House with amendment (96-Y 0-N)",96,0,0,4,100
1916469,1493786,2025-02-19,Senate,"House Amendment agreed to by Senate (40-Y 0-N)",40,0,0,0,40
1916481,1478349,2025-01-30,Senate,"Reported from Education and Health (15-Y 0-N)",15,0,0,0,15
1916481,1478350,2025-01-31,Senate,"Constitutional reading dispensed (on 1st reading) (39-Y 0-N)",39,0,0,1,40
1916481,1480433,2025-02-03,Senate,"Constitutional reading dispensed (on 3rd reading) (40-Y 0-N)",40,0,0,0,40
1916481,1480434,2025-02-03,Senate,"Passed Senate (40-Y 0-N)",40,0,0,0,40
1916481,1485941,2025-02-11,House,"Reported from Health and Human Services (22-Y 0-N)",22,0,0,0,22
1916481,1490272,2025-02-14,House,"Passed House (96-Y 0-N)",96,0,0,4,100
1916493,1476428,2025-01-29,Senate,"Reported from Courts of Justice with amendment (15-Y 0-N)",15,0,0,0,15
1916493,1478258,2025-01-31,Senate,"Constitutional reading dispensed (on 1st reading) (39-Y 0-N)",39,0,0,1,40
1916493,1480345,2025-02-03,Senate,"Constitutional reading dispensed (on 3rd reading) (40-Y 0-N)",40,0,0,0,40
1916493,1480346,2025-02-03,Senate,"Passed Senate (40-Y 0-N)",40,0,0,0,40
1916493,1485008,2025-02-10,House,"Reported from Courts of Justice with substitute (22-Y 0-N)",22,0,0,0,22
1916493,1490009,2025-02-13,House,"Passed House with substitute (96-Y 0-N)",96,0,0,4,100
1916493,1492682,2025-02-17,Senate,"House substitute rejected by Senate (0-Y 39-N)",0,39,0,1,40
1916493,1494143,2025-02-19,Senate,"Senate acceded to request (38-Y 0-N 1-A)",38,0,1,1,40
1916493,1496483,2025-02-21,Senate,"Conference report agreed to by Senate (40-Y 0-N)",40,0,0,0,40
1916493,1503991,2025-02-21,House,"Conference report agreed to by House (94-Y 0-N)",94,0,0,6,100
1916508,1478057,2025-01-30,Senate,"Stricken at request of Patron in Education and Health (15-Y 0-N)",15,0,0,0,15
1916522,1473876,2025-01-22,Senate,"Reported from General Laws and Technology and rereferred to Finance and Appropriations (15-Y 0-N)",15,0,0,0,15
1916522,1477098,2025-01-29,Senate,"Reported from Finance and Appropriations (14-Y 0-N)",14,0,0,1,15
1916522,1477481,2025-01-30,Senate,"Constitutional reading dispensed (on 1st reading) (39-Y 0-N 1-A)",39,0,1,0,40
1916522,1479111,2025-01-31,Senate,"Constitutional reading dispensed (on 3rd reading) (40-Y 0-N)",40,0,0,0,40
1916522,1479112,2025-01-31,Senate,"Passed Senate (40-Y 0-N)",40,0,0,0,40
1916522,1489163,2025-02-13,House,"Subcommittee recommends reporting with amendment(s) (8-Y 0-N)",8,0,0,1,9
1916522,1489164,2025-02-13,House,"Reported from General Laws with amendment(s) (19-Y 0-N)",19,0,0,3,22
1916522,1493141,2025-02-18,House,"Passed House with amendments (97-Y 0-N 0-A)",95,0,0,5,100
1916522,1493881,2025-02-19,Senate,"House Amendments agreed to by Senate (40-Y 0-N)",40,0,0,0,40
1916532,1474600,2025-01-24,Senate,"Stricken at request of Patron in Commerce and Labor (15-Y 0-N)",15,0,0,0,15
1916543,1477192,2025-01-30,Senate,"Reported from Education and Health with amendments and rereferred to Finance and Appropriations (15-Y 0-N)",15,0,0,0,15
1916543,1477977,2025-01-30,Senate,"Reported from Finance and Appropriations with amendment (15-Y 0-N)",15,0,0,0,15
1916543,1480336,2025-02-03,Senate,"Constitutional reading dispensed (on 1st reading) (40-Y 0-N)",40,0,0,0,40
1916543,1482563,2025-02-04,Senate,"Constitutional reading dispensed (on 3rd reading) (39-Y 0-N)",39,0,0,1,40
1916543,1482564,2025-02-04,Senate,"Passed Senate (40-Y 0-N)",40,0,0,0,40
1916543,1486005,2025-02-11,House,"Subcommittee recommends reporting with substitute (8-Y 0-N)",8,0,0,1,9
1916543,1488666,2025-02-13,House,"Reported from Health and Human Services with substitute (22-Y 0-N)",22,0,0,0,22
1916543,1493045,2025-02-18,House,"Passed House with substitute (97-Y 0-N)",97,0,0,3,100
1916543,1494251,2025-02-19,Senate,"House substitute agreed to by Senate (40-Y 0-N)",40,0,0,0,40
1916543,1535541,2025-04-02,Senate,"Senate concurred in Governor's recommendation (40-Y 0-N)",40,0,0,0,40
1916543,1535542,2025-04-02,House,"House concurred in Governor's recommendation (96-Y 0-N)",96,0,0,4,100
1916555,1472365,2025-01-20,Senate,"Reported from Courts of Justice (15-Y 0-N)",15,0,0,0,15
1916555,1472721,2025-01-21,Senate,"Constitutional reading dispensed (on 1st reading) (40-Y 0-N)",40,0,0,0,40
1916555,1473995,2025-01-23,Senate,"Read third time and passed Senate (39-Y 0-N)",39,0,0,1,40
1916555,1484073,2025-02-07,House,"Subcommittee recommends reporting (8-Y 0-N)",8,0,0,1,9
1916555,1486007,2025-02-10,House,"Reported from Courts of Justice (22-Y 0-N)",22,0,0,0,22
1916555,1489231,2025-02-13,House,"Passed House (96-Y 0-N)",96,0,0,4,100
1916568,1473260,2025-01-22,Senate,"Stricken at request of Patron in General Laws and Technology (15-Y 0-N)",15,0,0,0,15
1916579,1472326,2025-01-20,Senate,"Incorporated by Local Government (SB1178-Hashmi) (14-Y 0-N)",14,0,0,1,15
1916589,1475375,2025-01-28,Senate,"Reported from Education and Health and rereferred to Finance and Appropriations (15-Y 0-N)",15,0,0,0,15
1916589,1477640,2025-01-30,Senate,"Reported from Finance and Appropriations (15-Y 0-N)",15,0,0,0,15
1916589,1479890,2025-02-03,Senate,"Constitutional reading dispensed (on 1st reading) (40-Y 0-N)",40,0,0,0,40
1916589,1479891,2025-02-04,Senate,"Constitutional reading dispensed (on 3rd reading) (39-Y 0-N)",39,0,0,1,40
1916589,1479892,2025-02-04,Senate,"Passed Senate (40-Y 0-N)",40,0,0,0,40
1916589,1485927,2025-02-11,House,"Reported from Health and Human Services (22-Y 0-N)",22,0,0,0,22
1916589,1490153,2025-02-14,House,"Passed House (96-Y 0-N)",96,0,0,4,100
1916960,1475242,2025-01-28,House,"Subcommittee recommends reporting (8-Y 0-N)",8,0,0,1,9
1916960,1476697,2025-01-29,House,"Reported from Education (22-Y 0-N)",22,0,0,0,22
1916960,1482782,2025-02-04,House,"Read third time and passed House (97-Y 0-N)",97,0,0,3,100
1916960,1482783,2025-02-04,House,"Passed House (99-Y 0-N)",99,0,0,1,100
1916960,1489831,2025-02-13,Senate,"Reported from Education and Health (13-Y 0-N)",13,0,0,2,15
1916960,1491364,2025-02-17,Senate,"Constitutional reading dispensed (on 2nd reading)",39,0,0,1,40
1916960,1492458,2025-02-18,Senate,"Passed Senate (40-Y 0-N)",40,0,0,0,40
1916981,1475774,2025-01-28,House,"Subcommittee recommends reporting with amendment(s) (2-Y 4-N)",2,4,0,3,9
1916981,1475775,2025-01-28,House,"Subcommittee failed to recommend reporting (3-Y 4-N)",3,4,0,2,9
1917002,1476325,2025-01-29,House,"Reported from Agriculture, Chesapeake and Natural Resources (22-Y 0-N)",22,0,0,0,22
1917002,1482332,2025-02-04,House,"Read third time and passed House (63-Y 35-N)",63,35,0,2,100
1917002,1486636,2025-02-11,Senate,"Reported from Agriculture, Conservation and Natural Resources (8-Y 7-N)",8,7,0,0,15
1917002,1490101,2025-02-13,Senate,"Constitutional reading dispensed (on 2nd reading) (40-Y 0-N)",40,0,0,0,40
1917002,1492046,2025-02-18,Senate,"Passed Senate (22-Y 18-N)",22,18,0,0,40
1917008,1473719,2025-01-23,House,"Subcommittee recommends reporting (5-Y 3-N)",5,3,0,1,9
1917008,1474350,2025-01-24,House,"Reported from Counties, Cities and Towns and referred to Appropriations (11-Y 9-N)",11,9,0,2,22
1917008,1476407,2025-01-29,House,"Subcommittee recommends reporting with amendment(s) (5-Y 3-N)",5,3,0,1,9
1917008,1476949,2025-01-29,House,"Reported from Appropriations with amendment(s) (12-Y 9-N)",12,9,0,1,22
1917008,1482363,2025-02-04,House,"Read third time and passed House (50-Y 48-N)",50,48,0,2,100
1917008,1484567,2025-02-10,Senate,"Reported from Local Government with amendment and rereferred to Finance and Appropriations (7-Y 6-N 2-A)",7,6,2,0,15
1917008,1487350,2025-02-12,Senate,"Passed by indefinitely in Finance and Appropriations (15-Y 0-N)",15,0,0,0,15
1917325,1472291,2025-01-14,Senate,"Rules suspended (37-Y 0-N)",37,0,0,1,38
1917325,1472292,2025-01-14,House,"Waive reading of report - Adoption (99-Y 0-N)",99,0,0,1,100
1917325,1472293,2025-01-14,Senate,"Agreed to by Senate (37-Y 0-N)",37,0,0,1,38
1917325,1565370,2025-01-14,House,"Agreed to by House (99-Y 0-N)",99,0,0,1,100
1917733,1477693,2025-01-30,House,"Subcommittee recommends reporting (8-Y 0-N)",8,0,0,1,9
1917733,1477694,2025-01-30,House,"Reported from General Laws (21-Y 0-N)",21,0,0,1,22
1917733,1480152,2025-02-04,House,"Read third time and passed House (97-Y 0-N)",97,0,0,3,100
1917733,1480153,2025-02-04,House,"Passed House (99-Y 0-N)",99,0,0,1,100
1917733,1488241,2025-02-12,Senate,"Reported from General Laws and Technology (15-Y 0-N)",15,0,0,0,15
1917733,1490527,2025-02-14,Senate,"Constitutional reading dispensed (on 2nd reading) (36-Y 0-N)",36,0,0,4,40
1917733,1491135,2025-02-17,Senate,"Passed Senate (39-Y 0-N)",39,0,0,1,40
1917821,1473453,2025-01-23,House,"Subcommittee recommends reporting with substitute and referring to Appropriations (4-Y 2-N)",4,2,0,1,7
1917821,1474205,2025-01-24,House,"Reported from Public Safety with substitute and referred to Appropriations (12-Y 10-N)",12,10,0,0,22
1917821,1476419,2025-01-29,House,"Subcommittee recommends reporting (5-Y 3-N)",5,3,0,1,9
1917821,1476805,2025-01-29,House,"Reported from Appropriations (14-Y 7-N)",14,7,0,1,22
1917821,1480654,2025-02-04,House,"Read third time and passed House (51-Y 46-N)",51,46,0,3,100
1917821,1483863,2025-02-07,Senate,"Reported from Rehabilitation and Social Services and rereferred to Finance and Appropriations (8-Y 6-N)",8,6,0,1,15
1917821,1487440,2025-02-12,Senate,"Reported from Finance and Appropriations (10-Y 5-N)",10,5,0,0,15
1917821,1489050,2025-02-13,Senate,"Constitutional reading dispensed (on 2nd reading) (40-Y 0-N)",40,0,0,0,40
1917821,1490294,2025-02-14,Senate,"Passed Senate (21-Y 15-N)",21,15,0,4,40
1917908,1477776,2025-01-30,House,"Subcommittee recommends reporting (5-Y 0-N)",5,0,0,1,6
1917908,1477777,2025-01-30,House,"Reported from Labor and Commerce (21-Y 0-N)",21,0,0,1,22
1917908,1480868,2025-02-04,House,"Read third time and passed House (97-Y 0-N)",97,0,0,3,100
1917908,1480869,2025-02-04,House,"Passed House (99-Y 0-N)",99,0,0,1,100
1917908,1491388,2025-02-17,Senate,"Reported from Commerce and Labor (15-Y 0-N)",15,0,0,0,15
1917908,1493388,2025-02-18,Senate,"Constitutional reading dispensed (on 2nd reading) (40-Y 0-N)",40,0,0,0,40
1917908,1495074,2025-02-19,Senate,"Passed Senate (40-Y 0-N)",40,0,0,0,40
1917938,1471555,2025-01-14,Senate,"Rules suspended (37-Y 0-N)",37,0,0,1,38
1917938,1471556,2025-01-14,Senate,"Election by Senate (37-Y 0-N)",37,0,0,1,38
1917938,1471557,2025-01-14,Senate,"Blank Action (37-Y 0-N)",37,0,1,0,38
1917997,1471560,2025-01-14,Senate,"Rules suspended (37-Y 0-N)",37,0,0,1,38
1917997,1471561,2025-01-14,Senate,"Election by Senate (37-Y 0-N)",37,0,0,1,38
1917997,1471562,2025-01-14,Senate,"Blank Action (37-Y 0-N)",37,0,1,0,38
1918055,1472765,2025-01-21,House,"Subcommittee recommends reporting (8-Y 0-N)",8,0,0,1,9
1918055,1473049,2025-01-22,House,"Reported from Finance (22-Y 0-N)",22,0,0,0,22
1918055,1476638,2025-01-28,House,"Read third time and passed House (99-Y 0-N)",99,0,0,1,100
1918055,1482597,2025-02-05,Senate,"Passed by indefinitely in Finance and Appropriations (12-Y 0-N)",12,0,0,3,15
1918083,1471558,2025-01-14,Senate,"Rules suspended (37-Y 0-N)",37,0,0,1,38
1918083,1471559,2025-01-14,Senate,"Election by Senate (37-Y 0-N)",37,0,0,1,38
1918111,1472286,2025-01-14,House,"Election of House (99-Y 0-N)",99,0,0,1,100
1918141,1472287,2025-01-14,House,"Election of House (98-Y 0-N)",98,0,0,2,100
1918173,1472289,2025-01-14,House,"Election of House (98-Y 0-N)",98,0,0,2,100
1918286,1471563,2025-01-14,Senate,"Rules suspended (37-Y 0-N)",37,0,0,1,38
1918286,1471564,2025-01-14,Senate,"Election by Senate (37-Y 0-N)",37,0,0,1,38
1918286,1471565,2025-01-14,Senate,"Blank Action (37-Y 0-N)",37,0,1,0,38
1918315,1476600,2025-01-29,House,"Reported from Education (22-Y 0-N)",22,0,0,0,22
1918315,1482607,2025-02-04,House,"Read third time and passed House (97-Y 0-N)",97,0,0,3,100
1918315,1482608,2025-02-04,House,"Passed House (99-Y 0-N)",99,0,0,1,100
1918315,1489986,2025-02-14,Senate,"Reported from Rules (15-Y 0-N)",15,0,0,0,15
1918315,1491619,2025-02-17,Senate,"Constitutional reading dispensed (on 2nd reading)",39,0,0,1,40
1918315,1493101,2025-02-18,Senate,"Passed Senate (40-Y 0-N)",40,0,0,0,40
1918373,1472288,2025-01-14,House,"Election of House (99-Y 0-N)",99,0,0,1,100
1918403,1471566,2025-01-14,Senate,"Rules suspended (37-Y 0-N)",37,0,0,1,38
1918403,1471567,2025-01-14,Senate,"Election by Senate (37-Y 0-N)",37,0,0,1,38
1918403,1471568,2025-01-14,Senate,"Blank Action (37-Y 0-N)",37,0,1,0,38
1918459,1472290,2025-01-14,House,"Election of House (97-Y 0-N)",97,0,0,3,100
1918511,1472734,2025-01-21,Senate,"Reported from Privileges and Elections (14-Y 0-N)",14,0,0,1,15
1918511,1473960,2025-01-23,Senate,"Reading waived (on 1st reading) (39-Y 0-N)",39,0,0,1,40
1918511,1475170,2025-01-27,Senate,"Read third time and agreed to by Senate (38-Y 0-N)",38,0,0,2,40
1918511,1478070,2025-01-31,House,"Reported from Privileges and Elections with amendment(s) (21-Y 0-N)",21,0,0,1,22
1918511,1565212,2025-02-07,House,"Agreed to by House (94-Y 0-N)",94,0,0,6,100
1918539,1474556,2025-01-23,Senate,"Reported from Finance and Appropriations (12-Y 0-N 2-A)",12,0,2,1,15
1918539,1474907,2025-01-27,Senate,"Constitutional reading dispensed (on 1st reading) (36-Y 0-N)",36,0,0,4,40
1918539,1476256,2025-01-29,Senate,"Read third time and passed Senate (36-Y 2-N)",36,2,0,2,40
1918539,1488329,2025-02-12,House,"Reported from Finance (20-Y 2-N)",20,2,0,0,22
1918539,1490817,2025-02-17,House,"Passed House (87-Y 7-N)",87,7,0,6,100
1918554,1473878,2025-01-21,Senate,"Rereferred from Privileges and Rereferred to Elections to Education and Health (12-Y 0-N)",12,0,0,3,15
1918554,1477247,2025-01-30,Senate,"Failed to report (defeated) in Education and Health (6-Y 7-N 2-A)",6,7,2,0,15
1918568,1475733,2025-01-27,Senate,"Stricken at request of Patron in Commerce and Labor (15-Y 0-N)",15,0,0,0,15
1918583,1474105,2025-01-23,House,"Subcommittee recommends striking from the docket (10-Y 0-N)",10,0,0,1,11
1918602,1473406,2025-01-22,Senate,"Reported from General Laws and Technology with substitute (14-Y 0-N 1-A)",14,0,1,0,15
1918602,1474588,2025-01-24,Senate,"Constitutional reading dispensed (on 1st reading) (37-Y 0-N)",37,0,0,3,40
1918602,1476798,2025-01-28,Senate,"Read third time and passed Senate (38-Y 1-N)",38,1,0,1,40
1918602,1486820,2025-02-11,House,"Subcommittee recommends reporting (10-Y 0-N)",10,0,0,1,11
1918602,1489448,2025-02-13,House,"Reported from Labor and Commerce (22-Y 0-N)",22,0,0,0,22
1918602,1492099,2025-02-18,House,"Passed House (97-Y 0-N)",97,0,0,3,100
1918616,1475146,2025-01-27,Senate,"Reported from Commerce and Labor with substitute (13-Y 1-N 1-A)",13,1,1,0,15
1918616,1476195,2025-01-29,Senate,"Constitutional reading dispensed (on 1st reading) (38-Y 0-N)",38,0,0,2,40
1918616,1478595,2025-01-31,Senate,"Read third time and passed Senate (40-Y 0-N)",40,0,0,0,40
1918616,1489452,2025-02-13,House,"Reported from Labor and Commerce with substitute (15-Y 7-N)",15,7,0,0,22
1918616,1492120,2025-02-18,House,"Passed House with substitute (55-Y 42-N)",55,42,0,3,100
1918616,1495907,2025-02-19,Senate,"House substitute agreed to by Senate (39-Y 0-N)",39,0,0,1,40
1918646,1474747,2025-01-27,Senate,"Passed by indefinitely in Courts of Justice (8-Y 6-N)",8,6,0,1,15
1918709,1472880,2025-01-21,Senate,"Reported from Privileges and Elections (15-Y 0-N)",15,0,0,0,15
1918709,1473739,2025-01-23,Senate,"Reading waived (on 1st reading) (39-Y 0-N)",39,0,0,1,40
1918709,1474848,2025-01-27,Senate,"Read third time and agreed to by Senate (38-Y 0-N)",38,0,0,2,40
1918709,1478076,2025-01-31,House,"Reported from Privileges and Elections (21-Y 0-N)",21,0,0,1,22
1918709,1484035,2025-02-07,House,"Agreed to by House (94-Y 0-N)",94,0,0,6,100
1918739,1476059,2025-01-28,House,"Subcommittee recommends striking from the docket (8-Y 0-N)",8,0,0,1,9
1918754,1473391,2025-01-22,Senate,"Rereferred from General Laws and Technology to Rehabilitation and Social Services (14-Y 0-N)",14,0,0,1,15
1918754,1478307,2025-01-31,Senate,"Reported from Rehabilitation and Social Services (15-Y 0-N)",15,0,0,0,15
1918754,1480342,2025-02-03,Senate,"Constitutional reading dispensed (on 1st reading) (40-Y 0-N)",40,0,0,0,40
1918754,1482580,2025-02-04,Senate,"Constitutional reading dispensed (on 3rd reading) (39-Y 0-N)",39,0,0,1,40
1918754,1482581,2025-02-04,Senate,"Passed Senate (40-Y 0-N)",40,0,0,0,40
1918754,1486809,2025-02-11,House,"Reported from General Laws (19-Y 0-N)",19,0,0,3,22
1918754,1490502,2025-02-14,House,"Passed House (96-Y 0-N)",96,0,0,4,100
1918769,1472727,2025-01-21,Senate,"Passed by indefinitely in Privileges and Elections (8-Y 7-N)",8,7,0,0,15
1918769,1473935,2025-01-17,Senate,"Rereferred from Rehabilitation and Social Services to Privileges and Elections (14-Y 0-N)",14,0,0,1,15
1918789,1473377,2025-01-22,Senate,"Passed by indefinitely in Courts of Justice (8-Y 7-N)",8,7,0,0,15
1918804,1474552,2025-01-24,Senate,"Incorporated by Commerce and Labor (SB917-Surovell) (15-Y 0-N)",15,0,0,0,15
1918818,1476519,2025-01-29,Senate,"Passed by indefinitely in General Laws and Technology with letter (9-Y 3-N 3-A)",9,3,3,0,15
1918832,1474528,2025-01-24,House,"Subcommittee recommends reporting (8-Y 0-N)",8,0,0,1,9
1918832,1477010,2025-01-29,House,"Reported from Courts of Justice (22-Y 0-N)",22,0,0,0,22
1918832,1482194,2025-02-04,House,"Read third time and passed House (97-Y 0-N)",97,0,0,3,100
1918832,1482195,2025-02-04,House,"Passed House (99-Y 0-N)",99,0,0,1,100
1918832,1488585,2025-02-12,Senate,"Reported from Courts of Justice (15-Y 0-N)",15,0,0,0,15
1918832,1490491,2025-02-14,Senate,"Constitutional reading dispensed (on 2nd reading) (36-Y 0-N)",36,0,0,4,40
1918832,1491248,2025-02-17,Senate,"Passed Senate (39-Y 0-N)",39,0,0,1,40
1918848,1475271,2025-01-28,House,"Subcommittee recommends reporting (8-Y 0-N)",8,0,0,1,9
1918848,1477259,2025-01-30,House,"Reported from Health and Human Services (21-Y 0-N)",21,0,0,1,22
1918848,1480698,2025-02-04,House,"Read third time and passed House (97-Y 0-N)",97,0,0,3,100
1918848,1480699,2025-02-04,House,"Passed House (99-Y 0-N)",99,0,0,1,100
1918848,1489565,2025-02-13,Senate,"Reported from Education and Health (15-Y 0-N)",15,0,0,0,15
1918848,1490992,2025-02-17,Senate,"Constitutional reading dispensed (on 2nd reading)",39,0,0,1,40
1918848,1492281,2025-02-18,Senate,"Passed Senate (40-Y 0-N)",40,0,0,0,40
1918897,1474924,2025-01-27,Senate,"Reading waived (on 1st reading) (38-Y 0-N)",38,0,0,2,40
1918897,1490789,2025-02-17,House,"Reported from Rules (18-Y 0-N)",18,0,0,0,18
1918897,1495652,2025-02-20,House,"Agreed to by House (97-Y 0-N)",97,0,0,3,100
1918911,1473889,2025-01-21,Senate,"Passed by indefinitely in Privileges and Elections (8-Y 7-N)",8,7,0,0,15
1918925,1473522,2025-01-23,Senate,"Reported from Education and Health with substitute (15-Y 0-N)",15,0,0,0,15
1918925,1474608,2025-01-24,Senate,"Constitutional reading dispensed (on 1st reading) (37-Y 0-N)",37,0,0,3,40
1918925,1476161,2025-01-28,Senate,"Read third time and passed Senate (39-Y 0-N)",39,0,0,1,40
1918925,1485913,2025-02-11,House,"Reported from Health and Human Services with substitute (22-Y 0-N)",22,0,0,0,22
1918925,1490169,2025-02-14,House,"Passed House with substitute (96-Y 0-N)",96,0,0,4,100
1918925,1492218,2025-02-18,Senate,"House substitute agreed to by Senate (40-Y 0-N)",40,0,0,0,40
1918925,1535330,2025-04-02,House,"House concurred in Governor's recommendation (96-Y 0-N)",96,0,0,4,100
1918925,1536495,2025-04-02,Senate,"Senate concurred in Governor's recommendation (40-Y 0-N)",40,0,0,0,40
1918941,1472782,2025-01-21,Senate,"Reported from Privileges and Elections with amendments (14-Y 0-N)",14,0,0,1,15
1918941,1474469,2025-01-23,Senate,"Reading waived (on 1st reading) (39-Y 0-N)",39,0,0,1,40
1918941,1475009,2025-01-27,Senate,"Read third time and agreed to by Senate (38-Y 0-N)",38,0,0,2,40
1918941,1478117,2025-01-31,House,"Reported from Privileges and Elections with amendment(s) (21-Y 0-N)",21,0,0,1,22
1918941,1484036,2025-02-07,House,"VOTE: lines 469 and 470 [Daniel Cortez] - Rejected (22-Y 68-N)",22,68,0,10,100
1918941,1565204,2025-02-07,House,"Agreed to by House except lines 469 and 470 (94-Y 0-N)",94,0,0,6,100
1918955,1479127,2025-02-03,Senate,"Reported from Courts of Justice with substitute (15-Y 0-N)",15,0,0,0,15
1918955,1480125,2025-02-04,Senate,"Constitutional reading dispensed (on 1st reading) (40-Y 0-N)",40,0,0,0,40
1918955,1480126,2025-02-04,Senate,"Constitutional reading dispensed (on 3rd reading) (40-Y 0-N)",40,0,0,0,40
1918955,1480127,2025-02-04,Senate,"Passed Senate (40-Y 0-N)",40,0,0,0,40
1918955,1485195,2025-02-10,House,"Subcommittee recommends reporting with substitute (8-Y 0-N)",8,0,0,1,9
1918955,1490054,2025-02-14,House,"Reported from Courts of Justice with substitute (21-Y 0-N)",21,0,0,1,22
1918955,1493426,2025-02-19,House,"Passed House with substitute (83-Y 14-N)",83,14,0,3,100
1918955,1495092,2025-02-20,Senate,"House substitute rejected by Senate (0-Y 39-N)",0,39,0,1,40
1918955,1495752,2025-02-20,Senate,"Senate acceded to request (38-Y 0-N)",38,0,0,2,40
1918974,1472540,2025-01-21,Senate,"Passed by indefinitely in Finance and Appropriations (15-Y 0-N)",15,0,0,0,15
1919018,1475267,2025-01-27,Senate,"Passed by indefinitely in Courts of Justice (8-Y 6-N)",8,6,0,1,15
1919046,1472819,2025-01-21,Senate,"Reported from Privileges and Elections with amendments (14-Y 0-N 1-A)",14,0,1,0,15
1919046,1473602,2025-01-23,Senate,"Reading waived (on 1st reading) (39-Y 0-N)",39,0,0,1,40
1919046,1475925,2025-01-27,Senate,"Read third time and agreed to by Senate (38-Y 0-N)",38,0,0,2,40
1919046,1478171,2025-01-31,House,"Reported from Privileges and Elections with amendment(s) (21-Y 0-N)",21,0,0,1,22
1919046,1484026,2025-02-07,House,"VOTE: lines 279 and 280 [Lionell Spruill] - Rejected (46-Y 48-N)",46,48,0,6,100
1919046,1484027,2025-02-07,House,"VOTE: lines 282 and 283 [Brian Campbell] - Rejected (44-Y 48-N)",44,48,0,8,100
1919046,1484028,2025-02-07,House,"VOTE: lines 284 and 285 [Stanley Goldfarb] - Rejected (46-Y 48-N)",46,48,0,6,100
1919046,1484029,2025-02-07,House,"Agreed to by House except lines 279 and 280; 282 and 283; and 284 and 285 (93-Y 0-N 1-A)",93,0,1,6,100
1919304,1478346,2025-01-31,House,"Subcommittee recommends laying on the table (5-Y 3-N)",5,3,0,1,9
1919314,1476190,2025-01-29,House,"Subcommittee recommends striking from the docket (9-Y 1-N)",9,1,0,1,11
1919323,1472770,2025-01-21,House,"Subcommittee recommends reporting (8-Y 0-N)",8,0,0,1,9
1919323,1473032,2025-01-22,House,"Reported from Finance (22-Y 0-N)",22,0,0,0,22
1919323,1476380,2025-01-28,House,"Read third time and passed House (99-Y 0-N)",99,0,0,1,100
1919323,1486047,2025-02-11,Senate,"Reported from Finance and Appropriations (15-Y 0-N)",15,0,0,0,15
1919323,1486048,2025-02-11,Senate,"Constitutional reading dispensed (on 2nd reading) (40-Y 0-N)",40,0,0,0,40
1919323,1488182,2025-02-12,Senate,"Passed Senate (39-Y 0-N)",39,0,0,1,40
1919335,1477158,2025-01-30,House,"Subcommittee recommends reporting with amendment(s) (8-Y 0-N)",8,0,0,1,9
1919335,1478427,2025-01-31,House,"Reported from Counties, Cities and Towns with amendment(s) (21-Y 1-N)",21,1,0,0,22
1919335,1482251,2025-02-04,House,"Read third time and passed House (97-Y 1-N)",97,1,0,2,100
1919335,1484856,2025-02-10,Senate,"Reported from Local Government (15-Y 0-N)",15,0,0,0,15
1919335,1486316,2025-02-11,Senate,"Constitutional reading dispensed (on 2nd reading) (40-Y 0-N)",40,0,0,0,40
1919335,1488317,2025-02-12,Senate,"Passed Senate (39-Y 0-N)",39,0,0,1,40
1919481,1476427,2025-01-29,House,"Subcommittee recommends reporting (8-Y 0-N)",8,0,0,1,9
1919481,1478371,2025-01-31,House,"Reported from Counties, Cities and Towns (22-Y 0-N)",22,0,0,0,22
1919481,1482638,2025-02-04,House,"Read third time and passed House (97-Y 0-N)",97,0,0,3,100
1919481,1482639,2025-02-04,House,"Passed House (99-Y 0-N)",99,0,0,1,100
1919481,1484561,2025-02-10,Senate,"Reported from Local Government (15-Y 0-N)",15,0,0,0,15
1919481,1486141,2025-02-11,Senate,"Constitutional reading dispensed (on 2nd reading) (40-Y 0-N)",40,0,0,0,40
1919481,1488833,2025-02-12,Senate,"Passed Senate (39-Y 0-N)",39,0,0,1,40
1919630,1475420,2025-01-27,House,"Subcommittee recommends reporting with substitute and referring to Appropriations (6-Y 2-N)",6,2,0,1,9
1919630,1476946,2025-01-29,House,"Reported from Courts of Justice with substitute (18-Y 4-N)",18,4,0,0,22
1919630,1482688,2025-02-04,House,"Read third time and passed House Passage (98-Y 1-N)",98,1,0,1,100
1919630,1485390,2025-02-10,Senate,"Reported from Courts of Justice with substitute and rereferred to Finance and Appropriations (15-Y 0-N)",15,0,0,0,15
1919630,1488193,2025-02-12,Senate,"Reported from Finance and Appropriations (14-Y 1-N)",14,1,0,0,15
1919630,1489578,2025-02-13,Senate,"Constitutional reading dispensed (on 2nd reading) (40-Y 0-N)",40,0,0,0,40
1919630,1494311,2025-02-18,Senate,"Passed Senate with substitute (39-Y 1-N)",39,1,0,0,40
1919630,1494312,2025-02-19,House,"Senate substitute rejected by House (46-Y 51-N)",46,51,0,3,100
1919630,1496841,2025-02-20,Senate,"Senate insisted on substitute (39-Y 0-N)",39,0,0,1,40
1919630,1496842,2025-02-21,Senate,"Conference report agreed to by Senate (35-Y 4-N)",35,4,0,1,40
1919630,1504009,2025-02-21,House,"Conference report agreed to by House (93-Y 1-N)",93,1,0,6,100
1919630,1535538,2025-04-02,House,"VOTE: Pass by for the day - Adoption (47-Y 46-N)",47,46,0,7,100
1919780,1477134,2025-01-30,House,"Reported from Transportation with amendment(s) (20-Y 2-N)",20,2,0,0,22
1919780,1482382,2025-02-04,House,"Read third time and passed House (97-Y 0-N)",97,0,0,3,100
1919780,1489608,2025-02-13,Senate,"Reported from Transportation with substitute (15-Y 0-N)",15,0,0,0,15
1919780,1491039,2025-02-17,Senate,"Constitutional reading dispensed (on 2nd reading)",39,0,0,1,40
1919780,1492320,2025-02-18,Senate,"Passed Senate with substitute (40-Y 0-N)",40,0,0,0,40
1919780,1493756,2025-02-19,House,"Senate substitute agreed to by House (97-Y 0-N)",97,0,0,3,100
1919993,1472940,2025-01-22,Senate,"Reported from Finance and Appropriations with substitute (10-Y 4-N)",10,4,0,1,15
1919993,1473721,2025-01-17,Senate,"Reported from Rehabilitation and Social Services and rereferred to Finance and Appropriations (8-Y 7-N)",8,7,0,0,15
1919993,1473722,2025-01-23,Senate,"Constitutional reading dispensed (on 1st reading) (39-Y 0-N)",39,0,0,1,40
1919993,1476556,2025-01-28,Senate,"Read third time and passed Senate (21-Y 18-N)",21,18,0,1,40
1919993,1483953,2025-02-07,House,"Reported from Public Safety (11-Y 10-N)",11,10,0,1,22
1919993,1487848,2025-02-12,House,"Passed House (50-Y 47-N)",50,47,0,3,100
1920032,1475297,2025-01-28,House,"Subcommittee recommends laying on the table (8-Y 0-N)",8,0,0,1,9
1920057,1471688,2025-01-15,Senate,"Rules suspended (38-Y 0-N)",38,0,0,0,38
1920078,1475185,2025-01-27,House,"Subcommittee recommends reporting with substitute (5-Y 2-N 1-A)",5,2,1,1,9
1920078,1478077,2025-01-31,House,"Reported from Privileges and Elections with substitute (18-Y 3-N)",18,3,0,1,22
1920078,1482757,2025-02-04,House,"Read third time and passed House (77-Y 21-N)",77,21,0,2,100
1920078,1486838,2025-02-11,Senate,"Reported from Privileges and Elections (8-Y 7-N)",8,7,0,0,15
1920078,1489071,2025-02-13,Senate,"Constitutional reading dispensed (on 2nd reading) (40-Y 0-N)",40,0,0,0,40
1920078,1490718,2025-02-14,Senate,"Passed Senate (21-Y 15-N)",21,15,0,4,40
1920103,1474661,2025-01-27,House,"Subcommittee recommends striking from the docket (10-Y 0-N)",10,0,0,1,11
1920129,1474211,2025-01-24,House,"Reported from Privileges and Elections with substitute and referred to Appropriations (21-Y 0-N)",21,0,0,1,22
1920178,1478689,2025-02-03,Senate,"Reported from Courts of Justice with substitute (13-Y 1-N)",13,1,0,1,15
1920178,1480328,2025-02-04,Senate,"Constitutional reading dispensed (on 1st reading) (40-Y 0-N)",40,0,0,0,40
1920178,1480329,2025-02-04,Senate,"Constitutional reading dispensed (on 3rd reading) (40-Y 0-N)",40,0,0,0,40
1920178,1480330,2025-02-04,Senate,"Passed Senate (40-Y 0-N)",40,0,0,0,40
1920178,1485465,2025-02-10,House,"Subcommittee recommends reporting with amendment(s) (8-Y 0-N)",8,0,0,1,9
1920178,1490623,2025-02-14,House,"Reported from Courts of Justice with amendment(s) (21-Y 0-N)",21,0,0,1,22
1920178,1494226,2025-02-19,House,"Passed House with amendments (97-Y 0-N)",97,0,0,3,100
1920178,1495601,2025-02-20,Senate,"House Amendments agreed to by Senate (39-Y 0-N)",39,0,0,1,40
1920229,1474752,2025-01-27,House,"Subcommittee recommends laying on the table (5-Y 3-N)",5,3,0,1,9
1920257,1473554,2025-01-23,Senate,"Reported from Education and Health with amendment (9-Y 6-N)",9,6,0,0,15
1920257,1474575,2025-01-24,Senate,"Constitutional reading dispensed (on 1st reading) (37-Y 0-N)",37,0,0,3,40
1920257,1476634,2025-01-28,Senate,"Read third time and passed Senate (21-Y 18-N)",21,18,0,1,40
1920257,1487355,2025-02-12,House,"Reported from Education with substitute (16-Y 5-N)",16,5,0,1,22
1920257,1490946,2025-02-17,House,"Passed House with substitute (59-Y 37-N)",59,37,0,4,100
1920257,1492163,2025-02-18,Senate,"House substitute rejected by Senate (19-Y 21-N)",19,21,0,0,40
1920257,1492164,2025-02-18,Senate,"House substitute agreed to by Senate (22-Y 18-N)",22,18,0,0,40
1920257,1535332,2025-04-02,House,"House concurred in Governor's recommendation (80-Y 16-N)",80,16,0,4,100
1920257,1536517,2025-04-02,Senate,"Senate concurred in Governor's recommendation (37-Y 2-N)",37,2,0,1,40
1920257,1564895,2025-02-18,Senate,"Reconsideration of (40-Y 0-N)",40,0,0,0,40
1920282,1473378,2025-01-22,Senate,"Reported from General Laws and Technology (15-Y 0-N)",15,0,0,0,15
1920282,1474436,2025-01-24,Senate,"Constitutional reading dispensed (on 1st reading) (37-Y 0-N)",37,0,0,3,40
1920282,1476153,2025-01-28,Senate,"Read third time and passed Senate (39-Y 0-N)",39,0,0,1,40
1920282,1486657,2025-02-11,House,"Subcommittee recommends reporting (5-Y 2-N)",5,2,0,2,9
1920282,1489790,2025-02-13,House,"Reported from General Laws (10-Y 9-N)",10,9,0,3,22
1920282,1494013,2025-02-18,House,"Passed House (53-Y 43-N)",53,43,0,4,100
1920310,1478119,2025-01-31,House,"Reported from Finance (14-Y 6-N)",14,6,0,2,22
1920310,1482403,2025-02-04,House,"Read third time and passed House (80-Y 16-N)",80,16,0,4,100
1920310,1486010,2025-02-11,Senate,"Reported from Finance and Appropriations (14-Y 0-N)",14,0,0,1,15
1920310,1486011,2025-02-11,Senate,"Constitutional reading dispensed (on 2nd reading) (40-Y 0-N)",40,0,0,0,40
1920310,1488891,2025-02-12,Senate,"Passed Senate (39-Y 0-N)",39,0,0,1,40
1920338,1475183,2025-01-27,House,"Subcommittee recommends reporting (7-Y 1-N)",7,1,0,1,9
1920338,1478090,2025-01-31,House,"Reported from Privileges and Elections (19-Y 2-N)",19,2,0,1,22
1920389,1475985,2025-01-28,House,"Subcommittee recommends reporting with substitute (7-Y 0-N)",7,0,0,1,8
1920389,1477760,2025-01-30,House,"Reported from Labor and Commerce with substitute (19-Y 3-N)",19,3,0,0,22
1920389,1482205,2025-02-04,House,"Read third time and passed House (93-Y 5-N)",93,5,0,2,100
1920389,1491286,2025-02-17,Senate,"Reported from Commerce and Labor (15-Y 0-N)",15,0,0,0,15
1920389,1492237,2025-02-18,Senate,"Constitutional reading dispensed (on 2nd reading) (40-Y 0-N)",40,0,0,0,40
1920389,1496032,2025-02-19,Senate,"Passed Senate (40-Y 0-N)",40,0,0,0,40
1920413,1474727,2025-01-27,House,"Subcommittee recommends striking from the docket (8-Y 0-N)",8,0,0,1,9
1920437,1475228,2025-01-28,House,"Subcommittee recommends laying on the table (5-Y 3-N)",5,3,0,1,9
1920463,1474052,2025-01-23,Senate,"Rereferred from Transportation and Rereferred to Courts of Justice (12-Y 0-N)",12,0,0,3,15
1920463,1478638,2025-02-03,Senate,"Reported from Courts of Justice with substitute (13-Y 0-N)",13,0,0,2,15
1920463,1479734,2025-02-04,Senate,"Constitutional reading dispensed (on 1st reading) (40-Y 0-N)",40,0,0,0,40
1920463,1479735,2025-02-04,Senate,"Constitutional reading dispensed (on 3rd reading) (40-Y 0-N)",40,0,0,0,40
1920463,1479736,2025-02-04,Senate,"Passed Senate (40-Y 0-N)",40,0,0,0,40
1920463,1488135,2025-02-12,House,"Subcommittee recommends reporting (8-Y 0-N)",8,0,0,1,9
1920463,1490464,2025-02-14,House,"Reported from Courts of Justice (18-Y 3-N)",18,3,0,1,22
1920463,1493373,2025-02-19,House,"Passed House (75-Y 20-N)",75,20,0,5,100
1920539,1474282,2025-01-23,Senate,"Reported from Education and Health and rereferred to Finance and Appropriations (15-Y 0-N)",15,0,0,0,15
1920569,1477406,2025-01-30,House,"Subcommittee recommends reporting with amendment(s) (8-Y 0-N)",8,0,0,1,9
1920569,1477697,2025-01-30,House,"Reported from General Laws with amendment(s) (18-Y 2-N 1-A)",18,2,1,1,22
1920569,1482192,2025-02-04,House,"Read third time and passed House (83-Y 14-N)",83,14,0,3,100
1920569,1488566,2025-02-12,Senate,"Reported from General Laws and Technology (15-Y 0-N)",15,0,0,0,15
1920569,1490045,2025-02-14,Senate,"Constitutional reading dispensed (on 2nd reading) (36-Y 0-N)",36,0,0,4,40
1920569,1492795,2025-02-17,Senate,"Passed Senate (39-Y 0-N)",39,0,0,1,40
1920622,1474290,2025-01-24,House,"Reported from Counties, Cities and Towns (20-Y 0-N)",20,0,0,2,22
1920622,1478342,2025-01-30,House,"Read third time and passed House (96-Y 0-N)",96,0,0,4,100
1920622,1485061,2025-02-10,Senate,"Reported from Local Government (15-Y 0-N)",15,0,0,0,15
1920622,1486473,2025-02-11,Senate,"Constitutional reading dispensed (on 2nd reading) (40-Y 0-N)",40,0,0,0,40
1920622,1487789,2025-02-12,Senate,"Passed Senate (39-Y 0-N)",39,0,0,1,40
1920647,1474933,2025-01-27,Senate,"Reading waived (on 1st reading) (38-Y 0-N)",38,0,0,2,40
1920647,1490784,2025-02-17,House,"Reported from Rules (18-Y 0-N)",18,0,0,0,18
1920647,1497181,2025-02-20,House,"Agreed to by House (97-Y 0-N)",97,0,0,3,100
1920698,1473635,2025-01-23,Senate,"Rereferred from Transportation to Courts of Justice (9-Y 0-N)",9,0,0,6,15
1920698,1478634,2025-02-03,Senate,"Reported from Courts of Justice with substitute (12-Y 3-N)",12,3,0,0,15
1920698,1479664,2025-02-04,Senate,"Constitutional reading dispensed (on 1st reading) (40-Y 0-N)",40,0,0,0,40
1920698,1479665,2025-02-04,Senate,"Constitutional reading dispensed (on 3rd reading) (40-Y 0-N)",40,0,0,0,40
1920698,1479666,2025-02-04,Senate,"Passed Senate (34-Y 6-N)",34,6,0,0,40
1920698,1488052,2025-02-12,House,"Subcommittee recommends laying on the table (5-Y 3-N)",5,3,0,1,9
1922577,1476821,2025-01-29,House,"Subcommittee recommends striking from the docket (8-Y 0-N)",8,0,0,1,9
1922645,1477409,2025-01-30,House,"Subcommittee recommends reporting with amendment(s) (8-Y 0-N)",8,0,0,1,9
1922645,1477721,2025-01-30,House,"Reported from General Laws with amendment(s) (21-Y 0-N)",21,0,0,1,22
1922645,1479739,2025-02-04,House,"Read third time and passed House (97-Y 0-N)",97,0,0,3,100
1922645,1479740,2025-02-04,House,"Passed House (99-Y 0-N)",99,0,0,1,100
1922645,1488261,2025-02-12,Senate,"Reported from General Laws and Technology (15-Y 0-N)",15,0,0,0,15
1922645,1490510,2025-02-14,Senate,"Constitutional reading dispensed (on 2nd reading) (36-Y 0-N)",36,0,0,4,40
1922645,1492490,2025-02-17,Senate,"Passed Senate (39-Y 0-N)",39,0,0,1,40
1922718,1475298,2025-01-28,House,"Subcommittee recommends reporting (8-Y 0-N)",8,0,0,1,9
1922718,1476285,2025-01-29,House,"Reported from Education (17-Y 5-N)",17,5,0,0,22
1922718,1482802,2025-02-04,House,"Read third time and passed House (86-Y 13-N)",86,13,0,1,100
1922718,1489634,2025-02-13,Senate,"Reported from Education and Health (11-Y 3-N)",11,3,0,1,15
1922718,1491244,2025-02-17,Senate,"Constitutional reading dispensed (on 2nd reading) (39-Y 0-N)",39,0,0,1,40
1922718,1495454,2025-02-19,Senate,"Passed Senate (40-Y 0-N)",40,0,0,0,40
1922787,1475974,2025-01-28,House,"Subcommittee recommends laying on the table (6-Y 4-N)",6,4,0,1,11
1922861,1476879,2025-01-29,House,"Reported from Rules (10-Y 3-N)",10,3,0,5,18
1922861,1478920,2025-02-03,House,"Agreed to by House (54-Y 43-N)",54,43,0,3,100
1922861,1493629,2025-02-19,Senate,"Reading waived (on 2nd reading) (39-Y 0-N)",39,0,0,1,40
1922861,1564969,2025-02-20,House,"Senate Amendment agreed to by House (50-Y 45-N)",50,45,0,5,100
1922931,1475860,2025-01-28,House,"Subcommittee recommends reporting with substitute (7-Y 0-N)",7,0,0,2,9
1922931,1476602,2025-01-29,House,"Reported from Finance with substitute (22-Y 0-N)",22,0,0,0,22
1922931,1480063,2025-02-04,House,"Read third time and passed House (97-Y 0-N)",97,0,0,3,100
1922931,1480064,2025-02-04,House,"Passed House (99-Y 0-N)",99,0,0,1,100
1922931,1486731,2025-02-11,Senate,"Passed by indefinitely in Finance and Appropriations (13-Y 0-N)",13,0,0,2,15
1923000,1477648,2025-01-30,House,"Subcommittee recommends laying on the table (5-Y 3-N)",5,3,0,1,9
1923073,1476111,2025-01-29,House,"Subcommittee recommends laying on the table (8-Y 0-N)",8,0,0,1,9
1923146,1475128,2025-01-27,House,"Subcommittee recommends reporting (6-Y 2-N)",6,2,0,1,9
1923146,1477021,2025-01-29,House,"Reported from Courts of Justice (12-Y 9-N)",12,9,0,1,22
1923146,1480595,2025-02-04,House,"Read third time and passed House (53-Y 46-N)",53,46,0,1,100
1923146,1488582,2025-02-12,Senate,"Reported from Courts of Justice with substitute (15-Y 0-N)",15,0,0,0,15
1923146,1490493,2025-02-14,Senate,"Constitutional reading dispensed (on 2nd reading) (36-Y 0-N)",36,0,0,4,40
1923146,1491568,2025-02-17,Senate,"Passed Senate with substitute (39-Y 0-N)",39,0,0,1,40
1923146,1492709,2025-02-18,House,"Senate substitute agreed to by House (82-Y 15-N)",82,15,0,3,100
1923217,1474709,2025-01-27,House,"Subcommittee recommends reporting (7-Y 1-N)",7,1,0,1,9
1923217,1476823,2025-01-29,House,"Reported from Finance (20-Y 2-N)",20,2,0,0,22
1923217,1482778,2025-02-04,House,"Read third time and passed House (95-Y 2-N)",95,2,0,3,100
1923217,1486526,2025-02-11,Senate,"Reported from Finance and Appropriations (15-Y 0-N)",15,0,0,0,15
1923217,1486527,2025-02-11,Senate,"Constitutional reading dispensed (on 2nd reading) (40-Y 0-N)",40,0,0,0,40
1923217,1488221,2025-02-12,Senate,"Passed Senate (39-Y 0-N)",39,0,0,1,40
1924383,1475174,2025-01-27,House,"Subcommittee recommends reporting (7-Y 0-N)",7,0,0,2,9
1924383,1476755,2025-01-29,House,"Reported from Appropriations (21-Y 0-N)",21,0,0,1,22
1924383,1482753,2025-02-04,House,"Read third time and passed House (97-Y 0-N)",97,0,0,3,100
1924383,1482754,2025-02-04,House,"Passed House (99-Y 0-N)",99,0,0,1,100
1924383,1487723,2025-02-12,Senate,"Reported from Finance and Appropriations (15-Y 0-N)",15,0,0,0,15
1924383,1490470,2025-02-13,Senate,"Constitutional reading dispensed (on 2nd reading) (40-Y 0-N)",40,0,0,0,40
1924383,1490471,2025-02-14,Senate,"Passed Senate (36-Y 0-N)",36,0,0,4,40
1924458,1472861,2025-01-21,House,"Stricken from docket by Labor and Commerce (19-Y 0-N)",19,0,0,3,22
1924497,1474441,2025-01-24,Senate,"Incorporated by Rules (SB1391-Srinivasan) (11-Y 0-N)",11,0,0,4,15
1924611,1473996,2025-01-23,House,"Subcommittee recommends laying on the table (6-Y 3-N)",6,3,0,0,9
1924649,1477392,2025-01-30,House,"Subcommittee recommends reporting (8-Y 0-N)",8,0,0,1,9
1924649,1477684,2025-01-30,House,"Reported from General Laws (21-Y 0-N)",21,0,0,1,22
1924649,1480065,2025-02-04,House,"Read third time and passed House (97-Y 0-N)",97,0,0,3,100
1924649,1480066,2025-02-04,House,"Passed House (99-Y 0-N)",99,0,0,1,100
1924649,1488230,2025-02-12,Senate,"Reported from General Laws and Technology (15-Y 0-N)",15,0,0,0,15
1924649,1490547,2025-02-14,Senate,"Constitutional reading dispensed (on 2nd reading) (36-Y 0-N)",36,0,0,4,40
1924649,1492357,2025-02-17,Senate,"Passed Senate (39-Y 0-N)",39,0,0,1,40
1924649,1536382,2025-04-02,House,"Passed by for the day (47-Y 46-N)",47,46,0,7,100
1924685,1475770,2025-01-28,House,"Subcommittee recommends laying on the table (5-Y 2-N)",5,2,0,2,9
1924724,1474412,2025-01-24,House,"Subcommittee recommends reporting (7-Y 0-N)",7,0,0,2,9
1924724,1475074,2025-01-27,House,"Reported from Appropriations (22-Y 0-N)",22,0,0,0,22
1924724,1478610,2025-01-31,House,"Read third time and passed House (96-Y 0-N)",96,0,0,4,100
1924724,1486118,2025-02-11,Senate,"Reported from Finance and Appropriations (15-Y 0-N)",15,0,0,0,15
1924724,1486119,2025-02-11,Senate,"Constitutional reading dispensed (on 2nd reading) (40-Y 0-N)",40,0,0,0,40
1924724,1488974,2025-02-12,Senate,"Passed Senate (39-Y 0-N)",39,0,0,1,40
1924761,1476324,2025-01-29,Senate,"Passed by indefinitely in Courts of Justice with letter (8-Y 7-N)",8,7,0,0,15
1924799,1475376,2025-01-28,House,"Subcommittee recommends laying on the table (8-Y 0-N)",8,0,0,1,9
1924838,1477912,2025-01-30,House,"Subcommittee recommends laying on the table (8-Y 0-N)",8,0,0,1,9
1924876,1474039,2025-01-24,House,"Subcommittee recommends laying on the table (6-Y 4-N)",6,4,0,1,11
1924989,1477246,2025-01-30,Senate,"Reported from Education and Health (15-Y 0-N)",15,0,0,0,15
1924989,1478172,2025-01-31,Senate,"Constitutional reading dispensed (on 1st reading) (39-Y 0-N)",39,0,0,1,40
1924989,1480264,2025-02-03,Senate,"Constitutional reading dispensed (on 3rd reading) (40-Y 0-N)",40,0,0,0,40
1924989,1480265,2025-02-03,Senate,"Passed Senate (40-Y 0-N)",40,0,0,0,40
1924989,1485948,2025-02-11,House,"Reported from Health and Human Services with substitute (22-Y 0-N)",22,0,0,0,22
1924989,1490262,2025-02-14,House,"Passed House with substitute (87-Y 9-N)",87,9,0,4,100
1924989,1493080,2025-02-18,Senate,"House substitute agreed to by Senate (40-Y 0-N)",40,0,0,0,40
1924989,1534653,2025-04-02,Senate,"Senate rejected Governor's recommendation (19-Y 21-N)",19,21,0,0,40
1925027,1475250,2025-01-28,House,"Subcommittee recommends reporting with substitute (8-Y 0-N)",8,0,0,1,9
1925027,1476171,2025-01-29,House,"Reported from Education with substitute (22-Y 0-N)",22,0,0,0,22
1925027,1479554,2025-02-04,House,"Read third time and passed House (97-Y 0-N)",97,0,0,3,100
1925027,1479555,2025-02-04,House,"Passed House (99-Y 0-N)",99,0,0,1,100
1925027,1489507,2025-02-13,Senate,"Reported from Education and Health with substitute (14-Y 0-N)",14,0,0,1,15
1925027,1491012,2025-02-17,Senate,"Constitutional reading dispensed (on 2nd reading)",39,0,0,1,40
1925027,1492291,2025-02-18,Senate,"Passed Senate with substitute (40-Y 0-N)",40,0,0,0,40
1925027,1493743,2025-02-19,House,"Senate substitute agreed to by House (84-Y 11-N)",84,11,0,5,100
1925064,1476386,2025-01-29,House,"Subcommittee recommends striking from the docket (8-Y 0-N)",8,0,0,1,9
1925106,1475199,2025-01-27,House,"Subcommittee recommends striking from the docket (8-Y 0-N)",8,0,0,1,9
1925143,1475121,2025-01-27,House,"Subcommittee recommends reporting (8-Y 0-N)",8,0,0,1,9
1925143,1477020,2025-01-29,House,"Reported from Courts of Justice (22-Y 0-N)",22,0,0,0,22
1925143,1480564,2025-02-04,House,"Read third time and passed House (97-Y 0-N)",97,0,0,3,100
1925143,1480565,2025-02-04,House,"Passed House (99-Y 0-N)",99,0,0,1,100
1925143,1488225,2025-02-12,Senate,"Reported from Courts of Justice (15-Y 0-N)",15,0,0,0,15
1925143,1490552,2025-02-14,Senate,"Constitutional reading dispensed (on 2nd reading) (36-Y 0-N)",36,0,0,4,40
1925143,1491120,2025-02-17,Senate,"Passed Senate (39-Y 0-N)",39,0,0,1,40
1925180,1472367,2025-01-20,Senate,"Reported from Local Government (15-Y 0-N)",15,0,0,0,15
1925180,1472697,2025-01-21,Senate,"Constitutional reading dispensed (on 1st reading) (40-Y 0-N)",40,0,0,0,40
1925180,1473817,2025-01-23,Senate,"Read third time and passed Senate (39-Y 0-N)",39,0,0,1,40
1925180,1488698,2025-02-13,House,"Subcommittee recommends reporting (8-Y 0-N)",8,0,0,1,9
1925180,1489954,2025-02-14,House,"Reported from Counties, Cities and Towns (21-Y 0-N)",21,0,0,1,22
1925180,1493245,2025-02-19,House,"Passed House (97-Y 0-N)",97,0,0,3,100
1925257,1477019,2025-01-29,House,"Reported from Rules (15-Y 0-N)",15,0,0,3,18
1925257,1480341,2025-02-03,House,"Agreed to by House (96-Y 0-N)",96,0,0,4,100
1925257,1491269,2025-02-17,Senate,"Reading waived (on 2nd reading) (39-Y 0-N)",39,0,0,1,40
1925294,1473289,2025-01-22,Senate,"Reported from General Laws and Technology with amendments (15-Y 0-N)",15,0,0,0,15
1925294,1474418,2025-01-24,Senate,"Constitutional reading dispensed (on 1st reading) (37-Y 0-N)",37,0,0,3,40
1925294,1476771,2025-01-28,Senate,"Read third time and passed Senate (39-Y 0-N)",39,0,0,1,40
1925294,1483611,2025-02-06,House,"Reported from General Laws (21-Y 0-N)",21,0,0,1,22
1925294,1486777,2025-02-11,House,"Passed House (94-Y 0-N)",94,0,0,6,100
1925408,1474531,2025-01-24,House,"Subcommittee recommends reporting with amendment(s) (5-Y 3-N)",5,3,0,1,9
1925408,1476948,2025-01-29,House,"Reported from Courts of Justice with amendment(s) (13-Y 9-N)",13,9,0,0,22
1925408,1488556,2025-02-12,Senate,"Reported from Courts of Justice with amendment (10-Y 5-N)",10,5,0,0,15
1925408,1490472,2025-02-14,Senate,"Constitutional reading dispensed (on 2nd reading) (36-Y 0-N)",36,0,0,4,40
1925408,1492043,2025-02-18,Senate,"Passed Senate with amendment (22-Y 18-N)",22,18,0,0,40
1925408,1534637,2025-04-02,Senate,"Senate concurred in Governor's recommendation (27-Y 12-N)",27,12,0,1,40
1925408,1536399,2025-04-02,House,"House concurred in Governor's recommendation (72-Y 23-N)",72,23,0,5,100
1925408,1565028,2025-02-04,House,"Read third time and passed House (51-Y 48-N)",51,48,0,1,100
1925408,1565029,2025-02-19,House,"Senate Amendment agreed to by House (51-Y 46-N)",51,46,0,3,100
1925485,1474399,2025-01-24,Senate,"Passed by indefinitely in General Laws and Technology with letter (15-Y 0-N)",15,0,0,0,15
1925522,1477411,2025-01-29,Senate,"Reported from General Laws and Technology with substitute and rereferred to Finance and Appropriations (9-Y 6-N)",9,6,0,0,15
1925635,1475773,2025-01-28,Senate,"Passed by indefinitely in Finance and Appropriations (10-Y 4-N)",10,4,0,1,15
1925674,1473020,2025-01-22,House,"Subcommittee recommends laying on the table (5-Y 2-N)",5,2,0,2,9
1925711,1476920,2025-01-29,Senate,"Reported from Courts of Justice (15-Y 0-N)",15,0,0,0,15
1925711,1478284,2025-01-31,Senate,"Constitutional reading dispensed (on 1st reading) (39-Y 0-N)",39,0,0,1,40
1925711,1480356,2025-02-03,Senate,"Constitutional reading dispensed (on 3rd reading) (40-Y 0-N)",40,0,0,0,40
1925711,1480357,2025-02-03,Senate,"Passed Senate (40-Y 0-N)",40,0,0,0,40
1925711,1485458,2025-02-10,House,"Subcommittee recommends reporting (7-Y 1-N)",7,1,0,1,9
1925711,1490595,2025-02-14,House,"Reported from Courts of Justice with substitute (21-Y 0-N)",21,0,0,1,22
1925711,1495103,2025-02-20,Senate,"House substitute agreed to by Senate (39-Y 0-N)",39,0,0,1,40
1925711,1565438,2025-02-19,House,"Passed House with substitute (90-Y 5-N)",90,5,0,5,100
1925749,1477001,2025-01-29,House,"Reported from Rules (15-Y 0-N)",15,0,0,3,18
1925749,1478960,2025-02-03,House,"Agreed to by House (96-Y 0-N)",96,0,0,4,100
1925749,1491265,2025-02-17,Senate,"Reading waived (on 2nd reading) (39-Y 0-N)",39,0,0,1,40
1926626,1474351,2025-01-24,House,"Subcommittee recommends reporting with amendment(s) (8-Y 0-N)",8,0,0,1,9
1926626,1477008,2025-01-29,House,"Reported from Courts of Justice with amendment(s) (22-Y 0-N)",22,0,0,0,22
1926626,1482768,2025-02-04,House,"Read third time and passed House (97-Y 0-N)",97,0,0,3,100
1926626,1482769,2025-02-04,House,"Passed House (99-Y 0-N)",99,0,0,1,100
1926626,1490827,2025-02-17,Senate,"Reported from Courts of Justice (15-Y 0-N)",15,0,0,0,15
1926626,1492744,2025-02-18,Senate,"Constitutional reading dispensed (on 2nd reading) (39-Y 0-N)",39,0,0,1,40
1926626,1495595,2025-02-19,Senate,"Passed Senate (40-Y 0-N)",40,0,0,0,40
1926717,1476334,2025-01-29,House,"Tabled in Agriculture, Chesapeake and Natural Resources (22-Y 0-N)",22,0,0,0,22
1926808,1475997,2025-01-28,House,"Subcommittee recommends reporting (9-Y 0-N 1-A)",9,0,1,1,11
1926808,1477743,2025-01-30,House,"Reported from Labor and Commerce with substitute (17-Y 4-N 1-A)",17,4,1,0,22
1926808,1482474,2025-02-04,House,"Read third time and passed House (83-Y 14-N)",83,14,0,3,100
1926808,1491405,2025-02-17,Senate,"Reported from Commerce and Labor with amendments (15-Y 0-N)",15,0,0,0,15
1926808,1493402,2025-02-18,Senate,"Constitutional reading dispensed (on 2nd reading) (40-Y 0-N)",40,0,0,0,40
1926808,1495054,2025-02-19,Senate,"Passed Senate with amendments (40-Y 0-N)",40,0,0,0,40
1926808,1495709,2025-02-20,Senate,"Senate insisted on amendment (39-Y 0-N)",39,0,0,1,40
1926808,1496654,2025-02-20,House,"Senate Amendments rejected by House (2-Y 96-N)",2,96,0,2,100
1926808,1496655,2025-02-21,Senate,"Conference report agreed to by Senate (39-Y 1-N)",39,1,0,0,40
1926808,1504197,2025-02-21,House,"Conference report agreed to by House (81-Y 14-N)",81,14,0,5,100
1926913,1475289,2025-01-27,House,"Subcommittee recommends reporting with substitute and referring to Appropriations (5-Y 3-N)",5,3,0,1,9
1926913,1476612,2025-01-29,House,"Reported from Courts of Justice with substitute and referred to Appropriations (18-Y 4-N)",18,4,0,0,22
1926913,1478156,2025-01-31,House,"Reported from Appropriations (17-Y 5-N)",17,5,0,0,22
1926913,1482393,2025-02-04,House,"Read third time and passed House (59-Y 39-N)",59,39,0,2,100
1926913,1490738,2025-02-17,Senate,"Reported from Courts of Justice with substitute and rereferred to Finance and Appropriations (11-Y 3-N 1-A)",11,3,1,0,15
1926913,1491839,2025-02-17,Senate,"Reported from Finance and Appropriations (11-Y 3-N)",11,3,0,1,15
1926913,1494948,2025-02-20,Senate,"Passed Senate with substitute (28-Y 11-N)",28,11,0,1,40
1926913,1495575,2025-02-19,Senate,"Constitutional reading dispensed (on 2nd reading) (40-Y 0-N)",40,0,0,0,40
1926913,1495576,2025-02-20,House,"Senate substitute agreed to by House (71-Y 24-N)",71,24,0,5,100
1926913,1536878,2025-04-02,House,"Passed by for the day (47-Y 46-N)",47,46,0,7,100
1926923,1475236,2025-01-27,House,"Subcommittee recommends reporting with substitute and referring to Appropriations (7-Y 1-N)",7,1,0,1,9
1926923,1476679,2025-01-29,House,"Reported from Courts of Justice with substitute and referred to Appropriations (14-Y 8-N)",14,8,0,0,22
1926923,1478176,2025-01-31,House,"Reported from Appropriations (15-Y 7-N)",15,7,0,0,22
1926923,1482505,2025-02-04,House,"Read third time and passed House (89-Y 7-N)",89,7,0,4,100
1926923,1484642,2025-02-10,Senate,"Reported from Courts of Justice with substitute and rereferred to Finance and Appropriations (10-Y 5-N)",10,5,0,0,15
1926923,1490152,2025-02-14,Senate,"Reported from Finance and Appropriations with substitute (10-Y 4-N)",10,4,0,1,15
1926923,1491022,2025-02-17,Senate,"Constitutional reading dispensed (on 2nd reading) (39-Y 0-N)",39,0,0,1,40
1926923,1493705,2025-02-19,Senate,"Passed Senate with substitute (23-Y 16-N)",23,16,0,1,40
1926923,1496844,2025-02-20,House,"Senate substitute rejected by House (0-Y 97-N)",0,97,0,3,100
1926923,1496845,2025-02-20,Senate,"Senate insisted on substitute (39-Y 0-N)",39,0,0,1,40
1926923,1497163,2025-02-22,House,"Conference report agreed to by House (98-Y 0-N)",98,0,0,2,100
1926923,1503943,2025-02-22,Senate,"Conference report agreed to by Senate (28-Y 12-N)",28,12,0,0,40
1926923,1535504,2025-04-02,Senate,"Senate concurred in Governor's recommendation (40-Y 0-N)",40,0,0,0,40
1926923,1536699,2025-04-02,House,"House concurred in Governor's recommendation (96-Y 0-N)",96,0,0,4,100
1926932,1477024,2025-01-29,House,"Reported from Rules (14-Y 0-N)",14,0,0,4,18
1926932,1478962,2025-02-03,House,"Agreed to by House (96-Y 0-N)",96,0,0,4,100
1926932,1491635,2025-02-17,Senate,"Reading waived (on 2nd reading) (39-Y 0-N)",39,0,0,1,40
1926940,1476652,2025-01-29,House,"Subcommittee recommends reporting (8-Y 0-N)",8,0,0,1,9
1926940,1477191,2025-01-30,House,"Reported from Transportation (22-Y 0-N)",22,0,0,0,22
1926940,1482766,2025-02-04,House,"Read third time and passed House (97-Y 0-N)",97,0,0,3,100
1926940,1482767,2025-02-04,House,"Passed House (99-Y 0-N)",99,0,0,1,100
1926940,1489874,2025-02-13,Senate,"Reported from Transportation with amendment (14-Y 1-N)",14,1,0,0,15
1926940,1491555,2025-02-17,Senate,"Constitutional reading dispensed (on 2nd reading) (39-Y 0-N)",39,0,0,1,40
1926940,1495134,2025-02-19,Senate,"Passed Senate with amendment (36-Y 4-N)",36,4,0,0,40
1926940,1496429,2025-02-20,House,"Senate Amendment agreed to by House (95-Y 2-N)",95,2,0,3,100
1926940,1535524,2025-04-02,House,"House concurred in Governor's recommendation (95-Y 0-N)",95,0,0,5,100
1926940,1535525,2025-04-02,Senate,"Senate concurred in Governor's recommendation (34-Y 5-N)",34,5,0,1,40
1926950,1474241,2025-01-24,House,"Subcommittee recommends reporting with substitute and referring to Appropriations (8-Y 0-N)",8,0,0,1,9
1926950,1476957,2025-01-29,House,"Reported from Courts of Justice with substitute and referred to Appropriations (21-Y 0-N)",21,0,0,1,22
1926950,1478505,2025-01-31,House,"Reported from Appropriations (22-Y 0-N)",22,0,0,0,22
1926950,1479813,2025-02-04,House,"Read third time and passed House (97-Y 0-N)",97,0,0,3,100
1926950,1479814,2025-02-04,House,"Passed House (99-Y 0-N)",99,0,0,1,100
1926950,1485862,2025-02-10,Senate,"Reported from Courts of Justice with substitute and rereferred to Finance and Appropriations (14-Y 1-N)",14,1,0,0,15
1926950,1490611,2025-02-14,Senate,"Reported from Finance and Appropriations (14-Y 0-N)",14,0,0,1,15
1926950,1491652,2025-02-17,Senate,"Constitutional reading dispensed (on 2nd reading) (39-Y 0-N)",39,0,0,1,40
1926950,1494265,2025-02-19,Senate,"Passed Senate with substitute (40-Y 0-N)",40,0,0,0,40
1926950,1496687,2025-02-20,House,"Senate substitute rejected by House (1-Y 97-N)",1,97,0,2,100
1926950,1496688,2025-02-20,House,"Senate substitute agreed to by House (87-Y 0-N)",87,0,0,13,100
1926962,1474769,2025-01-27,House,"Subcommittee recommends reporting with substitute (8-Y 0-N)",8,0,0,1,9
1926962,1476182,2025-01-29,House,"Reported from Education with substitute (21-Y 1-N)",21,1,0,0,22
1926962,1482176,2025-02-04,House,"Read third time and passed House (99-Y 0-N)",99,0,0,1,100
1926962,1489675,2025-02-13,Senate,"Reported from Education and Health and rereferred to Finance and Appropriations (9-Y 2-N 3-A)",9,2,3,1,15
1926962,1492185,2025-02-17,Senate,"Reported from Finance and Appropriations with substitute (14-Y 0-N)",14,0,0,1,15
1926962,1493654,2025-02-19,Senate,"Constitutional reading dispensed (on 2nd reading) (40-Y 0-N)",40,0,0,0,40
1926962,1495921,2025-02-20,House,"Senate substitute agreed to by House (96-Y 0-N)",96,0,0,4,100
1926962,1496350,2025-02-20,Senate,"Passed Senate with substitute (36-Y 3-N)",36,3,0,1,40
1926971,1474931,2025-01-27,House,"Subcommittee recommends laying on the table (7-Y 3-N)",7,3,0,1,11
1926989,1475767,2025-01-28,House,"Subcommittee recommends striking from the docket (7-Y 0-N)",7,0,0,2,9
1927001,1477718,2025-01-30,House,"Subcommittee recommends reporting (8-Y 0-N)",8,0,0,1,9
1927001,1477719,2025-01-30,House,"Reported from General Laws (21-Y 0-N)",21,0,0,1,22
1927001,1479947,2025-02-04,House,"Read third time and passed House (97-Y 0-N)",97,0,0,3,100
1927001,1479948,2025-02-04,House,"Passed House (99-Y 0-N)",99,0,0,1,100
1927001,1488192,2025-02-12,Senate,"Reported from General Laws and Technology and rereferred to Finance and Appropriations (15-Y 0-N)",15,0,0,0,15
1927001,1492549,2025-02-17,Senate,"Reported from Finance and Appropriations (14-Y 0-N)",14,0,0,1,15
1927001,1495114,2025-02-19,Senate,"Constitutional reading dispensed (on 2nd reading) (40-Y 0-N)",40,0,0,0,40
1927001,1495115,2025-02-20,Senate,"Passed Senate (39-Y 0-N)",39,0,0,1,40
1927001,1495116,2025-02-20,Senate,"Reconsideration of Senate passage agreed to by Senate (39-Y 0-N)",39,0,0,1,40
1927001,1495117,2025-02-20,Senate,"Passed Senate (39-Y 0-N)",39,0,0,1,40
1927011,1474647,2025-01-24,House,"Stricken from docket by Courts of Justice (22-Y 0-N)",22,0,0,0,22
1927021,1475581,2025-01-28,House,"Subcommittee recommends reporting (8-Y 0-N)",8,0,0,1,9
1927021,1477213,2025-01-30,House,"Reported from Transportation (22-Y 0-N)",22,0,0,0,22
1927021,1482966,2025-02-04,House,"Read third time and passed House (92-Y 5-N)",92,5,0,3,100
1927021,1489276,2025-02-13,Senate,"Reported from Transportation (14-Y 0-N)",14,0,0,1,15
1927021,1491310,2025-02-17,Senate,"Constitutional reading dispensed (on 2nd reading)",39,0,0,1,40
1927021,1492397,2025-02-18,Senate,"Passed Senate (40-Y 0-N)",40,0,0,0,40
1927029,1478010,2025-01-31,House,"Reported from Public Safety (21-Y 0-N)",21,0,0,1,22
1927029,1479582,2025-02-04,House,"Read third time and passed House (97-Y 0-N)",97,0,0,3,100
1927029,1479583,2025-02-04,House,"Passed House (99-Y 0-N)",99,0,0,1,100
1927029,1488089,2025-02-12,Senate,"Rereferred from General Laws and Technology to Courts of Justice (10-Y 0-N)",10,0,0,5,15
1927029,1490788,2025-02-17,Senate,"Reported from Courts of Justice (15-Y 0-N)",15,0,0,0,15
1927029,1493307,2025-02-18,Senate,"Constitutional reading dispensed (on 2nd reading) (39-Y 0-N)",39,0,0,1,40
1927029,1495680,2025-02-19,Senate,"Passed Senate (40-Y 0-N)",40,0,0,0,40
1927039,1475552,2025-01-27,House,"Subcommittee recommends reporting with amendment(s) and referring to Appropriations (8-Y 0-N)",8,0,0,1,9
1927039,1476951,2025-01-29,House,"Reported from Courts of Justice with amendment(s) and referred to Appropriations (22-Y 0-N)",22,0,0,0,22
1927039,1478519,2025-01-31,House,"Reported from Appropriations (22-Y 0-N)",22,0,0,0,22
1927039,1479674,2025-02-04,House,"Read third time and passed House (97-Y 0-N)",97,0,0,3,100
1927039,1479675,2025-02-04,House,"Passed House (99-Y 0-N)",99,0,0,1,100
1927039,1484596,2025-02-10,Senate,"Reported from Courts of Justice with substitute and rereferred to Finance and Appropriations (15-Y 0-N)",15,0,0,0,15
1927039,1490253,2025-02-14,Senate,"Reported from Finance and Appropriations (14-Y 0-N)",14,0,0,1,15
1927039,1491315,2025-02-17,Senate,"Constitutional reading dispensed (on 2nd reading) (39-Y 0-N)",39,0,0,1,40
1927039,1492402,2025-02-18,Senate,"Passed Senate with substitute (40-Y 0-N)",40,0,0,0,40
1927039,1493291,2025-02-19,House,"Senate substitute rejected by House (0-Y 97-N)",0,97,0,3,100
1927039,1494972,2025-02-20,Senate,"Senate insisted on substitute (39-Y 0-N)",39,0,0,1,40
1927039,1497187,2025-02-22,House,"Conference report agreed to by House (97-Y 0-N)",97,0,0,3,100
1927039,1503102,2025-02-22,Senate,"Conference report agreed to by Senate (40-Y 0-N)",40,0,0,0,40
1927050,1474703,2025-01-27,House,"Subcommittee recommends striking from the docket (9-Y 0-N)",9,0,0,0,9
1927071,1475843,2025-01-28,House,"Subcommittee recommends laying on the table (5-Y 3-N)",5,3,0,1,9
1927091,1476590,2025-01-29,House,"Subcommittee recommends reporting (7-Y 1-N)",7,1,0,1,9
1927091,1477384,2025-01-30,House,"Stricken from docket by Transportation (22-Y 0-N)",22,0,0,0,22
1927101,1477214,2025-01-30,House,"Subcommittee recommends laying on the table (7-Y 1-N)",7,1,0,1,9
1927108,1475243,2025-01-28,House,"Subcommittee recommends reporting with amendment(s) and referring to Appropriations (8-Y 0-N)",8,0,0,1,9
1927108,1477236,2025-01-30,House,"Reported from Health and Human Services with amendment(s) (21-Y 0-N)",21,0,0,1,22
1927108,1480668,2025-02-04,House,"Read third time and passed House (97-Y 0-N)",97,0,0,3,100
1927108,1480669,2025-02-04,House,"Passed House (99-Y 0-N)",99,0,0,1,100
1927108,1489517,2025-02-13,Senate,"Reported from Education and Health with substitute and rereferred to Finance and Appropriations (15-Y 0-N)",15,0,0,0,15
1927108,1492170,2025-02-17,Senate,"Passed by indefinitely in Finance and Appropriations (11-Y 2-N 1-A)",11,2,1,1,15
1927118,1475855,2025-01-28,House,"Subcommittee recommends reporting and referring to Appropriations (8-Y 0-N)",8,0,0,1,9
1927118,1476156,2025-01-29,House,"Reported from Education with substitute and referred to Appropriations (14-Y 8-N)",14,8,0,0,22
1927118,1476789,2025-01-29,House,"Subcommittee recommends laying on the table (4-Y 3-N)",4,3,0,2,9
1927148,1477525,2025-01-30,House,"Subcommittee recommends striking from the docket (9-Y 0-N)",9,0,0,2,11
1927157,1474358,2025-01-24,House,"Subcommittee recommends striking from the docket (8-Y 0-N)",8,0,0,1,9
1927167,1474678,2025-01-27,House,"Subcommittee recommends laying on the table (6-Y 4-N)",6,4,0,1,11
1927210,1475794,2025-01-28,House,"Subcommittee recommends laying on the table (5-Y 2-N)",5,2,0,2,9
1927261,1477011,2025-01-29,House,"Reported from Rules (13-Y 0-N)",13,0,0,5,18
1927261,1478949,2025-02-03,House,"Agreed to by House (96-Y 0-N)",96,0,0,4,100
1927261,1491262,2025-02-17,Senate,"Reading waived (on 2nd reading) (39-Y 0-N)",39,0,0,1,40
1927286,1476074,2025-01-28,House,"Subcommittee recommends laying on the table (5-Y 2-N)",5,2,0,2,9
1927336,1475760,2025-01-28,House,"Reported from Health and Human Services with substitute and referred to Appropriations (22-Y 0-N)",22,0,0,0,22
1927336,1478515,2025-01-31,House,"Reported from Appropriations (22-Y 0-N)",22,0,0,0,22
1927336,1480137,2025-02-04,House,"Read third time and passed House (97-Y 0-N)",97,0,0,3,100
1927336,1480138,2025-02-04,House,"Passed House (99-Y 0-N)",99,0,0,1,100
1927336,1488210,2025-02-12,Senate,"Reported from General Laws and Technology (15-Y 0-N)",15,0,0,0,15
1927336,1490508,2025-02-14,Senate,"Constitutional reading dispensed (on 2nd reading) (36-Y 0-N)",36,0,0,4,40
1927336,1492815,2025-02-17,Senate,"Passed Senate (39-Y 0-N)",39,0,0,1,40
1927365,1475771,2025-01-28,House,"Subcommittee recommends laying on the table (5-Y 3-N)",5,3,0,1,9
1927416,1477695,2025-01-30,House,"Subcommittee recommends reporting with substitute (7-Y 1-N)",7,1,0,1,9
1927416,1477696,2025-01-30,House,"Reported from General Laws with substitute (21-Y 0-N)",21,0,0,1,22
1927416,1479990,2025-02-04,House,"Read third time and passed House (97-Y 0-N)",97,0,0,3,100
1927416,1479991,2025-02-04,House,"Passed House (99-Y 0-N)",99,0,0,1,100
1927416,1488233,2025-02-12,Senate,"Reported from General Laws and Technology (10-Y 4-N 1-A)",10,4,1,0,15
1927416,1490545,2025-02-14,Senate,"Constitutional reading dispensed (on 2nd reading) (36-Y 0-N)",36,0,0,4,40
1927416,1492808,2025-02-18,Senate,"Passed Senate (31-Y 5-N)",31,5,0,4,40
1927495,1477800,2025-01-30,House,"Subcommittee recommends reporting with substitute (3-Y 2-N)",3,2,0,1,6
1927495,1477801,2025-01-30,House,"Reported from Labor and Commerce with substitute (12-Y 9-N)",12,9,0,1,22
1927495,1480859,2025-02-04,House,"Read third time and passed House (49-Y 48-N)",49,48,0,3,100
1927495,1491346,2025-02-17,Senate,"Failed to report (defeated) in Commerce and Labor (6-Y 8-N)",6,8,0,1,15
1927523,1476379,2025-01-29,House,"Subcommittee recommends reporting (8-Y 0-N)",8,0,0,1,9
1927523,1478066,2025-01-31,House,"Reported from Counties, Cities and Towns (22-Y 0-N)",22,0,0,0,22
1927523,1480165,2025-02-04,House,"Read third time and passed House (97-Y 0-N)",97,0,0,3,100
1927523,1480166,2025-02-04,House,"Passed House (99-Y 0-N)",99,0,0,1,100
1927523,1485041,2025-02-10,Senate,"Reported from Local Government (15-Y 0-N)",15,0,0,0,15
1927523,1486444,2025-02-11,Senate,"Constitutional reading dispensed (on 2nd reading) (40-Y 0-N)",40,0,0,0,40
1927523,1489784,2025-02-12,Senate,"Passed Senate (39-Y 0-N)",39,0,0,1,40
1927548,1475583,2025-01-28,House,"Subcommittee recommends reporting with substitute (8-Y 0-N)",8,0,0,1,9
1927548,1477238,2025-01-30,House,"Reported from Health and Human Services with substitute (21-Y 0-N)",21,0,0,1,22
1927548,1480670,2025-02-04,House,"Read third time and passed House (97-Y 0-N)",97,0,0,3,100
1927548,1480671,2025-02-04,House,"Passed House (99-Y 0-N)",99,0,0,1,100
1927548,1489429,2025-02-13,Senate,"Reported from Education and Health with substitute (15-Y 0-N)",15,0,0,0,15
1927548,1492048,2025-02-17,Senate,"Constitutional reading dispensed (on 2nd reading)",39,0,0,1,40
1927548,1492049,2025-02-18,Senate,"Passed Senate with substitute (40-Y 0-N)",40,0,0,0,40
1927548,1493540,2025-02-19,House,"Senate substitute agreed to by House (97-Y 0-N)",97,0,0,3,100
1927600,1475827,2025-01-28,House,"Subcommittee recommends laying on the table (7-Y 0-N)",7,0,0,2,9
1927652,1475991,2025-01-28,House,"Subcommittee recommends striking from the docket (10-Y 0-N)",10,0,0,1,11
1927681,1476943,2025-01-29,House,"Subcommittee recommends striking from the docket (6-Y 0-N)",6,0,0,3,9
1927705,1474297,2025-01-24,House,"Reported from Counties, Cities and Towns (11-Y 9-N)",11,9,0,2,22
1927705,1478554,2025-01-30,House,"Read third time and passed House (54-Y 40-N)",54,40,0,6,100
1927705,1484909,2025-02-10,Senate,"Reported from Local Government with amendment (8-Y 7-N)",8,7,0,0,15
1927705,1486372,2025-02-11,Senate,"Constitutional reading dispensed (on 2nd reading) (40-Y 0-N)",40,0,0,0,40
1927705,1488351,2025-02-12,Senate,"Passed Senate with amendment (21-Y 18-N)",21,18,0,1,40
1927705,1497196,2025-02-18,House,"Senate Amendment agreed to by House (53-Y 44-N)",53,44,0,3,100
1927757,1477139,2025-01-30,House,"Subcommittee recommends reporting with substitute (8-Y 0-N)",8,0,0,1,9
1927757,1478128,2025-01-31,House,"Failed to report from Counties, Cities and Towns with substitute (9-Y 13-N)",9,13,0,0,22
1927784,1475448,2025-01-28,House,"Subcommittee recommends reporting with amendment(s) (8-Y 0-N)",8,0,0,1,9
1927784,1477227,2025-01-30,House,"Reported from Health and Human Services with amendment(s) (21-Y 0-N)",21,0,0,1,22
1927784,1480609,2025-02-04,House,"Read third time and passed House (97-Y 0-N)",97,0,0,3,100
1927784,1480610,2025-02-04,House,"Passed House (99-Y 0-N)",99,0,0,1,100
1927784,1489482,2025-02-13,Senate,"Reported from Education and Health (15-Y 0-N)",15,0,0,0,15
1927784,1492117,2025-02-17,Senate,"Constitutional reading dispensed (on 2nd reading)",39,0,0,1,40
1927784,1492118,2025-02-18,Senate,"Passed Senate (40-Y 0-N)",40,0,0,0,40
1927811,1475928,2025-01-28,House,"Subcommittee recommends reporting with substitute (5-Y 2-N)",5,2,0,1,8
1927811,1477742,2025-01-30,House,"Reported from Labor and Commerce with substitute (14-Y 8-N)",14,8,0,0,22
1927811,1481556,2025-02-04,House,"Read third time and passed House (79-Y 19-N)",79,19,0,2,100
1927811,1491408,2025-02-17,Senate,"Reported from Commerce and Labor with amendments (14-Y 0-N)",14,0,0,1,15
1927811,1493430,2025-02-18,Senate,"Constitutional reading dispensed (on 2nd reading) (40-Y 0-N)",40,0,0,0,40
1927811,1495066,2025-02-19,Senate,"Passed Senate with amendments (40-Y 0-N)",40,0,0,0,40
1927811,1496686,2025-02-20,House,"Senate Amendments agreed to by House (83-Y 15-N)",83,15,0,2,100
1927835,1475593,2025-01-28,House,"Subcommittee recommends reporting with substitute (8-Y 0-N)",8,0,0,1,9
1927835,1477218,2025-01-30,House,"Reported from Health and Human Services with substitute (21-Y 0-N)",21,0,0,1,22
1927835,1480182,2025-02-04,House,"Read third time and passed House (97-Y 0-N)",97,0,0,3,100
1927835,1480183,2025-02-04,House,"Passed House (99-Y 0-N)",99,0,0,1,100
1927835,1489493,2025-02-13,Senate,"Reported from Education and Health with substitute (15-Y 0-N)",15,0,0,0,15
1927835,1492191,2025-02-17,Senate,"Constitutional reading dispensed (on 2nd reading)",39,0,0,1,40
1927835,1492192,2025-02-18,Senate,"Passed Senate with substitute (40-Y 0-N)",40,0,0,0,40
1927835,1493599,2025-02-19,House,"Senate substitute rejected by House (0-Y 97-N)",0,97,0,3,100
1927835,1495245,2025-02-20,Senate,"Senate insisted on substitute (39-Y 0-N)",39,0,0,1,40
1927835,1497145,2025-02-21,Senate,"Conference report agreed to by Senate (38-Y 0-N)",38,0,0,2,40
1927835,1535085,2025-04-02,House,"House concurred in Governor's recommendation (96-Y 0-N)",96,0,0,4,100
1927835,1535086,2025-04-02,Senate,"Senate concurred in Governor's recommendation (40-Y 0-N)",40,0,0,0,40
1927835,1564819,2025-02-21,House,"Conference report agreed to by House (94-Y 0-N)",94,0,0,6,100
1927864,1475963,2025-01-28,House,"Subcommittee recommends reporting (4-Y 3-N)",4,3,0,1,8
1927864,1477736,2025-01-30,House,"Reported from Labor and Commerce (12-Y 10-N)",12,10,0,0,22
1927864,1480847,2025-02-04,House,"Read third time and passed House (53-Y 44-N)",53,44,0,3,100
1927864,1491344,2025-02-17,Senate,"Reported from Commerce and Labor (11-Y 4-N)",11,4,0,0,15
1927864,1493321,2025-02-18,Senate,"Constitutional reading dispensed (on 2nd reading) (40-Y 0-N)",40,0,0,0,40
1927864,1495669,2025-02-19,Senate,"Passed Senate (24-Y 15-N)",24,15,0,1,40
1927890,1475762,2025-01-28,House,"Subcommittee recommends reporting with substitute (8-Y 0-N)",8,0,0,1,9
1927890,1477847,2025-01-30,House,"Reported from General Laws with substitute (21-Y 0-N)",21,0,0,1,22
1927890,1480180,2025-02-04,House,"Read third time and passed House (97-Y 0-N)",97,0,0,3,100
1927890,1480181,2025-02-04,House,"Passed House (99-Y 0-N)",99,0,0,1,100
1927890,1488497,2025-02-12,Senate,"Reported from General Laws and Technology (15-Y 0-N)",15,0,0,0,15
1927890,1490575,2025-02-14,Senate,"Constitutional reading dispensed (on 2nd reading) (36-Y 0-N)",36,0,0,4,40
1927890,1491258,2025-02-17,Senate,"Passed Senate (39-Y 0-N)",39,0,0,1,40
1927916,1475817,2025-01-28,House,"Subcommittee recommends reporting with substitute (6-Y 4-N)",6,4,0,1,11
1927916,1477714,2025-01-30,House,"Reported from Labor and Commerce with substitute (15-Y 7-N)",15,7,0,0,22
1927916,1480839,2025-02-04,House,"Read third time and passed House (67-Y 31-N)",67,31,0,2,100
1927916,1491401,2025-02-17,Senate,"Reported from Commerce and Labor with amendment (11-Y 4-N)",11,4,0,0,15
1927916,1493408,2025-02-18,Senate,"Constitutional reading dispensed (on 2nd reading) (40-Y 0-N)",40,0,0,0,40
1927916,1495735,2025-02-19,Senate,"Passed Senate with amendment (22-Y 18-N)",22,18,0,0,40
1927916,1496658,2025-02-20,House,"Senate Amendment agreed to by House (70-Y 27-N)",70,27,0,3,100
1927993,1477400,2025-01-30,House,"Subcommittee recommends reporting (5-Y 3-N)",5,3,0,1,9
1927993,1477909,2025-01-30,House,"Reported from Labor and Commerce (12-Y 10-N)",12,10,0,0,22
1927993,1482588,2025-02-04,House,"Read third time and passed House (51-Y 46-N 1-A)",51,46,1,2,100
1927993,1485379,2025-02-10,Senate,"Reported from Commerce and Labor with substitute and rereferred to Finance and Appropriations (9-Y 6-N)",9,6,0,0,15
1927993,1490118,2025-02-14,Senate,"Reported from Finance and Appropriations (10-Y 4-N)",10,4,0,1,15
1927993,1492070,2025-02-17,Senate,"Constitutional reading dispensed (on 2nd reading) (39-Y 0-N)",39,0,0,1,40
1927993,1495830,2025-02-19,Senate,"Passed Senate with substitute (21-Y 19-N)",21,19,0,0,40
1927993,1496753,2025-02-20,House,"Senate substitute rejected by House (1-Y 97-N)",1,97,0,2,100
1927993,1496754,2025-02-20,Senate,"Senate insisted on substitute (39-Y 0-N)",39,0,0,1,40
1927993,1497140,2025-02-22,House,"Conference report agreed to by House (49-Y 46-N)",49,46,0,5,100
1927993,1497141,2025-02-22,House,"Conference report agreed to by House (50-Y 47-N)",50,47,0,3,100
1927993,1503731,2025-02-22,Senate,"Conference report agreed to by Senate (21-Y 19-N)",21,19,0,0,40
1927993,1536447,2025-04-02,House,"House sustained Governor's veto (50-Y 46-N)",50,46,0,4,100
1928048,1477372,2025-01-30,House,"Subcommittee recommends reporting with substitute and referring to Appropriations (5-Y 3-N)",5,3,0,1,9
1928048,1477836,2025-01-30,House,"Reported from Labor and Commerce with substitute and referred to Appropriations (12-Y 10-N)",12,10,0,0,22
1928048,1478327,2025-01-31,House,"Reported from Appropriations (12-Y 10-N)",12,10,0,0,22
1928048,1482335,2025-02-04,House,"Read third time and passed House (51-Y 46-N)",51,46,0,3,100
1928048,1485321,2025-02-10,Senate,"Reported from Commerce and Labor and rereferred to Finance and Appropriations (9-Y 6-N)",9,6,0,0,15
1928048,1492045,2025-02-17,Senate,"Reported from Finance and Appropriations (9-Y 5-N)",9,5,0,1,15
1928048,1495171,2025-02-20,Senate,"Passed Senate (20-Y 18-N)",20,18,0,2,40
1928048,1495837,2025-02-19,Senate,"Constitutional reading dispensed (on 2nd reading) (40-Y 0-N)",40,0,0,0,40
1928125,1473818,2025-01-23,House,"Subcommittee recommends reporting with substitute (8-Y 0-N)",8,0,0,1,9
1928125,1475746,2025-01-28,House,"Reported from Health and Human Services with substitute (21-Y 0-N)",21,0,0,1,22
1928125,1478921,2025-02-03,House,"Read third time and passed House (98-Y 0-N)",98,0,0,2,100
1928125,1478922,2025-02-03,House,"Read third time and passed House (99-Y 0-N)",99,0,0,1,100
1928125,1483007,2025-02-06,Senate,"Rereferred from Education and Health to Rehabilitation and Social Services (14-Y 0-N)",14,0,0,1,15
1928125,1490088,2025-02-14,Senate,"Reported from Rehabilitation and Social Services (11-Y 0-N)",11,0,0,4,15
1928125,1491577,2025-02-17,Senate,"Constitutional reading dispensed (on 2nd reading)",39,0,0,1,40
1928125,1492532,2025-02-18,Senate,"Passed Senate (40-Y 0-N)",40,0,0,0,40
1928150,1476894,2025-01-29,House,"Subcommittee recommends reporting with substitute (7-Y 1-N)",7,1,0,1,9
1928150,1477850,2025-01-30,House,"Reported from Transportation with substitute (18-Y 4-N)",18,4,0,0,22
1928150,1482731,2025-02-04,House,"Read third time and passed House (59-Y 39-N)",59,39,0,2,100
1928150,1489663,2025-02-13,Senate,"Reported from Transportation (13-Y 0-N)",13,0,0,2,15
1928150,1490975,2025-02-17,Senate,"Constitutional reading dispensed (on 2nd reading)",39,0,0,1,40
1928150,1492273,2025-02-18,Senate,"Passed Senate (40-Y 0-N)",40,0,0,0,40
1928203,1491125,2025-02-17,House,"Tabled in Rules (18-Y 0-N)",18,0,0,0,18
1928255,1477543,2025-01-30,House,"Subcommittee recommends passing by indefinitely (6-Y 4-N)",6,4,0,1,11
1928281,1475870,2025-01-28,House,"Reported from Health and Human Services (21-Y 0-N)",21,0,0,1,22
1928281,1477188,2025-01-30,House,"Reported from Health and Human Services and referred to Appropriations (21-Y 0-N)",21,0,0,1,22
1928281,1478512,2025-01-31,House,"Reported from Appropriations (22-Y 0-N)",22,0,0,0,22
1928281,1480128,2025-02-04,House,"Read third time and passed House (97-Y 0-N)",97,0,0,3,100
1928281,1480129,2025-02-04,House,"Passed House (99-Y 0-N)",99,0,0,1,100
1928281,1489593,2025-02-13,Senate,"Reported from Education and Health and rereferred to Finance and Appropriations (15-Y 0-N)",15,0,0,0,15
1928281,1492536,2025-02-17,Senate,"Passed by indefinitely in Finance and Appropriations (14-Y 0-N)",14,0,0,1,15
1928306,1475749,2025-01-28,House,"Subcommittee recommends laying on the table (8-Y 0-N)",8,0,0,1,9
1928329,1476906,2025-01-29,House,"Subcommittee recommends reporting with substitute (5-Y 2-N)",5,2,0,2,9
1928329,1478508,2025-01-31,House,"Reported from Courts of Justice with substitute (14-Y 6-N)",14,6,0,2,22
1928329,1482979,2025-02-04,House,"Read third time and passed House (59-Y 39-N)",59,39,0,2,100
1928329,1484617,2025-02-10,Senate,"Reported from Courts of Justice (13-Y 0-N)",13,0,0,2,15
1928329,1485996,2025-02-11,Senate,"Constitutional reading dispensed (on 2nd reading) (40-Y 0-N)",40,0,0,0,40
1928329,1487895,2025-02-12,Senate,"Passed Senate (39-Y 0-N)",39,0,0,1,40
1928389,1474022,2025-01-23,Senate,"Rules suspended (39-Y 0-N)",39,0,0,1,40
1928438,1475990,2025-01-28,House,"Subcommittee recommends laying on the table (6-Y 4-N)",6,4,0,1,11
1928489,1475983,2025-01-28,House,"Subcommittee recommends laying on the table (4-Y 3-N)",4,3,0,1,8
1928641,1474926,2025-01-27,House,"Subcommittee recommends laying on the table (6-Y 4-N)",6,4,0,1,11
1928695,1478509,2025-01-31,House,"Subcommittee recommends reporting (8-Y 0-N)",8,0,0,1,9
1928695,1478510,2025-01-31,House,"Reported from Courts of Justice (20-Y 0-N)",20,0,0,2,22
1928695,1479985,2025-02-04,House,"Read third time and passed House (97-Y 0-N)",97,0,0,3,100
1928695,1479986,2025-02-04,House,"Passed House (99-Y 0-N)",99,0,0,1,100
1928695,1485037,2025-02-10,Senate,"Reported from Courts of Justice with substitute and rereferred to Finance and Appropriations (15-Y 0-N)",15,0,0,0,15
1928695,1487535,2025-02-12,Senate,"Reported from Finance and Appropriations with substitute (15-Y 0-N)",15,0,0,0,15
1928695,1489557,2025-02-13,Senate,"Constitutional reading dispensed (on 2nd reading) (40-Y 0-N)",40,0,0,0,40
1928695,1490690,2025-02-14,Senate,"Passed Senate with substitute (36-Y 0-N)",36,0,0,4,40
1928695,1491962,2025-02-18,House,"Senate substitute agreed to by House (97-Y 0-N)",97,0,0,3,100
1928695,1535529,2025-04-02,House,"House concurred in Governor's recommendation (95-Y 0-N)",95,0,0,5,100
1928695,1535530,2025-04-02,Senate,"Senate concurred in Governor's recommendation (40-Y 0-N)",40,0,0,0,40
1928745,1475311,2025-01-28,House,"Subcommittee recommends reporting with substitute (8-Y 0-N)",8,0,0,1,9
1928745,1476148,2025-01-29,House,"Reported from Education with substitute (17-Y 5-N)",17,5,0,0,22
1928745,1482395,2025-02-04,House,"Read third time and passed House (89-Y 10-N)",89,10,0,1,100
1928745,1489696,2025-02-13,Senate,"Reported from Education and Health with substitute and rereferred to Finance and Appropriations (14-Y 0-N)",14,0,0,1,15
1928745,1492150,2025-02-17,Senate,"Reported from Finance and Appropriations (14-Y 0-N)",14,0,0,1,15
1928745,1493606,2025-02-19,Senate,"Constitutional reading dispensed (on 2nd reading) (40-Y 0-N)",40,0,0,0,40
1928745,1495913,2025-02-20,House,"Senate substitute rejected by House (1-Y 95-N)",1,95,0,4,100
1928745,1495914,2025-02-20,Senate,"Senate insisted on substitute (38-Y 0-N)",38,0,0,2,40
1928745,1496355,2025-02-20,Senate,"Passed Senate with substitute (39-Y 0-N)",39,0,0,1,40
1928745,1496356,2025-02-20,Senate,"Reconsideration of Senate passage agreed to by Senate (39-Y 0-N)",39,0,0,1,40
1928745,1496357,2025-02-20,Senate,"Passed Senate with substitute (39-Y 0-N)",39,0,0,1,40
1928745,1497150,2025-02-21,Senate,"Conference report agreed to by Senate (39-Y 0-N)",39,0,0,1,40
1928745,1503807,2025-02-21,House,"Conference report agreed to by House (91-Y 3-N)",91,3,0,6,100
1928745,1536349,2025-04-02,House,"Passed by for the day (47-Y 46-N)",47,46,0,7,100
1928793,1477160,2025-01-30,House,"Subcommittee recommends reporting (6-Y 2-N)",6,2,0,1,9
1928793,1478068,2025-01-31,House,"Reported from Counties, Cities and Towns (19-Y 3-N)",19,3,0,0,22
1928793,1480594,2025-02-04,House,"Read third time and passed House (71-Y 25-N)",71,25,0,4,100
1928793,1488153,2025-02-12,Senate,"Reported from General Laws and Technology (15-Y 0-N)",15,0,0,0,15
1928793,1490526,2025-02-14,Senate,"Constitutional reading dispensed (on 2nd reading) (36-Y 0-N)",36,0,0,4,40
1928793,1491571,2025-02-17,Senate,"Passed Senate (23-Y 16-N)",23,16,0,1,40
1928844,1477681,2025-01-30,House,"Subcommittee recommends reporting with substitute (8-Y 0-N)",8,0,0,1,9
1928844,1477682,2025-01-30,House,"Reported from General Laws with substitute (21-Y 0-N)",21,0,0,1,22
1928844,1480515,2025-02-04,House,"Read third time and passed House (97-Y 0-N)",97,0,0,3,100
1928844,1480516,2025-02-04,House,"Passed House (99-Y 0-N)",99,0,0,1,100
1928844,1488164,2025-02-12,Senate,"Reported from General Laws and Technology (15-Y 0-N)",15,0,0,0,15
1928844,1490426,2025-02-14,Senate,"Constitutional reading dispensed (on 2nd reading) (36-Y 0-N)",36,0,0,4,40
1928844,1491266,2025-02-17,Senate,"Passed Senate (39-Y 0-N)",39,0,0,1,40
1928844,1535565,2025-04-02,House,"VOTE: Pass by for the day - Adoption (47-Y 46-N)",47,46,0,7,100
1928896,1475293,2025-01-28,House,"Subcommittee recommends reporting with substitute (7-Y 1-N)",7,1,0,1,9
1928896,1476172,2025-01-29,House,"Reported from Education with substitute (18-Y 4-N)",18,4,0,0,22
1928896,1480559,2025-02-04,House,"Read third time and passed House (97-Y 0-N)",97,0,0,3,100
1928896,1489869,2025-02-13,Senate,"Reported from Education and Health with substitute (14-Y 0-N)",14,0,0,1,15
1928896,1491650,2025-02-17,Senate,"Constitutional reading dispensed (on 2nd reading)",39,0,0,1,40
1928896,1493119,2025-02-18,Senate,"Passed Senate with substitute (40-Y 0-N)",40,0,0,0,40
1928896,1494902,2025-02-19,House,"Senate substitute rejected by House (2-Y 94-N)",2,94,0,4,100
1928896,1496237,2025-02-20,Senate,"Senate insisted on substitute (39-Y 0-N)",39,0,0,1,40
1928896,1497198,2025-02-22,House,"Conference report agreed to by House (97-Y 0-N)",97,0,0,3,100
1928896,1503241,2025-02-22,Senate,"Conference report agreed to by Senate (40-Y 0-N)",40,0,0,0,40
1928949,1475000,2025-01-27,House,"Subcommittee recommends reporting with substitute (10-Y 0-N)",10,0,0,1,11
1928949,1476336,2025-01-29,House,"Reported from Agriculture, Chesapeake and Natural Resources (22-Y 0-N)",22,0,0,0,22
1928949,1482275,2025-02-04,House,"Read third time and passed House (78-Y 18-N)",78,18,0,4,100
1928949,1486629,2025-02-11,Senate,"Reported from Agriculture, Conservation and Natural Resources with amendment (14-Y 1-N)",14,1,0,0,15
1928949,1490067,2025-02-13,Senate,"Constitutional reading dispensed (on 2nd reading) (40-Y 0-N)",40,0,0,0,40
1928949,1490068,2025-02-14,Senate,"Passed Senate with amendments (35-Y 1-N)",35,1,0,4,40
1928949,1491989,2025-02-18,House,"Senate Amendments agreed to by House (67-Y 30-N)",67,30,0,3,100
1929001,1476226,2025-01-29,House,"Subcommittee recommends laying on the table (10-Y 0-N)",10,0,0,1,11
1929883,1476734,2025-01-29,Senate,"Stricken at request of Patron in General Laws and Technology (15-Y 0-N)",15,0,0,0,15
1929884,1479149,2025-02-03,Senate,"Reported from Courts of Justice with amendments (14-Y 0-N 1-A)",14,0,1,0,15
1929884,1480161,2025-02-04,Senate,"Constitutional reading dispensed (on 1st reading) (40-Y 0-N)",40,0,0,0,40
1929884,1480162,2025-02-04,Senate,"Constitutional reading dispensed (on 3rd reading) (40-Y 0-N)",40,0,0,0,40
1929884,1480163,2025-02-04,Senate,"Passed Senate (40-Y 0-N)",40,0,0,0,40
1929884,1485969,2025-02-10,House,"Subcommittee recommends reporting (8-Y 0-N)",8,0,0,1,9
1929884,1490621,2025-02-14,House,"Reported from Courts of Justice (21-Y 0-N)",21,0,0,1,22
1929884,1493368,2025-02-19,House,"Passed House (97-Y 0-N)",97,0,0,3,100
1929885,1474993,2025-01-27,Senate,"Reported from Commerce and Labor with substitute (15-Y 0-N)",15,0,0,0,15
1929885,1476274,2025-01-29,Senate,"Constitutional reading dispensed (on 1st reading) (38-Y 0-N)",38,0,0,2,40
1929885,1477453,2025-01-30,Senate,"Read third time and passed Senate (40-Y 0-N)",40,0,0,0,40
1929885,1479118,2025-01-30,Senate,"Constitutional reading dispensed (on 3rd reading) (39-Y 1-N)",39,1,0,0,40
1929885,1479119,2025-01-30,Senate,"Passed Senate (40-Y 0-N)",39,1,0,0,40
1929885,1483390,2025-02-06,House,"Reported from Labor and Commerce (21-Y 0-N)",21,0,0,1,22
1929885,1486320,2025-02-11,House,"Passed House (94-Y 0-N)",94,0,0,6,100
1929886,1477913,2025-01-30,Senate,"Passed by indefinitely in Transportation (9-Y 6-N)",9,6,0,0,15
1929887,1474696,2025-01-27,Senate,"Reported from Local Government with substitute (12-Y 3-N)",12,3,0,0,15
1929887,1476774,2025-01-28,Senate,"Constitutional reading dispensed (on 1st reading) (39-Y 0-N)",39,0,0,1,40
1929887,1478138,2025-01-30,Senate,"Read third time and passed Senate (33-Y 6-N 1-A)",33,6,1,0,40
1929887,1483097,2025-02-06,House,"Subcommittee recommends reporting with substitute (5-Y 3-N)",5,3,0,1,9
1929887,1483894,2025-02-07,House,"Reported from Counties, Cities and Towns with substitute (14-Y 7-N)",14,7,0,1,22
1929887,1487590,2025-02-12,House,"Passed House with substitute (58-Y 39-N)",58,39,0,3,100
1929887,1490704,2025-02-14,Senate,"House substitute rejected by Senate (4-Y 31-N 1-A)",4,31,1,4,40
1929887,1492485,2025-02-18,Senate,"Senate acceded to request (39-Y 0-N 1-A)",39,0,1,0,40
1929887,1496562,2025-02-21,Senate,"Conference report agreed to by Senate (26-Y 13-N 1-A)",26,13,1,0,40
1929887,1497119,2025-02-22,House,"Conference report agreed to by House (57-Y 40-N)",57,40,0,3,100
1929887,1536775,2025-04-02,Senate,"Senate rejected Governor's recommendation (16-Y 24-N)",16,24,0,0,40
1929888,1476515,2025-01-29,Senate,"Stricken at request of Patron in General Laws and Technology (15-Y 0-N)",15,0,0,0,15
1929889,1476122,2025-01-28,Senate,"Passed by indefinitely in Finance and Appropriations (10-Y 5-N)",10,5,0,0,15
1929890,1477778,2025-01-29,Senate,"Reported from Finance and Appropriations (15-Y 0-N)",15,0,0,0,15
1929890,1477779,2025-01-30,Senate,"Constitutional reading dispensed (on 1st reading) (39-Y 0-N 1-A)",39,0,1,0,40
1929890,1479383,2025-01-31,Senate,"Constitutional reading dispensed (on 3rd reading) (40-Y 0-N)",40,0,0,0,40
1929890,1479384,2025-01-31,Senate,"Passed Senate (40-Y 0-N)",40,0,0,0,40
1929890,1490477,2025-02-14,House,"Reported from Appropriations with substitute (21-Y 0-N)",21,0,0,1,22
1929890,1493183,2025-02-19,House,"Passed House with substitute (84-Y 13-N)",84,13,0,3,100
1929890,1496057,2025-02-20,Senate,"Senate acceded to request (38-Y 0-N)",38,0,0,2,40
1929890,1496832,2025-02-20,Senate,"House substitute rejected by Senate (0-Y 39-N)",0,39,0,1,40
1929890,1496833,2025-02-21,Senate,"Conference report agreed to by Senate (40-Y 0-N)",40,0,0,0,40
1929890,1497171,2025-02-22,House,"Conference report agreed to by House (84-Y 13-N)",84,13,0,3,100
1929890,1535587,2025-04-02,Senate,"Senate concurred in Governor's recommendation (40-Y 0-N)",40,0,0,0,40
1929890,1535588,2025-04-02,House,"House concurred in Governor's recommendation (94-Y 2-N)",94,2,0,4,100
1929891,1476263,2025-01-28,Senate,"Passed by indefinitely in Finance and Appropriations (15-Y 0-N)",15,0,0,0,15
1929893,1474877,2025-01-27,Senate,"Reported from Courts of Justice with substitute and rereferred to Finance and Appropriations (9-Y 3-N 2-A)",9,3,2,1,15
1929893,1476439,2025-01-29,Senate,"Reported from Finance and Appropriations with substitute (10-Y 4-N)",10,4,0,1,15
1929893,1477496,2025-01-30,Senate,"Constitutional reading dispensed (on 1st reading) (39-Y 0-N 1-A)",39,0,1,0,40
1929893,1482191,2025-02-04,Senate,"Read third time and passed Senate (25-Y 15-N)",25,15,0,0,40
1929893,1485365,2025-02-10,House,"Reported from Courts of Justice with substitute (22-Y 0-N)",22,0,0,0,22
1929893,1489305,2025-02-13,House,"Passed House with substitute (97-Y 0-N)",97,0,0,3,100
1929893,1491316,2025-02-17,Senate,"House substitute rejected by Senate (0-Y 39-N)",0,39,0,1,40
1929893,1494060,2025-02-19,Senate,"Senate acceded to request (40-Y 0-N)",40,0,0,0,40
1929893,1497126,2025-02-22,House,"Conference report agreed to by House (97-Y 0-N)",97,0,0,3,100
1929893,1504110,2025-02-22,Senate,"Conference report agreed to by Senate (28-Y 11-N)",28,11,0,1,40
1929893,1534928,2025-04-02,Senate,"Senate concurred in Governor's recommendation (40-Y 0-N)",40,0,0,0,40
1929893,1534929,2025-04-02,House,"House concurred in Governor's recommendation (96-Y 0-N)",96,0,0,4,100
1929894,1475728,2025-01-28,Senate,"Passed by indefinitely in Privileges and Elections (8-Y 7-N)",8,7,0,0,15
1929896,1475506,2025-01-28,Senate,"Passed by indefinitely in Finance and Appropriations (10-Y 4-N)",10,4,0,1,15
1929897,1476437,2025-01-28,Senate,"Reported from Finance and Appropriations (15-Y 0-N)",15,0,0,0,15
1929897,1476438,2025-01-29,Senate,"Constitutional reading dispensed (on 1st reading) (38-Y 0-N)",38,0,0,2,40
1929897,1477458,2025-01-30,Senate,"Read third time and passed Senate (40-Y 0-N)",40,0,0,0,40
1929897,1479093,2025-01-30,Senate,"Constitutional reading dispensed (on 3rd reading) (39-Y 1-N)",39,1,0,0,40
1929897,1479094,2025-01-30,Senate,"Passed Senate (40-Y 0-N)",39,1,0,0,40
1929897,1485420,2025-02-10,House,"Reported from Appropriations (22-Y 0-N)",22,0,0,0,22
1929897,1489542,2025-02-13,House,"Passed House (96-Y 0-N)",96,0,0,4,100
1929899,1475390,2025-01-28,Senate,"Reported from Education and Health and rereferred to Finance and Appropriations (14-Y 0-N 1-A)",14,0,1,0,15
1929900,1475282,2025-01-28,Senate,"Stricken at request of Patron in Finance and Appropriations (15-Y 0-N)",15,0,0,0,15
1929901,1475057,2025-01-27,Senate,"Reported from Courts of Justice and rereferred to Finance and Appropriations (8-Y 6-N)",8,6,0,1,15
1929901,1477784,2025-01-29,Senate,"Reported from Finance and Appropriations (10-Y 4-N)",10,4,0,1,15
1929901,1477785,2025-01-30,Senate,"Constitutional reading dispensed (on 1st reading) (39-Y 0-N 1-A)",39,0,1,0,40
1929901,1480139,2025-02-03,Senate,"Read third time and passed Senate (21-Y 19-N)",21,19,0,0,40
1929901,1489910,2025-02-14,House,"Reported from Public Safety with substitute (11-Y 10-N)",11,10,0,1,22
1929901,1493290,2025-02-19,House,"Passed House with substitute (51-Y 46-N)",51,46,0,3,100
1929901,1495203,2025-02-20,Senate,"House substitute agreed to by Senate (20-Y 19-N)",20,19,0,1,40
1929903,1474101,2025-01-23,Senate,"Passed by indefinitely in Transportation with letter (12-Y 0-N)",12,0,0,3,15
1929904,1475047,2025-01-27,Senate,"Reported from Local Government (15-Y 0-N)",15,0,0,0,15
1929904,1476237,2025-01-29,Senate,"Passed Senate (38-Y 0-N)",38,0,0,2,40
1929904,1476575,2025-01-28,Senate,"Constitutional reading dispensed (on 1st reading) (39-Y 0-N)",39,0,0,1,40
1929904,1479064,2025-01-29,Senate,"Constitutional reading dispensed (on 3rd reading) (38-Y 0-N)",38,0,0,2,40
1929904,1487282,2025-02-12,House,"Subcommittee recommends reporting (8-Y 0-N)",8,0,0,1,9
1929904,1490057,2025-02-14,House,"Reported from Counties, Cities and Towns (21-Y 0-N)",21,0,0,1,22
1929904,1493365,2025-02-19,House,"Passed House (97-Y 0-N)",97,0,0,3,100
1929905,1478053,2025-01-30,Senate,"Reported from Education and Health with substitute (11-Y 4-N)",11,4,0,0,15
1929905,1478597,2025-01-31,Senate,"Constitutional reading dispensed (on 1st reading) (39-Y 0-N)",39,0,0,1,40
1929905,1480846,2025-02-04,Senate,"Read third time and passed Senate (37-Y 0-N)",37,0,0,3,40
1929905,1485945,2025-02-11,House,"Reported from Health and Human Services (22-Y 0-N)",22,0,0,0,22
1929905,1490309,2025-02-14,House,"Passed House (96-Y 0-N)",96,0,0,4,100
1929906,1475273,2025-01-27,Senate,"Reported from Courts of Justice (12-Y 0-N 2-A)",12,0,2,1,15
1929906,1476669,2025-01-28,Senate,"Constitutional reading dispensed (on 1st reading) (39-Y 0-N)",39,0,0,1,40
1929906,1477497,2025-01-30,Senate,"Read third time and passed Senate (40-Y 0-N)",40,0,0,0,40
1929906,1480745,2025-02-05,House,"Reported from Courts of Justice with substitute (22-Y 0-N)",22,0,0,0,22
1929906,1484655,2025-02-10,House,"Passed House with substitute (95-Y 0-N)",95,0,0,5,100
1929906,1487621,2025-02-12,Senate,"House substitute agreed to by Senate (39-Y 0-N)",39,0,0,1,40
1929906,1534640,2025-04-02,Senate,"Senate concurred in Governor's recommendation (40-Y 0-N)",40,0,0,0,40
1929906,1536863,2025-04-02,House,"House concurred in Governor's recommendation (95-Y 0-N)",95,0,0,5,100
1929907,1475237,2025-01-27,Senate,"Passed by indefinitely in Local Government (9-Y 6-N)",9,6,0,0,15
1929908,1477641,2025-01-30,Senate,"Reported from Education and Health (15-Y 0-N)",15,0,0,0,15
1929908,1478214,2025-01-31,Senate,"Constitutional reading dispensed (on 1st reading) (39-Y 0-N)",39,0,0,1,40
1929908,1479897,2025-02-03,Senate,"Constitutional reading dispensed (on 3rd reading) (40-Y 0-N)",40,0,0,0,40
1929908,1479898,2025-02-03,Senate,"Passed Senate (40-Y 0-N)",40,0,0,0,40
1929908,1488769,2025-02-13,House,"Reported from Health and Human Services (21-Y 0-N)",21,0,0,1,22
1929908,1492141,2025-02-18,House,"Passed House (97-Y 0-N)",97,0,0,3,100
1929909,1476382,2025-01-29,Senate,"Reported from Courts of Justice with substitute (15-Y 0-N)",15,0,0,0,15
1929909,1478122,2025-01-31,Senate,"Constitutional reading dispensed (on 1st reading) (39-Y 0-N)",39,0,0,1,40
1929909,1480231,2025-02-03,Senate,"Constitutional reading dispensed (on 3rd reading) (40-Y 0-N)",40,0,0,0,40
1929909,1480232,2025-02-03,Senate,"Passed Senate (40-Y 0-N)",40,0,0,0,40
1929909,1485354,2025-02-10,House,"Subcommittee recommends reporting with substitute (5-Y 3-N)",5,3,0,1,9
1929909,1490430,2025-02-14,House,"Tabled in Courts of Justice (15-Y 5-N)",15,5,0,2,22
1929910,1475887,2025-01-28,Senate,"Reported from Privileges and Elections (8-Y 7-N)",8,7,0,0,15
1929910,1478423,2025-01-30,Senate,"Constitutional reading dispensed (on 1st reading) (39-Y 0-N 1-A)",39,0,1,0,40
1929911,1474642,2025-01-24,Senate,"Reported from Rules with amendment and rereferred to Finance and Appropriations (13-Y 0-N)",13,0,0,2,15
1929911,1476425,2025-01-29,Senate,"Reported from Finance and Appropriations with substitute (15-Y 0-N)",15,0,0,0,15
1929911,1477440,2025-01-30,Senate,"Constitutional reading dispensed (on 1st reading) (39-Y 0-N 1-A)",39,0,1,0,40
1929911,1479245,2025-01-31,Senate,"Constitutional reading dispensed (on 3rd reading) (40-Y 0-N)",40,0,0,0,40
1929911,1479246,2025-01-31,Senate,"Passed Senate (40-Y 0-N)",40,0,0,0,40
1929911,1486371,2025-02-10,House,"Reported from Courts of Justice with substitute (22-Y 0-N)",22,0,0,0,22
1929911,1488849,2025-02-13,House,"Passed House with substitute (96-Y 0-N)",96,0,0,4,100
1929911,1491160,2025-02-17,Senate,"House substitute rejected by Senate (0-Y 39-N)",0,39,0,1,40
1929911,1494077,2025-02-19,Senate,"Senate acceded to request (40-Y 0-N)",40,0,0,0,40
1929911,1497130,2025-02-22,House,"Conference report agreed to by House (97-Y 0-N)",97,0,0,3,100
1929911,1504002,2025-02-22,Senate,"Conference report agreed to by Senate (40-Y 0-N)",40,0,0,0,40
1929913,1473404,2025-01-22,Senate,"Reported from General Laws and Technology and rereferred to Finance and Appropriations (15-Y 0-N)",15,0,0,0,15
1929914,1474788,2025-01-27,Senate,"Passed by indefinitely in Courts of Justice with letter (8-Y 6-N)",8,6,0,1,15
1929915,1475845,2025-01-28,Senate,"Reported from Agriculture, Conservation and Natural Resources and rereferred to Finance and Appropriations (10-Y 4-N)",10,4,0,1,15
1929916,1477193,2025-01-30,Senate,"Incorporated by Education and Health (SB1393-Williams Graves) (15-Y 0-N)",15,0,0,0,15
1929917,1476208,2025-01-29,Senate,"Reported from Finance and Appropriations (15-Y 0-N)",15,0,0,0,15
1929917,1477802,2025-01-30,Senate,"Constitutional reading dispensed (on 1st reading) (39-Y 0-N 1-A)",39,0,1,0,40
1929917,1479381,2025-01-31,Senate,"Constitutional reading dispensed (on 3rd reading) (40-Y 0-N)",40,0,0,0,40
1929917,1479382,2025-01-31,Senate,"Passed Senate (40-Y 0-N)",40,0,0,0,40
1929917,1490513,2025-02-14,House,"Reported from Appropriations with amendment(s) (21-Y 0-N)",21,0,0,1,22
1929917,1493288,2025-02-19,House,"Passed House with amendments (97-Y 0-N)",97,0,0,3,100
1929917,1495140,2025-02-20,Senate,"House Amendments agreed to by Senate (39-Y 0-N)",39,0,0,1,40
1929917,1535552,2025-04-02,Senate,"Senate concurred in Governor's recommendation (40-Y 0-N)",40,0,0,0,40
1929917,1535553,2025-04-02,House,"House concurred in Governor's recommendation (94-Y 1-N)",94,1,0,5,100
1929918,1474092,2025-01-23,Senate,"Reported from Transportation with substitute and rereferred to Finance and Appropriations (12-Y 0-N)",12,0,0,3,15
1929918,1475263,2025-01-28,Senate,"Passed by indefinitely in Finance and Appropriations (10-Y 5-N)",10,5,0,0,15
1929919,1477269,2025-01-30,Senate,"Reported from Education and Health with amendments (12-Y 2-N)",12,2,0,1,15
1929919,1478185,2025-01-31,Senate,"Constitutional reading dispensed (on 1st reading) (39-Y 0-N)",39,0,0,1,40
1929919,1480627,2025-02-04,Senate,"Read third time and passed Senate (30-Y 9-N 1-A)",30,9,1,0,40
1929919,1487450,2025-02-12,House,"Reported from Education with amendment(s) (16-Y 5-N)",16,5,0,1,22
1929919,1491212,2025-02-17,House,"Passed House with amendment (55-Y 39-N)",55,39,0,6,100
1929919,1492438,2025-02-18,Senate,"House Amendment agreed to by Senate (29-Y 8-N)",29,8,0,3,40
1929919,1536654,2025-04-02,Senate,"Senate rejected Governor's recommendation (18-Y 22-N)",18,22,0,0,40
1929920,1474437,2025-01-24,Senate,"Incorporated by Commerce and Labor (SB1190-Deeds) (15-Y 0-N)",15,0,0,0,15
1929921,1477421,2025-01-30,Senate,"Reported from Transportation (15-Y 0-N)",15,0,0,0,15
1929921,1480073,2025-02-03,Senate,"Constitutional reading dispensed (on 1st reading) (40-Y 0-N)",40,0,0,0,40
1929921,1482149,2025-02-04,Senate,"Constitutional reading dispensed (on 3rd reading) (39-Y 0-N)",39,0,0,1,40
1929921,1482150,2025-02-04,Senate,"Passed Senate (40-Y 0-N)",40,0,0,0,40
1929921,1486030,2025-02-11,House,"Reported from Transportation (20-Y 0-N)",20,0,0,2,22
1929921,1490065,2025-02-14,House,"Passed House (96-Y 0-N)",96,0,0,4,100
1929923,1476749,2025-01-29,Senate,"Reported from General Laws and Technology with substitute (9-Y 6-N)",9,6,0,0,15
1929923,1478408,2025-01-31,Senate,"Constitutional reading dispensed (on 1st reading) (39-Y 0-N)",39,0,0,1,40
1929923,1480317,2025-02-04,Senate,"Engrossment reconsidered by Senate",40,0,0,0,40
1929923,1480318,2025-02-04,Senate,"Constitutional reading dispensed (on 3rd reading) (40-Y 0-N)",40,0,0,0,40
1929923,1480319,2025-02-04,Senate,"Passed Senate (39-Y 1-N)",39,1,0,0,40
1929923,1489181,2025-02-13,House,"Subcommittee recommends reporting with amendment(s) (5-Y 2-N)",5,2,0,2,9
1929923,1489182,2025-02-13,House,"Reported from General Laws with amendment(s) (19-Y 0-N)",19,0,0,3,22
1929923,1492817,2025-02-18,House,"Passed House with amendments (82-Y 14-N)",82,14,0,4,100
1929923,1493729,2025-02-19,Senate,"House Amendments agreed to by Senate (40-Y 0-N)",40,0,0,0,40
1929924,1475380,2025-01-28,Senate,"Reported from Education and Health with substitute and rereferred to Finance and Appropriations (15-Y 0-N)",15,0,0,0,15
1929924,1477630,2025-01-30,Senate,"Reported from Finance and Appropriations (15-Y 0-N)",15,0,0,0,15
1929924,1479818,2025-02-03,Senate,"Constitutional reading dispensed (on 1st reading) (40-Y 0-N)",40,0,0,0,40
1929924,1479819,2025-02-04,Senate,"Constitutional reading dispensed (on 3rd reading) (39-Y 0-N)",39,0,0,1,40
1929924,1479820,2025-02-04,Senate,"Passed Senate (40-Y 0-N)",40,0,0,0,40
1929924,1485872,2025-02-11,House,"Subcommittee recommends reporting (6-Y 1-N)",6,1,0,2,9
1929924,1490765,2025-02-17,House,"Reported from Education (22-Y 0-N)",22,0,0,0,22
1929925,1476507,2025-01-29,Senate,"Passed by indefinitely in General Laws and Technology (9-Y 6-N)",9,6,0,0,15
1929926,1476726,2025-01-29,Senate,"Passed by indefinitely in General Laws and Technology (14-Y 0-N)",14,0,0,1,15
1929927,1477905,2025-01-30,Senate,"Reported from Transportation with substitute (12-Y 3-N)",12,3,0,0,15
1929927,1479563,2025-02-03,Senate,"Constitutional reading dispensed (on 1st reading) (40-Y 0-N)",40,0,0,0,40
1929927,1482217,2025-02-04,Senate,"Constitutional reading dispensed (on 3rd reading) (40-Y 0-N)",40,0,0,0,40
1929927,1482218,2025-02-04,Senate,"Passed Senate (33-Y 7-N)",33,7,0,0,40
1929927,1487662,2025-02-12,House,"Subcommittee failed to recommend reporting (3-Y 3-N)",3,3,0,3,9
1929928,1474181,2025-01-24,Senate,"Passed by indefinitely in Rehabilitation and Social Services (13-Y 2-N)",13,2,0,0,15
1929929,1474180,2025-01-24,Senate,"Reported from Rehabilitation and Social Services and rereferred to Finance and Appropriations (15-Y 0-N)",15,0,0,0,15
1929929,1477773,2025-01-29,Senate,"Passed by indefinitely in Finance and Appropriations (14-Y 0-N)",14,0,0,1,15
1929930,1474601,2025-01-24,Senate,"Passed by indefinitely in Commerce and Labor with letter (15-Y 0-N)",15,0,0,0,15
1929931,1475700,2025-01-27,Senate,"Passed by indefinitely in Commerce and Labor (9-Y 6-N)",9,6,0,0,15
1929932,1477631,2025-01-30,Senate,"Reported from Education and Health (15-Y 0-N)",15,0,0,0,15
1929932,1478355,2025-01-31,Senate,"Constitutional reading dispensed (on 1st reading) (39-Y 0-N)",39,0,0,1,40
1929932,1480358,2025-02-03,Senate,"Constitutional reading dispensed (on 3rd reading) (40-Y 0-N)",40,0,0,0,40
1929932,1480359,2025-02-03,Senate,"Passed Senate (40-Y 0-N)",40,0,0,0,40
1929932,1486439,2025-02-11,House,"Reported from Health and Human Services (22-Y 0-N)",22,0,0,0,22
1929932,1490077,2025-02-14,House,"Passed House (96-Y 0-N)",96,0,0,4,100
1929935,1476761,2025-01-29,Senate,"Passed by indefinitely in General Laws and Technology (9-Y 6-N)",9,6,0,0,15
1929937,1476444,2025-01-28,Senate,"Passed by indefinitely in Finance and Appropriations (10-Y 5-N)",10,5,0,0,15
1929938,1474614,2025-01-24,Senate,"Reported from Rules (12-Y 0-N)",12,0,0,3,15
1929938,1475046,2025-01-27,Senate,"Constitutional reading dispensed (on 1st reading) (37-Y 1-N)",37,1,0,2,40
1929938,1476158,2025-01-29,Senate,"Read third time and passed Senate (38-Y 0-N)",38,0,0,2,40
1929938,1490803,2025-02-17,House,"Tabled in Rules (12-Y 6-N)",12,6,0,0,18
1929939,1474778,2025-01-27,Senate,"Passed by indefinitely in Local Government (8-Y 7-N)",8,7,0,0,15
1929940,1474183,2025-01-24,Senate,"Reported from Rehabilitation and Social Services and rereferred to Finance and Appropriations (15-Y 0-N)",15,0,0,0,15
1929940,1477137,2025-01-29,Senate,"Passed by indefinitely in Finance and Appropriations (10-Y 5-N)",10,5,0,0,15
1929942,1474699,2025-01-27,Senate,"Reported from Local Government with amendments (11-Y 3-N)",11,3,0,1,15
1929942,1476746,2025-01-28,Senate,"Constitutional reading dispensed (on 1st reading) (39-Y 0-N)",39,0,0,1,40
1929942,1477602,2025-01-30,Senate,"Read third time and passed Senate (32-Y 8-N)",32,8,0,0,40
1929942,1483093,2025-02-06,House,"Subcommittee recommends reporting with amendment(s) (8-Y 0-N)",8,0,0,1,9
1929942,1483882,2025-02-07,House,"Reported from Counties, Cities and Towns with amendment(s) (21-Y 0-N)",21,0,0,1,22
1929942,1487510,2025-02-12,House,"Passed House with amendments (97-Y 0-N)",97,0,0,3,100
1929942,1490694,2025-02-14,Senate,"House Amendment agreed to by Senate (30-Y 5-N)",30,5,0,5,40
1929943,1474321,2025-01-24,Senate,"Reported from Rehabilitation and Social Services with amendment and rereferred to Finance and Appropriations (12-Y 3-N)",12,3,0,0,15
1929943,1477431,2025-01-29,Senate,"Reported from Finance and Appropriations (15-Y 0-N)",15,0,0,0,15
1929943,1477432,2025-01-30,Senate,"Constitutional reading dispensed (on 1st reading) (39-Y 0-N 1-A)",39,0,1,0,40
1929943,1480112,2025-02-03,Senate,"Read third time and passed Senate (28-Y 8-N)",28,8,0,4,40
1929943,1480113,2025-02-03,Senate,"Reconsideration of passage agreed to by Senate",39,0,0,1,40
1929943,1480114,2025-02-03,Senate,"Passed Senate (31-Y 9-N)",31,9,0,0,40
1929943,1488183,2025-02-12,House,"Subcommittee recommends laying on the table (10-Y 0-N)",10,0,0,1,11
1929945,1479099,2025-02-03,Senate,"Passed by indefinitely in Courts of Justice (9-Y 6-N)",9,6,0,0,15
1929946,1478042,2025-01-30,Senate,"Reported from Education and Health with substitute (15-Y 0-N)",15,0,0,0,15
1929946,1478200,2025-01-31,Senate,"Constitutional reading dispensed (on 1st reading) (39-Y 0-N)",39,0,0,1,40
1929946,1479872,2025-02-03,Senate,"Constitutional reading dispensed (on 3rd reading)",40,0,0,0,40
1929946,1479873,2025-02-03,Senate,"Passed Senate (40-Y 0-N)",40,0,0,0,40
1929946,1485964,2025-02-11,House,"Subcommittee recommends reporting (8-Y 0-N)",8,0,0,1,9
1929946,1488795,2025-02-13,House,"Reported from Health and Human Services (21-Y 0-N)",21,0,0,1,22
1929946,1492012,2025-02-18,House,"Passed House (97-Y 0-N)",97,0,0,3,100
1929947,1477101,2025-01-30,Senate,"Reported from Education and Health with substitute (15-Y 0-N)",15,0,0,0,15
1929947,1478069,2025-01-31,Senate,"Constitutional reading dispensed (on 1st reading) (39-Y 0-N)",39,0,0,1,40
1929947,1480089,2025-02-03,Senate,"Constitutional reading dispensed (on 3rd reading) (40-Y 0-N)",40,0,0,0,40
1929947,1480090,2025-02-03,Senate,"Passed Senate (40-Y 0-N)",40,0,0,0,40
1929947,1485917,2025-02-11,House,"Reported from Health and Human Services with substitute (22-Y 0-N)",22,0,0,0,22
1929947,1490231,2025-02-14,House,"Passed House with substitute (96-Y 0-N)",96,0,0,4,100
1929947,1493059,2025-02-18,Senate,"House substitute agreed to by Senate (40-Y 0-N)",40,0,0,0,40
1929948,1475681,2025-01-27,Senate,"Passed by indefinitely in Commerce and Labor with letter (15-Y 0-N)",15,0,0,0,15
1929950,1473934,2025-01-23,Senate,"Passed by indefinitely in Education and Health (9-Y 6-N)",9,6,0,0,15
1929951,1474609,2025-01-24,Senate,"Reported from Rules and rereferred to Finance and Appropriations (12-Y 0-N)",12,0,0,3,15
1929951,1477775,2025-01-29,Senate,"Passed by indefinitely in Finance and Appropriations (14-Y 0-N)",14,0,0,1,15
1929952,1474363,2025-01-23,Senate,"Rereferred from Education and Health and rereferred to Transportation (15-Y 0-N)",15,0,0,0,15
1929952,1477837,2025-01-30,Senate,"Reported from Transportation with substitute (8-Y 7-N)",8,7,0,0,15
1929952,1480411,2025-02-03,Senate,"Constitutional reading dispensed (on 1st reading) (40-Y 0-N)",40,0,0,0,40
1929952,1482855,2025-02-04,Senate,"Constitutional reading dispensed (on 3rd reading) (40-Y 0-N)",40,0,0,0,40
1929952,1482856,2025-02-04,Senate,"Passed Senate (26-Y 14-N)",26,14,0,0,40
1929953,1473251,2025-01-22,Senate,"Passed by indefinitely in Courts of Justice (8-Y 7-N)",8,7,0,0,15
1929954,1474595,2025-01-24,Senate,"Passed by indefinitely in Rules with letter (7-Y 4-N)",7,4,0,4,15
1929955,1477255,2025-01-30,Senate,"Reported from Education and Health with substitute (15-Y 0-N)",15,0,0,0,15
1929955,1478178,2025-01-31,Senate,"Constitutional reading dispensed (on 1st reading) (39-Y 0-N)",39,0,0,1,40
1929955,1480337,2025-02-03,Senate,"Constitutional reading dispensed (on 3rd reading) (40-Y 0-N)",40,0,0,0,40
1929955,1480338,2025-02-03,Senate,"Passed Senate (40-Y 0-N)",40,0,0,0,40
1929955,1485870,2025-02-11,House,"Subcommittee recommends reporting with substitute (6-Y 1-N)",6,1,0,2,9
1929955,1490747,2025-02-17,House,"Reported from Education with substitute (19-Y 3-N)",19,3,0,0,22
1929955,1496575,2025-02-20,House,"Passed House with substitute (98-Y 0-N)",98,0,0,2,100
1929955,1496909,2025-02-20,Senate,"House substitute agreed to by Senate (39-Y 0-N)",39,0,0,1,40
1929956,1474871,2025-01-27,Senate,"Reported from Local Government and rereferred to Finance and Appropriations (8-Y 7-N)",8,7,0,0,15
1929956,1477967,2025-01-30,Senate,"Reported from Finance and Appropriations with substitute (10-Y 5-N)",10,5,0,0,15
1929956,1480297,2025-02-03,Senate,"Constitutional reading dispensed (on 1st reading) (40-Y 0-N)",40,0,0,0,40
1929956,1480298,2025-02-04,Senate,"Constitutional reading dispensed (on 3rd reading) (40-Y 0-N)",40,0,0,0,40
1929956,1480299,2025-02-04,Senate,"Passed Senate (21-Y 19-N)",21,19,0,0,40
1929956,1489998,2025-02-14,House,"Subcommittee recommends reporting (5-Y 3-N)",5,3,0,1,9
1929956,1489999,2025-02-14,House,"Reported from Counties, Cities and Towns (12-Y 9-N)",12,9,0,1,22
1929956,1494098,2025-02-19,House,"Passed House (51-Y 46-N)",51,46,0,3,100
1929957,1473382,2025-01-22,Senate,"Reported from Courts of Justice and rereferred to Finance and Appropriations (15-Y 0-N)",15,0,0,0,15
1930724,1476503,2025-01-29,Senate,"Passed by indefinitely in General Laws and Technology (14-Y 1-N)",14,1,0,0,15
1930738,1473287,2025-01-22,Senate,"Reported from Courts of Justice (15-Y 0-N)",15,0,0,0,15
1930738,1476443,2025-01-28,Senate,"Read third time and agreed to by Senate (39-Y 0-N)",39,0,0,1,40
1930738,1484070,2025-02-07,House,"Subcommittee recommends reporting (8-Y 0-N)",8,0,0,1,9
1930738,1485892,2025-02-10,House,"Reported from Courts of Justice (22-Y 0-N)",22,0,0,0,22
1930738,1489569,2025-02-13,House,"Agreed to by House (96-Y 1-N)",96,1,0,3,100
1930753,1472883,2025-01-21,Senate,"Reported from Privileges and Elections with amendment (15-Y 0-N)",15,0,0,0,15
1930753,1473860,2025-01-23,Senate,"Reading waived (on 1st reading) (39-Y 0-N)",39,0,0,1,40
1930753,1475202,2025-01-27,Senate,"Read third time and agreed to by Senate (38-Y 0-N)",38,0,0,2,40
1930753,1478051,2025-01-31,House,"Reported from Privileges and Elections (21-Y 0-N)",21,0,0,1,22
1930753,1484272,2025-02-07,House,"Agreed to by House (94-Y 0-N)",94,0,0,6,100
1944744,1476300,2025-01-29,Senate,"Rules suspended (36-Y 0-N)",36,0,0,4,40
1948272,1477486,2025-01-30,Senate,"Rules suspended (40-Y 0-N)",40,0,0,0,40
1948968,1478370,2025-01-31,Senate,"Reported from Agriculture, Conservation and Natural Resources with substitute (9-Y 4-N)",9,4,0,2,15
1948968,1479881,2025-02-04,Senate,"Constitutional reading dispensed (on 3rd reading) (40-Y 0-N)",40,0,0,0,40
1948968,1479882,2025-02-04,Senate,"Passed Senate (37-Y 3-N)",37,3,0,0,40
1948968,1480340,2025-02-03,Senate,"Constitutional reading dispensed (on 1st reading) (40-Y 0-N)",40,0,0,0,40
1948968,1487442,2025-02-12,House,"Subcommittee recommends reporting (9-Y 1-N)",9,1,0,1,11
1948968,1487443,2025-02-12,House,"Reported from Agriculture, Chesapeake and Natural Resources (22-Y 0-N)",22,0,0,0,22
1948968,1491079,2025-02-17,House,"Passed House (95-Y 0-N)",95,0,0,5,100
1948968,1491080,2025-02-17,House,"Passed House (96-Y 0-N)",96,0,0,4,100
1949594,1482143,2025-02-05,Senate,"Rules suspended (40-Y 0-N)",40,0,0,0,40
1951463,1487882,2025-02-12,Senate,"Rules suspended (40-Y 0-N)",40,0,0,0,40
1954798,1490831,2025-02-17,Senate,"Reported from Privileges and Elections (14-Y 0-N)",14,0,0,1,15
1954798,1491434,2025-02-17,Senate,"Reading waived (on 2nd reading) (39-Y 0-N)",39,0,0,1,40
1954798,1491435,2025-02-17,Senate,"Reading waived (on 3rd reading) (38-Y 0-N)",38,0,0,2,40
1954798,1491436,2025-02-17,Senate,"Agreed to by Senate (39-Y 0-N)",39,0,0,1,40
1954798,1493510,2025-02-19,House,"Reported from Privileges and Elections (22-Y 0-N)",22,0,0,0,22
1954798,1503718,2025-02-21,House,"Agreed to by House (97-Y 0-N)",97,0,0,3,100
1955042,1485976,2025-02-11,Senate,"Rules suspended (38-Y 0-N)",38,0,0,2,40
1961603,1490744,2025-02-12,Senate,"Rules suspended (40-Y 0-N)",40,0,0,0,40
1968964,1491277,2025-02-17,Senate,"Rules suspended (36-Y 0-N)",36,0,0,4,40
1970888,1490786,2025-02-17,House,"Reported from Rules (18-Y 0-N)",18,0,0,0,18
1970888,1497184,2025-02-20,House,"Agreed to by House (98-Y 0-N)",98,0,0,2,100
1971009,1490779,2025-02-17,House,"Reported from Rules (18-Y 0-N)",18,0,0,0,18
1971009,1496830,2025-02-20,House,"Agreed to by House (98-Y 0-N)",98,0,0,2,100
1971009,1496831,2025-02-21,Senate,"Reported from Rules (12-Y 0-N)",12,0,0,3,15
1971009,1504052,2025-02-22,Senate,"Reading waived (on 3rd reading) (37-Y 0-N)",37,0,0,3,40
1971009,1504053,2025-02-22,Senate,"Agreed to by Senate (40-Y 0-N)",40,0,0,0,40
1973773,1496719,2025-02-21,Senate,"Reported from Rules (11-Y 0-N)",11,0,0,4,15
1973773,1503281,2025-02-22,Senate,"Reading waived (on 2nd reading) (40-Y 0-N)",40,0,0,0,40
1973773,1503282,2025-02-22,Senate,"Reading waived (on 3rd reading) (40-Y 0-N)",40,0,0,0,40
1973773,1503283,2025-02-22,Senate,"Agreed to by Senate (40-Y 0-N)",40,0,0,0,40
1974637,1494216,2025-02-19,House,"Agreed to by House (97-Y 0-N)",97,0,0,3,100
1974637,1494217,2025-02-19,House,"Waive reading of Report (96-Y 1-N)",96,1,0,3,100
1974637,1494218,2025-02-19,Senate,"Agreed to by Senate (40-Y 0-N)",40,0,0,0,40
1974637,1565104,2025-02-19,Senate,"Taken up for immediate consideration",40,0,0,0,40
1975295,1493218,2025-02-19,House,"VOTE: Adoption (97-Y 0-N)",97,0,0,3,100
1975345,1497177,2025-02-19,Senate,"Rules suspended (40-Y 0-N)",40,0,0,0,40
1975399,1493220,2025-02-19,House,"VOTE: Adoption (97-Y 0-N)",97,0,0,3,100
1975452,1493223,2025-02-19,House,"VOTE: Adoption (97-Y 0-N)",97,0,0,3,100
1975500,1493224,2025-02-19,House,"VOTE: Adoption (97-Y 0-N)",97,0,0,3,100
1975552,1497176,2025-02-19,Senate,"Rules suspended (40-Y 0-N)",40,0,0,0,40
1975600,1497175,2025-02-19,Senate,"Rules suspended (40-Y 0-N)",40,0,0,0,40
1975646,1497178,2025-02-19,Senate,"Rules suspended (40-Y 0-N)",40,0,0,0,40
1975999,1496491,2025-02-21,Senate,"Rules suspended (40-Y 0-N)",40,0,0,0,40
1976766,1497180,2025-02-20,Senate,"Rules suspended (39-Y 0-N)",39,0,0,1,40
