bill_id,roll_call_id,date,chamber,description,yea,nay,nv,absent,total
1801162,1479224,2025-02-03,Senate,"Senate Health, Human Services and Senior Citizens Committee: Reported Favorably",8,0,0,0,8
1801184,1457111,2024-06-13,Senate,"Senate Law and Public Safety Committee: Reported with Amendments",4,0,1,0,5
1801184,1461646,2024-06-28,Senate,"Senate Floor: Third Reading - Final Passage",37,3,0,0,40
1801199,1409368,2024-03-14,Senate,"Senate Environment and Energy Committee: Reported with Substitution",3,2,0,0,5
1801211,1443821,2024-05-16,Senate,"Senate Military and Veterans' Affairs Committee: Reported Favorably",5,0,0,0,5
1801231,1478932,2025-02-03,Senate,"Senate Health, Human Services and Senior Citizens Committee: Reported with Amendments",8,0,0,0,8
1801232,1452811,2024-06-03,Senate,"Senate Transportation Committee: Reported Favorably",6,0,0,0,6
1801241,1455718,2024-06-10,Senate,"Senate Economic Growth Committee: Reported Favorably",5,0,0,0,5
1801241,1478048,2025-01-30,Senate,"Senate Floor: Third Reading - Final Passage",37,0,3,0,40
1801277,1468614,2024-10-10,Senate,"Senate Economic Growth Committee: Reported with Amendments",5,0,0,0,5
1801281,1369539,2024-01-25,Senate,"Senate Labor Committee: Reported with Amendments",3,0,2,0,5
1801286,1392364,2024-02-22,Senate,"Senate Health, Human Services and Senior Citizens Committee: Reported with Substitution",5,1,2,0,8
1801292,1369477,2024-01-25,Senate,"Senate Transportation Committee: Reported with Amendments",5,0,1,0,6
1801299,1443722,2024-05-16,Senate,"Senate Judiciary Committee: Reported Favorably",11,0,0,0,11
1801300,1379932,2024-02-08,Senate,"Senate Law and Public Safety Committee: Reported Favorably",5,0,0,0,5
1801300,1381626,2024-02-12,Senate,"Senate Floor: Third Reading - Final Passage (Voice Vote)",0,0,0,0,0
1801301,1485146,2025-02-10,Senate,"Senate Higher Eduction Committee: Reported with Amendments",5,0,0,0,5
1801310,1468638,2024-10-10,Senate,"Senate Commerce Committee: Reported with Amendments",4,1,0,0,5
1801329,1442863,2024-05-13,Senate,"Senate Environment and Energy Committee: Reported with Amendments",3,2,0,0,5
1801329,1467734,2024-09-30,Senate,"Senate Floor: Second Reading (Voice Vote)",0,0,0,0,0
1801329,1467850,2024-09-30,Senate,"Senate Floor: Amend",31,0,9,0,40
1801335,1468640,2024-10-10,Senate,"Senate Environment and Energy Committee: Reported Favorably",5,0,0,0,5
1801340,1439495,2024-05-06,Senate,"Senate Education Committee: Reported Favorably",5,0,0,0,5
1801344,1518808,2025-03-17,Senate,"Senate Community and Urban Affairs Committee: Reported Favorably",4,0,1,0,5
1801350,1485168,2025-02-10,Senate,"Senate Environment and Energy Committee: Reported with Amendments",5,0,0,0,5
1801357,1518850,2025-03-17,Senate,"Senate Community and Urban Affairs Committee: Reported with Amendments",4,0,1,0,5
1801377,1573209,2025-05-19,Senate,"Senate Health, Human Services and Senior Citizens Committee: Reported Favorably",8,0,0,0,8
1801382,1468995,2024-10-28,Senate,"Senate Health, Human Services and Senior Citizens Committee: Reported with Amendments",8,0,0,0,8
1801382,1469876,2024-12-09,Senate,"Senate Health, Human Services and Senior Citizens Committee: Reported with Amendments",7,0,1,0,8
1801384,1443625,2024-05-16,Senate,"Senate Economic Growth Committee: Reported with Amendments",5,0,0,0,5
1801416,1470439,2024-12-16,Senate,"Senate Judiciary Committee: Reported with Amendments",11,0,0,0,11
1801423,1458678,2024-06-20,Senate,"Senate Health, Human Services and Senior Citizens Committee: Reported with Amendments",8,0,0,0,8
1801426,1369476,2024-01-25,Senate,"Senate Transportation Committee: Reported Favorably",5,0,1,0,6
1801426,1458998,2024-06-24,Senate,"Senate Budget and Appropriations Committee: Reported with Amendments",12,0,1,0,13
1801427,1385549,2024-02-15,Senate,"Senate Education Committee: Reported Favorably",5,0,0,0,5
1801427,1411954,2024-03-18,Senate,"Senate Floor: Third Reading - Final Passage",38,0,2,0,40
1801462,1503831,2025-03-03,Senate,"Senate Military and Veterans' Affairs Committee: Reported Favorably",5,0,0,0,5
1801462,1595944,2025-06-26,Senate,"Senate Budget and Appropriations Committee: Reported Favorably",13,0,0,0,13
1801476,1518436,2025-03-17,Senate,"Senate Education Committee: Reported Favorably",5,0,0,0,5
1801487,1441736,2024-05-09,Senate,"Senate Health, Human Services and Senior Citizens Committee: Reported with Amendments",8,0,0,0,8
1801502,1409630,2024-03-14,Senate,"Senate Health, Human Services and Senior Citizens Committee: Reported Favorably",8,0,0,0,8
1801513,1403091,2024-03-04,Senate,"Senate Environment and Energy Committee: Reported Favorably",3,2,0,0,5
1801521,1439800,2024-05-06,Senate,"Senate Education Committee: Reported Favorably",5,0,0,0,5
1801521,1445065,2024-05-20,Senate,"Senate Floor: Third Reading - Final Passage",37,0,3,0,40
1801525,1454778,2024-06-06,Senate,"Senate Health, Human Services and Senior Citizens Committee: Reported Favorably",8,0,0,0,8
1801529,1375771,2024-02-05,Senate,"Senate Commerce Committee: Reported with Amendments",5,0,0,0,5
1801529,1381334,2024-02-12,Senate,"Senate Floor: Third Reading - Final Passage",37,0,3,0,40
1801531,1369454,2024-01-25,Senate,"Senate Community and Urban Affairs Committee: Reported with Amendments",5,0,0,0,5
1801531,1407198,2024-03-11,Senate,"Senate Budget and Appropriations Committee: Reported with Amendments",13,0,0,0,13
1801531,1410101,2024-03-18,Assembly,"Assembly Floor: Substitute for A3365 (Voice Vote)",0,0,0,0,0
1801531,1411853,2024-03-18,Assembly,"Assembly Floor: Third Reading - Final Passage",67,8,5,0,80
1801531,1411854,2024-03-18,Senate,"Senate Floor: Third Reading - Final Passage",32,4,4,0,40
1801533,1386293,2024-02-15,Senate,"Senate Community and Urban Affairs Committee: Reported with Amendments",4,0,1,0,5
1801533,1411671,2024-03-18,Senate,"Senate Floor: Third Reading - Final Passage",37,0,3,0,40
1801533,1523374,2025-03-20,Assembly,"Assembly Housing and Community Development Committee: Reported with Amendments",6,0,1,0,7
1801533,1572089,2025-05-15,Assembly,"Assembly Appropriations Committee: Reported Favorably",11,0,0,0,11
1801533,1575898,2025-05-22,Assembly,"Assembly Floor: Substitute for A3363 (Voice Vote)",0,0,0,0,0
1801533,1576564,2025-05-22,Assembly,"Assembly Floor: Third Reading - Final Passage",76,1,3,0,80
1801533,1583734,2025-06-02,Senate,"Senate Floor: Concur in Assembly Amendments",38,0,2,0,40
1801535,1369453,2024-01-25,Senate,"Senate Community and Urban Affairs Committee: Reported Favorably",5,0,0,0,5
1801535,1407211,2024-03-11,Senate,"Senate Budget and Appropriations Committee: Reported with Substitution",13,0,0,0,13
1801539,1467847,2024-09-30,Senate,"Senate Transportation Committee: Reported Favorably",6,0,0,0,6
1801555,1443841,2024-05-16,Senate,"Senate Economic Growth Committee: Reported with Amendments",5,0,0,0,5
1801557,1410813,2024-03-18,Senate,"Senate State Government, Wagering, Tourism & Historic Preservation Committee: Reported with Amendments",3,2,0,0,5
1801557,1479000,2025-02-03,Senate,"Senate Budget and Appropriations Committee: Reported with Amendments",9,3,1,0,13
1801557,1596616,2025-06-30,Senate,"Senate Floor: Third Reading - Final Passage",25,14,1,0,40
1801558,1404052,2024-02-12,Senate,"Senate State Government, Wagering, Tourism & Historic Preservation Committee: Reported Favorably",5,0,0,0,5
1801564,1457902,2024-06-17,Senate,"Senate Community and Urban Affairs Committee: Reported Favorably",3,1,1,0,5
1801564,1468208,2024-10-07,Senate,"Senate Budget and Appropriations Committee: Reported with Amendments",10,3,0,0,13
1801564,1469019,2024-10-28,Senate,"Senate Floor: Third Reading - Final Passage",27,12,1,0,40
1801564,1469868,2024-12-09,Assembly,"Assembly Telecommunications and Utilities Committee: Reported with Amendments",6,2,0,0,8
1801573,1470811,2024-12-19,Senate,"Senate Health, Human Services and Senior Citizens Committee: Reported Favorably",8,0,0,0,8
1801583,1409445,2024-03-14,Senate,"Senate Health, Human Services and Senior Citizens Committee: Reported Favorably",8,0,0,0,8
1801583,1469894,2024-12-09,Senate,"Senate Budget and Appropriations Committee: Reported with Amendments",13,0,0,0,13
1801588,1468244,2024-10-07,Senate,"Senate Health, Human Services and Senior Citizens Committee: Reported with Substitution",8,0,0,0,8
1801588,1469881,2024-12-09,Senate,"Senate Budget and Appropriations Committee: Reported Favorably",13,0,0,0,13
1801610,1443775,2024-05-16,Senate,"Senate Law and Public Safety Committee: Reported with Amendments",4,0,1,0,5
1801636,1385974,2024-02-15,Senate,"Senate Transportation Committee: Reported with Substitution",5,0,1,0,6
1801636,1469878,2024-12-09,Senate,"Senate Budget and Appropriations Committee: Reported with Amendments",13,0,0,0,13
1801644,1379577,2024-02-08,Senate,"Senate Law and Public Safety Committee: Reported with Amendments",3,2,0,0,5
1801644,1381309,2024-02-12,Senate,"Senate Floor: Third Reading - Final Passage",21,15,4,0,40
1801646,1469895,2024-12-09,Senate,"Senate Health, Human Services and Senior Citizens Committee: Reported with Amendments",8,0,0,0,8
1801656,1585598,2025-06-05,Senate,"Senate Education Committee: Reported with Amendments",3,2,0,0,5
1801661,1439697,2024-05-06,Senate,"Senate Transportation Committee: Reported Favorably",5,0,1,0,6
1801670,1592848,2025-06-19,Senate,"Senate Military and Veterans' Affairs Committee: Reported Favorably",5,0,0,0,5
1801673,1469817,2024-12-05,Senate,"Senate Education Committee: Reported with Amendments",5,0,0,0,5
1801673,1470876,2024-12-19,Senate,"Senate Floor: Third Reading - Final Passage",38,0,2,0,40
1801673,1525463,2025-03-24,Assembly,"Assembly Floor: Substitute for A1028 (Voice Vote)",0,0,0,0,0
1801673,1525464,2025-03-24,Assembly,"Assembly Floor: Third Reading - Final Passage",76,0,4,0,80
1801678,1379074,2024-02-08,Senate,"Senate Military and Veterans' Affairs Committee: Reported Favorably",5,0,0,0,5
1801696,1518521,2025-03-17,Senate,"Senate Community and Urban Affairs Committee: Reported with Substitution",3,1,1,0,5
1801699,1452624,2024-06-03,Senate,"Senate Transportation Committee: Reported Favorably",4,2,0,0,6
1801710,1523152,2025-03-17,Senate,"Senate Environment and Energy Committee: Reported Favorably",3,2,0,0,5
1801721,1375724,2024-02-05,Senate,"Senate Environment and Energy Committee: Reported Favorably",5,0,0,0,5
1801731,1369638,2024-01-25,Senate,"Senate Community and Urban Affairs Committee: Reported with Amendments",5,0,0,0,5
1801731,1407159,2024-03-11,Senate,"Senate Budget and Appropriations Committee: Reported with Amendments",13,0,0,0,13
1801734,1442426,2024-05-13,Senate,"Senate Commerce Committee: Reported with Amendments",5,0,0,0,5
1801734,1518855,2025-03-17,Senate,"Senate Budget and Appropriations Committee: Reported with Amendments",13,0,0,0,13
1801738,1369452,2024-01-25,Senate,"Senate Education Committee: Reported Favorably",5,0,0,0,5
1801753,1405027,2024-03-07,Senate,"Senate Law and Public Safety Committee: Reported with Amendments",5,0,0,0,5
1801759,1485638,2025-02-10,Senate,"Senate Environment and Energy Committee: Reported Favorably",5,0,0,0,5
1801768,1503128,2025-03-03,Senate,"Senate Military and Veterans' Affairs Committee: Reported with Amendments",5,0,0,0,5
1801768,1583996,2025-06-02,Senate,"Senate Floor: Third Reading - Final Passage",38,0,2,0,40
1801771,1589531,2025-06-12,Senate,"Senate Commerce Committee: Reported Favorably",5,0,0,0,5
1801780,1471275,2025-01-13,Senate,"Senate Environment and Energy Committee: Reported with Substitution",4,0,1,0,5
1801780,1525401,2025-03-24,Senate,"Senate Floor: Third Reading - Final Passage",39,0,1,0,40
1801782,1477491,2025-01-30,Senate,"Senate Education Committee: Reported Favorably",5,0,0,0,5
1801799,1371039,2024-01-29,Senate,"Senate Health, Human Services and Senior Citizens Committee: Reported with Amendments",8,0,0,0,8
1801799,1381396,2024-02-12,Senate,"Senate Floor: Third Reading - Final Passage",37,0,3,0,40
1801799,1442355,2024-05-13,Assembly,"Assembly Community Development and Womens Affairs Committee Committee: Reported Favorably",6,0,0,0,6
1801799,1467626,2024-09-26,Assembly,"Assembly Floor: Substitute for A3887 (Voice Vote)",0,0,0,0,0
1801799,1467687,2024-09-26,Assembly,"Assembly Floor: Third Reading - Final Passage",74,0,6,0,80
1801801,1455719,2024-06-10,Senate,"Senate Economic Growth Committee: Reported with Amendments",5,0,0,0,5
1801801,1478980,2025-02-03,Senate,"Senate Budget and Appropriations Committee: Reported with Amendments",12,0,1,0,13
1801801,1525040,2025-03-24,Senate,"Senate Floor: Third Reading - Final Passage",39,0,1,0,40
1801809,1457918,2024-06-17,Senate,"Senate State Government, Wagering, Tourism & Historic Preservation Committee: Reported Favorably",5,0,0,0,5
1801810,1441696,2024-05-09,Senate,"Senate Health, Human Services and Senior Citizens Committee: Reported with Substitution",5,3,0,0,8
1801810,1458993,2024-06-24,Senate,"Senate Budget and Appropriations Committee: Reported with Amendments",10,2,1,0,13
1801810,1461408,2024-06-28,Assembly,"Assembly Floor: Substitute for A1970 (Voice Vote)",0,0,0,0,0
1801810,1461496,2024-06-28,Assembly,"Assembly Floor: Third Reading - Final Passage",64,7,9,0,80
1801810,1461497,2024-06-28,Senate,"Senate Floor: Third Reading - Final Passage",27,12,1,0,40
1801817,1369478,2024-01-25,Senate,"Senate Transportation Committee: Reported with Amendments",5,0,1,0,6
1801817,1381722,2024-02-12,Senate,"Senate Floor: Third Reading - Final Passage",37,0,3,0,40
1801817,1454629,2024-06-06,Assembly,"Assembly Transportation and Independent Authorities Committee: Reported Favorably",11,0,2,0,13
1801817,1467630,2024-09-26,Assembly,"Assembly Floor: Substitute for AJR48 (Voice Vote)",0,0,0,0,0
1801817,1467701,2024-09-26,Assembly,"Assembly Floor: Third Reading - Final Passage",76,0,4,0,80
1801825,1401986,2024-03-04,Senate,"Senate Higher Eduction Committee: Reported Favorably",5,0,0,0,5
1801830,1379829,2024-02-08,Senate,"Senate Military and Veterans' Affairs Committee: Reported with Amendments",5,0,0,0,5
1801844,1385943,2024-02-15,Senate,"Senate Community and Urban Affairs Committee: Reported with Substitution",3,1,1,0,5
1801854,1485173,2025-02-10,Senate,"Senate Higher Eduction Committee: Reported with Amendments",5,0,0,0,5
1801868,1569622,2025-05-12,Senate,"Senate Transportation Committee: Reported with Amendments",6,0,0,0,6
1801875,1478942,2025-02-03,Senate,"Senate Health, Human Services and Senior Citizens Committee: Reported with Amendments",8,0,0,0,8
1801882,1454584,2024-06-06,Senate,"Senate Health, Human Services and Senior Citizens Committee: Reported with Substitution",6,2,0,0,8
1801882,1468217,2024-10-07,Senate,"Senate Budget and Appropriations Committee: Reported with Amendments",12,0,1,0,13
1801884,1525340,2025-03-24,Senate,"Senate Judiciary Committee: Reported with Amendments",11,0,0,0,11
1801884,1583762,2025-06-02,Senate,"Senate Floor: Third Reading - Final Passage",38,0,2,0,40
1801894,1455733,2024-06-10,Senate,"Senate Commerce Committee: Reported with Amendments",3,1,1,0,5
1801894,1470861,2024-12-19,Senate,"Senate Floor: Third Reading - Final Passage",32,3,5,0,40
1801894,1544788,2025-04-10,Assembly,"Assembly Regulated Professions Committee: Reported Favorably",5,0,2,0,7
1801897,1524702,2025-03-24,Senate,"Senate Commerce Committee: Reported with Amendments",5,0,0,0,5
1801910,1524925,2025-03-24,Senate,"Senate Commerce Committee: Reported Favorably",5,0,0,0,5
1801911,1375687,2024-02-05,Senate,"Senate Environment and Energy Committee: Reported Favorably",3,2,0,0,5
1801915,1371224,2024-01-29,Senate,"Senate Health, Human Services and Senior Citizens Committee: Reported with Amendments",5,1,2,0,8
1801931,1369496,2024-01-25,Senate,"Senate Labor Committee: Reported Favorably",3,0,2,0,5
1801952,1409642,2024-03-14,Senate,"Senate Health, Human Services and Senior Citizens Committee: Reported with Amendments",7,1,0,0,8
1801952,1445015,2024-05-20,Senate,"Senate Floor: Third Reading - Final Passage",37,0,3,0,40
1801953,1405348,2024-03-07,Senate,"Senate Law and Public Safety Committee: Reported with Amendments",5,0,0,0,5
1801965,1455727,2024-06-10,Senate,"Senate Commerce Committee: Reported Favorably",5,0,0,0,5
1801965,1469862,2024-12-09,Senate,"Senate Budget and Appropriations Committee: Reported with Substitution",13,0,0,0,13
1801992,1457929,2024-06-17,Senate,"Senate State Government, Wagering, Tourism & Historic Preservation Committee: Reported Favorably",5,0,0,0,5
1801992,1469015,2024-10-28,Senate,"Senate Floor: Third Reading - Final Passage",40,0,0,0,40
1801992,1469297,2024-11-14,Assembly,"Assembly Tourism, Gaming and the Arts Committee: Reported Favorably",5,0,1,0,6
1802004,1442844,2024-05-13,Senate,"Senate Environment and Energy Committee: Reported Favorably",5,0,0,0,5
1802005,1441914,2024-05-09,Senate,"Senate Health, Human Services and Senior Citizens Committee: Reported with Amendments",8,0,0,0,8
1802005,1469000,2024-10-28,Senate,"Senate Floor: Third Reading - Final Passage",40,0,0,0,40
1802014,1478692,2025-02-03,Senate,"Senate Health, Human Services and Senior Citizens Committee: Reported Favorably",8,0,0,0,8
1802019,1503429,2025-03-03,Senate,"Senate Military and Veterans' Affairs Committee: Reported Favorably",5,0,0,0,5
1802021,1470398,2024-12-16,Senate,"Senate Military and Veterans' Affairs Committee: Reported Favorably",4,0,1,0,5
1802032,1459441,2024-06-24,Senate,"Senate Budget and Appropriations Committee: Reported with Amendments",12,0,1,0,13
1802032,1461650,2024-06-28,Senate,"Senate Floor: Third Reading - Final Passage",40,0,0,0,40
1802032,1467492,2024-09-19,Assembly,"Assembly State and Local Government Committee: Reported with Amendments",7,0,0,0,7
1802032,1469024,2024-10-28,Assembly,"Assembly Floor: Substitute for A2286 (Voice Vote)",0,0,0,0,0
1802032,1469025,2024-10-28,Assembly,"Assembly Floor: Third Reading - Final Passage",77,0,3,0,80
1802032,1469026,2024-10-28,Senate,"Senate Floor: Concur in Assembly Amendments",40,0,0,0,40
1802040,1477536,2025-01-30,Senate,"Senate Education Committee: Reported Favorably",5,0,0,0,5
1802058,1392021,2024-02-22,Senate,"Senate Health, Human Services and Senior Citizens Committee: Reported Favorably",7,0,1,0,8
1802066,1498883,2025-02-25,Senate,"Senate State Government, Wagering, Tourism & Historic Preservation Committee: Reported Favorably",5,0,0,0,5
1802066,1530654,2025-03-24,Senate,"Senate Floor: Reconsidered Vote",31,0,9,0,40
1802066,1530655,2025-03-24,Senate,"Senate Floor: Third Reading - Final Passage",32,0,8,0,40
1802073,1454575,2024-06-06,Senate,"Senate Health, Human Services and Senior Citizens Committee: Reported with Amendments",8,0,0,0,8
1802083,1369458,2024-01-25,Senate,"Senate Education Committee: Reported Favorably",5,0,0,0,5
1802084,1468740,2024-10-21,Senate,"Senate Law and Public Safety Committee: Reported with Amendments",5,0,0,0,5
1802084,1595796,2025-06-26,Senate,"Senate Budget and Appropriations Committee: Reported with Substitution",9,4,0,0,13
1802097,1522723,2025-03-17,Senate,"Senate Environment and Energy Committee: Reported with Amendments",5,0,0,0,5
1802097,1586711,2025-06-09,Senate,"Senate Budget and Appropriations Committee: Reported with Amendments",12,0,1,0,13
1802100,1392227,2024-02-22,Senate,"Senate Health, Human Services and Senior Citizens Committee: Reported Favorably",7,0,1,0,8
1802127,1392146,2024-02-22,Senate,"Senate Health, Human Services and Senior Citizens Committee: Reported with Substitution",7,0,1,0,8
1802134,1461460,2024-06-28,Senate,"Senate Judiciary Committee: Reported with Amendments",11,0,0,0,11
1802141,1592990,2025-06-19,Senate,"Senate Law and Public Safety Committee: Reported with Amendments",3,1,1,0,5
1802142,1402551,2024-03-04,Senate,"Senate Economic Growth Committee: Reported Favorably",5,0,0,0,5
1802147,1576266,2025-05-22,Senate,"Senate Economic Growth Committee: Reported Favorably",3,2,0,0,5
1802153,1467772,2024-09-30,Senate,"Senate Transportation Committee: Reported with Amendments",6,0,0,0,6
1802156,1573082,2025-05-19,Senate,"Senate Health, Human Services and Senior Citizens Committee: Reported Favorably",5,3,0,0,8
1802165,1576411,2025-05-22,Senate,"Senate Environment and Energy Committee: Reported with Amendments",5,0,0,0,5
1802181,1441841,2024-05-09,Senate,"Senate Health, Human Services and Senior Citizens Committee: Reported with Amendments",8,0,0,0,8
1802186,1470406,2024-12-16,Senate,"Senate Military and Veterans' Affairs Committee: Reported Favorably",4,0,1,0,5
1802188,1458629,2024-06-20,Senate,"Senate Education Committee: Reported Favorably",5,0,0,0,5
1802192,1443748,2024-05-16,Senate,"Senate Economic Growth Committee: Reported Favorably",5,0,0,0,5
1802192,1460802,2024-06-26,Senate,"Senate Budget and Appropriations Committee: Reported with Amendments",13,0,0,0,13
1802192,1470789,2024-12-19,Assembly,"Assembly Floor: Substitute for A2076 (Voice Vote)",0,0,0,0,0
1802192,1470790,2024-12-19,Assembly,"Assembly Floor: Table Motion",41,27,12,0,80
1802192,1470791,2024-12-19,Assembly,"Assembly Floor: Third Reading - Final Passage",49,22,9,0,80
1802192,1470792,2024-12-19,Senate,"Senate Floor: Concur in Assembly Amendments",38,0,2,0,40
1802192,1470793,2024-12-19,Senate,"Senate Floor: Third Reading - Final Passage",37,0,3,0,40
1802200,1441784,2024-05-09,Senate,"Senate Health, Human Services and Senior Citizens Committee: Reported Favorably",8,0,0,0,8
1802200,1442509,2024-05-13,Senate,"Senate Floor: Third Reading - Final Passage",37,0,3,0,40
1802210,1469805,2024-12-05,Senate,"Senate Community and Urban Affairs Committee: Reported Favorably",4,0,1,0,5
1802210,1477829,2025-01-30,Senate,"Senate Floor: Third Reading - Final Passage",37,0,3,0,40
1802222,1468641,2024-10-10,Senate,"Senate Commerce Committee: Reported with Substitution",5,0,0,0,5
1802222,1519050,2025-03-17,Senate,"Senate Budget and Appropriations Committee: Reported with Amendments",13,0,0,0,13
1802223,1458641,2024-06-20,Senate,"Senate State Government, Wagering, Tourism & Historic Preservation Committee: Reported with Amendments",4,1,0,0,5
1802231,1439502,2024-05-06,Senate,"Senate Education Committee: Reported Favorably",4,1,0,0,5
1802240,1405363,2024-03-07,Senate,"Senate Law and Public Safety Committee: Reported Favorably",5,0,0,0,5
1802240,1411889,2024-03-18,Senate,"Senate Floor: Third Reading - Final Passage",38,0,2,0,40
1802240,1454531,2024-06-06,Assembly,"Assembly Judiciary Committee: Reported Favorably",6,0,0,0,6
1802240,1461699,2024-06-28,Assembly,"Assembly Floor: Substitute for A3748 (Voice Vote)",0,0,0,0,0
1802240,1461700,2024-06-28,Assembly,"Assembly Floor: Third Reading - Final Passage",77,0,3,0,80
1802241,1569424,2025-05-12,Senate,"Senate Transportation Committee: Reported Favorably",6,0,0,0,6
1802260,1467780,2024-09-30,Senate,"Senate Education Committee: Reported with Substitution",5,0,0,0,5
1802262,1442885,2024-05-13,Senate,"Senate Environment and Energy Committee: Reported with Amendments",3,2,0,0,5
1802262,1461472,2024-06-28,Senate,"Senate Floor: Third Reading - Final Passage",21,15,4,0,40
1802263,1392264,2024-02-22,Senate,"Senate Health, Human Services and Senior Citizens Committee: Reported with Substitution",5,1,2,0,8
1802304,1457124,2024-06-13,Senate,"Senate Military and Veterans' Affairs Committee: Reported Favorably",5,0,0,0,5
1802307,1455685,2024-06-10,Senate,"Senate Higher Eduction Committee: Reported with Amendments",5,0,0,0,5
1802312,1369455,2024-01-25,Senate,"Senate Community and Urban Affairs Committee: Reported with Amendments",5,0,0,0,5
1802312,1460793,2024-06-26,Senate,"Senate Budget and Appropriations Committee: Reported with Amendments",13,0,0,0,13
1802312,1461625,2024-06-28,Senate,"Senate Floor: Third Reading - Final Passage",39,0,1,0,40
1802312,1469012,2024-10-28,Assembly,"Assembly Floor: Substitute for A586 (Voice Vote)",0,0,0,0,0
1802312,1469013,2024-10-28,Assembly,"Assembly Floor: Third Reading - Final Passage",76,0,4,0,80
1802321,1409780,2024-02-08,Senate,"Senate Judiciary Committee: Reported Favorably",11,0,0,0,11
1802321,1411606,2024-03-18,Senate,"Senate Floor: Third Reading - Final Passage",38,0,2,0,40
1802321,1444931,2024-05-20,Assembly,"Assembly Judiciary Committee: Reported with Amendments",6,0,0,0,6
1802321,1526166,2025-03-24,Assembly,"Assembly Floor: Substitute for A1992 (Voice Vote)",0,0,0,0,0
1802321,1526167,2025-03-24,Assembly,"Assembly Floor: Third Reading - Final Passage",78,0,2,0,80
1802328,1485064,2025-02-10,Senate,"Senate Commerce Committee: Reported with Amendments",3,2,0,0,5
1802339,1469790,2024-12-05,Senate,"Senate Education Committee: Reported with Amendments",4,1,0,0,5
1802366,1402792,2024-03-04,Senate,"Senate Environment and Energy Committee: Reported with Amendments",3,2,0,0,5
1802373,1376144,2024-02-05,Senate,"Senate Higher Eduction Committee: Reported Favorably",5,0,0,0,5
1802373,1382043,2024-02-12,Senate,"Senate Floor: Third Reading - Final Passage",37,0,3,0,40
1802373,1452642,2024-06-03,Assembly,"Assembly Higher Education Committee: Reported Favorably",6,0,1,0,7
1802373,1473505,2025-01-23,Assembly,"Assembly Military and Veterans' Affairs Committee: Reported Favorably",6,0,0,0,6
1802373,1477299,2025-01-30,Assembly,"Assembly Floor: Substitute for A3803 (Voice Vote)",0,0,0,0,0
1802373,1477827,2025-01-30,Assembly,"Assembly Floor: Third Reading - Final Passage",75,0,5,0,80
1802386,1369475,2024-01-25,Senate,"Senate Transportation Committee: Reported Favorably",5,0,1,0,6
1802386,1382534,2024-02-12,Senate,"Senate Floor: Third Reading - Final Passage",37,0,3,0,40
1802386,1402668,2024-03-04,Assembly,"Assembly Transportation and Independent Authorities Committee: Reported Favorably",13,0,0,0,13
1802386,1410590,2024-03-18,Assembly,"Assembly Floor: Substitute for A1490 (Voice Vote)",0,0,0,0,0
1802386,1411635,2024-03-18,Assembly,"Assembly Floor: Third Reading - Final Passage",68,7,5,0,80
1802393,1375729,2024-02-05,Senate,"Senate Environment and Energy Committee: Reported Favorably",4,1,0,0,5
1802438,1585437,2025-06-05,Senate,"Senate Education Committee: Reported with Amendments",5,0,0,0,5
1802438,1595797,2025-06-26,Senate,"Senate Budget and Appropriations Committee: Reported with Amendments",13,0,0,0,13
1802438,1596543,2025-06-30,Assembly,"Assembly Floor: Substitute for A1406 (Voice Vote)",0,0,0,0,0
1802438,1596849,2025-06-30,Assembly,"Assembly Floor: Third Reading - Final Passage",79,0,1,0,80
1802438,1596850,2025-06-30,Senate,"Senate Floor: Third Reading - Final Passage",39,0,1,0,40
1802447,1452871,2024-06-03,Senate,"Senate Transportation Committee: Reported Favorably",6,0,0,0,6
1802447,1458913,2024-06-24,Senate,"Senate Budget and Appropriations Committee: Reported Favorably",12,0,1,0,13
1802447,1461622,2024-06-28,Senate,"Senate Floor: Third Reading - Final Passage",40,0,0,0,40
1802447,1467462,2024-09-19,Assembly,"Assembly Transportation and Independent Authorities Committee: Reported Favorably",12,0,1,0,13
1802447,1496047,2025-02-20,Assembly,"Assembly Appropriations Committee: Reported Favorably",10,0,1,0,11
1802447,1501966,2025-02-27,Assembly,"Assembly Floor: Substitute for A2609 (Voice Vote)",0,0,0,0,0
1802447,1502230,2025-02-27,Assembly,"Assembly Floor: Third Reading - Final Passage",73,0,7,0,80
1802459,1369070,2024-01-25,Senate,"Senate Labor Committee: Reported Favorably",3,0,2,0,5
1802459,1381312,2024-02-12,Senate,"Senate Floor: Third Reading - Final Passage",22,14,4,0,40
1802477,1467843,2024-09-30,Senate,"Senate Transportation Committee: Reported with Amendments",6,0,0,0,6
1802477,1478975,2025-02-03,Senate,"Senate Budget and Appropriations Committee: Reported with Amendments",12,0,1,0,13
1802502,1443777,2024-05-16,Senate,"Senate Military and Veterans' Affairs Committee: Reported Favorably",5,0,0,0,5
1802505,1470436,2024-12-16,Senate,"Senate State Government, Wagering, Tourism & Historic Preservation Committee: Reported Favorably",4,0,1,0,5
1802510,1477502,2025-01-30,Senate,"Senate Community and Urban Affairs Committee: Reported Favorably",5,0,0,0,5
1802519,1522813,2025-03-17,Senate,"Senate Environment and Energy Committee: Reported with Amendments",5,0,0,0,5
1802547,1409153,2024-03-14,Senate,"Senate Environment and Energy Committee: Reported with Amendments",3,1,1,0,5
1802552,1439923,2024-05-06,Senate,"Senate Community and Urban Affairs Committee: Reported with Amendments",5,0,0,0,5
1802586,1386291,2024-02-15,Senate,"Senate Transportation Committee: Reported Favorably",5,0,1,0,6
1802604,1457450,2024-06-13,Senate,"Senate Judiciary Committee: Reported with Amendments",11,0,0,0,11
1802606,1470144,2024-12-12,Senate,"Senate Economic Growth Committee: Reported with Amendments",4,0,1,0,5
1802616,1459436,2024-06-24,Senate,"Senate Budget and Appropriations Committee: Reported Favorably",11,0,2,0,13
1802619,1469765,2024-12-05,Senate,"Senate Community and Urban Affairs Committee: Reported with Amendments",4,0,1,0,5
1802621,1369459,2024-01-25,Senate,"Senate Education Committee: Reported with Substitution",5,0,0,0,5
1802621,1381684,2024-02-12,Senate,"Senate Floor: Third Reading - Final Passage",34,1,5,0,40
1802621,1401547,2024-03-04,Assembly,"Assembly Education Committee: Reported with Amendments",9,0,0,0,9
1802621,1410192,2024-03-18,Assembly,"Assembly Floor: Substitute for A3413 (Voice Vote)",0,0,0,0,0
1802621,1411661,2024-03-18,Assembly,"Assembly Floor: Third Reading - Final Passage",73,4,3,0,80
1802621,1442395,2024-05-13,Senate,"Senate Floor: Concur in Assembly Amendments",34,1,5,0,40
1802628,1586778,2025-06-09,Senate,"Senate Health, Human Services and Senior Citizens Committee: Reported Favorably",7,0,1,0,8
1802635,1442446,2024-05-13,Senate,"Senate Commerce Committee: Reported with Amendments",5,0,0,0,5
1802650,1385733,2024-02-15,Senate,"Senate Community and Urban Affairs Committee: Reported with Amendments",4,0,1,0,5
1802651,1469760,2024-12-05,Senate,"Senate Transportation Committee: Reported with Amendments",6,0,0,0,6
1802663,1369473,2024-01-25,Senate,"Senate Transportation Committee: Reported with Amendments",5,0,1,0,6
1802663,1468209,2024-10-07,Senate,"Senate Budget and Appropriations Committee: Reported Favorably",13,0,0,0,13
1802667,1468619,2024-10-10,Senate,"Senate Commerce Committee: Reported with Amendments",3,0,2,0,5
1802668,1477455,2025-01-30,Senate,"Senate Transportation Committee: Reported with Amendments",6,0,0,0,6
1802670,1457930,2024-06-17,Senate,"Senate State Government, Wagering, Tourism & Historic Preservation Committee: Reported with Amendments",5,0,0,0,5
1802670,1458965,2024-06-24,Senate,"Senate Budget and Appropriations Committee: Reported Favorably",12,0,1,0,13
1802675,1469808,2024-12-05,Senate,"Senate Education Committee: Reported Favorably",5,0,0,0,5
1802678,1468626,2024-10-10,Senate,"Senate Economic Growth Committee: Reported Favorably",5,0,0,0,5
1802682,1590087,2025-06-12,Senate,"Senate Environment and Energy Committee: Reported with Amendments",5,0,0,0,5
1802684,1470407,2024-12-16,Senate,"Senate State Government, Wagering, Tourism & Historic Preservation Committee: Reported with Amendments",4,0,1,0,5
1802684,1518430,2025-03-17,Senate,"Senate Budget and Appropriations Committee: Reported with Amendments",10,3,0,0,13
1802693,1470209,2024-12-12,Senate,"Senate Commerce Committee: Reported Favorably",5,0,0,0,5
1802703,1467824,2024-09-30,Senate,"Senate Education Committee: Reported Favorably",4,1,0,0,5
1802726,1503597,2025-03-03,Senate,"Senate Health, Human Services and Senior Citizens Committee: Reported with Substitution",8,0,0,0,8
1802735,1441660,2024-05-09,Senate,"Senate Health, Human Services and Senior Citizens Committee: Reported with Amendments",8,0,0,0,8
1802735,1445098,2024-05-20,Senate,"Senate Floor: Third Reading - Final Passage",37,0,3,0,40
1802752,1409370,2024-03-14,Senate,"Senate Health, Human Services and Senior Citizens Committee: Reported with Amendments",6,0,2,0,8
1802752,1411724,2024-03-18,Senate,"Senate Floor: Third Reading - Final Passage",36,0,4,0,40
1802752,1568196,2025-05-08,Assembly,"Assembly Human Services Committee: Reported Favorably",5,1,0,0,6
1802752,1589811,2025-06-12,Assembly,"Assembly Health Committee: Reported with Amendments",6,2,3,0,11
1802759,1392065,2024-02-22,Senate,"Senate Health, Human Services and Senior Citizens Committee: Reported Favorably",7,0,1,0,8
1802760,1455726,2024-06-10,Senate,"Senate Higher Eduction Committee: Reported Favorably",5,0,0,0,5
1802767,1469770,2024-12-05,Senate,"Senate Labor Committee: Reported with Substitution",4,0,1,0,5
1802804,1525294,2025-03-24,Senate,"Senate Commerce Committee: Reported with Amendments",5,0,0,0,5
1802804,1596494,2025-06-30,Assembly,"Assembly Floor: Substitute for A1446 (Voice Vote)",0,0,0,0,0
1802804,1596708,2025-06-30,Assembly,"Assembly Floor: Third Reading - Final Passage",77,2,1,0,80
1802804,1596709,2025-06-30,Senate,"Senate Floor: Third Reading - Final Passage",39,0,1,0,40
1802822,1385654,2024-02-15,Senate,"Senate Transportation Committee: Reported Favorably",5,0,1,0,6
1802831,1403265,2024-03-04,Senate,"Senate Environment and Energy Committee: Reported Favorably",5,0,0,0,5
1802834,1461470,2024-06-28,Senate,"Senate Judiciary Committee: Reported Favorably",11,0,0,0,11
1802835,1409495,2024-03-14,Senate,"Senate Health, Human Services and Senior Citizens Committee: Reported with Amendments",8,0,0,0,8
1802835,1444904,2024-05-20,Senate,"Senate Floor: Third Reading - Final Passage",37,0,3,0,40
1802845,1489242,2025-02-13,Senate,"Senate Law and Public Safety Committee: Reported with Amendments",5,0,0,0,5
1802859,1585626,2025-06-05,Senate,"Senate Community and Urban Affairs Committee: Reported with Amendments",4,0,1,0,5
1802862,1443772,2024-05-16,Senate,"Senate Law and Public Safety Committee: Reported Favorably",4,0,1,0,5
1802879,1467791,2024-09-30,Senate,"Senate Community and Urban Affairs Committee: Reported Favorably",5,0,0,0,5
1802879,1583711,2025-06-02,Senate,"Senate Floor: Third Reading - Final Passage",38,0,2,0,40
1802883,1376342,2024-02-05,Senate,"Senate Higher Eduction Committee: Reported with Amendments",5,0,0,0,5
1802883,1381394,2024-02-12,Senate,"Senate Floor: Third Reading - Final Passage",37,0,3,0,40
1802883,1484747,2025-02-10,Assembly,"Assembly Higher Education Committee: Reported Favorably",7,0,0,0,7
1802887,1404182,2024-02-12,Senate,"Senate State Government, Wagering, Tourism & Historic Preservation Committee: Reported Favorably",5,0,0,0,5
1802887,1410575,2024-03-18,Assembly,"Assembly Floor: Substitute for A3946 (Voice Vote)",0,0,0,0,0
1802887,1411792,2024-03-18,Assembly,"Assembly Floor: Third Reading - Final Passage",76,1,3,0,80
1802887,1411793,2024-03-18,Senate,"Senate Floor: Concur in Assembly Amendments",36,0,4,0,40
1802887,1411794,2024-03-18,Senate,"Senate Floor: Third Reading - Final Passage",38,0,2,0,40
1802905,1443767,2024-05-16,Senate,"Senate Law and Public Safety Committee: Reported Favorably",4,0,1,0,5
1802907,1467794,2024-09-30,Senate,"Senate Community and Urban Affairs Committee: Reported Favorably",5,0,0,0,5
1802912,1439781,2024-05-06,Senate,"Senate Transportation Committee: Reported Favorably",5,0,1,0,6
1802912,1445181,2024-05-20,Senate,"Senate Floor: Third Reading - Final Passage",37,0,3,0,40
1802912,1568436,2025-05-08,Assembly,"Assembly Transportation and Independent Authorities Committee: Reported with Amendments",12,0,1,0,13
1802912,1575870,2025-05-22,Assembly,"Assembly Floor: Substitute for A2596 (Voice Vote)",0,0,0,0,0
1802912,1576685,2025-05-22,Assembly,"Assembly Floor: Third Reading - Final Passage",77,0,3,0,80
1802912,1597031,2025-06-30,Senate,"Senate Floor: Concur in Assembly Amendments",39,0,1,0,40
1802922,1457906,2024-06-17,Senate,"Senate Community and Urban Affairs Committee: Reported Favorably",4,0,1,0,5
1802922,1468207,2024-10-07,Senate,"Senate Budget and Appropriations Committee: Reported with Amendments",13,0,0,0,13
1802925,1380064,2024-02-08,Senate,"Senate Law and Public Safety Committee: Reported Favorably",5,0,0,0,5
1802930,1385679,2024-02-15,Senate,"Senate Community and Urban Affairs Committee: Reported Favorably",4,0,1,0,5
1802931,1439767,2024-05-06,Senate,"Senate Transportation Committee: Reported Favorably",5,0,1,0,6
1802931,1459709,2024-06-24,Senate,"Senate Budget and Appropriations Committee: Reported Favorably",12,0,1,0,13
1802931,1461605,2024-06-28,Senate,"Senate Floor: Third Reading - Final Passage",40,0,0,0,40
1802931,1470218,2024-12-12,Assembly,"Assembly Transportation and Independent Authorities Committee: Reported with Amendments",13,0,0,0,13
1802933,1443616,2024-05-16,Senate,"Senate Economic Growth Committee: Reported with Amendments",5,0,0,0,5
1802937,1403897,2024-02-12,Senate,"Senate State Government, Wagering, Tourism & Historic Preservation Committee: Reported Favorably",5,0,0,0,5
1802937,1518849,2025-03-17,Senate,"Senate Budget and Appropriations Committee: Reported Favorably",13,0,0,0,13
1802941,1369472,2024-01-25,Senate,"Senate Transportation Committee: Reported Favorably",5,0,1,0,6
1802985,1470197,2024-12-12,Senate,"Senate Environment and Energy Committee: Reported with Substitution",5,0,0,0,5
1802985,1518753,2025-03-17,Senate,"Senate Budget and Appropriations Committee: Reported Favorably",12,0,1,0,13
1802985,1524918,2025-03-24,Senate,"Senate Floor: Third Reading - Final Passage",39,0,1,0,40
1802985,1590970,2025-06-16,Assembly,"Assembly Environment and Solid Waste Committee: Reported Favorably",7,0,0,0,7
1802988,1503324,2025-03-03,Senate,"Senate Labor Committee: Reported with Amendments",4,1,0,0,5
1802997,1468945,2024-10-24,Senate,"Senate State Government, Wagering, Tourism & Historic Preservation Committee: Reported Favorably",4,0,1,0,5
1803000,1471306,2025-01-13,Senate,"Senate Environment and Energy Committee: Reported with Amendments",4,0,1,0,5
1803005,1458659,2024-06-20,Senate,"Senate Environment and Energy Committee: Reported with Amendments",3,2,0,0,5
1803016,1454656,2024-06-06,Senate,"Senate Health, Human Services and Senior Citizens Committee: Reported with Amendments",8,0,0,0,8
1803025,1439780,2024-05-06,Senate,"Senate Education Committee: Reported Favorably",5,0,0,0,5
1803045,1392062,2024-02-22,Senate,"Senate Health, Human Services and Senior Citizens Committee: Reported with Substitution",7,0,1,0,8
1803053,1485594,2025-02-10,Senate,"Senate Economic Growth Committee: Reported with Amendments",4,0,1,0,5
1803056,1468625,2024-10-10,Senate,"Senate Environment and Energy Committee: Reported Favorably",5,0,0,0,5
1803059,1369456,2024-01-25,Senate,"Senate Community and Urban Affairs Committee: Reported with Amendments",5,0,0,0,5
1803059,1381343,2024-02-12,Senate,"Senate Floor: Third Reading - Final Passage",22,15,3,0,40
1803059,1392664,2024-02-22,Assembly,"Assembly Housing and Community Development Committee: Reported Favorably",5,0,2,0,7
1803059,1458948,2024-06-24,Assembly,"Assembly Appropriations Committee: Reported Favorably",7,3,1,0,11
1803059,1461363,2024-06-28,Assembly,"Assembly Floor: Substitute for A2824 (Voice Vote)",0,0,0,0,0
1803059,1461614,2024-06-28,Assembly,"Assembly Floor: Concur Governor Recommendations",57,13,10,0,80
1803059,1461615,2024-06-28,Assembly,"Assembly Floor: Emergency Resolution Vote",55,14,11,0,80
1803059,1461616,2024-06-28,Assembly,"Assembly Floor: Third Reading - Final Passage",56,17,7,0,80
1803059,1461617,2024-06-28,Senate,"Senate Floor: Adopt Governor Recommendations",27,11,2,0,40
1803059,1461618,2024-06-28,Senate,"Senate Floor: Concur Governor Recommendations",27,12,1,0,40
1803059,1461619,2024-06-28,Senate,"Senate Floor: Suspend Rule 23:4",33,2,5,0,40
1803068,1403996,2024-02-12,Senate,"Senate State Government, Wagering, Tourism & Historic Preservation Committee: Reported Favorably",5,0,0,0,5
1803068,1411840,2024-03-18,Senate,"Senate Floor: Third Reading - Final Passage",38,0,2,0,40
1803068,1470170,2024-12-12,Assembly,"Assembly Human Services Committee: Reported Favorably",5,0,1,0,6
1803068,1522640,2025-03-20,Assembly,"Assembly Oversight, Reform and Federal Relations Committee: Reported Favorably",6,0,0,0,6
1803069,1477319,2025-01-30,Senate,"Senate Community and Urban Affairs Committee: Reported with Amendments",5,0,0,0,5
1803071,1375840,2024-02-05,Senate,"Senate Commerce Committee: Reported Favorably",4,0,1,0,5
1803071,1410114,2024-03-18,Assembly,"Assembly Floor: Substitute for A3330 (Voice Vote)",0,0,0,0,0
1803071,1411847,2024-03-18,Assembly,"Assembly Floor: Third Reading - Final Passage",61,8,11,0,80
1803071,1411848,2024-03-18,Senate,"Senate Floor: Concur in Assembly Amendments",31,3,6,0,40
1803071,1411849,2024-03-18,Senate,"Senate Floor: Third Reading - Final Passage",33,3,4,0,40
1803079,1468215,2024-10-07,Senate,"Senate Health, Human Services and Senior Citizens Committee: Reported Favorably",8,0,0,0,8
1803096,1444695,2024-05-16,Senate,"Senate Law and Public Safety Committee: Reported Favorably",4,0,1,0,5
1803100,1503216,2025-03-03,Senate,"Senate Health, Human Services and Senior Citizens Committee: Reported Favorably",8,0,0,0,8
1803103,1409252,2024-03-14,Senate,"Senate Health, Human Services and Senior Citizens Committee: Reported with Amendments",8,0,0,0,8
1803108,1518815,2025-03-17,Senate,"Senate Transportation Committee: Reported with Amendments",5,0,1,0,6
1803113,1469848,2024-12-09,Senate,"Senate Health, Human Services and Senior Citizens Committee: Reported with Amendments",8,0,0,0,8
1803113,1595776,2025-06-26,Senate,"Senate Budget and Appropriations Committee: Reported with Amendments",13,0,0,0,13
1803113,1596720,2025-06-30,Senate,"Senate Floor: Third Reading - Final Passage",39,0,1,0,40
1803118,1469797,2024-12-05,Senate,"Senate Education Committee: Reported Favorably",5,0,0,0,5
1803129,1409603,2024-03-14,Senate,"Senate Health, Human Services and Senior Citizens Committee: Reported with Amendments",8,0,0,0,8
1803129,1445383,2024-05-20,Senate,"Senate Floor: Third Reading - Final Passage",37,0,3,0,40
1803129,1468741,2024-10-21,Assembly,"Assembly Judiciary Committee: Reported Favorably",6,0,0,0,6
1803129,1470937,2024-12-19,Assembly,"Assembly Floor: Substitute for A4168 (Voice Vote)",0,0,0,0,0
1803129,1470938,2024-12-19,Assembly,"Assembly Floor: Third Reading - Final Passage",73,0,7,0,80
1803134,1405324,2024-03-07,Senate,"Senate Law and Public Safety Committee: Reported with Substitution",5,0,0,0,5
1803138,1468618,2024-10-10,Senate,"Senate Environment and Energy Committee: Reported Favorably",5,0,0,0,5
1803153,1407190,2024-03-11,Senate,"Senate Budget and Appropriations Committee: Reported with Amendments",13,0,0,0,13
1803153,1411760,2024-03-18,Senate,"Senate Floor: Third Reading - Final Passage",38,0,2,0,40
1803153,1452635,2024-06-03,Assembly,"Assembly Commerce and Economic Development Committee: Reported Favorably",11,0,1,0,12
1803153,1459013,2024-06-24,Assembly,"Assembly Appropriations Committee: Reported with Amendments",11,0,0,0,11
1803153,1461353,2024-06-28,Assembly,"Assembly Floor: Substitute for A2812 (Voice Vote)",0,0,0,0,0
1803153,1461540,2024-06-28,Assembly,"Assembly Floor: Third Reading - Final Passage",73,0,7,0,80
1803153,1461541,2024-06-28,Senate,"Senate Floor: Concur in Assembly Amendments",40,0,0,0,40
1803177,1442683,2024-05-13,Senate,"Senate Commerce Committee: Reported with Amendments",5,0,0,0,5
1803177,1459705,2024-06-24,Senate,"Senate Budget and Appropriations Committee: Reported Favorably",12,0,1,0,13
1803177,1461499,2024-06-28,Senate,"Senate Floor: Third Reading - Final Passage",40,0,0,0,40
1803177,1469898,2024-12-09,Assembly,"Assembly Financial Institutions and Insurance Committee: Reported Favorably",10,0,3,0,13
1803177,1523280,2025-03-20,Assembly,"Assembly Appropriations Committee: Reported Favorably",10,0,1,0,11
1803177,1576069,2025-05-22,Assembly,"Assembly Floor: Substitute for A3856 (Voice Vote)",0,0,0,0,0
1803177,1576665,2025-05-22,Assembly,"Assembly Floor: Third Reading - Final Passage",75,0,5,0,80
1803199,1457063,2024-06-13,Senate,"Senate Military and Veterans' Affairs Committee: Reported Favorably",5,0,0,0,5
1803210,1369392,2024-01-25,Senate,"Senate Labor Committee: Reported Favorably",3,0,2,0,5
1803224,1379088,2024-02-08,Senate,"Senate Military and Veterans' Affairs Committee: Reported Favorably",5,0,0,0,5
1803237,1439682,2024-05-06,Senate,"Senate Labor Committee: Reported Favorably",3,1,1,0,5
1803237,1459707,2024-06-24,Senate,"Senate Budget and Appropriations Committee: Reported Favorably",12,0,1,0,13
1803237,1477826,2025-01-30,Senate,"Senate Floor: Third Reading - Final Passage",34,2,4,0,40
1803237,1595699,2025-06-26,Assembly,"Assembly Budget Committee: Reported with Amendments",10,0,5,0,15
1803237,1596473,2025-06-30,Assembly,"Assembly Floor: Substitute for A4029 (Voice Vote)",0,0,0,0,0
1803237,1596636,2025-06-30,Assembly,"Assembly Floor: Third Reading - Final Passage",61,15,4,0,80
1803237,1596637,2025-06-30,Senate,"Senate Floor: Concur in Assembly Amendments",39,0,1,0,40
1803239,1369457,2024-01-25,Senate,"Senate Education Committee: Reported with Amendments",5,0,0,0,5
1803246,1454648,2024-06-06,Senate,"Senate Health, Human Services and Senior Citizens Committee: Reported Favorably",8,0,0,0,8
1803246,1461586,2024-06-28,Senate,"Senate Floor: Third Reading - Final Passage",40,0,0,0,40
1803246,1564924,2025-05-05,Assembly,"Assembly Community Development and Womens Affairs Committee Committee: Reported Favorably",6,0,0,0,6
1803246,1576865,2025-05-22,Assembly,"Assembly Floor: Substitute for AJR45 (Voice Vote)",0,0,0,0,0
1803246,1576866,2025-05-22,Assembly,"Assembly Floor: Third Reading - Final Passage",76,0,4,0,80
1803260,1369617,2024-01-25,Senate,"Senate Transportation Committee: Reported Favorably",5,0,1,0,6
1803260,1468226,2024-10-07,Senate,"Senate Budget and Appropriations Committee: Reported with Amendments",13,0,0,0,13
1803260,1595801,2025-06-26,Senate,"Senate Budget and Appropriations Committee: Reported with Amendments",13,0,0,0,13
1803262,1470186,2024-12-12,Senate,"Senate Commerce Committee: Reported with Amendments",3,2,0,0,5
1803273,1469800,2024-12-05,Senate,"Senate Community and Urban Affairs Committee: Reported with Amendments",4,0,1,0,5
1803291,1457456,2024-06-13,Senate,"Senate Judiciary Committee: Reported Favorably",11,0,0,0,11
1803291,1595930,2025-06-26,Senate,"Senate Budget and Appropriations Committee: Reported with Amendments",13,0,0,0,13
1803291,1596694,2025-06-30,Senate,"Senate Floor: Third Reading - Final Passage",39,0,1,0,40
1803307,1442661,2024-05-13,Senate,"Senate Commerce Committee: Reported with Amendments",5,0,0,0,5
1803313,1379677,2024-02-08,Senate,"Senate Law and Public Safety Committee: Reported Favorably",5,0,0,0,5
1803338,1376322,2024-02-05,Senate,"Senate Commerce Committee: Reported Favorably",5,0,0,0,5
1803338,1381389,2024-02-12,Senate,"Senate Floor: Third Reading - Final Passage",37,0,3,0,40
1803338,1468926,2024-10-24,Assembly,"Assembly Consumer Affairs Committee: Reported with Amendments",5,0,1,0,6
1803338,1470751,2024-12-19,Assembly,"Assembly Floor: Substitute for A2334 (Voice Vote)",0,0,0,0,0
1803338,1470852,2024-12-19,Assembly,"Assembly Floor: Third Reading - Final Passage",70,0,10,0,80
1803338,1470853,2024-12-19,Senate,"Senate Floor: Concur in Assembly Amendments",37,0,3,0,40
1803345,1443761,2024-05-16,Senate,"Senate Law and Public Safety Committee: Reported Favorably",4,0,1,0,5
1803365,1379127,2024-02-08,Senate,"Senate Law and Public Safety Committee: Reported Favorably",5,0,0,0,5
1803371,1379830,2024-02-08,Senate,"Senate Law and Public Safety Committee: Reported Favorably",5,0,0,0,5
1803371,1468270,2024-10-07,Senate,"Senate Budget and Appropriations Committee: Reported Favorably",13,0,0,0,13
1803371,1469056,2024-10-28,Senate,"Senate Floor: Third Reading - Final Passage",40,0,0,0,40
1803371,1470435,2024-12-16,Assembly,"Assembly Appropriations Committee: Reported Favorably",10,0,1,0,11
1803371,1470771,2024-12-19,Assembly,"Assembly Floor: Substitute for A908 (Voice Vote)",0,0,0,0,0
1803371,1470842,2024-12-19,Assembly,"Assembly Floor: Third Reading - Final Passage",73,0,7,0,80
1803378,1369474,2024-01-25,Senate,"Senate Transportation Committee: Reported Favorably",5,0,1,0,6
1803378,1381521,2024-02-12,Senate,"Senate Floor: Third Reading - Final Passage",37,0,3,0,40
1803378,1468801,2024-10-21,Assembly,"Assembly Transportation and Independent Authorities Committee: Reported Favorably",13,0,0,0,13
1803378,1469034,2024-10-28,Assembly,"Assembly Floor: Substitute for A4433 (Voice Vote)",0,0,0,0,0
1803378,1469035,2024-10-28,Assembly,"Assembly Floor: Third Reading - Final Passage",77,0,3,0,80
1803380,1409139,2024-03-14,Senate,"Senate Environment and Energy Committee: Reported with Amendments",5,0,0,0,5
1803382,1470201,2024-12-12,Senate,"Senate Environment and Energy Committee: Reported with Amendments",5,0,0,0,5
1803382,1471423,2025-01-14,Senate,"Senate Floor: Third Reading - Final Passage",35,0,4,0,39
1803382,1511586,2025-03-10,Assembly,"Assembly Environment and Solid Waste Committee: Reported Favorably",7,0,0,0,7
1803384,1468627,2024-10-10,Senate,"Senate Commerce Committee: Reported with Amendments",5,0,0,0,5
1803386,1404491,2024-02-12,Senate,"Senate State Government, Wagering, Tourism & Historic Preservation Committee: Reported with Amendments",5,0,0,0,5
1803386,1411812,2024-03-18,Senate,"Senate Floor: Third Reading - Final Passage",38,0,2,0,40
1803412,1585595,2025-06-05,Senate,"Senate Labor Committee: Reported with Amendments",5,0,0,0,5
1803428,1385925,2024-02-15,Senate,"Senate Community and Urban Affairs Committee: Reported with Amendments",4,0,1,0,5
1803428,1460338,2024-06-26,Senate,"Senate Budget and Appropriations Committee: Reported with Amendments",13,0,0,0,13
1803432,1503949,2025-03-03,Senate,"Senate Military and Veterans' Affairs Committee: Reported Favorably",5,0,0,0,5
1803433,1401922,2024-03-04,Senate,"Senate Higher Eduction Committee: Reported with Amendments",5,0,0,0,5
1803448,1569593,2025-05-12,Senate,"Senate Community and Urban Affairs Committee: Reported Favorably",4,0,1,0,5
1803459,1443669,2024-05-16,Senate,"Senate Military and Veterans' Affairs Committee: Reported Favorably",5,0,0,0,5
1803461,1385457,2024-02-15,Senate,"Senate Transportation Committee: Reported Favorably",5,0,1,0,6
1803461,1468213,2024-10-07,Senate,"Senate Budget and Appropriations Committee: Reported Favorably",13,0,0,0,13
1803470,1586796,2025-06-09,Senate,"Senate Health, Human Services and Senior Citizens Committee: Reported Favorably",7,0,1,0,8
1803472,1485410,2025-02-10,Senate,"Senate Environment and Energy Committee: Reported with Amendments",5,0,0,0,5
1803472,1499764,2025-02-25,Senate,"Senate Floor: Third Reading - Final Passage",38,0,2,0,40
1803479,1404421,2024-02-12,Senate,"Senate State Government, Wagering, Tourism & Historic Preservation Committee: Reported with Amendments",5,0,0,0,5
1803479,1412286,2024-03-18,Senate,"Senate Floor: Third Reading - Final Passage",38,0,2,0,40
1803479,1443769,2024-05-16,Assembly,"Assembly State and Local Government Committee: Reported with Amendments",7,0,0,0,7
1803479,1460876,2024-06-26,Assembly,"Assembly Budget Committee: Reported Favorably",13,0,2,0,15
1803479,1461418,2024-06-28,Assembly,"Assembly Floor: Substitute for A2608 (Voice Vote)",0,0,0,0,0
1803479,1461665,2024-06-28,Assembly,"Assembly Floor: Third Reading - Final Passage",76,0,4,0,80
1803479,1461666,2024-06-28,Senate,"Senate Floor: Concur in Assembly Amendments",40,0,0,0,40
1803482,1439686,2024-05-06,Senate,"Senate Transportation Committee: Reported Favorably",5,0,1,0,6
1803487,1442438,2024-05-13,Senate,"Senate Commerce Committee: Reported Favorably",5,0,0,0,5
1803487,1461717,2024-06-28,Senate,"Senate Floor: Third Reading - Final Passage",40,0,0,0,40
1803487,1467298,2024-09-12,Assembly,"Assembly Regulated Professions Committee: Reported Favorably",7,0,0,0,7
1803487,1524601,2025-03-24,Assembly,"Assembly Floor: Substitute for A4390 (Voice Vote)",0,0,0,0,0
1803487,1525553,2025-03-24,Assembly,"Assembly Floor: Third Reading - Final Passage",78,0,2,0,80
1803487,1525554,2025-03-24,Senate,"Senate Floor: Concur in Assembly Amendments",39,0,1,0,40
1803487,1583814,2025-06-02,Senate,"Senate Floor: Adopt Governor Recommendations",38,0,2,0,40
1803487,1596717,2025-06-30,Assembly,"Assembly Floor: Concur Governor Recommendations",78,0,2,0,80
1803487,1596718,2025-06-30,Senate,"Senate Floor: Concur Governor Recommendations",39,0,1,0,40
1803524,1442445,2024-05-13,Senate,"Senate Commerce Committee: Reported with Amendments",5,0,0,0,5
1803543,1469779,2024-12-05,Senate,"Senate Labor Committee: Reported with Substitution",4,0,1,0,5
1803561,1477345,2025-01-30,Senate,"Senate Education Committee: Reported with Substitution",5,0,0,0,5
1803567,1586481,2025-06-09,Senate,"Senate Health, Human Services and Senior Citizens Committee: Reported with Amendments",7,0,1,0,8
1803572,1503860,2025-03-03,Senate,"Senate Labor Committee: Reported Favorably",5,0,0,0,5
1803573,1461468,2024-06-28,Senate,"Senate Judiciary Committee: Reported Favorably",11,0,0,0,11
1803573,1525448,2025-03-24,Senate,"Senate Floor: Third Reading - Final Passage",39,0,1,0,40
1803573,1568316,2025-05-08,Assembly,"Assembly Judiciary Committee: Reported Favorably",6,0,0,0,6
1803573,1576484,2025-05-22,Assembly,"Assembly Floor: Substitute for A5448 (Voice Vote)",0,0,0,0,0
1803573,1576485,2025-05-22,Assembly,"Assembly Floor: Third Reading - Final Passage",77,0,3,0,80
1803579,1457275,2024-06-13,Senate,"Senate Judiciary Committee: Reported Favorably",11,0,0,0,11
1803579,1469060,2024-10-28,Senate,"Senate Floor: Third Reading - Final Passage",40,0,0,0,40
1803587,1379292,2024-02-08,Senate,"Senate Military and Veterans' Affairs Committee: Reported Favorably",5,0,0,0,5
1803591,1369123,2024-01-25,Senate,"Senate Labor Committee: Reported with Amendments",3,0,2,0,5
1803625,1455725,2024-06-10,Senate,"Senate Commerce Committee: Reported Favorably",5,0,0,0,5
1803625,1461724,2024-06-28,Senate,"Senate Floor: Third Reading - Final Passage",40,0,0,0,40
1803625,1469017,2024-10-28,Assembly,"Assembly Floor: Substitute for AJR50 (Voice Vote)",0,0,0,0,0
1803625,1469018,2024-10-28,Assembly,"Assembly Floor: Third Reading - Final Passage",77,0,3,0,80
1803630,1376371,2024-02-05,Senate,"Senate Commerce Committee: Reported Favorably",5,0,0,0,5
1803630,1381316,2024-02-12,Senate,"Senate Floor: Third Reading - Final Passage",37,0,3,0,40
1803630,1458935,2024-06-24,Assembly,"Assembly Regulated Professions Committee: Reported Favorably",7,0,0,0,7
1803630,1467636,2024-09-26,Assembly,"Assembly Floor: Substitute for A3890 (Voice Vote)",0,0,0,0,0
1803630,1467704,2024-09-26,Assembly,"Assembly Floor: Third Reading - Final Passage",76,0,4,0,80
1803633,1385694,2024-02-15,Senate,"Senate Community and Urban Affairs Committee: Reported with Amendments",4,0,1,0,5
1803640,1375695,2024-02-05,Senate,"Senate Environment and Energy Committee: Reported with Amendments",4,1,0,0,5
1803647,1409378,2024-03-14,Senate,"Senate Labor Committee: Reported Favorably",5,0,0,0,5
1803649,1443832,2024-05-16,Senate,"Senate Military and Veterans' Affairs Committee: Reported Favorably",5,0,0,0,5
1803654,1569517,2025-05-12,Senate,"Senate Community and Urban Affairs Committee: Reported with Substitution",3,1,1,0,5
1803678,1369598,2024-01-25,Senate,"Senate Education Committee: Reported Favorably",4,0,1,0,5
1803678,1407499,2024-03-11,Senate,"Senate Budget and Appropriations Committee: Reported Favorably",13,0,0,0,13
1803678,1445105,2024-05-20,Senate,"Senate Floor: Third Reading - Final Passage",37,0,3,0,40
1803679,1468723,2024-10-21,Senate,"Senate Military and Veterans' Affairs Committee: Reported Favorably",5,0,0,0,5
1803692,1484801,2025-02-10,Senate,"Senate Economic Growth Committee: Reported with Amendments",4,0,1,0,5
1803708,1409358,2024-03-14,Senate,"Senate Health, Human Services and Senior Citizens Committee: Reported with Amendments",8,0,0,0,8
1803708,1468223,2024-10-07,Senate,"Senate Budget and Appropriations Committee: Reported with Amendments",13,0,0,0,13
1803708,1468981,2024-10-28,Senate,"Senate Floor: Third Reading - Final Passage",40,0,0,0,40
1803708,1495866,2025-02-20,Assembly,"Assembly Appropriations Committee: Reported Favorably",10,0,1,0,11
1803708,1501784,2025-02-27,Assembly,"Assembly Floor: Substitute for A1673 (Voice Vote)",0,0,0,0,0
1803708,1502354,2025-02-27,Assembly,"Assembly Floor: Third Reading - Final Passage",75,0,5,0,80
1803708,1583698,2025-06-02,Senate,"Senate Floor: Adopt Governor Recommendations",38,0,2,0,40
1803708,1596719,2025-06-30,Senate,"Senate Floor: Concur Governor Recommendations",39,0,1,0,40
1803722,1385766,2024-02-15,Senate,"Senate Community and Urban Affairs Committee: Reported with Amendments",4,0,1,0,5
1803726,1385582,2024-02-15,Senate,"Senate Community and Urban Affairs Committee: Reported Favorably",4,0,1,0,5
1803726,1445348,2024-05-20,Senate,"Senate Floor: Third Reading - Final Passage",37,0,3,0,40
1803732,1376081,2024-02-05,Senate,"Senate Environment and Energy Committee: Reported Favorably",3,2,0,0,5
1803734,1589905,2025-06-12,Senate,"Senate Environment and Energy Committee: Reported Favorably",3,2,0,0,5
1803737,1467829,2024-09-30,Senate,"Senate Education Committee: Reported Favorably",5,0,0,0,5
1803737,1595778,2025-06-26,Senate,"Senate Budget and Appropriations Committee: Reported with Amendments",13,0,0,0,13
1803738,1385409,2024-02-15,Senate,"Senate Transportation Committee: Reported Favorably",5,0,1,0,6
1803762,1443755,2024-05-16,Senate,"Senate Military and Veterans' Affairs Committee: Reported Favorably",5,0,0,0,5
1803768,1470779,2024-12-19,Senate,"Senate Health, Human Services and Senior Citizens Committee: Reported with Amendments",8,0,0,0,8
1803775,1405372,2024-03-07,Senate,"Senate Law and Public Safety Committee: Reported with Amendments",5,0,0,0,5
1803791,1442839,2024-05-13,Senate,"Senate Environment and Energy Committee: Reported with Amendments",5,0,0,0,5
1803792,1379800,2024-02-08,Senate,"Senate Military and Veterans' Affairs Committee: Reported Favorably",5,0,0,0,5
1803802,1369471,2024-01-25,Senate,"Senate Transportation Committee: Reported Favorably",5,0,1,0,6
1803806,1439730,2024-05-06,Senate,"Senate Labor Committee: Reported with Amendments",3,1,1,0,5
1803816,1457249,2024-06-13,Senate,"Senate Judiciary Committee: Reported Favorably",8,0,3,0,11
1803822,1409126,2024-03-14,Senate,"Senate Labor Committee: Reported Favorably",5,0,0,0,5
1803835,1385793,2024-02-15,Senate,"Senate Education Committee: Reported Favorably",5,0,0,0,5
1803835,1477825,2025-01-30,Senate,"Senate Floor: Third Reading - Final Passage",37,0,3,0,40
1803843,1469813,2024-12-05,Senate,"Senate Transportation Committee: Reported with Amendments",6,0,0,0,6
1803858,1442441,2024-05-13,Senate,"Senate Commerce Committee: Reported with Amendments",5,0,0,0,5
1803861,1458642,2024-06-20,Senate,"Senate State Government, Wagering, Tourism & Historic Preservation Committee: Reported with Substitution",5,0,0,0,5
1803864,1441652,2024-05-09,Senate,"Senate Health, Human Services and Senior Citizens Committee: Reported Favorably",8,0,0,0,8
1803864,1442420,2024-05-13,Senate,"Senate Floor: Third Reading - Final Passage",37,0,3,0,40
1803873,1470408,2024-12-16,Senate,"Senate Military and Veterans' Affairs Committee: Reported Favorably",4,0,1,0,5
1803878,1468938,2024-10-24,Senate,"Senate State Government, Wagering, Tourism & Historic Preservation Committee: Reported Favorably",4,0,1,0,5
1803878,1469896,2024-12-09,Senate,"Senate Budget and Appropriations Committee: Reported Favorably",13,0,0,0,13
1803884,1404746,2024-02-12,Senate,"Senate State Government, Wagering, Tourism & Historic Preservation Committee: Reported Favorably",5,0,0,0,5
1803906,1457448,2024-06-13,Senate,"Senate Judiciary Committee: Reported with Amendments",11,0,0,0,11
1803906,1460797,2024-06-26,Senate,"Senate Budget and Appropriations Committee: Reported with Amendments",13,0,0,0,13
1803906,1461647,2024-06-28,Senate,"Senate Floor: Third Reading - Final Passage",40,0,0,0,40
1803918,1524671,2025-03-24,Senate,"Senate Commerce Committee: Reported with Amendments",5,0,0,0,5
1803919,1458651,2024-06-20,Senate,"Senate Environment and Energy Committee: Reported with Amendments",3,2,0,0,5
1803927,1498902,2025-02-25,Senate,"Senate State Government, Wagering, Tourism & Historic Preservation Committee: Reported Favorably",5,0,0,0,5
1803932,1589493,2025-06-12,Senate,"Senate Commerce Committee: Reported Favorably",5,0,0,0,5
1803939,1455684,2024-06-10,Senate,"Senate Higher Eduction Committee: Reported Favorably",5,0,0,0,5
1803943,1576540,2025-05-22,Senate,"Senate Higher Eduction Committee: Reported with Amendments",4,0,1,0,5
1803947,1469788,2024-12-05,Senate,"Senate Education Committee: Reported with Amendments",4,1,0,0,5
1804346,1409593,2024-03-14,Assembly,"Assembly Health Committee: Reported with Amendments",10,1,0,0,11
1804346,1467708,2024-09-26,Assembly,"Assembly Floor: Third Reading - Final Passage",73,2,5,0,80
1804346,1468277,2024-10-07,Senate,"Senate Health, Human Services and Senior Citizens Committee: Reported Favorably",8,0,0,0,8
1804360,1403366,2024-03-04,Assembly,"Assembly Environment and Solid Waste Committee: Reported Favorably",7,0,0,0,7
1804360,1454631,2024-06-06,Assembly,"Assembly State and Local Government Committee: Reported with Amendments",7,0,0,0,7
1804360,1461530,2024-06-28,Assembly,"Assembly Floor: Third Reading - Final Passage",73,0,7,0,80
1804360,1485199,2025-02-10,Senate,"Senate Environment and Energy Committee: Reported with Amendments",5,0,0,0,5
1804364,1467483,2024-09-19,Assembly,"Assembly State and Local Government Committee: Reported Favorably",7,0,0,0,7
1804380,1409639,2024-03-14,Assembly,"Assembly Human Services Committee: Reported with Amendments",5,0,1,0,6
1804380,1467295,2024-09-12,Assembly,"Assembly Regulated Professions Committee: Reported Favorably",7,0,0,0,7
1804380,1467690,2024-09-26,Assembly,"Assembly Floor: Third Reading - Final Passage",76,0,4,0,80
1804380,1478902,2025-02-03,Senate,"Senate Health, Human Services and Senior Citizens Committee: Reported with Amendments",8,0,0,0,8
1804387,1469302,2024-11-14,Assembly,"Assembly State and Local Government Committee: Reported with Amendments",5,1,1,0,7
1804394,1442448,2024-05-13,Assembly,"Assembly Health Committee: Reported Favorably",7,3,1,0,11
1804394,1461715,2024-06-28,Assembly,"Assembly Floor: Third Reading - Final Passage",58,17,5,0,80
1804394,1469046,2024-10-28,Senate,"Senate Health, Human Services and Senior Citizens Committee: Reported with Amendments",8,0,0,0,8
1804394,1469874,2024-12-09,Senate,"Senate Health, Human Services and Senior Citizens Committee: Reported with Amendments",7,0,1,0,8
1804394,1470879,2024-12-19,Assembly,"Assembly Floor: Concur in Senate Amendments",55,15,10,0,80
1804394,1470880,2024-12-19,Senate,"Senate Floor: Substitute for S1981 (Voice Vote)",0,0,0,0,0
1804394,1470881,2024-12-19,Senate,"Senate Floor: Third Reading - Final Passage",30,6,4,0,40
1804400,1596834,2025-06-30,Assembly,"Assembly Floor: Table Motion",44,27,9,0,80
1804416,1392267,2024-02-22,Assembly,"Assembly Financial Institutions and Insurance Committee: Reported with Amendments",13,0,0,0,13
1804416,1442364,2024-05-13,Assembly,"Assembly Floor: Third Reading - Final Passage",72,0,8,0,80
1804416,1524687,2025-03-24,Senate,"Senate Commerce Committee: Reported Favorably",5,0,0,0,5
1804417,1391580,2024-02-22,Assembly,"Assembly Health Committee: Reported Favorably",11,0,0,0,11
1804417,1411803,2024-03-18,Assembly,"Assembly Floor: Third Reading - Final Passage",77,0,3,0,80
1804443,1439766,2024-05-06,Assembly,"Assembly Human Services Committee: Reported Favorably",6,0,0,0,6
1804443,1468689,2024-10-17,Assembly,"Assembly Health Committee: Reported Favorably",10,0,1,0,11
1804458,1391591,2024-02-22,Assembly,"Assembly Higher Education Committee: Reported Favorably",7,0,0,0,7
1804472,1443759,2024-05-16,Assembly,"Assembly Human Services Committee: Reported Favorably",6,0,0,0,6
1804472,1460869,2024-06-26,Assembly,"Assembly Budget Committee: Reported Favorably",14,0,1,0,15
1804472,1461377,2024-06-28,Senate,"Senate Floor: Second Reading (Voice Vote)",0,0,0,0,0
1804472,1461378,2024-06-28,Senate,"Senate Floor: Substitute for S2330 (Voice Vote)",0,0,0,0,0
1804472,1461629,2024-06-28,Assembly,"Assembly Floor: Concur in Senate Amendments",72,0,8,0,80
1804472,1461630,2024-06-28,Assembly,"Assembly Floor: Third Reading - Final Passage",77,0,3,0,80
1804472,1461631,2024-06-28,Senate,"Senate Floor: Amend",39,0,1,0,40
1804472,1461632,2024-06-28,Senate,"Senate Floor: Third Reading - Final Passage",40,0,0,0,40
1804480,1392250,2024-02-22,Assembly,"Assembly Financial Institutions and Insurance Committee: Reported Favorably",9,3,1,0,13
1804480,1409121,2024-03-14,Assembly,"Assembly Appropriations Committee: Reported Favorably",5,4,2,0,11
1804480,1426898,2024-04-15,Assembly,"Assembly Floor: Third Reading - Final Passage",49,23,8,0,80
1804486,1439788,2024-05-06,Assembly,"Assembly Education Committee: Reported with Amendments",9,0,0,0,9
1804503,1374115,2024-02-01,Assembly,"Assembly State and Local Government Committee: Reported with Amendments",7,0,0,0,7
1804503,1426900,2024-04-15,Assembly,"Assembly Floor: Third Reading - Final Passage",72,0,8,0,80
1804503,1458994,2024-06-24,Senate,"Senate Budget and Appropriations Committee: Reported Favorably",12,0,1,0,13
1804506,1468747,2024-10-21,Assembly,"Assembly Military and Veterans' Affairs Committee: Reported Favorably",6,0,0,0,6
1804532,1401908,2024-03-04,Assembly,"Assembly Education Committee: Reported with Amendments",9,0,0,0,9
1804532,1507463,2025-03-06,Assembly,"Assembly Health Committee: Reported Favorably",10,0,1,0,11
1804532,1525379,2025-03-24,Assembly,"Assembly Floor: Third Reading - Final Passage",75,2,3,0,80
1804551,1401617,2024-03-04,Assembly,"Assembly State and Local Government Committee: Reported with Amendments",7,0,0,0,7
1804551,1457890,2024-06-17,Assembly,"Assembly Public Safety and Preparedness Committee Committee: Reported with Amendments",9,0,0,0,9
1804551,1461416,2024-06-28,Senate,"Senate Floor: Substitute for S2070 (Voice Vote)",0,0,0,0,0
1804551,1461507,2024-06-28,Assembly,"Assembly Floor: Third Reading - Final Passage",76,0,4,0,80
1804551,1461508,2024-06-28,Senate,"Senate Floor: Third Reading - Final Passage",40,0,0,0,40
1804590,1392185,2024-02-22,Assembly,"Assembly Committee: Not Reported",7,2,0,0,9
1804590,1393119,2024-02-22,Assembly,"Assembly Public Safety and Preparedness Committee Committee: Not Reported",7,2,0,0,9
1804600,1467460,2024-09-19,Assembly,"Assembly Military and Veterans' Affairs Committee: Reported Favorably",5,0,1,0,6
1804606,1376587,2024-02-05,Assembly,"Assembly Labor Committee: Reported with Amendments",11,0,0,0,11
1804607,1454606,2024-06-06,Assembly,"Assembly Military and Veterans' Affairs Committee: Reported with Amendments",6,0,0,0,6
1804607,1467706,2024-09-26,Assembly,"Assembly Floor: Third Reading - Final Passage",76,0,4,0,80
1804630,1467542,2024-09-23,Assembly,"Assembly Health Committee: Reported Favorably",9,0,2,0,11
1804630,1576783,2025-05-22,Assembly,"Assembly Floor: Third Reading - Final Passage",77,0,3,0,80
1804637,1458901,2024-06-24,Assembly,"Assembly State and Local Government Committee: Reported Favorably",7,0,0,0,7
1804637,1461682,2024-06-28,Assembly,"Assembly Floor: Third Reading - Final Passage",65,3,12,0,80
1804637,1484759,2025-02-10,Senate,"Senate Economic Growth Committee: Reported with Amendments",4,0,1,0,5
1804687,1485051,2025-02-10,Assembly,"Assembly Higher Education Committee: Reported with Amendments",6,1,0,0,7
1804705,1470223,2024-12-12,Assembly,"Assembly Environment and Solid Waste Committee: Reported Favorably",7,0,0,0,7
1804705,1470805,2024-12-19,Assembly,"Assembly Floor: Third Reading - Final Passage",70,1,9,0,80
1804707,1591092,2025-06-16,Assembly,"Assembly Environment and Solid Waste Committee: Reported with Substitution",7,0,0,0,7
1804715,1407501,2024-03-11,Assembly,"Assembly Labor Committee: Reported Favorably",9,2,0,0,11
1804715,1459242,2024-06-24,Assembly,"Assembly State and Local Government Committee: Reported Favorably",7,0,0,0,7
1804715,1460407,2024-06-26,Assembly,"Assembly Budget Committee: Reported with Amendments",11,1,3,0,15
1804715,1461564,2024-06-28,Assembly,"Assembly Floor: Third Reading - Final Passage",74,2,4,0,80
1804715,1461565,2024-06-28,Senate,"Senate Floor: Substitute for S3231 (Voice Vote)",0,0,0,0,0
1804715,1461566,2024-06-28,Senate,"Senate Floor: Third Reading - Final Passage",40,0,0,0,40
1804727,1392834,2024-02-22,Assembly,"Assembly Regulated Professions Committee: Reported Favorably",7,0,0,0,7
1804727,1411664,2024-03-18,Assembly,"Assembly Floor: Third Reading - Final Passage",77,0,3,0,80
1804727,1468615,2024-10-10,Senate,"Senate Commerce Committee: Reported Favorably",5,0,0,0,5
1804727,1518561,2025-03-17,Senate,"Senate Budget and Appropriations Committee: Reported Favorably",13,0,0,0,13
1804727,1524798,2025-03-24,Senate,"Senate Floor: Substitute for S2688 (Voice Vote)",0,0,0,0,0
1804727,1525370,2025-03-24,Senate,"Senate Floor: Third Reading - Final Passage",39,0,1,0,40
1804750,1454591,2024-06-06,Assembly,"Assembly Labor Committee: Reported with Amendments",10,0,1,0,11
1804750,1495150,2025-02-20,Assembly,"Assembly State and Local Government Committee: Reported with Substitution",7,0,0,0,7
1804750,1522984,2025-03-20,Assembly,"Assembly Appropriations Committee: Reported Favorably",9,2,0,0,11
1804750,1525631,2025-03-24,Assembly,"Assembly Floor: Third Reading - Final Passage",70,7,3,0,80
1804764,1442356,2024-05-13,Assembly,"Assembly Oversight, Reform and Federal Relations Committee: Reported Favorably",6,0,0,0,6
1804782,1467309,2024-09-12,Assembly,"Assembly Commerce and Economic Development Committee: Reported Favorably",8,3,1,0,12
1804792,1445001,2024-05-20,Assembly,"Assembly Financial Institutions and Insurance Committee: Reported Favorably",11,0,2,0,13
1804809,1454621,2024-06-06,Assembly,"Assembly Military and Veterans' Affairs Committee: Reported Favorably",6,0,0,0,6
1804812,1568526,2025-05-08,Assembly,"Assembly Transportation and Independent Authorities Committee: Reported Favorably",12,0,1,0,13
1804831,1468789,2024-10-21,Assembly,"Assembly Education Committee: Reported with Amendments",9,0,0,0,9
1804839,1468934,2024-10-24,Assembly,"Assembly Consumer Affairs Committee: Reported with Amendments",5,0,1,0,6
1804841,1468751,2024-10-21,Assembly,"Assembly Military and Veterans' Affairs Committee: Reported Favorably",6,0,0,0,6
1804841,1469036,2024-10-28,Assembly,"Assembly Floor: Third Reading - Final Passage",75,0,5,0,80
1804856,1391506,2024-02-22,Assembly,"Assembly Health Committee: Reported Favorably",11,0,0,0,11
1804856,1411641,2024-03-18,Assembly,"Assembly Floor: Third Reading - Final Passage",77,0,3,0,80
1804869,1467476,2024-09-19,Assembly,"Assembly State and Local Government Committee: Reported Favorably",7,0,0,0,7
1804869,1468989,2024-10-28,Assembly,"Assembly Floor: Third Reading - Final Passage",76,0,4,0,80
1804871,1509231,2025-03-10,Assembly,"Assembly Environment and Solid Waste Committee: Reported with Amendments",7,0,0,0,7
1804891,1454654,2024-06-06,Assembly,"Assembly Military and Veterans' Affairs Committee: Reported with Amendments",4,0,2,0,6
1804924,1442695,2024-05-13,Assembly,"Assembly Commerce and Economic Development Committee: Reported Favorably",12,0,0,0,12
1804947,1454653,2024-06-06,Assembly,"Assembly Transportation and Independent Authorities Committee: Reported Favorably",11,0,2,0,13
1804947,1461679,2024-06-28,Assembly,"Assembly Floor: Third Reading - Final Passage",71,1,8,0,80
1804950,1489589,2025-02-13,Assembly,"Assembly Judiciary Committee: Reported Favorably",5,0,1,0,6
1804950,1496039,2025-02-20,Assembly,"Assembly Appropriations Committee: Reported Favorably",10,0,1,0,11
1804959,1401910,2024-03-04,Assembly,"Assembly Education Committee: Reported Favorably",9,0,0,0,9
1804959,1411941,2024-03-18,Assembly,"Assembly Floor: Third Reading - Final Passage",75,2,3,0,80
1804959,1439516,2024-05-06,Senate,"Senate Education Committee: Reported Favorably",4,1,0,0,5
1804959,1444867,2024-05-20,Senate,"Senate Floor: Substitute for S1287 (Voice Vote)",0,0,0,0,0
1804959,1444958,2024-05-20,Senate,"Senate Floor: Third Reading - Final Passage",34,2,4,0,40
1804959,1461602,2024-06-28,Assembly,"Assembly Floor: Concur in Senate Amendments",75,1,4,0,80
1804960,1458954,2024-06-24,Assembly,"Assembly Appropriations Committee: Reported Favorably",11,0,0,0,11
1804960,1458955,2024-06-24,Assembly,"Assembly Regulated Professions Committee: Reported Favorably",7,0,0,0,7
1804960,1461399,2024-06-28,Senate,"Senate Floor: Substitute for S3203 (Voice Vote)",0,0,0,0,0
1804960,1461559,2024-06-28,Assembly,"Assembly Floor: Third Reading - Final Passage",76,0,4,0,80
1804960,1461560,2024-06-28,Senate,"Senate Floor: Third Reading - Final Passage",40,0,0,0,40
1805006,1439365,2024-05-06,Assembly,"Assembly Military and Veterans' Affairs Committee: Reported Favorably",6,0,0,0,6
1805013,1402140,2024-03-04,Assembly,"Assembly Education Committee: Reported with Amendments",9,0,0,0,9
1805027,1591040,2025-06-16,Assembly,"Assembly Military and Veterans' Affairs Committee: Reported Favorably",5,0,1,0,6
1805030,1467686,2024-09-26,Assembly,"Assembly Floor: Table Motion",41,28,11,0,80
1805077,1507430,2025-03-06,Assembly,"Assembly Consumer Affairs Committee: Reported with Amendments",4,0,2,0,6
1805077,1525411,2025-03-24,Assembly,"Assembly Floor: Third Reading - Final Passage",76,1,3,0,80
1805080,1467292,2024-09-12,Assembly,"Assembly Regulated Professions Committee: Reported Favorably",6,1,0,0,7
1805080,1469315,2024-11-14,Assembly,"Assembly State and Local Government Committee: Reported with Amendments",6,0,1,0,7
1805092,1454633,2024-06-06,Assembly,"Assembly Military and Veterans' Affairs Committee: Reported Favorably",6,0,0,0,6
1805098,1402653,2024-03-04,Assembly,"Assembly Transportation and Independent Authorities Committee: Reported Favorably",13,0,0,0,13
1805098,1426932,2024-04-15,Assembly,"Assembly Floor: Third Reading - Final Passage",74,0,6,0,80
1805098,1458973,2024-06-24,Senate,"Senate Budget and Appropriations Committee: Reported with Amendments",12,0,1,0,13
1805098,1461422,2024-06-28,Senate,"Senate Floor: Substitute for S360 (Voice Vote)",0,0,0,0,0
1805098,1461534,2024-06-28,Assembly,"Assembly Floor: Concur in Senate Amendments",71,0,9,0,80
1805098,1461535,2024-06-28,Senate,"Senate Floor: Third Reading - Final Passage",40,0,0,0,40
1805098,1467682,2024-09-26,Assembly,"Assembly Floor: Concur Governor Recommendations",75,0,5,0,80
1805098,1467852,2024-09-30,Senate,"Senate Floor: Concur Governor Recommendations",33,0,7,0,40
1805110,1473958,2025-01-23,Assembly,"Assembly State and Local Government Committee: Reported Favorably",6,0,1,0,7
1805138,1452601,2024-06-03,Assembly,"Assembly Consumer Affairs Committee: Reported Favorably",4,2,0,0,6
1805147,1467293,2024-09-12,Assembly,"Assembly Public Safety and Preparedness Committee Committee: Reported with Amendments",6,1,2,0,9
1805147,1525859,2025-03-24,Assembly,"Assembly Floor: Third Reading - Final Passage",73,3,4,0,80
1805166,1391711,2024-02-22,Assembly,"Assembly Commerce and Economic Development Committee: Reported Favorably",12,0,0,0,12
1805166,1411929,2024-03-18,Assembly,"Assembly Floor: Third Reading - Final Passage",76,0,4,0,80
1805177,1391415,2024-02-22,Assembly,"Assembly Health Committee: Reported with Amendments",11,0,0,0,11
1805177,1412051,2024-03-18,Assembly,"Assembly Floor: Third Reading - Final Passage",77,0,3,0,80
1805177,1469852,2024-12-09,Senate,"Senate Health, Human Services and Senior Citizens Committee: Reported Favorably",8,0,0,0,8
1805179,1591063,2025-06-16,Assembly,"Assembly Education Committee: Reported with Amendments",9,0,0,0,9
1805189,1442487,2024-05-13,Assembly,"Assembly Housing and Community Development Committee: Reported Favorably",5,0,2,0,7
1805189,1470487,2024-12-16,Assembly,"Assembly Appropriations Committee: Reported with Amendments",10,0,1,0,11
1805189,1470788,2024-12-19,Assembly,"Assembly Floor: Third Reading - Final Passage",73,0,7,0,80
1805189,1597004,2025-06-30,Assembly,"Assembly Floor: Concur in Senate Amendments",80,0,0,0,80
1805189,1597005,2025-06-30,Senate,"Senate Floor: Substitute for S1034 (Voice Vote)",0,0,0,0,0
1805189,1597006,2025-06-30,Senate,"Senate Floor: Third Reading - Final Passage",39,0,1,0,40
1805204,1473748,2025-01-23,Assembly,"Assembly State and Local Government Committee: Reported with Amendments",6,0,1,0,7
1805204,1477810,2025-01-30,Assembly,"Assembly Floor: Third Reading - Final Passage",74,0,6,0,80
1805204,1569592,2025-05-12,Senate,"Senate Community and Urban Affairs Committee: Reported with Amendments",4,0,1,0,5
1805220,1523321,2025-03-20,Assembly,"Assembly Housing and Community Development Committee: Reported with Amendments",6,0,1,0,7
1805220,1572058,2025-05-15,Assembly,"Assembly Appropriations Committee: Reported Favorably",11,0,0,0,11
1805267,1467479,2024-09-19,Assembly,"Assembly Education Committee: Reported Favorably",9,0,0,0,9
1805267,1469040,2024-10-28,Assembly,"Assembly Floor: Third Reading - Final Passage",77,0,3,0,80
1805267,1585445,2025-06-05,Senate,"Senate Education Committee: Reported with Amendments",5,0,0,0,5
1805273,1454632,2024-06-06,Assembly,"Assembly Education Committee: Reported with Amendments",8,1,0,0,9
1805273,1460964,2024-06-26,Assembly,"Assembly Budget Committee: Reported with Amendments",13,0,2,0,15
1805273,1461554,2024-06-28,Assembly,"Assembly Floor: Third Reading - Final Passage",62,15,3,0,80
1805273,1461555,2024-06-28,Senate,"Senate Floor: Substitute for S3263 (Voice Vote)",0,0,0,0,0
1805273,1461556,2024-06-28,Senate,"Senate Floor: Third Reading - Final Passage",27,13,0,0,40
1805280,1467533,2024-09-23,Assembly,"Assembly Children, Families and Food Security Committee Committee: Reported Favorably",6,0,0,0,6
1805298,1495869,2025-02-20,Assembly,"Assembly Labor Committee: Reported Favorably",10,2,0,0,12
1805301,1468706,2024-10-17,Assembly,"Assembly Community Development and Womens Affairs Committee Committee: Reported with Amendments",6,0,0,0,6
1805301,1576845,2025-05-22,Assembly,"Assembly Floor: Third Reading - Final Passage",77,0,3,0,80
1805312,1459012,2024-06-24,Assembly,"Assembly Human Services Committee: Reported with Substitution",4,1,1,0,6
1805312,1461509,2024-06-28,Assembly,"Assembly Floor: Reconsidered Vote",71,0,9,0,80
1805312,1461510,2024-06-28,Assembly,"Assembly Floor: Third Reading - Final Passage",67,9,4,0,80
1805319,1401643,2024-03-04,Assembly,"Assembly State and Local Government Committee: Reported Favorably",5,2,0,0,7
1805320,1469316,2024-11-14,Assembly,"Assembly Environment and Solid Waste Committee: Reported Favorably",7,0,0,0,7
1805320,1470813,2024-12-19,Assembly,"Assembly Floor: Third Reading - Final Passage",73,0,7,0,80
1805330,1401917,2024-03-04,Assembly,"Assembly Education Committee: Reported with Amendments",9,0,0,0,9
1805335,1391660,2024-02-22,Assembly,"Assembly Higher Education Committee: Reported with Amendments",7,0,0,0,7
1805335,1411869,2024-03-18,Assembly,"Assembly Floor: Third Reading - Final Passage",77,0,3,0,80
1805350,1409528,2024-03-14,Assembly,"Assembly Regulated Professions Committee: Reported Favorably",6,0,1,0,7
1805350,1442731,2024-05-13,Assembly,"Assembly Floor: Third Reading - Final Passage",68,3,9,0,80
1805379,1485474,2025-02-10,Assembly,"Assembly Housing and Community Development Committee: Not Reported",7,0,0,0,7
1805407,1402670,2024-03-04,Assembly,"Assembly Science, Innovation and Technology Committee: Reported with Amendments",6,1,0,0,7
1805407,1444922,2024-05-20,Assembly,"Assembly Judiciary Committee: Reported with Substitution",4,2,0,0,6
1805407,1459397,2024-06-24,Assembly,"Assembly Appropriations Committee: Reported with Amendments",7,4,0,0,11
1805407,1460404,2024-06-26,Assembly,"Assembly Budget Committee: Reported with Amendments",8,0,7,0,15
1805407,1461501,2024-06-28,Assembly,"Assembly Floor: Third Reading - Final Passage",60,13,7,0,80
1805407,1468924,2024-10-24,Senate,"Senate State Government, Wagering, Tourism & Historic Preservation Committee: Reported Favorably",4,0,1,0,5
1805411,1467463,2024-09-19,Assembly,"Assembly Transportation and Independent Authorities Committee: Reported Favorably",12,0,1,0,13
1805411,1495359,2025-02-20,Assembly,"Assembly Appropriations Committee: Reported Favorably",10,0,1,0,11
1805419,1467478,2024-09-19,Assembly,"Assembly Science, Innovation and Technology Committee: Reported with Amendments",6,0,1,0,7
1805463,1376401,2024-02-05,Assembly,"Assembly Labor Committee: Reported Favorably",11,0,0,0,11
1805463,1458991,2024-06-24,Assembly,"Assembly Appropriations Committee: Reported with Amendments",11,0,0,0,11
1805463,1467698,2024-09-26,Assembly,"Assembly Floor: Third Reading - Final Passage",75,0,5,0,80
1805480,1467302,2024-09-12,Assembly,"Assembly Public Safety and Preparedness Committee Committee: Reported with Amendments",9,0,0,0,9
1805480,1467517,2024-09-23,Assembly,"Assembly Appropriations Committee: Reported with Amendments",11,0,0,0,11
1805520,1454634,2024-06-06,Assembly,"Assembly Science, Innovation and Technology Committee: Reported Favorably",6,1,0,0,7
1805530,1391728,2024-02-22,Assembly,"Assembly Housing and Community Development Committee: Reported Favorably",5,0,2,0,7
1805530,1411604,2024-03-18,Assembly,"Assembly Floor: Third Reading - Final Passage",64,11,5,0,80
1805530,1439911,2024-05-06,Senate,"Senate Community and Urban Affairs Committee: Reported with Amendments",5,0,0,0,5
1805530,1444887,2024-05-20,Senate,"Senate Floor: Substitute for S1311 (Voice Vote)",0,0,0,0,0
1805530,1444888,2024-05-20,Senate,"Senate Floor: Third Reading - Final Passage",26,10,4,0,40
1805530,1461557,2024-06-28,Assembly,"Assembly Floor: Concur in Senate Amendments",65,10,5,0,80
1805531,1572209,2025-05-15,Assembly,"Assembly Regulated Professions Committee: Not Reported",6,0,1,0,7
1805533,1409418,2024-03-14,Assembly,"Assembly Health Committee: Reported Favorably",7,3,1,0,11
1805533,1468713,2024-10-21,Assembly,"Assembly Children, Families and Food Security Committee Committee: Reported Favorably",4,0,2,0,6
1805536,1392399,2024-02-22,Assembly,"Assembly Financial Institutions and Insurance Committee: Reported with Substitution",13,0,0,0,13
1805536,1412053,2024-03-18,Assembly,"Assembly Floor: Third Reading - Final Passage",77,0,3,0,80
1805538,1472037,2025-01-16,Assembly,"Assembly Regulated Professions Committee: Reported Favorably",7,0,0,0,7
1805538,1597290,2025-06-30,Assembly,"Assembly Floor: Third Reading - Final Passage",79,0,1,0,80
1805574,1468785,2024-10-21,Assembly,"Assembly Transportation and Independent Authorities Committee: Reported Favorably",12,0,1,0,13
1805574,1470921,2024-12-19,Assembly,"Assembly Floor: Third Reading - Final Passage",70,0,10,0,80
1805576,1485014,2025-02-10,Assembly,"Assembly Regulated Professions Committee: Reported Favorably",6,0,1,0,7
1805580,1467515,2024-09-23,Assembly,"Assembly Health Committee: Reported with Amendments",6,2,3,0,11
1805580,1468975,2024-10-28,Assembly,"Assembly Floor: Third Reading - Final Passage",56,17,7,0,80
1805607,1401947,2024-03-04,Assembly,"Assembly Military and Veterans' Affairs Committee: Reported Favorably",6,0,0,0,6
1805610,1467482,2024-09-19,Assembly,"Assembly Education Committee: Reported with Amendments",7,2,0,0,9
1805610,1470907,2024-12-19,Assembly,"Assembly Floor: Third Reading - Final Passage",56,12,12,0,80
1805664,1589890,2025-06-12,Assembly,"Assembly Telecommunications and Utilities Committee: Reported Favorably",6,1,1,0,8
1805667,1439358,2024-05-06,Assembly,"Assembly Military and Veterans' Affairs Committee: Reported Favorably",6,0,0,0,6
1805667,1467709,2024-09-26,Assembly,"Assembly Floor: Third Reading - Final Passage",76,0,4,0,80
1805667,1593008,2025-06-19,Senate,"Senate Military and Veterans' Affairs Committee: Reported Favorably",5,0,0,0,5
1805687,1401939,2024-03-04,Assembly,"Assembly Judiciary Committee: Reported with Amendments",6,0,0,0,6
1805688,1452949,2024-06-03,Assembly,"Assembly Telecommunications and Utilities Committee: Reported with Amendments",8,0,0,0,8
1805688,1467696,2024-09-26,Assembly,"Assembly Floor: Third Reading - Final Passage",76,0,4,0,80
1805696,1403627,2024-03-04,Assembly,"Assembly Environment and Solid Waste Committee: Reported Favorably",5,2,0,0,7
1805696,1596066,2025-06-27,Assembly,"Assembly Budget Committee: Reported with Amendments",9,5,1,0,15
1805696,1596901,2025-06-30,Assembly,"Assembly Floor: Third Reading - Final Passage",55,24,1,0,80
1805703,1509046,2025-03-10,Assembly,"Assembly Children, Families and Food Security Committee Committee: Reported with Amendments",5,0,1,0,6
1805710,1458939,2024-06-24,Assembly,"Assembly Appropriations Committee: Reported Favorably",8,3,0,0,11
1805710,1458940,2024-06-24,Assembly,"Assembly State and Local Government Committee: Reported Favorably",7,0,0,0,7
1805710,1461603,2024-06-28,Assembly,"Assembly Floor: Third Reading - Final Passage",66,10,4,0,80
1805710,1470437,2024-12-16,Senate,"Senate State Government, Wagering, Tourism & Historic Preservation Committee: Reported Favorably",4,0,1,0,5
1805710,1595789,2025-06-26,Senate,"Senate Budget and Appropriations Committee: Reported Favorably",11,2,0,0,13
1805710,1596077,2025-06-30,Senate,"Senate Floor: Substitute for S3713 (Voice Vote)",0,0,0,0,0
1805710,1596815,2025-06-30,Senate,"Senate Floor: Third Reading - Final Passage",31,6,3,0,40
1805714,1392113,2024-02-22,Assembly,"Assembly Higher Education Committee: Reported with Amendments",6,0,1,0,7
1805716,1409333,2024-03-14,Assembly,"Assembly Regulated Professions Committee: Reported with Amendments",6,0,1,0,7
1805717,1474739,2025-01-27,Assembly,"Assembly Public Safety and Preparedness Committee Committee: Reported Favorably",9,0,0,0,9
1805717,1495909,2025-02-20,Assembly,"Assembly Labor Committee: Reported Favorably",12,0,0,0,12
1805754,1392818,2024-02-22,Assembly,"Assembly Commerce and Economic Development Committee: Reported with Substitution",9,2,1,0,12
1805754,1409373,2024-03-14,Assembly,"Assembly Appropriations Committee: Reported Favorably",7,3,1,0,11
1805755,1401935,2024-03-04,Assembly,"Assembly Military and Veterans' Affairs Committee: Reported with Amendments",6,0,0,0,6
1805771,1442349,2024-05-13,Assembly,"Assembly Regulated Professions Committee: Reported Favorably",6,0,1,0,7
1805771,1589624,2025-06-12,Assembly,"Assembly Oversight, Reform and Federal Relations Committee: Reported with Amendments",6,0,0,0,6
1805771,1595703,2025-06-26,Assembly,"Assembly Budget Committee: Reported Favorably",15,0,0,0,15
1805787,1442336,2024-05-13,Assembly,"Assembly Housing and Community Development Committee: Reported with Substitution",5,0,2,0,7
1805787,1458975,2024-06-24,Assembly,"Assembly Appropriations Committee: Reported Favorably",10,0,1,0,11
1805795,1454624,2024-06-06,Assembly,"Assembly Transportation and Independent Authorities Committee: Reported with Amendments",11,0,2,0,13
1805801,1409640,2024-03-14,Senate,"Senate Labor Committee: Reported Favorably",5,0,0,0,5
1805801,1468243,2024-10-07,Senate,"Senate Budget and Appropriations Committee: Reported with Amendments",13,0,0,0,13
1805808,1374117,2024-02-01,Assembly,"Assembly State and Local Government Committee: Reported with Amendments",7,0,0,0,7
1805808,1381773,2024-02-12,Assembly,"Assembly Floor: Third Reading - Final Passage",78,0,2,0,80
1805808,1458640,2024-06-20,Senate,"Senate State Government, Wagering, Tourism & Historic Preservation Committee: Reported Favorably",5,0,0,0,5
1805808,1468985,2024-10-28,Senate,"Senate Floor: Substitute for SJR12 (Voice Vote)",0,0,0,0,0
1805808,1468986,2024-10-28,Senate,"Senate Floor: Third Reading - Final Passage",39,0,1,0,40
1805826,1468749,2024-10-21,Assembly,"Assembly Military and Veterans' Affairs Committee: Reported Favorably",6,0,0,0,6
1805829,1452826,2024-06-03,Assembly,"Assembly Health Committee: Reported Favorably",10,0,1,0,11
1805829,1473684,2025-01-23,Assembly,"Assembly Children, Families and Food Security Committee Committee: Reported Favorably",5,0,1,0,6
1805829,1593141,2025-06-19,Assembly,"Assembly Appropriations Committee: Reported Favorably",11,0,0,0,11
1805829,1596818,2025-06-30,Assembly,"Assembly Floor: Third Reading - Final Passage",79,0,1,0,80
1805832,1568765,2025-05-08,Assembly,"Assembly Human Services Committee: Reported with Amendments",5,1,0,0,6
1805832,1589546,2025-06-12,Assembly,"Assembly Health Committee: Reported with Amendments",6,2,3,0,11
1805849,1444794,2024-05-16,Assembly,"Assembly Science, Innovation and Technology Committee: Reported with Amendments",7,0,0,0,7
1805849,1593101,2025-06-19,Assembly,"Assembly Appropriations Committee: Reported with Amendments",9,2,0,0,11
1805854,1452800,2024-06-03,Assembly,"Assembly Health Committee: Reported Favorably",10,0,1,0,11
1805854,1468972,2024-10-28,Assembly,"Assembly Floor: Third Reading - Final Passage",75,0,5,0,80
1805877,1457210,2024-06-13,Assembly,"Assembly Housing and Community Development Committee: Reported with Substitution",7,0,0,0,7
1805877,1467307,2024-09-12,Assembly,"Assembly Commerce and Economic Development Committee: Reported Favorably",7,4,1,0,12
1805877,1477812,2025-01-30,Assembly,"Assembly Floor: Third Reading - Final Passage",52,21,7,0,80
1805877,1524653,2025-03-24,Senate,"Senate Floor: Substitute for S2953 (Voice Vote)",0,0,0,0,0
1805877,1525305,2025-03-24,Senate,"Senate Floor: Third Reading - Final Passage",25,13,2,0,40
1805877,1576120,2025-05-22,Assembly,"Assembly Floor: Concur in Senate Amendments",54,23,3,0,80
1805877,1596630,2025-06-30,Assembly,"Assembly Floor: Concur Governor Recommendations",56,23,1,0,80
1805877,1596631,2025-06-30,Senate,"Senate Floor: Concur Governor Recommendations",26,12,2,0,40
1805877,1598792,2025-06-30,Assembly,"Assembly Floor: Suspend Rule 22:5b",56,23,1,0,80
1805877,1598793,2025-06-30,Senate,"Senate Floor: Suspend Rule 23:5",27,12,1,0,40
1805899,1457113,2024-06-13,Assembly,"Assembly Children, Families and Food Security Committee Committee: Reported Favorably",6,0,0,0,6
1805907,1439747,2024-05-06,Assembly,"Assembly Education Committee: Reported Favorably",9,0,0,0,9
1805907,1458957,2024-06-24,Assembly,"Assembly Appropriations Committee: Reported with Amendments",11,0,0,0,11
1805913,1452818,2024-06-03,Assembly,"Assembly Higher Education Committee: Reported Favorably",6,0,1,0,7
1805913,1467702,2024-09-26,Assembly,"Assembly Floor: Third Reading - Final Passage",74,0,6,0,80
1805914,1443771,2024-05-16,Assembly,"Assembly State and Local Government Committee: Reported with Amendments",7,0,0,0,7
1805914,1460878,2024-06-26,Assembly,"Assembly Budget Committee: Reported Favorably",13,0,2,0,15
1805920,1445002,2024-05-20,Assembly,"Assembly Judiciary Committee: Reported Favorably",6,0,0,0,6
1805930,1402654,2024-03-04,Assembly,"Assembly Science, Innovation and Technology Committee: Reported Favorably",7,0,0,0,7
1805949,1454622,2024-06-06,Assembly,"Assembly Transportation and Independent Authorities Committee: Reported Favorably",11,0,2,0,13
1805967,1485455,2025-02-10,Assembly,"Assembly Housing and Community Development Committee: Not Reported",7,0,0,0,7
1805992,1469879,2024-12-09,Assembly,"Assembly Higher Education Committee: Reported Favorably",7,0,0,0,7
1805993,1443747,2024-05-16,Assembly,"Assembly Children, Families and Food Security Committee Committee: Reported Favorably",6,0,0,0,6
1806044,1439774,2024-05-06,Assembly,"Assembly Education Committee: Reported with Amendments",8,0,1,0,9
1806044,1467540,2024-09-23,Assembly,"Assembly Appropriations Committee: Reported Favorably",11,0,0,0,11
1806057,1454612,2024-06-06,Assembly,"Assembly Human Services Committee: Reported with Amendments",6,0,0,0,6
1806057,1457926,2024-06-17,Assembly,"Assembly Health Committee: Reported Favorably",10,0,1,0,11
1806057,1496025,2025-02-20,Assembly,"Assembly Appropriations Committee: Reported with Amendments",10,0,1,0,11
1806074,1444766,2024-05-16,Assembly,"Assembly Science, Innovation and Technology Committee: Reported with Amendments",5,0,2,0,7
1806075,1469318,2024-11-14,Assembly,"Assembly Environment and Solid Waste Committee: Reported Favorably",7,0,0,0,7
1806087,1518395,2025-03-17,Assembly,"Assembly Human Services Committee: Reported Favorably",4,2,0,0,6
1806124,1392157,2024-02-22,Assembly,"Assembly Housing and Community Development Committee: Reported with Amendments",5,0,2,0,7
1806124,1458979,2024-06-24,Assembly,"Assembly Appropriations Committee: Reported Favorably",7,3,1,0,11
1806126,1467461,2024-09-19,Assembly,"Assembly Transportation and Independent Authorities Committee: Reported with Amendments",7,4,2,0,13
1806126,1475149,2025-01-27,Assembly,"Assembly Public Safety and Preparedness Committee Committee: Reported Favorably",6,3,0,0,9
1806126,1477811,2025-01-30,Assembly,"Assembly Floor: Third Reading - Final Passage",51,22,7,0,80
1806126,1518470,2025-03-17,Senate,"Senate Transportation Committee: Reported with Amendments",5,0,1,0,6
1806126,1583063,2025-06-02,Senate,"Senate Floor: Substitute for S4134 (Voice Vote)",0,0,0,0,0
1806126,1583823,2025-06-02,Senate,"Senate Floor: Third Reading - Final Passage",28,10,2,0,40
1806126,1596608,2025-06-30,Assembly,"Assembly Floor: Concur in Senate Amendments",56,24,0,0,80
1806131,1468695,2024-10-17,Assembly,"Assembly Community Development and Womens Affairs Committee Committee: Reported Favorably",6,0,0,0,6
1806131,1522625,2025-03-20,Assembly,"Assembly Health Committee: Reported with Amendments",8,2,1,0,11
1806144,1392646,2024-02-22,Assembly,"Assembly Commerce and Economic Development Committee: Reported Favorably",12,0,0,0,12
1806144,1458928,2024-06-24,Assembly,"Assembly Appropriations Committee: Reported Favorably",11,0,0,0,11
1806153,1470420,2024-12-16,Assembly,"Assembly Health Committee: Reported with Amendments",10,0,1,0,11
1806153,1478058,2025-01-30,Assembly,"Assembly Floor: Third Reading - Final Passage",72,1,7,0,80
1806153,1586674,2025-06-09,Senate,"Senate Health, Human Services and Senior Citizens Committee: Reported with Amendments",7,0,1,0,8
1806159,1489455,2025-02-13,Assembly,"Assembly Tourism, Gaming and the Arts Committee: Reported Favorably",6,0,0,0,6
1806162,1470488,2024-12-16,Assembly,"Assembly Health Committee: Reported Favorably",10,0,1,0,11
1806207,1371722,2024-01-29,Assembly,"Assembly Housing and Community Development Committee: Reported with Amendments",7,0,0,0,7
1806207,1379697,2024-02-08,Assembly,"Assembly Appropriations Committee: Reported Favorably",9,2,0,0,11
1806207,1381771,2024-02-12,Assembly,"Assembly Floor: Third Reading - Final Passage",73,6,1,0,80
1806207,1440375,2024-05-06,Senate,"Senate Community and Urban Affairs Committee: Reported Favorably",4,0,1,0,5
1806207,1595956,2025-06-26,Senate,"Senate Budget and Appropriations Committee: Reported with Amendments",9,4,0,0,13
1806207,1596523,2025-06-30,Senate,"Senate Floor: Substitute for S4071 (Voice Vote)",0,0,0,0,0
1806207,1596971,2025-06-30,Assembly,"Assembly Floor: Concur in Senate Amendments",68,11,1,0,80
1806207,1596972,2025-06-30,Senate,"Senate Floor: Third Reading - Final Passage",26,13,1,0,40
1806210,1467526,2024-09-23,Assembly,"Assembly Health Committee: Reported with Amendments",5,3,3,0,11
1806224,1403130,2024-03-04,Assembly,"Assembly Science, Innovation and Technology Committee: Reported with Amendments",5,1,1,0,7
1806224,1444914,2024-05-20,Assembly,"Assembly Judiciary Committee: Reported Favorably",4,0,2,0,6
1806252,1452993,2024-06-03,Assembly,"Assembly Consumer Affairs Committee: Reported Favorably",6,0,0,0,6
1806263,1468920,2024-10-24,Assembly,"Assembly Regulated Professions Committee: Reported with Amendments",5,0,2,0,7
1806263,1470806,2024-12-19,Assembly,"Assembly Floor: Third Reading - Final Passage",70,2,8,0,80
1806265,1470421,2024-12-16,Assembly,"Assembly Health Committee: Reported with Amendments",10,0,1,0,11
1806265,1572518,2025-05-15,Assembly,"Assembly Appropriations Committee: Reported with Amendments",11,0,0,0,11
1806265,1576667,2025-05-22,Assembly,"Assembly Floor: Third Reading - Final Passage",77,0,3,0,80
1806272,1591002,2025-06-16,Assembly,"Assembly Military and Veterans' Affairs Committee: Reported Favorably",5,0,1,0,6
1806275,1392900,2024-02-22,Assembly,"Assembly Regulated Professions Committee: Reported Favorably",7,0,0,0,7
1806275,1411704,2024-03-18,Assembly,"Assembly Floor: Third Reading - Final Passage",77,0,3,0,80
1806275,1485066,2025-02-10,Senate,"Senate Commerce Committee: Reported with Amendments",5,0,0,0,5
1806288,1458929,2024-06-24,Assembly,"Assembly Human Services Committee: Reported Favorably",6,0,0,0,6
1806304,1474685,2025-01-27,Assembly,"Assembly Consumer Affairs Committee: Reported Favorably",6,0,0,0,6
1806309,1468752,2024-10-21,Assembly,"Assembly Education Committee: Reported with Amendments",9,0,0,0,9
1806329,1470188,2024-12-12,Assembly,"Assembly Environment and Solid Waste Committee: Reported Favorably",7,0,0,0,7
1806329,1470851,2024-12-19,Assembly,"Assembly Floor: Third Reading - Final Passage",73,0,7,0,80
1806339,1371723,2024-01-29,Assembly,"Assembly Housing and Community Development Committee: Reported Favorably",5,0,2,0,7
1806339,1380070,2024-02-08,Assembly,"Assembly Appropriations Committee: Reported with Amendments",11,0,0,0,11
1806339,1382299,2024-02-12,Assembly,"Assembly Floor: Third Reading - Final Passage",64,14,2,0,80
1806339,1407169,2024-03-11,Senate,"Senate Budget and Appropriations Committee: Reported Favorably",10,3,0,0,13
1806339,1410061,2024-03-18,Senate,"Senate Floor: Substitute for S2312 (Voice Vote)",0,0,0,0,0
1806339,1411759,2024-03-18,Senate,"Senate Floor: Third Reading - Final Passage",28,8,4,0,40
1806368,1442300,2024-05-13,Assembly,"Assembly Health Committee: Reported Favorably",10,0,1,0,11
1806368,1470875,2024-12-19,Assembly,"Assembly Floor: Third Reading - Final Passage",72,0,8,0,80
1806377,1467475,2024-09-19,Assembly,"Assembly State and Local Government Committee: Reported with Amendments",7,0,0,0,7
1806381,1409365,2024-03-14,Assembly,"Assembly Human Services Committee: Reported Favorably",5,0,1,0,6
1806389,1489312,2025-02-13,Assembly,"Assembly Tourism, Gaming and the Arts Committee: Reported with Amendments",6,0,0,0,6
1806389,1525440,2025-03-24,Assembly,"Assembly Floor: Third Reading - Final Passage",77,0,3,0,80
1806389,1576646,2025-05-22,Senate,"Senate Higher Eduction Committee: Reported Favorably",4,0,1,0,5
1806407,1452829,2024-06-03,Assembly,"Assembly Higher Education Committee: Reported with Amendments",5,0,2,0,7
1806407,1469002,2024-10-28,Assembly,"Assembly Floor: Third Reading - Final Passage",63,5,12,0,80
1806412,1474047,2025-01-23,Assembly,"Assembly Science, Innovation and Technology Committee: Reported Favorably",7,0,0,0,7
1806417,1391632,2024-02-22,Assembly,"Assembly Health Committee: Reported Favorably",9,0,2,0,11
1806417,1442342,2024-05-13,Assembly,"Assembly Regulated Professions Committee: Reported Favorably",6,0,1,0,7
1806421,1468717,2024-10-21,Assembly,"Assembly Military and Veterans' Affairs Committee: Reported Favorably",6,0,0,0,6
1806426,1468707,2024-10-17,Assembly,"Assembly Community Development and Womens Affairs Committee Committee: Reported with Amendments",6,0,0,0,6
1806426,1474938,2025-01-27,Assembly,"Assembly Financial Institutions and Insurance Committee: Reported with Amendments",7,0,6,0,13
1806426,1523417,2025-03-20,Assembly,"Assembly Appropriations Committee: Reported with Amendments",8,0,3,0,11
1806426,1525006,2025-03-24,Assembly,"Assembly Floor: Third Reading - Final Passage",69,0,11,0,80
1806437,1443693,2024-05-16,Assembly,"Assembly Environment and Solid Waste Committee: Reported with Amendments",7,0,0,0,7
1806439,1568265,2025-05-08,Assembly,"Assembly Children, Families and Food Security Committee Committee: Reported with Amendments",5,0,1,0,6
1806439,1595717,2025-06-26,Assembly,"Assembly Budget Committee: Reported with Amendments",15,0,0,0,15
1806457,1470162,2024-12-12,Assembly,"Assembly Education Committee: Reported with Amendments",7,0,2,0,9
1806457,1477809,2025-01-30,Assembly,"Assembly Floor: Third Reading - Final Passage",64,3,13,0,80
1806457,1596517,2025-06-30,Senate,"Senate Floor: Substitute for S1054 (Voice Vote)",0,0,0,0,0
1806457,1596776,2025-06-30,Assembly,"Assembly Floor: Concur in Senate Amendments",76,3,1,0,80
1806457,1596777,2025-06-30,Senate,"Senate Floor: Third Reading - Final Passage",35,3,2,0,40
1806463,1467296,2024-09-12,Assembly,"Assembly Financial Institutions and Insurance Committee: Reported Favorably",12,0,1,0,13
1806465,1442696,2024-05-13,Assembly,"Assembly Community Development and Womens Affairs Committee Committee: Reported Favorably",6,0,0,0,6
1806487,1470227,2024-12-12,Assembly,"Assembly Transportation and Independent Authorities Committee: Reported with Amendments",13,0,0,0,13
1806488,1442372,2024-05-13,Assembly,"Assembly Health Committee: Reported Favorably",10,0,1,0,11
1806488,1467705,2024-09-26,Assembly,"Assembly Floor: Third Reading - Final Passage",76,0,4,0,80
1806509,1401854,2024-03-04,Assembly,"Assembly Education Committee: Reported Favorably",8,0,1,0,9
1806567,1407496,2024-03-11,Assembly,"Assembly Labor Committee: Reported with Amendments",10,1,0,0,11
1806575,1454784,2024-06-06,Assembly,"Assembly Judiciary Committee: Reported Favorably",5,0,0,0,5
1806575,1467304,2024-09-12,Assembly,"Assembly Public Safety and Preparedness Committee Committee: Reported with Amendments",9,0,0,0,9
1806579,1522728,2025-03-20,Assembly,"Assembly Telecommunications and Utilities Committee: Reported with Amendments",5,3,0,0,8
1806579,1525086,2025-03-24,Assembly,"Assembly Floor: Third Reading - Final Passage",63,15,2,0,80
1806580,1470411,2024-12-16,Assembly,"Assembly Public Safety and Preparedness Committee Committee: Reported Favorably",9,0,0,0,9
1806580,1478107,2025-01-30,Assembly,"Assembly Floor: Third Reading - Final Passage",73,0,7,0,80
1806580,1596244,2025-06-30,Senate,"Senate Floor: Substitute for S2223 (Voice Vote)",0,0,0,0,0
1806580,1596695,2025-06-30,Senate,"Senate Floor: Third Reading - Final Passage",39,0,1,0,40
1806586,1443778,2024-05-16,Assembly,"Assembly Tourism, Gaming and the Arts Committee: Reported with Amendments",6,0,0,0,6
1806589,1470224,2024-12-12,Assembly,"Assembly Judiciary Committee: Reported with Amendments",6,0,0,0,6
1806589,1470917,2024-12-19,Assembly,"Assembly Floor: Third Reading - Final Passage",71,0,9,0,80
1806591,1443848,2024-05-16,Assembly,"Assembly Environment and Solid Waste Committee: Reported with Amendments",5,0,2,0,7
1806595,1470261,2024-12-12,Assembly,"Assembly Human Services Committee: Reported with Amendments",5,0,1,0,6
1806597,1443753,2024-05-16,Assembly,"Assembly Tourism, Gaming and the Arts Committee: Reported Favorably",6,0,0,0,6
1806611,1371718,2024-01-29,Assembly,"Assembly Housing and Community Development Committee: Reported with Amendments",7,0,0,0,7
1806611,1379992,2024-02-08,Assembly,"Assembly Appropriations Committee: Reported with Amendments",9,2,0,0,11
1806611,1381768,2024-02-12,Assembly,"Assembly Floor: Third Reading - Final Passage",70,8,2,0,80
1806611,1407172,2024-03-11,Senate,"Senate Budget and Appropriations Committee: Reported Favorably",13,0,0,0,13
1806611,1410058,2024-03-18,Senate,"Senate Floor: Substitute for S1484 (Voice Vote)",0,0,0,0,0
1806611,1411714,2024-03-18,Senate,"Senate Floor: Third Reading - Final Passage",31,6,3,0,40
1806629,1485172,2025-02-10,Assembly,"Assembly Housing and Community Development Committee: Reported Favorably",7,0,0,0,7
1806630,1469355,2024-11-14,Assembly,"Assembly Public Safety and Preparedness Committee Committee: Reported Favorably",7,0,2,0,9
1806642,1454934,2024-06-06,Assembly,"Assembly Education Committee: Reported Favorably",9,0,0,0,9
1806654,1467554,2024-09-23,Assembly,"Assembly Environment and Solid Waste Committee: Reported Favorably",7,0,0,0,7
1806654,1469010,2024-10-28,Assembly,"Assembly Floor: Third Reading - Final Passage",75,2,3,0,80
1806664,1590938,2025-06-16,Assembly,"Assembly Education Committee: Reported with Amendments",9,0,0,0,9
1806686,1470161,2024-12-12,Assembly,"Assembly Human Services Committee: Reported Favorably",5,0,1,0,6
1806693,1452921,2024-06-03,Assembly,"Assembly Telecommunications and Utilities Committee: Reported with Amendments",8,0,0,0,8
1806695,1439356,2024-05-06,Assembly,"Assembly Military and Veterans' Affairs Committee: Reported Favorably",6,0,0,0,6
1806701,1467493,2024-09-19,Assembly,"Assembly Judiciary Committee: Reported Favorably",6,0,0,0,6
1806705,1442353,2024-05-13,Assembly,"Assembly Community Development and Womens Affairs Committee Committee: Reported Favorably",6,0,0,0,6
1806735,1401502,2024-03-04,Assembly,"Assembly Military and Veterans' Affairs Committee: Reported Favorably",6,0,0,0,6
1806739,1468718,2024-10-21,Assembly,"Assembly Children, Families and Food Security Committee Committee: Reported Favorably",6,0,0,0,6
1806743,1443766,2024-05-16,Assembly,"Assembly Environment and Solid Waste Committee: Reported Favorably",7,0,0,0,7
1806743,1458938,2024-06-24,Assembly,"Assembly Appropriations Committee: Reported Favorably",11,0,0,0,11
1806743,1467676,2024-09-26,Assembly,"Assembly Floor: Third Reading - Final Passage",75,0,5,0,80
1806743,1468623,2024-10-10,Senate,"Senate Environment and Energy Committee: Reported Favorably",5,0,0,0,5
1806745,1572487,2025-05-15,Assembly,"Assembly Financial Institutions and Insurance Committee: Reported with Amendments",9,0,4,0,13
1806752,1454507,2024-06-06,Assembly,"Assembly Military and Veterans' Affairs Committee: Reported Favorably",6,0,0,0,6
1806767,1522544,2025-03-20,Assembly,"Assembly Health Committee: Reported with Amendments",10,0,1,0,11
1806767,1568250,2025-05-08,Assembly,"Assembly Children, Families and Food Security Committee Committee: Reported Favorably",5,0,1,0,6
1806782,1469885,2024-12-09,Assembly,"Assembly Housing and Community Development Committee: Reported Favorably",7,0,0,0,7
1806783,1568497,2025-05-08,Assembly,"Assembly Transportation and Independent Authorities Committee: Reported with Amendments",12,0,1,0,13
1806790,1468946,2024-10-24,Assembly,"Assembly Labor Committee: Reported Favorably",10,0,1,0,11
1806804,1468802,2024-10-21,Assembly,"Assembly Transportation and Independent Authorities Committee: Reported with Amendments",9,2,2,0,13
1806804,1543339,2025-04-10,Assembly,"Assembly State and Local Government Committee: Reported with Amendments",7,0,0,0,7
1806804,1576815,2025-05-22,Assembly,"Assembly Floor: Third Reading - Final Passage",53,23,4,0,80
1806804,1595775,2025-06-26,Senate,"Senate Budget and Appropriations Committee: Reported with Amendments",9,4,0,0,13
1806814,1376379,2024-02-05,Assembly,"Assembly Labor Committee: Reported Favorably",11,0,0,0,11
1806814,1379831,2024-02-08,Assembly,"Assembly Appropriations Committee: Reported Favorably",11,0,0,0,11
1806829,1468705,2024-10-17,Assembly,"Assembly Community Development and Womens Affairs Committee Committee: Reported with Amendments",6,0,0,0,6
1806829,1469038,2024-10-28,Assembly,"Assembly Floor: Third Reading - Final Passage",77,0,3,0,80
1806829,1470204,2024-12-12,Senate,"Senate Commerce Committee: Reported Favorably",5,0,0,0,5
1806829,1479296,2025-02-03,Senate,"Senate Budget and Appropriations Committee: Reported Favorably",12,0,1,0,13
1806834,1565156,2025-05-05,Assembly,"Assembly Community Development and Womens Affairs Committee Committee: Reported Favorably",6,0,0,0,6
1806844,1401601,2024-03-04,Assembly,"Assembly Military and Veterans' Affairs Committee: Reported Favorably",6,0,0,0,6
1806864,1392097,2024-02-22,Assembly,"Assembly Regulated Professions Committee: Reported with Amendments",5,0,2,0,7
1806864,1467703,2024-09-26,Assembly,"Assembly Floor: Third Reading - Final Passage",66,9,5,0,80
1806878,1467489,2024-09-19,Assembly,"Assembly Military and Veterans' Affairs Committee: Reported Favorably",6,0,0,0,6
1806878,1577974,2025-05-22,Assembly,"Assembly Floor: Third Reading - Final Passage",78,0,2,0,80
1806881,1442477,2024-05-13,Assembly,"Assembly Regulated Professions Committee: Reported Favorably",6,0,1,0,7
1806881,1460852,2024-06-26,Assembly,"Assembly Budget Committee: Reported with Amendments",13,0,2,0,15
1806882,1454857,2024-06-06,Assembly,"Assembly Judiciary Committee: Reported with Amendments",6,0,0,0,6
1806882,1470942,2024-12-19,Assembly,"Assembly Floor: Third Reading - Final Passage",73,0,7,0,80
1806886,1467289,2024-09-12,Assembly,"Assembly Financial Institutions and Insurance Committee: Reported Favorably",12,0,1,0,13
1806892,1572123,2025-05-15,Assembly,"Assembly Appropriations Committee: Reported with Substitution",7,4,0,0,11
1806903,1489361,2025-02-13,Assembly,"Assembly Military and Veterans' Affairs Committee: Not Reported",5,0,1,0,6
1806903,1518449,2025-03-17,Assembly,"Assembly Military and Veterans' Affairs Committee: Reported Favorably",5,0,1,0,6
1806904,1507449,2025-03-06,Assembly,"Assembly Health Committee: Reported with Amendments",10,0,1,0,11
1806904,1525394,2025-03-24,Assembly,"Assembly Floor: Third Reading - Final Passage",76,2,2,0,80
1806914,1572081,2025-05-15,Assembly,"Assembly Public Safety and Preparedness Committee Committee: Reported Favorably",6,0,3,0,9
1806918,1409326,2024-03-14,Assembly,"Assembly Health Committee: Reported with Amendments",9,1,1,0,11
1806918,1474725,2025-01-27,Assembly,"Assembly Financial Institutions and Insurance Committee: Reported with Substitution",12,0,1,0,13
1806918,1523175,2025-03-20,Assembly,"Assembly Appropriations Committee: Reported with Substitution",11,0,0,0,11
1806918,1524932,2025-03-24,Assembly,"Assembly Floor: Third Reading - Final Passage",75,2,3,0,80
1806918,1524933,2025-03-24,Senate,"Senate Floor: Substitute for S3533 (Voice Vote)",0,0,0,0,0
1806918,1524934,2025-03-24,Senate,"Senate Floor: Third Reading - Final Passage",39,0,1,0,40
1806921,1409648,2024-03-14,Assembly,"Assembly Regulated Professions Committee: Reported with Amendments",6,0,1,0,7
1806921,1442452,2024-05-13,Assembly,"Assembly Floor: Third Reading - Final Passage",64,7,9,0,80
1806944,1403191,2024-03-04,Assembly,"Assembly Transportation and Independent Authorities Committee: Reported Favorably",13,0,0,0,13
1806985,1468962,2024-10-24,Assembly,"Assembly Consumer Affairs Committee: Reported with Amendments",4,0,2,0,6
1806992,1392660,2024-02-22,Assembly,"Assembly Health Committee: Reported with Amendments",9,2,0,0,11
1806992,1425486,2024-04-11,Assembly,"Assembly Appropriations Committee: Reported with Amendments",6,2,3,0,11
1806992,1459006,2024-06-24,Assembly,"Assembly Appropriations Committee: Reported with Amendments",8,3,0,0,11
1806992,1461420,2024-06-28,Senate,"Senate Floor: Substitute for S2552 (Voice Vote)",0,0,0,0,0
1806992,1461519,2024-06-28,Assembly,"Assembly Floor: Third Reading - Final Passage",59,16,5,0,80
1806992,1461520,2024-06-28,Senate,"Senate Floor: Third Reading - Final Passage",38,1,1,0,40
1807010,1407005,2024-03-11,Assembly,"Assembly Education Committee: Reported Favorably",7,1,1,0,9
1807029,1468748,2024-10-21,Assembly,"Assembly Military and Veterans' Affairs Committee: Reported Favorably",6,0,0,0,6
1807029,1470221,2024-12-12,Assembly,"Assembly State and Local Government Committee: Reported Favorably",7,0,0,0,7
1807035,1454625,2024-06-06,Assembly,"Assembly Military and Veterans' Affairs Committee: Reported with Amendments",6,0,0,0,6
1807047,1457209,2024-06-13,Assembly,"Assembly Housing and Community Development Committee: Not Reported",7,0,0,0,7
1807061,1454659,2024-06-06,Assembly,"Assembly Education Committee: Reported Favorably",9,0,0,0,9
1807061,1458992,2024-06-24,Assembly,"Assembly Appropriations Committee: Reported with Amendments",8,2,1,0,11
1807061,1461518,2024-06-28,Assembly,"Assembly Floor: Third Reading - Final Passage",69,6,5,0,80
1807061,1470434,2024-12-16,Senate,"Senate State Government, Wagering, Tourism & Historic Preservation Committee: Reported Favorably",4,0,1,0,5
1807061,1518416,2025-03-17,Senate,"Senate Budget and Appropriations Committee: Reported with Amendments",10,3,0,0,13
1807061,1524846,2025-03-24,Senate,"Senate Floor: Substitute for S2078 (Voice Vote)",0,0,0,0,0
1807061,1525433,2025-03-24,Senate,"Senate Floor: Third Reading - Final Passage",31,5,4,0,40
1807061,1596902,2025-06-30,Assembly,"Assembly Floor: Concur in Senate Amendments",69,9,2,0,80
1807062,1442348,2024-05-13,Assembly,"Assembly Commerce and Economic Development Committee: Reported with Amendments",12,0,0,0,12
1807062,1458942,2024-06-24,Assembly,"Assembly Appropriations Committee: Reported with Amendments",7,2,2,0,11
1807062,1470416,2024-12-16,Assembly,"Assembly Appropriations Committee: Reported with Amendments",7,2,2,0,11
1807065,1407158,2024-03-11,Assembly,"Assembly Education Committee: Reported with Amendments",9,0,0,0,9
1807065,1427380,2024-04-15,Assembly,"Assembly Floor: Third Reading - Final Passage",72,0,8,0,80
1807065,1444890,2024-05-20,Senate,"Senate Floor: Substitute for S3000 (Voice Vote)",0,0,0,0,0
1807065,1444891,2024-05-20,Senate,"Senate Floor: Third Reading - Final Passage",37,0,3,0,40
1807065,1467667,2024-09-26,Assembly,"Assembly Floor: Concur Governor Recommendations",73,2,5,0,80
1807065,1467668,2024-09-26,Assembly,"Assembly Floor: Suspend Rule 22:4",72,1,7,0,80
1807065,1467872,2024-09-30,Senate,"Senate Floor: Concur Governor Recommendations",34,0,6,0,40
1807072,1568492,2025-05-08,Assembly,"Assembly Human Services Committee: Reported with Amendments",6,0,0,0,6
1807088,1507070,2025-03-06,Assembly,"Assembly Health Committee: Reported Favorably",9,1,1,0,11
1807088,1523075,2025-03-20,Assembly,"Assembly Appropriations Committee: Reported Favorably",9,0,2,0,11
1807088,1576891,2025-05-22,Assembly,"Assembly Floor: Third Reading - Final Passage",71,2,7,0,80
1807093,1391669,2024-02-22,Assembly,"Assembly Higher Education Committee: Reported Favorably",7,0,0,0,7
1807093,1467538,2024-09-23,Assembly,"Assembly Appropriations Committee: Reported with Amendments",9,1,1,0,11
1807093,1469016,2024-10-28,Assembly,"Assembly Floor: Third Reading - Final Passage",66,10,4,0,80
1807093,1485141,2025-02-10,Senate,"Senate Higher Eduction Committee: Reported with Amendments",5,0,0,0,5
1807097,1374116,2024-02-01,Assembly,"Assembly State and Local Government Committee: Reported with Amendments",7,0,0,0,7
1807106,1457102,2024-06-13,Assembly,"Assembly Financial Institutions and Insurance Committee: Reported with Amendments",13,0,0,0,13
1807106,1458931,2024-06-24,Assembly,"Assembly Appropriations Committee: Reported Favorably",11,0,0,0,11
1807106,1461624,2024-06-28,Assembly,"Assembly Floor: Third Reading - Final Passage",67,2,11,0,80
1807116,1467464,2024-09-19,Assembly,"Assembly Labor Committee: Reported with Amendments",9,0,2,0,11
1807117,1452812,2024-06-03,Assembly,"Assembly Higher Education Committee: Reported Favorably",6,0,1,0,7
1807141,1454520,2024-06-06,Assembly,"Assembly Military and Veterans' Affairs Committee: Reported Favorably",6,0,0,0,6
1807143,1489600,2025-02-13,Assembly,"Assembly Military and Veterans' Affairs Committee: Reported Favorably",5,0,1,0,6
1807143,1522539,2025-03-20,Assembly,"Assembly State and Local Government Committee: Reported Favorably",7,0,0,0,7
1807145,1590977,2025-06-16,Assembly,"Assembly Labor Committee: Reported Favorably",10,1,1,0,12
1807149,1453001,2024-06-03,Assembly,"Assembly Regulated Professions Committee: Reported with Substitution",7,0,0,0,7
1807156,1467552,2024-09-23,Assembly,"Assembly Environment and Solid Waste Committee: Reported with Amendments",5,1,1,0,7
1807158,1401755,2024-03-04,Assembly,"Assembly Judiciary Committee: Reported Favorably",6,0,0,0,6
1807158,1467300,2024-09-12,Assembly,"Assembly Public Safety and Preparedness Committee Committee: Reported Favorably",8,0,1,0,9
1807167,1409627,2024-03-14,Assembly,"Assembly Human Services Committee: Reported Favorably",5,0,1,0,6
1807167,1427155,2024-04-15,Assembly,"Assembly Floor: Third Reading - Final Passage",73,0,7,0,80
1807167,1445063,2024-05-20,Senate,"Senate Floor: Substitute for SJR66 (Voice Vote)",0,0,0,0,0
1807167,1445064,2024-05-20,Senate,"Senate Floor: Third Reading - Final Passage",37,0,3,0,40
1807213,1442310,2024-05-13,Assembly,"Assembly Regulated Professions Committee: Reported Favorably",6,0,1,0,7
1807230,1543998,2025-04-10,Assembly,"Assembly Science, Innovation and Technology Committee: Reported Favorably",5,1,1,0,7
1807230,1568272,2025-05-08,Assembly,"Assembly Children, Families and Food Security Committee Committee: Reported Favorably",5,0,1,0,6
1807251,1391705,2024-02-22,Assembly,"Assembly Housing and Community Development Committee: Reported Favorably",5,0,2,0,7
1807251,1412210,2024-03-18,Assembly,"Assembly Floor: Third Reading - Final Passage",76,1,3,0,80
1807251,1589517,2025-06-12,Senate,"Senate Commerce Committee: Reported Favorably",5,0,0,0,5
1807252,1452809,2024-06-03,Assembly,"Assembly Commerce and Economic Development Committee: Reported Favorably",9,2,1,0,12
1807276,1391641,2024-02-22,Assembly,"Assembly Housing and Community Development Committee: Reported with Amendments",5,0,2,0,7
1807276,1409122,2024-03-14,Assembly,"Assembly Appropriations Committee: Reported Favorably",11,0,0,0,11
1807276,1426907,2024-04-15,Assembly,"Assembly Floor: Third Reading - Final Passage",71,1,8,0,80
1807276,1460855,2024-06-26,Senate,"Senate Budget and Appropriations Committee: Reported with Amendments",13,0,0,0,13
1807276,1461392,2024-06-28,Senate,"Senate Floor: Substitute for S1443 (Voice Vote)",0,0,0,0,0
1807276,1461600,2024-06-28,Assembly,"Assembly Floor: Concur in Senate Amendments",70,0,10,0,80
1807276,1461601,2024-06-28,Senate,"Senate Floor: Third Reading - Final Passage",40,0,0,0,40
1807290,1467466,2024-09-19,Assembly,"Assembly Judiciary Committee: Reported Favorably",6,0,0,0,6
1807290,1474771,2025-01-27,Assembly,"Assembly Public Safety and Preparedness Committee Committee: Reported with Substitution",9,0,0,0,9
1807290,1502202,2025-02-27,Assembly,"Assembly Floor: Third Reading - Final Passage",75,0,5,0,80
1807291,1402676,2024-03-04,Assembly,"Assembly Transportation and Independent Authorities Committee: Reported Favorably",13,0,0,0,13
1807291,1467535,2024-09-23,Assembly,"Assembly Appropriations Committee: Reported Favorably",11,0,0,0,11
1807296,1522477,2025-03-20,Assembly,"Assembly Community Development and Womens Affairs Committee Committee: Reported with Amendments",4,2,0,0,6
1807303,1452772,2024-06-03,Assembly,"Assembly Commerce and Economic Development Committee: Reported with Amendments",11,0,1,0,12
1807303,1458996,2024-06-24,Assembly,"Assembly Appropriations Committee: Reported with Amendments",11,0,0,0,11
1807308,1459005,2024-06-24,Assembly,"Assembly Appropriations Committee: Reported with Substitution",8,3,0,0,11
1807308,1461425,2024-06-28,Senate,"Senate Floor: Substitute for S2647 (Voice Vote)",0,0,0,0,0
1807308,1461545,2024-06-28,Assembly,"Assembly Floor: Third Reading - Final Passage",65,10,5,0,80
1807308,1461546,2024-06-28,Senate,"Senate Floor: Third Reading - Final Passage",40,0,0,0,40
1807324,1407506,2024-03-11,Assembly,"Assembly Labor Committee: Reported Favorably",10,1,0,0,11
1807324,1411672,2024-03-18,Assembly,"Assembly Floor: Third Reading - Final Passage",59,17,4,0,80
1807334,1472042,2025-01-16,Assembly,"Assembly Regulated Professions Committee: Reported with Amendments",7,0,0,0,7
1807334,1477932,2025-01-30,Assembly,"Assembly Floor: Third Reading - Final Passage",75,0,5,0,80
1807361,1442308,2024-05-13,Assembly,"Assembly Housing and Community Development Committee: Reported Favorably",5,0,2,0,7
1807361,1458927,2024-06-24,Assembly,"Assembly Appropriations Committee: Reported Favorably",11,0,0,0,11
1807361,1461613,2024-06-28,Assembly,"Assembly Floor: Third Reading - Final Passage",77,0,3,0,80
1807361,1468932,2024-10-24,Senate,"Senate State Government, Wagering, Tourism & Historic Preservation Committee: Reported Favorably",4,0,1,0,5
1807361,1469858,2024-12-09,Senate,"Senate Budget and Appropriations Committee: Reported Favorably",13,0,0,0,13
1807361,1471667,2025-01-14,Senate,"Senate Floor: Substitute for S1285 (Voice Vote)",0,0,0,0,0
1807361,1471668,2025-01-14,Senate,"Senate Floor: Third Reading - Final Passage",35,0,4,0,39
1807389,1467490,2024-09-19,Assembly,"Assembly Education Committee: Reported with Amendments",9,0,0,0,9
1807390,1507347,2025-03-06,Assembly,"Assembly Consumer Affairs Committee: Reported with Substitution",4,0,2,0,6
1807406,1439795,2024-05-06,Assembly,"Assembly Human Services Committee: Reported Favorably",6,0,0,0,6
1807415,1442307,2024-05-13,Assembly,"Assembly Health Committee: Reported Favorably",9,0,2,0,11
1807424,1392191,2024-02-22,Assembly,"Assembly Regulated Professions Committee: Reported Favorably",5,0,2,0,7
1807428,1509044,2025-03-10,Assembly,"Assembly Transportation and Independent Authorities Committee: Reported with Substitution",12,0,1,0,13
1807478,1439386,2024-05-06,Assembly,"Assembly Military and Veterans' Affairs Committee: Reported with Substitution",6,0,0,0,6
1807493,1454600,2024-06-06,Assembly,"Assembly Labor Committee: Reported Favorably",10,0,1,0,11
1807496,1392298,2024-02-22,Assembly,"Assembly Committee: Reported Favorably",9,0,0,0,9
1807496,1393117,2024-02-22,Assembly,"Assembly Public Safety and Preparedness Committee Committee: Reported Favorably",9,0,0,0,9
1807518,1495011,2025-02-20,Assembly,"Assembly Judiciary Committee: Reported with Amendments",4,0,2,0,6
1807518,1525180,2025-03-24,Assembly,"Assembly Floor: Third Reading - Final Passage",54,24,2,0,80
1807528,1439355,2024-05-06,Assembly,"Assembly Military and Veterans' Affairs Committee: Reported Favorably",6,0,0,0,6
1807553,1407507,2024-03-11,Assembly,"Assembly Labor Committee: Reported Favorably",11,0,0,0,11
1807553,1458976,2024-06-24,Assembly,"Assembly Appropriations Committee: Reported with Amendments",11,0,0,0,11
1807562,1572103,2025-05-15,Assembly,"Assembly Public Safety and Preparedness Committee Committee: Reported Favorably",7,0,2,0,9
1807562,1576131,2025-05-22,Assembly,"Assembly Floor: Third Reading - Final Passage",77,0,3,0,80
1807581,1454642,2024-06-06,Assembly,"Assembly Transportation and Independent Authorities Committee: Reported Favorably",11,0,2,0,13
1807581,1458930,2024-06-24,Assembly,"Assembly Appropriations Committee: Reported Favorably",11,0,0,0,11
1807581,1461561,2024-06-28,Assembly,"Assembly Floor: Third Reading - Final Passage",71,1,8,0,80
1807585,1444923,2024-05-20,Assembly,"Assembly Judiciary Committee: Not Reported",3,2,1,0,6
1807586,1454640,2024-06-06,Assembly,"Assembly Transportation and Independent Authorities Committee: Reported Favorably",11,0,2,0,13
1807586,1467669,2024-09-26,Assembly,"Assembly Floor: Third Reading - Final Passage",76,0,4,0,80
1807587,1473638,2025-01-23,Assembly,"Assembly State and Local Government Committee: Reported Favorably",6,0,1,0,7
1807587,1477821,2025-01-30,Assembly,"Assembly Floor: Third Reading - Final Passage",73,0,7,0,80
1807615,1453028,2024-06-03,Assembly,"Assembly Public Safety and Preparedness Committee Committee: Reported Favorably",9,0,0,0,9
1807615,1470484,2024-12-16,Assembly,"Assembly Appropriations Committee: Reported Favorably",10,0,1,0,11
1807616,1509740,2025-03-10,Assembly,"Assembly Judiciary Committee: Reported Favorably",6,0,0,0,6
1807619,1376381,2024-02-05,Assembly,"Assembly Labor Committee: Reported Favorably",11,0,0,0,11
1807643,1467507,2024-09-23,Assembly,"Assembly Children, Families and Food Security Committee Committee: Reported with Amendments",6,0,0,0,6
1807643,1523345,2025-03-20,Assembly,"Assembly Appropriations Committee: Reported with Substitution",11,0,0,0,11
1807643,1596861,2025-06-30,Assembly,"Assembly Floor: Third Reading - Final Passage",80,0,0,0,80
1807656,1467546,2024-09-23,Assembly,"Assembly Higher Education Committee: Reported Favorably",6,0,1,0,7
1807662,1439385,2024-05-06,Assembly,"Assembly Transportation and Independent Authorities Committee: Reported Favorably",12,0,1,0,13
1807662,1467697,2024-09-26,Assembly,"Assembly Floor: Third Reading - Final Passage",76,0,4,0,80
1807662,1469889,2024-12-09,Senate,"Senate Budget and Appropriations Committee: Reported with Amendments",13,0,0,0,13
1807662,1470774,2024-12-19,Senate,"Senate Floor: Substitute for S361 (Voice Vote)",0,0,0,0,0
1807662,1470845,2024-12-19,Assembly,"Assembly Floor: Concur in Senate Amendments",73,0,7,0,80
1807662,1470846,2024-12-19,Senate,"Senate Floor: Third Reading - Final Passage",38,0,2,0,40
1807666,1507538,2025-03-06,Assembly,"Assembly Commerce and Economic Development Committee: Reported with Amendments",8,3,1,0,12
1807667,1443706,2024-05-16,Assembly,"Assembly Environment and Solid Waste Committee: Reported Favorably",5,0,2,0,7
1807667,1467683,2024-09-26,Assembly,"Assembly Floor: Third Reading - Final Passage",61,13,6,0,80
1807667,1589881,2025-06-12,Senate,"Senate Environment and Energy Committee: Reported with Amendments",4,1,0,0,5
1807681,1454526,2024-06-06,Assembly,"Assembly Judiciary Committee: Reported Favorably",6,0,0,0,6
1807681,1468799,2024-10-21,Assembly,"Assembly Transportation and Independent Authorities Committee: Reported with Amendments",13,0,0,0,13
1807681,1525428,2025-03-24,Assembly,"Assembly Floor: Third Reading - Final Passage",78,0,2,0,80
1807717,1473647,2025-01-23,Assembly,"Assembly Military and Veterans' Affairs Committee: Reported Favorably",6,0,0,0,6
1807717,1593043,2025-06-19,Assembly,"Assembly Housing and Community Development Committee: Reported Favorably",6,0,1,0,7
1807738,1509193,2025-03-10,Assembly,"Assembly Judiciary Committee: Reported with Amendments",6,0,0,0,6
1807738,1523330,2025-03-20,Assembly,"Assembly Appropriations Committee: Reported with Substitution",11,0,0,0,11
1807744,1371721,2024-01-29,Assembly,"Assembly Housing and Community Development Committee: Reported Favorably",7,0,0,0,7
1807744,1381770,2024-02-12,Assembly,"Assembly Floor: Third Reading - Final Passage",64,15,1,0,80
1807744,1439891,2024-05-06,Senate,"Senate Community and Urban Affairs Committee: Reported Favorably",3,2,0,0,5
1807744,1471392,2025-01-14,Senate,"Senate Floor: Substitute for S2506 (Voice Vote)",0,0,0,0,0
1807744,1583863,2025-06-02,Senate,"Senate Floor: Third Reading - Final Passage",23,15,2,0,40
1807744,1596704,2025-06-30,Assembly,"Assembly Floor: Concur in Senate Amendments",54,25,1,0,80
1807744,1596705,2025-06-30,Assembly,"Assembly Floor: Table Motion",50,28,2,0,80
1807746,1401967,2024-03-04,Assembly,"Assembly Committee: Reported with Amendments",6,0,0,0,6
1807746,1402399,2024-03-04,Assembly,"Assembly Children, Families and Food Security Committee Committee: Reported with Amendments",6,0,0,0,6
1807746,1461604,2024-06-28,Assembly,"Assembly Floor: Third Reading - Final Passage",76,0,4,0,80
1807759,1445027,2024-05-20,Assembly,"Assembly Judiciary Committee: Reported Favorably",4,2,0,0,6
1807760,1439366,2024-05-06,Assembly,"Assembly Military and Veterans' Affairs Committee: Reported with Substitution",6,0,0,0,6
1807764,1392924,2024-02-22,Assembly,"Assembly Financial Institutions and Insurance Committee: Reported with Amendments",8,0,5,0,13
1807764,1468779,2024-10-21,Assembly,"Assembly Judiciary Committee: Reported with Amendments",5,0,1,0,6
1807764,1468997,2024-10-28,Assembly,"Assembly Floor: Third Reading - Final Passage",63,5,12,0,80
1807769,1468957,2024-10-24,Assembly,"Assembly Consumer Affairs Committee: Reported with Amendments",5,0,1,0,6
1807769,1485015,2025-02-10,Assembly,"Assembly Regulated Professions Committee: Reported with Substitution",6,0,1,0,7
1807769,1597112,2025-06-30,Assembly,"Assembly Floor: Third Reading - Final Passage",80,0,0,0,80
1807781,1454683,2024-06-06,Assembly,"Assembly Human Services Committee: Reported Favorably",6,0,0,0,6
1807781,1576500,2025-05-22,Assembly,"Assembly Floor: Third Reading - Final Passage",77,1,2,0,80
1807791,1371719,2024-01-29,Assembly,"Assembly Housing and Community Development Committee: Reported Favorably",7,0,0,0,7
1807791,1379696,2024-02-08,Assembly,"Assembly Appropriations Committee: Reported with Substitution",7,4,0,0,11
1807791,1410062,2024-03-18,Senate,"Senate Floor: Second Reading (Voice Vote)",0,0,0,0,0
1807791,1410063,2024-03-18,Senate,"Senate Floor: Substitute for S1415 (Voice Vote)",0,0,0,0,0
1807791,1411748,2024-03-18,Assembly,"Assembly Floor: Concur in Senate Amendments",63,14,3,0,80
1807791,1411749,2024-03-18,Assembly,"Assembly Floor: Third Reading - Final Passage",61,15,4,0,80
1807791,1411750,2024-03-18,Senate,"Senate Floor: Amend",32,0,8,0,40
1807791,1411751,2024-03-18,Senate,"Senate Floor: Third Reading - Final Passage",34,1,5,0,40
1807792,1376382,2024-02-05,Assembly,"Assembly Labor Committee: Reported with Amendments",10,1,0,0,11
1807792,1381859,2024-02-12,Assembly,"Assembly Floor: Third Reading - Final Passage",63,16,1,0,80
1807792,1439738,2024-05-06,Senate,"Senate Labor Committee: Reported Favorably",4,0,1,0,5
1807792,1442515,2024-05-13,Senate,"Senate Floor: Substitute for SCR98 (Voice Vote)",0,0,0,0,0
1807792,1442516,2024-05-13,Senate,"Senate Floor: Third Reading - Final Passage",34,0,6,0,40
1807797,1371720,2024-01-29,Assembly,"Assembly Housing and Community Development Committee: Reported with Amendments",7,0,0,0,7
1807797,1381769,2024-02-12,Assembly,"Assembly Floor: Third Reading - Final Passage",74,5,1,0,80
1807797,1410310,2024-03-18,Senate,"Senate Floor: Substitute for S2309 (Voice Vote)",0,0,0,0,0
1807797,1412356,2024-03-18,Senate,"Senate Floor: Third Reading - Final Passage",33,3,4,0,40
1812786,1369460,2024-01-25,Senate,"Senate Community and Urban Affairs Committee: Reported Favorably",5,0,0,0,5
1812830,1455732,2024-06-10,Senate,"Senate Commerce Committee: Reported Favorably",5,0,0,0,5
1812830,1460373,2024-06-26,Senate,"Senate Budget and Appropriations Committee: Reported with Amendments",13,0,0,0,13
1812830,1461476,2024-06-28,Assembly,"Assembly Floor: Substitute for A1128 (Voice Vote)",0,0,0,0,0
1812830,1461477,2024-06-28,Senate,"Senate Floor: Third Reading - Final Passage",40,0,0,0,40
1812830,1461608,2024-06-28,Assembly,"Assembly Floor: Third Reading - Final Passage",73,0,7,0,80
1812915,1439556,2024-05-06,Senate,"Senate Labor Committee: Reported with Amendments",4,0,1,0,5
1812915,1458995,2024-06-24,Senate,"Senate Budget and Appropriations Committee: Reported Favorably",12,0,1,0,13
1812915,1461521,2024-06-28,Senate,"Senate Floor: Third Reading - Final Passage",40,0,0,0,40
1812915,1467631,2024-09-26,Assembly,"Assembly Floor: Substitute for A4151 (Voice Vote)",0,0,0,0,0
1812915,1467694,2024-09-26,Assembly,"Assembly Floor: Third Reading - Final Passage",57,16,7,0,80
1812959,1369462,2024-01-25,Senate,"Senate Community and Urban Affairs Committee: Reported with Amendments",3,2,0,0,5
1812959,1407164,2024-03-11,Senate,"Senate Budget and Appropriations Committee: Reported with Amendments",9,4,0,0,13
1813042,1369461,2024-01-25,Senate,"Senate Community and Urban Affairs Committee: Reported Favorably",4,0,1,0,5
1813042,1407170,2024-03-11,Senate,"Senate Budget and Appropriations Committee: Reported with Amendments",10,3,0,0,13
1813104,1371725,2024-01-29,Assembly,"Assembly Housing and Community Development Committee: Reported Favorably",5,2,0,0,7
1813104,1379744,2024-02-08,Assembly,"Assembly Appropriations Committee: Reported with Amendments",7,3,1,0,11
1813104,1381772,2024-02-12,Assembly,"Assembly Floor: Third Reading - Final Passage",51,28,1,0,80
1813104,1407138,2024-03-11,Senate,"Senate Budget and Appropriations Committee: Reported with Amendments",9,4,0,0,13
1813104,1410050,2024-03-18,Senate,"Senate Floor: Substitute for S50 (Voice Vote)",0,0,0,0,0
1813104,1411701,2024-03-18,Assembly,"Assembly Floor: Concur in Senate Amendments",50,25,5,0,80
1813104,1411702,2024-03-18,Senate,"Senate Floor: Third Reading - Final Passage",23,14,3,0,40
1813223,1371724,2024-01-29,Assembly,"Assembly Housing and Community Development Committee: Reported Favorably",7,0,0,0,7
1813223,1380400,2024-02-08,Assembly,"Assembly Appropriations Committee: Reported with Amendments",10,1,0,0,11
1813752,1442415,2024-05-13,Assembly,"Assembly Community Development and Womens Affairs Committee Committee: Reported with Amendments",6,0,0,0,6
1813752,1467512,2024-09-23,Assembly,"Assembly Appropriations Committee: Reported Favorably",11,0,0,0,11
1813752,1467692,2024-09-26,Assembly,"Assembly Floor: Third Reading - Final Passage",75,1,4,0,80
1818915,1452992,2024-06-03,Senate,"Senate Transportation Committee: Reported Favorably",6,0,0,0,6
1828428,1485138,2025-02-10,Senate,"Senate Higher Eduction Committee: Reported Favorably",5,0,0,0,5
1828432,1370599,2024-01-29,Senate,"Senate Health, Human Services and Senior Citizens Committee: Reported Favorably",8,0,0,0,8
1828432,1381462,2024-02-12,Senate,"Senate Floor: Third Reading - Final Passage",37,0,3,0,40
1828432,1576779,2025-05-22,Assembly,"Assembly Floor: Substitute for A3893 (Voice Vote)",0,0,0,0,0
1828432,1576780,2025-05-22,Assembly,"Assembly Floor: Third Reading - Final Passage",76,0,4,0,80
1828439,1454804,2024-06-06,Senate,"Senate Health, Human Services and Senior Citizens Committee: Reported with Amendments",8,0,0,0,8
1828439,1460778,2024-06-26,Senate,"Senate Budget and Appropriations Committee: Reported Favorably",13,0,0,0,13
1828446,1503269,2025-03-03,Senate,"Senate Military and Veterans' Affairs Committee: Reported Favorably",5,0,0,0,5
1828450,1469785,2024-12-05,Senate,"Senate Transportation Committee: Reported Favorably",6,0,0,0,6
1828456,1443754,2024-05-16,Senate,"Senate Law and Public Safety Committee: Reported Favorably",3,1,1,0,5
1828466,1385884,2024-02-15,Senate,"Senate Community and Urban Affairs Committee: Reported with Substitution",3,1,1,0,5
1828466,1499054,2025-02-25,Senate,"Senate Floor: Second Reading (Voice Vote)",0,0,0,0,0
1828466,1499055,2025-02-25,Senate,"Senate Floor: Senate Substitute",35,1,4,0,40
1828471,1467831,2024-09-30,Senate,"Senate Education Committee: Reported with Amendments",5,0,0,0,5
1828471,1583723,2025-06-02,Senate,"Senate Floor: Third Reading - Final Passage",38,0,2,0,40
1828471,1591079,2025-06-16,Assembly,"Assembly Education Committee: Reported Favorably",9,0,0,0,9
1828481,1586546,2025-06-09,Senate,"Senate Health, Human Services and Senior Citizens Committee: Reported Favorably",7,0,1,0,8
1828501,1458685,2024-06-20,Senate,"Senate Education Committee: Reported Favorably",5,0,0,0,5
1828506,1439905,2024-05-06,Senate,"Senate Community and Urban Affairs Committee: Reported with Amendments",5,0,0,0,5
1828506,1459007,2024-06-24,Senate,"Senate Budget and Appropriations Committee: Reported with Amendments",12,0,1,0,13
1828518,1581369,2025-05-29,Senate,"Senate Law and Public Safety Committee: Reported with Amendments",5,0,0,0,5
1828518,1595858,2025-06-26,Senate,"Senate Budget and Appropriations Committee: Reported with Amendments",13,0,0,0,13
1828518,1596599,2025-06-30,Senate,"Senate Floor: Third Reading - Final Passage",39,0,1,0,40
1828530,1457104,2024-06-13,Senate,"Senate Military and Veterans' Affairs Committee: Reported Favorably",5,0,0,0,5
1828642,1443583,2024-05-16,Senate,"Senate Law and Public Safety Committee: Reported Favorably",4,0,1,0,5
1828642,1479008,2025-02-03,Senate,"Senate Budget and Appropriations Committee: Reported Favorably",12,0,1,0,13
1828642,1499144,2025-02-25,Senate,"Senate Floor: Third Reading - Final Passage",38,0,2,0,40
1828657,1385339,2024-02-15,Senate,"Senate Education Committee: Reported with Amendments",5,0,0,0,5
1828657,1468242,2024-10-07,Senate,"Senate Budget and Appropriations Committee: Reported with Substitution",13,0,0,0,13
1828657,1469001,2024-10-28,Senate,"Senate Floor: Third Reading - Final Passage",40,0,0,0,40
1828657,1595697,2025-06-26,Assembly,"Assembly Budget Committee: Reported Favorably",15,0,0,0,15
1828657,1596552,2025-06-30,Assembly,"Assembly Floor: Substitute for A3871 (Voice Vote)",0,0,0,0,0
1828657,1596876,2025-06-30,Assembly,"Assembly Floor: Third Reading - Final Passage",73,1,6,0,80
1828665,1458619,2024-06-20,Senate,"Senate Health, Human Services and Senior Citizens Committee: Reported with Amendments",8,0,0,0,8
1828665,1595793,2025-06-26,Senate,"Senate Budget and Appropriations Committee: Reported with Amendments",13,0,0,0,13
1828665,1596838,2025-06-30,Senate,"Senate Floor: Third Reading - Final Passage",39,0,1,0,40
1828671,1379060,2024-02-08,Senate,"Senate Military and Veterans' Affairs Committee: Reported Favorably",5,0,0,0,5
1828685,1403024,2024-03-04,Senate,"Senate Economic Growth Committee: Reported Favorably",5,0,0,0,5
1828685,1412138,2024-03-18,Senate,"Senate Floor: Third Reading - Final Passage",38,0,2,0,40
1828685,1454639,2024-06-06,Assembly,"Assembly State and Local Government Committee: Reported Favorably",7,0,0,0,7
1828685,1460874,2024-06-26,Assembly,"Assembly Budget Committee: Reported Favorably",14,0,1,0,15
1828685,1461581,2024-06-28,Assembly,"Assembly Floor: Substitute for A3582 (Voice Vote)",0,0,0,0,0
1828685,1461582,2024-06-28,Assembly,"Assembly Floor: Third Reading - Final Passage",77,0,3,0,80
1828696,1371216,2024-01-29,Senate,"Senate Health, Human Services and Senior Citizens Committee: Reported Favorably",6,1,1,0,8
1828696,1468225,2024-10-07,Senate,"Senate Budget and Appropriations Committee: Reported Favorably",9,4,0,0,13
1828696,1468987,2024-10-28,Senate,"Senate Floor: Third Reading - Final Passage",29,10,1,0,40
1828696,1470765,2024-12-19,Assembly,"Assembly Floor: Substitute for A3517 (Voice Vote)",0,0,0,0,0
1828696,1470819,2024-12-19,Assembly,"Assembly Floor: Third Reading - Final Passage",50,23,7,0,80
1828733,1593025,2025-06-19,Senate,"Senate Military and Veterans' Affairs Committee: Reported with Amendments",5,0,0,0,5
1828736,1443765,2024-05-16,Senate,"Senate Law and Public Safety Committee: Reported Favorably",4,0,1,0,5
1828749,1467777,2024-09-30,Senate,"Senate Community and Urban Affairs Committee: Reported Favorably",5,0,0,0,5
1828749,1477846,2025-01-30,Senate,"Senate Floor: Third Reading - Final Passage",37,0,3,0,40
1828762,1457898,2024-06-17,Senate,"Senate Community and Urban Affairs Committee: Reported Favorably",4,0,1,0,5
1828768,1392150,2024-02-22,Senate,"Senate Health, Human Services and Senior Citizens Committee: Reported with Amendments",7,0,1,0,8
1828788,1385683,2024-02-15,Senate,"Senate Education Committee: Reported Favorably",4,1,0,0,5
1828796,1460347,2024-06-26,Senate,"Senate Budget and Appropriations Committee: Reported with Amendments",13,0,0,0,13
1828796,1461489,2024-06-28,Senate,"Senate Floor: Third Reading - Final Passage",38,1,1,0,40
1828800,1467820,2024-09-30,Senate,"Senate Education Committee: Reported with Substitution",3,2,0,0,5
1828802,1443716,2024-05-16,Senate,"Senate Judiciary Committee: Reported with Amendments",11,0,0,0,11
1828812,1443842,2024-05-16,Senate,"Senate Judiciary Committee: Reported with Amendments",11,0,0,0,11
1828812,1468222,2024-10-07,Senate,"Senate Budget and Appropriations Committee: Reported with Amendments",13,0,0,0,13
1828812,1468996,2024-10-28,Senate,"Senate Floor: Third Reading - Final Passage",39,0,1,0,40
1828825,1455682,2024-06-10,Senate,"Senate Economic Growth Committee: Reported Favorably",3,2,0,0,5
1828828,1470397,2024-12-16,Senate,"Senate Military and Veterans' Affairs Committee: Reported Favorably",4,0,1,0,5
1828840,1444066,2024-05-16,Senate,"Senate Judiciary Committee: Reported Favorably",7,3,1,0,11
1828843,1458661,2024-06-20,Senate,"Senate Environment and Energy Committee: Reported with Amendments",4,1,0,0,5
1828843,1595798,2025-06-26,Senate,"Senate Budget and Appropriations Committee: Reported with Amendments",9,4,0,0,13
1828899,1439526,2024-05-06,Senate,"Senate Labor Committee: Reported with Amendments",4,0,1,0,5
1828908,1468624,2024-10-10,Senate,"Senate Environment and Energy Committee: Reported Favorably",5,0,0,0,5
1828914,1443721,2024-05-16,Senate,"Senate Military and Veterans' Affairs Committee: Reported Favorably",5,0,0,0,5
1828914,1445016,2024-05-20,Senate,"Senate Floor: Third Reading - Final Passage",37,0,3,0,40
1828914,1468759,2024-10-21,Assembly,"Assembly Military and Veterans' Affairs Committee: Reported Favorably",6,0,0,0,6
1828914,1469032,2024-10-28,Assembly,"Assembly Floor: Substitute for AJR25 (Voice Vote)",0,0,0,0,0
1828914,1469033,2024-10-28,Assembly,"Assembly Floor: Third Reading - Final Passage",77,0,3,0,80
1828920,1392550,2024-02-22,Senate,"Senate Health, Human Services and Senior Citizens Committee: Reported Favorably",7,0,1,0,8
1828920,1407171,2024-03-11,Senate,"Senate Budget and Appropriations Committee: Reported with Amendments",13,0,0,0,13
1828920,1411791,2024-03-18,Senate,"Senate Floor: Third Reading - Final Passage",38,0,2,0,40
1828920,1460841,2024-06-26,Assembly,"Assembly Budget Committee: Reported with Amendments",13,0,2,0,15
1828920,1461369,2024-06-28,Assembly,"Assembly Floor: Substitute for A3537 (Voice Vote)",0,0,0,0,0
1828920,1461579,2024-06-28,Assembly,"Assembly Floor: Third Reading - Final Passage",76,0,4,0,80
1828920,1461580,2024-06-28,Senate,"Senate Floor: Concur in Assembly Amendments",39,0,1,0,40
1828948,1405021,2024-03-07,Senate,"Senate Law and Public Safety Committee: Reported Favorably",5,0,0,0,5
1828948,1411616,2024-03-18,Senate,"Senate Floor: Third Reading - Final Passage",38,0,2,0,40
1828948,1470402,2024-12-16,Assembly,"Assembly Public Safety and Preparedness Committee Committee: Reported Favorably",8,1,0,0,9
1828948,1477624,2025-01-30,Assembly,"Assembly Floor: Substitute for A3678 (Voice Vote)",0,0,0,0,0
1828948,1477828,2025-01-30,Assembly,"Assembly Floor: Third Reading - Final Passage",61,12,7,0,80
1830331,1458958,2024-06-24,Assembly,"Assembly Appropriations Committee: Reported Favorably",11,0,0,0,11
1830347,1469883,2024-12-09,Assembly,"Assembly Housing and Community Development Committee: Reported with Amendments",7,0,0,0,7
1830417,1458632,2024-06-20,Senate,"Senate Health, Human Services and Senior Citizens Committee: Reported Favorably",8,0,0,0,8
1830431,1454618,2024-06-06,Assembly,"Assembly Education Committee: Reported Favorably",9,0,0,0,9
1830431,1458959,2024-06-24,Assembly,"Assembly Appropriations Committee: Reported Favorably",11,0,0,0,11
1830431,1461609,2024-06-28,Assembly,"Assembly Floor: Third Reading - Final Passage",76,0,4,0,80
1830457,1522432,2025-03-20,Assembly,"Assembly Community Development and Womens Affairs Committee Committee: Reported with Amendments",4,2,0,0,6
1830503,1409409,2024-03-14,Assembly,"Assembly Regulated Professions Committee: Reported Favorably",6,0,1,0,7
1830503,1442385,2024-05-13,Assembly,"Assembly Floor: Third Reading - Final Passage",60,11,9,0,80
1830503,1470922,2024-12-19,Assembly,"Assembly Floor: Concur in Senate Amendments",61,10,9,0,80
1830503,1470923,2024-12-19,Senate,"Senate Floor: Amend",38,0,2,0,40
1830503,1470924,2024-12-19,Senate,"Senate Floor: Second Reading (Voice Vote)",0,0,0,0,0
1830503,1470925,2024-12-19,Senate,"Senate Floor: Substitute for S2245 (Voice Vote)",0,0,0,0,0
1830503,1470926,2024-12-19,Senate,"Senate Floor: Third Reading - Final Passage",38,0,2,0,40
1830553,1509227,2025-03-10,Assembly,"Assembly Education Committee: Reported Favorably",7,0,2,0,9
1830553,1572408,2025-05-15,Assembly,"Assembly Appropriations Committee: Reported with Amendments",11,0,0,0,11
1830553,1576225,2025-05-22,Assembly,"Assembly Floor: Third Reading - Final Passage",72,2,6,0,80
1830553,1595788,2025-06-26,Senate,"Senate Budget and Appropriations Committee: Reported Favorably",13,0,0,0,13
1830553,1596524,2025-06-30,Senate,"Senate Floor: Substitute for S1784 (Voice Vote)",0,0,0,0,0
1830553,1596837,2025-06-30,Senate,"Senate Floor: Third Reading - Final Passage",39,0,1,0,40
1830611,1402456,2024-03-04,Assembly,"Assembly Education Committee: Reported with Amendments",9,0,0,0,9
1830678,1454649,2024-06-06,Assembly,"Assembly Education Committee: Reported with Substitution",7,1,1,0,9
1830678,1461498,2024-06-28,Assembly,"Assembly Floor: Third Reading - Final Passage",53,20,7,0,80
1830678,1467823,2024-09-30,Senate,"Senate Education Committee: Reported Favorably",3,2,0,0,5
1830678,1468973,2024-10-28,Senate,"Senate Floor: Substitute for S2421 (Voice Vote)",0,0,0,0,0
1830678,1468974,2024-10-28,Senate,"Senate Floor: Third Reading - Final Passage",24,15,1,0,40
1830685,1376380,2024-02-05,Assembly,"Assembly Labor Committee: Reported Favorably",9,2,0,0,11
1830685,1379698,2024-02-08,Assembly,"Assembly Appropriations Committee: Reported Favorably",7,4,0,0,11
1830685,1382111,2024-02-12,Assembly,"Assembly Floor: Third Reading - Final Passage",49,26,5,0,80
1830728,1439909,2024-05-06,Senate,"Senate Community and Urban Affairs Committee: Reported Favorably",3,2,0,0,5
1830738,1406901,2024-03-11,Assembly,"Assembly Education Committee: Reported with Amendments",7,2,0,0,9
1830738,1409114,2024-03-14,Assembly,"Assembly Appropriations Committee: Reported with Amendments",7,4,0,0,11
1830761,1379175,2024-02-08,Senate,"Senate Military and Veterans' Affairs Committee: Reported Favorably",5,0,0,0,5
1830792,1470168,2024-12-12,Assembly,"Assembly Education Committee: Reported with Amendments",8,0,1,0,9
1830810,1474927,2025-01-27,Assembly,"Assembly Consumer Affairs Committee: Reported with Amendments",6,0,0,0,6
1830823,1460935,2024-06-26,Senate,"Senate Budget and Appropriations Committee: Reported Favorably",13,0,0,0,13
1830823,1461634,2024-06-28,Senate,"Senate Floor: Third Reading - Final Passage",40,0,0,0,40
1830860,1460890,2024-06-26,Senate,"Senate Budget and Appropriations Committee: Reported Favorably",13,0,0,0,13
1830860,1461426,2024-06-28,Assembly,"Assembly Floor: Substitute for A3412 (Voice Vote)",0,0,0,0,0
1830860,1461674,2024-06-28,Assembly,"Assembly Floor: Third Reading - Final Passage",71,0,9,0,80
1830860,1461675,2024-06-28,Senate,"Senate Floor: Third Reading - Final Passage",40,0,0,0,40
1830882,1385686,2024-02-15,Senate,"Senate Education Committee: Reported Favorably",5,0,0,0,5
1830882,1468211,2024-10-07,Senate,"Senate Budget and Appropriations Committee: Reported with Substitution",13,0,0,0,13
1830882,1469045,2024-10-28,Senate,"Senate Floor: Third Reading - Final Passage",40,0,0,0,40
1830882,1470284,2024-12-12,Assembly,"Assembly Education Committee: Reported Favorably",8,0,1,0,9
1830882,1473710,2025-01-23,Assembly,"Assembly Science, Innovation and Technology Committee: Reported Favorably",6,1,0,0,7
1830896,1442673,2024-05-13,Senate,"Senate Commerce Committee: Reported with Amendments",5,0,0,0,5
1830896,1444918,2024-05-20,Senate,"Senate Floor: Third Reading - Final Passage",37,0,3,0,40
1830896,1591017,2025-06-16,Assembly,"Assembly Labor Committee: Reported Favorably",12,0,0,0,12
1830928,1441829,2024-05-09,Senate,"Senate Budget and Appropriations Committee: Reported with Amendments",9,4,0,0,13
1830928,1442674,2024-05-13,Senate,"Senate Floor: Third Reading - Final Passage",26,11,3,0,40
1830928,1459227,2024-06-24,Assembly,"Assembly Appropriations Committee: Reported Favorably",7,4,0,0,11
1830928,1459228,2024-06-24,Assembly,"Assembly State and Local Government Committee: Reported Favorably",7,0,0,0,7
1830928,1461611,2024-06-28,Assembly,"Assembly Floor: Substitute for A3930 (Voice Vote)",0,0,0,0,0
1830928,1461612,2024-06-28,Assembly,"Assembly Floor: Third Reading - Final Passage",55,21,4,0,80
1830937,1439503,2024-05-06,Assembly,"Assembly Human Services Committee: Reported with Amendments",6,0,0,0,6
1830937,1467680,2024-09-26,Assembly,"Assembly Floor: Third Reading - Final Passage",76,0,4,0,80
1830990,1409404,2024-03-14,Senate,"Senate Health, Human Services and Senior Citizens Committee: Reported with Amendments",8,0,0,0,8
1831021,1468743,2024-10-21,Senate,"Senate Law and Public Safety Committee: Reported with Amendments",5,0,0,0,5
1831057,1385380,2024-02-15,Senate,"Senate Education Committee: Reported Favorably",5,0,0,0,5
1831057,1468210,2024-10-07,Senate,"Senate Budget and Appropriations Committee: Reported with Substitution",13,0,0,0,13
1834897,1457103,2024-06-13,Assembly,"Assembly Children, Families and Food Security Committee Committee: Reported Favorably",6,0,0,0,6
1834897,1461643,2024-06-28,Assembly,"Assembly Floor: Third Reading - Final Passage",77,0,3,0,80
1834941,1467471,2024-09-19,Assembly,"Assembly Military and Veterans' Affairs Committee: Reported Favorably",6,0,0,0,6
1834989,1474074,2025-01-23,Assembly,"Assembly State and Local Government Committee: Reported Favorably",6,0,1,0,7
1835041,1392418,2024-02-22,Assembly,"Assembly Financial Institutions and Insurance Committee: Reported with Amendments",8,5,0,0,13
1835041,1442347,2024-05-13,Assembly,"Assembly Commerce and Economic Development Committee: Reported Favorably",8,4,0,0,12
1835077,1509006,2025-03-10,Assembly,"Assembly Transportation and Independent Authorities Committee: Reported with Amendments",12,0,1,0,13
1835106,1454592,2024-06-06,Assembly,"Assembly Labor Committee: Reported Favorably",9,1,1,0,11
1835106,1467521,2024-09-23,Assembly,"Assembly Appropriations Committee: Reported with Amendments",11,0,0,0,11
1835106,1467666,2024-09-26,Assembly,"Assembly Floor: Third Reading - Final Passage",71,1,8,0,80
1835106,1469787,2024-12-05,Senate,"Senate Labor Committee: Reported Favorably",4,0,1,0,5
1835215,1392117,2024-02-22,Assembly,"Assembly Committee: Reported with Amendments",7,0,2,0,9
1835215,1393118,2024-02-22,Assembly,"Assembly Public Safety and Preparedness Committee Committee: Reported with Amendments",7,0,2,0,9
1835215,1460845,2024-06-26,Assembly,"Assembly Budget Committee: Reported with Amendments",13,0,2,0,15
1835230,1453017,2024-06-03,Assembly,"Assembly Public Safety and Preparedness Committee Committee: Reported Favorably",9,0,0,0,9
1835247,1565152,2025-05-05,Assembly,"Assembly Community Development and Womens Affairs Committee Committee: Reported with Amendments",6,0,0,0,6
1835251,1443653,2024-05-16,Assembly,"Assembly Children, Families and Food Security Committee Committee: Reported Favorably",5,1,0,0,6
1835251,1468733,2024-10-21,Assembly,"Assembly Judiciary Committee: Reported Favorably",6,0,0,0,6
1835256,1379699,2024-02-08,Assembly,"Assembly Appropriations Committee: Reported Favorably",10,0,1,0,11
1835267,1599084,2025-07-24,Assembly,"Assembly State and Local Government Committee: Reported with Substitution",7,0,0,0,7
1835273,1409629,2024-03-14,Assembly,"Assembly Health Committee: Reported with Amendments",11,0,0,0,11
1835273,1411727,2024-03-18,Assembly,"Assembly Floor: Third Reading - Final Passage",77,0,3,0,80
1835273,1470814,2024-12-19,Senate,"Senate Health, Human Services and Senior Citizens Committee: Reported Favorably",8,0,0,0,8
1835273,1471654,2025-01-14,Senate,"Senate Floor: Substitute for SJR110 (Voice Vote)",0,0,0,0,0
1835273,1471655,2025-01-14,Senate,"Senate Floor: Third Reading - Final Passage",35,0,4,0,39
1835301,1522593,2025-03-20,Assembly,"Assembly Health Committee: Reported Favorably",10,0,1,0,11
1835303,1402636,2024-03-04,Assembly,"Assembly Science, Innovation and Technology Committee: Reported with Amendments",5,2,0,0,7
1835303,1444929,2024-05-20,Assembly,"Assembly Judiciary Committee: Reported with Substitution",4,0,2,0,6
1835303,1459003,2024-06-24,Assembly,"Assembly Appropriations Committee: Reported with Amendments",7,4,0,0,11
1835303,1460601,2024-06-26,Assembly,"Assembly Budget Committee: Reported with Amendments",8,0,7,0,15
1835303,1461536,2024-06-28,Assembly,"Assembly Floor: Third Reading - Final Passage",60,14,6,0,80
1835303,1477460,2025-01-30,Senate,"Senate Floor: Substitute for S2544 (Voice Vote)",0,0,0,0,0
1835303,1477813,2025-01-30,Senate,"Senate Floor: Third Reading - Final Passage",37,0,3,0,40
1835303,1524954,2025-03-24,Assembly,"Assembly Floor: Concur Governor Recommendations",64,13,3,0,80
1835303,1524955,2025-03-24,Senate,"Senate Floor: Concur Governor Recommendations",39,0,1,0,40
1835308,1401586,2024-03-04,Assembly,"Assembly Judiciary Committee: Reported Favorably",6,0,0,0,6
1835308,1457070,2024-06-13,Assembly,"Assembly Children, Families and Food Security Committee Committee: Reported Favorably",6,0,0,0,6
1835310,1444755,2024-05-16,Assembly,"Assembly Science, Innovation and Technology Committee: Reported Favorably",7,0,0,0,7
1835310,1470165,2024-12-12,Assembly,"Assembly Judiciary Committee: Reported Favorably",6,0,0,0,6
1835317,1473824,2025-01-23,Assembly,"Assembly Human Services Committee: Reported Favorably",6,0,0,0,6
1835330,1401588,2024-03-04,Assembly,"Assembly Military and Veterans' Affairs Committee: Reported Favorably",6,0,0,0,6
1835334,1467477,2024-09-19,Assembly,"Assembly State and Local Government Committee: Reported with Amendments",7,0,0,0,7
1835334,1495316,2025-02-20,Assembly,"Assembly Labor Committee: Reported with Amendments",11,1,0,0,12
1835334,1525008,2025-03-24,Assembly,"Assembly Floor: Third Reading - Final Passage",72,5,3,0,80
1835358,1509723,2025-03-10,Assembly,"Assembly Environment and Solid Waste Committee: Reported with Amendments",6,0,1,0,7
1835364,1467541,2024-09-23,Assembly,"Assembly Higher Education Committee: Reported Favorably",6,0,1,0,7
1835374,1443714,2024-05-16,Assembly,"Assembly Labor Committee: Reported with Amendments",7,4,0,0,11
1835376,1595707,2025-06-26,Assembly,"Assembly Budget Committee: Reported with Amendments",10,1,4,0,15
1835376,1596881,2025-06-30,Assembly,"Assembly Floor: Third Reading - Final Passage",75,3,2,0,80
1835376,1596882,2025-06-30,Senate,"Senate Floor: Third Reading - Final Passage",31,6,3,0,40
1835376,1597309,2025-06-30,Senate,"Senate Floor: Substitute for S1297 (Voice Vote)",0,0,0,0,0
1837124,1485676,2025-02-10,Senate,"Senate Environment and Energy Committee: Reported Favorably",3,2,0,0,5
1837134,1409338,2024-03-14,Senate,"Senate Labor Committee: Reported with Amendments",5,0,0,0,5
1837135,1468956,2024-10-24,Senate,"Senate State Government, Wagering, Tourism & Historic Preservation Committee: Reported with Substitution",4,0,1,0,5
1837142,1443770,2024-05-16,Senate,"Senate Military and Veterans' Affairs Committee: Reported Favorably",5,0,0,0,5
1837154,1458039,2024-06-17,Senate,"Senate Community and Urban Affairs Committee: Reported Favorably",4,0,1,0,5
1837244,1458999,2024-06-24,Assembly,"Assembly Human Services Committee: Reported with Substitution",6,0,0,0,6
1837296,1402153,2024-03-04,Assembly,"Assembly Committee: Reported Favorably",6,0,0,0,6
1837296,1402400,2024-03-04,Assembly,"Assembly Children, Families and Food Security Committee Committee: Reported Favorably",6,0,0,0,6
1837296,1454614,2024-06-06,Assembly,"Assembly State and Local Government Committee: Reported Favorably",7,0,0,0,7
1837296,1460943,2024-06-26,Assembly,"Assembly Budget Committee: Reported Favorably",14,0,1,0,15
1837298,1403282,2024-03-04,Senate,"Senate Environment and Energy Committee: Reported with Amendments",5,0,0,0,5
1837298,1444903,2024-05-20,Senate,"Senate Floor: Third Reading - Final Passage",37,0,3,0,40
1837298,1509686,2025-03-10,Assembly,"Assembly Environment and Solid Waste Committee: Reported Favorably",7,0,0,0,7
1837298,1523258,2025-03-20,Assembly,"Assembly Appropriations Committee: Reported Favorably",11,0,0,0,11
1837298,1525075,2025-03-24,Assembly,"Assembly Floor: Substitute for A3951 (Voice Vote)",0,0,0,0,0
1837298,1525076,2025-03-24,Assembly,"Assembly Floor: Third Reading - Final Passage",76,0,4,0,80
1837319,1459422,2024-06-24,Senate,"Senate Budget and Appropriations Committee: Reported Favorably",12,0,1,0,13
1837323,1410831,2024-03-18,Senate,"Senate State Government, Wagering, Tourism & Historic Preservation Committee: Reported with Amendments",5,0,0,0,5
1837323,1442746,2024-05-13,Senate,"Senate Floor: Third Reading - Final Passage",37,0,3,0,40
1837331,1439941,2024-05-06,Senate,"Senate Community and Urban Affairs Committee: Reported Favorably",5,0,0,0,5
1837331,1468276,2024-10-07,Senate,"Senate Budget and Appropriations Committee: Reported with Amendments",13,0,0,0,13
1837353,1392690,2024-02-22,Senate,"Senate Health, Human Services and Senior Citizens Committee: Reported with Amendments",7,0,1,0,8
1837353,1407504,2024-03-11,Senate,"Senate Budget and Appropriations Committee: Reported Favorably",13,0,0,0,13
1837353,1454943,2024-06-06,Senate,"Senate Health, Human Services and Senior Citizens Committee: Reported with Amendments",8,0,0,0,8
1837365,1405046,2024-03-07,Senate,"Senate Law and Public Safety Committee: Reported with Amendments",5,0,0,0,5
1837365,1458997,2024-06-24,Senate,"Senate Budget and Appropriations Committee: Reported with Substitution",12,0,1,0,13
1837375,1484722,2025-02-10,Assembly,"Assembly Higher Education Committee: Reported with Amendments",7,0,0,0,7
1837375,1596555,2025-06-30,Senate,"Senate Floor: Substitute for S1297 (Voice Vote)",0,0,0,0,0
1837398,1454933,2024-06-06,Senate,"Senate Health, Human Services and Senior Citizens Committee: Reported Favorably",8,0,0,0,8
1837400,1467553,2024-09-23,Assembly,"Assembly Environment and Solid Waste Committee: Reported Favorably",6,0,1,0,7
1837448,1440413,2024-05-06,Senate,"Senate Community and Urban Affairs Committee: Reported with Amendments",5,0,0,0,5
1837622,1439782,2024-05-06,Senate,"Senate Education Committee: Reported with Amendments",5,0,0,0,5
1837622,1469003,2024-10-28,Senate,"Senate Floor: Third Reading - Final Passage",40,0,0,0,40
1837622,1470283,2024-12-12,Assembly,"Assembly Education Committee: Reported Favorably",8,0,1,0,9
1837622,1470756,2024-12-19,Assembly,"Assembly Floor: Substitute for AJR101 (Voice Vote)",0,0,0,0,0
1837622,1470906,2024-12-19,Assembly,"Assembly Floor: Third Reading - Final Passage",71,0,9,0,80
1837630,1401707,2024-03-04,Senate,"Senate Higher Eduction Committee: Reported with Substitution",5,0,0,0,5
1837630,1411656,2024-03-18,Senate,"Senate Floor: Third Reading - Final Passage",36,2,2,0,40
1837643,1401920,2024-03-04,Assembly,"Assembly Judiciary Committee: Reported Favorably",6,0,0,0,6
1837643,1467695,2024-09-26,Assembly,"Assembly Floor: Third Reading - Final Passage",76,0,4,0,80
1837685,1441775,2024-05-09,Senate,"Senate Health, Human Services and Senior Citizens Committee: Reported with Amendments",8,0,0,0,8
1837685,1460937,2024-06-26,Senate,"Senate Budget and Appropriations Committee: Reported with Amendments",13,0,0,0,13
1837685,1469062,2024-10-28,Senate,"Senate Floor: Third Reading - Final Passage",40,0,0,0,40
1837685,1568380,2025-05-08,Assembly,"Assembly Human Services Committee: Reported Favorably",6,0,0,0,6
1837698,1385539,2024-02-15,Senate,"Senate Transportation Committee: Reported with Amendments",5,0,1,0,6
1837698,1411965,2024-03-18,Senate,"Senate Floor: Third Reading - Final Passage",38,0,2,0,40
1837698,1439621,2024-05-06,Assembly,"Assembly Transportation and Independent Authorities Committee: Reported Favorably",12,0,1,0,13
1837698,1461722,2024-06-28,Assembly,"Assembly Floor: Substitute for A3872 (Voice Vote)",0,0,0,0,0
1837698,1461723,2024-06-28,Assembly,"Assembly Floor: Third Reading - Final Passage",77,0,3,0,80
1841027,1443751,2024-05-16,Assembly,"Assembly Tourism, Gaming and the Arts Committee: Reported Favorably",6,0,0,0,6
1841027,1596822,2025-06-30,Assembly,"Assembly Floor: Third Reading - Final Passage",76,2,2,0,80
1841122,1469870,2024-12-09,Senate,"Senate Health, Human Services and Senior Citizens Committee: Reported with Substitution",8,0,0,0,8
1841141,1470179,2024-12-12,Assembly,"Assembly Human Services Committee: Reported Favorably",5,0,1,0,6
1841141,1522551,2025-03-20,Assembly,"Assembly Oversight, Reform and Federal Relations Committee: Reported Favorably",6,0,0,0,6
1841151,1503632,2025-03-03,Senate,"Senate Health, Human Services and Senior Citizens Committee: Reported with Substitution",8,0,0,0,8
1841181,1443720,2024-05-16,Senate,"Senate Judiciary Committee: Reported Favorably",8,3,0,0,11
1841185,1405001,2024-03-07,Senate,"Senate Law and Public Safety Committee: Reported Favorably",5,0,0,0,5
1841185,1444907,2024-05-20,Senate,"Senate Floor: Third Reading - Final Passage",37,0,3,0,40
1841185,1457046,2024-06-13,Assembly,"Assembly Children, Families and Food Security Committee Committee: Reported Favorably",6,0,0,0,6
1841185,1467622,2024-09-26,Assembly,"Assembly Floor: Substitute for A3539 (Voice Vote)",0,0,0,0,0
1841185,1467677,2024-09-26,Assembly,"Assembly Floor: Third Reading - Final Passage",76,0,4,0,80
1841215,1443620,2024-05-16,Assembly,"Assembly Children, Families and Food Security Committee Committee: Reported Favorably",4,1,1,0,6
1841215,1461567,2024-06-28,Assembly,"Assembly Floor: Third Reading - Final Passage",52,13,15,0,80
1841221,1468622,2024-10-10,Senate,"Senate Commerce Committee: Reported Favorably",5,0,0,0,5
1841221,1518534,2025-03-17,Senate,"Senate Budget and Appropriations Committee: Reported Favorably",13,0,0,0,13
1841230,1569406,2025-05-12,Senate,"Senate Transportation Committee: Reported Favorably",6,0,0,0,6
1841272,1469312,2024-11-14,Assembly,"Assembly Environment and Solid Waste Committee: Reported Favorably",7,0,0,0,7
1841272,1470815,2024-12-19,Assembly,"Assembly Floor: Third Reading - Final Passage",71,2,7,0,80
1841285,1469865,2024-12-09,Senate,"Senate Health, Human Services and Senior Citizens Committee: Reported with Substitution",8,0,0,0,8
1841325,1468805,2024-10-21,Senate,"Senate Law and Public Safety Committee: Reported Favorably",5,0,0,0,5
1841328,1507929,2025-03-06,Assembly,"Assembly Health Committee: Reported Favorably",8,1,2,0,11
1841328,1525029,2025-03-24,Assembly,"Assembly Floor: Third Reading - Final Passage",49,25,6,0,80
1841366,1591016,2025-06-16,Assembly,"Assembly Military and Veterans' Affairs Committee: Reported Favorably",5,0,1,0,6
1841414,1585618,2025-06-05,Senate,"Senate Labor Committee: Reported Favorably",5,0,0,0,5
1841435,1591014,2025-06-16,Assembly,"Assembly Military and Veterans' Affairs Committee: Reported Favorably",5,0,1,0,6
1841530,1473767,2025-01-23,Assembly,"Assembly State and Local Government Committee: Reported with Amendments",6,0,1,0,7
1841533,1458674,2024-06-20,Senate,"Senate Education Committee: Reported with Substitution",5,0,0,0,5
1841597,1458653,2024-06-20,Senate,"Senate Education Committee: Reported with Substitution",5,0,0,0,5
1841597,1458970,2024-06-24,Senate,"Senate Budget and Appropriations Committee: Reported Favorably",12,0,1,0,13
1841606,1401919,2024-03-04,Assembly,"Assembly Military and Veterans' Affairs Committee: Reported Favorably",6,0,0,0,6
1841606,1412274,2024-03-18,Assembly,"Assembly Floor: Third Reading - Final Passage",74,0,6,0,80
1841626,1440455,2024-05-06,Senate,"Senate Community and Urban Affairs Committee: Reported Favorably",3,0,2,0,5
1841671,1401476,2024-03-04,Assembly,"Assembly Military and Veterans' Affairs Committee: Reported Favorably",6,0,0,0,6
1841671,1412098,2024-03-18,Assembly,"Assembly Floor: Third Reading - Final Passage",75,0,5,0,80
1841678,1444976,2024-05-20,Assembly,"Assembly Financial Institutions and Insurance Committee: Reported Favorably",11,0,2,0,13
1841678,1452952,2024-06-03,Assembly,"Assembly Health Committee: Reported Favorably",10,0,1,0,11
1841678,1461645,2024-06-28,Assembly,"Assembly Floor: Third Reading - Final Passage",76,0,4,0,80
1841678,1470208,2024-12-12,Senate,"Senate Commerce Committee: Reported Favorably",5,0,0,0,5
1841678,1478025,2025-01-30,Senate,"Senate Floor: Substitute for S1138 (Voice Vote)",0,0,0,0,0
1841678,1478026,2025-01-30,Senate,"Senate Floor: Third Reading - Final Passage",37,0,3,0,40
1841681,1473826,2025-01-23,Assembly,"Assembly Human Services Committee: Reported with Amendments",6,0,0,0,6
1841692,1392975,2024-02-22,Assembly,"Assembly Commerce and Economic Development Committee: Reported Favorably",12,0,0,0,12
1841692,1409644,2024-03-14,Assembly,"Assembly Appropriations Committee: Reported Favorably",11,0,0,0,11
1841702,1509295,2025-03-10,Assembly,"Assembly Environment and Solid Waste Committee: Reported with Amendments",5,1,1,0,7
1841720,1473806,2025-01-23,Assembly,"Assembly Human Services Committee: Reported Favorably",6,0,0,0,6
1841720,1507691,2025-03-06,Assembly,"Assembly Health Committee: Reported Favorably",11,0,0,0,11
1841739,1391998,2024-02-22,Assembly,"Assembly Commerce and Economic Development Committee: Reported Favorably",12,0,0,0,12
1841739,1409646,2024-03-14,Assembly,"Assembly Appropriations Committee: Reported Favorably",11,0,0,0,11
1841771,1470433,2024-12-16,Assembly,"Assembly Public Safety and Preparedness Committee Committee: Reported with Substitution",8,1,0,0,9
1841772,1444934,2024-05-20,Assembly,"Assembly Financial Institutions and Insurance Committee: Reported with Amendments",11,0,2,0,13
1841809,1458645,2024-06-20,Senate,"Senate Education Committee: Reported with Substitution",5,0,0,0,5
1841809,1458978,2024-06-24,Senate,"Senate Budget and Appropriations Committee: Reported Favorably",12,0,1,0,13
1841809,1461478,2024-06-28,Assembly,"Assembly Floor: Substitute for A4303 (Voice Vote)",0,0,0,0,0
1841809,1461479,2024-06-28,Senate,"Senate Floor: Third Reading - Final Passage",39,0,1,0,40
1841809,1461610,2024-06-28,Assembly,"Assembly Floor: Third Reading - Final Passage",72,0,8,0,80
1841817,1458652,2024-06-20,Senate,"Senate Education Committee: Reported with Substitution",5,0,0,0,5
1841822,1452907,2024-06-03,Senate,"Senate Transportation Committee: Reported with Amendments",6,0,0,0,6
1844260,1470425,2024-12-16,Assembly,"Assembly Public Safety and Preparedness Committee Committee: Reported Favorably",9,0,0,0,9
1844342,1409095,2024-03-14,Assembly,"Assembly Community Development and Womens Affairs Committee Committee: Reported Favorably",6,0,0,0,6
1844379,1401928,2024-03-04,Assembly,"Assembly Judiciary Committee: Reported with Amendments",6,0,0,0,6
1844401,1590092,2025-06-12,Senate,"Senate Environment and Energy Committee: Reported with Amendments",4,1,0,0,5
1844422,1470159,2024-12-12,Senate,"Senate Commerce Committee: Reported with Amendments",5,0,0,0,5
1844422,1499794,2025-02-25,Senate,"Senate Floor: Third Reading - Final Passage",38,0,2,0,40
1844422,1597071,2025-06-30,Assembly,"Assembly Floor: Substitute for A3696 (Voice Vote)",0,0,0,0,0
1844422,1597072,2025-06-30,Assembly,"Assembly Floor: Third Reading - Final Passage",80,0,0,0,80
1844422,1597073,2025-06-30,Senate,"Senate Floor: Concur in Assembly Amendments",37,0,3,0,40
1844443,1477900,2025-01-30,Senate,"Senate Education Committee: Reported with Substitution",5,0,0,0,5
1844463,1403221,2024-03-04,Assembly,"Assembly Transportation and Independent Authorities Committee: Reported with Amendments",13,0,0,0,13
1844463,1443764,2024-05-16,Assembly,"Assembly State and Local Government Committee: Reported Favorably",7,0,0,0,7
1844463,1461649,2024-06-28,Assembly,"Assembly Floor: Third Reading - Final Passage",75,1,4,0,80
1844463,1585623,2025-06-05,Senate,"Senate Community and Urban Affairs Committee: Reported with Amendments",4,0,1,0,5
1844490,1468908,2024-10-24,Senate,"Senate State Government, Wagering, Tourism & Historic Preservation Committee: Reported Favorably",4,0,1,0,5
1844492,1457120,2024-06-13,Senate,"Senate Military and Veterans' Affairs Committee: Reported with Amendments",5,0,0,0,5
1844547,1509007,2025-03-10,Assembly,"Assembly Judiciary Committee: Reported with Amendments",6,0,0,0,6
1844547,1523135,2025-03-20,Assembly,"Assembly Appropriations Committee: Reported with Amendments",11,0,0,0,11
1844547,1525133,2025-03-24,Assembly,"Assembly Floor: Third Reading - Final Passage",77,0,3,0,80
1844569,1468692,2024-10-17,Assembly,"Assembly Community Development and Womens Affairs Committee Committee: Reported Favorably",6,0,0,0,6
1844569,1568279,2025-05-08,Assembly,"Assembly Judiciary Committee: Reported Favorably",6,0,0,0,6
1844577,1458983,2024-06-24,Assembly,"Assembly Appropriations Committee: Reported with Amendments",7,0,4,0,11
1844577,1458984,2024-06-24,Assembly,"Assembly State and Local Government Committee: Reported Favorably",7,0,0,0,7
1844577,1461409,2024-06-28,Senate,"Senate Floor: Substitute for S2334 (Voice Vote)",0,0,0,0,0
1844577,1461494,2024-06-28,Assembly,"Assembly Floor: Third Reading - Final Passage",75,0,5,0,80
1844577,1461495,2024-06-28,Senate,"Senate Floor: Third Reading - Final Passage",40,0,0,0,40
1844586,1467480,2024-09-19,Assembly,"Assembly Judiciary Committee: Reported Favorably",6,0,0,0,6
1844608,1453012,2024-06-03,Assembly,"Assembly Public Safety and Preparedness Committee Committee: Reported with Amendments",8,0,1,0,9
1844623,1509029,2025-03-10,Assembly,"Assembly Judiciary Committee: Reported with Amendments",6,0,0,0,6
1844623,1525059,2025-03-24,Assembly,"Assembly Floor: Third Reading - Final Passage",78,0,2,0,80
1844630,1469356,2024-11-14,Assembly,"Assembly Regulated Professions Committee: Reported Favorably",7,0,0,0,7
1844630,1571985,2025-05-15,Assembly,"Assembly State and Local Government Committee: Reported Favorably",7,0,0,0,7
1844630,1576422,2025-05-22,Assembly,"Assembly Floor: Third Reading - Final Passage",77,0,3,0,80
1844679,1589843,2025-06-12,Assembly,"Assembly Commerce and Economic Development Committee: Reported with Amendments",10,0,2,0,12
1844679,1595718,2025-06-26,Assembly,"Assembly Budget Committee: Reported Favorably",15,0,0,0,15
1844679,1596907,2025-06-30,Assembly,"Assembly Floor: Third Reading - Final Passage",77,2,1,0,80
1844710,1454523,2024-06-06,Assembly,"Assembly Judiciary Committee: Reported Favorably",6,0,0,0,6
1844718,1568381,2025-05-08,Assembly,"Assembly Human Services Committee: Reported with Amendments",6,0,0,0,6
1844793,1392265,2024-02-22,Assembly,"Assembly Consumer Affairs Committee: Reported Favorably",5,0,1,0,6
1844793,1442405,2024-05-13,Assembly,"Assembly Floor: Third Reading - Final Passage",72,0,8,0,80
1844806,1569557,2025-05-12,Senate,"Senate Labor Committee: Reported Favorably",5,0,0,0,5
1844818,1452796,2024-06-03,Assembly,"Assembly Consumer Affairs Committee: Reported with Substitution",6,0,0,0,6
1844818,1461504,2024-06-28,Assembly,"Assembly Floor: Third Reading - Final Passage",77,0,3,0,80
1844821,1452764,2024-06-03,Assembly,"Assembly Higher Education Committee: Reported Favorably",6,0,1,0,7
1844821,1473762,2025-01-23,Assembly,"Assembly Military and Veterans' Affairs Committee: Reported Favorably",6,0,0,0,6
1844828,1470399,2024-12-16,Assembly,"Assembly Health Committee: Reported with Amendments",10,0,1,0,11
1844828,1470423,2024-12-16,Assembly,"Assembly Appropriations Committee: Reported Favorably",10,0,1,0,11
1844828,1470772,2024-12-19,Senate,"Senate Floor: Substitute for S2988 (Voice Vote)",0,0,0,0,0
1844828,1470840,2024-12-19,Assembly,"Assembly Floor: Third Reading - Final Passage",72,1,7,0,80
1844828,1470841,2024-12-19,Senate,"Senate Floor: Third Reading - Final Passage",38,0,2,0,40
1844839,1425554,2024-04-11,Senate,"Senate Budget and Appropriations Committee: Reported Favorably",11,0,2,0,13
1844839,1442733,2024-05-13,Senate,"Senate Floor: Third Reading - Final Passage",36,0,4,0,40
1844839,1461466,2024-06-28,Assembly,"Assembly Floor: Substitute for A3697 (Voice Vote)",0,0,0,0,0
1844839,1461711,2024-06-28,Assembly,"Assembly Floor: Third Reading - Final Passage",76,0,4,0,80
1844840,1458960,2024-06-24,Assembly,"Assembly State and Local Government Committee: Reported Favorably",7,0,0,0,7
1844841,1444764,2024-05-16,Assembly,"Assembly Science, Innovation and Technology Committee: Reported with Substitution",5,0,2,0,7
1844846,1425548,2024-04-11,Senate,"Senate Budget and Appropriations Committee: Reported Favorably",11,0,2,0,13
1844846,1442412,2024-05-13,Senate,"Senate Floor: Third Reading - Final Passage",37,0,3,0,40
1844846,1461467,2024-06-28,Assembly,"Assembly Floor: Substitute for A3698 (Voice Vote)",0,0,0,0,0
1844846,1461714,2024-06-28,Assembly,"Assembly Floor: Third Reading - Final Passage",76,0,4,0,80
1844872,1475153,2025-01-27,Assembly,"Assembly Public Safety and Preparedness Committee Committee: Reported Favorably",9,0,0,0,9
1844872,1495412,2025-02-20,Assembly,"Assembly Appropriations Committee: Reported Favorably",10,0,1,0,11
1844872,1502215,2025-02-27,Assembly,"Assembly Floor: Third Reading - Final Passage",74,0,6,0,80
1844883,1452604,2024-06-03,Assembly,"Assembly Health Committee: Reported Favorably",9,0,2,0,11
1844883,1469067,2024-10-28,Assembly,"Assembly Floor: Third Reading - Final Passage",70,1,9,0,80
1844892,1454630,2024-06-06,Assembly,"Assembly Science, Innovation and Technology Committee: Reported with Amendments",6,1,0,0,7
1844912,1444970,2024-05-20,Assembly,"Assembly Financial Institutions and Insurance Committee: Reported Favorably",11,0,2,0,13
1844912,1467470,2024-09-19,Assembly,"Assembly Judiciary Committee: Reported Favorably",6,0,0,0,6
1844912,1468998,2024-10-28,Assembly,"Assembly Floor: Third Reading - Final Passage",77,0,3,0,80
1844912,1470190,2024-12-12,Senate,"Senate Commerce Committee: Reported Favorably",5,0,0,0,5
1844912,1597266,2025-06-30,Assembly,"Assembly Floor: Concur in Senate Amendments",79,1,0,0,80
1844912,1597267,2025-06-30,Senate,"Senate Floor: Substitute for S3061 (Voice Vote)",0,0,0,0,0
1844912,1597268,2025-06-30,Senate,"Senate Floor: Third Reading - Final Passage",39,0,1,0,40
1844914,1459111,2024-06-24,Assembly,"Assembly State and Local Government Committee: Reported Favorably",7,0,0,0,7
1844917,1444763,2024-05-16,Assembly,"Assembly Science, Innovation and Technology Committee: Reported with Substitution",5,0,2,0,7
1844919,1457903,2024-06-17,Assembly,"Assembly Health Committee: Not Reported",6,2,3,0,11
1844937,1452600,2024-06-03,Assembly,"Assembly Telecommunications and Utilities Committee: Reported with Amendments",6,0,2,0,8
1844937,1459434,2024-06-24,Assembly,"Assembly Appropriations Committee: Reported Favorably",8,2,1,0,11
1844937,1461673,2024-06-28,Assembly,"Assembly Floor: Third Reading - Final Passage",62,9,9,0,80
1844937,1575886,2025-05-22,Senate,"Senate Environment and Energy Committee: Reported Favorably",4,1,0,0,5
1844975,1457091,2024-06-13,Assembly,"Assembly Housing and Community Development Committee: Reported with Amendments",7,0,0,0,7
1844975,1461493,2024-06-28,Assembly,"Assembly Floor: Third Reading - Final Passage",76,0,4,0,80
1844983,1425530,2024-04-11,Senate,"Senate Budget and Appropriations Committee: Reported Favorably",11,0,2,0,13
1844983,1442667,2024-05-13,Senate,"Senate Floor: Third Reading - Final Passage",37,0,3,0,40
1844983,1458945,2024-06-24,Assembly,"Assembly Appropriations Committee: Reported with Amendments",11,0,0,0,11
1844983,1469063,2024-10-28,Assembly,"Assembly Floor: Substitute for A4569 (Voice Vote)",0,0,0,0,0
1844983,1469064,2024-10-28,Assembly,"Assembly Floor: Third Reading - Final Passage",77,0,3,0,80
1844983,1469065,2024-10-28,Senate,"Senate Floor: Concur in Assembly Amendments",40,0,0,0,40
1844983,1470849,2024-12-19,Senate,"Senate Floor: Adopt Governor Recommendations",38,0,2,0,40
1844983,1470850,2024-12-19,Senate,"Senate Floor: Concur Governor Recommendations",38,0,2,0,40
1844983,1471005,2024-12-19,Senate,"Senate Floor: Motion to Suspend Rules",38,0,2,0,40
1844983,1596692,2025-06-30,Assembly,"Assembly Floor: Concur Governor Recommendations",80,0,0,0,80
1845003,1469892,2024-12-09,Assembly,"Assembly Financial Institutions and Insurance Committee: Reported with Amendments",10,0,3,0,13
1845003,1523405,2025-03-20,Assembly,"Assembly Appropriations Committee: Reported with Amendments",10,0,1,0,11
1845006,1407502,2024-03-11,Assembly,"Assembly Labor Committee: Reported with Amendments",10,1,0,0,11
1847938,1460804,2024-06-26,Senate,"Senate Budget and Appropriations Committee: Reported with Amendments",9,0,4,0,13
1847962,1410960,2024-03-18,Senate,"Senate State Government, Wagering, Tourism & Historic Preservation Committee: Reported Favorably",5,0,0,0,5
1847962,1458950,2024-06-24,Senate,"Senate Budget and Appropriations Committee: Reported with Amendments",12,0,1,0,13
1848066,1411027,2024-03-18,Senate,"Senate State Government, Wagering, Tourism & Historic Preservation Committee: Reported Favorably",5,0,0,0,5
1848066,1444886,2024-05-20,Senate,"Senate Floor: Third Reading - Final Passage",37,0,3,0,40
1848066,1459226,2024-06-24,Assembly,"Assembly State and Local Government Committee: Reported Favorably",7,0,0,0,7
1848066,1461598,2024-06-28,Assembly,"Assembly Floor: Substitute for A3779 (Voice Vote)",0,0,0,0,0
1848066,1461599,2024-06-28,Assembly,"Assembly Floor: Third Reading - Final Passage",77,0,3,0,80
1848069,1439482,2024-05-06,Senate,"Senate Transportation Committee: Reported Favorably",5,0,1,0,6
1848069,1469859,2024-12-09,Senate,"Senate Budget and Appropriations Committee: Reported with Amendments",13,0,0,0,13
1848148,1409401,2024-03-14,Senate,"Senate Health, Human Services and Senior Citizens Committee: Reported Favorably",8,0,0,0,8
1848148,1412159,2024-03-18,Senate,"Senate Floor: Third Reading - Final Passage",38,0,2,0,40
1848251,1467844,2024-09-30,Senate,"Senate Transportation Committee: Reported with Amendments",6,0,0,0,6
1852614,1409451,2024-03-14,Assembly,"Assembly Appropriations Committee: Reported Favorably",7,2,2,0,11
1852638,1454519,2024-06-06,Assembly,"Assembly Transportation and Independent Authorities Committee: Reported Favorably",11,0,2,0,13
1852655,1470213,2024-12-12,Assembly,"Assembly Education Committee: Reported with Amendments",8,0,1,0,9
1852655,1473819,2025-01-23,Assembly,"Assembly Science, Innovation and Technology Committee: Reported Favorably",6,1,0,0,7
1852681,1453004,2024-06-03,Assembly,"Assembly Regulated Professions Committee: Reported with Amendments",5,1,1,0,7
1852690,1403142,2024-03-04,Assembly,"Assembly Environment and Solid Waste Committee: Reported Favorably",5,0,2,0,7
1852706,1444925,2024-05-20,Assembly,"Assembly Financial Institutions and Insurance Committee: Not Reported",7,0,6,0,13
1852706,1457082,2024-06-13,Assembly,"Assembly Financial Institutions and Insurance Committee: Reported with Amendments",9,0,4,0,13
1852706,1461386,2024-06-28,Senate,"Senate Floor: Substitute for S2806 (Voice Vote)",0,0,0,0,0
1852706,1461596,2024-06-28,Assembly,"Assembly Floor: Third Reading - Final Passage",60,2,18,0,80
1852706,1461597,2024-06-28,Senate,"Senate Floor: Third Reading - Final Passage",25,15,0,0,40
1852730,1409485,2024-03-14,Assembly,"Assembly Regulated Professions Committee: Reported Favorably",6,0,1,0,7
1852730,1442732,2024-05-13,Assembly,"Assembly Floor: Third Reading - Final Passage",65,7,8,0,80
1852757,1468937,2024-10-24,Assembly,"Assembly Commerce and Economic Development Committee: Reported with Amendments",9,0,3,0,12
1852757,1471907,2025-01-16,Assembly,"Assembly Community Development and Womens Affairs Committee Committee: Reported with Amendments",6,0,0,0,6
1852774,1442694,2024-05-13,Assembly,"Assembly Regulated Professions Committee: Reported Favorably",6,0,1,0,7
1852774,1591039,2025-06-16,Assembly,"Assembly Labor Committee: Reported Favorably",12,0,0,0,12
1852790,1509701,2025-03-10,Assembly,"Assembly Education Committee: Reported with Amendments",9,0,0,0,9
1852806,1454808,2024-06-06,Assembly,"Assembly Judiciary Committee: Reported Favorably",5,0,0,0,5
1852806,1470412,2024-12-16,Assembly,"Assembly Public Safety and Preparedness Committee Committee: Reported with Amendments",9,0,0,0,9
1852806,1478238,2025-01-30,Assembly,"Assembly Floor: Third Reading - Final Passage",74,0,6,0,80
1852815,1458934,2024-06-24,Assembly,"Assembly Regulated Professions Committee: Reported Favorably",7,0,0,0,7
1852834,1442350,2024-05-13,Assembly,"Assembly Housing and Community Development Committee: Reported Favorably",5,0,2,0,7
1852834,1454627,2024-06-06,Assembly,"Assembly State and Local Government Committee: Reported Favorably",7,0,0,0,7
1852834,1469317,2024-11-14,Assembly,"Assembly Public Safety and Preparedness Committee Committee: Reported with Amendments",7,1,1,0,9
1852834,1470764,2024-12-19,Senate,"Senate Floor: Substitute for S2580 (Voice Vote)",0,0,0,0,0
1852834,1470817,2024-12-19,Assembly,"Assembly Floor: Third Reading - Final Passage",69,4,7,0,80
1852834,1470818,2024-12-19,Senate,"Senate Floor: Third Reading - Final Passage",38,0,2,0,40
1852850,1444901,2024-05-20,Assembly,"Assembly Judiciary Committee: Reported with Amendments",6,0,0,0,6
1852850,1467693,2024-09-26,Assembly,"Assembly Floor: Third Reading - Final Passage",76,0,4,0,80
1852850,1468742,2024-10-21,Senate,"Senate Law and Public Safety Committee: Reported with Amendments",5,0,0,0,5
1852850,1471404,2025-01-14,Senate,"Senate Floor: Substitute for S2513 (Voice Vote)",0,0,0,0,0
1852850,1471405,2025-01-14,Senate,"Senate Floor: Third Reading - Final Passage",35,0,4,0,39
1852850,1477814,2025-01-30,Assembly,"Assembly Floor: Concur in Senate Amendments",75,0,5,0,80
1852850,1525296,2025-03-24,Assembly,"Assembly Floor: Concur Governor Recommendations",76,0,4,0,80
1852850,1525297,2025-03-24,Senate,"Senate Floor: Concur Governor Recommendations",33,0,7,0,40
1852878,1439714,2024-05-06,Assembly,"Assembly Transportation and Independent Authorities Committee: Reported Favorably",12,0,1,0,13
1852893,1595715,2025-06-26,Assembly,"Assembly Budget Committee: Reported with Substitution",15,0,0,0,15
1852912,1458941,2024-06-24,Assembly,"Assembly Regulated Professions Committee: Reported Favorably",5,2,0,0,7
1852912,1461648,2024-06-28,Assembly,"Assembly Floor: Third Reading - Final Passage",60,17,3,0,80
1852912,1467845,2024-09-30,Senate,"Senate Transportation Committee: Reported Favorably",6,0,0,0,6
1852912,1478045,2025-01-30,Assembly,"Assembly Floor: Concur in Senate Amendments",58,17,5,0,80
1852912,1478046,2025-01-30,Senate,"Senate Floor: Substitute for S2954 (Voice Vote)",0,0,0,0,0
1852912,1478047,2025-01-30,Senate,"Senate Floor: Third Reading - Final Passage",24,13,3,0,40
1852945,1439508,2024-05-06,Assembly,"Assembly Education Committee: Reported with Amendments",9,0,0,0,9
1852952,1454638,2024-06-06,Assembly,"Assembly Science, Innovation and Technology Committee: Reported with Amendments",6,0,1,0,7
1852952,1469320,2024-11-14,Assembly,"Assembly State and Local Government Committee: Reported Favorably",6,0,1,0,7
1852960,1439876,2024-05-06,Senate,"Senate Community and Urban Affairs Committee: Reported Favorably",5,0,0,0,5
1852970,1442360,2024-05-13,Assembly,"Assembly Community Development and Womens Affairs Committee Committee: Reported with Amendments",6,0,0,0,6
1852985,1468961,2024-10-24,Assembly,"Assembly Consumer Affairs Committee: Reported with Amendments",5,0,1,0,6
1852995,1569511,2025-05-12,Senate,"Senate Education Committee: Reported with Amendments",5,0,0,0,5
1853022,1444731,2024-05-16,Assembly,"Assembly Human Services Committee: Reported Favorably",6,0,0,0,6
1853069,1470405,2024-12-16,Assembly,"Assembly Public Safety and Preparedness Committee Committee: Reported Favorably",9,0,0,0,9
1853079,1409278,2024-03-14,Senate,"Senate Labor Committee: Reported Favorably",5,0,0,0,5
1853079,1442418,2024-05-13,Senate,"Senate Floor: Third Reading - Final Passage",27,9,4,0,40
1853079,1443658,2024-05-16,Assembly,"Assembly Labor Committee: Reported Favorably",9,2,0,0,11
1853079,1461415,2024-06-28,Assembly,"Assembly Floor: Substitute for A3986 (Voice Vote)",0,0,0,0,0
1853079,1461522,2024-06-28,Assembly,"Assembly Floor: Third Reading - Final Passage",54,20,6,0,80
1853104,1444937,2024-05-20,Assembly,"Assembly Financial Institutions and Insurance Committee: Not Reported",7,0,6,0,13
1853104,1457083,2024-06-13,Assembly,"Assembly Financial Institutions and Insurance Committee: Reported with Amendments",8,0,5,0,13
1853104,1460831,2024-06-26,Assembly,"Assembly Budget Committee: Reported Favorably",8,2,5,0,15
1853104,1461585,2024-06-28,Assembly,"Assembly Floor: Third Reading - Final Passage",62,7,11,0,80
1853112,1403166,2024-03-04,Assembly,"Assembly Environment and Solid Waste Committee: Reported Favorably",6,0,1,0,7
1853256,1402826,2024-03-04,Senate,"Senate Environment and Energy Committee: Reported with Amendments",5,0,0,0,5
1853256,1444899,2024-05-20,Senate,"Senate Floor: Third Reading - Final Passage",31,6,3,0,40
1853282,1469823,2024-12-05,Senate,"Senate Labor Committee: Reported Favorably",4,0,1,0,5
1853436,1459011,2024-06-24,Assembly,"Assembly Human Services Committee: Reported Favorably",6,0,0,0,6
1853450,1425536,2024-04-11,Senate,"Senate Budget and Appropriations Committee: Reported Favorably",11,0,2,0,13
1853450,1442410,2024-05-13,Senate,"Senate Floor: Third Reading - Final Passage",36,0,4,0,40
1853450,1461676,2024-06-28,Assembly,"Assembly Floor: Substitute for A3906 (Voice Vote)",0,0,0,0,0
1853450,1461677,2024-06-28,Assembly,"Assembly Floor: Third Reading - Final Passage",66,8,6,0,80
1853450,1461678,2024-06-28,Senate,"Senate Floor: Concur in Assembly Amendments",40,0,0,0,40
1853480,1442506,2024-05-13,Senate,"Senate Commerce Committee: Reported Favorably",5,0,0,0,5
1855075,1459055,2024-06-24,Assembly,"Assembly Appropriations Committee: Reported Favorably",7,4,0,0,11
1855075,1459056,2024-06-24,Assembly,"Assembly State and Local Government Committee: Reported with Amendments",7,0,0,0,7
1855192,1477522,2025-01-30,Senate,"Senate Education Committee: Reported Favorably",5,0,0,0,5
1855213,1471308,2025-01-13,Senate,"Senate Environment and Energy Committee: Reported Favorably",4,0,1,0,5
1855274,1439630,2024-05-06,Senate,"Senate Labor Committee: Reported Favorably",4,0,1,0,5
1855274,1442292,2024-05-13,Senate,"Senate Floor: Second Reading (Voice Vote)",0,0,0,0,0
1855274,1442416,2024-05-13,Senate,"Senate Floor: Senate Substitute",27,3,10,0,40
1855274,1445072,2024-05-20,Senate,"Senate Floor: Third Reading - Final Passage",34,0,6,0,40
1855274,1461435,2024-06-28,Assembly,"Assembly Floor: Substitute for A4081 (Voice Vote)",0,0,0,0,0
1855274,1461696,2024-06-28,Assembly,"Assembly Floor: Third Reading - Final Passage",70,4,6,0,80
1855289,1442436,2024-05-13,Senate,"Senate Commerce Committee: Reported with Amendments",4,0,1,0,5
1855289,1459000,2024-06-24,Senate,"Senate Budget and Appropriations Committee: Reported with Amendments",12,0,1,0,13
1855289,1461419,2024-06-28,Assembly,"Assembly Floor: Substitute for A3972 (Voice Vote)",0,0,0,0,0
1855289,1461505,2024-06-28,Assembly,"Assembly Floor: Third Reading - Final Passage",72,0,8,0,80
1855289,1461506,2024-06-28,Senate,"Senate Floor: Third Reading - Final Passage",38,0,2,0,40
1855313,1478894,2025-02-03,Senate,"Senate Health, Human Services and Senior Citizens Committee: Reported Favorably",8,0,0,0,8
1855350,1409519,2024-03-14,Senate,"Senate Labor Committee: Reported Favorably",5,0,0,0,5
1855350,1444889,2024-05-20,Senate,"Senate Floor: Third Reading - Final Passage",37,0,3,0,40
1855350,1461364,2024-06-28,Assembly,"Assembly Floor: Substitute for A4061 (Voice Vote)",0,0,0,0,0
1855350,1461578,2024-06-28,Assembly,"Assembly Floor: Third Reading - Final Passage",70,6,4,0,80
1855350,1470802,2024-12-19,Assembly,"Assembly Floor: Concur Governor Recommendations",68,4,8,0,80
1855350,1470803,2024-12-19,Senate,"Senate Floor: Adopt Governor Recommendations",38,0,2,0,40
1855350,1470804,2024-12-19,Senate,"Senate Floor: Concur Governor Recommendations",38,0,2,0,40
1855350,1470994,2024-12-19,Senate,"Senate Floor: Motion to Suspend Rules",38,0,2,0,40
1855362,1443773,2024-05-16,Senate,"Senate Law and Public Safety Committee: Reported with Amendments",4,0,1,0,5
1855370,1439739,2024-05-06,Senate,"Senate Transportation Committee: Reported Favorably",5,0,1,0,6
1855370,1445067,2024-05-20,Senate,"Senate Floor: Third Reading - Final Passage",37,0,3,0,40
1855370,1461469,2024-06-28,Assembly,"Assembly Floor: Substitute for A4127 (Voice Vote)",0,0,0,0,0
1855370,1461671,2024-06-28,Assembly,"Assembly Floor: Third Reading - Final Passage",77,0,3,0,80
1855383,1576073,2025-05-22,Senate,"Senate Environment and Energy Committee: Reported with Amendments",4,1,0,0,5
1855396,1407176,2024-03-11,Senate,"Senate Budget and Appropriations Committee: Reported Favorably",13,0,0,0,13
1855396,1412255,2024-03-18,Senate,"Senate Floor: Third Reading - Final Passage",37,1,2,0,40
1855396,1454616,2024-06-06,Assembly,"Assembly Education Committee: Reported Favorably",8,1,0,0,9
1855396,1458946,2024-06-24,Assembly,"Assembly Appropriations Committee: Reported Favorably",10,1,0,0,11
1855396,1461589,2024-06-28,Assembly,"Assembly Floor: Substitute for A4084 (Voice Vote)",0,0,0,0,0
1855396,1461590,2024-06-28,Assembly,"Assembly Floor: Third Reading - Final Passage",70,7,3,0,80
1855398,1467826,2024-09-30,Senate,"Senate Education Committee: Reported with Amendments",3,2,0,0,5
1855401,1469781,2024-12-05,Senate,"Senate Labor Committee: Reported with Amendments",4,0,1,0,5
1855408,1406904,2024-03-11,Assembly,"Assembly State and Local Government Committee: Reported Favorably",7,0,0,0,7
1855408,1409201,2024-03-14,Assembly,"Assembly Appropriations Committee: Reported with Amendments",11,0,0,0,11
1855415,1412270,2024-03-18,Assembly,"Assembly Floor: Third Reading - Final Passage",71,0,9,0,80
1855438,1442378,2024-05-13,Assembly,"Assembly Community Development and Womens Affairs Committee Committee: Reported with Substitution",6,0,0,0,6
1855441,1468947,2024-10-24,Senate,"Senate State Government, Wagering, Tourism & Historic Preservation Committee: Reported Favorably",4,0,1,0,5
1855441,1469014,2024-10-28,Senate,"Senate Floor: Third Reading - Final Passage",40,0,0,0,40
1855448,1503344,2025-03-03,Senate,"Senate Labor Committee: Reported Favorably",5,0,0,0,5
1855457,1457121,2024-06-13,Senate,"Senate Military and Veterans' Affairs Committee: Reported Favorably",5,0,0,0,5
1855488,1410837,2024-03-18,Senate,"Senate State Government, Wagering, Tourism & Historic Preservation Committee: Reported with Amendments",5,0,0,0,5
1855499,1509206,2025-03-10,Assembly,"Assembly Environment and Solid Waste Committee: Reported with Substitution",7,0,0,0,7
1855499,1523137,2025-03-20,Assembly,"Assembly Appropriations Committee: Reported Favorably",11,0,0,0,11
1855530,1409248,2024-03-14,Senate,"Senate Labor Committee: Reported Favorably",5,0,0,0,5
1855554,1485078,2025-02-10,Senate,"Senate Commerce Committee: Reported with Amendments",5,0,0,0,5
1855554,1498894,2025-02-25,Senate,"Senate Floor: Third Reading - Final Passage",38,0,2,0,40
1855554,1572097,2025-05-15,Assembly,"Assembly Financial Institutions and Insurance Committee: Reported Favorably",12,0,1,0,13
1855554,1576524,2025-05-22,Assembly,"Assembly Floor: Substitute for A4015 (Voice Vote)",0,0,0,0,0
1855554,1576525,2025-05-22,Assembly,"Assembly Floor: Third Reading - Final Passage",77,0,3,0,80
1855569,1455717,2024-06-10,Senate,"Senate Environment and Energy Committee: Reported Favorably",3,1,1,0,5
1855577,1468635,2024-10-10,Senate,"Senate Commerce Committee: Reported with Amendments",5,0,0,0,5
1855583,1571941,2025-05-15,Assembly,"Assembly State and Local Government Committee: Reported Favorably",7,0,0,0,7
1855583,1576710,2025-05-22,Assembly,"Assembly Floor: Third Reading - Final Passage",75,1,4,0,80
1855588,1402705,2024-03-04,Assembly,"Assembly Transportation and Independent Authorities Committee: Reported Favorably",9,2,2,0,13
1855596,1569665,2025-05-12,Senate,"Senate Education Committee: Reported with Amendments",5,0,0,0,5
1855610,1585455,2025-06-05,Senate,"Senate Education Committee: Reported with Amendments",5,0,0,0,5
1855637,1585427,2025-06-05,Senate,"Senate Community and Urban Affairs Committee: Reported Favorably",4,0,1,0,5
1855637,1596865,2025-06-30,Senate,"Senate Floor: Third Reading - Final Passage",39,0,1,0,40
1855651,1409590,2024-03-14,Assembly,"Assembly Appropriations Committee: Reported Favorably",11,0,0,0,11
1855651,1411609,2024-03-18,Assembly,"Assembly Floor: Third Reading - Final Passage",77,0,3,0,80
1855651,1442338,2024-05-13,Senate,"Senate Floor: Substitute for S2890 (Voice Vote)",0,0,0,0,0
1855651,1442471,2024-05-13,Senate,"Senate Floor: Third Reading - Final Passage",37,0,3,0,40
1855658,1477599,2025-01-30,Senate,"Senate Education Committee: Reported with Amendments",5,0,0,0,5
1855676,1442491,2024-05-13,Assembly,"Assembly Regulated Professions Committee: Reported with Substitution",6,0,1,0,7
1855676,1469059,2024-10-28,Assembly,"Assembly Floor: Third Reading - Final Passage",74,1,5,0,80
1855676,1518899,2025-03-17,Senate,"Senate Budget and Appropriations Committee: Reported with Amendments",13,0,0,0,13
1855676,1524983,2025-03-24,Assembly,"Assembly Floor: Concur in Senate Amendments",69,5,6,0,80
1855676,1524984,2025-03-24,Senate,"Senate Floor: Substitute for S1635 (Voice Vote)",0,0,0,0,0
1855676,1524985,2025-03-24,Senate,"Senate Floor: Third Reading - Final Passage",39,0,1,0,40
1855682,1468637,2024-10-10,Senate,"Senate Environment and Energy Committee: Reported with Amendments",5,0,0,0,5
1856246,1409364,2024-03-14,Assembly,"Assembly Health Committee: Reported with Amendments",8,0,3,0,11
1856246,1457081,2024-06-13,Assembly,"Assembly Financial Institutions and Insurance Committee: Reported with Amendments",13,0,0,0,13
1856300,1442344,2024-05-13,Assembly,"Assembly Oversight, Reform and Federal Relations Committee: Reported Favorably",6,0,0,0,6
1856300,1459031,2024-06-24,Assembly,"Assembly Appropriations Committee: Reported with Amendments",11,0,0,0,11
1856300,1467685,2024-09-26,Assembly,"Assembly Floor: Third Reading - Final Passage",68,8,4,0,80
1856300,1503426,2025-03-03,Senate,"Senate Health, Human Services and Senior Citizens Committee: Reported with Amendments",8,0,0,0,8
1856300,1518777,2025-03-17,Senate,"Senate Budget and Appropriations Committee: Reported with Amendments",13,0,0,0,13
1856300,1524902,2025-03-24,Senate,"Senate Floor: Substitute for S3955 (Voice Vote)",0,0,0,0,0
1856300,1525491,2025-03-24,Senate,"Senate Floor: Third Reading - Final Passage",39,0,1,0,40
1856300,1596702,2025-06-30,Assembly,"Assembly Floor: Concur in Senate Amendments",80,0,0,0,80
1856354,1442369,2024-05-13,Assembly,"Assembly Oversight, Reform and Federal Relations Committee: Reported with Amendments",6,0,0,0,6
1856354,1593151,2025-06-19,Assembly,"Assembly Appropriations Committee: Reported with Amendments",11,0,0,0,11
1856354,1596894,2025-06-30,Assembly,"Assembly Floor: Third Reading - Final Passage",80,0,0,0,80
1856407,1442340,2024-05-13,Assembly,"Assembly Oversight, Reform and Federal Relations Committee: Reported Favorably",6,0,0,0,6
1856407,1592985,2025-06-19,Assembly,"Assembly Housing and Community Development Committee: Reported Favorably",6,0,1,0,7
1856566,1442490,2024-05-13,Assembly,"Assembly Oversight, Reform and Federal Relations Committee: Reported Favorably",6,0,0,0,6
1856726,1442341,2024-05-13,Assembly,"Assembly Oversight, Reform and Federal Relations Committee: Reported Favorably",6,0,0,0,6
1856726,1459017,2024-06-24,Assembly,"Assembly Appropriations Committee: Reported Favorably",11,0,0,0,11
1856726,1467688,2024-09-26,Assembly,"Assembly Floor: Third Reading - Final Passage",75,0,5,0,80
1856726,1503534,2025-03-03,Senate,"Senate Health, Human Services and Senior Citizens Committee: Reported Favorably",8,0,0,0,8
1856726,1518845,2025-03-17,Senate,"Senate Budget and Appropriations Committee: Reported with Amendments",13,0,0,0,13
1856726,1524910,2025-03-24,Senate,"Senate Floor: Substitute for S3952 (Voice Vote)",0,0,0,0,0
1856726,1524911,2025-03-24,Senate,"Senate Floor: Third Reading - Final Passage",39,0,1,0,40
1856726,1596840,2025-06-30,Assembly,"Assembly Floor: Concur in Senate Amendments",80,0,0,0,80
1856780,1442351,2024-05-13,Assembly,"Assembly Oversight, Reform and Federal Relations Committee: Reported Favorably",6,0,0,0,6
1856833,1442343,2024-05-13,Assembly,"Assembly Oversight, Reform and Federal Relations Committee: Reported with Substitution",6,0,0,0,6
1856841,1442309,2024-05-13,Assembly,"Assembly Oversight, Reform and Federal Relations Committee: Reported Favorably",6,0,0,0,6
1856841,1572356,2025-05-15,Assembly,"Assembly Appropriations Committee: Reported Favorably",11,0,0,0,11
1856841,1576185,2025-05-22,Assembly,"Assembly Floor: Third Reading - Final Passage",74,2,4,0,80
1858961,1454524,2024-06-06,Assembly,"Assembly Human Services Committee: Reported with Amendments",4,0,2,0,6
1858997,1543315,2025-04-10,Assembly,"Assembly State and Local Government Committee: Reported with Amendments",7,0,0,0,7
1859017,1572096,2025-05-15,Assembly,"Assembly Public Safety and Preparedness Committee Committee: Reported with Amendments",6,0,3,0,9
1859039,1439537,2024-05-06,Senate,"Senate Labor Committee: Reported Favorably",4,0,1,0,5
1859052,1457912,2024-06-17,Senate,"Senate State Government, Wagering, Tourism & Historic Preservation Committee: Reported Favorably",5,0,0,0,5
1859075,1589748,2025-06-12,Assembly,"Assembly Commerce and Economic Development Committee: Reported Favorably",10,0,2,0,12
1859098,1443704,2024-05-16,Assembly,"Assembly State and Local Government Committee: Reported with Amendments",7,0,0,0,7
1859116,1454657,2024-06-06,Senate,"Senate Health, Human Services and Senior Citizens Committee: Reported with Amendments",8,0,0,0,8
1859129,1443823,2024-05-16,Assembly,"Assembly Labor Committee: Reported Favorably",9,2,0,0,11
1859142,1442301,2024-05-13,Assembly,"Assembly Health Committee: Reported Favorably",10,0,1,0,11
1859142,1469039,2024-10-28,Assembly,"Assembly Floor: Third Reading - Final Passage",77,0,3,0,80
1859154,1518909,2025-03-17,Senate,"Senate Transportation Committee: Reported Favorably",5,0,1,0,6
1859172,1468915,2024-10-24,Assembly,"Assembly Labor Committee: Reported with Amendments",6,3,2,0,11
1859228,1468796,2024-10-21,Assembly,"Assembly Transportation and Independent Authorities Committee: Reported with Amendments",12,0,1,0,13
1859241,1452966,2024-06-03,Senate,"Senate Transportation Committee: Reported Favorably",6,0,0,0,6
1859247,1509200,2025-03-10,Assembly,"Assembly Education Committee: Reported Favorably",7,0,2,0,9
1859277,1457905,2024-06-17,Assembly,"Assembly Health Committee: Reported Favorably",10,0,1,0,11
1859341,1444765,2024-05-16,Assembly,"Assembly Science, Innovation and Technology Committee: Reported with Substitution",5,0,2,0,7
1859355,1572477,2025-05-15,Assembly,"Assembly Financial Institutions and Insurance Committee: Reported with Amendments",12,0,1,0,13
1859358,1442305,2024-05-13,Assembly,"Assembly Health Committee: Reported with Amendments",8,2,1,0,11
1859365,1404992,2024-03-07,Assembly,"Assembly Transportation and Independent Authorities Committee: Reported Favorably",7,4,2,0,13
1859365,1409349,2024-03-14,Assembly,"Assembly Appropriations Committee: Reported Favorably",7,4,0,0,11
1859365,1410060,2024-03-18,Senate,"Senate Floor: Substitute for S2931 (Voice Vote)",0,0,0,0,0
1859365,1411761,2024-03-18,Assembly,"Assembly Floor: Third Reading - Final Passage",49,28,3,0,80
1859365,1411762,2024-03-18,Senate,"Senate Floor: Table Motion",23,14,3,0,40
1859365,1411763,2024-03-18,Senate,"Senate Floor: Third Reading - Final Passage",24,14,2,0,40
1859384,1407500,2024-03-11,Assembly,"Assembly Labor Committee: Not Reported",9,2,0,0,11
1859384,1443844,2024-05-16,Assembly,"Assembly Labor Committee: Reported Favorably",9,2,0,0,11
1859384,1461721,2024-06-28,Assembly,"Assembly Floor: Third Reading - Final Passage",54,23,3,0,80
1859384,1469004,2024-10-28,Senate,"Senate Floor: Substitute for S3310 (Voice Vote)",0,0,0,0,0
1859384,1469005,2024-10-28,Senate,"Senate Floor: Table Motion",24,15,1,0,40
1859384,1469006,2024-10-28,Senate,"Senate Floor: Third Reading - Final Passage",28,11,1,0,40
1859418,1468935,2024-10-24,Assembly,"Assembly Financial Institutions and Insurance Committee: Reported with Amendments",8,0,5,0,13
1859425,1468690,2024-10-17,Assembly,"Assembly Health Committee: Reported Favorably",9,1,1,0,11
1859437,1457922,2024-06-17,Assembly,"Assembly Health Committee: Reported with Amendments",10,0,1,0,11
1859437,1460883,2024-06-26,Assembly,"Assembly Budget Committee: Reported with Amendments",13,0,2,0,15
1859437,1461424,2024-06-28,Senate,"Senate Floor: Substitute for S2809 (Voice Vote)",0,0,0,0,0
1859437,1461667,2024-06-28,Assembly,"Assembly Floor: Third Reading - Final Passage",77,0,3,0,80
1859437,1461668,2024-06-28,Senate,"Senate Floor: Third Reading - Final Passage",40,0,0,0,40
1859490,1461105,2024-06-26,Assembly,"Assembly Budget Committee: Reported Favorably",9,3,3,0,15
1859490,1595705,2025-06-26,Assembly,"Assembly Budget Committee: Reported with Amendments",10,0,5,0,15
1859798,1407136,2024-03-11,Senate,"Senate Budget and Appropriations Committee: Reported Favorably",9,4,0,0,13
1859886,1407503,2024-03-11,Senate,"Senate Budget and Appropriations Committee: Reported with Amendments",13,0,0,0,13
1859886,1410222,2024-03-18,Assembly,"Assembly Floor: Substitute for A4044 (Voice Vote)",0,0,0,0,0
1859886,1411797,2024-03-18,Assembly,"Assembly Floor: Third Reading - Final Passage",52,22,6,0,80
1859886,1411798,2024-03-18,Senate,"Senate Floor: Concur in Assembly Amendments",34,0,6,0,40
1859886,1411799,2024-03-18,Senate,"Senate Floor: Third Reading - Final Passage",37,0,3,0,40
1859910,1407197,2024-03-11,Assembly,"Assembly State and Local Government Committee: Reported Favorably",7,0,0,0,7
1859910,1409337,2024-03-14,Assembly,"Assembly Appropriations Committee: Reported with Amendments",9,2,0,0,11
1859910,1411907,2024-03-18,Assembly,"Assembly Floor: Third Reading - Final Passage",66,11,3,0,80
1859910,1455713,2024-06-10,Senate,"Senate Economic Growth Committee: Reported with Amendments",5,0,0,0,5
1859910,1460932,2024-06-26,Senate,"Senate Budget and Appropriations Committee: Reported with Amendments",13,0,0,0,13
1859910,1461404,2024-06-28,Senate,"Senate Floor: Substitute for S3303 (Voice Vote)",0,0,0,0,0
1859910,1461659,2024-06-28,Assembly,"Assembly Floor: Concur in Senate Amendments",65,6,9,0,80
1859910,1461660,2024-06-28,Senate,"Senate Floor: Third Reading - Final Passage",36,4,0,0,40
1859925,1407497,2024-03-11,Assembly,"Assembly State and Local Government Committee: Reported with Amendments",7,0,0,0,7
1859925,1409631,2024-03-14,Assembly,"Assembly Appropriations Committee: Reported with Amendments",10,1,0,0,11
1859939,1407163,2024-03-11,Senate,"Senate Budget and Appropriations Committee: Reported with Amendments",9,4,0,0,13
1859939,1441673,2024-05-09,Senate,"Senate Budget and Appropriations Committee: Reported with Amendments",10,3,0,0,13
1859939,1442365,2024-05-13,Assembly,"Assembly Floor: Substitute for A4045 (Voice Vote)",0,0,0,0,0
1859939,1442366,2024-05-13,Assembly,"Assembly Floor: Third Reading - Final Passage",42,27,11,0,80
1859939,1442367,2024-05-13,Senate,"Senate Floor: Third Reading - Final Passage",21,10,9,0,40
1859964,1406900,2024-03-11,Assembly,"Assembly State and Local Government Committee: Reported with Amendments",5,2,0,0,7
1859964,1442083,2024-05-10,Assembly,"Assembly Appropriations Committee: Reported with Amendments",8,1,2,0,11
1861085,1458638,2024-06-20,Senate,"Senate State Government, Wagering, Tourism & Historic Preservation Committee: Reported with Amendments",4,1,0,0,5
1861108,1470428,2024-12-16,Assembly,"Assembly Commerce and Economic Development Committee: Not Reported",7,3,2,0,12
1861158,1443776,2024-05-16,Senate,"Senate Law and Public Safety Committee: Reported with Amendments",4,0,1,0,5
1861241,1442302,2024-05-13,Assembly,"Assembly Health Committee: Reported with Amendments",10,0,1,0,11
1861257,1440154,2024-05-06,Senate,"Senate Community and Urban Affairs Committee: Reported with Amendments",5,0,0,0,5
1861257,1499712,2025-02-25,Senate,"Senate Floor: Third Reading - Final Passage",30,8,2,0,40
1861270,1407157,2024-03-11,Assembly,"Assembly Labor Committee: Reported Favorably",9,2,0,0,11
1861270,1460840,2024-06-26,Assembly,"Assembly Budget Committee: Reported Favorably",8,5,2,0,15
1861270,1461583,2024-06-28,Assembly,"Assembly Floor: Third Reading - Final Passage",55,22,3,0,80
1861270,1468993,2024-10-28,Senate,"Senate Floor: Substitute for S2949 (Voice Vote)",0,0,0,0,0
1861270,1468994,2024-10-28,Senate,"Senate Floor: Third Reading - Final Passage",36,3,1,0,40
1861297,1469309,2024-11-14,Assembly,"Assembly Tourism, Gaming and the Arts Committee: Reported Favorably",5,0,1,0,6
1861379,1457931,2024-06-17,Senate,"Senate State Government, Wagering, Tourism & Historic Preservation Committee: Reported with Amendments",5,0,0,0,5
1861379,1525220,2025-03-24,Senate,"Senate Floor: Third Reading - Final Passage",30,8,2,0,40
1861391,1439784,2024-05-06,Senate,"Senate Education Committee: Reported with Amendments",5,0,0,0,5
1861403,1409038,2024-03-14,Assembly,"Assembly Committee: Reported Favorably",6,0,0,0,6
1861403,1409074,2024-03-14,Assembly,"Assembly Community Development and Womens Affairs Committee Committee: Reported Favorably",6,0,0,0,6
1861403,1411615,2024-03-18,Assembly,"Assembly Floor: Third Reading - Final Passage",77,0,3,0,80
1861403,1469783,2024-12-05,Senate,"Senate Community and Urban Affairs Committee: Reported Favorably",4,0,1,0,5
1861403,1477215,2025-01-30,Senate,"Senate Floor: Substitute for SJR109 (Voice Vote)",0,0,0,0,0
1861403,1477820,2025-01-30,Senate,"Senate Floor: Third Reading - Final Passage",37,0,3,0,40
1861429,1459437,2024-06-24,Senate,"Senate Budget and Appropriations Committee: Reported Favorably",12,0,1,0,13
1861429,1596945,2025-06-30,Senate,"Senate Floor: Third Reading - Final Passage",38,0,2,0,40
1861436,1467842,2024-09-30,Senate,"Senate Transportation Committee: Reported Favorably",6,0,0,0,6
1861445,1407144,2024-03-11,Assembly,"Assembly Education Committee: Reported with Amendments",9,0,0,0,9
1861454,1407491,2024-03-11,Assembly,"Assembly State and Local Government Committee: Reported with Amendments",5,1,1,0,7
1861454,1411920,2024-03-18,Assembly,"Assembly Floor: Third Reading - Final Passage",51,8,21,0,80
1861458,1407152,2024-03-11,Assembly,"Assembly Education Committee: Reported Favorably",7,1,1,0,9
1861465,1469782,2024-12-05,Senate,"Senate Community and Urban Affairs Committee: Reported with Amendments",4,0,1,0,5
1861465,1478996,2025-02-03,Senate,"Senate Budget and Appropriations Committee: Reported Favorably",9,3,1,0,13
1861465,1524685,2025-03-24,Senate,"Senate Floor: Second Reading (Voice Vote)",0,0,0,0,0
1861465,1525351,2025-03-24,Senate,"Senate Floor: Amend",30,5,5,0,40
1861471,1452790,2024-06-03,Senate,"Senate Labor Committee: Reported Favorably",4,1,0,0,5
1861471,1460854,2024-06-26,Senate,"Senate Budget and Appropriations Committee: Reported Favorably",10,3,0,0,13
1861477,1407145,2024-03-11,Assembly,"Assembly Education Committee: Reported Favorably",9,0,0,0,9
1861477,1461548,2024-06-28,Assembly,"Assembly Floor: Third Reading - Final Passage",76,1,3,0,80
1861490,1410259,2024-03-18,Senate,"Senate Floor: Third Reading - Final Passage (Voice Vote)",0,0,0,0,0
1861495,1468916,2024-10-24,Senate,"Senate State Government, Wagering, Tourism & Historic Preservation Committee: Reported with Amendments",3,1,1,0,5
1862587,1457910,2024-06-17,Senate,"Senate State Government, Wagering, Tourism & Historic Preservation Committee: Reported with Amendments",5,0,0,0,5
1862587,1596986,2025-06-30,Assembly,"Assembly Floor: Substitute for A4124 (Voice Vote)",0,0,0,0,0
1862587,1596987,2025-06-30,Assembly,"Assembly Floor: Third Reading - Final Passage",70,7,3,0,80
1862587,1596988,2025-06-30,Senate,"Senate Floor: Concur in Assembly Amendments",39,0,1,0,40
1862587,1596989,2025-06-30,Senate,"Senate Floor: Third Reading - Final Passage",39,0,1,0,40
1862625,1443690,2024-05-16,Assembly,"Assembly Labor Committee: Reported with Amendments",10,1,0,0,11
1862792,1421359,2024-04-05,Assembly,"Assembly Education Committee: Reported Favorably",8,0,1,0,9
1862792,1427024,2024-04-15,Assembly,"Assembly Floor: Third Reading - Final Passage",74,0,6,0,80
1862792,1439425,2024-05-06,Senate,"Senate Education Committee: Reported Favorably",3,0,2,0,5
1862792,1441671,2024-05-09,Senate,"Senate Budget and Appropriations Committee: Reported Favorably",13,0,0,0,13
1862792,1442339,2024-05-13,Senate,"Senate Floor: Substitute for S3002 (Voice Vote)",0,0,0,0,0
1862792,1442502,2024-05-13,Senate,"Senate Floor: Third Reading - Final Passage",37,0,3,0,40
1864158,1458669,2024-06-20,Senate,"Senate Health, Human Services and Senior Citizens Committee: Reported Favorably",8,0,0,0,8
1864158,1596873,2025-06-30,Senate,"Senate Floor: Third Reading - Final Passage",39,0,1,0,40
1864246,1439799,2024-05-06,Senate,"Senate Labor Committee: Reported Favorably",4,0,1,0,5
1864246,1459711,2024-06-24,Senate,"Senate Budget and Appropriations Committee: Reported with Amendments",12,0,1,0,13
1864246,1461653,2024-06-28,Senate,"Senate Floor: Third Reading - Final Passage",40,0,0,0,40
1864246,1467305,2024-09-12,Assembly,"Assembly Regulated Professions Committee: Reported Favorably",6,1,0,0,7
1864246,1467620,2024-09-26,Assembly,"Assembly Floor: Substitute for A4745 (Voice Vote)",0,0,0,0,0
1864246,1467699,2024-09-26,Assembly,"Assembly Floor: Third Reading - Final Passage",68,7,5,0,80
1864262,1444733,2024-05-16,Assembly,"Assembly Labor Committee: Reported with Substitution",10,1,0,0,11
1864350,1444753,2024-05-16,Assembly,"Assembly Science, Innovation and Technology Committee: Reported with Amendments",7,0,0,0,7
1864350,1468936,2024-10-24,Assembly,"Assembly Regulated Professions Committee: Reported with Amendments",5,0,2,0,7
1864350,1470844,2024-12-19,Assembly,"Assembly Floor: Third Reading - Final Passage",71,1,8,0,80
1864350,1589915,2025-06-12,Senate,"Senate Commerce Committee: Reported Favorably",5,0,0,0,5
1864350,1595882,2025-06-26,Senate,"Senate Budget and Appropriations Committee: Reported with Amendments",12,1,0,0,13
1864350,1596498,2025-06-30,Senate,"Senate Floor: Substitute for S3007 (Voice Vote)",0,0,0,0,0
1864350,1596959,2025-06-30,Assembly,"Assembly Floor: Concur in Senate Amendments",79,1,0,0,80
1864350,1596960,2025-06-30,Senate,"Senate Floor: Third Reading - Final Passage",37,2,1,0,40
1864357,1458985,2024-06-24,Assembly,"Assembly Human Services Committee: Reported with Amendments",6,0,0,0,6
1864358,1458888,2024-06-24,Assembly,"Assembly Human Services Committee: Reported with Amendments",5,1,0,0,6
1864358,1502422,2025-02-27,Assembly,"Assembly Floor: Third Reading - Final Passage",72,3,5,0,80
1864372,1458666,2024-06-20,Senate,"Senate Education Committee: Reported Favorably",3,2,0,0,5
1864379,1518389,2025-03-17,Senate,"Senate Community and Urban Affairs Committee: Reported with Substitution",4,0,1,0,5
1864390,1439432,2024-05-06,Senate,"Senate Education Committee: Reported Favorably",3,0,2,0,5
1864390,1441815,2024-05-09,Senate,"Senate Budget and Appropriations Committee: Reported Favorably",13,0,0,0,13
1864400,1469773,2024-12-05,Senate,"Senate Labor Committee: Reported with Amendments",4,0,1,0,5
1864406,1470235,2024-12-12,Assembly,"Assembly State and Local Government Committee: Reported with Amendments",5,2,0,0,7
1864406,1589602,2025-06-12,Assembly,"Assembly Oversight, Reform and Federal Relations Committee: Reported with Amendments",4,1,1,0,6
1864412,1590076,2025-06-12,Senate,"Senate Commerce Committee: Reported with Amendments",5,0,0,0,5
1864412,1595815,2025-06-26,Senate,"Senate Budget and Appropriations Committee: Reported with Amendments",12,1,0,0,13
1864417,1467301,2024-09-12,Assembly,"Assembly Regulated Professions Committee: Reported with Amendments",7,0,0,0,7
1864417,1467674,2024-09-26,Assembly,"Assembly Floor: Third Reading - Final Passage",76,0,4,0,80
1864417,1468621,2024-10-10,Senate,"Senate Commerce Committee: Reported Favorably",5,0,0,0,5
1864417,1471409,2025-01-14,Senate,"Senate Floor: Substitute for S2874 (Voice Vote)",0,0,0,0,0
1864417,1471410,2025-01-14,Senate,"Senate Floor: Third Reading - Final Passage",35,0,4,0,39
1864419,1444747,2024-05-16,Senate,"Senate Judiciary Committee: Reported with Amendments",11,0,0,0,11
1864419,1460939,2024-06-26,Senate,"Senate Budget and Appropriations Committee: Reported with Substitution",13,0,0,0,13
1864419,1461683,2024-06-28,Senate,"Senate Floor: Third Reading - Final Passage",36,1,3,0,40
1864419,1467494,2024-09-19,Assembly,"Assembly State and Local Government Committee: Reported Favorably",7,0,0,0,7
1864419,1467621,2024-09-26,Assembly,"Assembly Floor: Substitute for A4299 (Voice Vote)",0,0,0,0,0
1864419,1467700,2024-09-26,Assembly,"Assembly Floor: Third Reading - Final Passage",74,0,6,0,80
1864428,1468724,2024-10-21,Senate,"Senate Military and Veterans' Affairs Committee: Reported Favorably",5,0,0,0,5
1864431,1468214,2024-10-07,Senate,"Senate Health, Human Services and Senior Citizens Committee: Reported Favorably",8,0,0,0,8
1864431,1469882,2024-12-09,Senate,"Senate Budget and Appropriations Committee: Reported with Amendments",13,0,0,0,13
1864439,1454658,2024-06-06,Assembly,"Assembly Education Committee: Reported Favorably",8,1,0,0,9
1864439,1459001,2024-06-24,Assembly,"Assembly Appropriations Committee: Reported Favorably",10,1,0,0,11
1864442,1439791,2024-05-06,Senate,"Senate Transportation Committee: Reported with Amendments",5,0,1,0,6
1864810,1585639,2025-06-05,Senate,"Senate Community and Urban Affairs Committee: Reported with Amendments",4,0,1,0,5
1864825,1489135,2025-02-13,Assembly,"Assembly Human Services Committee: Reported with Amendments",5,1,0,0,6
1864825,1502199,2025-02-27,Assembly,"Assembly Floor: Third Reading - Final Passage",59,15,6,0,80
1864840,1469821,2024-12-05,Senate,"Senate Labor Committee: Reported with Amendments",4,0,1,0,5
1864840,1470908,2024-12-19,Senate,"Senate Floor: Third Reading - Final Passage",36,0,4,0,40
1864840,1473643,2025-01-23,Assembly,"Assembly Labor Committee: Reported with Amendments",10,0,1,0,11
1864840,1596068,2025-06-27,Assembly,"Assembly Budget Committee: Reported with Amendments",10,0,5,0,15
1864840,1596464,2025-06-30,Assembly,"Assembly Floor: Substitute for A4194 (Voice Vote)",0,0,0,0,0
1864840,1596624,2025-06-30,Assembly,"Assembly Floor: Third Reading - Final Passage",72,2,6,0,80
1864840,1596625,2025-06-30,Senate,"Senate Floor: Concur in Assembly Amendments",39,0,1,0,40
1864844,1503953,2025-03-03,Senate,"Senate Health, Human Services and Senior Citizens Committee: Reported with Amendments",8,0,0,0,8
1864861,1467834,2024-09-30,Senate,"Senate Education Committee: Reported with Amendments",5,0,0,0,5
1864862,1568574,2025-05-08,Assembly,"Assembly Environment and Solid Waste Committee: Reported with Amendments",5,2,0,0,7
1864896,1452904,2024-06-03,Assembly,"Assembly Regulated Professions Committee: Reported with Amendments",7,0,0,0,7
1864896,1467523,2024-09-23,Assembly,"Assembly Appropriations Committee: Reported Favorably",9,2,0,0,11
1864896,1467670,2024-09-26,Assembly,"Assembly Floor: Third Reading - Final Passage",61,14,5,0,80
1864900,1443628,2024-05-16,Assembly,"Assembly Children, Families and Food Security Committee Committee: Reported with Amendments",5,0,1,0,6
1864951,1469306,2024-11-14,Assembly,"Assembly State and Local Government Committee: Reported with Amendments",5,1,1,0,7
1864951,1590990,2025-06-16,Assembly,"Assembly Labor Committee: Reported Favorably",12,0,0,0,12
1864978,1457122,2024-06-13,Senate,"Senate Military and Veterans' Affairs Committee: Reported with Amendments",5,0,0,0,5
1864978,1499754,2025-02-25,Senate,"Senate Floor: Third Reading - Final Passage",38,0,2,0,40
1864978,1589490,2025-06-12,Assembly,"Assembly Higher Education Committee: Reported Favorably",7,0,0,0,7
1864978,1596490,2025-06-30,Assembly,"Assembly Floor: Substitute for A4878 (Voice Vote)",0,0,0,0,0
1864978,1596947,2025-06-30,Assembly,"Assembly Floor: Third Reading - Final Passage",80,0,0,0,80
1864995,1468636,2024-10-10,Senate,"Senate Commerce Committee: Reported with Amendments",5,0,0,0,5
1864999,1439459,2024-05-06,Assembly,"Assembly Transportation and Independent Authorities Committee: Reported Favorably",12,0,1,0,13
1865065,1439794,2024-05-06,Senate,"Senate Labor Committee: Reported Favorably",4,0,1,0,5
1865066,1452780,2024-06-03,Assembly,"Assembly Regulated Professions Committee: Reported with Amendments",7,0,0,0,7
1865066,1461492,2024-06-28,Assembly,"Assembly Floor: Third Reading - Final Passage",75,1,4,0,80
1865069,1452784,2024-06-03,Assembly,"Assembly Higher Education Committee: Reported Favorably",6,0,1,0,7
1865075,1467537,2024-09-23,Assembly,"Assembly Higher Education Committee: Reported with Amendments",6,0,1,0,7
1865075,1502360,2025-02-27,Assembly,"Assembly Floor: Third Reading - Final Passage",75,0,5,0,80
1865075,1576569,2025-05-22,Senate,"Senate Higher Eduction Committee: Reported Favorably",4,0,1,0,5
1865075,1583210,2025-06-02,Senate,"Senate Floor: Substitute for S2155 (Voice Vote)",0,0,0,0,0
1865075,1583715,2025-06-02,Senate,"Senate Floor: Third Reading - Final Passage",38,0,2,0,40
1865089,1595804,2025-06-26,Senate,"Senate Budget and Appropriations Committee: Reported with Substitution",9,4,0,0,13
1865100,1439552,2024-05-06,Assembly,"Assembly Education Committee: Reported Favorably",9,0,0,0,9
1865100,1467675,2024-09-26,Assembly,"Assembly Floor: Third Reading - Final Passage",76,0,4,0,80
1865100,1467825,2024-09-30,Senate,"Senate Education Committee: Reported Favorably",5,0,0,0,5
1865100,1468979,2024-10-28,Senate,"Senate Floor: Substitute for S3057 (Voice Vote)",0,0,0,0,0
1865100,1468980,2024-10-28,Senate,"Senate Floor: Third Reading - Final Passage",39,0,1,0,40
1865139,1470193,2024-12-12,Senate,"Senate Commerce Committee: Reported Favorably",5,0,0,0,5
1865140,1454597,2024-06-06,Assembly,"Assembly Labor Committee: Reported with Amendments",9,1,1,0,11
1865140,1458875,2024-06-24,Assembly,"Assembly Regulated Professions Committee: Reported Favorably",5,0,2,0,7
1865143,1442851,2024-05-13,Senate,"Senate Environment and Energy Committee: Reported with Amendments",5,0,0,0,5
1865146,1503886,2025-03-03,Senate,"Senate Military and Veterans' Affairs Committee: Reported Favorably",5,0,0,0,5
1865150,1441764,2024-05-09,Senate,"Senate Health, Human Services and Senior Citizens Committee: Reported Favorably",8,0,0,0,8
1865150,1442467,2024-05-13,Senate,"Senate Floor: Third Reading - Final Passage",36,0,4,0,40
1865150,1473835,2025-01-23,Assembly,"Assembly Children, Families and Food Security Committee Committee: Reported Favorably",5,0,1,0,6
1865150,1524630,2025-03-24,Assembly,"Assembly Floor: Substitute for AJR167 (Voice Vote)",0,0,0,0,0
1865150,1525583,2025-03-24,Assembly,"Assembly Floor: Third Reading - Final Passage",78,0,2,0,80
1865152,1443774,2024-05-16,Senate,"Senate Military and Veterans' Affairs Committee: Reported Favorably",5,0,0,0,5
1865152,1461716,2024-06-28,Senate,"Senate Floor: Third Reading - Final Passage",39,0,1,0,40
1865152,1468716,2024-10-21,Assembly,"Assembly Military and Veterans' Affairs Committee: Reported Favorably",6,0,0,0,6
1865152,1469052,2024-10-28,Assembly,"Assembly Floor: Substitute for AJR60 (Voice Vote)",0,0,0,0,0
1865152,1469053,2024-10-28,Assembly,"Assembly Floor: Third Reading - Final Passage",77,0,3,0,80
1865163,1439517,2024-05-06,Senate,"Senate Transportation Committee: Reported Favorably",5,0,1,0,6
1870348,1468928,2024-10-24,Assembly,"Assembly Financial Institutions and Insurance Committee: Reported with Amendments",12,0,1,0,13
1870348,1470417,2024-12-16,Assembly,"Assembly Appropriations Committee: Reported Favorably",10,0,1,0,11
1870348,1525067,2025-03-24,Assembly,"Assembly Floor: Concur in Senate Amendments",77,0,3,0,80
1870348,1525068,2025-03-24,Assembly,"Assembly Floor: Third Reading - Final Passage",78,0,2,0,80
1870348,1525069,2025-03-24,Senate,"Senate Floor: Amend",39,0,1,0,40
1870348,1525070,2025-03-24,Senate,"Senate Floor: Second Reading (Voice Vote)",0,0,0,0,0
1870348,1525071,2025-03-24,Senate,"Senate Floor: Substitute for S3098 (Voice Vote)",0,0,0,0,0
1870348,1525072,2025-03-24,Senate,"Senate Floor: Third Reading - Final Passage",39,0,1,0,40
1870419,1425430,2024-04-11,Assembly,"Assembly Appropriations Committee: Reported Favorably",6,3,2,0,11
1870419,1426347,2024-04-05,Assembly,"Assembly Education Committee: Reported Favorably",8,0,1,0,9
1870419,1426917,2024-04-15,Assembly,"Assembly Floor: Table Motion",43,24,13,0,80
1870419,1426918,2024-04-15,Assembly,"Assembly Floor: Third Reading - Final Passage",51,20,9,0,80
1870419,1441678,2024-05-09,Senate,"Senate Budget and Appropriations Committee: Reported with Amendments",11,2,0,0,13
1870419,1442291,2024-05-13,Senate,"Senate Floor: Substitute for S3081 (Voice Vote)",0,0,0,0,0
1870419,1442402,2024-05-13,Assembly,"Assembly Floor: Concur in Senate Amendments",48,23,9,0,80
1870419,1442403,2024-05-13,Senate,"Senate Floor: Table Motion",22,13,5,0,40
1870419,1442404,2024-05-13,Senate,"Senate Floor: Third Reading - Final Passage",24,9,7,0,40
1870436,1468722,2024-10-21,Assembly,"Assembly Judiciary Committee: Reported Favorably",6,0,0,0,6
1870703,1452773,2024-06-03,Assembly,"Assembly Consumer Affairs Committee: Reported Favorably",4,0,2,0,6
1870703,1468990,2024-10-28,Assembly,"Assembly Floor: Third Reading - Final Passage",63,0,17,0,80
1870703,1471413,2025-01-14,Senate,"Senate Floor: Substitute for SJR104 (Voice Vote)",0,0,0,0,0
1870703,1471414,2025-01-14,Senate,"Senate Floor: Third Reading - Final Passage",33,0,6,0,39
1870703,1502256,2025-02-27,Assembly,"Assembly Floor: Concur in Senate Amendments",63,0,17,0,80
1870764,1592992,2025-06-19,Senate,"Senate State Government, Wagering, Tourism & Historic Preservation Committee: Reported Favorably",5,0,0,0,5
1870796,1468944,2024-10-24,Senate,"Senate State Government, Wagering, Tourism & Historic Preservation Committee: Reported with Amendments",4,0,1,0,5
1870798,1470185,2024-12-12,Senate,"Senate Commerce Committee: Reported with Amendments",5,0,0,0,5
1870798,1518592,2025-03-17,Senate,"Senate Budget and Appropriations Committee: Reported with Amendments",13,0,0,0,13
1870801,1468205,2024-10-07,Senate,"Senate Budget and Appropriations Committee: Reported with Substitution",13,0,0,0,13
1870820,1468804,2024-10-21,Senate,"Senate Law and Public Safety Committee: Reported with Substitution",5,0,0,0,5
1870825,1443652,2024-05-16,Senate,"Senate Economic Growth Committee: Reported Favorably",5,0,0,0,5
1870825,1458944,2024-06-24,Senate,"Senate Budget and Appropriations Committee: Reported Favorably",12,0,1,0,13
1870825,1461480,2024-06-28,Assembly,"Assembly Floor: Substitute for A4226 (Voice Vote)",0,0,0,0,0
1870825,1461481,2024-06-28,Assembly,"Assembly Floor: Third Reading - Final Passage",55,16,9,0,80
1870825,1461482,2024-06-28,Senate,"Senate Floor: Third Reading - Final Passage",40,0,0,0,40
1870828,1441706,2024-05-09,Senate,"Senate Budget and Appropriations Committee: Reported with Substitution",11,2,0,0,13
1870836,1468721,2024-10-21,Assembly,"Assembly Judiciary Committee: Reported with Amendments",6,0,0,0,6
1870836,1470427,2024-12-16,Assembly,"Assembly Appropriations Committee: Reported Favorably",7,2,2,0,11
1870836,1495213,2025-02-20,Assembly,"Assembly Appropriations Committee: Reported with Amendments",10,0,1,0,11
1870836,1502197,2025-02-27,Assembly,"Assembly Floor: Third Reading - Final Passage",49,26,5,0,80
1870852,1445370,2024-05-20,Assembly,"Assembly Judiciary Committee: Reported Favorably",6,0,0,0,6
1870852,1469068,2024-10-28,Assembly,"Assembly Floor: Third Reading - Final Passage",77,0,3,0,80
1870855,1586740,2025-06-09,Senate,"Senate Budget and Appropriations Committee: Reported with Amendments",12,0,1,0,13
1870858,1470176,2024-12-12,Assembly,"Assembly Judiciary Committee: Reported Favorably",6,0,0,0,6
1870873,1457125,2024-06-13,Senate,"Senate Military and Veterans' Affairs Committee: Reported Favorably",5,0,0,0,5
1871846,1467848,2024-09-30,Senate,"Senate Community and Urban Affairs Committee: Reported with Amendments",4,1,0,0,5
1871853,1519047,2025-03-17,Senate,"Senate Education Committee: Reported with Amendments",3,0,2,0,5
1871877,1457071,2024-06-13,Senate,"Senate Law and Public Safety Committee: Reported with Amendments",4,0,1,0,5
1871893,1457092,2024-06-13,Senate,"Senate Law and Public Safety Committee: Reported with Substitution",4,0,1,0,5
1871897,1460877,2024-06-26,Assembly,"Assembly Budget Committee: Reported Favorably",12,1,2,0,15
1871897,1461707,2024-06-28,Assembly,"Assembly Floor: Third Reading - Final Passage",67,4,9,0,80
1871960,1457072,2024-06-13,Senate,"Senate Law and Public Safety Committee: Reported with Substitution",4,0,1,0,5
1871966,1523319,2025-03-20,Assembly,"Assembly Oversight, Reform and Federal Relations Committee: Reported Favorably",5,1,0,0,6
1871966,1591075,2025-06-16,Assembly,"Assembly Labor Committee: Reported Favorably",10,2,0,0,12
1871966,1596965,2025-06-30,Assembly,"Assembly Floor: Third Reading - Final Passage",61,19,0,0,80
1871994,1443763,2024-05-16,Assembly,"Assembly State and Local Government Committee: Reported Favorably",7,0,0,0,7
1871994,1572139,2025-05-15,Assembly,"Assembly Appropriations Committee: Reported Favorably",11,0,0,0,11
1871994,1576656,2025-05-22,Assembly,"Assembly Floor: Third Reading - Final Passage",76,1,3,0,80
1871994,1586715,2025-06-09,Senate,"Senate Budget and Appropriations Committee: Reported Favorably",12,0,1,0,13
1871994,1596451,2025-06-30,Senate,"Senate Floor: Substitute for S4553 (Voice Vote)",0,0,0,0,0
1871994,1596687,2025-06-30,Senate,"Senate Floor: Third Reading - Final Passage",39,0,1,0,40
1872017,1468620,2024-10-10,Senate,"Senate Commerce Committee: Reported with Amendments",5,0,0,0,5
1872017,1477830,2025-01-30,Senate,"Senate Floor: Third Reading - Final Passage",37,0,3,0,40
1872017,1572114,2025-05-15,Assembly,"Assembly Consumer Affairs Committee: Reported Favorably",5,0,1,0,6
1872017,1596549,2025-06-30,Assembly,"Assembly Floor: Substitute for A4334 (Voice Vote)",0,0,0,0,0
1872017,1596857,2025-06-30,Assembly,"Assembly Floor: Third Reading - Final Passage",79,0,1,0,80
1872017,1596858,2025-06-30,Senate,"Senate Floor: Concur in Assembly Amendments",39,0,1,0,40
1872019,1439422,2024-05-06,Assembly,"Assembly Transportation and Independent Authorities Committee: Reported with Amendments",12,0,1,0,13
1872029,1439522,2024-05-06,Senate,"Senate Transportation Committee: Reported with Amendments",5,0,1,0,6
1872029,1444896,2024-05-20,Senate,"Senate Floor: Third Reading - Final Passage",37,0,3,0,40
1872029,1461429,2024-06-28,Assembly,"Assembly Floor: Substitute for A4192 (Voice Vote)",0,0,0,0,0
1872029,1461570,2024-06-28,Assembly,"Assembly Floor: Third Reading - Final Passage",77,0,3,0,80
1872034,1595779,2025-06-26,Senate,"Senate Budget and Appropriations Committee: Reported Favorably",10,3,0,0,13
1872055,1442837,2024-05-13,Senate,"Senate Environment and Energy Committee: Reported with Amendments",3,2,0,0,5
1872275,1427017,2024-04-15,Assembly,"Assembly Floor: Third Reading - Final Passage",53,10,17,0,80
1872373,1473832,2025-01-23,Assembly,"Assembly Labor Committee: Reported with Amendments",10,0,1,0,11
1872373,1596070,2025-06-27,Assembly,"Assembly Budget Committee: Reported with Amendments",10,0,5,0,15
1872389,1469887,2024-12-09,Assembly,"Assembly Housing and Community Development Committee: Reported Favorably",7,0,0,0,7
1872389,1495870,2025-02-20,Assembly,"Assembly Appropriations Committee: Reported Favorably",10,0,1,0,11
1872389,1502409,2025-02-27,Assembly,"Assembly Floor: Third Reading - Final Passage",74,1,5,0,80
1872389,1569542,2025-05-12,Senate,"Senate Community and Urban Affairs Committee: Reported Favorably",4,0,1,0,5
1872397,1444710,2024-05-16,Assembly,"Assembly Tourism, Gaming and the Arts Committee: Reported Favorably",6,0,0,0,6
1872420,1452592,2024-06-03,Assembly,"Assembly Higher Education Committee: Not Reported",6,0,1,0,7
1872420,1467529,2024-09-23,Assembly,"Assembly Higher Education Committee: Reported with Amendments",6,0,1,0,7
1872420,1468913,2024-10-24,Assembly,"Assembly Appropriations Committee: Reported Favorably",8,0,3,0,11
1872420,1470848,2024-12-19,Assembly,"Assembly Floor: Third Reading - Final Passage",70,1,9,0,80
1872444,1467495,2024-09-19,Assembly,"Assembly Human Services Committee: Reported Favorably",4,2,0,0,6
1872444,1469037,2024-10-28,Assembly,"Assembly Floor: Third Reading - Final Passage",62,13,5,0,80
1872449,1468220,2024-10-07,Senate,"Senate Health, Human Services and Senior Citizens Committee: Reported with Amendments",8,0,0,0,8
1872451,1591060,2025-06-16,Assembly,"Assembly Science, Innovation and Technology Committee: Reported Favorably",5,0,2,0,7
1872451,1596798,2025-06-30,Assembly,"Assembly Floor: Third Reading - Final Passage",80,0,0,0,80
1872453,1452862,2024-06-03,Assembly,"Assembly Regulated Professions Committee: Reported Favorably",5,0,2,0,7
1872489,1439540,2024-05-06,Assembly,"Assembly Human Services Committee: Reported Favorably",4,0,2,0,6
1872489,1471910,2025-01-16,Assembly,"Assembly Community Development and Womens Affairs Committee Committee: Reported with Amendments",6,0,0,0,6
1872489,1473660,2025-01-23,Assembly,"Assembly Children, Families and Food Security Committee Committee: Reported Favorably",5,0,1,0,6
1872489,1523289,2025-03-20,Assembly,"Assembly Appropriations Committee: Reported with Substitution",11,0,0,0,11
1872492,1444302,2024-05-16,Assembly,"Assembly State and Local Government Committee: Reported Favorably",7,0,0,0,7
1872492,1469011,2024-10-28,Assembly,"Assembly Floor: Third Reading - Final Passage",76,0,4,0,80
1872498,1473859,2025-01-23,Assembly,"Assembly Children, Families and Food Security Committee Committee: Reported Favorably",5,0,1,0,6
1872511,1453005,2024-06-03,Assembly,"Assembly Commerce and Economic Development Committee: Reported with Amendments",11,0,1,0,12
1872511,1470418,2024-12-16,Assembly,"Assembly Appropriations Committee: Reported Favorably",10,0,1,0,11
1872511,1470918,2024-12-19,Assembly,"Assembly Floor: Third Reading - Final Passage",72,0,8,0,80
1872514,1458956,2024-06-24,Assembly,"Assembly State and Local Government Committee: Reported Favorably",7,0,0,0,7
1872523,1467536,2024-09-23,Assembly,"Assembly Higher Education Committee: Reported with Amendments",6,0,1,0,7
1872523,1470873,2024-12-19,Assembly,"Assembly Floor: Third Reading - Final Passage",71,0,9,0,80
1872523,1485130,2025-02-10,Senate,"Senate Higher Eduction Committee: Reported Favorably",5,0,0,0,5
1872529,1596867,2025-06-30,Assembly,"Assembly Floor: Table Motion",44,28,8,0,80
1872550,1470211,2024-12-12,Assembly,"Assembly Tourism, Gaming and the Arts Committee: Reported Favorably",6,0,0,0,6
1872553,1442475,2024-05-13,Assembly,"Assembly Commerce and Economic Development Committee: Reported with Amendments",9,3,0,0,12
1872553,1458947,2024-06-24,Assembly,"Assembly Appropriations Committee: Reported Favorably",7,4,0,0,11
1872575,1468693,2024-10-17,Assembly,"Assembly Health Committee: Reported Favorably",10,0,1,0,11
1872586,1452866,2024-06-03,Assembly,"Assembly Regulated Professions Committee: Reported with Amendments",7,0,0,0,7
1872590,1443659,2024-05-16,Senate,"Senate Economic Growth Committee: Reported with Amendments",5,0,0,0,5
1872590,1469857,2024-12-09,Senate,"Senate Budget and Appropriations Committee: Reported with Amendments",13,0,0,0,13
1872590,1470798,2024-12-19,Senate,"Senate Floor: Third Reading - Final Passage",38,0,2,0,40
1872623,1468921,2024-10-24,Assembly,"Assembly Financial Institutions and Insurance Committee: Reported Favorably",12,0,1,0,13
1872629,1489757,2025-02-13,Assembly,"Assembly Human Services Committee: Reported Favorably",6,0,0,0,6
1872629,1502206,2025-02-27,Assembly,"Assembly Floor: Third Reading - Final Passage",75,0,5,0,80
1872642,1468221,2024-10-07,Senate,"Senate Health, Human Services and Senior Citizens Committee: Reported with Amendments",8,0,0,0,8
1872642,1469890,2024-12-09,Senate,"Senate Budget and Appropriations Committee: Reported Favorably",13,0,0,0,13
1872642,1470843,2024-12-19,Senate,"Senate Floor: Third Reading - Final Passage",38,0,2,0,40
1872642,1523263,2025-03-20,Assembly,"Assembly Appropriations Committee: Reported Favorably",11,0,0,0,11
1872646,1472036,2025-01-16,Assembly,"Assembly Regulated Professions Committee: Reported with Amendments",7,0,0,0,7
1872647,1452828,2024-06-03,Assembly,"Assembly Health Committee: Reported Favorably",10,0,1,0,11
1872647,1576570,2025-05-22,Assembly,"Assembly Floor: Third Reading - Final Passage",77,0,3,0,80
1875797,1439384,2024-05-06,Assembly,"Assembly Transportation and Independent Authorities Committee: Reported Favorably",12,0,1,0,13
1875797,1458971,2024-06-24,Assembly,"Assembly Appropriations Committee: Reported Favorably",11,0,0,0,11
1875797,1458972,2024-06-24,Assembly,"Assembly Regulated Professions Committee: Reported with Amendments",7,0,0,0,7
1875797,1461606,2024-06-28,Assembly,"Assembly Floor: Third Reading - Final Passage",75,0,5,0,80
1875797,1477171,2025-01-30,Senate,"Senate Transportation Committee: Reported Favorably",6,0,0,0,6
1875942,1442401,2024-05-13,Assembly,"Assembly Commerce and Economic Development Committee: Reported Favorably",8,1,3,0,12
1875953,1572194,2025-05-15,Assembly,"Assembly Regulated Professions Committee: Reported with Amendments",6,0,1,0,7
1875953,1576413,2025-05-22,Assembly,"Assembly Floor: Third Reading - Final Passage",74,1,5,0,80
1875959,1458936,2024-06-24,Assembly,"Assembly Regulated Professions Committee: Reported Favorably",7,0,0,0,7
1875959,1461664,2024-06-28,Assembly,"Assembly Floor: Third Reading - Final Passage",76,1,3,0,80
1875964,1467488,2024-09-19,Assembly,"Assembly State and Local Government Committee: Reported with Amendments",7,0,0,0,7
1875964,1589964,2025-06-12,Assembly,"Assembly Regulated Professions Committee: Reported Favorably",6,0,1,0,7
1875964,1596874,2025-06-30,Assembly,"Assembly Floor: Third Reading - Final Passage",78,1,1,0,80
1875980,1467481,2024-09-19,Assembly,"Assembly State and Local Government Committee: Reported with Amendments",7,0,0,0,7
1876226,1457920,2024-06-17,Assembly,"Assembly Health Committee: Reported with Amendments",10,0,1,0,11
1876230,1469774,2024-12-05,Senate,"Senate Community and Urban Affairs Committee: Reported with Substitution",4,0,1,0,5
1876234,1457900,2024-06-17,Senate,"Senate Community and Urban Affairs Committee: Reported with Amendments",4,0,1,0,5
1876235,1457048,2024-06-13,Senate,"Senate Military and Veterans' Affairs Committee: Reported with Amendments",5,0,0,0,5
1876247,1569533,2025-05-12,Senate,"Senate Community and Urban Affairs Committee: Reported Favorably",4,0,1,0,5
1876251,1457116,2024-06-13,Senate,"Senate Law and Public Safety Committee: Reported Favorably",4,0,1,0,5
1876251,1461708,2024-06-28,Senate,"Senate Floor: Third Reading - Final Passage",40,0,0,0,40
1876251,1469303,2024-11-14,Assembly,"Assembly Public Safety and Preparedness Committee Committee: Reported Favorably",7,0,2,0,9
1876251,1470940,2024-12-19,Assembly,"Assembly Floor: Substitute for A2941 (Voice Vote)",0,0,0,0,0
1876251,1470941,2024-12-19,Assembly,"Assembly Floor: Third Reading - Final Passage",72,1,7,0,80
1876255,1569672,2025-05-12,Senate,"Senate Labor Committee: Reported with Amendments",5,0,0,0,5
1876257,1469768,2024-12-05,Senate,"Senate Community and Urban Affairs Committee: Reported Favorably",4,0,1,0,5
1876259,1443657,2024-05-16,Assembly,"Assembly Tourism, Gaming and the Arts Committee: Reported Favorably",6,0,0,0,6
1876259,1467710,2024-09-26,Assembly,"Assembly Floor: Third Reading - Final Passage",75,0,5,0,80
1876260,1467297,2024-09-12,Assembly,"Assembly Regulated Professions Committee: Reported with Amendments",7,0,0,0,7
1876260,1576623,2025-05-22,Assembly,"Assembly Floor: Third Reading - Final Passage",78,0,2,0,80
1876260,1595947,2025-06-26,Senate,"Senate Budget and Appropriations Committee: Reported Favorably",13,0,0,0,13
1876260,1596441,2025-06-30,Senate,"Senate Floor: Substitute for S3227 (Voice Vote)",0,0,0,0,0
1876260,1596686,2025-06-30,Senate,"Senate Floor: Third Reading - Final Passage",39,0,1,0,40
1876269,1454785,2024-06-06,Assembly,"Assembly Education Committee: Reported with Amendments",9,0,0,0,9
1876276,1503140,2025-03-03,Senate,"Senate Labor Committee: Reported with Amendments",3,2,0,0,5
1876288,1468943,2024-10-24,Senate,"Senate State Government, Wagering, Tourism & Historic Preservation Committee: Reported with Amendments",4,0,1,0,5
1876288,1469054,2024-10-28,Senate,"Senate Floor: Third Reading - Final Passage (Voice Vote)",0,0,0,0,0
1876293,1545131,2025-04-10,Assembly,"Assembly Science, Innovation and Technology Committee: Reported with Amendments",5,0,2,0,7
1876293,1568036,2025-05-08,Assembly,"Assembly Children, Families and Food Security Committee Committee: Reported Favorably",5,0,1,0,6
1876293,1596700,2025-06-30,Assembly,"Assembly Floor: Third Reading - Final Passage",68,4,8,0,80
1876297,1470816,2024-12-19,Senate,"Senate Health, Human Services and Senior Citizens Committee: Reported Favorably",8,0,0,0,8
1876306,1459008,2024-06-24,Assembly,"Assembly Appropriations Committee: Reported with Substitution",11,0,0,0,11
1876312,1439404,2024-05-06,Senate,"Senate Education Committee: Reported Favorably",4,1,0,0,5
1876312,1444892,2024-05-20,Senate,"Senate Floor: Table Motion",22,15,3,0,40
1876312,1444893,2024-05-20,Senate,"Senate Floor: Third Reading - Final Passage",22,15,3,0,40
1876312,1467486,2024-09-19,Assembly,"Assembly Education Committee: Reported with Amendments",6,3,0,0,9
1876320,1452827,2024-06-03,Assembly,"Assembly Health Committee: Reported Favorably",10,0,1,0,11
1876324,1468917,2024-10-24,Assembly,"Assembly Regulated Professions Committee: Reported with Amendments",5,0,2,0,7
1876324,1470854,2024-12-19,Assembly,"Assembly Floor: Third Reading - Final Passage",71,0,9,0,80
1876324,1573088,2025-05-19,Senate,"Senate Health, Human Services and Senior Citizens Committee: Reported Favorably",8,0,0,0,8
1876327,1442697,2024-05-13,Senate,"Senate Commerce Committee: Reported Favorably",5,0,0,0,5
1876327,1444885,2024-05-20,Senate,"Senate Floor: Third Reading - Final Passage",37,0,3,0,40
1876327,1457090,2024-06-13,Assembly,"Assembly Financial Institutions and Insurance Committee: Reported Favorably",13,0,0,0,13
1876327,1460849,2024-06-26,Assembly,"Assembly Budget Committee: Reported with Amendments",13,0,2,0,15
1876327,1461373,2024-06-28,Assembly,"Assembly Floor: Substitute for A4454 (Voice Vote)",0,0,0,0,0
1876327,1461587,2024-06-28,Assembly,"Assembly Floor: Third Reading - Final Passage",76,0,4,0,80
1876327,1461588,2024-06-28,Senate,"Senate Floor: Concur in Assembly Amendments",40,0,0,0,40
1876329,1468628,2024-10-10,Senate,"Senate Economic Growth Committee: Reported with Amendments",5,0,0,0,5
1876329,1479124,2025-02-03,Senate,"Senate Budget and Appropriations Committee: Reported Favorably",12,0,1,0,13
1876329,1499016,2025-02-25,Senate,"Senate Floor: Third Reading - Final Passage",38,0,2,0,40
1876329,1593258,2025-06-19,Assembly,"Assembly Appropriations Committee: Reported with Amendments",9,2,0,0,11
1876329,1596489,2025-06-30,Assembly,"Assembly Floor: Substitute for A2365 (Voice Vote)",0,0,0,0,0
1876329,1596706,2025-06-30,Assembly,"Assembly Floor: Third Reading - Final Passage",78,1,1,0,80
1876329,1596707,2025-06-30,Senate,"Senate Floor: Concur in Assembly Amendments",38,0,2,0,40
1876336,1467846,2024-09-30,Senate,"Senate Transportation Committee: Reported Favorably",6,0,0,0,6
1876341,1470183,2024-12-12,Senate,"Senate Commerce Committee: Reported with Amendments",5,0,0,0,5
1876341,1470847,2024-12-19,Senate,"Senate Floor: Third Reading - Final Passage",38,0,2,0,40
1876344,1470415,2024-12-16,Senate,"Senate Judiciary Committee: Reported Favorably",11,0,0,0,11
1876344,1499733,2025-02-25,Senate,"Senate Floor: Third Reading - Final Passage",37,0,3,0,40
1876351,1439904,2024-05-06,Senate,"Senate Community and Urban Affairs Committee: Reported with Amendments",4,0,1,0,5
1876351,1595950,2025-06-26,Senate,"Senate Budget and Appropriations Committee: Reported with Substitution",9,4,0,0,13
1876369,1576551,2025-05-22,Senate,"Senate Higher Eduction Committee: Reported with Amendments",4,0,1,0,5
1876371,1458989,2024-06-24,Assembly,"Assembly Appropriations Committee: Reported with Substitution",11,0,0,0,11
1876373,1459033,2024-06-24,Assembly,"Assembly Appropriations Committee: Reported with Substitution",11,0,0,0,11
1876385,1522966,2025-03-20,Assembly,"Assembly Oversight, Reform and Federal Relations Committee: Reported with Amendments",6,0,0,0,6
1876428,1454919,2024-06-06,Assembly,"Assembly State and Local Government Committee: Reported with Amendments",6,1,0,0,7
1876428,1458926,2024-06-24,Assembly,"Assembly Regulated Professions Committee: Reported Favorably",7,0,0,0,7
1876428,1461571,2024-06-28,Assembly,"Assembly Floor: Third Reading - Final Passage",74,2,4,0,80
1876428,1461572,2024-06-28,Senate,"Senate Floor: Substitute for S3402 (Voice Vote)",0,0,0,0,0
1876428,1461573,2024-06-28,Senate,"Senate Floor: Third Reading - Final Passage",38,1,1,0,40
1876439,1442834,2024-05-13,Senate,"Senate Environment and Energy Committee: Reported Favorably",5,0,0,0,5
1876439,1461430,2024-06-28,Senate,"Senate Floor: Third Reading - Final Passage (Voice Vote)",0,0,0,0,0
1876445,1478941,2025-02-03,Senate,"Senate Health, Human Services and Senior Citizens Committee: Reported Favorably",8,0,0,0,8
1876445,1499445,2025-02-25,Senate,"Senate Floor: Third Reading - Final Passage (Voice Vote)",0,0,0,0,0
1876494,1572051,2025-05-15,Assembly,"Assembly Consumer Affairs Committee: Reported with Amendments",5,0,1,0,6
1876498,1460907,2024-06-26,Senate,"Senate Budget and Appropriations Committee: Reported with Substitution",13,0,0,0,13
1876514,1469325,2024-11-14,Assembly,"Assembly Regulated Professions Committee: Reported with Amendments",4,2,1,0,7
1876569,1443671,2024-05-16,Assembly,"Assembly Human Services Committee: Reported Favorably",4,2,0,0,6
1876569,1461607,2024-06-28,Assembly,"Assembly Floor: Third Reading - Final Passage",57,7,16,0,80
1876595,1468616,2024-10-10,Senate,"Senate Environment and Energy Committee: Reported with Amendments",3,2,0,0,5
1876607,1457114,2024-06-13,Senate,"Senate Law and Public Safety Committee: Reported with Amendments",4,0,1,0,5
1876607,1460938,2024-06-26,Senate,"Senate Budget and Appropriations Committee: Reported Favorably",13,0,0,0,13
1876607,1461642,2024-06-28,Senate,"Senate Floor: Third Reading - Final Passage",40,0,0,0,40
1876607,1467294,2024-09-12,Assembly,"Assembly Public Safety and Preparedness Committee Committee: Reported Favorably",9,0,0,0,9
1876607,1467524,2024-09-23,Assembly,"Assembly Appropriations Committee: Reported with Amendments",11,0,0,0,11
1876607,1467649,2024-09-26,Assembly,"Assembly Floor: Substitute for A2378 (Voice Vote)",0,0,0,0,0
1876607,1467684,2024-09-26,Assembly,"Assembly Floor: Third Reading - Final Passage",76,0,4,0,80
1876607,1467854,2024-09-30,Senate,"Senate Floor: Concur in Assembly Amendments",34,0,6,0,40
1876659,1468912,2024-10-24,Senate,"Senate State Government, Wagering, Tourism & Historic Preservation Committee: Reported with Amendments",4,0,1,0,5
1876659,1477831,2025-01-30,Senate,"Senate Floor: Third Reading - Final Passage",36,0,4,0,40
1876659,1523690,2025-03-20,Assembly,"Assembly Oversight, Reform and Federal Relations Committee: Reported Favorably",6,0,0,0,6
1876659,1525532,2025-03-24,Assembly,"Assembly Floor: Substitute for A4343 (Voice Vote)",0,0,0,0,0
1876659,1525533,2025-03-24,Assembly,"Assembly Floor: Third Reading - Final Passage",63,3,14,0,80
1876665,1459706,2024-06-24,Senate,"Senate Budget and Appropriations Committee: Reported Favorably",12,0,1,0,13
1877359,1470232,2024-12-12,Senate,"Senate Commerce Committee: Reported with Amendments",5,0,0,0,5
1877359,1595941,2025-06-26,Senate,"Senate Budget and Appropriations Committee: Reported Favorably",13,0,0,0,13
1877397,1518910,2025-03-17,Senate,"Senate Education Committee: Reported Favorably",5,0,0,0,5
1877419,1452596,2024-06-03,Senate,"Senate Labor Committee: Reported Favorably",4,0,1,0,5
1877419,1459704,2024-06-24,Senate,"Senate Budget and Appropriations Committee: Reported with Amendments",12,0,1,0,13
1877435,1443896,2024-05-16,Senate,"Senate Judiciary Committee: Reported with Amendments",6,2,3,0,11
1877435,1458966,2024-06-24,Senate,"Senate Budget and Appropriations Committee: Reported with Amendments",9,0,4,0,13
1877435,1460416,2024-06-26,Senate,"Senate Budget and Appropriations Committee: Reported with Amendments",9,0,4,0,13
1877435,1461410,2024-06-28,Assembly,"Assembly Floor: Substitute for A4461 (Voice Vote)",0,0,0,0,0
1877435,1461502,2024-06-28,Assembly,"Assembly Floor: Third Reading - Final Passage",65,6,9,0,80
1877435,1461503,2024-06-28,Senate,"Senate Floor: Third Reading - Final Passage",34,5,1,0,40
1877450,1458802,2024-06-20,Senate,"Senate Environment and Energy Committee: Reported Favorably",5,0,0,0,5
1877457,1518904,2025-03-17,Senate,"Senate Transportation Committee: Reported Favorably",5,0,1,0,6
1877670,1509043,2025-03-10,Assembly,"Assembly Children, Families and Food Security Committee Committee: Reported Favorably",6,0,0,0,6
1877671,1452863,2024-06-03,Assembly,"Assembly Health Committee: Reported with Amendments",6,4,1,0,11
1877671,1523415,2025-03-20,Assembly,"Assembly Appropriations Committee: Reported with Amendments",7,4,0,0,11
1877671,1525080,2025-03-24,Assembly,"Assembly Floor: Reconsidered Vote",55,15,10,0,80
1877671,1525081,2025-03-24,Assembly,"Assembly Floor: Third Reading - Final Passage",51,27,2,0,80
1877837,1458765,2024-06-20,Senate,"Senate Education Committee: Reported with Amendments",3,2,0,0,5
1877860,1454617,2024-06-06,Senate,"Senate Health, Human Services and Senior Citizens Committee: Reported with Amendments",8,0,0,0,8
1877860,1469027,2024-10-28,Senate,"Senate Floor: Third Reading - Final Passage",40,0,0,0,40
1877877,1485149,2025-02-10,Senate,"Senate Higher Eduction Committee: Reported with Amendments",5,0,0,0,5
1877889,1467792,2024-09-30,Senate,"Senate Community and Urban Affairs Committee: Reported with Substitution",4,0,1,0,5
1877948,1569555,2025-05-12,Senate,"Senate Labor Committee: Reported with Amendments",5,0,0,0,5
1877950,1468788,2024-10-21,Senate,"Senate Law and Public Safety Committee: Reported with Amendments",5,0,0,0,5
1877956,1468782,2024-10-21,Senate,"Senate Military and Veterans' Affairs Committee: Reported with Amendments",5,0,0,0,5
1877966,1468578,2024-10-10,Senate,"Senate Economic Growth Committee: Reported with Amendments",5,0,0,0,5
1877984,1458681,2024-06-20,Senate,"Senate Health, Human Services and Senior Citizens Committee: Reported Favorably",8,0,0,0,8
1877999,1455689,2024-06-10,Senate,"Senate Economic Growth Committee: Reported with Amendments",3,1,1,0,5
1877999,1460861,2024-06-26,Senate,"Senate Budget and Appropriations Committee: Reported with Amendments",11,2,0,0,13
1877999,1461636,2024-06-28,Assembly,"Assembly Floor: Substitute for A4448 (Voice Vote)",0,0,0,0,0
1877999,1461637,2024-06-28,Assembly,"Assembly Floor: Third Reading - Final Passage",71,3,6,0,80
1877999,1461638,2024-06-28,Senate,"Senate Floor: Third Reading - Final Passage",34,4,2,0,40
1878006,1467640,2024-09-26,Senate,"Senate Judiciary Committee: Reported with Amendments",11,0,0,0,11
1878022,1507292,2025-03-06,Assembly,"Assembly Consumer Affairs Committee: Reported with Substitution",4,0,2,0,6
1878022,1593135,2025-06-19,Assembly,"Assembly Appropriations Committee: Reported with Amendments",11,0,0,0,11
1878022,1595689,2025-06-26,Assembly,"Assembly Budget Committee: Reported with Amendments",14,0,1,0,15
1878023,1467487,2024-09-19,Assembly,"Assembly Education Committee: Reported with Amendments",6,3,0,0,9
1878034,1452832,2024-06-03,Assembly,"Assembly Higher Education Committee: Reported Favorably",6,0,1,0,7
1878034,1454914,2024-06-06,Assembly,"Assembly State and Local Government Committee: Reported Favorably",7,0,0,0,7
1878034,1467711,2024-09-26,Assembly,"Assembly Floor: Third Reading - Final Passage",75,0,5,0,80
1878050,1473510,2025-01-23,Assembly,"Assembly Labor Committee: Reported Favorably",6,4,1,0,11
1878050,1568232,2025-05-08,Assembly,"Assembly Judiciary Committee: Reported with Amendments",4,2,0,0,6
1878059,1467306,2024-09-12,Assembly,"Assembly Regulated Professions Committee: Reported Favorably",7,0,0,0,7
1878075,1458949,2024-06-24,Assembly,"Assembly Appropriations Committee: Reported with Amendments",11,0,0,0,11
1878075,1461663,2024-06-28,Assembly,"Assembly Floor: Third Reading - Final Passage",76,0,4,0,80
1878107,1457904,2024-06-17,Assembly,"Assembly Health Committee: Reported Favorably",10,0,1,0,11
1878111,1485477,2025-02-10,Assembly,"Assembly Housing and Community Development Committee: Not Reported",7,0,0,0,7
1878828,1454944,2024-06-06,Assembly,"Assembly State and Local Government Committee: Reported Favorably",7,0,0,0,7
1878828,1467691,2024-09-26,Assembly,"Assembly Floor: Third Reading - Final Passage",75,1,4,0,80
1878828,1518791,2025-03-17,Senate,"Senate Community and Urban Affairs Committee: Reported Favorably",4,0,1,0,5
1878850,1468686,2024-10-17,Assembly,"Assembly Health Committee: Reported with Amendments",6,2,3,0,11
1878850,1470413,2024-12-16,Assembly,"Assembly Appropriations Committee: Reported Favorably",7,3,1,0,11
1878850,1470820,2024-12-19,Assembly,"Assembly Floor: Third Reading - Final Passage",47,23,10,0,80
1878855,1468800,2024-10-21,Assembly,"Assembly Transportation and Independent Authorities Committee: Reported Favorably",13,0,0,0,13
1878862,1454646,2024-06-06,Assembly,"Assembly Judiciary Committee: Reported with Amendments",6,0,0,0,6
1878875,1471276,2025-01-13,Senate,"Senate Environment and Energy Committee: Reported with Amendments",4,0,1,0,5
1878875,1595795,2025-06-26,Senate,"Senate Budget and Appropriations Committee: Reported Favorably",13,0,0,0,13
1878875,1596851,2025-06-30,Senate,"Senate Floor: Third Reading - Final Passage",39,0,1,0,40
1878945,1590930,2025-06-16,Assembly,"Assembly Military and Veterans' Affairs Committee: Reported Favorably",5,0,1,0,6
1878972,1454589,2024-06-06,Assembly,"Assembly Labor Committee: Reported Favorably",9,1,1,0,11
1878972,1468951,2024-10-24,Assembly,"Assembly Appropriations Committee: Reported with Amendments",7,0,4,0,11
1878972,1469023,2024-10-28,Assembly,"Assembly Floor: Third Reading - Final Passage",65,8,7,0,80
1878972,1586526,2025-06-09,Senate,"Senate Budget and Appropriations Committee: Reported with Amendments",12,0,1,0,13
1878972,1596444,2025-06-30,Senate,"Senate Floor: Substitute for S3302 (Voice Vote)",0,0,0,0,0
1878972,1596892,2025-06-30,Assembly,"Assembly Floor: Concur in Senate Amendments",66,4,10,0,80
1878972,1596893,2025-06-30,Senate,"Senate Floor: Third Reading - Final Passage",38,1,1,0,40
1879019,1452611,2024-06-03,Senate,"Senate Labor Committee: Reported Favorably",5,0,0,0,5
1879019,1586542,2025-06-09,Senate,"Senate Budget and Appropriations Committee: Reported with Amendments",12,0,1,0,13
1879027,1592975,2025-06-19,Senate,"Senate State Government, Wagering, Tourism & Historic Preservation Committee: Reported with Substitution",5,0,0,0,5
1879027,1596466,2025-06-30,Assembly,"Assembly Floor: Substitute for A4380 (Voice Vote)",0,0,0,0,0
1879027,1596621,2025-06-30,Assembly,"Assembly Floor: Third Reading - Final Passage",80,0,0,0,80
1879027,1596622,2025-06-30,Senate,"Senate Floor: Concur in Assembly Amendments",38,0,2,0,40
1879027,1596623,2025-06-30,Senate,"Senate Floor: Third Reading - Final Passage",39,0,1,0,40
1879036,1455748,2024-06-10,Senate,"Senate Economic Growth Committee: Reported with Amendments",5,0,0,0,5
1879036,1460933,2024-06-26,Senate,"Senate Budget and Appropriations Committee: Reported with Amendments",13,0,0,0,13
1879085,1457384,2024-06-13,Assembly,"Assembly Housing and Community Development Committee: Reported Favorably",7,0,0,0,7
1879085,1461635,2024-06-28,Assembly,"Assembly Floor: Third Reading - Final Passage",77,0,3,0,80
1879085,1477142,2025-01-30,Senate,"Senate Community and Urban Affairs Committee: Reported with Amendments",5,0,0,0,5
1879120,1458840,2024-06-20,Senate,"Senate Environment and Energy Committee: Reported Favorably",5,0,0,0,5
1879120,1469029,2024-10-28,Senate,"Senate Floor: Third Reading - Final Passage",40,0,0,0,40
1879120,1469847,2024-12-09,Assembly,"Assembly Telecommunications and Utilities Committee: Reported with Amendments",8,0,0,0,8
1879120,1470761,2024-12-19,Assembly,"Assembly Floor: Substitute for A4513 (Voice Vote)",0,0,0,0,0
1879120,1470807,2024-12-19,Assembly,"Assembly Floor: Third Reading - Final Passage",68,2,10,0,80
1879120,1470808,2024-12-19,Senate,"Senate Floor: Concur in Assembly Amendments",37,0,3,0,40
1879390,1452576,2024-06-03,Senate,"Senate Labor Committee: Reported Favorably",4,1,0,0,5
1879390,1459708,2024-06-24,Senate,"Senate Budget and Appropriations Committee: Reported Favorably",9,3,1,0,13
1879442,1458961,2024-06-24,Assembly,"Assembly State and Local Government Committee: Reported with Amendments",7,0,0,0,7
1879450,1457909,2024-06-17,Senate,"Senate Community and Urban Affairs Committee: Reported Favorably",4,0,1,0,5
1879452,1460860,2024-06-26,Assembly,"Assembly Budget Committee: Reported with Amendments",13,0,2,0,15
1879478,1507716,2025-03-06,Assembly,"Assembly Commerce and Economic Development Committee: Reported with Amendments",11,0,1,0,12
1879478,1522670,2025-03-20,Assembly,"Assembly State and Local Government Committee: Reported with Amendments",7,0,0,0,7
1879478,1593119,2025-06-19,Assembly,"Assembly Appropriations Committee: Reported with Substitution",10,0,1,0,11
1879478,1595704,2025-06-26,Assembly,"Assembly Budget Committee: Reported with Amendments",15,0,0,0,15
1879478,1596443,2025-06-30,Senate,"Senate Floor: Substitute for S4503 (Voice Vote)",0,0,0,0,0
1879478,1596888,2025-06-30,Assembly,"Assembly Floor: Third Reading - Final Passage",80,0,0,0,80
1879478,1596889,2025-06-30,Senate,"Senate Floor: Third Reading - Final Passage",39,0,1,0,40
1879486,1518567,2025-03-17,Senate,"Senate Community and Urban Affairs Committee: Reported Favorably",4,0,1,0,5
1879489,1468266,2024-10-07,Senate,"Senate Health, Human Services and Senior Citizens Committee: Reported Favorably",8,0,0,0,8
1879489,1595936,2025-06-26,Senate,"Senate Budget and Appropriations Committee: Reported Favorably",13,0,0,0,13
1879498,1477510,2025-01-30,Senate,"Senate Community and Urban Affairs Committee: Reported with Substitution",5,0,0,0,5
1879503,1457194,2024-06-13,Assembly,"Assembly Financial Institutions and Insurance Committee: Reported Favorably",13,0,0,0,13
1879503,1460886,2024-06-26,Assembly,"Assembly Budget Committee: Reported with Amendments",13,0,2,0,15
1879508,1458038,2024-06-17,Senate,"Senate Community and Urban Affairs Committee: Reported Favorably",4,0,1,0,5
1879508,1459487,2024-06-24,Senate,"Senate Budget and Appropriations Committee: Reported with Amendments",12,0,1,0,13
1879508,1461440,2024-06-28,Assembly,"Assembly Floor: Substitute for A4623 (Voice Vote)",0,0,0,0,0
1879508,1461651,2024-06-28,Assembly,"Assembly Floor: Third Reading - Final Passage",72,0,8,0,80
1879508,1461652,2024-06-28,Senate,"Senate Floor: Third Reading - Final Passage",40,0,0,0,40
1879511,1477442,2025-01-30,Senate,"Senate Transportation Committee: Reported with Amendments",6,0,0,0,6
1879515,1489498,2025-02-13,Assembly,"Assembly Human Services Committee: Reported with Amendments",6,0,0,0,6
1879525,1458943,2024-06-24,Assembly,"Assembly Regulated Professions Committee: Reported Favorably",7,0,0,0,7
1879525,1461633,2024-06-28,Assembly,"Assembly Floor: Third Reading - Final Passage",75,0,5,0,80
1879525,1467647,2024-09-26,Senate,"Senate Judiciary Committee: Reported with Amendments",11,0,0,0,11
1879525,1467735,2024-09-30,Senate,"Senate Floor: Substitute for S3242 (Voice Vote)",0,0,0,0,0
1879525,1467942,2024-09-30,Senate,"Senate Floor: Third Reading - Final Passage",34,0,6,0,40
1879525,1469041,2024-10-28,Assembly,"Assembly Floor: Concur in Senate Amendments",77,0,3,0,80
1879528,1457101,2024-06-13,Senate,"Senate Law and Public Safety Committee: Reported Favorably",4,0,1,0,5
1879539,1468629,2024-10-10,Senate,"Senate Economic Growth Committee: Reported Favorably",5,0,0,0,5
1879539,1477832,2025-01-30,Senate,"Senate Floor: Third Reading - Final Passage",34,2,4,0,40
1879539,1495339,2025-02-20,Assembly,"Assembly Labor Committee: Reported Favorably",11,1,0,0,12
1879539,1525738,2025-03-24,Assembly,"Assembly Floor: Substitute for A4501 (Voice Vote)",0,0,0,0,0
1879539,1525739,2025-03-24,Assembly,"Assembly Floor: Third Reading - Final Passage",71,4,5,0,80
1879568,1581040,2025-05-29,Senate,"Senate Law and Public Safety Committee: Reported with Amendments",5,0,0,0,5
1879579,1468212,2024-10-07,Senate,"Senate Health, Human Services and Senior Citizens Committee: Reported with Amendments",8,0,0,0,8
1879586,1454818,2024-06-06,Assembly,"Assembly Transportation and Independent Authorities Committee: Reported Favorably",8,0,5,0,13
1879586,1467308,2024-09-12,Assembly,"Assembly Commerce and Economic Development Committee: Reported Favorably",10,1,1,0,12
1879597,1455728,2024-06-10,Senate,"Senate Commerce Committee: Reported with Amendments",5,0,0,0,5
1879597,1461428,2024-06-28,Assembly,"Assembly Floor: Substitute for A4457 (Voice Vote)",0,0,0,0,0
1879597,1461568,2024-06-28,Assembly,"Assembly Floor: Third Reading - Final Passage",72,0,8,0,80
1879597,1461569,2024-06-28,Senate,"Senate Floor: Third Reading - Final Passage",40,0,0,0,40
1879602,1457123,2024-06-13,Assembly,"Assembly Housing and Community Development Committee: Reported Favorably",7,0,0,0,7
1879602,1461639,2024-06-28,Assembly,"Assembly Floor: Third Reading - Final Passage",75,0,5,0,80
1879602,1461640,2024-06-28,Senate,"Senate Floor: Substitute for S3342 (Voice Vote)",0,0,0,0,0
1879602,1461641,2024-06-28,Senate,"Senate Floor: Third Reading - Final Passage",38,1,1,0,40
1879751,1457908,2024-06-17,Assembly,"Assembly Health Committee: Reported with Amendments",6,2,3,0,11
1879751,1459004,2024-06-24,Assembly,"Assembly Appropriations Committee: Reported with Amendments",8,0,3,0,11
1879751,1460444,2024-06-26,Assembly,"Assembly Budget Committee: Reported with Amendments",12,1,2,0,15
1879792,1470481,2024-12-16,Assembly,"Assembly Commerce and Economic Development Committee: Reported Favorably",10,0,2,0,12
1879793,1457126,2024-06-13,Assembly,"Assembly Housing and Community Development Committee: Not Reported",7,0,0,0,7
1879797,1470217,2024-12-12,Assembly,"Assembly Judiciary Committee: Reported Favorably",6,0,0,0,6
1879797,1470800,2024-12-19,Assembly,"Assembly Floor: Third Reading - Final Passage",73,0,7,0,80
1879805,1457115,2024-06-13,Assembly,"Assembly Housing and Community Development Committee: Reported Favorably",7,0,0,0,7
1879805,1470191,2024-12-12,Assembly,"Assembly Judiciary Committee: Reported Favorably",6,0,0,0,6
1879805,1495497,2025-02-20,Assembly,"Assembly Appropriations Committee: Reported Favorably",10,0,1,0,11
1879805,1502232,2025-02-27,Assembly,"Assembly Floor: Third Reading - Final Passage",74,1,5,0,80
1879805,1569589,2025-05-12,Senate,"Senate Community and Urban Affairs Committee: Reported Favorably",4,0,1,0,5
1879826,1459205,2024-06-24,Assembly,"Assembly State and Local Government Committee: Reported Favorably",7,0,0,0,7
1879826,1467299,2024-09-12,Assembly,"Assembly Financial Institutions and Insurance Committee: Reported Favorably",12,0,1,0,13
1879826,1467671,2024-09-26,Assembly,"Assembly Floor: Third Reading - Final Passage",75,1,4,0,80
1881160,1523419,2025-03-20,Assembly,"Assembly Commerce and Economic Development Committee: Reported Favorably",12,0,0,0,12
1881170,1457915,2024-06-17,Senate,"Senate Community and Urban Affairs Committee: Reported with Amendments",4,0,1,0,5
1881170,1459488,2024-06-24,Senate,"Senate Budget and Appropriations Committee: Reported Favorably",12,0,1,0,13
1881176,1454610,2024-06-06,Assembly,"Assembly Science, Innovation and Technology Committee: Reported Favorably",7,0,0,0,7
1881176,1593010,2025-06-19,Assembly,"Assembly Public Safety and Preparedness Committee Committee: Reported with Amendments",8,0,1,0,9
1881176,1596810,2025-06-30,Assembly,"Assembly Floor: Third Reading - Final Passage",80,0,0,0,80
1881178,1454553,2024-06-06,Assembly,"Assembly Science, Innovation and Technology Committee: Reported Favorably",5,0,2,0,7
1881182,1457933,2024-06-17,Senate,"Senate Community and Urban Affairs Committee: Reported Favorably",4,0,1,0,5
1881182,1461403,2024-06-28,Assembly,"Assembly Floor: Substitute for A4602 (Voice Vote)",0,0,0,0,0
1881182,1461656,2024-06-28,Assembly,"Assembly Floor: Third Reading - Final Passage",62,12,6,0,80
1881182,1461657,2024-06-28,Senate,"Senate Floor: Third Reading - Final Passage",40,0,0,0,40
1881186,1454608,2024-06-06,Assembly,"Assembly Science, Innovation and Technology Committee: Reported Favorably",7,0,0,0,7
1881186,1461623,2024-06-28,Assembly,"Assembly Floor: Third Reading - Final Passage",74,1,5,0,80
1881190,1467769,2024-09-30,Senate,"Senate Transportation Committee: Reported Favorably",6,0,0,0,6
1881197,1470414,2024-12-16,Assembly,"Assembly Health Committee: Reported Favorably",10,0,1,0,11
1881201,1470512,2024-12-16,Assembly,"Assembly Commerce and Economic Development Committee: Reported Favorably",10,0,2,0,12
1881201,1495206,2025-02-20,Assembly,"Assembly Labor Committee: Reported with Amendments",11,1,0,0,12
1881202,1454607,2024-06-06,Assembly,"Assembly Transportation and Independent Authorities Committee: Reported Favorably",11,0,2,0,13
1881202,1458986,2024-06-24,Assembly,"Assembly Appropriations Committee: Reported Favorably",11,0,0,0,11
1881202,1461421,2024-06-28,Senate,"Senate Floor: Substitute for S3367 (Voice Vote)",0,0,0,0,0
1881202,1461538,2024-06-28,Assembly,"Assembly Floor: Third Reading - Final Passage",75,0,5,0,80
1881202,1461539,2024-06-28,Senate,"Senate Floor: Third Reading - Final Passage",40,0,0,0,40
1881205,1485039,2025-02-10,Senate,"Senate Commerce Committee: Reported Favorably",5,0,0,0,5
1881205,1499345,2025-02-25,Senate,"Senate Floor: Third Reading - Final Passage",38,0,2,0,40
1881205,1501801,2025-02-27,Assembly,"Assembly Floor: Substitute for A4391 (Voice Vote)",0,0,0,0,0
1881205,1502364,2025-02-27,Assembly,"Assembly Floor: Third Reading - Final Passage",75,0,5,0,80
1881209,1592858,2025-06-19,Senate,"Senate State Government, Wagering, Tourism & Historic Preservation Committee: Reported Favorably",5,0,0,0,5
1881225,1477396,2025-01-30,Senate,"Senate Community and Urban Affairs Committee: Reported with Amendments",5,0,0,0,5
1881236,1467511,2024-09-23,Assembly,"Assembly Community Development and Womens Affairs Committee Committee: Reported with Amendments",5,0,1,0,6
1881241,1525707,2025-03-24,Assembly,"Assembly Floor: Substitute for AJR181 (Voice Vote)",0,0,0,0,0
1881241,1525708,2025-03-24,Assembly,"Assembly Floor: Third Reading - Final Passage",75,0,5,0,80
1881241,1525709,2025-03-24,Senate,"Senate Floor: Third Reading - Final Passage",39,0,1,0,40
1881246,1452614,2024-06-03,Senate,"Senate Transportation Committee: Reported Favorably",6,0,0,0,6
1881249,1564901,2025-05-05,Assembly,"Assembly Community Development and Womens Affairs Committee Committee: Reported Favorably",4,2,0,0,6
1881256,1469866,2024-12-09,Assembly,"Assembly Telecommunications and Utilities Committee: Reported with Amendments",8,0,0,0,8
1881258,1457921,2024-06-17,Assembly,"Assembly Public Safety and Preparedness Committee Committee: Reported Favorably",9,0,0,0,9
1881258,1461531,2024-06-28,Assembly,"Assembly Floor: Third Reading - Final Passage",77,0,3,0,80
1881259,1457925,2024-06-17,Assembly,"Assembly Public Safety and Preparedness Committee Committee: Reported Favorably",9,0,0,0,9
1881259,1461655,2024-06-28,Assembly,"Assembly Floor: Third Reading - Final Passage",75,0,5,0,80
1881262,1468798,2024-10-21,Assembly,"Assembly Transportation and Independent Authorities Committee: Reported Favorably",13,0,0,0,13
1881270,1468939,2024-10-24,Assembly,"Assembly Commerce and Economic Development Committee: Reported Favorably",9,0,3,0,12
1881270,1470786,2024-12-19,Assembly,"Assembly Floor: Third Reading - Final Passage",72,0,8,0,80
1881273,1477320,2025-01-30,Senate,"Senate Community and Urban Affairs Committee: Reported with Amendments",5,0,0,0,5
1881276,1457923,2024-06-17,Assembly,"Assembly Public Safety and Preparedness Committee Committee: Reported Favorably",9,0,0,0,9
1881276,1461537,2024-06-28,Assembly,"Assembly Floor: Third Reading - Final Passage",75,1,4,0,80
1881287,1457892,2024-06-17,Assembly,"Assembly Public Safety and Preparedness Committee Committee: Reported Favorably",9,0,0,0,9
1881287,1461591,2024-06-28,Assembly,"Assembly Floor: Third Reading - Final Passage",76,1,3,0,80
1881288,1458747,2024-06-20,Senate,"Senate Environment and Energy Committee: Reported with Amendments",5,0,0,0,5
1881288,1461595,2024-06-28,Senate,"Senate Floor: Third Reading - Final Passage",40,0,0,0,40
1881289,1468930,2024-10-24,Assembly,"Assembly Regulated Professions Committee: Reported with Amendments",4,0,3,0,7
1881290,1457924,2024-06-17,Assembly,"Assembly Public Safety and Preparedness Committee Committee: Reported Favorably",9,0,0,0,9
1881290,1461654,2024-06-28,Assembly,"Assembly Floor: Third Reading - Final Passage",77,0,3,0,80
1881299,1457919,2024-06-17,Assembly,"Assembly Public Safety and Preparedness Committee Committee: Reported Favorably",9,0,0,0,9
1881299,1461672,2024-06-28,Assembly,"Assembly Floor: Third Reading - Final Passage",76,1,3,0,80
1881301,1459243,2024-06-24,Assembly,"Assembly State and Local Government Committee: Reported with Amendments",7,0,0,0,7
1881301,1461461,2024-06-28,Senate,"Senate Floor: Second Reading (Voice Vote)",0,0,0,0,0
1881301,1461462,2024-06-28,Senate,"Senate Floor: Substitute for S3439 (Voice Vote)",0,0,0,0,0
1881301,1461703,2024-06-28,Assembly,"Assembly Floor: Concur in Senate Amendments",72,0,8,0,80
1881301,1461704,2024-06-28,Assembly,"Assembly Floor: Third Reading - Final Passage",74,1,5,0,80
1881301,1461705,2024-06-28,Senate,"Senate Floor: Amend",40,0,0,0,40
1881301,1461706,2024-06-28,Senate,"Senate Floor: Third Reading - Final Passage",40,0,0,0,40
1881306,1485158,2025-02-10,Senate,"Senate Environment and Energy Committee: Reported with Substitution",3,2,0,0,5
1881314,1593045,2025-06-19,Assembly,"Assembly Public Safety and Preparedness Committee Committee: Reported Favorably",5,3,1,0,9
1881314,1596880,2025-06-30,Assembly,"Assembly Floor: Third Reading - Final Passage",54,26,0,0,80
1881316,1459245,2024-06-24,Assembly,"Assembly Appropriations Committee: Reported Favorably",9,1,1,0,11
1881316,1459246,2024-06-24,Assembly,"Assembly State and Local Government Committee: Reported Favorably",7,0,0,0,7
1881316,1461626,2024-06-28,Assembly,"Assembly Floor: Third Reading - Final Passage",67,10,3,0,80
1881316,1461627,2024-06-28,Senate,"Senate Floor: Substitute for S3421 (Voice Vote)",0,0,0,0,0
1881316,1461628,2024-06-28,Senate,"Senate Floor: Third Reading - Final Passage",28,12,0,0,40
1881745,1467534,2024-09-23,Assembly,"Assembly Children, Families and Food Security Committee Committee: Reported Favorably",6,0,0,0,6
1881745,1468933,2024-10-24,Assembly,"Assembly Appropriations Committee: Reported Favorably",11,0,0,0,11
1881745,1469050,2024-10-28,Assembly,"Assembly Floor: Third Reading - Final Passage",75,0,5,0,80
1881745,1469853,2024-12-09,Senate,"Senate Health, Human Services and Senior Citizens Committee: Reported with Amendments",8,0,0,0,8
1881745,1518659,2025-03-17,Senate,"Senate Budget and Appropriations Committee: Reported Favorably",13,0,0,0,13
1881745,1583065,2025-06-02,Senate,"Senate Floor: Substitute for S3429 (Voice Vote)",0,0,0,0,0
1881745,1583813,2025-06-02,Senate,"Senate Floor: Third Reading - Final Passage",38,0,2,0,40
1881745,1596900,2025-06-30,Assembly,"Assembly Floor: Concur in Senate Amendments",79,0,1,0,80
1881752,1470422,2024-12-16,Assembly,"Assembly Oversight, Reform and Federal Relations Committee: Reported with Amendments",4,0,2,0,6
1881752,1495807,2025-02-20,Assembly,"Assembly Appropriations Committee: Reported with Amendments",7,3,1,0,11
1881752,1502340,2025-02-27,Assembly,"Assembly Floor: Third Reading - Final Passage",63,10,7,0,80
1881752,1524848,2025-03-24,Senate,"Senate Floor: Substitute for S2952 (Voice Vote)",0,0,0,0,0
1881752,1525451,2025-03-24,Senate,"Senate Floor: Third Reading - Final Passage",33,6,1,0,40
1881752,1576598,2025-05-22,Assembly,"Assembly Floor: Concur Governor Recommendations",70,6,4,0,80
1881752,1583729,2025-06-02,Senate,"Senate Floor: Concur Governor Recommendations",35,3,2,0,40
1881764,1467504,2024-09-23,Assembly,"Assembly Children, Families and Food Security Committee Committee: Reported with Amendments",6,0,0,0,6
1881764,1523329,2025-03-20,Assembly,"Assembly Appropriations Committee: Reported with Amendments",11,0,0,0,11
1881767,1524680,2025-03-24,Senate,"Senate Commerce Committee: Reported Favorably",5,0,0,0,5
1881773,1525255,2025-03-24,Senate,"Senate Commerce Committee: Reported Favorably",5,0,0,0,5
1881776,1458990,2024-06-24,Assembly,"Assembly Appropriations Committee: Reported Favorably",8,3,0,0,11
1881782,1470257,2024-12-12,Senate,"Senate Economic Growth Committee: Reported with Amendments",4,0,1,0,5
1881782,1499803,2025-02-25,Senate,"Senate Floor: Third Reading - Final Passage",36,0,4,0,40
1881782,1501635,2025-02-27,Assembly,"Assembly Floor: Substitute for A4556 (Voice Vote)",0,0,0,0,0
1881782,1502309,2025-02-27,Assembly,"Assembly Floor: Third Reading - Final Passage",75,0,5,0,80
1881782,1583785,2025-06-02,Senate,"Senate Floor: Adopt Governor Recommendations",36,0,4,0,40
1881782,1596898,2025-06-30,Assembly,"Assembly Floor: Concur Governor Recommendations",79,0,1,0,80
1881782,1596899,2025-06-30,Senate,"Senate Floor: Concur Governor Recommendations",38,0,2,0,40
1881801,1458977,2024-06-24,Senate,"Senate Budget and Appropriations Committee: Reported Favorably",10,2,1,0,13
1881801,1461414,2024-06-28,Assembly,"Assembly Floor: Substitute for A4540 (Voice Vote)",0,0,0,0,0
1881801,1461532,2024-06-28,Assembly,"Assembly Floor: Third Reading - Final Passage",64,9,7,0,80
1881801,1461533,2024-06-28,Senate,"Senate Floor: Third Reading - Final Passage",35,5,0,0,40
1881805,1468202,2024-10-07,Senate,"Senate Budget and Appropriations Committee: Reported with Amendments",12,0,1,0,13
1881834,1460887,2024-06-26,Senate,"Senate Budget and Appropriations Committee: Reported Favorably",9,4,0,0,13
1881837,1468768,2024-10-21,Senate,"Senate Military and Veterans' Affairs Committee: Reported Favorably",5,0,0,0,5
1881843,1460828,2024-06-26,Assembly,"Assembly Budget Committee: Reported Favorably",10,2,3,0,15
1881844,1580990,2025-05-29,Senate,"Senate Law and Public Safety Committee: Reported Favorably",5,0,0,0,5
1881844,1583757,2025-06-02,Senate,"Senate Floor: Third Reading - Final Passage",38,0,2,0,40
1881849,1581311,2025-05-29,Senate,"Senate Law and Public Safety Committee: Reported Favorably",5,0,0,0,5
1881849,1583793,2025-06-02,Senate,"Senate Floor: Third Reading - Final Passage",38,0,2,0,40
1881851,1468960,2024-10-24,Assembly,"Assembly Commerce and Economic Development Committee: Reported Favorably",9,0,3,0,12
1881851,1470933,2024-12-19,Assembly,"Assembly Floor: Third Reading - Final Passage",73,0,7,0,80
1881856,1469850,2024-12-09,Senate,"Senate Health, Human Services and Senior Citizens Committee: Reported with Amendments",8,0,0,0,8
1881856,1518788,2025-03-17,Senate,"Senate Budget and Appropriations Committee: Reported Favorably",13,0,0,0,13
1881858,1470499,2024-12-16,Assembly,"Assembly Commerce and Economic Development Committee: Reported with Amendments",10,0,2,0,12
1881858,1489769,2025-02-13,Assembly,"Assembly Tourism, Gaming and the Arts Committee: Reported Favorably",6,0,0,0,6
1881864,1467510,2024-09-23,Assembly,"Assembly Community Development and Womens Affairs Committee Committee: Reported Favorably",5,0,1,0,6
1881866,1455735,2024-06-10,Senate,"Senate Commerce Committee: Reported with Amendments",5,0,0,0,5
1881866,1461718,2024-06-28,Senate,"Senate Floor: Third Reading - Final Passage",36,0,4,0,40
1881870,1460794,2024-06-26,Senate,"Senate Budget and Appropriations Committee: Reported Favorably",13,0,0,0,13
1881870,1461427,2024-06-28,Assembly,"Assembly Floor: Substitute for A4558 (Voice Vote)",0,0,0,0,0
1881870,1461562,2024-06-28,Assembly,"Assembly Floor: Third Reading - Final Passage",60,14,6,0,80
1881870,1461563,2024-06-28,Senate,"Senate Floor: Third Reading - Final Passage",40,0,0,0,40
1881877,1470240,2024-12-12,Assembly,"Assembly State and Local Government Committee: Reported Favorably",7,0,0,0,7
1881877,1576647,2025-05-22,Assembly,"Assembly Floor: Third Reading - Final Passage",67,9,4,0,80
1881914,1470189,2024-12-12,Assembly,"Assembly Education Committee: Reported Favorably",8,0,1,0,9
1881921,1593003,2025-06-19,Assembly,"Assembly Public Safety and Preparedness Committee Committee: Reported with Amendments",7,1,1,0,9
1881937,1460895,2024-06-26,Assembly,"Assembly Budget Committee: Reported Favorably",14,0,1,0,15
1881937,1461431,2024-06-28,Senate,"Senate Floor: Substitute for S3383 (Voice Vote)",0,0,0,0,0
1881937,1461684,2024-06-28,Assembly,"Assembly Floor: Third Reading - Final Passage",74,2,4,0,80
1881937,1461685,2024-06-28,Senate,"Senate Floor: Third Reading - Final Passage",40,0,0,0,40
1881938,1467543,2024-09-23,Assembly,"Assembly Health Committee: Reported Favorably",9,0,2,0,11
1881939,1467520,2024-09-23,Assembly,"Assembly Health Committee: Reported Favorably",8,1,2,0,11
1881942,1467484,2024-09-19,Assembly,"Assembly Science, Innovation and Technology Committee: Reported with Amendments",6,0,1,0,7
1881942,1596703,2025-06-30,Assembly,"Assembly Floor: Third Reading - Final Passage",79,0,1,0,80
1881943,1460925,2024-06-26,Assembly,"Assembly Budget Committee: Reported Favorably",14,0,1,0,15
1881943,1461432,2024-06-28,Senate,"Senate Floor: Substitute for S3471 (Voice Vote)",0,0,0,0,0
1881943,1461686,2024-06-28,Assembly,"Assembly Floor: Third Reading - Final Passage",76,0,4,0,80
1881943,1461687,2024-06-28,Senate,"Senate Floor: Third Reading - Final Passage",40,0,0,0,40
1881944,1460867,2024-06-26,Assembly,"Assembly Budget Committee: Reported Favorably",14,0,1,0,15
1881945,1459428,2024-06-24,Assembly,"Assembly Appropriations Committee: Reported with Amendments",11,0,0,0,11
1881945,1461681,2024-06-28,Assembly,"Assembly Floor: Third Reading - Final Passage",74,1,5,0,80
1881945,1470822,2024-12-19,Assembly,"Assembly Floor: Concur in Senate Amendments",69,0,11,0,80
1881945,1470823,2024-12-19,Senate,"Senate Floor: Amend",38,0,2,0,40
1881945,1470824,2024-12-19,Senate,"Senate Floor: Second Reading (Voice Vote)",0,0,0,0,0
1881945,1470825,2024-12-19,Senate,"Senate Floor: Substitute for S3472 (Voice Vote)",0,0,0,0,0
1881945,1470826,2024-12-19,Senate,"Senate Floor: Third Reading - Final Passage",38,0,2,0,40
1881947,1467485,2024-09-19,Assembly,"Assembly Science, Innovation and Technology Committee: Reported Favorably",6,0,1,0,7
1881948,1458937,2024-06-24,Assembly,"Assembly Appropriations Committee: Reported Favorably",11,0,0,0,11
1881950,1460422,2024-06-26,Assembly,"Assembly Budget Committee: Reported Favorably",13,0,2,0,15
1881951,1467550,2024-09-23,Assembly,"Assembly Community Development and Womens Affairs Committee Committee: Reported Favorably",5,0,1,0,6
1881952,1460891,2024-06-26,Assembly,"Assembly Budget Committee: Reported Favorably",14,0,1,0,15
1881954,1460873,2024-06-26,Assembly,"Assembly Budget Committee: Reported Favorably",13,0,2,0,15
1881954,1461438,2024-06-28,Senate,"Senate Floor: Substitute for S3473 (Voice Vote)",0,0,0,0,0
1881954,1461697,2024-06-28,Assembly,"Assembly Floor: Third Reading - Final Passage",76,1,3,0,80
1881954,1461698,2024-06-28,Senate,"Senate Floor: Third Reading - Final Passage",39,1,0,0,40
1881955,1467519,2024-09-23,Assembly,"Assembly Health Committee: Reported Favorably",7,1,3,0,11
1882036,1469756,2024-12-05,Senate,"Senate Transportation Committee: Reported with Amendments",6,0,0,0,6
1882071,1460921,2024-06-26,Senate,"Senate Budget and Appropriations Committee: Reported with Amendments",13,0,0,0,13
1882074,1478961,2025-02-03,Senate,"Senate Health, Human Services and Senior Citizens Committee: Reported with Amendments",8,0,0,0,8
1882076,1458679,2024-06-20,Senate,"Senate Health, Human Services and Senior Citizens Committee: Reported Favorably",8,0,0,0,8
1882079,1467766,2024-09-30,Senate,"Senate Community and Urban Affairs Committee: Reported with Amendments",5,0,0,0,5
1882418,1467817,2024-09-30,Senate,"Senate Education Committee: Reported with Amendments",5,0,0,0,5
1882418,1524943,2025-03-24,Senate,"Senate Floor: Third Reading - Final Passage",39,0,1,0,40
1882420,1460865,2024-06-26,Assembly,"Assembly Budget Committee: Reported with Amendments",11,0,4,0,15
1882426,1459577,2024-06-24,Assembly,"Assembly Appropriations Committee: Reported Favorably",9,1,1,0,11
1882429,1467522,2024-09-23,Assembly,"Assembly Health Committee: Reported Favorably",9,0,2,0,11
1882439,1473594,2025-01-23,Assembly,"Assembly State and Local Government Committee: Reported with Amendments",6,0,1,0,7
1882441,1543829,2025-04-10,Assembly,"Assembly Regulated Professions Committee: Reported with Amendments",5,0,2,0,7
1882443,1459713,2024-06-24,Senate,"Senate Budget and Appropriations Committee: Reported with Amendments",12,0,1,0,13
1882443,1461433,2024-06-28,Assembly,"Assembly Floor: Substitute for A4597 (Voice Vote)",0,0,0,0,0
1882443,1461688,2024-06-28,Assembly,"Assembly Floor: Third Reading - Final Passage",71,1,8,0,80
1882443,1461689,2024-06-28,Senate,"Senate Floor: Third Reading - Final Passage",40,0,0,0,40
1882443,1467865,2024-09-30,Senate,"Senate Floor: Adopt Governor Recommendations",34,0,6,0,40
1882449,1470146,2024-12-12,Senate,"Senate Economic Growth Committee: Reported with Amendments",4,0,1,0,5
1882451,1518500,2025-03-17,Senate,"Senate Education Committee: Reported with Amendments",5,0,0,0,5
1882452,1469814,2024-12-05,Senate,"Senate Transportation Committee: Reported Favorably",6,0,0,0,6
1882453,1468958,2024-10-24,Senate,"Senate State Government, Wagering, Tourism & Historic Preservation Committee: Reported Favorably",4,0,1,0,5
1882453,1469860,2024-12-09,Senate,"Senate Budget and Appropriations Committee: Reported Favorably",13,0,0,0,13
1882459,1467518,2024-09-23,Assembly,"Assembly Health Committee: Reported Favorably",6,3,2,0,11
1882463,1460875,2024-06-26,Assembly,"Assembly Budget Committee: Reported Favorably",11,0,4,0,15
1882463,1461423,2024-06-28,Senate,"Senate Floor: Substitute for S3451 (Voice Vote)",0,0,0,0,0
1882463,1461669,2024-06-28,Assembly,"Assembly Floor: Third Reading - Final Passage",67,7,6,0,80
1882463,1461670,2024-06-28,Senate,"Senate Floor: Third Reading - Final Passage",40,0,0,0,40
1882469,1459710,2024-06-24,Senate,"Senate Budget and Appropriations Committee: Reported Favorably",12,0,1,0,13
1882471,1507776,2025-03-06,Assembly,"Assembly Consumer Affairs Committee: Reported Favorably",4,0,2,0,6
1882481,1459002,2024-06-24,Senate,"Senate Budget and Appropriations Committee: Reported with Amendments",9,3,1,0,13
1882481,1461547,2024-06-28,Senate,"Senate Floor: Third Reading - Final Passage",23,14,3,0,40
1882484,1467531,2024-09-23,Assembly,"Assembly Community Development and Womens Affairs Committee Committee: Reported with Amendments",5,0,1,0,6
1882484,1564903,2025-05-05,Assembly,"Assembly Community Development and Womens Affairs Committee Committee: Reported with Substitution",4,2,0,0,6
1882487,1468942,2024-10-24,Assembly,"Assembly Commerce and Economic Development Committee: Reported Favorably",9,0,3,0,12
1882487,1470943,2024-12-19,Assembly,"Assembly Floor: Third Reading - Final Passage",73,0,7,0,80
1882487,1589502,2025-06-12,Senate,"Senate Economic Growth Committee: Reported Favorably",5,0,0,0,5
1882487,1596470,2025-06-30,Senate,"Senate Floor: Substitute for S3662 (Voice Vote)",0,0,0,0,0
1882487,1596638,2025-06-30,Senate,"Senate Floor: Third Reading - Final Passage",39,0,1,0,40
1882607,1489338,2025-02-13,Assembly,"Assembly Human Services Committee: Reported with Amendments",6,0,0,0,6
1882614,1468790,2024-10-21,Senate,"Senate Law and Public Safety Committee: Reported with Amendments",3,1,1,0,5
1882618,1568737,2025-05-08,Assembly,"Assembly Human Services Committee: Reported Favorably",4,0,2,0,6
1882624,1470182,2024-12-12,Senate,"Senate Environment and Energy Committee: Reported with Amendments",5,0,0,0,5
1882624,1471437,2025-01-14,Senate,"Senate Floor: Third Reading - Final Passage",35,0,4,0,39
1882624,1474777,2025-01-27,Assembly,"Assembly Environment and Solid Waste Committee: Reported Favorably",6,0,1,0,7
1882624,1477462,2025-01-30,Assembly,"Assembly Floor: Substitute for A4627 (Voice Vote)",0,0,0,0,0
1882624,1477833,2025-01-30,Assembly,"Assembly Floor: Third Reading - Final Passage",75,0,5,0,80
1882634,1473558,2025-01-23,Assembly,"Assembly Labor Committee: Reported with Amendments",10,0,1,0,11
1882634,1568199,2025-05-08,Assembly,"Assembly Transportation and Independent Authorities Committee: Reported Favorably",10,0,3,0,13
1882634,1576632,2025-05-22,Assembly,"Assembly Floor: Third Reading - Final Passage",64,11,5,0,80
1882644,1459048,2024-06-24,Assembly,"Assembly Appropriations Committee: Reported Favorably",10,1,0,0,11
1882644,1461441,2024-06-28,Senate,"Senate Floor: Substitute for S3479 (Voice Vote)",0,0,0,0,0
1882644,1461701,2024-06-28,Assembly,"Assembly Floor: Third Reading - Final Passage",76,1,3,0,80
1882644,1461702,2024-06-28,Senate,"Senate Floor: Third Reading - Final Passage",40,0,0,0,40
1882645,1460929,2024-06-26,Senate,"Senate Budget and Appropriations Committee: Reported Favorably",12,1,0,0,13
1882646,1460934,2024-06-26,Senate,"Senate Budget and Appropriations Committee: Reported Favorably",13,0,0,0,13
1882647,1460916,2024-06-26,Senate,"Senate Budget and Appropriations Committee: Reported Favorably",12,1,0,0,13
1882648,1460930,2024-06-26,Senate,"Senate Budget and Appropriations Committee: Reported Favorably",13,0,0,0,13
1882648,1461437,2024-06-28,Assembly,"Assembly Floor: Substitute for A4570 (Voice Vote)",0,0,0,0,0
1882648,1461690,2024-06-28,Assembly,"Assembly Floor: Third Reading - Final Passage",74,0,6,0,80
1882648,1461691,2024-06-28,Senate,"Senate Floor: Third Reading - Final Passage",40,0,0,0,40
1882650,1460936,2024-06-26,Senate,"Senate Budget and Appropriations Committee: Reported Favorably",13,0,0,0,13
1882650,1461434,2024-06-28,Assembly,"Assembly Floor: Substitute for ACR139 (Voice Vote)",0,0,0,0,0
1882650,1461694,2024-06-28,Assembly,"Assembly Floor: Third Reading - Final Passage",72,0,8,0,80
1882650,1461695,2024-06-28,Senate,"Senate Floor: Third Reading - Final Passage",40,0,0,0,40
1882652,1518423,2025-03-17,Senate,"Senate Community and Urban Affairs Committee: Reported with Amendments",3,1,1,0,5
1882653,1460931,2024-06-26,Senate,"Senate Budget and Appropriations Committee: Reported with Amendments",13,0,0,0,13
1882658,1460941,2024-06-26,Senate,"Senate Budget and Appropriations Committee: Reported Favorably",13,0,0,0,13
1882658,1461436,2024-06-28,Assembly,"Assembly Floor: Substitute for A4426 (Voice Vote)",0,0,0,0,0
1882658,1461692,2024-06-28,Assembly,"Assembly Floor: Third Reading - Final Passage",72,0,8,0,80
1882658,1461693,2024-06-28,Senate,"Senate Floor: Third Reading - Final Passage",40,0,0,0,40
1882659,1460940,2024-06-26,Senate,"Senate Budget and Appropriations Committee: Reported Favorably",13,0,0,0,13
1882967,1581578,2025-05-29,Senate,"Senate Judiciary Committee: Reported with Amendments",11,0,0,0,11
1882967,1595783,2025-06-26,Senate,"Senate Budget and Appropriations Committee: Reported with Amendments",12,0,1,0,13
1882978,1467467,2024-09-19,Assembly,"Assembly Labor Committee: Reported with Amendments",8,1,2,0,11
1882998,1467469,2024-09-19,Assembly,"Assembly Transportation and Independent Authorities Committee: Reported with Amendments",7,5,1,0,13
1882999,1460918,2024-06-26,Assembly,"Assembly Budget Committee: Reported with Amendments",13,0,2,0,15
1883007,1467468,2024-09-19,Assembly,"Assembly Labor Committee: Reported with Amendments",6,3,2,0,11
1883130,1473694,2025-01-23,Assembly,"Assembly Children, Families and Food Security Committee Committee: Reported Favorably",5,0,1,0,6
1883130,1572127,2025-05-15,Assembly,"Assembly Appropriations Committee: Reported Favorably",11,0,0,0,11
1883136,1469893,2024-12-09,Assembly,"Assembly Housing and Community Development Committee: Reported with Amendments",5,2,0,0,7
1883140,1468781,2024-10-21,Assembly,"Assembly Science, Innovation and Technology Committee: Reported with Amendments",7,0,0,0,7
1883148,1474745,2025-01-27,Assembly,"Assembly Consumer Affairs Committee: Reported with Amendments",4,2,0,0,6
1883148,1596864,2025-06-30,Assembly,"Assembly Floor: Third Reading - Final Passage",59,21,0,0,80
1883177,1469831,2024-12-05,Senate,"Senate Education Committee: Reported with Amendments",5,0,0,0,5
1883190,1595762,2025-06-26,Assembly,"Assembly Budget Committee: Reported with Amendments",15,0,0,0,15
1883190,1596696,2025-06-30,Assembly,"Assembly Floor: Third Reading - Final Passage",78,0,2,0,80
1883204,1474936,2025-01-27,Assembly,"Assembly Environment and Solid Waste Committee: Reported with Amendments",6,0,1,0,7
1883207,1467816,2024-09-30,Senate,"Senate Transportation Committee: Reported Favorably",6,0,0,0,6
1883212,1489801,2025-02-13,Senate,"Senate Law and Public Safety Committee: Reported with Amendments",5,0,0,0,5
1883212,1519069,2025-03-17,Senate,"Senate Budget and Appropriations Committee: Reported with Amendments",13,0,0,0,13
1883219,1467530,2024-09-23,Assembly,"Assembly Community Development and Womens Affairs Committee Committee: Reported Favorably",5,0,1,0,6
1883220,1468776,2024-10-21,Senate,"Senate Military and Veterans' Affairs Committee: Reported with Amendments",5,0,0,0,5
1883220,1595948,2025-06-26,Senate,"Senate Budget and Appropriations Committee: Reported Favorably",13,0,0,0,13
1883222,1474785,2025-01-27,Assembly,"Assembly Public Safety and Preparedness Committee Committee: Reported Favorably",9,0,0,0,9
1883222,1495880,2025-02-20,Assembly,"Assembly Appropriations Committee: Reported Favorably",10,0,1,0,11
1883222,1502384,2025-02-27,Assembly,"Assembly Floor: Third Reading - Final Passage",76,0,4,0,80
1883222,1518554,2025-03-17,Senate,"Senate Budget and Appropriations Committee: Reported with Amendments",13,0,0,0,13
1883222,1524816,2025-03-24,Senate,"Senate Floor: Substitute for S3507 (Voice Vote)",0,0,0,0,0
1883222,1525409,2025-03-24,Assembly,"Assembly Floor: Concur in Senate Amendments",75,0,5,0,80
1883222,1525410,2025-03-24,Senate,"Senate Floor: Third Reading - Final Passage",39,0,1,0,40
1883222,1576497,2025-05-22,Assembly,"Assembly Floor: Appeal Ruling of Chair (Voice Vote)",0,0,0,0,0
1883222,1576498,2025-05-22,Assembly,"Assembly Floor: Concur Governor Recommendations",74,1,5,0,80
1883222,1576499,2025-05-22,Assembly,"Assembly Floor: Table Motion",48,28,4,0,80
1883222,1583795,2025-06-02,Senate,"Senate Floor: Concur Governor Recommendations",38,0,2,0,40
1883224,1460809,2024-06-26,Assembly,"Assembly Budget Committee: Reported with Amendments",9,3,3,0,15
1883224,1461549,2024-06-28,Assembly,"Assembly Floor: Third Reading - Final Passage",51,22,7,0,80
1883230,1593039,2025-06-19,Assembly,"Assembly Public Safety and Preparedness Committee Committee: Reported with Amendments",7,0,2,0,9
1883230,1596928,2025-06-30,Assembly,"Assembly Floor: Third Reading - Final Passage",61,15,4,0,80
1883231,1503223,2025-03-03,Senate,"Senate Labor Committee: Reported with Amendments",3,2,0,0,5
1883239,1489207,2025-02-13,Assembly,"Assembly Judiciary Committee: Reported Favorably",5,0,1,0,6
1883239,1495603,2025-02-20,Assembly,"Assembly Appropriations Committee: Reported with Amendments",10,0,1,0,11
1883239,1502235,2025-02-27,Assembly,"Assembly Floor: Third Reading - Final Passage",75,0,5,0,80
1883239,1518557,2025-03-17,Senate,"Senate Budget and Appropriations Committee: Reported with Amendments",13,0,0,0,13
1883240,1489796,2025-02-13,Senate,"Senate Law and Public Safety Committee: Reported Favorably",5,0,0,0,5
1883240,1519345,2025-03-17,Senate,"Senate Budget and Appropriations Committee: Reported with Amendments",13,0,0,0,13
1883281,1468971,2024-10-28,Senate,"Senate Health, Human Services and Senior Citizens Committee: Reported Favorably",5,3,0,0,8
1883281,1469884,2024-12-09,Senate,"Senate Budget and Appropriations Committee: Reported Favorably",9,4,0,0,13
1883290,1468991,2024-10-28,Senate,"Senate Health, Human Services and Senior Citizens Committee: Reported Favorably",5,3,0,0,8
1883296,1467491,2024-09-19,Assembly,"Assembly Science, Innovation and Technology Committee: Reported Favorably",5,1,1,0,7
1883296,1470419,2024-12-16,Assembly,"Assembly Appropriations Committee: Reported with Amendments",7,3,1,0,11
1883296,1470799,2024-12-19,Assembly,"Assembly Floor: Third Reading - Final Passage",46,24,10,0,80
1883309,1468992,2024-10-28,Senate,"Senate Health, Human Services and Senior Citizens Committee: Reported Favorably",5,3,0,0,8
1883309,1469880,2024-12-09,Senate,"Senate Budget and Appropriations Committee: Reported Favorably",9,4,0,0,13
1883313,1468970,2024-10-28,Senate,"Senate Health, Human Services and Senior Citizens Committee: Reported Favorably",7,1,0,0,8
1883319,1460917,2024-06-26,Senate,"Senate Budget and Appropriations Committee: Reported Favorably",13,0,0,0,13
1883319,1461439,2024-06-28,Assembly,"Assembly Floor: Substitute for A4703 (Voice Vote)",0,0,0,0,0
1883319,1461661,2024-06-28,Assembly,"Assembly Floor: Third Reading - Final Passage",49,19,12,0,80
1883319,1461662,2024-06-28,Senate,"Senate Floor: Third Reading - Final Passage",39,0,1,0,40
1883324,1460915,2024-06-26,Senate,"Senate Budget and Appropriations Committee: Reported Favorably",9,4,0,0,13
1883423,1460345,2024-06-26,Senate,"Senate Budget and Appropriations Committee: Reported Favorably",11,2,0,0,13
1883427,1460346,2024-06-26,Senate,"Senate Budget and Appropriations Committee: Reported Favorably",13,0,0,0,13
1883427,1461592,2024-06-28,Assembly,"Assembly Floor: Substitute for A4701 (Voice Vote)",0,0,0,0,0
1883427,1461593,2024-06-28,Assembly,"Assembly Floor: Third Reading - Final Passage",52,22,6,0,80
1883427,1461594,2024-06-28,Senate,"Senate Floor: Third Reading - Final Passage",38,1,1,0,40
1883432,1460796,2024-06-26,Senate,"Senate Budget and Appropriations Committee: Reported Favorably",9,4,0,0,13
1883439,1460349,2024-06-26,Senate,"Senate Budget and Appropriations Committee: Reported Favorably",8,5,0,0,13
1883443,1460945,2024-06-26,Senate,"Senate Budget and Appropriations Committee: Reported Favorably",10,2,1,0,13
1883443,1461574,2024-06-28,Assembly,"Assembly Floor: Substitute for A4709 (Voice Vote)",0,0,0,0,0
1883443,1461575,2024-06-28,Assembly,"Assembly Floor: Third Reading - Final Passage",50,23,7,0,80
1883443,1461576,2024-06-28,Senate,"Senate Floor: Third Reading - Final Passage",29,11,0,0,40
1883447,1460348,2024-06-26,Senate,"Senate Budget and Appropriations Committee: Reported Favorably",9,4,0,0,13
1883459,1460908,2024-06-26,Assembly,"Assembly Budget Committee: Reported Favorably",8,5,2,0,15
1883461,1460909,2024-06-26,Assembly,"Assembly Budget Committee: Reported Favorably",9,5,1,0,15
1883467,1460912,2024-06-26,Assembly,"Assembly Budget Committee: Reported Favorably",12,0,3,0,15
1883467,1461558,2024-06-28,Assembly,"Assembly Floor: Third Reading - Final Passage",72,3,5,0,80
1883467,1468262,2024-10-07,Senate,"Senate Budget and Appropriations Committee: Reported with Amendments",13,0,0,0,13
1883467,1468976,2024-10-28,Assembly,"Assembly Floor: Concur in Senate Amendments",73,1,6,0,80
1883467,1468977,2024-10-28,Senate,"Senate Floor: Substitute for S3693 (Voice Vote)",0,0,0,0,0
1883467,1468978,2024-10-28,Senate,"Senate Floor: Third Reading - Final Passage",40,0,0,0,40
1883468,1460906,2024-06-26,Assembly,"Assembly Budget Committee: Reported Favorably",9,5,1,0,15
1883468,1461542,2024-06-28,Assembly,"Assembly Floor: Third Reading - Final Passage",41,34,5,0,80
1883468,1461543,2024-06-28,Senate,"Senate Floor: Substitute for S3512 (Voice Vote)",0,0,0,0,0
1883468,1461544,2024-06-28,Senate,"Senate Floor: Third Reading - Final Passage",25,15,0,0,40
1883471,1460864,2024-06-26,Assembly,"Assembly Budget Committee: Reported Favorably",9,5,1,0,15
1883471,1461374,2024-06-28,Senate,"Senate Floor: Substitute for S3515 (Voice Vote)",0,0,0,0,0
1883471,1461523,2024-06-28,Assembly,"Assembly Floor: Concur Governor Recommendations",53,20,7,0,80
1883471,1461524,2024-06-28,Assembly,"Assembly Floor: Emergency Resolution Vote",49,21,10,0,80
1883471,1461525,2024-06-28,Assembly,"Assembly Floor: Third Reading - Final Passage",41,34,5,0,80
1883471,1461526,2024-06-28,Senate,"Senate Floor: Concur Governor Recommendations",39,1,0,0,40
1883471,1461527,2024-06-28,Senate,"Senate Floor: Rescind Vote",38,0,2,0,40
1883471,1461528,2024-06-28,Senate,"Senate Floor: Third Reading - Final Passage",26,13,1,0,40
1883471,1461529,2024-06-28,Senate,"Senate Floor: Third Reading - Final Passage",23,16,1,0,40
1883475,1460911,2024-06-26,Assembly,"Assembly Budget Committee: Reported Favorably",8,5,2,0,15
1883475,1461464,2024-06-28,Senate,"Senate Floor: Substitute for S3514 (Voice Vote)",0,0,0,0,0
1883475,1461709,2024-06-28,Assembly,"Assembly Floor: Third Reading - Final Passage",41,34,5,0,80
1883475,1461710,2024-06-28,Senate,"Senate Floor: Third Reading - Final Passage",21,17,2,0,40
1883479,1460913,2024-06-26,Assembly,"Assembly Budget Committee: Reported Favorably",8,5,2,0,15
1883479,1461370,2024-06-28,Senate,"Senate Floor: Substitute for S3513 (Voice Vote)",0,0,0,0,0
1883479,1461484,2024-06-28,Assembly,"Assembly Floor: Table Motion",45,25,10,0,80
1883479,1461485,2024-06-28,Assembly,"Assembly Floor: Third Reading - Final Passage",43,34,3,0,80
1883479,1461486,2024-06-28,Senate,"Senate Floor: Third Reading - Final Passage",22,15,3,0,40
1883480,1460910,2024-06-26,Assembly,"Assembly Budget Committee: Reported Favorably",8,0,7,0,15
1883484,1460914,2024-06-26,Assembly,"Assembly Budget Committee: Reported Favorably",13,0,2,0,15
1883484,1461584,2024-06-28,Assembly,"Assembly Floor: Third Reading - Final Passage",76,0,4,0,80
1883484,1499657,2025-02-25,Senate,"Senate Floor: Substitute for S3516 (Voice Vote)",0,0,0,0,0
1883484,1499658,2025-02-25,Senate,"Senate Floor: Third Reading - Final Passage",28,10,2,0,40
1883494,1460923,2024-06-26,Assembly,"Assembly Budget Committee: Reported Favorably",9,5,1,0,15
1883494,1461380,2024-06-28,Senate,"Senate Floor: Substitute for S2025 (Voice Vote)",0,0,0,0,0
1883494,1461550,2024-06-28,Assembly,"Assembly Floor: Table Motion",41,25,14,0,80
1883494,1461551,2024-06-28,Assembly,"Assembly Floor: Third Reading - Final Passage",55,22,3,0,80
1883494,1461552,2024-06-28,Senate,"Senate Floor: Table Motion",24,15,1,0,40
1883494,1461553,2024-06-28,Senate,"Senate Floor: Third Reading - Final Passage",27,13,0,0,40
1883497,1467753,2024-09-30,Senate,"Senate Community and Urban Affairs Committee: Reported with Amendments",5,0,0,0,5
1883497,1469028,2024-10-28,Senate,"Senate Floor: Third Reading - Final Passage",39,0,1,0,40
1883497,1469855,2024-12-09,Assembly,"Assembly Financial Institutions and Insurance Committee: Reported with Amendments",12,0,1,0,13
1883497,1470767,2024-12-19,Assembly,"Assembly Floor: Substitute for A4893 (Voice Vote)",0,0,0,0,0
1883497,1470828,2024-12-19,Assembly,"Assembly Floor: Third Reading - Final Passage",72,1,7,0,80
1883497,1525400,2025-03-24,Senate,"Senate Floor: Concur in Assembly Amendments",39,0,1,0,40
1883500,1593096,2025-06-19,Senate,"Senate Law and Public Safety Committee: Reported with Amendments",4,0,1,0,5
1883529,1467827,2024-09-30,Senate,"Senate Transportation Committee: Reported with Amendments",6,0,0,0,6
1883535,1460414,2024-06-26,Senate,"Senate Budget and Appropriations Committee: Reported Favorably",9,4,0,0,13
1883542,1461577,2024-06-28,Assembly,"Assembly Floor: Third Reading - Final Passage",54,6,20,0,80
1883543,1461500,2024-06-28,Assembly,"Assembly Floor: Third Reading - Final Passage",57,5,18,0,80
1883740,1468617,2024-10-10,Senate,"Senate Commerce Committee: Reported Favorably",5,0,0,0,5
1883740,1518643,2025-03-17,Senate,"Senate Budget and Appropriations Committee: Reported with Substitution",13,0,0,0,13
1883742,1468720,2024-10-21,Assembly,"Assembly Judiciary Committee: Reported with Amendments",4,0,2,0,6
1883742,1468919,2024-10-24,Assembly,"Assembly Appropriations Committee: Reported with Amendments",11,0,0,0,11
1883742,1469031,2024-10-28,Assembly,"Assembly Floor: Third Reading - Final Passage",77,0,3,0,80
1883742,1478971,2025-02-03,Senate,"Senate Budget and Appropriations Committee: Reported Favorably",12,0,1,0,13
1883742,1498615,2025-02-25,Senate,"Senate Floor: Substitute for S3564 (Voice Vote)",0,0,0,0,0
1883742,1499521,2025-02-25,Senate,"Senate Floor: Third Reading - Final Passage",38,0,2,0,40
1883747,1467532,2024-09-23,Assembly,"Assembly Community Development and Womens Affairs Committee Committee: Reported with Amendments",5,0,1,0,6
1883755,1477424,2025-01-30,Senate,"Senate Transportation Committee: Reported with Amendments",6,0,0,0,6
1883758,1470171,2024-12-12,Senate,"Senate Environment and Energy Committee: Reported with Amendments",3,2,0,0,5
1883760,1509689,2025-03-10,Assembly,"Assembly Environment and Solid Waste Committee: Reported with Amendments",5,2,0,0,7
1883762,1467549,2024-09-23,Assembly,"Assembly Community Development and Womens Affairs Committee Committee: Reported with Amendments",5,0,1,0,6
1883763,1469856,2024-12-09,Senate,"Senate Health, Human Services and Senior Citizens Committee: Reported with Amendments",5,3,0,0,8
1883763,1478977,2025-02-03,Senate,"Senate Budget and Appropriations Committee: Reported Favorably",9,3,1,0,13
1883763,1524782,2025-03-24,Assembly,"Assembly Floor: Substitute for A4362 (Voice Vote)",0,0,0,0,0
1883763,1525395,2025-03-24,Assembly,"Assembly Floor: Third Reading - Final Passage",50,27,3,0,80
1883763,1525396,2025-03-24,Senate,"Senate Floor: Third Reading - Final Passage",24,15,1,0,40
1883764,1467525,2024-09-23,Assembly,"Assembly Community Development and Womens Affairs Committee Committee: Reported Favorably",5,0,1,0,6
1883765,1590989,2025-06-16,Assembly,"Assembly Transportation and Independent Authorities Committee: Reported Favorably",11,0,2,0,13
1883770,1467551,2024-09-23,Assembly,"Assembly Community Development and Womens Affairs Committee Committee: Reported Favorably",5,0,1,0,6
1883781,1468767,2024-10-21,Assembly,"Assembly Children, Families and Food Security Committee Committee: Reported with Amendments",6,0,0,0,6
1883781,1470902,2024-12-19,Assembly,"Assembly Floor: Third Reading - Final Passage",71,1,8,0,80
1883782,1467513,2024-09-23,Assembly,"Assembly Community Development and Womens Affairs Committee Committee: Reported Favorably",5,0,1,0,6
1883783,1470220,2024-12-12,Assembly,"Assembly Military and Veterans' Affairs Committee: Reported with Amendments",6,0,0,0,6
1883783,1593269,2025-06-19,Assembly,"Assembly Appropriations Committee: Reported Favorably",11,0,0,0,11
1883783,1596586,2025-06-30,Senate,"Senate Floor: Substitute for S3504 (Voice Vote)",0,0,0,0,0
1883783,1596957,2025-06-30,Assembly,"Assembly Floor: Third Reading - Final Passage",79,0,1,0,80
1883783,1596958,2025-06-30,Senate,"Senate Floor: Third Reading - Final Passage",39,0,1,0,40
1883784,1467514,2024-09-23,Assembly,"Assembly Community Development and Womens Affairs Committee Committee: Reported Favorably",5,0,1,0,6
1883787,1596744,2025-06-30,Assembly,"Assembly Floor: Table Motion",43,27,10,0,80
1883791,1470441,2024-12-16,Senate,"Senate Judiciary Committee: Reported Favorably",11,0,0,0,11
1883792,1467516,2024-09-23,Assembly,"Assembly Community Development and Womens Affairs Committee Committee: Reported Favorably",5,0,1,0,6
1883792,1565037,2025-05-05,Assembly,"Assembly Community Development and Womens Affairs Committee Committee: Reported with Amendments",4,1,1,0,6
1883794,1573060,2025-05-19,Senate,"Senate Health, Human Services and Senior Citizens Committee: Reported with Substitution",2,0,0,0,2
1883794,1573413,2025-05-19,Senate,"Senate Health, Human Services and Senior Citizens Committee: Reported with Amendments",8,0,0,0,8
1883797,1469795,2024-12-05,Senate,"Senate Education Committee: Reported Favorably",5,0,0,0,5
1883804,1485081,2025-02-10,Senate,"Senate Commerce Committee: Reported Favorably",5,0,0,0,5
1883805,1469873,2024-12-09,Senate,"Senate Health, Human Services and Senior Citizens Committee: Reported Favorably",8,0,0,0,8
1883805,1499475,2025-02-25,Senate,"Senate Floor: Third Reading - Final Passage",38,0,2,0,40
1883809,1489221,2025-02-13,Assembly,"Assembly Transportation and Independent Authorities Committee: Reported Favorably",12,0,1,0,13
1883810,1467539,2024-09-23,Assembly,"Assembly Community Development and Womens Affairs Committee Committee: Reported Favorably",5,0,1,0,6
1883812,1474078,2025-01-23,Assembly,"Assembly Tourism, Gaming and the Arts Committee: Reported with Amendments",6,0,0,0,6
1883812,1477822,2025-01-30,Assembly,"Assembly Floor: Third Reading - Final Passage",70,0,10,0,80
1883831,1485075,2025-02-10,Senate,"Senate Commerce Committee: Reported with Amendments",5,0,0,0,5
1883833,1468949,2024-10-24,Senate,"Senate Judiciary Committee: Reported with Amendments",10,0,1,0,11
1883833,1478982,2025-02-03,Senate,"Senate Budget and Appropriations Committee: Reported Favorably",12,0,1,0,13
1886929,1467303,2024-09-12,Assembly,"Assembly Regulated Professions Committee: Reported Favorably",6,1,0,0,7
1886931,1468715,2024-10-21,Assembly,"Assembly Children, Families and Food Security Committee Committee: Reported Favorably",6,0,0,0,6
1886931,1519118,2025-03-17,Assembly,"Assembly Human Services Committee: Reported Favorably",6,0,0,0,6
1886935,1468959,2024-10-24,Assembly,"Assembly Labor Committee: Reported Favorably",8,2,1,0,11
1886935,1470856,2024-12-19,Assembly,"Assembly Floor: Third Reading - Final Passage",50,23,7,0,80
1886937,1495676,2025-02-20,Senate,"Senate Judiciary Committee: Reported with Amendments",10,0,1,0,11
1886937,1499176,2025-02-25,Senate,"Senate Floor: Third Reading - Final Passage",38,0,2,0,40
1886937,1501604,2025-02-27,Assembly,"Assembly Floor: Substitute for A4755 (Voice Vote)",0,0,0,0,0
1886937,1502258,2025-02-27,Assembly,"Assembly Floor: Third Reading - Final Passage",76,0,4,0,80
1886940,1507413,2025-03-06,Assembly,"Assembly Consumer Affairs Committee: Reported with Amendments",4,0,2,0,6
1886940,1523917,2025-03-20,Assembly,"Assembly Appropriations Committee: Reported with Amendments",11,0,0,0,11
1886940,1576894,2025-05-22,Assembly,"Assembly Floor: Third Reading - Final Passage",78,0,2,0,80
1886941,1470225,2024-12-12,Assembly,"Assembly Tourism, Gaming and the Arts Committee: Reported Favorably",6,0,0,0,6
1886941,1470801,2024-12-19,Assembly,"Assembly Floor: Third Reading - Final Passage",72,0,8,0,80
1886941,1471664,2025-01-14,Senate,"Senate Floor: Substitute for S3456 (Voice Vote)",0,0,0,0,0
1886941,1471665,2025-01-14,Senate,"Senate Floor: Third Reading - Final Passage",35,0,4,0,39
1886946,1468699,2024-10-17,Assembly,"Assembly Oversight, Reform and Federal Relations Committee: Reported Favorably",4,2,0,0,6
1886947,1474746,2025-01-27,Assembly,"Assembly Consumer Affairs Committee: Reported Favorably",6,0,0,0,6
1886948,1478951,2025-02-03,Senate,"Senate Health, Human Services and Senior Citizens Committee: Reported Favorably",8,0,0,0,8
1886948,1519058,2025-03-17,Senate,"Senate Budget and Appropriations Committee: Reported with Amendments",10,3,0,0,13
1886948,1525146,2025-03-24,Senate,"Senate Floor: Third Reading - Final Passage",35,4,1,0,40
1886951,1468735,2024-10-21,Assembly,"Assembly Military and Veterans' Affairs Committee: Reported Favorably",6,0,0,0,6
1886951,1468918,2024-10-24,Assembly,"Assembly Appropriations Committee: Reported Favorably",11,0,0,0,11
1886951,1470833,2024-12-19,Assembly,"Assembly Floor: Third Reading - Final Passage",73,0,7,0,80
1886951,1489397,2025-02-13,Senate,"Senate Law and Public Safety Committee: Reported Favorably",5,0,0,0,5
1886951,1518625,2025-03-17,Senate,"Senate Budget and Appropriations Committee: Reported with Amendments",13,0,0,0,13
1886951,1524611,2025-03-24,Senate,"Senate Floor: Substitute for S3606 (Voice Vote)",0,0,0,0,0
1886951,1525176,2025-03-24,Assembly,"Assembly Floor: Concur in Senate Amendments",76,0,4,0,80
1886951,1525177,2025-03-24,Senate,"Senate Floor: Third Reading - Final Passage",39,0,1,0,40
1886954,1568322,2025-05-08,Assembly,"Assembly Education Committee: Reported with Amendments",9,0,0,0,9
1886954,1576344,2025-05-22,Assembly,"Assembly Floor: Third Reading - Final Passage",78,0,2,0,80
1886956,1473941,2025-01-23,Assembly,"Assembly Tourism, Gaming and the Arts Committee: Reported Favorably",4,0,2,0,6
1886959,1593022,2025-06-19,Senate,"Senate Military and Veterans' Affairs Committee: Reported Favorably",5,0,0,0,5
1886961,1489222,2025-02-13,Senate,"Senate Law and Public Safety Committee: Reported Favorably",5,0,0,0,5
1886961,1518898,2025-03-17,Senate,"Senate Budget and Appropriations Committee: Reported Favorably",13,0,0,0,13
1886961,1583826,2025-06-02,Senate,"Senate Floor: Third Reading - Final Passage",38,0,2,0,40
1886965,1468275,2024-10-07,Senate,"Senate Budget and Appropriations Committee: Reported with Amendments",13,0,0,0,13
1886965,1468968,2024-10-28,Assembly,"Assembly Floor: Substitute for A4866 (Voice Vote)",0,0,0,0,0
1886965,1469047,2024-10-28,Assembly,"Assembly Floor: Third Reading - Final Passage",75,0,5,0,80
1886965,1469048,2024-10-28,Senate,"Senate Floor: Concur in Assembly Amendments",39,0,1,0,40
1886965,1469049,2024-10-28,Senate,"Senate Floor: Third Reading - Final Passage",40,0,0,0,40
1886971,1467862,2024-09-30,Senate,"Senate Floor: Amend",34,0,6,0,40
1886971,1467863,2024-09-30,Senate,"Senate Floor: Second Reading (Voice Vote)",0,0,0,0,0
1886972,1469864,2024-12-09,Senate,"Senate Budget and Appropriations Committee: Reported with Amendments",13,0,0,0,13
1886973,1470404,2024-12-16,Senate,"Senate Military and Veterans' Affairs Committee: Reported Favorably",4,0,1,0,5
1886978,1498913,2025-02-25,Senate,"Senate State Government, Wagering, Tourism & Historic Preservation Committee: Reported Favorably",5,0,0,0,5
1886985,1489447,2025-02-13,Senate,"Senate Law and Public Safety Committee: Reported Favorably",5,0,0,0,5
1886985,1518414,2025-03-17,Senate,"Senate Budget and Appropriations Committee: Reported with Amendments",13,0,0,0,13
1886989,1509067,2025-03-10,Assembly,"Assembly Children, Families and Food Security Committee Committee: Reported Favorably",5,0,1,0,6
1886989,1576635,2025-05-22,Assembly,"Assembly Floor: Third Reading - Final Passage",71,2,7,0,80
1886990,1470287,2024-12-12,Assembly,"Assembly Transportation and Independent Authorities Committee: Reported Favorably",13,0,0,0,13
1886990,1470916,2024-12-19,Assembly,"Assembly Floor: Third Reading - Final Passage",73,0,7,0,80
1886990,1518653,2025-03-17,Senate,"Senate Transportation Committee: Reported with Amendments",5,0,1,0,6
1886990,1596078,2025-06-30,Senate,"Senate Floor: Substitute for S4146 (Voice Vote)",0,0,0,0,0
1886990,1596967,2025-06-30,Assembly,"Assembly Floor: Concur in Senate Amendments",80,0,0,0,80
1886990,1596968,2025-06-30,Senate,"Senate Floor: Third Reading - Final Passage",39,0,1,0,40
1886999,1469310,2024-11-14,Assembly,"Assembly Public Safety and Preparedness Committee Committee: Reported Favorably",8,0,1,0,9
1886999,1488770,2025-02-13,Assembly,"Assembly Judiciary Committee: Reported with Amendments",5,0,1,0,6
1886999,1495698,2025-02-20,Assembly,"Assembly Appropriations Committee: Reported with Amendments",10,0,1,0,11
1887001,1568302,2025-05-08,Assembly,"Assembly Education Committee: Reported Favorably",9,0,0,0,9
1887001,1576337,2025-05-22,Assembly,"Assembly Floor: Third Reading - Final Passage",78,0,2,0,80
1887011,1589688,2025-06-12,Assembly,"Assembly Higher Education Committee: Reported with Amendments",7,0,0,0,7
1887018,1585845,2025-06-05,Senate,"Senate Community and Urban Affairs Committee: Reported with Amendments",4,0,1,0,5
1887021,1469869,2024-12-09,Assembly,"Assembly Telecommunications and Utilities Committee: Reported with Amendments",6,2,0,0,8
1887025,1589873,2025-06-12,Assembly,"Assembly Commerce and Economic Development Committee: Reported with Amendments",10,0,2,0,12
1887026,1468955,2024-10-24,Assembly,"Assembly Labor Committee: Reported with Amendments",9,1,1,0,11
1887034,1470173,2024-12-12,Senate,"Senate Commerce Committee: Reported with Amendments",5,0,0,0,5
1887034,1479311,2025-02-03,Senate,"Senate Budget and Appropriations Committee: Reported Favorably",12,0,1,0,13
1887035,1573211,2025-05-19,Senate,"Senate Health, Human Services and Senior Citizens Committee: Reported Favorably",8,0,0,0,8
1887038,1470430,2024-12-16,Senate,"Senate State Government, Wagering, Tourism & Historic Preservation Committee: Reported with Amendments",4,0,1,0,5
1887040,1468201,2024-10-07,Senate,"Senate Health, Human Services and Senior Citizens Committee: Reported with Amendments",8,0,0,0,8
1887040,1469020,2024-10-28,Assembly,"Assembly Floor: Substitute for A4970 (Voice Vote)",0,0,0,0,0
1887040,1469021,2024-10-28,Assembly,"Assembly Floor: Third Reading - Final Passage",75,0,5,0,80
1887040,1469022,2024-10-28,Senate,"Senate Floor: Third Reading - Final Passage",40,0,0,0,40
1887044,1503675,2025-03-03,Senate,"Senate Health, Human Services and Senior Citizens Committee: Reported with Amendments",8,0,0,0,8
1887050,1468579,2024-10-10,Senate,"Senate Economic Growth Committee: Reported with Amendments",5,0,0,0,5
1887050,1469061,2024-10-28,Senate,"Senate Floor: Third Reading - Final Passage",27,13,0,0,40
1887050,1469867,2024-12-09,Assembly,"Assembly Telecommunications and Utilities Committee: Reported with Amendments",7,1,0,0,8
1887050,1501879,2025-02-27,Assembly,"Assembly Floor: Substitute for A4817 (Voice Vote)",0,0,0,0,0
1887050,1502269,2025-02-27,Assembly,"Assembly Floor: Third Reading - Final Passage",60,16,4,0,80
1887050,1525226,2025-03-24,Senate,"Senate Floor: Concur in Assembly Amendments",25,13,2,0,40
1887057,1469324,2024-11-14,Assembly,"Assembly Tourism, Gaming and the Arts Committee: Reported Favorably",5,0,1,0,6
1887057,1591020,2025-06-16,Assembly,"Assembly State and Local Government Committee: Reported Favorably",6,0,1,0,7
1887057,1596690,2025-06-30,Assembly,"Assembly Floor: Third Reading - Final Passage",78,1,1,0,80
1887061,1470237,2024-12-12,Assembly,"Assembly Transportation and Independent Authorities Committee: Reported with Amendments",13,0,0,0,13
1887061,1470836,2024-12-19,Assembly,"Assembly Floor: Third Reading - Final Passage",72,1,7,0,80
1887061,1569414,2025-05-12,Senate,"Senate Transportation Committee: Reported Favorably",6,0,0,0,6
1887063,1469863,2024-12-09,Assembly,"Assembly Telecommunications and Utilities Committee: Reported with Amendments",7,1,0,0,8
1887073,1467527,2024-09-23,Assembly,"Assembly Appropriations Committee: Reported Favorably",11,0,0,0,11
1887073,1467528,2024-09-23,Assembly,"Assembly Higher Education Committee: Reported with Amendments",6,0,1,0,7
1887073,1467689,2024-09-26,Assembly,"Assembly Floor: Third Reading - Final Passage",76,0,4,0,80
1887073,1467828,2024-09-30,Senate,"Senate Floor: Substitute for S3602 (Voice Vote)",0,0,0,0,0
1887073,1467851,2024-09-30,Senate,"Senate Floor: Third Reading - Final Passage",34,0,6,0,40
1887079,1489302,2025-02-13,Assembly,"Assembly Tourism, Gaming and the Arts Committee: Reported with Amendments",4,2,0,0,6
1887085,1468685,2024-10-17,Assembly,"Assembly Health Committee: Reported Favorably",10,0,1,0,11
1887085,1489483,2025-02-13,Assembly,"Assembly Human Services Committee: Reported Favorably",6,0,0,0,6
1887092,1468632,2024-10-10,Senate,"Senate Environment and Energy Committee: Reported with Amendments",5,0,0,0,5
1887092,1469044,2024-10-28,Senate,"Senate Floor: Third Reading - Final Passage",40,0,0,0,40
1887092,1509035,2025-03-10,Assembly,"Assembly Transportation and Independent Authorities Committee: Reported with Amendments",10,1,2,0,13
1887092,1589924,2025-06-12,Assembly,"Assembly Commerce and Economic Development Committee: Reported with Amendments",10,0,2,0,12
1887092,1596471,2025-06-30,Assembly,"Assembly Floor: Substitute for A4926 (Voice Vote)",0,0,0,0,0
1887092,1596632,2025-06-30,Assembly,"Assembly Floor: Third Reading - Final Passage",79,0,1,0,80
1887092,1596633,2025-06-30,Senate,"Senate Floor: Concur in Assembly Amendments",39,0,1,0,40
1887098,1468698,2024-10-17,Assembly,"Assembly Oversight, Reform and Federal Relations Committee: Reported Favorably",6,0,0,0,6
1887098,1470874,2024-12-19,Assembly,"Assembly Floor: Third Reading - Final Passage",72,0,8,0,80
1887104,1489056,2025-02-13,Assembly,"Assembly Judiciary Committee: Reported Favorably",5,0,1,0,6
1887104,1502406,2025-02-27,Assembly,"Assembly Floor: Third Reading - Final Passage",75,0,5,0,80
1887106,1468714,2024-10-21,Senate,"Senate Military and Veterans' Affairs Committee: Reported Favorably",5,0,0,0,5
1887527,1467793,2024-09-30,Senate,"Senate Community and Urban Affairs Committee: Reported with Substitution",4,0,1,0,5
1887528,1544373,2025-04-10,Assembly,"Assembly Financial Institutions and Insurance Committee: Reported with Amendments",9,1,3,0,13
1887533,1468691,2024-10-17,Assembly,"Assembly Community Development and Womens Affairs Committee Committee: Reported Favorably",6,0,0,0,6
1887533,1469886,2024-12-09,Assembly,"Assembly Financial Institutions and Insurance Committee: Reported with Amendments",12,0,1,0,13
1887533,1470821,2024-12-19,Assembly,"Assembly Floor: Third Reading - Final Passage",72,0,8,0,80
1887533,1503666,2025-03-03,Senate,"Senate Health, Human Services and Senior Citizens Committee: Reported with Amendments",8,0,0,0,8
1887538,1468780,2024-10-21,Assembly,"Assembly Science, Innovation and Technology Committee: Reported with Amendments",7,0,0,0,7
1887538,1477823,2025-01-30,Assembly,"Assembly Floor: Third Reading - Final Passage",74,0,6,0,80
1887542,1564930,2025-05-05,Assembly,"Assembly Telecommunications and Utilities Committee: Reported with Amendments",4,3,1,0,8
1887565,1468931,2024-10-24,Assembly,"Assembly Labor Committee: Reported Favorably",6,4,1,0,11
1887565,1477815,2025-01-30,Assembly,"Assembly Floor: Third Reading - Final Passage",42,25,13,0,80
1887573,1589515,2025-06-12,Senate,"Senate Economic Growth Committee: Reported Favorably",5,0,0,0,5
1887586,1471901,2025-01-16,Assembly,"Assembly Community Development and Womens Affairs Committee Committee: Reported Favorably",6,0,0,0,6
1887586,1568212,2025-05-08,Assembly,"Assembly Judiciary Committee: Reported Favorably",6,0,0,0,6
1887586,1576350,2025-05-22,Assembly,"Assembly Floor: Third Reading - Final Passage",77,0,3,0,80
1887589,1470401,2024-12-16,Assembly,"Assembly Health Committee: Reported Favorably",10,0,1,0,11
1887597,1468254,2024-10-07,Senate,"Senate Health, Human Services and Senior Citizens Committee: Reported Favorably",5,3,0,0,8
1887597,1468988,2024-10-28,Senate,"Senate Floor: Third Reading - Final Passage",25,14,1,0,40
1887597,1523343,2025-03-20,Assembly,"Assembly Community Development and Womens Affairs Committee Committee: Reported Favorably",4,2,0,0,6
1887597,1596445,2025-06-30,Assembly,"Assembly Floor: Substitute for A4915 (Voice Vote)",0,0,0,0,0
1887597,1596688,2025-06-30,Assembly,"Assembly Floor: Third Reading - Final Passage",54,25,1,0,80
1887600,1468726,2024-10-21,Assembly,"Assembly Education Committee: Reported Favorably",9,0,0,0,9
1887600,1543342,2025-04-10,Assembly,"Assembly State and Local Government Committee: Reported with Amendments",7,0,0,0,7
1887600,1572118,2025-05-15,Assembly,"Assembly Appropriations Committee: Reported with Amendments",11,0,0,0,11
1887600,1576304,2025-05-22,Assembly,"Assembly Floor: Third Reading - Final Passage",78,0,2,0,80
1887600,1585458,2025-06-05,Senate,"Senate Education Committee: Reported with Amendments",5,0,0,0,5
1887602,1468694,2024-10-17,Assembly,"Assembly Oversight, Reform and Federal Relations Committee: Reported with Amendments",6,0,0,0,6
1887602,1468925,2024-10-24,Assembly,"Assembly Appropriations Committee: Reported with Amendments",11,0,0,0,11
1887604,1468642,2024-10-10,Senate,"Senate Higher Eduction Committee: Reported Favorably",3,2,0,0,5
1887605,1498707,2025-02-25,Senate,"Senate State Government, Wagering, Tourism & Historic Preservation Committee: Reported with Amendments",5,0,0,0,5
1887762,1467707,2024-09-26,Assembly,"Assembly Floor: Third Reading - Final Passage",65,4,11,0,80
1887784,1495823,2025-02-20,Assembly,"Assembly State and Local Government Committee: Reported Favorably",7,0,0,0,7
1887784,1525005,2025-03-24,Assembly,"Assembly Floor: Third Reading - Final Passage",75,2,3,0,80
1887784,1585440,2025-06-05,Senate,"Senate Community and Urban Affairs Committee: Reported Favorably",4,0,1,0,5
1887791,1468929,2024-10-24,Assembly,"Assembly Housing and Community Development Committee: Reported with Amendments",4,2,1,0,7
1887793,1468922,2024-10-24,Assembly,"Assembly Appropriations Committee: Reported Favorably",11,0,0,0,11
1887793,1468923,2024-10-24,Assembly,"Assembly Housing and Community Development Committee: Reported with Amendments",6,0,1,0,7
1887957,1485770,2025-02-10,Senate,"Senate Commerce Committee: Reported with Amendments",5,0,0,0,5
1887958,1497080,2025-02-10,Assembly,"Assembly Housing and Community Development Committee: Reported Favorably",7,0,0,0,7
1887958,1572515,2025-05-15,Assembly,"Assembly Appropriations Committee: Reported with Amendments",10,1,0,0,11
1887958,1576648,2025-05-22,Assembly,"Assembly Floor: Third Reading - Final Passage",50,27,3,0,80
1887968,1469294,2024-11-14,Assembly,"Assembly Tourism, Gaming and the Arts Committee: Reported Favorably",5,0,1,0,6
1887970,1469846,2024-12-09,Assembly,"Assembly Higher Education Committee: Reported with Amendments",7,0,0,0,7
1887988,1469871,2024-12-09,Assembly,"Assembly Higher Education Committee: Reported with Amendments",7,0,0,0,7
1887988,1470857,2024-12-19,Assembly,"Assembly Floor: Third Reading - Final Passage",72,0,8,0,80
1887988,1595914,2025-06-26,Senate,"Senate Budget and Appropriations Committee: Reported Favorably",13,0,0,0,13
1887988,1596442,2025-06-30,Senate,"Senate Floor: Substitute for S3769 (Voice Vote)",0,0,0,0,0
1887988,1596679,2025-06-30,Senate,"Senate Floor: Third Reading - Final Passage",39,0,1,0,40
1887995,1474991,2025-01-27,Assembly,"Assembly Environment and Solid Waste Committee: Reported with Amendments",5,0,2,0,7
1887998,1469353,2024-11-14,Assembly,"Assembly Regulated Professions Committee: Reported Favorably",6,1,0,0,7
1888001,1473756,2025-01-23,Assembly,"Assembly Military and Veterans' Affairs Committee: Reported Favorably",6,0,0,0,6
1888001,1590023,2025-06-12,Assembly,"Assembly Higher Education Committee: Reported Favorably",7,0,0,0,7
1888021,1469849,2024-12-09,Assembly,"Assembly Financial Institutions and Insurance Committee: Reported with Amendments",12,0,1,0,13
1888036,1467770,2024-09-30,Senate,"Senate Community and Urban Affairs Committee: Reported Favorably",5,0,0,0,5
1888036,1468216,2024-10-07,Senate,"Senate Budget and Appropriations Committee: Reported with Amendments",13,0,0,0,13
1888036,1468982,2024-10-28,Assembly,"Assembly Floor: Substitute for A4871 (Voice Vote)",0,0,0,0,0
1888036,1468983,2024-10-28,Assembly,"Assembly Floor: Third Reading - Final Passage",75,0,5,0,80
1888036,1468984,2024-10-28,Senate,"Senate Floor: Third Reading - Final Passage",40,0,0,0,40
1888039,1468290,2024-10-07,Senate,"Senate Budget and Appropriations Committee: Reported with Amendments",13,0,0,0,13
1888071,1468953,2024-10-24,Assembly,"Assembly Housing and Community Development Committee: Reported with Amendments",4,1,2,0,7
1888071,1576469,2025-05-22,Assembly,"Assembly Floor: Third Reading - Final Passage",49,27,4,0,80
1888073,1474120,2025-01-23,Assembly,"Assembly Science, Innovation and Technology Committee: Reported with Amendments",6,1,0,0,7
1888085,1469764,2024-12-05,Senate,"Senate Community and Urban Affairs Committee: Reported with Amendments",4,0,1,0,5
1888090,1469763,2024-12-05,Senate,"Senate Transportation Committee: Reported with Amendments",6,0,0,0,6
1888097,1509208,2025-03-10,Assembly,"Assembly Education Committee: Reported with Amendments",7,0,2,0,9
1888107,1495775,2025-02-20,Assembly,"Assembly Appropriations Committee: Reported with Amendments",10,0,1,0,11
1888113,1468750,2024-10-21,Assembly,"Assembly Military and Veterans' Affairs Committee: Reported Favorably",6,0,0,0,6
1888113,1469055,2024-10-28,Assembly,"Assembly Floor: Third Reading - Final Passage",70,3,7,0,80
1888125,1593005,2025-06-19,Senate,"Senate Law and Public Safety Committee: Reported with Amendments",3,1,1,0,5
1888136,1468633,2024-10-10,Senate,"Senate Higher Eduction Committee: Reported with Amendments",5,0,0,0,5
1888215,1469789,2024-12-05,Senate,"Senate Education Committee: Reported with Amendments",5,0,0,0,5
1888215,1471426,2025-01-14,Senate,"Senate Floor: Third Reading - Final Passage",35,0,4,0,39
1888215,1509210,2025-03-10,Assembly,"Assembly Education Committee: Reported with Amendments",7,0,2,0,9
1888271,1523027,2025-03-20,Assembly,"Assembly Community Development and Womens Affairs Committee Committee: Reported Favorably",4,2,0,0,6
1888522,1468639,2024-10-10,Senate,"Senate Higher Eduction Committee: Reported Favorably",5,0,0,0,5
1888532,1469772,2024-12-05,Senate,"Senate Community and Urban Affairs Committee: Reported Favorably",4,0,1,0,5
1888534,1495644,2025-02-20,Senate,"Senate Judiciary Committee: Reported with Amendments",8,2,1,0,11
1888534,1499115,2025-02-25,Senate,"Senate Floor: Third Reading - Final Passage",33,2,5,0,40
1888534,1501536,2025-02-27,Assembly,"Assembly Floor: Substitute for A4904 (Voice Vote)",0,0,0,0,0
1888534,1502233,2025-02-27,Assembly,"Assembly Floor: Third Reading - Final Passage",64,8,8,0,80
1888540,1485642,2025-02-10,Senate,"Senate Environment and Energy Committee: Reported with Amendments",5,0,0,0,5
1888540,1595954,2025-06-26,Senate,"Senate Budget and Appropriations Committee: Reported Favorably",13,0,0,0,13
1888540,1596640,2025-06-30,Assembly,"Assembly Floor: Substitute for A5153 (Voice Vote)",0,0,0,0,0
1888540,1596641,2025-06-30,Assembly,"Assembly Floor: Third Reading - Final Passage",72,6,2,0,80
1888540,1596642,2025-06-30,Senate,"Senate Floor: Third Reading - Final Passage",39,0,1,0,40
1888546,1569613,2025-05-12,Senate,"Senate Community and Urban Affairs Committee: Reported with Amendments",3,0,2,0,5
1888569,1468630,2024-10-10,Senate,"Senate Higher Eduction Committee: Reported with Amendments",5,0,0,0,5
1888584,1470426,2024-12-16,Senate,"Senate State Government, Wagering, Tourism & Historic Preservation Committee: Reported Favorably",4,0,1,0,5
1888584,1595782,2025-06-26,Senate,"Senate Budget and Appropriations Committee: Reported Favorably",11,2,0,0,13
1888596,1471316,2025-01-13,Senate,"Senate Environment and Energy Committee: Reported with Amendments",4,0,1,0,5
1888607,1470243,2024-12-12,Senate,"Senate Economic Growth Committee: Reported with Amendments",4,0,1,0,5
1888607,1471432,2025-01-14,Senate,"Senate Floor: Third Reading - Final Passage",34,0,5,0,39
1888644,1573270,2025-05-19,Senate,"Senate Health, Human Services and Senior Citizens Committee: Reported with Amendments",8,0,0,0,8
1888648,1479129,2025-02-03,Senate,"Senate Health, Human Services and Senior Citizens Committee: Reported Favorably",8,0,0,0,8
1888651,1485423,2025-02-10,Senate,"Senate Higher Eduction Committee: Reported with Amendments",5,0,0,0,5
1888655,1470780,2024-12-19,Senate,"Senate Health, Human Services and Senior Citizens Committee: Reported Favorably",6,2,0,0,8
1888656,1581064,2025-05-29,Senate,"Senate State Government, Wagering, Tourism & Historic Preservation Committee: Reported Favorably",5,0,0,0,5
1888660,1470812,2024-12-19,Senate,"Senate Health, Human Services and Senior Citizens Committee: Reported with Amendments",6,2,0,0,8
1888661,1470810,2024-12-19,Senate,"Senate Health, Human Services and Senior Citizens Committee: Reported with Amendments",8,0,0,0,8
1888661,1595942,2025-06-26,Senate,"Senate Budget and Appropriations Committee: Reported Favorably",13,0,0,0,13
1888665,1595809,2025-06-26,Senate,"Senate Budget and Appropriations Committee: Reported with Amendments",13,0,0,0,13
1888666,1586838,2025-06-09,Senate,"Senate Health, Human Services and Senior Citizens Committee: Reported with Amendments",7,0,1,0,8
1888667,1470778,2024-12-19,Senate,"Senate Health, Human Services and Senior Citizens Committee: Reported with Amendments",8,0,0,0,8
1888837,1469810,2024-12-05,Senate,"Senate Labor Committee: Reported Favorably",4,0,1,0,5
1888844,1569685,2025-05-12,Senate,"Senate Education Committee: Reported with Amendments",5,0,0,0,5
1888844,1583697,2025-06-02,Senate,"Senate Floor: Third Reading - Final Passage",38,0,2,0,40
1888844,1591081,2025-06-16,Assembly,"Assembly Education Committee: Reported with Amendments",9,0,0,0,9
1888844,1596736,2025-06-30,Assembly,"Assembly Floor: Substitute for A5779 (Voice Vote)",0,0,0,0,0
1888844,1596737,2025-06-30,Assembly,"Assembly Floor: Third Reading - Final Passage",80,0,0,0,80
1888844,1596738,2025-06-30,Senate,"Senate Floor: Concur in Assembly Amendments",39,0,1,0,40
1888845,1469793,2024-12-05,Senate,"Senate Labor Committee: Reported Favorably",4,0,1,0,5
1888845,1499726,2025-02-25,Senate,"Senate Floor: Third Reading - Final Passage",38,0,2,0,40
1888845,1591061,2025-06-16,Assembly,"Assembly Labor Committee: Reported Favorably",10,2,0,0,12
1888845,1596890,2025-06-30,Assembly,"Assembly Floor: Substitute for A5506 (Voice Vote)",0,0,0,0,0
1888845,1596891,2025-06-30,Assembly,"Assembly Floor: Third Reading - Final Passage",66,12,2,0,80
1888880,1469794,2024-12-05,Senate,"Senate Community and Urban Affairs Committee: Reported with Amendments",4,0,1,0,5
1888880,1478062,2025-01-30,Senate,"Senate Floor: Third Reading - Final Passage",37,0,3,0,40
1888880,1571964,2025-05-15,Assembly,"Assembly State and Local Government Committee: Reported with Amendments",7,0,0,0,7
1888880,1576241,2025-05-22,Assembly,"Assembly Floor: Substitute for A5613 (Voice Vote)",0,0,0,0,0
1888880,1576242,2025-05-22,Assembly,"Assembly Floor: Third Reading - Final Passage",78,0,2,0,80
1888880,1583840,2025-06-02,Senate,"Senate Floor: Concur in Assembly Amendments",38,0,2,0,40
1888882,1469872,2024-12-09,Senate,"Senate Health, Human Services and Senior Citizens Committee: Reported Favorably",8,0,0,0,8
1888882,1499587,2025-02-25,Senate,"Senate Floor: Third Reading - Final Passage",38,0,2,0,40
1888882,1507216,2025-03-06,Assembly,"Assembly Health Committee: Reported Favorably",11,0,0,0,11
1888882,1524711,2025-03-24,Assembly,"Assembly Floor: Substitute for AJR202 (Voice Vote)",0,0,0,0,0
1888882,1525651,2025-03-24,Assembly,"Assembly Floor: Third Reading - Final Passage",76,0,4,0,80
1888973,1470400,2024-12-16,Senate,"Senate Military and Veterans' Affairs Committee: Reported Favorably",4,0,1,0,5
1888975,1470424,2024-12-16,Senate,"Senate State Government, Wagering, Tourism & Historic Preservation Committee: Reported Favorably",4,0,1,0,5
1888986,1470431,2024-12-16,Senate,"Senate State Government, Wagering, Tourism & Historic Preservation Committee: Reported Favorably",4,0,1,0,5
1888989,1470760,2024-12-19,Senate,"Senate State Government, Wagering, Tourism & Historic Preservation Committee: Reported Favorably",4,0,1,0,5
1888989,1518641,2025-03-17,Senate,"Senate Budget and Appropriations Committee: Reported Favorably",13,0,0,0,13
1888991,1470207,2024-12-12,Senate,"Senate Environment and Energy Committee: Reported Favorably",3,2,0,0,5
1889324,1589938,2025-06-12,Assembly,"Assembly Oversight, Reform and Federal Relations Committee: Reported with Amendments",5,0,1,0,6
1889324,1593060,2025-06-19,Assembly,"Assembly Appropriations Committee: Reported Favorably",8,1,2,0,11
1889324,1596574,2025-06-30,Senate,"Senate Floor: Second Reading (Voice Vote)",0,0,0,0,0
1889324,1596575,2025-06-30,Senate,"Senate Floor: Substitute for S3486 (Voice Vote)",0,0,0,0,0
1889324,1596933,2025-06-30,Assembly,"Assembly Floor: Concur in Senate Amendments",62,14,4,0,80
1889324,1596934,2025-06-30,Assembly,"Assembly Floor: Third Reading - Final Passage",64,14,2,0,80
1889324,1596935,2025-06-30,Senate,"Senate Floor: Amend",34,1,5,0,40
1889324,1596936,2025-06-30,Senate,"Senate Floor: Third Reading - Final Passage",33,3,4,0,40
1889325,1469851,2024-12-09,Assembly,"Assembly Financial Institutions and Insurance Committee: Not Reported",7,0,6,0,13
1889325,1593138,2025-06-19,Assembly,"Assembly Financial Institutions and Insurance Committee: Not Reported",8,0,5,0,13
1889331,1509036,2025-03-10,Assembly,"Assembly Transportation and Independent Authorities Committee: Reported with Amendments",10,1,2,0,13
1889331,1589926,2025-06-12,Assembly,"Assembly Commerce and Economic Development Committee: Reported with Amendments",10,0,2,0,12
1889337,1489288,2025-02-13,Assembly,"Assembly Judiciary Committee: Reported Favorably",5,0,1,0,6
1889337,1525627,2025-03-24,Assembly,"Assembly Floor: Third Reading - Final Passage",76,0,4,0,80
1889341,1469323,2024-11-14,Assembly,"Assembly Tourism, Gaming and the Arts Committee: Reported Favorably",5,0,1,0,6
1889341,1470432,2024-12-16,Assembly,"Assembly Appropriations Committee: Reported Favorably",8,2,1,0,11
1889341,1470787,2024-12-19,Assembly,"Assembly Floor: Third Reading - Final Passage",49,23,8,0,80
1889341,1597297,2025-06-30,Senate,"Senate Floor: Substitute for S3797 (Voice Vote)",0,0,0,0,0
1889341,1597298,2025-06-30,Senate,"Senate Floor: Third Reading - Final Passage",31,6,3,0,40
1889346,1473781,2025-01-23,Assembly,"Assembly Science, Innovation and Technology Committee: Reported Favorably",7,0,0,0,7
1889348,1474064,2025-01-23,Assembly,"Assembly Tourism, Gaming and the Arts Committee: Reported Favorably",6,0,0,0,6
1889348,1477824,2025-01-30,Assembly,"Assembly Floor: Third Reading - Final Passage",69,0,11,0,80
1889350,1468952,2024-10-24,Assembly,"Assembly Appropriations Committee: Reported Favorably",11,0,0,0,11
1889350,1469057,2024-10-28,Assembly,"Assembly Floor: Third Reading - Final Passage",75,0,5,0,80
1889350,1469786,2024-12-05,Senate,"Senate Transportation Committee: Reported with Amendments",6,0,0,0,6
1889350,1499701,2025-02-25,Senate,"Senate Floor: Substitute for S3819 (Voice Vote)",0,0,0,0,0
1889350,1499702,2025-02-25,Senate,"Senate Floor: Third Reading - Final Passage",23,15,2,0,40
1889350,1502523,2025-02-27,Assembly,"Assembly Floor: Concur in Senate Amendments",58,17,5,0,80
1889352,1469877,2024-12-09,Assembly,"Assembly Financial Institutions and Insurance Committee: Reported with Amendments",12,0,1,0,13
1889359,1507513,2025-03-06,Assembly,"Assembly Health Committee: Reported Favorably",11,0,0,0,11
1889360,1473959,2025-01-23,Assembly,"Assembly Children, Families and Food Security Committee Committee: Reported Favorably",5,0,1,0,6
1889360,1523905,2025-03-20,Assembly,"Assembly Appropriations Committee: Reported with Substitution",11,0,0,0,11
1889366,1484858,2025-02-10,Assembly,"Assembly Regulated Professions Committee: Reported Favorably",6,0,1,0,7
1889366,1502537,2025-02-27,Assembly,"Assembly Floor: Third Reading - Final Passage",72,1,7,0,80
1889366,1593233,2025-06-19,Senate,"Senate State Government, Wagering, Tourism & Historic Preservation Committee: Reported Favorably",5,0,0,0,5
1889376,1469321,2024-11-14,Assembly,"Assembly Environment and Solid Waste Committee: Reported Favorably",7,0,0,0,7
1889378,1470514,2024-12-16,Assembly,"Assembly Commerce and Economic Development Committee: Reported with Amendments",10,0,2,0,12
1889378,1471971,2025-01-16,Assembly,"Assembly Community Development and Womens Affairs Committee Committee: Reported Favorably",6,0,0,0,6
1889378,1572200,2025-05-15,Assembly,"Assembly Appropriations Committee: Reported Favorably",8,0,3,0,11
1889378,1593224,2025-06-19,Assembly,"Assembly Appropriations Committee: Reported with Amendments",7,1,3,0,11
1889378,1596582,2025-06-30,Senate,"Senate Floor: Substitute for S3891 (Voice Vote)",0,0,0,0,0
1889378,1596961,2025-06-30,Assembly,"Assembly Floor: Third Reading - Final Passage",78,0,2,0,80
1889378,1596962,2025-06-30,Senate,"Senate Floor: Third Reading - Final Passage",39,0,1,0,40
1889382,1470180,2024-12-12,Assembly,"Assembly Judiciary Committee: Reported Favorably",6,0,0,0,6
1889383,1564928,2025-05-05,Assembly,"Assembly Community Development and Womens Affairs Committee Committee: Reported with Amendments",6,0,0,0,6
1889384,1470236,2024-12-12,Assembly,"Assembly Transportation and Independent Authorities Committee: Reported Favorably",13,0,0,0,13
1889385,1470242,2024-12-12,Assembly,"Assembly State and Local Government Committee: Reported Favorably",7,0,0,0,7
1889385,1576574,2025-05-22,Assembly,"Assembly Floor: Third Reading - Final Passage",76,2,2,0,80
1889385,1596440,2025-06-30,Senate,"Senate Floor: Substitute for S3816 (Voice Vote)",0,0,0,0,0
1889385,1596906,2025-06-30,Senate,"Senate Floor: Third Reading - Final Passage",37,0,3,0,40
1889386,1468914,2024-10-24,Assembly,"Assembly Appropriations Committee: Reported Favorably",11,0,0,0,11
1889391,1470290,2024-12-12,Assembly,"Assembly Transportation and Independent Authorities Committee: Reported Favorably",13,0,0,0,13
1889391,1470464,2024-12-16,Assembly,"Assembly Appropriations Committee: Reported Favorably",10,0,1,0,11
1889391,1470863,2024-12-19,Assembly,"Assembly Floor: Third Reading - Final Passage",72,0,8,0,80
1889391,1470864,2024-12-19,Senate,"Senate Floor: Substitute for S3839 (Voice Vote)",0,0,0,0,0
1889391,1470865,2024-12-19,Senate,"Senate Floor: Third Reading - Final Passage",38,0,2,0,40
1889399,1572433,2025-05-15,Assembly,"Assembly Appropriations Committee: Reported with Substitution",11,0,0,0,11
1889403,1495064,2025-02-20,Assembly,"Assembly Judiciary Committee: Reported with Amendments",4,2,0,0,6
1889403,1523011,2025-03-20,Assembly,"Assembly Appropriations Committee: Reported with Amendments",7,4,0,0,11
1889403,1525109,2025-03-24,Assembly,"Assembly Floor: Third Reading - Final Passage",50,26,4,0,80
1889403,1593011,2025-06-19,Senate,"Senate Law and Public Safety Committee: Reported Favorably",3,1,1,0,5
1889405,1495318,2025-02-20,Assembly,"Assembly Judiciary Committee: Reported Favorably",4,2,0,0,6
1889408,1494981,2025-02-20,Assembly,"Assembly Judiciary Committee: Reported with Amendments",5,1,0,0,6
1889408,1524048,2025-03-20,Assembly,"Assembly Appropriations Committee: Reported with Amendments",8,0,3,0,11
1889408,1524978,2025-03-24,Assembly,"Assembly Floor: Third Reading - Final Passage",55,21,4,0,80
1889408,1593229,2025-06-19,Senate,"Senate Law and Public Safety Committee: Reported Favorably",3,1,1,0,5
1889412,1494927,2025-02-20,Assembly,"Assembly Judiciary Committee: Reported Favorably",4,2,0,0,6
1889412,1523276,2025-03-20,Assembly,"Assembly Appropriations Committee: Reported with Amendments",6,3,2,0,11
1889412,1525110,2025-03-24,Assembly,"Assembly Floor: Third Reading - Final Passage",53,22,5,0,80
1889412,1593013,2025-06-19,Senate,"Senate Law and Public Safety Committee: Reported Favorably",3,1,1,0,5
1889418,1485516,2025-02-10,Assembly,"Assembly Housing and Community Development Committee: Reported Favorably",5,2,0,0,7
1889420,1495000,2025-02-20,Assembly,"Assembly Judiciary Committee: Reported with Amendments",4,2,0,0,6
1889420,1523336,2025-03-20,Assembly,"Assembly Appropriations Committee: Reported with Amendments",7,4,0,0,11
1889420,1525102,2025-03-24,Assembly,"Assembly Floor: Third Reading - Final Passage",50,25,5,0,80
1889420,1593009,2025-06-19,Senate,"Senate Law and Public Safety Committee: Reported Favorably",3,1,1,0,5
1889423,1495658,2025-02-20,Assembly,"Assembly Judiciary Committee: Reported Favorably",5,1,0,0,6
1889423,1525015,2025-03-24,Assembly,"Assembly Floor: Third Reading - Final Passage",57,19,4,0,80
1889423,1593241,2025-06-19,Senate,"Senate Law and Public Safety Committee: Reported Favorably",4,0,1,0,5
1889425,1469854,2024-12-09,Assembly,"Assembly Housing and Community Development Committee: Reported Favorably",7,0,0,0,7
1889425,1477816,2025-01-30,Assembly,"Assembly Floor: Third Reading - Final Passage",69,6,5,0,80
1889425,1585558,2025-06-05,Senate,"Senate Community and Urban Affairs Committee: Reported with Amendments",3,1,1,0,5
1889428,1522646,2025-03-20,Assembly,"Assembly Community Development and Womens Affairs Committee Committee: Reported Favorably",6,0,0,0,6
1889428,1525178,2025-03-24,Assembly,"Assembly Floor: Third Reading - Final Passage",77,1,2,0,80
1889429,1522638,2025-03-20,Assembly,"Assembly Community Development and Womens Affairs Committee Committee: Reported with Amendments",6,0,0,0,6
1889429,1525175,2025-03-24,Assembly,"Assembly Floor: Third Reading - Final Passage",76,2,2,0,80
1889430,1522992,2025-03-20,Assembly,"Assembly Community Development and Womens Affairs Committee Committee: Reported with Amendments",5,0,1,0,6
1889430,1525623,2025-03-24,Assembly,"Assembly Floor: Third Reading - Final Passage",72,0,8,0,80
1889431,1523403,2025-03-20,Assembly,"Assembly Community Development and Womens Affairs Committee Committee: Reported Favorably",6,0,0,0,6
1889431,1525505,2025-03-24,Assembly,"Assembly Floor: Third Reading - Final Passage",78,0,2,0,80
1889466,1518559,2025-03-17,Assembly,"Assembly Human Services Committee: Reported Favorably",6,0,0,0,6
1889466,1576153,2025-05-22,Assembly,"Assembly Floor: Third Reading - Final Passage",78,0,2,0,80
1889466,1586830,2025-06-09,Senate,"Senate Health, Human Services and Senior Citizens Committee: Reported with Amendments",7,0,1,0,8
1889468,1489421,2025-02-13,Senate,"Senate Law and Public Safety Committee: Reported Favorably",5,0,0,0,5
1889471,1586821,2025-06-09,Senate,"Senate Health, Human Services and Senior Citizens Committee: Reported Favorably",7,0,1,0,8
1889475,1470455,2024-12-16,Assembly,"Assembly Appropriations Committee: Reported Favorably",9,0,2,0,11
1889480,1470410,2024-12-16,Senate,"Senate State Government, Wagering, Tourism & Historic Preservation Committee: Reported Favorably",4,0,1,0,5
1889480,1470862,2024-12-19,Senate,"Senate Floor: Third Reading - Final Passage",38,0,2,0,40
1889480,1478130,2025-01-30,Assembly,"Assembly Floor: Substitute for A4992 (Voice Vote)",0,0,0,0,0
1889480,1478131,2025-01-30,Assembly,"Assembly Floor: Third Reading - Final Passage",74,0,6,0,80
1889494,1470184,2024-12-12,Senate,"Senate Commerce Committee: Reported Favorably",5,0,0,0,5
1889494,1586841,2025-06-09,Senate,"Senate Budget and Appropriations Committee: Reported with Amendments",12,0,1,0,13
1889495,1498892,2025-02-25,Senate,"Senate State Government, Wagering, Tourism & Historic Preservation Committee: Reported with Amendments",5,0,0,0,5
1889496,1589721,2025-06-12,Assembly,"Assembly Oversight, Reform and Federal Relations Committee: Reported Favorably",6,0,0,0,6
1889497,1485183,2025-02-10,Senate,"Senate Environment and Energy Committee: Reported Favorably",5,0,0,0,5
1889504,1469818,2024-12-05,Senate,"Senate Transportation Committee: Reported with Amendments",6,0,0,0,6
1889512,1468941,2024-10-24,Senate,"Senate State Government, Wagering, Tourism & Historic Preservation Committee: Reported with Amendments",3,0,2,0,5
1889512,1468969,2024-10-28,Assembly,"Assembly Floor: Substitute for A4999 (Voice Vote)",0,0,0,0,0
1889512,1469007,2024-10-28,Assembly,"Assembly Floor: Third Reading - Final Passage",54,13,13,0,80
1889512,1469008,2024-10-28,Senate,"Senate Floor: Table Motion",25,15,0,0,40
1889512,1469009,2024-10-28,Senate,"Senate Floor: Third Reading - Final Passage",28,12,0,0,40
1889513,1469891,2024-12-09,Assembly,"Assembly Financial Institutions and Insurance Committee: Reported with Amendments",9,0,4,0,13
1889513,1473720,2025-01-23,Assembly,"Assembly Human Services Committee: Reported Favorably",4,0,2,0,6
1889513,1593130,2025-06-19,Assembly,"Assembly Appropriations Committee: Reported with Amendments",7,0,4,0,11
1889513,1596797,2025-06-30,Assembly,"Assembly Floor: Third Reading - Final Passage",66,2,12,0,80
1889515,1498914,2025-02-25,Senate,"Senate State Government, Wagering, Tourism & Historic Preservation Committee: Reported Favorably",5,0,0,0,5
1889516,1469776,2024-12-05,Senate,"Senate Transportation Committee: Reported Favorably",6,0,0,0,6
1889517,1468940,2024-10-24,Assembly,"Assembly Appropriations Committee: Reported with Amendments",7,1,3,0,11
1889518,1499188,2025-02-25,Senate,"Senate State Government, Wagering, Tourism & Historic Preservation Committee: Reported with Amendments",5,0,0,0,5
1889519,1504015,2025-03-03,Senate,"Senate Health, Human Services and Senior Citizens Committee: Reported Favorably",8,0,0,0,8
1889593,1543941,2025-04-10,Assembly,"Assembly Science, Innovation and Technology Committee: Reported with Amendments",7,0,0,0,7
1889593,1568315,2025-05-08,Assembly,"Assembly Judiciary Committee: Reported with Amendments",6,0,0,0,6
1889593,1593147,2025-06-19,Assembly,"Assembly Appropriations Committee: Reported with Amendments",11,0,0,0,11
1889593,1596843,2025-06-30,Assembly,"Assembly Floor: Third Reading - Final Passage",80,0,0,0,80
1889617,1473735,2025-01-23,Assembly,"Assembly Tourism, Gaming and the Arts Committee: Reported with Amendments",6,0,0,0,6
1889617,1495096,2025-02-20,Assembly,"Assembly Public Safety and Preparedness Committee Committee: Reported Favorably",7,0,2,0,9
1889619,1518456,2025-03-17,Assembly,"Assembly Human Services Committee: Reported with Amendments",6,0,0,0,6
1889620,1469888,2024-12-09,Senate,"Senate Budget and Appropriations Committee: Reported with Substitution",13,0,0,0,13
1889620,1470839,2024-12-19,Senate,"Senate Floor: Third Reading - Final Passage",38,0,2,0,40
1889620,1473621,2025-01-23,Assembly,"Assembly Tourism, Gaming and the Arts Committee: Reported Favorably",6,0,0,0,6
1889620,1495095,2025-02-20,Assembly,"Assembly Public Safety and Preparedness Committee Committee: Reported Favorably",7,0,2,0,9
1889620,1501222,2025-02-27,Assembly,"Assembly Floor: Substitute for A5007 (Voice Vote)",0,0,0,0,0
1889620,1502390,2025-02-27,Assembly,"Assembly Floor: Third Reading - Final Passage",76,0,4,0,80
1889623,1469030,2024-10-28,Assembly,"Assembly Floor: Third Reading - Final Passage",77,0,3,0,80
1889624,1498898,2025-02-25,Senate,"Senate State Government, Wagering, Tourism & Historic Preservation Committee: Reported Favorably",5,0,0,0,5
1889624,1525056,2025-03-24,Senate,"Senate Floor: Third Reading - Final Passage",31,8,1,0,40
1889624,1572136,2025-05-15,Assembly,"Assembly Appropriations Committee: Reported with Amendments",7,4,0,0,11
1889624,1576517,2025-05-22,Assembly,"Assembly Floor: Substitute for A5356 (Voice Vote)",0,0,0,0,0
1889624,1576518,2025-05-22,Assembly,"Assembly Floor: Third Reading - Final Passage",54,22,4,0,80
1889624,1583838,2025-06-02,Senate,"Senate Floor: Concur in Assembly Amendments",30,8,2,0,40
1889676,1470465,2024-12-16,Assembly,"Assembly Health Committee: Reported with Amendments",10,0,1,0,11
1889676,1495705,2025-02-20,Assembly,"Assembly Appropriations Committee: Reported Favorably",10,0,1,0,11
1889676,1502317,2025-02-27,Assembly,"Assembly Floor: Third Reading - Final Passage",75,0,5,0,80
1889680,1469899,2024-12-09,Senate,"Senate Health, Human Services and Senior Citizens Committee: Reported Favorably",8,0,0,0,8
1889686,1470187,2024-12-12,Senate,"Senate Commerce Committee: Reported with Amendments",5,0,0,0,5
1889688,1573653,2025-05-19,Senate,"Senate Health, Human Services and Senior Citizens Committee: Reported with Amendments",8,0,0,0,8
1889695,1503685,2025-03-03,Senate,"Senate Health, Human Services and Senior Citizens Committee: Reported Favorably",8,0,0,0,8
1889702,1593137,2025-06-19,Senate,"Senate State Government, Wagering, Tourism & Historic Preservation Committee: Reported Favorably",5,0,0,0,5
1889717,1470203,2024-12-12,Assembly,"Assembly State and Local Government Committee: Reported Favorably",7,0,0,0,7
1889717,1470440,2024-12-16,Assembly,"Assembly Appropriations Committee: Reported Favorably",10,0,1,0,11
1889717,1470794,2024-12-19,Assembly,"Assembly Floor: Third Reading - Final Passage",66,7,7,0,80
1889717,1470795,2024-12-19,Senate,"Senate Floor: Substitute for S3851 (Voice Vote)",0,0,0,0,0
1889717,1470796,2024-12-19,Senate,"Senate Floor: Third Reading - Final Passage",37,0,3,0,40
1889717,1502578,2025-02-27,Assembly,"Assembly Floor: Concur Governor Recommendations",65,6,9,0,80
1889725,1585650,2025-06-05,Senate,"Senate Community and Urban Affairs Committee: Reported Favorably",3,0,2,0,5
1889726,1568561,2025-05-08,Assembly,"Assembly Environment and Solid Waste Committee: Reported with Substitution",5,2,0,0,7
1889732,1470250,2024-12-12,Assembly,"Assembly Judiciary Committee: Reported Favorably",6,0,0,0,6
1889732,1470885,2024-12-19,Assembly,"Assembly Floor: Third Reading - Final Passage",65,7,8,0,80
1889757,1495885,2025-02-20,Assembly,"Assembly Labor Committee: Reported with Amendments",8,4,0,0,12
1889760,1473759,2025-01-23,Assembly,"Assembly State and Local Government Committee: Reported Favorably",6,0,1,0,7
1889760,1509758,2025-03-10,Assembly,"Assembly Education Committee: Reported Favorably",9,0,0,0,9
1889761,1473657,2025-01-23,Assembly,"Assembly Science, Innovation and Technology Committee: Reported with Amendments",7,0,0,0,7
1889761,1572036,2025-05-15,Assembly,"Assembly Financial Institutions and Insurance Committee: Reported with Amendments",12,0,1,0,13
1889761,1576358,2025-05-22,Assembly,"Assembly Floor: Third Reading - Final Passage",77,0,3,0,80
1889764,1519140,2025-03-17,Senate,"Senate Education Committee: Reported Favorably",5,0,0,0,5
1889764,1595953,2025-06-26,Senate,"Senate Budget and Appropriations Committee: Reported with Amendments",13,0,0,0,13
1889764,1596629,2025-06-30,Senate,"Senate Floor: Third Reading - Final Passage",39,0,1,0,40
1889770,1595910,2025-06-26,Senate,"Senate Budget and Appropriations Committee: Reported with Amendments",13,0,0,0,13
1889771,1470409,2024-12-16,Senate,"Senate State Government, Wagering, Tourism & Historic Preservation Committee: Reported Favorably",4,0,1,0,5
1889775,1576165,2025-05-22,Senate,"Senate Environment and Energy Committee: Reported with Amendments",5,0,0,0,5
1889775,1595902,2025-06-26,Senate,"Senate Budget and Appropriations Committee: Reported Favorably",13,0,0,0,13
1889775,1596628,2025-06-30,Senate,"Senate Floor: Third Reading - Final Passage",39,0,1,0,40
1889776,1470206,2024-12-12,Senate,"Senate Environment and Energy Committee: Reported with Amendments",5,0,0,0,5
1889776,1470896,2024-12-19,Assembly,"Assembly Floor: Substitute for A5123 (Voice Vote)",0,0,0,0,0
1889776,1470897,2024-12-19,Assembly,"Assembly Floor: Third Reading - Final Passage",72,0,8,0,80
1889776,1470898,2024-12-19,Senate,"Senate Floor: Third Reading - Final Passage",38,0,2,0,40
1889779,1470175,2024-12-12,Senate,"Senate Environment and Energy Committee: Reported Favorably",5,0,0,0,5
1889779,1470768,2024-12-19,Assembly,"Assembly Floor: Substitute for A5124 (Voice Vote)",0,0,0,0,0
1889779,1470829,2024-12-19,Assembly,"Assembly Floor: Third Reading - Final Passage",72,0,8,0,80
1889779,1470830,2024-12-19,Senate,"Senate Floor: Third Reading - Final Passage",38,0,2,0,40
1889785,1489355,2025-02-13,Assembly,"Assembly Military and Veterans' Affairs Committee: Reported Favorably",5,0,1,0,6
1889786,1524989,2025-03-24,Senate,"Senate Commerce Committee: Reported with Amendments",5,0,0,0,5
1889788,1485143,2025-02-10,Senate,"Senate Higher Eduction Committee: Reported Favorably",5,0,0,0,5
1889788,1498887,2025-02-25,Senate,"Senate Floor: Third Reading - Final Passage",38,0,2,0,40
1889788,1564906,2025-05-05,Assembly,"Assembly Higher Education Committee: Reported Favorably",6,0,1,0,7
1889789,1485116,2025-02-10,Senate,"Senate Higher Eduction Committee: Reported Favorably",5,0,0,0,5
1889789,1518631,2025-03-17,Senate,"Senate Budget and Appropriations Committee: Reported with Amendments",13,0,0,0,13
1889789,1583797,2025-06-02,Senate,"Senate Floor: Third Reading - Final Passage",38,0,2,0,40
1889791,1495093,2025-02-20,Assembly,"Assembly State and Local Government Committee: Reported Favorably",7,0,0,0,7
1889791,1523309,2025-03-20,Assembly,"Assembly Appropriations Committee: Reported with Amendments",11,0,0,0,11
1889791,1595610,2025-06-26,Assembly,"Assembly Budget Committee: Reported with Amendments",15,0,0,0,15
1889791,1596509,2025-06-30,Senate,"Senate Floor: Substitute for S3812 (Voice Vote)",0,0,0,0,0
1889791,1596740,2025-06-30,Assembly,"Assembly Floor: Third Reading - Final Passage",80,0,0,0,80
1889791,1596741,2025-06-30,Senate,"Senate Floor: Third Reading - Final Passage",39,0,1,0,40
1889792,1470205,2024-12-12,Senate,"Senate Environment and Energy Committee: Reported with Amendments",5,0,0,0,5
1889792,1470892,2024-12-19,Assembly,"Assembly Floor: Substitute for A5122 (Voice Vote)",0,0,0,0,0
1889792,1470893,2024-12-19,Assembly,"Assembly Floor: Third Reading - Final Passage",72,0,8,0,80
1889792,1470894,2024-12-19,Senate,"Senate Floor: Third Reading - Final Passage",38,0,2,0,40
1892053,1474942,2025-01-27,Assembly,"Assembly Environment and Solid Waste Committee: Reported with Amendments",6,0,1,0,7
1892053,1477817,2025-01-30,Assembly,"Assembly Floor: Third Reading - Final Passage",75,0,5,0,80
1892053,1485108,2025-02-10,Senate,"Senate Economic Growth Committee: Reported with Amendments",4,0,1,0,5
1892053,1525653,2025-03-24,Assembly,"Assembly Floor: Concur in Senate Amendments",76,0,4,0,80
1892053,1525654,2025-03-24,Senate,"Senate Floor: Substitute for S3918 (Voice Vote)",0,0,0,0,0
1892053,1525655,2025-03-24,Senate,"Senate Floor: Third Reading - Final Passage",39,0,1,0,40
1892119,1511974,2025-03-10,Assembly,"Assembly Education Committee: Reported Favorably",9,0,0,0,9
1892119,1593078,2025-06-19,Assembly,"Assembly Appropriations Committee: Reported with Amendments",11,0,0,0,11
1892135,1470214,2024-12-12,Assembly,"Assembly Education Committee: Reported with Amendments",7,0,2,0,9
1892135,1470835,2024-12-19,Assembly,"Assembly Floor: Third Reading - Final Passage",61,2,17,0,80
1892135,1569612,2025-05-12,Senate,"Senate Education Committee: Reported with Amendments",5,0,0,0,5
1892135,1583681,2025-06-02,Senate,"Senate Floor: Substitute for S4375 (Voice Vote)",0,0,0,0,0
1892135,1584011,2025-06-02,Senate,"Senate Floor: Third Reading - Final Passage",34,4,2,0,40
1892135,1596953,2025-06-30,Assembly,"Assembly Floor: Concur in Senate Amendments",72,2,6,0,80
1892144,1475100,2025-01-27,Assembly,"Assembly Public Safety and Preparedness Committee Committee: Reported Favorably",9,0,0,0,9
1892144,1495333,2025-02-20,Assembly,"Assembly Appropriations Committee: Reported Favorably",10,0,1,0,11
1892144,1502426,2025-02-27,Assembly,"Assembly Floor: Third Reading - Final Passage",75,0,5,0,80
1892144,1593232,2025-06-19,Senate,"Senate Law and Public Safety Committee: Reported with Amendments",4,0,1,0,5
1892210,1589851,2025-06-12,Assembly,"Assembly Telecommunications and Utilities Committee: Reported with Amendments",6,2,0,0,8
1892325,1593007,2025-06-19,Senate,"Senate Law and Public Safety Committee: Reported with Amendments",3,1,1,0,5
1892331,1469761,2024-12-05,Senate,"Senate Transportation Committee: Reported Favorably",6,0,0,0,6
1892334,1592993,2025-06-19,Senate,"Senate Law and Public Safety Committee: Reported with Amendments",3,1,1,0,5
1892338,1593002,2025-06-19,Senate,"Senate Law and Public Safety Committee: Reported with Amendments",3,1,1,0,5
1892340,1477434,2025-01-30,Senate,"Senate Transportation Committee: Reported Favorably",6,0,0,0,6
1892344,1593017,2025-06-19,Senate,"Senate Law and Public Safety Committee: Reported with Amendments",3,1,1,0,5
1892345,1485742,2025-02-10,Senate,"Senate Commerce Committee: Reported with Amendments",5,0,0,0,5
1892345,1519017,2025-03-17,Senate,"Senate Budget and Appropriations Committee: Reported Favorably",13,0,0,0,13
1892345,1583761,2025-06-02,Senate,"Senate Floor: Third Reading - Final Passage",38,0,2,0,40
1892347,1593237,2025-06-19,Senate,"Senate Law and Public Safety Committee: Reported Favorably",4,0,1,0,5
1892352,1569408,2025-05-12,Senate,"Senate Community and Urban Affairs Committee: Reported Favorably",4,0,1,0,5
1892361,1593093,2025-06-19,Senate,"Senate Law and Public Safety Committee: Reported with Amendments",3,1,1,0,5
1892363,1503967,2025-03-03,Senate,"Senate Military and Veterans' Affairs Committee: Reported with Amendments",5,0,0,0,5
1892363,1583784,2025-06-02,Senate,"Senate Floor: Third Reading - Final Passage",38,0,2,0,40
1892367,1569535,2025-05-12,Senate,"Senate Education Committee: Reported with Substitution",3,2,0,0,5
1892367,1595787,2025-06-26,Senate,"Senate Budget and Appropriations Committee: Reported with Amendments",10,3,0,0,13
1892367,1596528,2025-06-30,Assembly,"Assembly Floor: Substitute for A5717 (Voice Vote)",0,0,0,0,0
1892367,1596820,2025-06-30,Assembly,"Assembly Floor: Third Reading - Final Passage",53,25,2,0,80
1892367,1596821,2025-06-30,Senate,"Senate Floor: Third Reading - Final Passage",28,10,2,0,40
1892370,1593230,2025-06-19,Senate,"Senate Law and Public Safety Committee: Reported with Amendments",4,0,1,0,5
1892373,1585619,2025-06-05,Senate,"Senate Community and Urban Affairs Committee: Reported with Amendments",3,1,1,0,5
1892374,1485446,2025-02-10,Senate,"Senate Economic Growth Committee: Reported with Amendments",4,0,1,0,5
1892379,1477492,2025-01-30,Senate,"Senate Education Committee: Reported with Amendments",3,2,0,0,5
1892379,1595790,2025-06-26,Senate,"Senate Budget and Appropriations Committee: Reported with Substitution",12,0,1,0,13
1892379,1596846,2025-06-30,Senate,"Senate Floor: Third Reading - Final Passage",38,1,1,0,40
1894717,1470279,2024-12-12,Senate,"Senate Commerce Committee: Reported with Amendments",3,2,0,0,5
1894727,1479013,2025-02-03,Senate,"Senate Health, Human Services and Senior Citizens Committee: Reported Favorably",8,0,0,0,8
1894727,1499762,2025-02-25,Senate,"Senate Floor: Third Reading - Final Passage",38,0,2,0,40
1894727,1518410,2025-03-17,Assembly,"Assembly Human Services Committee: Reported Favorably",6,0,0,0,6
1894731,1569401,2025-05-12,Senate,"Senate Transportation Committee: Reported with Amendments",5,0,0,0,5
1894736,1485088,2025-02-10,Senate,"Senate Commerce Committee: Reported Favorably",5,0,0,0,5
1894736,1499435,2025-02-25,Senate,"Senate Floor: Third Reading - Final Passage",38,0,2,0,40
1894736,1572113,2025-05-15,Assembly,"Assembly Consumer Affairs Committee: Reported Favorably",4,1,1,0,6
1894736,1576372,2025-05-22,Assembly,"Assembly Floor: Substitute for A5322 (Voice Vote)",0,0,0,0,0
1894736,1576373,2025-05-22,Assembly,"Assembly Floor: Third Reading - Final Passage",60,13,7,0,80
1894745,1469897,2024-12-09,Senate,"Senate Budget and Appropriations Committee: Reported Favorably",13,0,0,0,13
1894745,1470899,2024-12-19,Assembly,"Assembly Floor: Substitute for A5120 (Voice Vote)",0,0,0,0,0
1894745,1470900,2024-12-19,Assembly,"Assembly Floor: Third Reading - Final Passage",73,0,7,0,80
1894745,1470901,2024-12-19,Senate,"Senate Floor: Third Reading - Final Passage",38,0,2,0,40
1894760,1469875,2024-12-09,Senate,"Senate Budget and Appropriations Committee: Reported with Amendments",13,0,0,0,13
1894760,1470858,2024-12-19,Assembly,"Assembly Floor: Substitute for A5090 (Voice Vote)",0,0,0,0,0
1894760,1470859,2024-12-19,Assembly,"Assembly Floor: Third Reading - Final Passage",70,0,10,0,80
1894760,1470860,2024-12-19,Senate,"Senate Floor: Third Reading - Final Passage",38,0,2,0,40
1894763,1576464,2025-05-22,Senate,"Senate Commerce Committee: Reported with Amendments",5,0,0,0,5
1894763,1586726,2025-06-09,Senate,"Senate Budget and Appropriations Committee: Reported Favorably",10,2,1,0,13
1894763,1596813,2025-06-30,Senate,"Senate Floor: Third Reading - Final Passage",34,5,1,0,40
1894766,1518844,2025-03-17,Senate,"Senate Education Committee: Reported Favorably",5,0,0,0,5
1894766,1595949,2025-06-26,Senate,"Senate Budget and Appropriations Committee: Reported with Amendments",13,0,0,0,13
1894766,1596613,2025-06-30,Assembly,"Assembly Floor: Substitute for A5075 (Voice Vote)",0,0,0,0,0
1894766,1596614,2025-06-30,Assembly,"Assembly Floor: Third Reading - Final Passage",79,1,0,0,80
1894766,1596615,2025-06-30,Senate,"Senate Floor: Third Reading - Final Passage",39,0,1,0,40
1894790,1469861,2024-12-09,Senate,"Senate Budget and Appropriations Committee: Reported Favorably",13,0,0,0,13
1894797,1586579,2025-06-09,Senate,"Senate Health, Human Services and Senior Citizens Committee: Reported Favorably",7,0,1,0,8
1894806,1469900,2024-12-09,Senate,"Senate Budget and Appropriations Committee: Reported Favorably",13,0,0,0,13
1894806,1470776,2024-12-19,Assembly,"Assembly Floor: Substitute for A5119 (Voice Vote)",0,0,0,0,0
1894806,1470886,2024-12-19,Assembly,"Assembly Floor: Third Reading - Final Passage",72,0,8,0,80
1894806,1470887,2024-12-19,Senate,"Senate Floor: Third Reading - Final Passage",38,0,2,0,40
1894812,1470463,2024-12-16,Senate,"Senate Law and Public Safety Committee: Reported Favorably",4,0,1,0,5
1894812,1478756,2025-02-03,Senate,"Senate Budget and Appropriations Committee: Reported with Amendments",12,0,1,0,13
1894812,1499036,2025-02-25,Senate,"Senate Floor: Third Reading - Final Passage",38,0,2,0,40
1894812,1522603,2025-03-20,Assembly,"Assembly Oversight, Reform and Federal Relations Committee: Reported with Amendments",6,0,0,0,6
1894812,1593038,2025-06-19,Assembly,"Assembly Housing and Community Development Committee: Reported with Amendments",6,0,1,0,7
1894812,1596448,2025-06-30,Assembly,"Assembly Floor: Substitute for A5125 (Voice Vote)",0,0,0,0,0
1894812,1596904,2025-06-30,Assembly,"Assembly Floor: Third Reading - Final Passage",74,6,0,0,80
1894812,1596905,2025-06-30,Senate,"Senate Floor: Concur in Assembly Amendments",39,0,1,0,40
1894999,1591052,2025-06-16,Assembly,"Assembly Military and Veterans' Affairs Committee: Reported Favorably",5,0,1,0,6
1895003,1572091,2025-05-15,Assembly,"Assembly Commerce and Economic Development Committee: Reported with Amendments",11,0,1,0,12
1895019,1589897,2025-06-12,Senate,"Senate Environment and Energy Committee: Reported with Substitution",5,0,0,0,5
1895038,1470429,2024-12-16,Assembly,"Assembly Appropriations Committee: Reported with Amendments",10,0,1,0,11
1895040,1470449,2024-12-16,Assembly,"Assembly Appropriations Committee: Reported Favorably",7,2,2,0,11
1895040,1470903,2024-12-19,Assembly,"Assembly Floor: Third Reading - Final Passage",41,26,13,0,80
1895040,1596909,2025-06-30,Senate,"Senate Floor: Substitute for S3991 (Voice Vote)",0,0,0,0,0
1895040,1596910,2025-06-30,Senate,"Senate Floor: Third Reading - Final Passage",26,13,1,0,40
1895047,1507709,2025-03-06,Assembly,"Assembly Commerce and Economic Development Committee: Reported with Amendments",10,1,1,0,12
1895100,1503526,2025-03-03,Senate,"Senate Health, Human Services and Senior Citizens Committee: Reported Favorably",8,0,0,0,8
1895100,1518606,2025-03-17,Senate,"Senate Budget and Appropriations Committee: Reported with Amendments",13,0,0,0,13
1895101,1503642,2025-03-03,Senate,"Senate Health, Human Services and Senior Citizens Committee: Reported with Amendments",8,0,0,0,8
1895101,1518714,2025-03-17,Senate,"Senate Budget and Appropriations Committee: Reported with Amendments",13,0,0,0,13
1895115,1470477,2024-12-16,Senate,"Senate Judiciary Committee: Reported with Amendments",11,0,0,0,11
1895115,1470809,2024-12-19,Senate,"Senate Floor: Third Reading - Final Passage",36,0,4,0,40
1895682,1470172,2024-12-12,Assembly,"Assembly Tourism, Gaming and the Arts Committee: Reported Favorably",6,0,0,0,6
1895682,1478002,2025-01-30,Assembly,"Assembly Floor: Third Reading - Final Passage",73,1,6,0,80
1895797,1470199,2024-12-12,Assembly,"Assembly Environment and Solid Waste Committee: Reported Favorably",7,0,0,0,7
1895797,1470475,2024-12-16,Assembly,"Assembly Appropriations Committee: Reported Favorably",10,0,1,0,11
1895802,1470202,2024-12-12,Assembly,"Assembly Environment and Solid Waste Committee: Reported Favorably",7,0,0,0,7
1895802,1470476,2024-12-16,Assembly,"Assembly Appropriations Committee: Reported Favorably",10,0,1,0,11
1895806,1470196,2024-12-12,Assembly,"Assembly State and Local Government Committee: Reported with Amendments",6,0,0,0,6
1895806,1470482,2024-12-16,Assembly,"Assembly Appropriations Committee: Reported Favorably",10,0,1,0,11
1895806,1470891,2024-12-19,Assembly,"Assembly Floor: Third Reading - Final Passage",70,0,10,0,80
1895810,1470198,2024-12-12,Assembly,"Assembly Environment and Solid Waste Committee: Reported Favorably",7,0,0,0,7
1895810,1470471,2024-12-16,Assembly,"Assembly Appropriations Committee: Reported Favorably",10,0,1,0,11
1895810,1470882,2024-12-19,Assembly,"Assembly Floor: Third Reading - Final Passage",71,0,9,0,80
1895810,1470883,2024-12-19,Senate,"Senate Floor: Substitute for S3943 (Voice Vote)",0,0,0,0,0
1895810,1470884,2024-12-19,Senate,"Senate Floor: Third Reading - Final Passage",38,0,2,0,40
1895818,1470200,2024-12-12,Assembly,"Assembly Environment and Solid Waste Committee: Reported with Amendments",7,0,0,0,7
1895818,1470443,2024-12-16,Assembly,"Assembly Appropriations Committee: Reported Favorably",10,0,1,0,11
1895822,1470285,2024-12-12,Assembly,"Assembly Environment and Solid Waste Committee: Reported Favorably",7,0,0,0,7
1895822,1470445,2024-12-16,Assembly,"Assembly Appropriations Committee: Reported Favorably",10,0,1,0,11
1895826,1470264,2024-12-12,Assembly,"Assembly Environment and Solid Waste Committee: Reported with Amendments",7,0,0,0,7
1895826,1470480,2024-12-16,Assembly,"Assembly Appropriations Committee: Reported Favorably",10,0,1,0,11
1895972,1477918,2025-01-30,Senate,"Senate Education Committee: Reported with Amendments",5,0,0,0,5
1895972,1499656,2025-02-25,Senate,"Senate Floor: Third Reading - Final Passage",38,0,2,0,40
1895972,1568732,2025-05-08,Assembly,"Assembly Education Committee: Reported with Amendments",9,0,0,0,9
1895972,1575875,2025-05-22,Assembly,"Assembly Floor: Substitute for A5263 (Voice Vote)",0,0,0,0,0
1895972,1576651,2025-05-22,Assembly,"Assembly Floor: Third Reading - Final Passage",78,0,2,0,80
1895972,1583959,2025-06-02,Senate,"Senate Floor: Concur in Assembly Amendments",38,0,2,0,40
1896003,1477619,2025-01-30,Senate,"Senate Community and Urban Affairs Committee: Reported Favorably",5,0,0,0,5
1896054,1523402,2025-03-20,Assembly,"Assembly Oversight, Reform and Federal Relations Committee: Reported with Amendments",6,0,0,0,6
1896054,1593085,2025-06-19,Assembly,"Assembly Housing and Community Development Committee: Reported with Amendments",6,0,1,0,7
1896140,1470258,2024-12-12,Assembly,"Assembly State and Local Government Committee: Reported Favorably",5,2,0,0,7
1896140,1470467,2024-12-16,Assembly,"Assembly Appropriations Committee: Reported with Amendments",7,3,1,0,11
1896140,1470888,2024-12-19,Assembly,"Assembly Floor: Third Reading - Final Passage",46,27,7,0,80
1896140,1477509,2025-01-30,Senate,"Senate Floor: Substitute for S3994 (Voice Vote)",0,0,0,0,0
1896140,1477818,2025-01-30,Assembly,"Assembly Floor: Concur in Senate Amendments",49,26,5,0,80
1896140,1477819,2025-01-30,Senate,"Senate Floor: Third Reading - Final Passage",24,13,3,0,40
1896194,1470456,2024-12-16,Assembly,"Assembly Appropriations Committee: Reported with Amendments",10,0,1,0,11
1896194,1470457,2024-12-16,Assembly,"Assembly Committee: Reported with Amendments",12,0,0,0,12
1896194,1470904,2024-12-16,Assembly,"Assembly Ballot Design Select Committee Committee: Reported with Amendments",12,0,0,0,12
1896194,1470905,2024-12-19,Assembly,"Assembly Floor: Third Reading - Final Passage",71,1,8,0,80
1896194,1495594,2025-02-20,Senate,"Senate Judiciary Committee: Reported with Amendments",10,0,1,0,11
1896194,1499351,2025-02-25,Senate,"Senate Floor: Substitute for S4142 (Voice Vote)",0,0,0,0,0
1896194,1499352,2025-02-25,Senate,"Senate Floor: Third Reading - Final Passage",35,2,3,0,40
1896194,1502220,2025-02-27,Assembly,"Assembly Floor: Concur in Senate Amendments",66,6,8,0,80
1896222,1470454,2024-12-16,Assembly,"Assembly Appropriations Committee: Reported Favorably",8,2,1,0,11
1896375,1470453,2024-12-16,Senate,"Senate State Government, Wagering, Tourism & Historic Preservation Committee: Reported with Amendments",4,0,1,0,5
1896381,1489321,2025-02-13,Assembly,"Assembly Human Services Committee: Reported Favorably",5,0,1,0,6
1896389,1470470,2024-12-16,Senate,"Senate State Government, Wagering, Tourism & Historic Preservation Committee: Reported Favorably",4,0,1,0,5
1896389,1470783,2024-12-19,Assembly,"Assembly Floor: Substitute for A5126 (Voice Vote)",0,0,0,0,0
1896389,1470914,2024-12-19,Assembly,"Assembly Floor: Third Reading - Final Passage",47,23,10,0,80
1896389,1470915,2024-12-19,Senate,"Senate Floor: Third Reading - Final Passage",38,0,2,0,40
1896394,1544463,2025-04-10,Assembly,"Assembly Financial Institutions and Insurance Committee: Reported with Amendments",12,0,1,0,13
1896398,1509020,2025-03-10,Assembly,"Assembly Children, Families and Food Security Committee Committee: Reported with Amendments",4,0,2,0,6
1896400,1509021,2025-03-10,Assembly,"Assembly Transportation and Independent Authorities Committee: Reported with Amendments",11,0,2,0,13
1896400,1525618,2025-03-24,Assembly,"Assembly Floor: Third Reading - Final Passage",70,5,5,0,80
1896419,1589580,2025-06-12,Senate,"Senate Higher Eduction Committee: Reported with Amendments",4,0,1,0,5
1896425,1473886,2025-01-23,Assembly,"Assembly State and Local Government Committee: Reported Favorably",6,0,1,0,7
1896425,1477869,2025-01-30,Assembly,"Assembly Floor: Third Reading - Final Passage",71,4,5,0,80
1896425,1518445,2025-03-17,Senate,"Senate Community and Urban Affairs Committee: Reported Favorably",3,1,1,0,5
1896425,1595791,2025-06-26,Senate,"Senate Budget and Appropriations Committee: Reported Favorably",12,1,0,0,13
1896425,1596120,2025-06-30,Senate,"Senate Floor: Substitute for S4128 (Voice Vote)",0,0,0,0,0
1896425,1596839,2025-06-30,Senate,"Senate Floor: Third Reading - Final Passage",37,2,1,0,40
1896436,1589885,2025-06-12,Senate,"Senate Higher Eduction Committee: Reported with Amendments",4,0,1,0,5
1896440,1485527,2025-02-10,Senate,"Senate Economic Growth Committee: Reported with Amendments",4,0,1,0,5
1896499,1518448,2025-03-17,Senate,"Senate Education Committee: Reported with Substitution",5,0,0,0,5
1896499,1525252,2025-03-24,Senate,"Senate Floor: Third Reading - Final Passage",39,0,1,0,40
1896499,1568195,2025-05-08,Assembly,"Assembly Education Committee: Reported with Amendments",9,0,0,0,9
1896499,1589902,2025-06-12,Assembly,"Assembly Oversight, Reform and Federal Relations Committee: Reported Favorably",6,0,0,0,6
1896499,1596551,2025-06-30,Assembly,"Assembly Floor: Substitute for A5492 (Voice Vote)",0,0,0,0,0
1896499,1596877,2025-06-30,Assembly,"Assembly Floor: Third Reading - Final Passage",80,0,0,0,80
1896499,1596878,2025-06-30,Senate,"Senate Floor: Concur in Assembly Amendments",39,0,1,0,40
1896539,1591025,2025-06-16,Assembly,"Assembly State and Local Government Committee: Reported Favorably",6,0,1,0,7
1896539,1596954,2025-06-30,Assembly,"Assembly Floor: Third Reading - Final Passage",76,0,4,0,80
1896585,1522550,2025-03-20,Assembly,"Assembly Oversight, Reform and Federal Relations Committee: Reported Favorably",6,0,0,0,6
1896585,1525099,2025-03-24,Assembly,"Assembly Floor: Third Reading - Final Passage",77,1,2,0,80
1896585,1583198,2025-06-02,Senate,"Senate Floor: Substitute for S3813 (Voice Vote)",0,0,0,0,0
1896585,1583717,2025-06-02,Senate,"Senate Floor: Third Reading - Final Passage",38,0,2,0,40
1896783,1470438,2024-12-16,Assembly,"Assembly Appropriations Committee: Reported Favorably",6,2,3,0,11
1896820,1470446,2024-12-16,Assembly,"Assembly Appropriations Committee: Reported with Amendments",7,3,1,0,11
1896820,1470837,2024-12-19,Assembly,"Assembly Floor: Third Reading - Final Passage",49,19,12,0,80
1896820,1470838,2024-12-19,Senate,"Senate Floor: Third Reading - Final Passage",36,0,4,0,40
1896885,1474982,2025-01-27,Assembly,"Assembly Environment and Solid Waste Committee: Reported Favorably",6,0,1,0,7
1896885,1593139,2025-06-19,Assembly,"Assembly Appropriations Committee: Reported Favorably",11,0,0,0,11
1896885,1595635,2025-06-26,Assembly,"Assembly Budget Committee: Reported with Amendments",12,2,1,0,15
1896919,1496065,2025-02-20,Senate,"Senate Judiciary Committee: Reported with Amendments",7,1,3,0,11
1896919,1499235,2025-02-25,Senate,"Senate Floor: Third Reading - Final Passage",25,13,2,0,40
1896919,1501698,2025-02-27,Assembly,"Assembly Floor: Substitute for A5370 (Voice Vote)",0,0,0,0,0
1896919,1502312,2025-02-27,Assembly,"Assembly Floor: Third Reading - Final Passage",53,22,5,0,80
1896948,1470855,2024-12-19,Assembly,"Assembly Floor: Third Reading - Final Passage",70,1,9,0,80
1896998,1477441,2025-01-30,Senate,"Senate Transportation Committee: Reported with Amendments",6,0,0,0,6
1896998,1499739,2025-02-25,Senate,"Senate Floor: Third Reading - Final Passage",38,0,2,0,40
1897009,1470758,2024-12-19,Senate,"Senate State Government, Wagering, Tourism & Historic Preservation Committee: Reported Favorably",4,0,1,0,5
1897019,1477495,2025-01-30,Senate,"Senate Community and Urban Affairs Committee: Reported Favorably",4,0,1,0,5
1897019,1583707,2025-06-02,Senate,"Senate Floor: Third Reading - Final Passage",38,0,2,0,40
1897019,1592986,2025-06-19,Assembly,"Assembly Housing and Community Development Committee: Reported Favorably",6,0,1,0,7
1897019,1596501,2025-06-30,Assembly,"Assembly Floor: Substitute for A5844 (Voice Vote)",0,0,0,0,0
1897019,1596725,2025-06-30,Assembly,"Assembly Floor: Third Reading - Final Passage",78,0,2,0,80
1897031,1470442,2024-12-16,Assembly,"Assembly Appropriations Committee: Reported Favorably",10,0,1,0,11
1897031,1470784,2024-12-19,Senate,"Senate Floor: Substitute for S3965 (Voice Vote)",0,0,0,0,0
1897031,1470919,2024-12-19,Assembly,"Assembly Floor: Third Reading - Final Passage",72,0,8,0,80
1897031,1470920,2024-12-19,Senate,"Senate Floor: Third Reading - Final Passage",38,0,2,0,40
1897042,1470748,2024-12-19,Senate,"Senate State Government, Wagering, Tourism & Historic Preservation Committee: Reported Favorably",4,0,1,0,5
1897551,1569474,2025-05-12,Senate,"Senate Community and Urban Affairs Committee: Reported Favorably",4,0,1,0,5
1897569,1569682,2025-05-12,Senate,"Senate Transportation Committee: Reported Favorably",6,0,0,0,6
1897577,1518935,2025-03-17,Senate,"Senate Budget and Appropriations Committee: Reported Favorably",13,0,0,0,13
1897577,1583862,2025-06-02,Senate,"Senate Floor: Third Reading - Final Passage",38,0,2,0,40
1897596,1485784,2025-02-10,Assembly,"Assembly Housing and Community Development Committee: Reported Favorably",7,0,0,0,7
1897596,1502478,2025-02-27,Assembly,"Assembly Floor: Third Reading - Final Passage",75,0,5,0,80
1897606,1572355,2025-05-15,Assembly,"Assembly Appropriations Committee: Reported with Amendments",7,4,0,0,11
1897606,1576452,2025-05-22,Assembly,"Assembly Floor: Third Reading - Final Passage",60,16,4,0,80
1897606,1596518,2025-06-30,Senate,"Senate Floor: Substitute for S4027 (Voice Vote)",0,0,0,0,0
1897606,1596765,2025-06-30,Senate,"Senate Floor: Third Reading - Final Passage",24,14,2,0,40
1897706,1586714,2025-06-09,Senate,"Senate Budget and Appropriations Committee: Reported Favorably",12,0,1,0,13
1897706,1596804,2025-06-30,Senate,"Senate Floor: Third Reading - Final Passage",39,0,1,0,40
1897722,1576300,2025-05-22,Senate,"Senate Commerce Committee: Reported Favorably",5,0,0,0,5
1897733,1593231,2025-06-19,Senate,"Senate State Government, Wagering, Tourism & Historic Preservation Committee: Reported Favorably",5,0,0,0,5
1897739,1576501,2025-05-22,Senate,"Senate Higher Eduction Committee: Reported Favorably",4,0,1,0,5
1897742,1585697,2025-06-05,Senate,"Senate Labor Committee: Reported with Amendments",5,0,0,0,5
1897744,1519042,2025-03-17,Senate,"Senate Community and Urban Affairs Committee: Reported with Amendments",4,0,1,0,5
1897751,1485339,2025-02-10,Assembly,"Assembly Higher Education Committee: Reported Favorably",7,0,0,0,7
1897751,1502339,2025-02-27,Assembly,"Assembly Floor: Third Reading - Final Passage",71,4,5,0,80
1897751,1569690,2025-05-12,Senate,"Senate Labor Committee: Reported Favorably",5,0,0,0,5
1897762,1519043,2025-03-17,Senate,"Senate Budget and Appropriations Committee: Reported with Amendments",9,4,0,0,13
1897763,1489390,2025-02-13,Senate,"Senate Law and Public Safety Committee: Reported with Amendments",5,0,0,0,5
1897775,1576582,2025-05-22,Senate,"Senate Higher Eduction Committee: Reported with Amendments",4,0,1,0,5
1897781,1569620,2025-05-12,Senate,"Senate Labor Committee: Reported Favorably",5,0,0,0,5
1897790,1586775,2025-06-09,Senate,"Senate Health, Human Services and Senior Citizens Committee: Reported with Amendments",7,0,1,0,8
1897794,1518707,2025-03-17,Assembly,"Assembly Human Services Committee: Reported Favorably",4,0,2,0,6
1897800,1569676,2025-05-12,Senate,"Senate Labor Committee: Reported with Amendments",5,0,0,0,5
1897806,1589935,2025-06-12,Senate,"Senate Higher Eduction Committee: Reported Favorably",4,0,1,0,5
1897812,1485107,2025-02-10,Assembly,"Assembly Higher Education Committee: Reported with Amendments",7,0,0,0,7
1897812,1502456,2025-02-27,Assembly,"Assembly Floor: Third Reading - Final Passage",73,0,7,0,80
1917676,1573207,2025-05-19,Senate,"Senate Health, Human Services and Senior Citizens Committee: Reported Favorably",8,0,0,0,8
1917731,1586479,2025-06-09,Senate,"Senate Health, Human Services and Senior Citizens Committee: Reported with Amendments",6,0,2,0,8
1917900,1503741,2025-03-03,Senate,"Senate Military and Veterans' Affairs Committee: Reported with Substitution",5,0,0,0,5
1917986,1477417,2025-01-30,Senate,"Senate Community and Urban Affairs Committee: Reported with Amendments",3,2,0,0,5
1917986,1595800,2025-06-26,Senate,"Senate Budget and Appropriations Committee: Reported with Amendments",7,1,5,0,13
1918577,1473887,2025-01-23,Assembly,"Assembly Labor Committee: Reported Favorably",10,0,1,0,11
1918610,1569453,2025-05-12,Senate,"Senate Community and Urban Affairs Committee: Reported with Amendments",4,0,1,0,5
1918610,1595940,2025-06-26,Senate,"Senate Budget and Appropriations Committee: Reported with Substitution",9,4,0,0,13
1918665,1576289,2025-05-22,Senate,"Senate Economic Growth Committee: Reported with Amendments",5,0,0,0,5
1918698,1484607,2025-02-10,Assembly,"Assembly Higher Education Committee: Reported Favorably",7,0,0,0,7
1918698,1495667,2025-02-20,Assembly,"Assembly Appropriations Committee: Reported Favorably",10,0,1,0,11
1918698,1576492,2025-05-22,Assembly,"Assembly Floor: Third Reading - Final Passage",76,0,4,0,80
1918741,1593014,2025-06-19,Assembly,"Assembly Financial Institutions and Insurance Committee: Reported Favorably",8,0,5,0,13
1918741,1595698,2025-06-26,Assembly,"Assembly Budget Committee: Reported Favorably",15,0,0,0,15
1918741,1596559,2025-06-30,Senate,"Senate Floor: Substitute for S4105 (Voice Vote)",0,0,0,0,0
1918741,1596895,2025-06-30,Assembly,"Assembly Floor: Third Reading - Final Passage",79,0,1,0,80
1918741,1596896,2025-06-30,Senate,"Senate Floor: Third Reading - Final Passage",38,0,2,0,40
1918801,1485569,2025-02-10,Assembly,"Assembly Higher Education Committee: Reported Favorably",7,0,0,0,7
1918801,1495320,2025-02-20,Assembly,"Assembly Appropriations Committee: Reported with Amendments",10,0,1,0,11
1918801,1597293,2025-06-30,Assembly,"Assembly Floor: Third Reading - Final Passage",79,0,1,0,80
1918828,1569457,2025-05-12,Senate,"Senate Community and Urban Affairs Committee: Reported with Amendments",3,0,2,0,5
1918876,1568562,2025-05-08,Assembly,"Assembly Environment and Solid Waste Committee: Reported with Substitution",5,0,2,0,7
1918876,1592999,2025-06-19,Assembly,"Assembly Public Safety and Preparedness Committee Committee: Reported with Substitution",8,0,1,0,9
1918876,1596863,2025-06-30,Assembly,"Assembly Floor: Third Reading - Final Passage",70,6,4,0,80
1918904,1484637,2025-02-10,Assembly,"Assembly Higher Education Committee: Reported Favorably",7,0,0,0,7
1918904,1495513,2025-02-20,Assembly,"Assembly Appropriations Committee: Reported with Amendments",10,0,1,0,11
1923425,1474974,2025-01-27,Assembly,"Assembly Financial Institutions and Insurance Committee: Reported Favorably",12,0,1,0,13
1923425,1523167,2025-03-20,Assembly,"Assembly Appropriations Committee: Reported Favorably",11,0,0,0,11
1923425,1525300,2025-03-24,Assembly,"Assembly Floor: Third Reading - Final Passage",78,0,2,0,80
1923425,1586828,2025-06-09,Senate,"Senate Budget and Appropriations Committee: Reported with Amendments",12,0,1,0,13
1924236,1523407,2025-03-20,Assembly,"Assembly Public Safety and Preparedness Committee Committee: Reported Favorably",8,1,0,0,9
1937296,1568514,2025-05-08,Assembly,"Assembly Environment and Solid Waste Committee: Reported with Substitution",5,0,2,0,7
1938395,1518647,2025-03-17,Assembly,"Assembly Military and Veterans' Affairs Committee: Reported with Substitution",5,0,1,0,6
1938395,1525156,2025-03-24,Assembly,"Assembly Floor: Third Reading - Final Passage",77,0,3,0,80
1938395,1525157,2025-03-24,Senate,"Senate Floor: Substitute for SJR149 (Voice Vote)",0,0,0,0,0
1938395,1525158,2025-03-24,Senate,"Senate Floor: Third Reading - Final Passage",39,0,1,0,40
1938492,1591112,2025-06-16,Assembly,"Assembly State and Local Government Committee: Reported with Amendments",5,0,2,0,7
1942669,1572290,2025-05-15,Assembly,"Assembly Commerce and Economic Development Committee: Reported with Amendments",6,3,3,0,12
1948318,1595695,2025-06-26,Assembly,"Assembly Budget Committee: Reported Favorably",10,3,2,0,15
1948318,1596885,2025-06-30,Assembly,"Assembly Floor: Third Reading - Final Passage",55,19,6,0,80
1948390,1507953,2025-03-06,Assembly,"Assembly Commerce and Economic Development Committee: Reported Favorably",9,1,2,0,12
1948390,1572110,2025-05-15,Assembly,"Assembly Appropriations Committee: Reported with Amendments",11,0,0,0,11
1948390,1576107,2025-05-22,Assembly,"Assembly Floor: Third Reading - Final Passage",78,0,2,0,80
1948390,1586596,2025-06-09,Senate,"Senate Budget and Appropriations Committee: Reported Favorably",12,0,1,0,13
1948390,1596617,2025-06-30,Senate,"Senate Floor: Substitute for S4100 (Voice Vote)",0,0,0,0,0
1948390,1596618,2025-06-30,Senate,"Senate Floor: Third Reading - Final Passage",39,0,1,0,40
1948449,1595760,2025-06-26,Assembly,"Assembly Budget Committee: Reported with Amendments",11,3,1,0,15
1948466,1522899,2025-03-20,Assembly,"Assembly Telecommunications and Utilities Committee: Reported with Amendments",6,2,0,0,8
1948466,1572130,2025-05-15,Assembly,"Assembly Appropriations Committee: Reported Favorably",7,4,0,0,11
1948466,1596453,2025-06-30,Senate,"Senate Floor: Substitute for S4289 (Voice Vote)",0,0,0,0,0
1948466,1596590,2025-06-30,Senate,"Senate Floor: Second Reading (Voice Vote)",0,0,0,0,0
1948466,1596920,2025-06-30,Assembly,"Assembly Floor: Concur in Senate Amendments",54,23,3,0,80
1948466,1596921,2025-06-30,Assembly,"Assembly Floor: Third Reading - Final Passage",55,22,3,0,80
1948466,1596922,2025-06-30,Senate,"Senate Floor: Amend",23,14,3,0,40
1948466,1596923,2025-06-30,Senate,"Senate Floor: Reconsidered Vote",27,11,2,0,40
1948466,1596924,2025-06-30,Senate,"Senate Floor: Third Reading - Final Passage",26,12,2,0,40
1948466,1596925,2025-06-30,Senate,"Senate Floor: Third Reading - Final Passage",25,14,1,0,40
1948478,1576660,2025-05-22,Senate,"Senate Environment and Energy Committee: Reported with Amendments",5,0,0,0,5
1948478,1586721,2025-06-09,Senate,"Senate Budget and Appropriations Committee: Reported Favorably",12,0,1,0,13
1948557,1568309,2025-05-08,Assembly,"Assembly Environment and Solid Waste Committee: Reported with Amendments",7,0,0,0,7
1948866,1581378,2025-05-29,Senate,"Senate Law and Public Safety Committee: Reported Favorably",5,0,0,0,5
1948912,1589953,2025-06-12,Assembly,"Assembly Commerce and Economic Development Committee: Reported Favorably",9,1,2,0,12
1949100,1568427,2025-05-08,Assembly,"Assembly Judiciary Committee: Reported Favorably",4,2,0,0,6
1949115,1568589,2025-05-08,Assembly,"Assembly Education Committee: Reported with Amendments",9,0,0,0,9
1949138,1499205,2025-02-25,Senate,"Senate State Government, Wagering, Tourism & Historic Preservation Committee: Reported Favorably",5,0,0,0,5
1949138,1595786,2025-06-26,Senate,"Senate Budget and Appropriations Committee: Reported Favorably",13,0,0,0,13
1949160,1522385,2025-03-20,Assembly,"Assembly Health Committee: Reported with Amendments",9,0,2,0,11
1949160,1593067,2025-06-19,Assembly,"Assembly Appropriations Committee: Reported Favorably",11,0,0,0,11
1949160,1593068,2025-06-19,Assembly,"Assembly Financial Institutions and Insurance Committee: Reported with Amendments",13,0,0,0,13
1949160,1596710,2025-06-30,Assembly,"Assembly Floor: Third Reading - Final Passage",79,0,1,0,80
1949175,1523307,2025-03-17,Senate,"Senate Environment and Energy Committee: Reported with Amendments",3,2,0,0,5
1949214,1488652,2025-02-13,Assembly,"Assembly Transportation and Independent Authorities Committee: Reported with Amendments",12,0,1,0,13
1949231,1589802,2025-06-12,Assembly,"Assembly Health Committee: Reported with Amendments",6,4,1,0,11
1949241,1523844,2025-03-17,Senate,"Senate Environment and Energy Committee: Reported Favorably",3,2,0,0,5
1949262,1569941,2025-05-12,Senate,"Senate Community and Urban Affairs Committee: Reported Favorably",4,0,1,0,5
1949292,1523081,2025-03-20,Assembly,"Assembly Commerce and Economic Development Committee: Reported with Amendments",8,1,3,0,12
1949292,1525442,2025-03-24,Assembly,"Assembly Floor: Third Reading - Final Passage",51,21,8,0,80
1949337,1522313,2025-03-20,Assembly,"Assembly State and Local Government Committee: Reported Favorably",7,0,0,0,7
1949337,1593270,2025-06-19,Assembly,"Assembly Appropriations Committee: Reported with Amendments",11,0,0,0,11
1949337,1596966,2025-06-30,Assembly,"Assembly Floor: Third Reading - Final Passage",77,1,2,0,80
1949391,1522312,2025-03-20,Assembly,"Assembly State and Local Government Committee: Reported Favorably",7,0,0,0,7
1949391,1525507,2025-03-24,Assembly,"Assembly Floor: Third Reading - Final Passage",76,0,4,0,80
1949391,1580999,2025-05-29,Senate,"Senate Law and Public Safety Committee: Reported Favorably",5,0,0,0,5
1949404,1519056,2025-03-17,Senate,"Senate Budget and Appropriations Committee: Reported Favorably",13,0,0,0,13
1949404,1525139,2025-03-24,Senate,"Senate Floor: Third Reading - Final Passage",39,0,1,0,40
1949404,1571961,2025-05-15,Assembly,"Assembly Public Safety and Preparedness Committee Committee: Reported Favorably",7,0,2,0,9
1949404,1576376,2025-05-22,Assembly,"Assembly Floor: Substitute for A5320 (Voice Vote)",0,0,0,0,0
1949404,1576377,2025-05-22,Assembly,"Assembly Floor: Third Reading - Final Passage",78,0,2,0,80
1949423,1593089,2025-06-19,Senate,"Senate State Government, Wagering, Tourism & Historic Preservation Committee: Reported with Amendments",5,0,0,0,5
1949423,1595915,2025-06-26,Senate,"Senate Budget and Appropriations Committee: Reported Favorably",13,0,0,0,13
1949423,1596596,2025-06-30,Assembly,"Assembly Floor: Substitute for A5257 (Voice Vote)",0,0,0,0,0
1949423,1596597,2025-06-30,Assembly,"Assembly Floor: Third Reading - Final Passage",58,21,1,0,80
1949423,1596598,2025-06-30,Senate,"Senate Floor: Third Reading - Final Passage",39,0,1,0,40
1949471,1485735,2025-02-10,Senate,"Senate Environment and Energy Committee: Reported Favorably",3,0,2,0,5
1949471,1525048,2025-03-24,Senate,"Senate Floor: Third Reading - Final Passage",24,13,3,0,40
1949471,1568567,2025-05-08,Assembly,"Assembly Environment and Solid Waste Committee: Reported Favorably",5,1,1,0,7
1949479,1576519,2025-05-22,Senate,"Senate Economic Growth Committee: Reported with Amendments",5,0,0,0,5
1949558,1489047,2025-02-13,Assembly,"Assembly Transportation and Independent Authorities Committee: Reported with Amendments",10,0,3,0,13
1949568,1522661,2025-03-20,Assembly,"Assembly Oversight, Reform and Federal Relations Committee: Reported Favorably",5,1,0,0,6
1952586,1519067,2025-03-17,Senate,"Senate Community and Urban Affairs Committee: Reported Favorably",3,1,1,0,5
1952586,1595784,2025-06-26,Senate,"Senate Budget and Appropriations Committee: Reported Favorably",12,1,0,0,13
1963737,1489576,2025-02-13,Assembly,"Assembly Military and Veterans' Affairs Committee: Reported Favorably",5,0,1,0,6
1963916,1522944,2025-03-20,Assembly,"Assembly Health Committee: Reported with Amendments",10,0,1,0,11
1963916,1524976,2025-03-24,Assembly,"Assembly Floor: Third Reading - Final Passage",78,0,2,0,80
1963916,1595919,2025-06-26,Senate,"Senate Budget and Appropriations Committee: Reported with Amendments",13,0,0,0,13
1963916,1596600,2025-06-30,Assembly,"Assembly Floor: Concur in Senate Amendments",80,0,0,0,80
1963916,1596601,2025-06-30,Senate,"Senate Floor: Substitute for S4147 (Voice Vote)",0,0,0,0,0
1963916,1596602,2025-06-30,Senate,"Senate Floor: Third Reading - Final Passage",39,0,1,0,40
1964010,1576351,2025-05-22,Senate,"Senate Economic Growth Committee: Reported with Amendments",5,0,0,0,5
1964010,1595810,2025-06-26,Senate,"Senate Budget and Appropriations Committee: Reported Favorably",13,0,0,0,13
1964010,1596887,2025-06-30,Senate,"Senate Floor: Third Reading - Final Passage",39,0,1,0,40
1964041,1518594,2025-03-17,Senate,"Senate Transportation Committee: Reported with Amendments",5,0,1,0,6
1964152,1488857,2025-02-13,Assembly,"Assembly Military and Veterans' Affairs Committee: Reported Favorably",5,0,1,0,6
1965426,1489762,2025-02-13,Assembly,"Assembly Judiciary Committee: Reported Favorably",5,0,1,0,6
1965426,1495597,2025-02-20,Assembly,"Assembly Appropriations Committee: Reported Favorably",10,0,1,0,11
1965426,1502218,2025-02-27,Assembly,"Assembly Floor: Third Reading - Final Passage",76,0,4,0,80
1965446,1518408,2025-03-17,Assembly,"Assembly Human Services Committee: Reported Favorably",6,0,0,0,6
1965467,1495515,2025-02-20,Assembly,"Assembly Judiciary Committee: Reported Favorably",5,1,0,0,6
1965467,1522977,2025-03-20,Assembly,"Assembly Appropriations Committee: Reported Favorably",9,0,2,0,11
1965467,1525078,2025-03-24,Assembly,"Assembly Floor: Third Reading - Final Passage",64,9,7,0,80
1965538,1489119,2025-02-13,Assembly,"Assembly Judiciary Committee: Reported Favorably",5,0,1,0,6
1965538,1495503,2025-02-20,Assembly,"Assembly Appropriations Committee: Reported Favorably",10,0,1,0,11
1965606,1489721,2025-02-13,Assembly,"Assembly Judiciary Committee: Reported Favorably",5,0,1,0,6
1965606,1502653,2025-02-27,Assembly,"Assembly Floor: Third Reading - Final Passage",76,0,4,0,80
1965678,1572105,2025-05-15,Assembly,"Assembly Public Safety and Preparedness Committee Committee: Reported Favorably",7,0,2,0,9
1965722,1572077,2025-05-15,Assembly,"Assembly Consumer Affairs Committee: Reported Favorably",4,1,1,0,6
1968905,1576531,2025-05-22,Senate,"Senate Economic Growth Committee: Reported Favorably",3,2,0,0,5
1968905,1583731,2025-06-02,Senate,"Senate Floor: Table Motion",21,15,4,0,40
1968905,1583732,2025-06-02,Senate,"Senate Floor: Third Reading - Final Passage",25,12,3,0,40
1968905,1596534,2025-06-30,Assembly,"Assembly Floor: Substitute for AJR216 (Voice Vote)",0,0,0,0,0
1968905,1596830,2025-06-30,Assembly,"Assembly Floor: Third Reading - Final Passage",57,23,0,0,80
1969659,1496126,2025-02-20,Senate,"Senate Judiciary Committee: Reported with Amendments",10,0,1,0,11
1969659,1499507,2025-02-25,Senate,"Senate Floor: Third Reading - Final Passage",37,0,3,0,40
1969659,1501576,2025-02-27,Assembly,"Assembly Floor: Substitute for A5343 (Voice Vote)",0,0,0,0,0
1969659,1502278,2025-02-27,Assembly,"Assembly Floor: Third Reading - Final Passage",64,12,4,0,80
1970075,1495887,2025-02-20,Assembly,"Assembly Appropriations Committee: Reported with Amendments",10,0,1,0,11
1970104,1565075,2025-05-05,Assembly,"Assembly Telecommunications and Utilities Committee: Reported Favorably",5,3,0,0,8
1970135,1523213,2025-03-17,Senate,"Senate Environment and Energy Committee: Reported Favorably",3,2,0,0,5
1970192,1495499,2025-02-20,Senate,"Senate Judiciary Committee: Reported with Amendments",10,0,1,0,11
1970250,1522933,2025-03-17,Senate,"Senate Environment and Energy Committee: Reported Favorably",3,2,0,0,5
1973506,1495237,2025-02-20,Assembly,"Assembly Judiciary Committee: Reported Favorably",4,2,0,0,6
1973506,1525273,2025-03-24,Assembly,"Assembly Floor: Third Reading - Final Passage",48,29,3,0,80
1973584,1494960,2025-02-20,Assembly,"Assembly Judiciary Committee: Reported with Amendments",4,2,0,0,6
1973584,1523313,2025-03-20,Assembly,"Assembly Appropriations Committee: Reported with Amendments",7,4,0,0,11
1973584,1525108,2025-03-24,Assembly,"Assembly Floor: Third Reading - Final Passage",49,27,4,0,80
1973584,1593012,2025-06-19,Senate,"Senate Law and Public Safety Committee: Reported Favorably",3,1,1,0,5
1977187,1496087,2025-02-20,Senate,"Senate Judiciary Committee: Reported Favorably",8,0,3,0,11
1977187,1499344,2025-02-25,Senate,"Senate Floor: Third Reading - Final Passage",27,10,3,0,40
1977187,1509089,2025-03-10,Assembly,"Assembly Judiciary Committee: Reported Favorably",6,0,0,0,6
1977187,1525253,2025-03-24,Assembly,"Assembly Floor: Substitute for A5411 (Voice Vote)",0,0,0,0,0
1977187,1525254,2025-03-24,Assembly,"Assembly Floor: Third Reading - Final Passage",67,10,3,0,80
1977384,1595781,2025-06-26,Senate,"Senate Budget and Appropriations Committee: Reported with Amendments",13,0,0,0,13
1977457,1518880,2025-03-17,Senate,"Senate Transportation Committee: Reported with Amendments",5,0,1,0,6
1977522,1519099,2025-03-17,Senate,"Senate Community and Urban Affairs Committee: Reported Favorably",4,0,1,0,5
1977982,1507728,2025-03-06,Assembly,"Assembly Commerce and Economic Development Committee: Reported with Amendments",11,0,1,0,12
1977982,1523913,2025-03-20,Assembly,"Assembly Appropriations Committee: Reported Favorably",11,0,0,0,11
1978000,1574025,2025-05-08,Assembly,"Assembly Tourism, Gaming and the Arts Committee: Reported Favorably",4,2,0,0,6
1978000,1596639,2025-06-30,Assembly,"Assembly Floor: Third Reading - Final Passage",56,24,0,0,80
1978018,1519082,2025-03-17,Senate,"Senate Education Committee: Reported Favorably",5,0,0,0,5
1978018,1525622,2025-03-24,Senate,"Senate Floor: Third Reading - Final Passage",39,0,1,0,40
1978018,1568490,2025-05-08,Assembly,"Assembly Education Committee: Reported Favorably",8,1,0,0,9
1978018,1576490,2025-05-22,Assembly,"Assembly Floor: Substitute for A5469 (Voice Vote)",0,0,0,0,0
1978018,1576491,2025-05-22,Assembly,"Assembly Floor: Third Reading - Final Passage",64,13,3,0,80
1978074,1522995,2025-03-20,Assembly,"Assembly State and Local Government Committee: Reported with Amendments",7,0,0,0,7
1978074,1572507,2025-05-15,Assembly,"Assembly Appropriations Committee: Reported Favorably",7,4,0,0,11
1978125,1544949,2025-04-10,Assembly,"Assembly State and Local Government Committee: Reported Favorably",7,0,0,0,7
1978125,1572330,2025-05-15,Assembly,"Assembly Appropriations Committee: Reported with Amendments",7,4,0,0,11
1978125,1576637,2025-05-22,Assembly,"Assembly Floor: Third Reading - Final Passage",49,28,3,0,80
1982811,1569417,2025-05-12,Senate,"Senate Transportation Committee: Reported Favorably",6,0,0,0,6
1982811,1583856,2025-06-02,Senate,"Senate Floor: Third Reading - Final Passage",38,0,2,0,40
1982841,1592997,2025-06-19,Assembly,"Assembly Housing and Community Development Committee: Reported with Amendments",4,1,2,0,7
1982887,1581242,2025-05-29,Senate,"Senate State Government, Wagering, Tourism & Historic Preservation Committee: Reported with Amendments",5,0,0,0,5
1982894,1585441,2025-06-05,Senate,"Senate Community and Urban Affairs Committee: Reported Favorably",4,0,1,0,5
1982934,1519112,2025-03-17,Senate,"Senate Budget and Appropriations Committee: Reported Favorably",12,1,0,0,13
1982934,1525140,2025-03-24,Assembly,"Assembly Floor: Substitute for A5467 (Voice Vote)",0,0,0,0,0
1982934,1525141,2025-03-24,Assembly,"Assembly Floor: Third Reading - Final Passage",62,4,14,0,80
1982934,1525142,2025-03-24,Senate,"Senate Floor: Third Reading - Final Passage",38,1,1,0,40
1982945,1592849,2025-06-19,Senate,"Senate Military and Veterans' Affairs Committee: Reported Favorably",5,0,0,0,5
1983045,1518427,2025-03-17,Senate,"Senate Education Committee: Reported Favorably",5,0,0,0,5
1983052,1524697,2025-03-24,Senate,"Senate Commerce Committee: Reported Favorably",5,0,0,0,5
1983052,1583710,2025-06-02,Senate,"Senate Floor: Third Reading - Final Passage",38,0,2,0,40
1983389,1592847,2025-06-19,Senate,"Senate Military and Veterans' Affairs Committee: Reported Favorably",5,0,0,0,5
1983610,1523010,2025-03-20,Assembly,"Assembly Community Development and Womens Affairs Committee Committee: Reported Favorably",4,1,1,0,6
1983610,1525082,2025-03-24,Assembly,"Assembly Floor: Table Motion",42,27,11,0,80
1983610,1525083,2025-03-24,Assembly,"Assembly Floor: Third Reading - Final Passage",46,21,13,0,80
1983610,1525084,2025-03-24,Senate,"Senate Floor: Substitute for SJR46 (Voice Vote)",0,0,0,0,0
1983610,1525085,2025-03-24,Senate,"Senate Floor: Third Reading - Final Passage",30,0,10,0,40
1983625,1581447,2025-05-29,Senate,"Senate State Government, Wagering, Tourism & Historic Preservation Committee: Reported Favorably",5,0,0,0,5
1983664,1593088,2025-06-19,Assembly,"Assembly Financial Institutions and Insurance Committee: Reported with Amendments",7,3,3,0,13
1983696,1575910,2025-05-22,Senate,"Senate Economic Growth Committee: Reported with Amendments",5,0,0,0,5
1983696,1595802,2025-06-26,Senate,"Senate Budget and Appropriations Committee: Reported with Amendments",9,4,0,0,13
1983815,1572268,2025-05-15,Assembly,"Assembly Appropriations Committee: Reported with Amendments",7,4,0,0,11
1983815,1576668,2025-05-22,Assembly,"Assembly Floor: Third Reading - Final Passage",57,21,2,0,80
1983815,1595785,2025-06-26,Senate,"Senate Budget and Appropriations Committee: Reported with Amendments",9,4,0,0,13
1983815,1596110,2025-06-30,Senate,"Senate Floor: Substitute for S4255 (Voice Vote)",0,0,0,0,0
1983815,1596841,2025-06-30,Assembly,"Assembly Floor: Concur in Senate Amendments",63,16,1,0,80
1983815,1596842,2025-06-30,Senate,"Senate Floor: Third Reading - Final Passage",27,12,1,0,40
1986973,1564853,2025-05-05,Assembly,"Assembly Higher Education Committee: Reported Favorably",6,0,1,0,7
1987222,1572015,2025-05-15,Assembly,"Assembly Consumer Affairs Committee: Reported with Amendments",5,0,1,0,6
1987222,1576339,2025-05-22,Assembly,"Assembly Floor: Third Reading - Final Passage",78,0,2,0,80
1987288,1502346,2025-02-27,Assembly,"Assembly Floor: Third Reading - Final Passage",46,10,24,0,80
1987288,1519501,2025-02-27,Assembly,"Assembly Floor: Motion to Strike Out & Insert (Voice Vote)",0,0,0,0,0
1987379,1509180,2025-03-10,Assembly,"Assembly Transportation and Independent Authorities Committee: Reported Favorably",12,0,1,0,13
1987472,1543771,2025-04-10,Assembly,"Assembly State and Local Government Committee: Reported Favorably",7,0,0,0,7
1987472,1593128,2025-06-19,Assembly,"Assembly Appropriations Committee: Reported with Amendments",11,0,0,0,11
1987472,1596481,2025-06-30,Senate,"Senate Floor: Substitute for S4402 (Voice Vote)",0,0,0,0,0
1987472,1596663,2025-06-30,Assembly,"Assembly Floor: Third Reading - Final Passage",79,0,1,0,80
1987472,1596664,2025-06-30,Senate,"Senate Floor: Third Reading - Final Passage",39,0,1,0,40
1987541,1543824,2025-04-10,Assembly,"Assembly Regulated Professions Committee: Reported with Amendments",6,0,1,0,7
1987603,1589579,2025-06-12,Assembly,"Assembly Health Committee: Reported Favorably",8,2,1,0,11
1987603,1593052,2025-06-19,Assembly,"Assembly Appropriations Committee: Reported with Amendments",8,2,1,0,11
1987603,1596612,2025-06-30,Assembly,"Assembly Floor: Third Reading - Final Passage",76,2,2,0,80
1987638,1523071,2025-03-20,Assembly,"Assembly Commerce and Economic Development Committee: Reported Favorably",12,0,0,0,12
1987638,1591042,2025-06-16,Assembly,"Assembly State and Local Government Committee: Reported Favorably",6,0,1,0,7
1987638,1596845,2025-06-30,Assembly,"Assembly Floor: Third Reading - Final Passage",79,0,1,0,80
1987654,1523910,2025-03-20,Assembly,"Assembly Commerce and Economic Development Committee: Reported Favorably",12,0,0,0,12
1987654,1591019,2025-06-16,Assembly,"Assembly State and Local Government Committee: Reported Favorably",6,0,1,0,7
1987654,1596678,2025-06-30,Assembly,"Assembly Floor: Third Reading - Final Passage",80,0,0,0,80
1987691,1509198,2025-03-10,Assembly,"Assembly Judiciary Committee: Reported Favorably",6,0,0,0,6
1987780,1589519,2025-06-12,Assembly,"Assembly Health Committee: Reported with Amendments",10,0,1,0,11
1987798,1523054,2025-03-20,Assembly,"Assembly Commerce and Economic Development Committee: Reported Favorably",12,0,0,0,12
1987798,1591048,2025-06-16,Assembly,"Assembly State and Local Government Committee: Reported Favorably",6,0,1,0,7
1987798,1596683,2025-06-30,Assembly,"Assembly Floor: Third Reading - Final Passage",80,0,0,0,80
1987806,1523914,2025-03-20,Assembly,"Assembly Commerce and Economic Development Committee: Reported Favorably",12,0,0,0,12
1987806,1591007,2025-06-16,Assembly,"Assembly State and Local Government Committee: Reported Favorably",6,0,1,0,7
1989012,1509672,2025-03-10,Assembly,"Assembly Judiciary Committee: Reported Favorably",4,2,0,0,6
1989070,1568476,2025-05-08,Assembly,"Assembly Judiciary Committee: Reported Favorably",6,0,0,0,6
1989129,1511476,2025-03-10,Assembly,"Assembly Judiciary Committee: Reported with Amendments",6,0,0,0,6
1989129,1524949,2025-03-24,Assembly,"Assembly Floor: Third Reading - Final Passage",78,0,2,0,80
1989161,1523265,2025-03-20,Assembly,"Assembly Housing and Community Development Committee: Reported Favorably",6,0,1,0,7
1989161,1572095,2025-05-15,Assembly,"Assembly Appropriations Committee: Reported with Amendments",10,1,0,0,11
1989161,1576486,2025-05-22,Assembly,"Assembly Floor: Third Reading - Final Passage",49,26,5,0,80
1989765,1503954,2025-03-03,Senate,"Senate Health, Human Services and Senior Citizens Committee: Reported Favorably",5,2,1,0,8
1989897,1573324,2025-05-19,Senate,"Senate Health, Human Services and Senior Citizens Committee: Reported with Amendments",8,0,0,0,8
1989897,1583693,2025-06-02,Senate,"Senate Floor: Third Reading - Final Passage",38,0,2,0,40
1989897,1589652,2025-06-12,Assembly,"Assembly Health Committee: Reported with Amendments",10,0,1,0,11
1989897,1596511,2025-06-30,Assembly,"Assembly Floor: Substitute for A5408 (Voice Vote)",0,0,0,0,0
1989897,1596742,2025-06-30,Assembly,"Assembly Floor: Third Reading - Final Passage",78,0,2,0,80
1989897,1596743,2025-06-30,Senate,"Senate Floor: Concur in Assembly Amendments",39,0,1,0,40
1989964,1589921,2025-06-12,Senate,"Senate Economic Growth Committee: Reported with Amendments",3,2,0,0,5
1993764,1509118,2025-03-10,Assembly,"Assembly Environment and Solid Waste Committee: Reported Favorably",7,0,0,0,7
1993764,1597036,2025-06-30,Assembly,"Assembly Floor: Third Reading - Final Passage",80,0,0,0,80
1994071,1523845,2025-03-20,Assembly,"Assembly Housing and Community Development Committee: Reported Favorably",4,0,3,0,7
1994091,1565210,2025-05-05,Assembly,"Assembly Telecommunications and Utilities Committee: Reported Favorably",8,0,0,0,8
1994091,1572455,2025-05-15,Assembly,"Assembly Appropriations Committee: Reported with Amendments",6,4,1,0,11
1994114,1564937,2025-05-05,Assembly,"Assembly Telecommunications and Utilities Committee: Reported with Amendments",8,0,0,0,8
1994114,1576776,2025-05-22,Assembly,"Assembly Floor: Third Reading - Final Passage",74,2,4,0,80
1994128,1568573,2025-05-08,Assembly,"Assembly Human Services Committee: Reported Favorably",4,2,0,0,6
1994128,1572345,2025-05-15,Assembly,"Assembly Appropriations Committee: Reported with Amendments",7,4,0,0,11
1994142,1565131,2025-05-05,Assembly,"Assembly Telecommunications and Utilities Committee: Reported Favorably",5,1,2,0,8
1994142,1572304,2025-05-15,Assembly,"Assembly Appropriations Committee: Reported Favorably",6,4,1,0,11
1994150,1523082,2025-03-20,Assembly,"Assembly Housing and Community Development Committee: Reported Favorably",4,1,2,0,7
1994150,1572286,2025-05-15,Assembly,"Assembly Appropriations Committee: Reported with Amendments",7,4,0,0,11
1994150,1576541,2025-05-22,Assembly,"Assembly Floor: Third Reading - Final Passage",50,25,5,0,80
1994165,1568565,2025-05-08,Assembly,"Assembly Human Services Committee: Reported with Amendments",5,0,1,0,6
1994165,1572351,2025-05-15,Assembly,"Assembly Appropriations Committee: Reported Favorably",11,0,0,0,11
1994165,1576657,2025-05-22,Assembly,"Assembly Floor: Third Reading - Final Passage",77,0,3,0,80
1996449,1573920,2025-05-08,Assembly,"Assembly Tourism, Gaming and the Arts Committee: Reported with Amendments",6,0,0,0,6
1996449,1593145,2025-06-19,Assembly,"Assembly Appropriations Committee: Reported Favorably",11,0,0,0,11
1996449,1596488,2025-06-30,Senate,"Senate Floor: Substitute for S4282 (Voice Vote)",0,0,0,0,0
1996449,1596715,2025-06-30,Assembly,"Assembly Floor: Third Reading - Final Passage",69,10,1,0,80
1996449,1596716,2025-06-30,Senate,"Senate Floor: Third Reading - Final Passage",34,5,1,0,40
1996564,1568420,2025-05-08,Assembly,"Assembly Judiciary Committee: Reported Favorably",6,0,0,0,6
2000067,1523092,2025-03-20,Assembly,"Assembly Health Committee: Reported Favorably",10,0,1,0,11
2000067,1524957,2025-03-24,Assembly,"Assembly Floor: Third Reading - Final Passage",78,0,2,0,80
2000081,1589632,2025-06-12,Assembly,"Assembly Telecommunications and Utilities Committee: Reported with Amendments",5,2,1,0,8
2000081,1596884,2025-06-30,Assembly,"Assembly Floor: Third Reading - Final Passage",53,26,1,0,80
2000098,1523890,2025-03-20,Assembly,"Assembly Appropriations Committee: Reported Favorably",10,1,0,0,11
2000113,1571984,2025-05-15,Assembly,"Assembly State and Local Government Committee: Reported Favorably",5,1,1,0,7
2000113,1593097,2025-06-19,Assembly,"Assembly Appropriations Committee: Reported Favorably",7,4,0,0,11
2000161,1565387,2025-05-05,Assembly,"Assembly Telecommunications and Utilities Committee: Reported Favorably",8,0,0,0,8
2000175,1523249,2025-03-20,Assembly,"Assembly Commerce and Economic Development Committee: Reported Favorably",12,0,0,0,12
2000207,1565125,2025-05-05,Assembly,"Assembly Telecommunications and Utilities Committee: Reported with Amendments",8,0,0,0,8
2000207,1576164,2025-05-22,Assembly,"Assembly Floor: Third Reading - Final Passage",75,2,3,0,80
2000207,1583048,2025-06-02,Senate,"Senate Floor: Substitute for S4318 (Voice Vote)",0,0,0,0,0
2000207,1583786,2025-06-02,Senate,"Senate Floor: Table Motion",22,15,3,0,40
2000207,1583787,2025-06-02,Senate,"Senate Floor: Third Reading - Final Passage",38,0,2,0,40
2000237,1571996,2025-05-15,Assembly,"Assembly State and Local Government Committee: Reported Favorably",6,1,0,0,7
2000237,1576716,2025-05-22,Assembly,"Assembly Floor: Table Motion",41,28,11,0,80
2000237,1576717,2025-05-22,Assembly,"Assembly Floor: Third Reading - Final Passage",61,12,7,0,80
2000237,1589479,2025-06-12,Senate,"Senate Economic Growth Committee: Reported with Amendments",4,0,1,0,5
2000237,1596152,2025-06-30,Senate,"Senate Floor: Substitute for S4363 (Voice Vote)",0,0,0,0,0
2000237,1596661,2025-06-30,Assembly,"Assembly Floor: Concur in Senate Amendments",63,16,1,0,80
2000237,1596662,2025-06-30,Senate,"Senate Floor: Third Reading - Final Passage",29,8,3,0,40
2009038,1581177,2025-05-29,Senate,"Senate State Government, Wagering, Tourism & Historic Preservation Committee: Reported Favorably",5,0,0,0,5
2009117,1581036,2025-05-29,Senate,"Senate State Government, Wagering, Tourism & Historic Preservation Committee: Reported with Amendments",5,0,0,0,5
2009117,1595777,2025-06-26,Senate,"Senate Budget and Appropriations Committee: Reported Favorably",9,4,0,0,13
2009167,1568277,2025-05-08,Assembly,"Assembly Human Services Committee: Reported Favorably",5,0,1,0,6
2009212,1568468,2025-05-08,Assembly,"Assembly Education Committee: Reported Favorably",8,1,0,0,9
2009437,1575944,2025-05-22,Senate,"Senate Environment and Energy Committee: Reported with Amendments",4,1,0,0,5
2009437,1596505,2025-06-30,Assembly,"Assembly Floor: Substitute for A5548 (Voice Vote)",0,0,0,0,0
2009437,1596726,2025-06-30,Assembly,"Assembly Floor: Third Reading - Final Passage",54,25,1,0,80
2009437,1596727,2025-06-30,Senate,"Senate Floor: Concur in Assembly Amendments",30,8,2,0,40
2009437,1596728,2025-06-30,Senate,"Senate Floor: Concur in House Amendments",34,3,3,0,40
2009437,1596729,2025-06-30,Senate,"Senate Floor: Reconsidered Vote",30,5,5,0,40
2009437,1598925,2025-06-30,Senate,"Senate Floor: Third Reading",36,0,4,0,40
2009501,1573163,2025-05-19,Senate,"Senate Health, Human Services and Senior Citizens Committee: Reported Favorably",5,3,0,0,8
2009541,1575942,2025-05-22,Senate,"Senate Environment and Energy Committee: Reported Favorably",3,2,0,0,5
2009541,1586514,2025-06-09,Senate,"Senate Budget and Appropriations Committee: Reported with Substitution",9,3,1,0,13
2011656,1564951,2025-05-05,Assembly,"Assembly Higher Education Committee: Reported Favorably",6,0,1,0,7
2011761,1568341,2025-05-08,Assembly,"Assembly Education Committee: Reported with Amendments",9,0,0,0,9
2011761,1589871,2025-06-12,Assembly,"Assembly Oversight, Reform and Federal Relations Committee: Reported Favorably",6,0,0,0,6
2012043,1591003,2025-06-16,Assembly,"Assembly Labor Committee: Reported Favorably",10,2,0,0,12
2012109,1565385,2025-05-05,Assembly,"Assembly Telecommunications and Utilities Committee: Reported with Amendments",8,0,0,0,8
2012109,1593083,2025-06-19,Assembly,"Assembly Appropriations Committee: Reported with Amendments",11,0,0,0,11
2012109,1596677,2025-06-30,Assembly,"Assembly Floor: Third Reading - Final Passage",79,1,0,0,80
2013217,1576400,2025-05-22,Senate,"Senate Environment and Energy Committee: Reported with Amendments",3,2,0,0,5
2013228,1585579,2025-06-05,Senate,"Senate Education Committee: Reported Favorably",5,0,0,0,5
2013284,1525633,2025-03-24,Assembly,"Assembly Floor: Third Reading - Final Passage",65,3,12,0,80
2013343,1575989,2025-05-22,Senate,"Senate Commerce Committee: Reported Favorably",5,0,0,0,5
2013412,1585617,2025-06-05,Senate,"Senate Education Committee: Reported with Amendments",5,0,0,0,5
2013457,1585463,2025-06-05,Senate,"Senate Labor Committee: Reported with Amendments",5,0,0,0,5
2013470,1589821,2025-06-12,Senate,"Senate Economic Growth Committee: Reported with Amendments",3,2,0,0,5
2013497,1568503,2025-05-08,Assembly,"Assembly Environment and Solid Waste Committee: Reported Favorably",5,0,2,0,7
2013497,1592994,2025-06-19,Assembly,"Assembly Housing and Community Development Committee: Reported with Amendments",6,0,1,0,7
2013497,1596721,2025-06-30,Assembly,"Assembly Floor: Third Reading - Final Passage",63,8,9,0,80
2013524,1569418,2025-05-12,Senate,"Senate Transportation Committee: Reported Favorably",6,0,0,0,6
2013546,1576459,2025-05-22,Senate,"Senate Economic Growth Committee: Reported with Amendments",5,0,0,0,5
2013558,1593158,2025-06-19,Assembly,"Assembly Appropriations Committee: Reported with Amendments",10,0,1,0,11
2013590,1568494,2025-05-08,Assembly,"Assembly Environment and Solid Waste Committee: Reported Favorably",5,0,2,0,7
2013590,1593148,2025-06-19,Assembly,"Assembly Appropriations Committee: Reported with Amendments",7,0,4,0,11
2013617,1568556,2025-05-08,Assembly,"Assembly Human Services Committee: Reported Favorably",4,1,1,0,6
2013617,1572484,2025-05-15,Assembly,"Assembly Appropriations Committee: Reported Favorably",7,0,4,0,11
2013617,1596496,2025-06-30,Senate,"Senate Floor: Second Reading (Voice Vote)",0,0,0,0,0
2013617,1596497,2025-06-30,Senate,"Senate Floor: Substitute for S4361 (Voice Vote)",0,0,0,0,0
2013617,1596711,2025-06-30,Assembly,"Assembly Floor: Concur in Senate Amendments",57,11,12,0,80
2013617,1596712,2025-06-30,Assembly,"Assembly Floor: Third Reading - Final Passage",57,11,12,0,80
2013617,1596713,2025-06-30,Senate,"Senate Floor: Amend",25,14,1,0,40
2013617,1596714,2025-06-30,Senate,"Senate Floor: Third Reading - Final Passage",25,14,1,0,40
2013618,1589484,2025-06-12,Senate,"Senate Commerce Committee: Reported with Amendments",4,0,1,0,5
2013619,1572486,2025-05-15,Assembly,"Assembly Commerce and Economic Development Committee: Reported Favorably",10,1,1,0,12
2013619,1576544,2025-05-22,Assembly,"Assembly Floor: Third Reading - Final Passage",75,3,2,0,80
2013622,1590965,2025-06-16,Assembly,"Assembly Labor Committee: Reported with Amendments",10,1,1,0,12
2013628,1571969,2025-05-15,Assembly,"Assembly Public Safety and Preparedness Committee Committee: Reported Favorably",7,0,2,0,9
2013628,1593155,2025-06-19,Assembly,"Assembly Appropriations Committee: Reported with Amendments",10,0,1,0,11
2013628,1596886,2025-06-30,Assembly,"Assembly Floor: Third Reading - Final Passage",79,0,1,0,80
2013630,1586553,2025-06-09,Senate,"Senate Budget and Appropriations Committee: Reported Favorably",9,3,1,0,13
2013636,1568500,2025-05-08,Assembly,"Assembly Environment and Solid Waste Committee: Reported with Amendments",5,0,2,0,7
2013636,1593149,2025-06-19,Assembly,"Assembly Appropriations Committee: Reported Favorably",7,0,4,0,11
2013639,1591047,2025-06-16,Assembly,"Assembly State and Local Government Committee: Reported Favorably",6,0,1,0,7
2013639,1593066,2025-06-19,Assembly,"Assembly Appropriations Committee: Reported with Amendments",7,4,0,0,11
2013639,1596658,2025-06-30,Assembly,"Assembly Floor: Third Reading - Final Passage",55,25,0,0,80
2013639,1596659,2025-06-30,Senate,"Senate Floor: Substitute for S4388 (Voice Vote)",0,0,0,0,0
2013639,1596660,2025-06-30,Senate,"Senate Floor: Third Reading - Final Passage",25,14,1,0,40
2013646,1595759,2025-06-26,Assembly,"Assembly Budget Committee: Reported Favorably",15,0,0,0,15
2013650,1573927,2025-05-08,Assembly,"Assembly Tourism, Gaming and the Arts Committee: Reported Favorably",6,0,0,0,6
2013659,1590017,2025-06-12,Senate,"Senate Economic Growth Committee: Reported with Amendments",4,0,1,0,5
2013682,1571997,2025-05-15,Assembly,"Assembly Public Safety and Preparedness Committee Committee: Reported with Amendments",6,1,2,0,9
2013687,1581208,2025-05-29,Senate,"Senate State Government, Wagering, Tourism & Historic Preservation Committee: Reported Favorably",5,0,0,0,5
2013695,1569616,2025-05-12,Senate,"Senate Education Committee: Reported with Amendments",5,0,0,0,5
2013696,1595602,2025-06-26,Assembly,"Assembly Budget Committee: Reported with Amendments",11,4,0,0,15
2013704,1593223,2025-06-19,Senate,"Senate Military and Veterans' Affairs Committee: Reported with Amendments",3,0,2,0,5
2013704,1595913,2025-06-26,Senate,"Senate Budget and Appropriations Committee: Reported Favorably",10,3,0,0,13
2013704,1596502,2025-06-30,Assembly,"Assembly Floor: Substitute for A5520 (Voice Vote)",0,0,0,0,0
2013704,1596955,2025-06-30,Assembly,"Assembly Floor: Third Reading - Final Passage",72,0,8,0,80
2013704,1596956,2025-06-30,Senate,"Senate Floor: Third Reading - Final Passage",32,6,2,0,40
2013718,1590084,2025-06-12,Senate,"Senate Economic Growth Committee: Reported Favorably",3,1,1,0,5
2013718,1595929,2025-06-26,Senate,"Senate Budget and Appropriations Committee: Reported with Amendments",9,4,0,0,13
2013736,1593064,2025-06-19,Assembly,"Assembly Public Safety and Preparedness Committee Committee: Reported with Amendments",7,0,2,0,9
2022662,1589698,2025-06-12,Assembly,"Assembly Commerce and Economic Development Committee: Reported Favorably",10,0,2,0,12
2022662,1596685,2025-06-30,Assembly,"Assembly Floor: Third Reading - Final Passage",80,0,0,0,80
2022672,1591021,2025-06-16,Assembly,"Assembly State and Local Government Committee: Reported Favorably",6,0,1,0,7
2022680,1589958,2025-06-12,Assembly,"Assembly Health Committee: Reported with Amendments",10,0,1,0,11
2022680,1596684,2025-06-30,Assembly,"Assembly Floor: Third Reading - Final Passage",80,0,0,0,80
2022737,1564904,2025-05-05,Assembly,"Assembly Higher Education Committee: Reported Favorably",6,0,1,0,7
2022824,1572328,2025-05-15,Assembly,"Assembly Appropriations Committee: Reported Favorably",11,0,0,0,11
2022824,1576714,2025-05-22,Assembly,"Assembly Floor: Third Reading - Final Passage",77,0,3,0,80
2022824,1580997,2025-05-29,Senate,"Senate State Government, Wagering, Tourism & Historic Preservation Committee: Reported Favorably",5,0,0,0,5
2022824,1583053,2025-06-02,Senate,"Senate Floor: Substitute for S4474 (Voice Vote)",0,0,0,0,0
2022824,1583848,2025-06-02,Senate,"Senate Floor: Third Reading - Final Passage",38,0,2,0,40
2022840,1589919,2025-06-12,Assembly,"Assembly Regulated Professions Committee: Reported Favorably",6,0,1,0,7
2022840,1596732,2025-06-30,Assembly,"Assembly Floor: Third Reading - Final Passage",79,0,1,0,80
2022844,1568437,2025-05-08,Assembly,"Assembly Environment and Solid Waste Committee: Reported Favorably",5,1,1,0,7
2022865,1572321,2025-05-15,Assembly,"Assembly Regulated Professions Committee: Reported with Amendments",6,0,1,0,7
2022865,1576571,2025-05-22,Assembly,"Assembly Floor: Third Reading - Final Passage",78,0,2,0,80
2022865,1589620,2025-06-12,Senate,"Senate Commerce Committee: Reported Favorably",5,0,0,0,5
2022885,1545246,2025-04-10,Assembly,"Assembly Regulated Professions Committee: Reported Favorably",6,0,1,0,7
2022885,1572485,2025-05-15,Assembly,"Assembly Commerce and Economic Development Committee: Reported with Amendments",10,1,1,0,12
2022885,1576691,2025-05-22,Assembly,"Assembly Floor: Third Reading - Final Passage",73,4,3,0,80
2022897,1590958,2025-06-16,Assembly,"Assembly State and Local Government Committee: Reported Favorably",6,0,1,0,7
2022897,1596722,2025-06-30,Assembly,"Assembly Floor: Third Reading - Final Passage",80,0,0,0,80
2022901,1591024,2025-06-16,Assembly,"Assembly Science, Innovation and Technology Committee: Reported Favorably",5,0,2,0,7
2022959,1568296,2025-05-08,Assembly,"Assembly Transportation and Independent Authorities Committee: Reported Favorably",8,3,2,0,13
2023002,1572044,2025-05-15,Assembly,"Assembly State and Local Government Committee: Reported with Amendments",7,0,0,0,7
2023770,1572126,2025-05-15,Assembly,"Assembly Regulated Professions Committee: Reported Favorably",5,0,2,0,7
2023776,1568429,2025-05-08,Assembly,"Assembly Judiciary Committee: Reported Favorably",6,0,0,0,6
2023782,1572360,2025-05-15,Assembly,"Assembly Regulated Professions Committee: Reported with Amendments",6,0,1,0,7
2023782,1576277,2025-05-22,Assembly,"Assembly Floor: Third Reading - Final Passage",78,0,2,0,80
2028571,1595755,2025-06-26,Assembly,"Assembly Budget Committee: Reported Favorably",15,0,0,0,15
2028571,1596673,2025-06-30,Assembly,"Assembly Floor: Third Reading - Final Passage",79,0,1,0,80
2028615,1572289,2025-05-15,Assembly,"Assembly Regulated Professions Committee: Reported Favorably",6,0,1,0,7
2028646,1568110,2025-05-08,Assembly,"Assembly Transportation and Independent Authorities Committee: Reported Favorably",12,0,1,0,13
2028646,1593244,2025-06-19,Assembly,"Assembly Appropriations Committee: Reported Favorably",11,0,0,0,11
2028716,1568287,2025-05-08,Assembly,"Assembly Judiciary Committee: Reported Favorably",6,0,0,0,6
2029712,1590955,2025-06-16,Assembly,"Assembly Labor Committee: Reported with Amendments",10,1,1,0,12
2029712,1593061,2025-06-19,Assembly,"Assembly Appropriations Committee: Reported with Amendments",8,1,2,0,11
2029712,1595767,2025-06-26,Assembly,"Assembly Budget Committee: Reported with Amendments",11,0,4,0,15
2029712,1596469,2025-06-30,Senate,"Senate Floor: Substitute for S4407 (Voice Vote)",0,0,0,0,0
2029712,1596938,2025-06-30,Assembly,"Assembly Floor: Third Reading - Final Passage",65,9,6,0,80
2029712,1596939,2025-06-30,Senate,"Senate Floor: Third Reading - Final Passage",39,0,1,0,40
2029712,1598799,2025-06-30,Assembly,"Assembly Floor: Motion to Strike Out",27,42,11,0,80
2029716,1591010,2025-06-16,Assembly,"Assembly Labor Committee: Reported Favorably",10,1,1,0,12
2029746,1589985,2025-06-12,Assembly,"Assembly Regulated Professions Committee: Reported Favorably",5,0,2,0,7
2029791,1591239,2025-06-16,Assembly,"Assembly Science, Innovation and Technology Committee: Reported Favorably",5,0,2,0,7
2029803,1595570,2025-06-26,Assembly,"Assembly Budget Committee: Reported with Amendments",10,3,2,0,15
2029803,1596655,2025-06-30,Assembly,"Assembly Floor: Third Reading - Final Passage",49,30,1,0,80
2029803,1596656,2025-06-30,Senate,"Senate Floor: Substitute for S4475 (Voice Vote)",0,0,0,0,0
2029803,1596657,2025-06-30,Senate,"Senate Floor: Third Reading - Final Passage",30,8,2,0,40
2030232,1569444,2025-05-12,Senate,"Senate Community and Urban Affairs Committee: Reported Favorably",4,0,1,0,5
2030258,1581355,2025-05-29,Senate,"Senate Law and Public Safety Committee: Reported Favorably",5,0,0,0,5
2030270,1592204,2025-06-12,Senate,"Senate Economic Growth Committee: Reported with Amendments",5,0,0,0,5
2030270,1596480,2025-06-30,Senate,"Senate Floor: Third Reading - Final Passage (Voice Vote)",0,0,0,0,0
2030271,1586737,2025-06-09,Senate,"Senate Budget and Appropriations Committee: Reported Favorably",12,0,1,0,13
2030271,1596436,2025-06-30,Assembly,"Assembly Floor: Substitute for A5622 (Voice Vote)",0,0,0,0,0
2030271,1596674,2025-06-30,Assembly,"Assembly Floor: Third Reading - Final Passage",78,0,2,0,80
2030271,1596675,2025-06-30,Senate,"Senate Floor: Concur in Assembly Amendments",39,0,1,0,40
2030271,1596676,2025-06-30,Senate,"Senate Floor: Third Reading - Final Passage",39,0,1,0,40
2030275,1576260,2025-05-22,Senate,"Senate Higher Eduction Committee: Reported Favorably",4,0,1,0,5
2030275,1583706,2025-06-02,Senate,"Senate Floor: Third Reading - Final Passage",25,11,4,0,40
2030275,1589940,2025-06-12,Assembly,"Assembly Higher Education Committee: Reported Favorably",5,2,0,0,7
2030275,1596468,2025-06-30,Assembly,"Assembly Floor: Substitute for A5729 (Voice Vote)",0,0,0,0,0
2030275,1596634,2025-06-30,Assembly,"Assembly Floor: Third Reading - Final Passage",61,18,1,0,80
2030278,1581376,2025-05-29,Senate,"Senate State Government, Wagering, Tourism & Historic Preservation Committee: Reported Favorably",5,0,0,0,5
2030278,1595794,2025-06-26,Senate,"Senate Budget and Appropriations Committee: Reported with Amendments",13,0,0,0,13
2030279,1576675,2025-05-22,Senate,"Senate Higher Eduction Committee: Reported Favorably",4,0,1,0,5
2030281,1586953,2025-06-09,Senate,"Senate Budget and Appropriations Committee: Reported Favorably",12,0,1,0,13
2030281,1596651,2025-06-30,Assembly,"Assembly Floor: Substitute for A5621 (Voice Vote)",0,0,0,0,0
2030281,1596652,2025-06-30,Assembly,"Assembly Floor: Third Reading - Final Passage",79,0,1,0,80
2030281,1596653,2025-06-30,Senate,"Senate Floor: Concur in Assembly Amendments",39,0,1,0,40
2030281,1596654,2025-06-30,Senate,"Senate Floor: Third Reading - Final Passage",39,0,1,0,40
2030282,1589931,2025-06-12,Senate,"Senate Commerce Committee: Reported Favorably",4,0,1,0,5
2030298,1575932,2025-05-22,Senate,"Senate Environment and Energy Committee: Reported Favorably",4,1,0,0,5
2030305,1569447,2025-05-12,Senate,"Senate Community and Urban Affairs Committee: Reported Favorably",4,0,1,0,5
2030314,1585551,2025-06-05,Senate,"Senate Education Committee: Reported Favorably",5,0,0,0,5
2030331,1585545,2025-06-05,Senate,"Senate Community and Urban Affairs Committee: Reported Favorably",3,1,1,0,5
2030331,1596980,2025-06-30,Senate,"Senate Floor: Third Reading - Final Passage",23,14,3,0,40
2030332,1576108,2025-05-22,Senate,"Senate Environment and Energy Committee: Reported Favorably",5,0,0,0,5
2030332,1596999,2025-06-30,Senate,"Senate Floor: Third Reading - Final Passage",39,0,1,0,40
2030348,1586712,2025-06-09,Senate,"Senate Budget and Appropriations Committee: Reported Favorably",12,0,1,0,13
2030348,1596854,2025-06-30,Assembly,"Assembly Floor: Substitute for ACR170 (Voice Vote)",0,0,0,0,0
2030348,1596855,2025-06-30,Assembly,"Assembly Floor: Third Reading - Final Passage",79,0,1,0,80
2030348,1596856,2025-06-30,Senate,"Senate Floor: Third Reading - Final Passage",39,0,1,0,40
2030359,1576676,2025-05-22,Senate,"Senate Commerce Committee: Reported Favorably",5,0,0,0,5
2030373,1569449,2025-05-12,Senate,"Senate Transportation Committee: Reported Favorably",6,0,0,0,6
2030373,1583733,2025-06-02,Senate,"Senate Floor: Third Reading - Final Passage",38,0,2,0,40
2030373,1593245,2025-06-19,Assembly,"Assembly Appropriations Committee: Reported Favorably",11,0,0,0,11
2030373,1596626,2025-06-30,Assembly,"Assembly Floor: Substitute for A5623 (Voice Vote)",0,0,0,0,0
2030373,1596627,2025-06-30,Assembly,"Assembly Floor: Third Reading - Final Passage",79,0,1,0,80
2030374,1585788,2025-06-05,Senate,"Senate Labor Committee: Reported Favorably",5,0,0,0,5
2030374,1596836,2025-06-30,Senate,"Senate Floor: Third Reading - Final Passage",39,0,1,0,40
2030378,1593240,2025-06-19,Senate,"Senate Law and Public Safety Committee: Reported with Amendments",4,0,1,0,5
2030384,1595911,2025-06-26,Senate,"Senate Budget and Appropriations Committee: Reported with Amendments",13,0,0,0,13
2030393,1576312,2025-05-22,Senate,"Senate Commerce Committee: Reported Favorably",3,1,1,0,5
2030409,1595912,2025-06-26,Senate,"Senate Budget and Appropriations Committee: Reported with Amendments",9,4,0,0,13
2030415,1576683,2025-05-22,Senate,"Senate Commerce Committee: Reported Favorably",5,0,0,0,5
2030415,1595903,2025-06-26,Senate,"Senate Budget and Appropriations Committee: Reported Favorably",13,0,0,0,13
2030415,1596948,2025-06-30,Senate,"Senate Floor: Third Reading - Final Passage",39,0,1,0,40
2030416,1576511,2025-05-22,Senate,"Senate Environment and Energy Committee: Reported Favorably",5,0,0,0,5
2030448,1585663,2025-06-05,Senate,"Senate Community and Urban Affairs Committee: Reported Favorably",4,0,1,0,5
2030448,1586577,2025-06-09,Senate,"Senate Budget and Appropriations Committee: Reported Favorably",12,0,1,0,13
2030448,1596619,2025-06-30,Senate,"Senate Floor: Third Reading - Final Passage",39,0,1,0,40
2030450,1581806,2025-05-29,Senate,"Senate State Government, Wagering, Tourism & Historic Preservation Committee: Reported Favorably",5,0,0,0,5
2030483,1585785,2025-06-05,Senate,"Senate Education Committee: Reported Favorably",3,1,1,0,5
2030483,1596981,2025-06-30,Assembly,"Assembly Floor: Substitute for A5780 (Voice Vote)",0,0,0,0,0
2030483,1596982,2025-06-30,Assembly,"Assembly Floor: Third Reading - Final Passage",71,5,4,0,80
2030483,1596983,2025-06-30,Senate,"Senate Floor: Third Reading - Final Passage",30,7,3,0,40
2030493,1595916,2025-06-26,Senate,"Senate Budget and Appropriations Committee: Reported with Amendments",11,2,0,0,13
2030517,1589718,2025-06-12,Senate,"Senate Economic Growth Committee: Reported with Amendments",3,2,0,0,5
2030538,1589870,2025-06-12,Senate,"Senate Commerce Committee: Reported Favorably",5,0,0,0,5
2031572,1589842,2025-06-12,Assembly,"Assembly Higher Education Committee: Reported with Amendments",7,0,0,0,7
2031572,1593065,2025-06-19,Assembly,"Assembly Appropriations Committee: Reported with Amendments",10,1,0,0,11
2031572,1596952,2025-06-30,Assembly,"Assembly Floor: Third Reading - Final Passage",71,5,4,0,80
2031672,1590021,2025-06-12,Assembly,"Assembly Commerce and Economic Development Committee: Reported Favorably",10,0,2,0,12
2031759,1590019,2025-06-12,Assembly,"Assembly Regulated Professions Committee: Reported Favorably",6,0,1,0,7
2031778,1589577,2025-06-12,Assembly,"Assembly Higher Education Committee: Reported Favorably",5,2,0,0,7
2031826,1591082,2025-06-16,Assembly,"Assembly Education Committee: Reported with Amendments",8,1,0,0,9
2031826,1593146,2025-06-19,Assembly,"Assembly Appropriations Committee: Reported with Amendments",8,3,0,0,11
2031852,1589913,2025-06-12,Assembly,"Assembly Commerce and Economic Development Committee: Reported with Amendments",7,2,3,0,12
2031929,1590972,2025-06-16,Assembly,"Assembly Science, Innovation and Technology Committee: Reported with Amendments",5,0,2,0,7
2031929,1595763,2025-06-26,Assembly,"Assembly Budget Committee: Reported Favorably",10,1,4,0,15
2031989,1590988,2025-06-16,Assembly,"Assembly Education Committee: Reported with Amendments",9,0,0,0,9
2032231,1576268,2025-05-22,Assembly,"Assembly Floor: Third Reading - Final Passage",58,18,4,0,80
2032406,1589896,2025-06-12,Senate,"Senate Commerce Committee: Reported Favorably",5,0,0,0,5
2032469,1576016,2025-05-22,Senate,"Senate Commerce Committee: Reported with Amendments",4,0,1,0,5
2032469,1583828,2025-06-02,Senate,"Senate Floor: Third Reading - Final Passage",26,11,3,0,40
2032495,1585706,2025-06-05,Senate,"Senate Labor Committee: Reported Favorably",5,0,0,0,5
2032495,1596733,2025-06-30,Assembly,"Assembly Floor: Substitute for A5692 (Voice Vote)",0,0,0,0,0
2032495,1596734,2025-06-30,Assembly,"Assembly Floor: Third Reading - Final Passage",78,1,1,0,80
2032495,1596735,2025-06-30,Senate,"Senate Floor: Third Reading - Final Passage",39,0,1,0,40
2032510,1592855,2025-06-19,Senate,"Senate State Government, Wagering, Tourism & Historic Preservation Committee: Reported with Amendments",5,0,0,0,5
2032516,1595814,2025-06-26,Senate,"Senate Budget and Appropriations Committee: Reported with Substitution",13,0,0,0,13
2033188,1589950,2025-06-12,Senate,"Senate Environment and Energy Committee: Reported Favorably",3,2,0,0,5
2033195,1586635,2025-06-09,Senate,"Senate Budget and Appropriations Committee: Reported Favorably",12,0,1,0,13
2033195,1596669,2025-06-30,Senate,"Senate Floor: Third Reading - Final Passage",39,0,1,0,40
2033212,1576705,2025-05-22,Assembly,"Assembly Floor: Third Reading - Final Passage",57,7,16,0,80
2033223,1590080,2025-06-12,Senate,"Senate Economic Growth Committee: Reported with Amendments",3,2,0,0,5
2033255,1581386,2025-05-29,Senate,"Senate Judiciary Committee: Reported Favorably",7,4,0,0,11
2033255,1595803,2025-06-26,Senate,"Senate Budget and Appropriations Committee: Reported with Amendments",9,4,0,0,13
2033255,1596862,2025-06-30,Senate,"Senate Floor: Third Reading - Final Passage",25,14,1,0,40
2033274,1589630,2025-06-12,Assembly,"Assembly Telecommunications and Utilities Committee: Reported with Amendments",7,1,0,0,8
2033274,1596665,2025-06-30,Assembly,"Assembly Floor: Amend",31,42,7,0,80
2033274,1596666,2025-06-30,Assembly,"Assembly Floor: Third Reading - Final Passage",61,18,1,0,80
2033274,1596667,2025-06-30,Senate,"Senate Floor: Substitute for S4532 (Voice Vote)",0,0,0,0,0
2033274,1596668,2025-06-30,Senate,"Senate Floor: Third Reading - Final Passage",30,9,1,0,40
2033278,1580948,2025-05-29,Senate,"Senate State Government, Wagering, Tourism & Historic Preservation Committee: Reported Favorably",5,0,0,0,5
2033314,1589956,2025-06-12,Senate,"Senate Commerce Committee: Reported Favorably",3,0,2,0,5
2033320,1590086,2025-06-12,Senate,"Senate Environment and Energy Committee: Reported Favorably",3,2,0,0,5
2033336,1589495,2025-06-12,Senate,"Senate Economic Growth Committee: Reported with Amendments",4,1,0,0,5
2033341,1589833,2025-06-12,Senate,"Senate Environment and Energy Committee: Reported Favorably",3,1,1,0,5
2033341,1596515,2025-06-30,Assembly,"Assembly Floor: Substitute for A5768 (Voice Vote)",0,0,0,0,0
2033341,1596949,2025-06-30,Assembly,"Assembly Floor: Third Reading - Final Passage",56,23,1,0,80
2033341,1596950,2025-06-30,Senate,"Senate Floor: Concur in Assembly Amendments",26,13,1,0,40
2033341,1596951,2025-06-30,Senate,"Senate Floor: Third Reading - Final Passage",25,14,1,0,40
2033391,1586750,2025-06-09,Senate,"Senate Budget and Appropriations Committee: Reported Favorably",12,0,1,0,13
2033391,1596693,2025-06-30,Senate,"Senate Floor: Third Reading - Final Passage",39,0,1,0,40
2033395,1585588,2025-06-05,Senate,"Senate Education Committee: Reported Favorably",5,0,0,0,5
2033398,1586598,2025-06-09,Senate,"Senate Budget and Appropriations Committee: Reported Favorably",12,0,1,0,13
2033398,1596990,2025-06-30,Assembly,"Assembly Floor: Substitute for A5858 (Voice Vote)",0,0,0,0,0
2033398,1596991,2025-06-30,Assembly,"Assembly Floor: Third Reading - Final Passage",79,0,1,0,80
2033398,1596992,2025-06-30,Senate,"Senate Floor: Third Reading - Final Passage",39,0,1,0,40
2033446,1590923,2025-06-16,Assembly,"Assembly Transportation and Independent Authorities Committee: Reported Favorably",11,0,2,0,13
2033446,1596811,2025-06-30,Assembly,"Assembly Floor: Third Reading - Final Passage",77,0,3,0,80
2033464,1590088,2025-06-12,Assembly,"Assembly Telecommunications and Utilities Committee: Reported Favorably",5,1,2,0,8
2033464,1595598,2025-06-26,Assembly,"Assembly Budget Committee: Reported with Amendments",10,5,0,0,15
2033464,1596062,2025-06-27,Assembly,"Assembly Budget Committee: Reported with Amendments",9,5,1,0,15
2034409,1586732,2025-06-09,Senate,"Senate Budget and Appropriations Committee: Reported Favorably",12,0,1,0,13
2034409,1596689,2025-06-30,Senate,"Senate Floor: Third Reading - Final Passage",39,0,1,0,40
2034431,1586703,2025-06-09,Senate,"Senate Budget and Appropriations Committee: Reported Favorably",12,0,1,0,13
2034431,1596691,2025-06-30,Senate,"Senate Floor: Third Reading - Final Passage",39,0,1,0,40
2034459,1586619,2025-06-09,Senate,"Senate Budget and Appropriations Committee: Reported Favorably",12,0,1,0,13
2034482,1586591,2025-06-09,Senate,"Senate Budget and Appropriations Committee: Reported Favorably",12,0,1,0,13
2034482,1596680,2025-06-30,Assembly,"Assembly Floor: Substitute for A5860 (Voice Vote)",0,0,0,0,0
2034482,1596681,2025-06-30,Assembly,"Assembly Floor: Third Reading - Final Passage",79,1,0,0,80
2034482,1596682,2025-06-30,Senate,"Senate Floor: Third Reading - Final Passage",39,0,1,0,40
2034524,1586731,2025-06-09,Senate,"Senate Budget and Appropriations Committee: Reported Favorably",12,0,1,0,13
2034524,1596985,2025-06-30,Senate,"Senate Floor: Third Reading - Final Passage",39,0,1,0,40
2035091,1589892,2025-06-12,Senate,"Senate Commerce Committee: Reported Favorably",5,0,0,0,5
2035178,1595906,2025-06-26,Senate,"Senate Budget and Appropriations Committee: Reported with Amendments",13,0,0,0,13
2037023,1590997,2025-06-16,Assembly,"Assembly Education Committee: Reported with Amendments",9,0,0,0,9
2037053,1593152,2025-06-19,Assembly,"Assembly Appropriations Committee: Reported Favorably",8,2,1,0,11
2037053,1596643,2025-06-30,Assembly,"Assembly Floor: Third Reading - Final Passage",58,19,3,0,80
2037053,1596644,2025-06-30,Senate,"Senate Floor: Substitute for S4619 (Voice Vote)",0,0,0,0,0
2037053,1596645,2025-06-30,Senate,"Senate Floor: Third Reading - Final Passage",26,13,1,0,40
2037056,1595922,2025-06-26,Senate,"Senate Budget and Appropriations Committee: Reported Favorably",11,2,0,0,13
2037068,1590985,2025-06-16,Assembly,"Assembly Labor Committee: Reported with Amendments",12,0,0,0,12
2037068,1596545,2025-06-30,Senate,"Senate Floor: Substitute for S4590 (Voice Vote)",0,0,0,0,0
2037068,1596852,2025-06-30,Assembly,"Assembly Floor: Third Reading - Final Passage",80,0,0,0,80
2037068,1596853,2025-06-30,Senate,"Senate Floor: Third Reading - Final Passage",39,0,1,0,40
2037076,1595792,2025-06-26,Senate,"Senate Budget and Appropriations Committee: Reported with Amendments",13,0,0,0,13
2037112,1590114,2025-06-12,Assembly,"Assembly Commerce and Economic Development Committee: Reported Favorably",8,1,3,0,12
2037112,1595761,2025-06-26,Assembly,"Assembly Budget Committee: Reported Favorably",15,0,0,0,15
2037112,1596603,2025-06-30,Assembly,"Assembly Floor: Third Reading - Final Passage",79,0,1,0,80
2037128,1590967,2025-06-16,Assembly,"Assembly Education Committee: Reported Favorably",8,0,1,0,9
2037141,1593055,2025-06-19,Assembly,"Assembly Housing and Community Development Committee: Reported Favorably",6,0,1,0,7
2037145,1596050,2025-06-26,Senate,"Senate Budget and Appropriations Committee: Reported with Amendments",12,1,0,0,13
2037145,1596591,2025-06-30,Assembly,"Assembly Floor: Substitute for A5827 (Voice Vote)",0,0,0,0,0
2037145,1596926,2025-06-30,Assembly,"Assembly Floor: Third Reading - Final Passage",63,16,1,0,80
2037145,1596927,2025-06-30,Senate,"Senate Floor: Third Reading - Final Passage",30,4,6,0,40
2037153,1590956,2025-06-16,Assembly,"Assembly Transportation and Independent Authorities Committee: Reported Favorably",11,0,2,0,13
2037161,1595920,2025-06-26,Senate,"Senate Budget and Appropriations Committee: Reported Favorably",9,3,1,0,13
2037163,1595739,2025-06-26,Assembly,"Assembly Budget Committee: Reported Favorably",15,0,0,0,15
2037163,1596474,2025-06-30,Assembly,"Assembly Floor: Table Motion (Voice Vote)",0,0,0,0,0
2037163,1596829,2025-06-30,Assembly,"Assembly Floor: Third Reading - Final Passage",65,5,10,0,80
2037170,1593063,2025-06-19,Assembly,"Assembly Appropriations Committee: Reported Favorably",11,0,0,0,11
2037170,1596646,2025-06-30,Assembly,"Assembly Floor: Third Reading - Final Passage",79,1,0,0,80
2037170,1596647,2025-06-30,Senate,"Senate Floor: Substitute for S4608 (Voice Vote)",0,0,0,0,0
2037170,1596648,2025-06-30,Senate,"Senate Floor: Third Reading - Final Passage",36,3,1,0,40
2037171,1593242,2025-06-19,Assembly,"Assembly Appropriations Committee: Reported Favorably",7,3,1,0,11
2037171,1596064,2025-06-27,Assembly,"Assembly Budget Committee: Reported with Amendments",11,3,1,0,15
2037171,1596859,2025-06-30,Assembly,"Assembly Floor: Reconsidered Vote",66,9,5,0,80
2037171,1596860,2025-06-30,Assembly,"Assembly Floor: Third Reading - Final Passage",62,16,2,0,80
2037324,1593062,2025-06-19,Assembly,"Assembly Public Safety and Preparedness Committee Committee: Reported Favorably",8,0,1,0,9
2037324,1596883,2025-06-30,Assembly,"Assembly Floor: Third Reading - Final Passage",80,0,0,0,80
2037326,1593058,2025-06-19,Assembly,"Assembly Appropriations Committee: Reported Favorably",7,2,2,0,11
2037326,1593059,2025-06-19,Assembly,"Assembly Financial Institutions and Insurance Committee: Reported with Amendments",10,0,3,0,13
2037326,1596635,2025-06-30,Assembly,"Assembly Floor: Third Reading - Final Passage",68,2,10,0,80
2037403,1593271,2025-06-19,Assembly,"Assembly Appropriations Committee: Reported Favorably",11,0,0,0,11
2037404,1593239,2025-06-19,Assembly,"Assembly Appropriations Committee: Reported with Amendments",11,0,0,0,11
2037405,1593157,2025-06-19,Assembly,"Assembly Appropriations Committee: Reported Favorably",11,0,0,0,11
2037409,1593243,2025-06-19,Assembly,"Assembly Appropriations Committee: Reported Favorably",11,0,0,0,11
2037411,1593140,2025-06-19,Assembly,"Assembly Appropriations Committee: Reported with Amendments",11,0,0,0,11
2037412,1593236,2025-06-19,Assembly,"Assembly Appropriations Committee: Reported Favorably",11,0,0,0,11
2037413,1593051,2025-06-19,Assembly,"Assembly Appropriations Committee: Reported with Amendments",11,0,0,0,11
2037413,1596670,2025-06-30,Assembly,"Assembly Floor: Third Reading - Final Passage",80,0,0,0,80
2037413,1596671,2025-06-30,Senate,"Senate Floor: Substitute for S4621 (Voice Vote)",0,0,0,0,0
2037413,1596672,2025-06-30,Senate,"Senate Floor: Third Reading - Final Passage",39,0,1,0,40
2037416,1593249,2025-06-19,Assembly,"Assembly Appropriations Committee: Reported Favorably",11,0,0,0,11
2037418,1593154,2025-06-19,Assembly,"Assembly Appropriations Committee: Reported Favorably",11,0,0,0,11
2037421,1593250,2025-06-19,Assembly,"Assembly Appropriations Committee: Reported Favorably",11,0,0,0,11
2037422,1593234,2025-06-19,Assembly,"Assembly Appropriations Committee: Reported Favorably",11,0,0,0,11
2037424,1595616,2025-06-26,Assembly,"Assembly Budget Committee: Reported with Amendments",15,0,0,0,15
2037424,1596513,2025-06-30,Senate,"Senate Floor: Substitute for S4614 (Voice Vote)",0,0,0,0,0
2037424,1596771,2025-06-30,Assembly,"Assembly Floor: Third Reading - Final Passage",79,0,1,0,80
2037424,1596772,2025-06-30,Senate,"Senate Floor: Third Reading - Final Passage",39,0,1,0,40
2037425,1593235,2025-06-19,Assembly,"Assembly Appropriations Committee: Reported Favorably",11,0,0,0,11
2037700,1595780,2025-06-26,Senate,"Senate Budget and Appropriations Committee: Reported Favorably",13,0,0,0,13
2037704,1595917,2025-06-26,Senate,"Senate Budget and Appropriations Committee: Reported Favorably",9,4,0,0,13
2037704,1596604,2025-06-30,Assembly,"Assembly Floor: Substitute for A5879 (Voice Vote)",0,0,0,0,0
2037704,1596605,2025-06-30,Assembly,"Assembly Floor: Third Reading - Final Passage",51,25,4,0,80
2037704,1596606,2025-06-30,Senate,"Senate Floor: Third Reading - Final Passage",25,14,1,0,40
2037783,1595766,2025-06-26,Assembly,"Assembly Budget Committee: Reported Favorably",15,0,0,0,15
2037783,1596879,2025-06-30,Assembly,"Assembly Floor: Third Reading - Final Passage",76,1,3,0,80
2037785,1595772,2025-06-26,Assembly,"Assembly Budget Committee: Reported Favorably",10,5,0,0,15
2037796,1595918,2025-06-26,Senate,"Senate Budget and Appropriations Committee: Reported with Amendments",13,0,0,0,13
2037796,1596609,2025-06-30,Assembly,"Assembly Floor: Substitute for A5812 (Voice Vote)",0,0,0,0,0
2037796,1596610,2025-06-30,Assembly,"Assembly Floor: Third Reading - Final Passage",79,0,1,0,80
2037796,1596611,2025-06-30,Senate,"Senate Floor: Third Reading - Final Passage",39,0,1,0,40
2037806,1595867,2025-06-26,Senate,"Senate Budget and Appropriations Committee: Reported Favorably",13,0,0,0,13
2037806,1596519,2025-06-30,Assembly,"Assembly Floor: Substitute for A5878 (Voice Vote)",0,0,0,0,0
2037806,1596795,2025-06-30,Assembly,"Assembly Floor: Third Reading - Final Passage",73,2,5,0,80
2037806,1596796,2025-06-30,Senate,"Senate Floor: Third Reading - Final Passage",36,0,4,0,40
2037906,1595828,2025-06-26,Senate,"Senate Budget and Appropriations Committee: Reported with Substitution",9,4,0,0,13
2037917,1595923,2025-06-26,Senate,"Senate Budget and Appropriations Committee: Reported Favorably",13,0,0,0,13
2037919,1595823,2025-06-26,Senate,"Senate Budget and Appropriations Committee: Reported with Amendments",9,4,0,0,13
2037922,1595883,2025-06-26,Senate,"Senate Budget and Appropriations Committee: Reported Favorably",13,0,0,0,13
2037924,1595927,2025-06-26,Senate,"Senate Budget and Appropriations Committee: Reported with Substitution",9,4,0,0,13
2038006,1595624,2025-06-26,Assembly,"Assembly Budget Committee: Reported Favorably",14,1,0,0,15
2038187,1595921,2025-06-26,Senate,"Senate Budget and Appropriations Committee: Reported Favorably",9,4,0,0,13
2038190,1595832,2025-06-26,Senate,"Senate Budget and Appropriations Committee: Reported with Amendments",8,4,1,0,13
2038382,1595769,2025-06-26,Assembly,"Assembly Budget Committee: Reported Favorably",14,0,1,0,15
2038385,1595743,2025-06-26,Assembly,"Assembly Budget Committee: Reported Favorably",8,5,2,0,15
2038385,1596536,2025-06-30,Senate,"Senate Floor: Substitute for S4666 (Voice Vote)",0,0,0,0,0
2038385,1596823,2025-06-30,Assembly,"Assembly Floor: Third Reading - Final Passage",41,37,2,0,80
2038385,1596824,2025-06-30,Senate,"Senate Floor: Third Reading - Final Passage",21,14,5,0,40
2038388,1595773,2025-06-26,Assembly,"Assembly Budget Committee: Reported Favorably",9,5,1,0,15
2038388,1596457,2025-06-30,Senate,"Senate Floor: Substitute for S3064 (Voice Vote)",0,0,0,0,0
2038388,1596918,2025-06-30,Assembly,"Assembly Floor: Third Reading - Final Passage",46,33,1,0,80
2038388,1596919,2025-06-30,Senate,"Senate Floor: Third Reading - Final Passage",25,14,1,0,40
2038394,1595770,2025-06-26,Assembly,"Assembly Budget Committee: Reported Favorably",9,5,1,0,15
2038394,1596447,2025-06-30,Senate,"Senate Floor: Substitute for S4659 (Voice Vote)",0,0,0,0,0
2038394,1596915,2025-06-30,Assembly,"Assembly Floor: Third Reading - Final Passage",46,33,1,0,80
2038394,1596916,2025-06-30,Senate,"Senate Floor: Third Reading - Final Passage",25,14,1,0,40
2038396,1595771,2025-06-26,Assembly,"Assembly Budget Committee: Reported Favorably",9,0,6,0,15
2038400,1596061,2025-06-27,Assembly,"Assembly Budget Committee: Reported with Amendments",10,0,5,0,15
2038400,1596075,2025-06-27,Assembly,"Assembly Budget Committee: Reported Favorably",10,0,5,0,15
2038400,1596701,2025-06-30,Assembly,"Assembly Floor: Third Reading - Final Passage",60,18,2,0,80
2038404,1595641,2025-06-26,Assembly,"Assembly Budget Committee: Reported Favorably",9,3,3,0,15
2038404,1596487,2025-06-30,Senate,"Senate Floor: Substitute for S4656 (Voice Vote)",0,0,0,0,0
2038404,1596847,2025-06-30,Assembly,"Assembly Floor: Third Reading - Final Passage",48,28,4,0,80
2038404,1596848,2025-06-30,Senate,"Senate Floor: Third Reading - Final Passage",25,14,1,0,40
2038406,1595642,2025-06-26,Assembly,"Assembly Budget Committee: Reported Favorably",9,5,1,0,15
2038406,1596507,2025-06-30,Senate,"Senate Floor: Substitute for S4692 (Voice Vote)",0,0,0,0,0
2038406,1596730,2025-06-30,Assembly,"Assembly Floor: Third Reading - Final Passage",51,28,1,0,80
2038406,1596731,2025-06-30,Senate,"Senate Floor: Third Reading - Final Passage",25,14,1,0,40
2038407,1595643,2025-06-26,Assembly,"Assembly Budget Committee: Reported Favorably",9,1,5,0,15
2038559,1596054,2025-06-26,Senate,"Senate Budget and Appropriations Committee: Reported Favorably",9,4,0,0,13
2038561,1596074,2025-06-27,Assembly,"Assembly Budget Committee: Reported Favorably",9,5,1,0,15
2038561,1596593,2025-06-30,Assembly,"Assembly Floor: Third Reading - Final Passage",53,27,0,0,80
2038561,1596594,2025-06-30,Senate,"Senate Floor: Substitute for S4655 (Voice Vote)",0,0,0,0,0
2038561,1596595,2025-06-30,Senate,"Senate Floor: Third Reading - Final Passage",25,14,1,0,40
2038563,1596073,2025-06-27,Assembly,"Assembly Budget Committee: Reported Favorably",13,0,2,0,15
2038563,1596697,2025-06-30,Assembly,"Assembly Floor: Third Reading - Final Passage",80,0,0,0,80
2038563,1596698,2025-06-30,Senate,"Senate Floor: Substitute for S4660 (Voice Vote)",0,0,0,0,0
2038563,1596699,2025-06-30,Senate,"Senate Floor: Third Reading - Final Passage",39,0,1,0,40
2038564,1596071,2025-06-27,Assembly,"Assembly Budget Committee: Reported Favorably",9,3,3,0,15
2038564,1596482,2025-06-30,Senate,"Senate Floor: Substitute for S4695 (Voice Vote)",0,0,0,0,0
2038564,1596816,2025-06-30,Assembly,"Assembly Floor: Third Reading - Final Passage",56,24,0,0,80
2038564,1596817,2025-06-30,Senate,"Senate Floor: Third Reading - Final Passage",31,6,3,0,40
2038568,1596063,2025-06-27,Assembly,"Assembly Budget Committee: Reported Favorably",9,3,3,0,15
2038568,1599083,2025-07-24,Assembly,"Assembly State and Local Government Committee: Reported with Amendments",7,0,0,0,7
2038569,1595955,2025-06-26,Senate,"Senate Budget and Appropriations Committee: Reported Favorably",9,4,0,0,13
2038569,1596554,2025-06-30,Assembly,"Assembly Floor: Substitute for A5800 (Voice Vote)",0,0,0,0,0
2038569,1596869,2025-06-30,Assembly,"Assembly Floor: Table Motion",44,28,8,0,80
2038569,1596870,2025-06-30,Assembly,"Assembly Floor: Third Reading - Final Passage",52,27,1,0,80
2038569,1596871,2025-06-30,Senate,"Senate Floor: Table Motion",25,14,1,0,40
2038569,1596872,2025-06-30,Senate,"Senate Floor: Third Reading - Final Passage",26,13,1,0,40
2038571,1596072,2025-06-27,Assembly,"Assembly Budget Committee: Reported Favorably",9,5,1,0,15
