bill_id,roll_call_id,date,chamber,description,yea,nay,nv,absent,total
1897823,1565431,2025-05-05,Senate,"Senate Codes Committee Vote",12,1,0,0,13
1897825,1503961,2025-02-04,Senate,"Senate Cultural Affairs, Tourism, Parks And Recreation Committee Vote",6,0,0,1,7
1897825,1503962,2025-03-03,Senate,"Senate Floor Vote - Final Passage",44,17,0,2,63
1897825,1540501,2025-04-08,Senate,"Senate Floor Vote - Final Passage",45,17,0,1,63
1897829,1590770,2025-06-13,Assembly,"Assembly Rules Committee: Favorable",29,0,0,2,31
1897829,1590771,2025-06-13,Assembly,"Assembly Ways And Means Committee: Favorable refer to committee Rules",32,0,0,3,35
1897832,1570903,2025-02-04,Senate,"Senate Crime Victims, Crime And Correction Committee Vote",7,0,0,0,7
1897832,1570904,2025-05-13,Senate,"Senate Floor Vote - Final Passage",57,0,0,5,62
1897835,1479860,2025-02-04,Senate,"Senate Social Services Committee Vote",7,0,0,0,7
1897846,1472623,2025-01-21,Senate,"Senate Floor Vote - Final Passage",39,20,0,4,63
1897846,1472624,2025-01-21,Senate,"Senate Health Committee Vote",9,5,0,1,15
1897846,1472903,2025-01-21,Senate,"Senate Rules Committee Vote",13,6,0,2,21
1897849,1581694,2025-02-03,Senate,"Senate Insurance Committee Vote",11,0,0,0,11
1897849,1581695,2025-05-29,Senate,"Senate Floor Vote - Final Passage",55,1,0,7,63
1897861,1571612,2025-01-27,Senate,"Senate Codes Committee Vote",12,0,0,1,13
1897861,1571613,2025-05-14,Senate,"Senate Floor Vote - Final Passage",57,0,0,5,62
1897864,1580576,2025-01-27,Senate,"Senate Housing, Construction And Community Development Committee Vote",8,3,0,0,11
1897864,1580577,2025-05-28,Senate,"Senate Floor Vote - Final Passage",40,21,0,2,63
1897870,1506222,2025-02-11,Senate,"Senate Environmental Conservation Committee Vote",11,0,0,0,11
1897870,1506223,2025-03-05,Senate,"Senate Floor Vote - Final Passage",61,0,0,2,63
1897870,1588011,2025-06-10,Senate,"Senate Floor Vote - Final Passage",58,0,0,5,63
1897875,1503881,2025-02-24,Senate,"Senate Codes Committee Vote",13,0,0,0,13
1897875,1503882,2025-03-03,Senate,"Senate Floor Vote - Final Passage",59,2,0,2,63
1897881,1585250,2025-05-27,Senate,"Senate New York City Education Committee Vote",6,0,0,0,6
1897881,1585251,2025-06-04,Senate,"Senate Floor Vote - Final Passage",58,0,0,5,63
1897886,1586211,2025-03-04,Senate,"Senate Finance Committee Vote",21,0,0,1,22
1897886,1586212,2025-06-06,Senate,"Senate Floor Vote - Final Passage",52,1,0,10,63
1897903,1473210,2025-01-22,Senate,"Senate Social Services Committee Vote",7,0,0,0,7
1897916,1525026,2025-02-25,Senate,"Senate Banks Committee Vote",5,2,0,0,7
1897916,1525027,2025-03-24,Senate,"Senate Floor Vote - Final Passage",37,22,0,4,63
1897932,1579460,2025-04-29,Senate,"Senate Investigations And Government Operations Committee Vote",7,0,0,0,7
1897932,1588922,2025-05-27,Senate,"Senate Floor Vote - Final Passage",51,8,0,4,63
1897932,1589824,2025-06-11,Assembly,"Assembly Floor Vote - Final Passage",119,27,0,4,150
1897933,1475636,2025-01-28,Senate,"Senate Cities 1 Committee Vote",7,0,0,0,7
1897943,1486415,2025-02-03,Senate,"Senate Higher Education Committee Vote",11,0,0,0,11
1897943,1486416,2025-02-11,Senate,"Senate Floor Vote - Final Passage",61,0,0,2,63
1897949,1580439,2025-01-21,Senate,"Senate Energy And Telecommunications Committee Vote",8,1,0,0,9
1897949,1580440,2025-05-28,Senate,"Senate Floor Vote - Final Passage",60,1,0,2,63
1897953,1498533,2025-01-21,Senate,"Senate Health Committee Vote",14,0,0,1,15
1897953,1498534,2025-02-24,Senate,"Senate Floor Vote - Final Passage",60,0,0,3,63
1897955,1504018,2025-02-04,Senate,"Senate Health Committee Vote",15,0,0,0,15
1897955,1504019,2025-03-03,Senate,"Senate Floor Vote - Final Passage",61,0,0,2,63
1897957,1576762,2025-02-04,Senate,"Senate Banks Committee Vote",5,2,0,0,7
1897957,1576763,2025-05-21,Senate,"Senate Floor Vote - Final Passage",37,22,0,3,62
1897958,1526412,2025-03-25,Assembly,"Assembly People With Disabilities Committee: Favorable refer to committee Ways and Means",9,0,0,0,9
1897958,1570348,2025-05-13,Assembly,"Assembly Rules Committee: Favorable",28,0,0,3,31
1897958,1570349,2025-05-13,Assembly,"Assembly Ways And Means Committee: Favorable refer to committee Rules",34,0,0,1,35
1897958,1571152,2025-05-13,Assembly,"Assembly Floor Vote - Final Passage",145,0,0,5,150
1897958,1588691,2025-06-10,Senate,"Senate Floor Vote - Final Passage",58,0,0,5,63
1897971,1563332,2025-04-29,Senate,"Senate Health Committee Vote",9,5,0,0,14
1897971,1581438,2025-05-29,Senate,"Senate Rules Committee Vote",13,7,0,1,21
1897971,1587096,2025-06-09,Senate,"Senate Floor Vote - Final Passage",37,25,0,1,63
1897972,1570106,2025-05-13,Assembly,"Assembly Judiciary Committee: Favorable",14,6,0,1,21
1897972,1581007,2025-05-28,Assembly,"Assembly Floor Vote - Final Passage",95,49,0,6,150
1897977,1539392,2025-04-08,Assembly,"Assembly Health Committee: Favorable refer to committee Ways and Means",24,0,0,2,26
1897977,1574283,2025-05-20,Assembly,"Assembly Ways And Means Committee: Favorable refer to committee Rules",35,0,0,0,35
1897977,1579091,2025-05-27,Assembly,"Assembly Rules Committee: Favorable",26,0,0,5,31
1897977,1585909,2025-06-05,Assembly,"Assembly Floor Vote - Final Passage",144,0,0,6,150
1897977,1590477,2025-06-12,Senate,"Senate Floor Vote - Final Passage",57,2,0,4,63
1897981,1473166,2025-01-22,Senate,"Senate Social Services Committee Vote",7,0,0,0,7
1897981,1513043,2025-03-11,Senate,"Senate Finance Committee Vote",20,1,0,1,22
1897981,1588015,2025-06-10,Senate,"Senate Floor Vote - Final Passage",58,0,0,5,63
1897984,1479743,2025-02-04,Senate,"Senate Labor Committee Vote",13,0,0,0,13
1897984,1504556,2025-03-04,Senate,"Senate Finance Committee Vote",18,3,0,1,22
1897984,1505260,2025-03-04,Senate,"Senate Floor Vote - Final Passage",50,11,0,2,63
1897984,1505730,2025-03-04,Senate,"Senate Rules Committee Vote",16,4,0,1,21
1897988,1590133,2025-02-25,Senate,"Senate Energy And Telecommunications Committee Vote",7,2,0,0,9
1897988,1590591,2025-06-12,Senate,"Senate Floor Vote - Final Passage",37,22,0,4,63
1898001,1475340,2025-01-28,Senate,"Senate Aging Committee Vote",7,0,0,0,7
1898001,1515282,2025-03-11,Senate,"Senate Finance Committee Vote",21,0,0,1,22
1898001,1522342,2025-03-20,Senate,"Senate Floor Vote - Final Passage",59,0,0,4,63
1898006,1559653,2025-04-29,Senate,"Senate Children And Families Committee Vote",7,0,0,0,7
1898008,1498307,2025-02-24,Assembly,"Assembly Labor Committee: Favorable refer to committee Ways and Means",29,0,0,0,29
1898008,1579388,2025-05-27,Assembly,"Assembly Ways And Means Committee: Favorable refer to committee Rules",32,0,0,3,35
1898008,1581519,2025-05-29,Assembly,"Assembly Rules Committee: Favorable",27,0,0,4,31
1898008,1582198,2025-05-29,Assembly,"Assembly Floor Vote - Final Passage",146,0,0,4,150
1898012,1579205,2025-05-27,Senate,"Senate New York City Education Committee Vote",6,0,0,0,6
1898013,1472643,2025-01-21,Senate,"Senate Floor Vote - Final Passage",39,20,0,4,63
1898013,1472898,2025-01-21,Senate,"Senate Rules Committee Vote",13,6,0,2,21
1898013,1473444,2025-01-22,Assembly,"Assembly Floor Vote - Final Passage",95,42,0,13,150
1898016,1475419,2025-01-28,Assembly,"Assembly Corporations, Authorities And Commissions Committee: Favorable refer to committee Ways and Means",26,0,0,0,26
1898016,1538032,2025-04-07,Assembly,"Assembly Rules Committee: Favorable",29,0,0,2,31
1898016,1538033,2025-04-07,Assembly,"Assembly Ways And Means Committee: Favorable refer to committee Rules",33,0,0,2,35
1898016,1541381,2025-04-08,Assembly,"Assembly Floor Vote - Final Passage",147,0,0,3,150
1898016,1586204,2025-06-05,Senate,"Senate Floor Vote - Final Passage",60,0,0,3,63
1898018,1589339,2025-06-09,Senate,"Senate Rules Committee Vote",20,1,0,0,21
1898018,1589670,2025-06-11,Senate,"Senate Floor Vote - Final Passage",45,14,0,4,63
1898020,1570557,2025-03-10,Senate,"Senate Codes Committee Vote",13,0,0,0,13
1898020,1570558,2025-05-13,Senate,"Senate Floor Vote - Final Passage",57,0,0,5,62
1898020,1590705,2025-06-12,Senate,"Senate Floor Vote - Final Passage",59,0,0,4,63
1898032,1574349,2025-05-20,Assembly,"Assembly Judiciary Committee: Held for Consideration",14,6,0,1,21
1898034,1486580,2025-02-03,Senate,"Senate Higher Education Committee Vote",11,0,0,0,11
1898034,1486581,2025-02-11,Senate,"Senate Floor Vote - Final Passage",61,0,0,2,63
1898040,1580693,2025-05-14,Senate,"Senate Local Government Committee Vote",6,0,0,1,7
1898040,1580694,2025-05-28,Senate,"Senate Floor Vote - Final Passage",61,0,0,2,63
1898041,1587183,2025-06-04,Senate,"Senate Rules Committee Vote",13,7,0,1,21
1898041,1587184,2025-06-09,Senate,"Senate Floor Vote - Final Passage",42,20,0,1,63
1898042,1539484,2025-04-08,Senate,"Senate Crime Victims, Crime And Correction Committee Vote",5,2,0,0,7
1898055,1540219,2025-04-08,Senate,"Senate Labor Committee Vote",12,1,0,0,13
1898055,1579435,2025-05-27,Senate,"Senate Disabilities Committee Vote",6,0,0,0,6
1898058,1498967,2025-02-25,Assembly,"Assembly Governmental Operations Committee: Favorable",13,0,0,1,14
1898058,1504144,2025-03-03,Assembly,"Assembly Floor Vote - Final Passage",148,0,0,2,150
1898058,1588270,2025-06-10,Senate,"Senate Floor Vote - Final Passage",58,0,0,5,63
1898069,1509542,2025-01-28,Senate,"Senate Consumer Protection Committee Vote",7,0,0,0,7
1898069,1509543,2025-03-10,Senate,"Senate Floor Vote - Final Passage",59,2,0,2,63
1898069,1589090,2025-06-10,Assembly,"Assembly Floor Vote - Final Passage",97,49,0,4,150
1898073,1471291,2025-01-13,Senate,"Senate Floor Vote - Final Passage",40,21,0,2,63
1898073,1471292,2025-01-13,Senate,"Senate Rules Committee Vote",14,7,0,0,21
1898085,1497679,2025-02-03,Senate,"Senate Investigations And Government Operations Committee Vote",7,0,0,0,7
1898085,1497680,2025-02-24,Senate,"Senate Floor Vote - Final Passage",59,1,0,3,63
1898085,1587220,2025-06-09,Assembly,"Assembly Floor Vote - Final Passage",144,0,0,6,150
1898087,1473220,2025-01-22,Senate,"Senate Social Services Committee Vote",7,0,0,0,7
1898087,1581825,2025-05-29,Senate,"Senate Rules Committee Vote",20,0,0,1,21
1898087,1585130,2025-06-04,Senate,"Senate Floor Vote - Final Passage",58,0,0,5,63
1898090,1563320,2025-04-29,Senate,"Senate Health Committee Vote",10,4,0,0,14
1898090,1585556,2025-06-04,Senate,"Senate Rules Committee Vote",14,6,0,1,21
1898090,1591072,2025-06-11,Senate,"Senate Floor Vote - Final Passage",38,21,0,4,63
1898091,1589928,2025-05-20,Senate,"Senate Transportation Committee Vote",13,0,0,0,13
1898091,1590461,2025-06-12,Senate,"Senate Floor Vote - Final Passage",58,1,0,4,63
1898104,1570810,2025-02-03,Senate,"Senate Higher Education Committee Vote",11,0,0,0,11
1898104,1570811,2025-05-13,Senate,"Senate Floor Vote - Final Passage",56,1,0,5,62
1898107,1475258,2025-01-27,Senate,"Senate Housing, Construction And Community Development Committee Vote",10,1,0,0,11
1898108,1571694,2025-04-29,Senate,"Senate Social Services Committee Vote",6,0,0,0,6
1898108,1571695,2025-05-14,Senate,"Senate Floor Vote - Final Passage",57,0,0,5,62
1898108,1575772,2025-05-21,Assembly,"Assembly Floor Vote - Final Passage",144,0,0,6,150
1898113,1499238,2025-02-25,Assembly,"Assembly Governmental Operations Committee: Favorable refer to committee Ways and Means",8,5,0,1,14
1898116,1505906,2025-02-25,Senate,"Senate Environmental Conservation Committee Vote",11,0,0,0,11
1898116,1505907,2025-03-05,Senate,"Senate Floor Vote - Final Passage",61,0,0,2,63
1898116,1590603,2025-06-12,Senate,"Senate Floor Vote - Final Passage",57,2,0,4,63
1898116,1592517,2025-06-17,Assembly,"Assembly Floor Vote - Final Passage",91,50,0,9,150
1898118,1486049,2025-02-11,Assembly,"Assembly Housing Committee: Favorable",18,9,0,1,28
1898118,1536221,2025-04-02,Assembly,"Assembly Floor Vote - Final Passage",84,64,0,2,150
1898118,1590495,2025-06-12,Senate,"Senate Floor Vote - Final Passage",37,22,0,4,63
1898442,1505932,2025-02-10,Senate,"Senate Transportation Committee Vote",13,0,0,0,13
1898442,1505933,2025-03-05,Senate,"Senate Floor Vote - Final Passage",60,1,0,2,63
1898444,1580344,2025-05-28,Assembly,"Assembly Transportation Committee: Held for Consideration",16,7,0,3,26
1898453,1498891,2025-02-25,Assembly,"Assembly Codes Committee: Favorable",15,6,0,1,22
1898458,1480395,2025-01-27,Senate,"Senate Rules Committee Vote",20,0,0,1,21
1898458,1480396,2025-02-04,Senate,"Senate Floor Vote - Final Passage",61,0,0,2,63
1898469,1498369,2025-02-24,Assembly,"Assembly Insurance Committee: Favorable",22,0,0,3,25
1898469,1504999,2025-03-03,Assembly,"Assembly Floor Vote - Final Passage",148,0,0,2,150
1898469,1586199,2025-06-06,Senate,"Senate Floor Vote - Final Passage",53,0,0,10,63
1898475,1498513,2025-01-21,Senate,"Senate Health Committee Vote",14,0,0,1,15
1898475,1498514,2025-02-24,Senate,"Senate Floor Vote - Final Passage",60,0,0,3,63
1898502,1532712,2025-03-18,Senate,"Senate Local Government Committee Vote",7,0,0,0,7
1898502,1532713,2025-04-01,Senate,"Senate Floor Vote - Final Passage",63,0,0,0,63
1898503,1574320,2025-05-20,Assembly,"Assembly Higher Education Committee: Favorable refer to committee Codes",23,0,0,3,26
1898503,1585435,2025-06-05,Assembly,"Assembly Codes Committee: Favorable refer to committee Ways and Means",21,0,0,1,22
1898503,1585938,2025-06-06,Assembly,"Assembly Ways And Means Committee: Favorable refer to committee Rules",35,0,0,0,35
1898513,1515823,2025-03-04,Senate,"Senate Finance Committee Vote",21,0,0,1,22
1898513,1516439,2025-03-12,Senate,"Senate Floor Vote - Final Passage",60,0,0,3,63
1898516,1517081,2025-03-12,Senate,"Senate Budget And Revenue Committee Vote",6,0,0,1,7
1898517,1498633,2025-02-25,Assembly,"Assembly Real Property Taxation Committee: Favorable refer to committee Ways and Means",10,0,0,0,10
1898517,1578999,2025-05-27,Assembly,"Assembly Ways And Means Committee: Favorable refer to committee Rules",32,0,0,3,35
1898517,1591868,2025-05-27,Assembly,"Assembly Ways And Means Committee: Favorable refer to committee Rules",32,0,0,3,35
1898520,1534421,2025-04-02,Assembly,"Assembly Correction Committee: Favorable refer to committee Codes",8,4,0,1,13
1898525,1560995,2025-04-29,Senate,"Senate Local Government Committee Vote",7,0,0,0,7
1898525,1587178,2025-06-09,Senate,"Senate Rules Committee Vote",21,0,0,0,21
1898525,1588399,2025-06-10,Senate,"Senate Floor Vote - Final Passage",58,0,0,5,63
1898527,1579544,2025-05-28,Assembly,"Assembly Housing Committee: Favorable refer to committee Codes",21,6,0,1,28
1898527,1585508,2025-06-05,Assembly,"Assembly Codes Committee: Favorable refer to committee Rules",15,6,0,1,22
1898530,1573861,2025-05-20,Assembly,"Assembly Children And Families Committee: Favorable refer to committee Rules",16,0,0,1,17
1898530,1588004,2025-06-10,Assembly,"Assembly Rules Committee: Favorable",28,0,0,3,31
1898530,1589600,2025-06-11,Assembly,"Assembly Floor Vote - Final Passage",133,5,0,12,150
1898541,1578973,2025-05-27,Assembly,"Assembly Education Committee: Favorable refer to committee Rules",28,0,0,3,31
1898549,1514334,2025-01-27,Senate,"Senate Housing, Construction And Community Development Committee Vote",10,1,0,0,11
1898549,1514335,2025-03-11,Senate,"Senate Floor Vote - Final Passage",59,2,0,2,63
1898556,1586887,2025-06-09,Assembly,"Assembly Ways And Means Committee: Favorable refer to committee Rules",31,0,0,4,35
1898556,1587327,2025-06-10,Assembly,"Assembly Rules Committee: Favorable",28,0,0,3,31
1898556,1589507,2025-06-11,Assembly,"Assembly Floor Vote - Final Passage",146,0,0,4,150
1898556,1589508,2025-06-11,Senate,"Senate Floor Vote - Final Passage",58,1,0,4,63
1898557,1579732,2025-05-28,Assembly,"Assembly Transportation Committee: Held for Consideration",16,7,0,3,26
1898571,1565810,2025-05-06,Assembly,"Assembly Energy Committee: Favorable refer to committee Ways and Means",12,4,0,1,17
1898577,1580272,2025-05-20,Senate,"Senate Social Services Committee Vote",6,0,0,0,6
1898577,1580273,2025-05-28,Senate,"Senate Floor Vote - Final Passage",60,1,0,2,63
1898579,1580021,2025-05-28,Assembly,"Assembly Insurance Committee: Favorable refer to committee Rules",22,2,0,1,25
1898579,1584917,2025-06-04,Assembly,"Assembly Rules Committee: Favorable",28,0,0,3,31
1898579,1588156,2025-06-10,Senate,"Senate Floor Vote - Final Passage",56,2,0,5,63
1898579,1589005,2025-06-10,Assembly,"Assembly Floor Vote - Final Passage",145,0,0,5,150
1898605,1479844,2025-02-04,Senate,"Senate Social Services Committee Vote",7,0,0,0,7
1898605,1581808,2025-05-29,Senate,"Senate Rules Committee Vote",20,0,0,1,21
1898605,1585253,2025-06-04,Senate,"Senate Floor Vote - Final Passage",58,0,0,5,63
1898607,1503245,2025-01-21,Senate,"Senate Environmental Conservation Committee Vote",11,0,0,0,11
1898607,1503246,2025-03-03,Senate,"Senate Floor Vote - Final Passage",60,1,0,2,63
1898611,1479930,2025-01-27,Senate,"Senate Housing, Construction And Community Development Committee Vote",8,3,0,0,11
1898611,1479931,2025-02-04,Senate,"Senate Floor Vote - Final Passage",42,19,0,2,63
1898611,1535007,2025-04-02,Senate,"Senate Floor Vote - Final Passage",45,17,0,1,63
1898626,1584690,2025-05-29,Senate,"Senate Rules Committee Vote",20,0,0,1,21
1898626,1585206,2025-06-04,Senate,"Senate Floor Vote - Final Passage",57,1,0,5,63
1898651,1570460,2025-05-13,Assembly,"Assembly Judiciary Committee: Favorable refer to committee Codes",14,6,0,1,21
1898651,1574667,2025-05-20,Assembly,"Assembly Codes Committee: Favorable refer to committee Rules",14,6,0,2,22
1898651,1574934,2025-05-21,Assembly,"Assembly Rules Committee: Favorable",20,9,0,2,31
1898651,1589584,2025-06-11,Assembly,"Assembly Floor Vote - Final Passage",94,52,0,4,150
1898651,1590728,2025-06-13,Senate,"Senate Floor Vote - Final Passage",39,20,0,4,63
1898653,1506998,2025-02-10,Senate,"Senate Transportation Committee Vote",13,0,0,0,13
1898653,1506999,2025-03-05,Senate,"Senate Floor Vote - Final Passage",61,0,0,2,63
1898656,1573391,2025-05-19,Assembly,"Assembly Governmental Employees Committee: Held for Consideration",8,5,0,1,14
1898661,1587697,2025-06-09,Senate,"Senate Rules Committee Vote",21,0,0,0,21
1898661,1588289,2025-06-10,Senate,"Senate Floor Vote - Final Passage",58,0,0,5,63
1898664,1574097,2025-04-29,Senate,"Senate Veterans, Homeland Security And Military Affairs Committee Vote",9,0,0,0,9
1898664,1574098,2025-05-20,Senate,"Senate Floor Vote - Final Passage",60,1,0,1,62
1898664,1591483,2025-06-12,Senate,"Senate Floor Vote - Final Passage",59,0,0,4,63
1898664,1591484,2025-06-12,Senate,"Senate Floor Vote - Final Passage",59,0,0,4,63
1898666,1504145,2025-01-21,Senate,"Senate Environmental Conservation Committee Vote",11,0,0,0,11
1898666,1504146,2025-03-03,Senate,"Senate Floor Vote - Final Passage",61,0,0,2,63
1898666,1591125,2025-06-13,Assembly,"Assembly Floor Vote - Final Passage",136,0,0,14,150
1898674,1574230,2025-05-20,Assembly,"Assembly Governmental Operations Committee: Favorable refer to committee Codes",10,4,0,0,14
1898674,1585833,2025-06-05,Assembly,"Assembly Codes Committee: Favorable refer to committee Rules",15,6,0,1,22
1898675,1580574,2025-05-28,Assembly,"Assembly Codes Committee: Favorable refer to committee Rules",21,0,0,1,22
1898676,1473095,2025-01-22,Senate,"Senate Social Services Committee Vote",5,2,0,0,7
1898681,1498649,2025-02-25,Assembly,"Assembly Housing Committee: Favorable",20,6,0,2,28
1898682,1580187,2025-05-28,Assembly,"Assembly Children And Families Committee: Favorable refer to committee Rules",13,3,0,1,17
1898682,1585971,2025-06-06,Assembly,"Assembly Rules Committee: Favorable",20,7,0,4,31
1898697,1591585,2025-06-17,Assembly,"Assembly Ways And Means Committee: Favorable refer to committee Rules",32,0,0,3,35
1898697,1591923,2025-06-17,Assembly,"Assembly Rules Committee: Favorable",19,9,0,3,31
1898698,1534098,2025-04-02,Assembly,"Assembly Insurance Committee: Favorable refer to committee Ways and Means",21,4,0,0,25
1898698,1574332,2025-05-20,Assembly,"Assembly Ways And Means Committee: Favorable refer to committee Rules",25,10,0,0,35
1898698,1574875,2025-05-21,Assembly,"Assembly Rules Committee: Favorable",20,9,0,2,31
1898698,1579534,2025-05-27,Assembly,"Assembly Floor Vote - Final Passage",115,31,0,4,150
1898702,1497828,2025-02-24,Assembly,"Assembly Corporations, Authorities And Commissions Committee: Favorable refer to committee Codes",16,6,0,4,26
1898702,1504281,2025-03-04,Assembly,"Assembly Codes Committee: Favorable refer to committee Ways and Means",21,1,0,0,22
1898702,1578993,2025-05-27,Assembly,"Assembly Ways And Means Committee: Favorable refer to committee Rules",22,10,0,3,35
1898702,1585928,2025-06-06,Assembly,"Assembly Rules Committee: Favorable",19,8,0,4,31
1898718,1560863,2025-04-29,Senate,"Senate Local Government Committee Vote",5,2,0,0,7
1898723,1574256,2025-05-20,Assembly,"Assembly Local Governments Committee: Held for Consideration",13,5,0,2,20
1898724,1498336,2025-02-24,Assembly,"Assembly Health Committee: Favorable refer to committee Codes",19,5,0,2,26
1898724,1504877,2025-03-04,Assembly,"Assembly Codes Committee: Favorable",17,5,0,0,22
1898733,1557035,2025-04-09,Senate,"Senate Codes Committee Vote",12,0,0,1,13
1898733,1557036,2025-04-24,Senate,"Senate Floor Vote - Final Passage",51,0,0,11,62
1898737,1560977,2025-04-29,Senate,"Senate Local Government Committee Vote",7,0,0,0,7
1898739,1579218,2025-04-29,Senate,"Senate Investigations And Government Operations Committee Vote",7,0,0,0,7
1898739,1584575,2025-05-27,Senate,"Senate Floor Vote - Final Passage",50,9,0,4,63
1898739,1585409,2025-06-04,Assembly,"Assembly Floor Vote - Final Passage",108,36,0,6,150
1898746,1586942,2025-03-11,Senate,"Senate Consumer Protection Committee Vote",7,0,0,0,7
1898746,1586943,2025-06-09,Senate,"Senate Floor Vote - Final Passage",49,13,0,1,63
1898747,1589301,2025-06-11,Senate,"Senate Floor Vote - Final Passage",40,19,0,4,63
1898747,1589302,2025-06-11,Senate,"Senate Rules Committee Vote",13,7,0,1,21
1898747,1591276,2025-06-13,Assembly,"Assembly Floor Vote - Final Passage",122,14,0,14,150
1898748,1559233,2025-04-28,Assembly,"Assembly Codes Committee: Favorable refer to committee Rules",12,9,0,1,22
1898748,1559234,2025-04-28,Assembly,"Assembly Health Committee: Favorable refer to committee Codes",15,10,0,1,26
1898748,1559757,2025-04-29,Assembly,"Assembly Rules Committee: Favorable",21,8,0,2,31
1898748,1562156,2025-04-29,Assembly,"Assembly Floor Vote - Final Passage",81,67,0,2,150
1898748,1587181,2025-06-09,Senate,"Senate Floor Vote - Final Passage",35,27,0,1,63
1898769,1575270,2025-04-29,Senate,"Senate Environmental Conservation Committee Vote",11,0,0,0,11
1898769,1575271,2025-05-21,Senate,"Senate Floor Vote - Final Passage",47,12,0,3,62
1898774,1540765,2025-03-18,Senate,"Senate Agriculture Committee Vote",9,0,0,0,9
1898774,1540766,2025-04-08,Senate,"Senate Floor Vote - Final Passage",61,1,0,1,63
1898775,1526873,2025-03-25,Assembly,"Assembly Consumer Affairs And Protection Committee: Favorable refer to committee Codes",10,5,0,1,16
1898775,1580435,2025-05-28,Assembly,"Assembly Codes Committee: Favorable refer to committee Rules",15,6,0,1,22
1898794,1540085,2025-02-25,Senate,"Senate Environmental Conservation Committee Vote",11,0,0,0,11
1898794,1540086,2025-04-08,Senate,"Senate Floor Vote - Final Passage",56,6,0,1,63
1898863,1590856,2025-06-12,Senate,"Senate Rules Committee Vote",20,0,0,1,21
1898863,1590857,2025-06-13,Senate,"Senate Floor Vote - Final Passage",59,0,0,4,63
1898864,1586825,2025-04-29,Senate,"Senate Transportation Committee Vote",13,0,0,0,13
1898864,1587125,2025-06-09,Senate,"Senate Floor Vote - Final Passage",61,1,0,1,63
1898868,1539935,2025-04-08,Senate,"Senate Labor Committee Vote",13,0,0,0,13
1898872,1587692,2025-05-27,Senate,"Senate Transportation Committee Vote",13,0,0,0,13
1898872,1588278,2025-06-10,Senate,"Senate Floor Vote - Final Passage",57,1,0,5,63
1898883,1500685,2025-02-03,Senate,"Senate Investigations And Government Operations Committee Vote",7,0,0,0,7
1898883,1500686,2025-02-26,Senate,"Senate Floor Vote - Final Passage",61,0,0,2,63
1898884,1540296,2025-04-08,Senate,"Senate Education Committee Vote",15,0,0,0,15
1898885,1585692,2025-05-28,Senate,"Senate Consumer Protection Committee Vote",5,2,0,0,7
1898885,1585693,2025-06-05,Senate,"Senate Floor Vote - Final Passage",38,22,0,3,63
1898894,1539609,2025-04-07,Senate,"Senate Investigations And Government Operations Committee Vote",7,0,0,0,7
1898897,1580661,2025-05-20,Senate,"Senate Codes Committee Vote",9,4,0,0,13
1898897,1580662,2025-05-28,Senate,"Senate Floor Vote - Final Passage",40,21,0,2,63
1898901,1471295,2025-01-13,Senate,"Senate Floor Vote - Final Passage",45,16,0,2,63
1898901,1471296,2025-01-13,Senate,"Senate Rules Committee Vote",16,5,0,0,21
1898905,1506878,2025-02-04,Senate,"Senate Health Committee Vote",11,4,0,0,15
1898905,1506879,2025-03-05,Senate,"Senate Floor Vote - Final Passage",42,19,0,2,63
1898919,1515995,2025-03-12,Senate,"Senate Commerce, Economic Development And Small Business Committee Vote",9,0,0,0,9
1898921,1539691,2025-04-08,Senate,"Senate Crime Victims, Crime And Correction Committee Vote",5,2,0,0,7
1899854,1503803,2025-02-04,Senate,"Senate Health Committee Vote",15,0,0,0,15
1899854,1503804,2025-03-03,Senate,"Senate Floor Vote - Final Passage",61,0,0,2,63
1899855,1580323,2025-05-13,Senate,"Senate Health Committee Vote",13,0,0,1,14
1899855,1580324,2025-05-28,Senate,"Senate Floor Vote - Final Passage",61,0,0,2,63
1899857,1571074,2025-05-13,Senate,"Senate Transportation Committee Vote",13,0,0,0,13
1899860,1518943,2025-03-17,Senate,"Senate Investigations And Government Operations Committee Vote",6,1,0,0,7
1899862,1515921,2025-02-03,Senate,"Senate Investigations And Government Operations Committee Vote",7,0,0,0,7
1899862,1515922,2025-03-11,Senate,"Senate Floor Vote - Final Passage",60,1,0,2,63
1899866,1480487,2025-02-04,Senate,"Senate Health Committee Vote",15,0,0,0,15
1899866,1560130,2025-04-29,Senate,"Senate Finance Committee Vote",22,0,0,0,22
1899866,1574438,2025-05-20,Senate,"Senate Floor Vote - Final Passage",61,0,0,1,62
1899871,1589690,2025-01-28,Senate,"Senate Consumer Protection Committee Vote",7,0,0,0,7
1899871,1590602,2025-06-12,Senate,"Senate Floor Vote - Final Passage",45,14,0,4,63
1899874,1512412,2025-03-10,Senate,"Senate Housing, Construction And Community Development Committee Vote",8,3,0,0,11
1899876,1472695,2025-01-21,Senate,"Senate Health Committee Vote",14,0,0,1,15
1899876,1512967,2025-03-11,Senate,"Senate Finance Committee Vote",20,1,0,1,22
1899876,1574425,2025-05-20,Senate,"Senate Floor Vote - Final Passage",56,5,0,1,62
1899877,1563323,2025-04-29,Senate,"Senate Health Committee Vote",14,0,0,0,14
1899878,1569489,2025-04-29,Senate,"Senate Ethics And Internal Governance Committee Vote",5,2,0,0,7
1899878,1569490,2025-05-12,Senate,"Senate Floor Vote - Final Passage",39,18,0,5,62
1899884,1586672,2025-05-20,Senate,"Senate Codes Committee Vote",9,4,0,0,13
1899884,1587063,2025-06-09,Senate,"Senate Floor Vote - Final Passage",40,22,0,1,63
1899888,1503919,2025-03-03,Senate,"Senate Labor Committee Vote",11,2,0,0,13
1899888,1505573,2025-03-04,Senate,"Senate Floor Vote - Final Passage",41,20,0,2,63
1899888,1506077,2025-03-04,Senate,"Senate Rules Committee Vote",15,5,0,1,21
1899888,1590607,2025-06-12,Senate,"Senate Floor Vote - Final Passage",41,18,0,4,63
1899893,1540737,2025-02-03,Senate,"Senate Insurance Committee Vote",11,0,0,0,11
1899893,1540738,2025-04-08,Senate,"Senate Floor Vote - Final Passage",61,1,0,1,63
1899893,1588884,2025-06-10,Assembly,"Assembly Floor Vote - Final Passage",95,52,0,3,150
1899894,1563370,2025-04-29,Senate,"Senate Health Committee Vote",9,5,0,0,14
1899894,1580847,2025-05-28,Senate,"Senate Finance Committee Vote",16,6,0,0,22
1899897,1480542,2025-02-04,Senate,"Senate Health Committee Vote",11,4,0,0,15
1899897,1560125,2025-04-29,Senate,"Senate Finance Committee Vote",16,6,0,0,22
1899897,1580365,2025-05-28,Senate,"Senate Floor Vote - Final Passage",41,20,0,2,63
1899898,1499086,2025-02-11,Senate,"Senate Corporations, Authorities And Commissions Committee Vote",7,0,0,0,7
1899898,1499087,2025-02-25,Senate,"Senate Floor Vote - Final Passage",61,0,0,2,63
1899901,1531990,2025-02-03,Senate,"Senate Investigations And Government Operations Committee Vote",7,0,0,0,7
1899901,1533647,2025-04-01,Senate,"Senate Floor Vote - Final Passage",63,0,0,0,63
1899991,1585714,2025-05-28,Senate,"Senate Finance Committee Vote",22,0,0,0,22
1899991,1585715,2025-06-05,Senate,"Senate Floor Vote - Final Passage",60,0,0,3,63
1900027,1497980,2025-02-03,Senate,"Senate Higher Education Committee Vote",11,0,0,0,11
1900027,1497981,2025-02-24,Senate,"Senate Floor Vote - Final Passage",60,0,0,3,63
1900038,1539351,2025-04-08,Senate,"Senate Crime Victims, Crime And Correction Committee Vote",5,2,0,0,7
1900040,1581320,2025-05-28,Senate,"Senate Investigations And Government Operations Committee Vote",7,0,0,0,7
1900061,1479846,2025-02-04,Senate,"Senate Labor Committee Vote",13,0,0,0,13
1900061,1505345,2025-03-04,Senate,"Senate Finance Committee Vote",19,2,0,1,22
1900061,1516649,2025-03-12,Senate,"Senate Floor Vote - Final Passage",57,3,0,3,63
1900093,1479839,2025-02-04,Senate,"Senate Crime Victims, Crime And Correction Committee Vote",7,0,0,0,7
1900234,1480537,2025-02-04,Senate,"Senate Agriculture Committee Vote",6,3,0,0,9
1900234,1512930,2025-03-11,Senate,"Senate Consumer Protection Committee Vote",7,0,0,0,7
1900234,1587072,2025-06-09,Senate,"Senate Floor Vote - Final Passage",48,14,0,1,63
1900281,1487804,2025-02-11,Senate,"Senate Budget And Revenue Committee Vote",7,0,0,0,7
1900281,1560892,2025-04-29,Senate,"Senate Finance Committee Vote",22,0,0,0,22
1900281,1573458,2025-05-19,Senate,"Senate Floor Vote - Final Passage",55,1,0,6,62
1900281,1592352,2025-06-17,Assembly,"Assembly Floor Vote - Final Passage",141,0,0,9,150
1900287,1581988,2025-05-28,Senate,"Senate Housing, Construction And Community Development Committee Vote",8,2,0,1,11
1900399,1563333,2025-04-29,Senate,"Senate Health Committee Vote",11,3,0,0,14
1900399,1580093,2025-05-28,Senate,"Senate Commerce, Economic Development And Small Business Committee Vote",6,3,0,0,9
1900404,1588769,2025-01-27,Senate,"Senate Judiciary Committee Vote",14,5,0,0,19
1900404,1589239,2025-06-11,Senate,"Senate Floor Vote - Final Passage",38,21,0,4,63
1900416,1526352,2025-03-25,Assembly,"Assembly People With Disabilities Committee: Favorable refer to committee Ways and Means",9,0,0,0,9
1900429,1587122,2025-06-09,Senate,"Senate Floor Vote - Final Passage",61,1,0,1,63
1900429,1587123,2025-06-09,Senate,"Senate Rules Committee Vote",20,1,0,0,21
1900430,1479785,2025-02-04,Assembly,"Assembly Transportation Committee: Favorable refer to committee Ways and Means",20,5,0,1,26
1900430,1586004,2025-06-06,Assembly,"Assembly Ways And Means Committee: Favorable refer to committee Rules",25,10,0,0,35
1900430,1588143,2025-06-10,Assembly,"Assembly Rules Committee: Favorable",20,8,0,3,31
1900436,1524664,2025-02-11,Senate,"Senate Judiciary Committee Vote",13,6,0,0,19
1900436,1525323,2025-03-24,Senate,"Senate Floor Vote - Final Passage",37,22,0,4,63
1900437,1570829,2025-02-04,Senate,"Senate Crime Victims, Crime And Correction Committee Vote",7,0,0,0,7
1900437,1570830,2025-05-13,Senate,"Senate Floor Vote - Final Passage",53,4,0,5,62
1900439,1487106,2025-02-11,Assembly,"Assembly Alcoholism And Drug Abuse Committee: Favorable refer to committee Ways and Means",14,0,0,0,14
1900439,1590755,2025-06-13,Assembly,"Assembly Rules Committee: Favorable",29,0,0,2,31
1900439,1590756,2025-06-13,Assembly,"Assembly Ways And Means Committee: Favorable refer to committee Rules",32,0,0,3,35
1900439,1591220,2025-06-13,Assembly,"Assembly Floor Vote - Final Passage",136,0,0,14,150
1900448,1499255,2025-02-03,Senate,"Senate Insurance Committee Vote",11,0,0,0,11
1900448,1499256,2025-02-25,Senate,"Senate Floor Vote - Final Passage",57,4,0,2,63
1900452,1589215,2025-06-11,Senate,"Senate Floor Vote - Final Passage",47,12,0,4,63
1900452,1589216,2025-06-11,Senate,"Senate Rules Committee Vote",18,2,0,1,21
1900457,1574508,2025-05-20,Assembly,"Assembly Governmental Operations Committee: Favorable refer to committee Ways and Means",14,0,0,0,14
1900457,1579399,2025-05-27,Assembly,"Assembly Ways And Means Committee: Favorable refer to committee Rules",32,0,0,3,35
1900457,1581530,2025-05-29,Assembly,"Assembly Rules Committee: Favorable",27,0,0,4,31
1900457,1582206,2025-05-29,Assembly,"Assembly Floor Vote - Final Passage",146,0,0,4,150
1900457,1588013,2025-06-10,Senate,"Senate Floor Vote - Final Passage",57,1,0,5,63
1900459,1561653,2025-04-29,Senate,"Senate Environmental Conservation Committee Vote",9,2,0,0,11
1900461,1475502,2025-01-28,Senate,"Senate Cities 1 Committee Vote",7,0,0,0,7
1900463,1590093,2025-04-07,Senate,"Senate Investigations And Government Operations Committee Vote",7,0,0,0,7
1900463,1590528,2025-06-12,Senate,"Senate Floor Vote - Final Passage",58,1,0,4,63
1900463,1592432,2025-06-17,Assembly,"Assembly Floor Vote - Final Passage",141,0,0,9,150
1900464,1589103,2025-01-21,Senate,"Senate Health Committee Vote",11,3,0,1,15
1900464,1589104,2025-06-11,Senate,"Senate Floor Vote - Final Passage",37,22,0,4,63
1900467,1473215,2025-01-22,Senate,"Senate Social Services Committee Vote",7,0,0,0,7
1900475,1498487,2025-02-10,Senate,"Senate Elections Committee Vote",7,0,0,0,7
1900475,1498488,2025-02-24,Senate,"Senate Floor Vote - Final Passage",58,2,0,3,63
1900482,1541848,2025-03-25,Senate,"Senate Codes Committee Vote",12,0,0,1,13
1900482,1541849,2025-04-09,Senate,"Senate Floor Vote - Final Passage",60,0,0,3,63
1900486,1475582,2025-01-28,Assembly,"Assembly Codes Committee: Favorable",14,6,0,2,22
1900495,1487117,2025-02-11,Assembly,"Assembly Alcoholism And Drug Abuse Committee: Favorable refer to committee Ways and Means",14,0,0,0,14
1900506,1479776,2025-02-04,Assembly,"Assembly Transportation Committee: Favorable refer to committee Ways and Means",23,2,0,1,26
1900513,1475457,2025-01-27,Senate,"Senate Judiciary Committee Vote",13,6,0,0,19
1900513,1504738,2025-03-04,Senate,"Senate Finance Committee Vote",14,7,0,1,22
1900513,1570932,2025-05-13,Senate,"Senate Floor Vote - Final Passage",35,22,0,5,62
1900516,1573877,2025-05-20,Assembly,"Assembly Governmental Operations Committee: Favorable refer to committee Ways and Means",14,0,0,0,14
1900516,1580943,2025-05-29,Assembly,"Assembly Ways And Means Committee: Favorable refer to committee Rules",34,0,0,1,35
1900516,1586878,2025-06-09,Assembly,"Assembly Rules Committee: Favorable",25,0,0,6,31
1900520,1519712,2025-03-18,Assembly,"Assembly Real Property Taxation Committee: Favorable refer to committee Ways and Means",10,0,0,0,10
1900520,1519713,2025-03-18,Assembly,"Assembly Rules Committee: Favorable",30,0,0,1,31
1900520,1519714,2025-03-18,Assembly,"Assembly Ways And Means Committee: Favorable refer to committee Rules",31,0,0,4,35
1900520,1520853,2025-03-18,Assembly,"Assembly Floor Vote - Final Passage",148,0,0,2,150
1900520,1560200,2025-04-29,Senate,"Senate Floor Vote - Final Passage",49,12,0,1,62
1900536,1534681,2025-04-02,Assembly,"Assembly Housing Committee: Favorable",18,8,0,2,28
1900541,1513556,2025-02-04,Senate,"Senate Labor Committee Vote",13,0,0,0,13
1900541,1513557,2025-03-11,Senate,"Senate Floor Vote - Final Passage",61,0,0,2,63
1900552,1573427,2025-05-19,Assembly,"Assembly Health Committee: Favorable refer to committee Ways and Means",24,0,0,2,26
1900559,1559534,2025-04-28,Assembly,"Assembly Consumer Affairs And Protection Committee: Favorable refer to committee Codes",14,0,0,2,16
1900559,1574687,2025-05-20,Assembly,"Assembly Codes Committee: Favorable refer to committee Rules",17,3,0,2,22
1900559,1574935,2025-05-21,Assembly,"Assembly Rules Committee: Favorable",20,9,0,2,31
1900562,1498821,2025-01-21,Senate,"Senate Finance Committee Vote",21,0,0,1,22
1900562,1498822,2025-02-25,Senate,"Senate Floor Vote - Final Passage",61,0,0,2,63
1900567,1566812,2025-05-06,Senate,"Senate Education Committee Vote",8,6,0,0,14
1900573,1579139,2025-05-27,Assembly,"Assembly Governmental Operations Committee: Held for Consideration",10,4,0,0,14
1900587,1499368,2025-02-25,Assembly,"Assembly Mental Health Committee: Favorable refer to committee Judiciary",13,0,0,0,13
1900588,1586104,2025-06-06,Assembly,"Assembly Ways And Means Committee: Held for Consideration",25,10,0,0,35
1900596,1588545,2025-06-11,Assembly,"Assembly Ways And Means Committee: Favorable refer to committee Rules",34,0,0,1,35
1900596,1589469,2025-06-12,Assembly,"Assembly Rules Committee: Favorable",29,0,0,2,31
1900609,1487653,2025-02-11,Senate,"Senate Judiciary Committee Vote",19,0,0,0,19
1900609,1580884,2025-05-28,Senate,"Senate Finance Committee Vote",22,0,0,0,22
1900609,1585854,2025-06-05,Senate,"Senate Floor Vote - Final Passage",56,4,0,3,63
1900613,1570308,2025-05-13,Senate,"Senate Crime Victims, Crime And Correction Committee Vote",5,2,0,0,7
1900622,1579161,2025-05-27,Assembly,"Assembly Governmental Operations Committee: Favorable refer to committee Rules",14,0,0,0,14
1900622,1581510,2025-05-29,Assembly,"Assembly Rules Committee: Favorable",27,0,0,4,31
1900631,1513600,2025-03-11,Assembly,"Assembly Energy Committee: Favorable refer to committee Ways and Means",11,5,0,1,17
1900631,1579348,2025-05-27,Assembly,"Assembly Ways And Means Committee: Favorable refer to committee Rules",22,10,0,3,35
1900631,1581517,2025-05-29,Assembly,"Assembly Rules Committee: Favorable",19,8,0,4,31
1900633,1574317,2025-05-20,Assembly,"Assembly Judiciary Committee: Held for Consideration",14,6,0,1,21
1900646,1559285,2025-04-28,Assembly,"Assembly Veterans' Affairs Committee: Favorable refer to committee Ways and Means",19,0,0,0,19
1900646,1574684,2025-05-20,Assembly,"Assembly Ways And Means Committee: Favorable refer to committee Rules",35,0,0,0,35
1900646,1574928,2025-05-21,Assembly,"Assembly Rules Committee: Favorable",29,0,0,2,31
1900646,1575851,2025-05-21,Assembly,"Assembly Floor Vote - Final Passage",144,0,0,6,150
1900646,1590723,2025-06-12,Senate,"Senate Floor Vote - Final Passage",57,2,0,4,63
1900653,1587191,2025-06-04,Senate,"Senate Rules Committee Vote",20,0,0,1,21
1900653,1587192,2025-06-09,Senate,"Senate Floor Vote - Final Passage",60,2,0,1,63
1900656,1579194,2025-05-27,Assembly,"Assembly Governmental Operations Committee: Held for Consideration",10,4,0,0,14
1900658,1498996,2025-01-28,Senate,"Senate Consumer Protection Committee Vote",6,1,0,0,7
1900658,1498997,2025-02-25,Senate,"Senate Floor Vote - Final Passage",50,11,0,2,63
1900658,1587135,2025-06-09,Senate,"Senate Floor Vote - Final Passage",46,16,0,1,63
1900660,1556974,2025-04-07,Senate,"Senate Investigations And Government Operations Committee Vote",7,0,0,0,7
1900660,1556975,2025-04-24,Senate,"Senate Floor Vote - Final Passage",51,0,0,11,62
1900677,1562704,2025-04-30,Assembly,"Assembly Local Governments Committee: Favorable refer to committee Codes",11,7,0,2,20
1900677,1574642,2025-05-20,Assembly,"Assembly Codes Committee: Favorable refer to committee Ways and Means",14,6,0,2,22
1900684,1504038,2025-01-27,Senate,"Senate Codes Committee Vote",10,2,0,1,13
1900684,1504039,2025-03-03,Senate,"Senate Floor Vote - Final Passage",38,23,0,2,63
1900696,1506381,2025-02-26,Senate,"Senate Alcoholism And Substance Use Disorders Committee Vote",7,0,0,0,7
1900696,1506382,2025-03-05,Senate,"Senate Floor Vote - Final Passage",61,0,0,2,63
1900696,1519269,2025-03-17,Senate,"Senate Floor Vote - Final Passage",58,2,0,3,63
1900826,1579726,2025-05-28,Assembly,"Assembly Transportation Committee: Held for Consideration",16,7,0,3,26
1900837,1573333,2025-01-21,Senate,"Senate Finance Committee Vote",18,3,0,1,22
1900837,1573334,2025-05-19,Senate,"Senate Floor Vote - Final Passage",44,12,0,6,62
1900837,1581254,2025-05-29,Senate,"Senate Floor Vote - Final Passage",43,13,0,7,63
1900840,1519595,2025-03-18,Assembly,"Assembly Health Committee: Favorable",24,1,0,1,26
1900840,1571864,2025-05-14,Assembly,"Assembly Floor Vote - Final Passage",113,34,0,3,150
1900840,1588185,2025-06-10,Senate,"Senate Floor Vote - Final Passage",57,1,0,5,63
1900861,1487313,2025-01-28,Senate,"Senate Education Committee Vote",14,1,0,0,15
1900861,1487824,2025-02-12,Senate,"Senate Floor Vote - Final Passage",53,6,0,4,63
1900862,1500760,2025-01-27,Senate,"Senate Codes Committee Vote",12,0,0,1,13
1900862,1500761,2025-02-26,Senate,"Senate Floor Vote - Final Passage",60,1,0,2,63
1900865,1561989,2025-04-30,Assembly,"Assembly Racing And Wagering Committee: Favorable",11,0,0,0,11
1900868,1584793,2025-05-14,Senate,"Senate Local Government Committee Vote",6,0,0,1,7
1900868,1584794,2025-06-04,Senate,"Senate Floor Vote - Final Passage",56,2,0,5,63
1900885,1513308,2025-03-12,Senate,"Senate Women's Issues Committee Vote",7,0,0,0,7
1900885,1581819,2025-05-29,Senate,"Senate Rules Committee Vote",20,0,0,1,21
1900885,1585286,2025-06-04,Senate,"Senate Floor Vote - Final Passage",58,0,0,5,63
1900889,1504149,2025-03-04,Senate,"Senate Education Committee Vote",15,0,0,0,15
1900896,1585497,2025-05-20,Senate,"Senate Judiciary Committee Vote",18,0,0,1,19
1900896,1585890,2025-06-05,Senate,"Senate Floor Vote - Final Passage",60,0,0,3,63
1900897,1473181,2025-01-21,Senate,"Senate Children And Families Committee Vote",7,0,0,0,7
1900897,1570278,2025-05-13,Senate,"Senate Finance Committee Vote",22,0,0,0,22
1900897,1573377,2025-05-19,Senate,"Senate Floor Vote - Final Passage",54,2,0,6,62
1900897,1586954,2025-06-09,Senate,"Senate Floor Vote - Final Passage",60,2,0,1,63
1900897,1592198,2025-06-16,Assembly,"Assembly Floor Vote - Final Passage",109,36,0,5,150
1900901,1565648,2025-05-06,Assembly,"Assembly Science And Technology Committee: Favorable refer to committee Codes",9,0,0,0,9
1900901,1570680,2025-05-13,Assembly,"Assembly Codes Committee: Favorable",22,0,0,0,22
1900901,1574000,2025-05-19,Assembly,"Assembly Floor Vote - Final Passage",144,0,0,6,150
1900903,1574504,2025-05-20,Assembly,"Assembly Aging Committee: Favorable refer to committee Ways and Means",27,0,0,3,30
1900903,1590816,2025-06-13,Assembly,"Assembly Rules Committee: Favorable",29,0,0,2,31
1900903,1590817,2025-06-13,Assembly,"Assembly Ways And Means Committee: Favorable refer to committee Rules",32,0,0,3,35
1900906,1475657,2025-01-28,Senate,"Senate Education Committee Vote",15,0,0,0,15
1900920,1580018,2025-05-28,Assembly,"Assembly Codes Committee: Favorable refer to committee Rules",21,0,0,1,22
1900950,1472705,2025-01-21,Senate,"Senate Health Committee Vote",14,0,0,1,15
1900950,1573886,2025-05-20,Senate,"Senate Finance Committee Vote",22,0,0,0,22
1900950,1580233,2025-05-28,Senate,"Senate Floor Vote - Final Passage",61,0,0,2,63
1900950,1586597,2025-06-06,Assembly,"Assembly Floor Vote - Final Passage",143,0,0,7,150
1900957,1486036,2025-02-10,Senate,"Senate Elections Committee Vote",6,1,0,0,7
1900957,1514278,2025-03-11,Senate,"Senate Finance Committee Vote",17,4,0,1,22
1900957,1564069,2025-04-30,Senate,"Senate Floor Vote - Final Passage",46,14,0,2,62
1900961,1500019,2025-02-03,Senate,"Senate Higher Education Committee Vote",11,0,0,0,11
1900961,1500020,2025-02-26,Senate,"Senate Floor Vote - Final Passage",61,0,0,2,63
1900964,1580852,2025-05-28,Senate,"Senate Budget And Revenue Committee Vote",4,3,0,0,7
1900967,1590207,2025-06-12,Senate,"Senate Rules Committee Vote",20,0,0,1,21
1900967,1590547,2025-06-13,Senate,"Senate Floor Vote - Final Passage",59,0,0,4,63
1900967,1592486,2025-06-17,Assembly,"Assembly Floor Vote - Final Passage",134,0,0,16,150
1900975,1471279,2025-01-13,Senate,"Senate Floor Vote - Final Passage",45,16,0,2,63
1900975,1471280,2025-01-13,Senate,"Senate Rules Committee Vote",15,6,0,0,21
1900981,1562594,2025-03-18,Senate,"Senate Local Government Committee Vote",7,0,0,0,7
1900981,1562595,2025-04-30,Senate,"Senate Floor Vote - Final Passage",56,4,0,2,62
1900996,1565343,2025-01-21,Senate,"Senate Finance Committee Vote",21,0,0,1,22
1900996,1565344,2025-05-05,Senate,"Senate Floor Vote - Final Passage",61,0,0,1,62
1901000,1482277,2025-02-04,Senate,"Senate Agriculture Committee Vote",9,0,0,0,9
1901000,1560145,2025-04-29,Senate,"Senate Finance Committee Vote",22,0,0,0,22
1901000,1566114,2025-05-06,Senate,"Senate Floor Vote - Final Passage",61,0,0,1,62
1901001,1487453,2025-02-11,Senate,"Senate Education Committee Vote",15,0,0,0,15
1901006,1503424,2025-02-04,Senate,"Senate Agriculture Committee Vote",9,0,0,0,9
1901006,1503425,2025-03-03,Senate,"Senate Floor Vote - Final Passage",61,0,0,2,63
1901013,1473170,2025-01-21,Senate,"Senate Energy And Telecommunications Committee Vote",8,1,0,0,9
1901013,1587124,2025-06-09,Senate,"Senate Rules Committee Vote",21,0,0,0,21
1901013,1588363,2025-06-10,Senate,"Senate Floor Vote - Final Passage",57,1,0,5,63
1901017,1570985,2025-03-18,Senate,"Senate Procurement And Contracts Committee Vote",7,0,0,0,7
1901017,1570986,2025-05-13,Senate,"Senate Floor Vote - Final Passage",57,0,0,5,62
1901017,1582149,2025-05-29,Assembly,"Assembly Floor Vote - Final Passage",146,0,0,4,150
1901024,1575457,2025-02-03,Senate,"Senate Investigations And Government Operations Committee Vote",7,0,0,0,7
1901024,1575458,2025-05-21,Senate,"Senate Floor Vote - Final Passage",55,4,0,3,62
1901027,1504140,2025-03-03,Senate,"Senate Housing, Construction And Community Development Committee Vote",10,1,0,0,11
1901027,1585530,2025-06-04,Senate,"Senate Rules Committee Vote",20,0,0,1,21
1901027,1589140,2025-06-11,Senate,"Senate Floor Vote - Final Passage",55,4,0,4,63
1901031,1487463,2025-02-11,Senate,"Senate Education Committee Vote",15,0,0,0,15
1901041,1479722,2025-02-03,Senate,"Senate Housing, Construction And Community Development Committee Vote",10,1,0,0,11
1901041,1560304,2025-04-29,Senate,"Senate Finance Committee Vote",21,1,0,0,22
1901041,1570364,2025-05-13,Senate,"Senate Floor Vote - Final Passage",54,3,0,5,62
1901041,1588387,2025-06-10,Senate,"Senate Floor Vote - Final Passage",55,3,0,5,63
1901053,1500030,2025-01-21,Senate,"Senate Health Committee Vote",14,0,0,1,15
1901053,1500031,2025-02-26,Senate,"Senate Floor Vote - Final Passage",61,0,0,2,63
1901055,1521767,2025-02-10,Senate,"Senate Elections Committee Vote",5,2,0,0,7
1901055,1521768,2025-03-19,Senate,"Senate Floor Vote - Final Passage",38,22,0,3,63
1901071,1580958,2025-05-20,Senate,"Senate Codes Committee Vote",13,0,0,0,13
1901071,1580959,2025-05-29,Senate,"Senate Floor Vote - Final Passage",56,0,0,7,63
1901081,1565393,2025-04-29,Senate,"Senate Transportation Committee Vote",13,0,0,0,13
1901081,1565394,2025-05-05,Senate,"Senate Floor Vote - Final Passage",61,0,0,1,62
1901081,1589245,2025-06-10,Assembly,"Assembly Floor Vote - Final Passage",147,0,0,3,150
1901083,1574710,2025-05-13,Senate,"Senate Higher Education Committee Vote",11,0,0,0,11
1901083,1574711,2025-05-20,Senate,"Senate Floor Vote - Final Passage",61,0,0,1,62
1901085,1570409,2025-04-30,Senate,"Senate Higher Education Committee Vote",11,0,0,0,11
1901085,1570410,2025-05-13,Senate,"Senate Floor Vote - Final Passage",57,0,0,5,62
1901085,1587126,2025-06-09,Senate,"Senate Floor Vote - Final Passage",62,0,0,1,63
1901168,1503361,2025-02-10,Senate,"Senate Elections Committee Vote",6,1,0,0,7
1901168,1503362,2025-03-03,Senate,"Senate Floor Vote - Final Passage",55,6,0,2,63
1901172,1587948,2025-05-20,Senate,"Senate Local Government Committee Vote",7,0,0,0,7
1901172,1587949,2025-06-10,Senate,"Senate Floor Vote - Final Passage",57,1,0,5,63
1901178,1565420,2025-01-21,Senate,"Senate Finance Committee Vote",21,0,0,1,22
1901178,1565421,2025-05-05,Senate,"Senate Floor Vote - Final Passage",61,0,0,1,62
1901181,1471376,2025-01-14,Assembly,"Assembly Agriculture Committee: Favorable refer to committee Rules",23,0,0,0,23
1901181,1471440,2025-01-14,Assembly,"Assembly Rules Committee: Favorable",29,0,0,2,31
1901181,1472994,2025-01-21,Assembly,"Assembly Floor Vote - Final Passage",147,0,0,3,150
1901181,1472995,2025-01-22,Senate,"Senate Floor Vote - Final Passage",58,1,0,4,63
1901182,1573905,2025-05-13,Senate,"Senate Higher Education Committee Vote",11,0,0,0,11
1901182,1573906,2025-05-19,Senate,"Senate Floor Vote - Final Passage",56,0,0,6,62
1901189,1586763,2025-06-04,Senate,"Senate Rules Committee Vote",20,0,0,1,21
1901189,1587194,2025-06-09,Senate,"Senate Floor Vote - Final Passage",60,2,0,1,63
1901193,1499868,2025-02-03,Senate,"Senate Higher Education Committee Vote",11,0,0,0,11
1901193,1500495,2025-02-26,Senate,"Senate Floor Vote - Final Passage",61,0,0,2,63
1901193,1590648,2025-06-12,Senate,"Senate Floor Vote - Final Passage",59,0,0,4,63
1901202,1576628,2025-03-11,Senate,"Senate Finance Committee Vote",21,0,0,1,22
1901202,1576629,2025-05-21,Senate,"Senate Floor Vote - Final Passage",50,9,0,3,62
1901204,1473165,2025-01-22,Assembly,"Assembly Real Property Taxation Committee: Favorable refer to committee Ways and Means",9,0,0,1,10
1901204,1479628,2025-02-04,Assembly,"Assembly Rules Committee: Favorable",26,0,0,5,31
1901204,1479629,2025-02-04,Assembly,"Assembly Ways And Means Committee: Favorable refer to committee Rules",33,0,0,2,35
1901208,1541347,2025-02-24,Senate,"Senate Codes Committee Vote",12,1,0,0,13
1901208,1541348,2025-04-08,Senate,"Senate Floor Vote - Final Passage",61,1,0,1,63
1901217,1584880,2025-01-28,Senate,"Senate Energy And Telecommunications Committee Vote",8,1,0,0,9
1901217,1584881,2025-06-04,Senate,"Senate Floor Vote - Final Passage",49,9,0,5,63
1901227,1479425,2025-02-03,Senate,"Senate Investigations And Government Operations Committee Vote",7,0,0,0,7
1901234,1586764,2025-03-10,Senate,"Senate Codes Committee Vote",11,2,0,0,13
1901234,1587086,2025-06-09,Senate,"Senate Floor Vote - Final Passage",50,12,0,1,63
1901238,1561652,2025-04-29,Senate,"Senate Transportation Committee Vote",13,0,0,0,13
1901240,1473088,2025-01-22,Assembly,"Assembly Real Property Taxation Committee: Favorable refer to committee Ways and Means",9,0,0,1,10
1901240,1479641,2025-02-04,Assembly,"Assembly Rules Committee: Favorable",26,0,0,5,31
1901240,1479642,2025-02-04,Assembly,"Assembly Ways And Means Committee: Favorable refer to committee Rules",33,0,0,2,35
1901242,1541284,2025-04-08,Senate,"Senate Health Committee Vote",11,3,0,1,15
1901242,1580854,2025-05-28,Senate,"Senate Finance Committee Vote",17,5,0,0,22
1901242,1589150,2025-06-11,Senate,"Senate Floor Vote - Final Passage",42,17,0,4,63
1901245,1580067,2025-05-28,Senate,"Senate Insurance Committee Vote",11,0,0,0,11
1901245,1587041,2025-06-09,Senate,"Senate Rules Committee Vote",21,0,0,0,21
1901245,1589456,2025-06-11,Senate,"Senate Floor Vote - Final Passage",58,1,0,4,63
1901251,1498847,2025-01-27,Senate,"Senate Housing, Construction And Community Development Committee Vote",11,0,0,0,11
1901251,1498848,2025-02-25,Senate,"Senate Floor Vote - Final Passage",61,0,0,2,63
1901272,1499906,2025-01-21,Senate,"Senate Environmental Conservation Committee Vote",11,0,0,0,11
1901272,1499907,2025-02-26,Senate,"Senate Floor Vote - Final Passage",61,0,0,2,63
1901274,1533816,2025-02-25,Senate,"Senate Local Government Committee Vote",7,0,0,0,7
1901274,1533817,2025-04-01,Senate,"Senate Floor Vote - Final Passage",63,0,0,0,63
1901274,1589731,2025-06-11,Assembly,"Assembly Floor Vote - Final Passage",146,0,0,4,150
1901276,1586178,2025-04-29,Senate,"Senate Local Government Committee Vote",7,0,0,0,7
1901276,1586179,2025-06-06,Senate,"Senate Floor Vote - Final Passage",53,0,0,10,63
1901276,1589037,2025-06-10,Assembly,"Assembly Floor Vote - Final Passage",147,0,0,3,150
1901280,1574165,2025-01-27,Senate,"Senate Codes Committee Vote",10,2,0,1,13
1901280,1574166,2025-05-20,Senate,"Senate Floor Vote - Final Passage",36,25,0,1,62
1901309,1540477,2025-03-18,Senate,"Senate Agriculture Committee Vote",9,0,0,0,9
1901309,1540478,2025-04-08,Senate,"Senate Floor Vote - Final Passage",62,0,0,1,63
1901317,1498575,2025-02-03,Senate,"Senate Insurance Committee Vote",11,0,0,0,11
1901317,1498576,2025-02-24,Senate,"Senate Floor Vote - Final Passage",60,0,0,3,63
1901336,1475544,2025-01-28,Assembly,"Assembly Insurance Committee: Favorable refer to committee Rules",21,0,0,4,25
1901336,1475545,2025-01-28,Assembly,"Assembly Rules Committee: Favorable",31,0,0,0,31
1901336,1478837,2025-02-03,Senate,"Senate Floor Vote - Final Passage",62,1,0,0,63
1901336,1479700,2025-02-03,Assembly,"Assembly Floor Vote - Final Passage",147,0,0,3,150
1901352,1528705,2025-03-03,Senate,"Senate Labor Committee Vote",13,0,0,0,13
1901352,1528706,2025-03-26,Senate,"Senate Floor Vote - Final Passage",52,9,0,2,63
1901364,1580586,2025-05-20,Senate,"Senate Local Government Committee Vote",6,1,0,0,7
1901364,1580587,2025-05-28,Senate,"Senate Floor Vote - Final Passage",42,19,0,2,63
1901371,1572901,2025-05-13,Senate,"Senate Environmental Conservation Committee Vote",11,0,0,0,11
1901387,1585878,2025-05-29,Senate,"Senate Rules Committee Vote",20,0,0,1,21
1901387,1585879,2025-06-05,Senate,"Senate Floor Vote - Final Passage",60,0,0,3,63
1901391,1471277,2025-01-13,Assembly,"Assembly Housing Committee: Favorable refer to committee Ways and Means",21,6,0,1,28
1901391,1471278,2025-01-13,Assembly,"Assembly Ways And Means Committee: Favorable refer to committee Rules",25,9,0,1,35
1901391,1471297,2025-01-13,Assembly,"Assembly Rules Committee: Favorable",19,9,0,3,31
1901391,1471403,2025-01-14,Senate,"Senate Floor Vote - Final Passage",60,0,0,3,63
1901391,1471442,2025-01-13,Assembly,"Assembly Floor Vote - Final Passage",104,43,0,3,150
1901395,1573772,2025-02-03,Senate,"Senate Investigations And Government Operations Committee Vote",5,2,0,0,7
1901395,1573773,2025-05-19,Senate,"Senate Floor Vote - Final Passage",37,19,0,6,62
1901395,1592675,2025-06-16,Assembly,"Assembly Floor Vote - Final Passage",95,49,0,6,150
1901418,1529445,2025-02-11,Senate,"Senate Environmental Conservation Committee Vote",9,2,0,0,11
1901418,1529446,2025-03-26,Senate,"Senate Floor Vote - Final Passage",48,13,0,2,63
1901428,1471421,2025-01-14,Assembly,"Assembly Economic Development Committee: Favorable refer to committee Ways and Means",18,8,0,0,26
1901428,1473118,2025-01-22,Assembly,"Assembly Ways And Means Committee: Favorable refer to committee Rules",24,10,0,1,35
1901428,1474207,2025-01-22,Assembly,"Assembly Rules Committee: Favorable",20,9,0,2,31
1901429,1589257,2025-05-28,Senate,"Senate Consumer Protection Committee Vote",7,0,0,0,7
1901429,1589422,2025-06-11,Senate,"Senate Floor Vote - Final Passage",58,1,0,4,63
1901436,1579515,2025-04-29,Senate,"Senate Investigations And Government Operations Committee Vote",7,0,0,0,7
1901436,1590867,2025-05-27,Senate,"Senate Floor Vote - Final Passage",46,13,0,4,63
1901436,1591171,2025-06-13,Assembly,"Assembly Floor Vote - Final Passage",111,25,0,14,150
1901450,1580730,2025-02-10,Senate,"Senate Elections Committee Vote",5,2,0,0,7
1901450,1580731,2025-05-28,Senate,"Senate Floor Vote - Final Passage",39,22,0,2,63
1901465,1574734,2025-05-13,Senate,"Senate Transportation Committee Vote",13,0,0,0,13
1901465,1574735,2025-05-20,Senate,"Senate Floor Vote - Final Passage",61,0,0,1,62
1901492,1580437,2025-03-04,Senate,"Senate Health Committee Vote",15,0,0,0,15
1901492,1580438,2025-05-28,Senate,"Senate Floor Vote - Final Passage",49,12,0,2,63
1901493,1471351,2025-01-14,Assembly,"Assembly Agriculture Committee: Favorable refer to committee Rules",21,2,0,0,23
1901493,1471621,2025-01-14,Assembly,"Assembly Rules Committee: Favorable",29,0,0,2,31
1901493,1472928,2025-01-21,Assembly,"Assembly Floor Vote - Final Passage",134,13,0,3,150
1901493,1473355,2025-01-22,Senate,"Senate Floor Vote - Final Passage",57,2,0,4,63
1901509,1475510,2025-01-28,Assembly,"Assembly Election Law Committee: Favorable refer to committee Rules",10,5,0,1,16
1901509,1475511,2025-01-28,Assembly,"Assembly Rules Committee: Favorable",22,9,0,0,31
1901515,1473102,2025-01-22,Assembly,"Assembly Codes Committee: Favorable refer to committee Rules",15,5,0,2,22
1901515,1474344,2025-01-22,Assembly,"Assembly Rules Committee: Favorable",20,9,0,2,31
1901517,1472699,2025-01-21,Assembly,"Assembly Tourism, Arts And Sports Development Committee: Favorable refer to committee Rules",19,0,0,2,21
1901517,1474343,2025-01-22,Assembly,"Assembly Rules Committee: Favorable",29,0,0,2,31
1901523,1472989,2025-01-22,Assembly,"Assembly Science And Technology Committee: Favorable refer to committee Rules",8,0,0,1,9
1901523,1475439,2025-01-28,Assembly,"Assembly Rules Committee: Favorable",31,0,0,0,31
1901523,1479404,2025-02-03,Assembly,"Assembly Floor Vote - Final Passage",147,0,0,3,150
1901523,1486353,2025-02-11,Senate,"Senate Floor Vote - Final Passage",61,0,0,2,63
1901537,1471347,2025-01-14,Assembly,"Assembly Consumer Affairs And Protection Committee: Favorable refer to committee Codes",15,0,0,1,16
1901537,1473104,2025-01-22,Assembly,"Assembly Codes Committee: Favorable refer to committee Rules",20,0,0,2,22
1901537,1474332,2025-01-22,Assembly,"Assembly Rules Committee: Favorable",29,0,0,2,31
1901537,1475277,2025-01-27,Assembly,"Assembly Floor Vote - Final Passage",145,0,0,5,150
1901537,1475278,2025-01-28,Senate,"Senate Floor Vote - Final Passage",61,0,0,2,63
1901542,1471368,2025-01-14,Assembly,"Assembly Banks Committee: Favorable refer to committee Rules",22,6,0,3,31
1901542,1471619,2025-01-14,Assembly,"Assembly Rules Committee: Favorable",29,0,0,2,31
1901542,1472922,2025-01-21,Assembly,"Assembly Floor Vote - Final Passage",143,4,0,3,150
1901542,1480766,2025-02-05,Senate,"Senate Floor Vote - Final Passage",46,16,0,1,63
1901547,1473096,2025-01-22,Assembly,"Assembly Codes Committee: Favorable refer to committee Rules",15,5,0,2,22
1901547,1474322,2025-01-22,Assembly,"Assembly Rules Committee: Favorable",20,9,0,2,31
1901558,1473122,2025-01-22,Assembly,"Assembly Small Business Committee: Favorable refer to committee Rules",16,0,0,1,17
1901558,1474204,2025-01-22,Assembly,"Assembly Rules Committee: Favorable",29,0,0,2,31
1901558,1475323,2025-01-27,Assembly,"Assembly Floor Vote - Final Passage",145,0,0,5,150
1901558,1475324,2025-01-28,Senate,"Senate Floor Vote - Final Passage",61,0,0,2,63
1901571,1472915,2025-01-22,Assembly,"Assembly Science And Technology Committee: Favorable refer to committee Rules",7,1,0,1,9
1901571,1474198,2025-01-22,Assembly,"Assembly Rules Committee: Favorable",29,0,0,2,31
1901576,1471379,2025-01-14,Assembly,"Assembly Consumer Affairs And Protection Committee: Favorable refer to committee Rules",15,0,0,1,16
1901576,1475435,2025-01-28,Assembly,"Assembly Rules Committee: Favorable",31,0,0,0,31
1901581,1471420,2025-01-14,Assembly,"Assembly Banks Committee: Favorable refer to committee Rules",28,0,0,3,31
1901581,1475525,2025-01-28,Assembly,"Assembly Rules Committee: Favorable",31,0,0,0,31
1901581,1479936,2025-02-03,Assembly,"Assembly Floor Vote - Final Passage",147,0,0,3,150
1901581,1479937,2025-02-04,Senate,"Senate Floor Vote - Final Passage",49,12,0,2,63
1901584,1475536,2025-01-28,Assembly,"Assembly Insurance Committee: Favorable refer to committee Rules",21,0,0,4,25
1901584,1475537,2025-01-28,Assembly,"Assembly Rules Committee: Favorable",31,0,0,0,31
1901584,1479472,2025-02-03,Assembly,"Assembly Floor Vote - Final Passage",147,0,0,3,150
1901584,1482826,2025-02-05,Senate,"Senate Floor Vote - Final Passage",61,1,0,1,63
1901592,1475433,2025-01-28,Assembly,"Assembly Insurance Committee: Favorable refer to committee Rules",21,0,0,4,25
1901592,1475434,2025-01-28,Assembly,"Assembly Rules Committee: Favorable",31,0,0,0,31
1901592,1478947,2025-02-03,Senate,"Senate Floor Vote - Final Passage",63,0,0,0,63
1901592,1479899,2025-02-03,Assembly,"Assembly Floor Vote - Final Passage",147,0,0,3,150
1901606,1587290,2025-06-10,Assembly,"Assembly Ways And Means Committee: Favorable refer to committee Rules",29,3,0,3,35
1901606,1588526,2025-06-11,Assembly,"Assembly Rules Committee: Favorable",28,0,0,3,31
1901609,1471576,2025-01-14,Assembly,"Assembly Consumer Affairs And Protection Committee: Favorable refer to committee Codes",15,0,0,1,16
1901609,1473087,2025-01-22,Assembly,"Assembly Codes Committee: Favorable refer to committee Rules",20,0,0,2,22
1901609,1474172,2025-01-22,Assembly,"Assembly Rules Committee: Favorable",29,0,0,2,31
1901609,1475332,2025-01-27,Assembly,"Assembly Floor Vote - Final Passage",146,0,0,4,150
1901609,1475333,2025-01-28,Senate,"Senate Floor Vote - Final Passage",61,0,0,2,63
1901616,1486052,2025-02-11,Assembly,"Assembly Housing Committee: Favorable refer to committee Rules",25,2,0,1,28
1901616,1486332,2025-02-11,Assembly,"Assembly Rules Committee: Favorable",27,0,0,4,31
1901625,1471345,2025-01-14,Assembly,"Assembly Banks Committee: Favorable refer to committee Rules",28,0,0,3,31
1901625,1475512,2025-01-28,Assembly,"Assembly Rules Committee: Favorable",31,0,0,0,31
1901625,1479473,2025-02-03,Assembly,"Assembly Floor Vote - Final Passage",147,0,0,3,150
1901625,1487451,2025-02-12,Senate,"Senate Floor Vote - Final Passage",45,14,0,4,63
1901626,1471349,2025-01-14,Assembly,"Assembly Consumer Affairs And Protection Committee: Favorable refer to committee Rules",10,5,0,1,16
1901626,1471639,2025-01-14,Assembly,"Assembly Consumer Affairs And Protection Committee: Favorable refer to committee Rules",10,5,0,1,16
1901633,1471350,2025-01-14,Assembly,"Assembly Consumer Affairs And Protection Committee: Favorable refer to committee Codes",15,0,0,1,16
1901633,1473065,2025-01-22,Assembly,"Assembly Codes Committee: Favorable refer to committee Rules",18,2,0,2,22
1901633,1474167,2025-01-22,Assembly,"Assembly Rules Committee: Favorable",29,0,0,2,31
1901633,1476210,2025-01-28,Assembly,"Assembly Floor Vote - Final Passage",138,7,0,5,150
1901633,1486525,2025-02-11,Senate,"Senate Floor Vote - Final Passage",56,5,0,2,63
1901636,1587289,2025-06-10,Assembly,"Assembly Ways And Means Committee: Favorable refer to committee Rules",29,3,0,3,35
1901636,1588491,2025-06-11,Assembly,"Assembly Rules Committee: Favorable",28,0,0,3,31
1901641,1471364,2025-01-14,Assembly,"Assembly Consumer Affairs And Protection Committee: Favorable refer to committee Rules",15,0,0,1,16
1901641,1471622,2025-01-14,Assembly,"Assembly Consumer Affairs And Protection Committee: Favorable refer to committee Rules",15,0,0,1,16
1901641,1472920,2025-01-21,Assembly,"Assembly Floor Vote - Final Passage",147,0,0,3,150
1901641,1479328,2025-02-03,Senate,"Senate Floor Vote - Final Passage",63,0,0,0,63
1902009,1479087,2025-01-13,Senate,"Senate Rules Committee Vote",21,0,0,0,21
1902009,1479088,2025-02-03,Senate,"Senate Floor Vote - Final Passage",62,1,0,0,63
1902009,1483438,2025-02-05,Assembly,"Assembly Floor Vote - Final Passage",145,0,0,5,150
1902014,1475799,2025-01-13,Senate,"Senate Rules Committee Vote",21,0,0,0,21
1902014,1475800,2025-01-28,Senate,"Senate Floor Vote - Final Passage",61,0,0,2,63
1902014,1482141,2025-02-04,Assembly,"Assembly Floor Vote - Final Passage",146,0,0,4,150
1902016,1471415,2025-01-13,Senate,"Senate Rules Committee Vote",21,0,0,0,21
1902016,1471416,2025-01-14,Senate,"Senate Floor Vote - Final Passage",60,0,0,3,63
1902016,1483295,2025-02-05,Assembly,"Assembly Floor Vote - Final Passage",145,0,0,5,150
1902018,1475879,2025-01-13,Senate,"Senate Rules Committee Vote",21,0,0,0,21
1902018,1475880,2025-01-28,Senate,"Senate Floor Vote - Final Passage",60,1,0,2,63
1902018,1483038,2025-02-05,Assembly,"Assembly Floor Vote - Final Passage",145,0,0,5,150
1902025,1472919,2025-01-13,Senate,"Senate Rules Committee Vote",21,0,0,0,21
1902025,1473345,2025-01-22,Senate,"Senate Floor Vote - Final Passage",59,0,0,4,63
1902025,1483459,2025-02-05,Assembly,"Assembly Floor Vote - Final Passage",145,0,0,5,150
1902037,1478800,2025-01-13,Senate,"Senate Rules Committee Vote",14,7,0,0,21
1902037,1478801,2025-02-03,Senate,"Senate Floor Vote - Final Passage",46,17,0,0,63
1902037,1522289,2025-03-19,Assembly,"Assembly Floor Vote - Final Passage",96,52,0,2,150
1902041,1479138,2025-01-13,Senate,"Senate Rules Committee Vote",20,1,0,0,21
1902041,1479139,2025-02-03,Senate,"Senate Floor Vote - Final Passage",57,6,0,0,63
1902041,1480534,2025-02-04,Assembly,"Assembly Floor Vote - Final Passage",137,9,0,4,150
1902075,1473218,2025-01-13,Senate,"Senate Rules Committee Vote",20,1,0,0,21
1902075,1473219,2025-01-22,Senate,"Senate Floor Vote - Final Passage",58,1,0,4,63
1902075,1488847,2025-02-12,Assembly,"Assembly Floor Vote - Final Passage",149,0,0,1,150
1902081,1484975,2025-01-13,Senate,"Senate Rules Committee Vote",20,1,0,0,21
1902081,1484976,2025-02-10,Senate,"Senate Floor Vote - Final Passage",54,7,0,2,63
1902081,1515761,2025-03-11,Assembly,"Assembly Floor Vote - Final Passage",145,4,0,1,150
1902096,1471411,2025-01-13,Senate,"Senate Rules Committee Vote",15,6,0,0,21
1902096,1471412,2025-01-14,Senate,"Senate Floor Vote - Final Passage",48,12,0,3,63
1902096,1488792,2025-02-12,Assembly,"Assembly Floor Vote - Final Passage",106,43,0,1,150
1902099,1473079,2025-01-13,Senate,"Senate Rules Committee Vote",21,0,0,0,21
1902099,1473080,2025-01-22,Senate,"Senate Floor Vote - Final Passage",59,0,0,4,63
1902099,1476260,2025-01-28,Assembly,"Assembly Floor Vote - Final Passage",145,0,0,5,150
1902103,1476120,2025-01-13,Senate,"Senate Rules Committee Vote",21,0,0,0,21
1902103,1476121,2025-01-28,Senate,"Senate Floor Vote - Final Passage",61,0,0,2,63
1902103,1504180,2025-03-03,Assembly,"Assembly Floor Vote - Final Passage",143,5,0,2,150
1902103,1589072,2025-06-11,Senate,"Senate Floor Vote - Final Passage",58,1,0,4,63
1902112,1472937,2025-01-13,Senate,"Senate Rules Committee Vote",21,0,0,0,21
1902112,1473360,2025-01-22,Senate,"Senate Floor Vote - Final Passage",59,0,0,4,63
1902112,1483319,2025-02-05,Assembly,"Assembly Floor Vote - Final Passage",145,0,0,5,150
1902129,1473085,2025-01-13,Senate,"Senate Rules Committee Vote",18,3,0,0,21
1902129,1473086,2025-01-22,Senate,"Senate Floor Vote - Final Passage",54,5,0,4,63
1902129,1483023,2025-02-05,Assembly,"Assembly Floor Vote - Final Passage",144,1,0,5,150
1902134,1479402,2025-01-13,Senate,"Senate Rules Committee Vote",19,2,0,0,21
1902134,1479403,2025-02-03,Senate,"Senate Floor Vote - Final Passage",55,8,0,0,63
1902134,1488603,2025-02-12,Assembly,"Assembly Floor Vote - Final Passage",145,4,0,1,150
1902138,1478984,2025-01-13,Senate,"Senate Rules Committee Vote",15,6,0,0,21
1902138,1478985,2025-02-03,Senate,"Senate Floor Vote - Final Passage",50,13,0,0,63
1902138,1523103,2025-03-19,Assembly,"Assembly Floor Vote - Final Passage",100,48,0,2,150
1902143,1484714,2025-01-13,Senate,"Senate Rules Committee Vote",18,3,0,0,21
1902143,1485454,2025-02-10,Senate,"Senate Floor Vote - Final Passage",57,4,0,2,63
1902143,1563377,2025-04-30,Assembly,"Assembly Floor Vote - Final Passage",112,33,0,5,150
1902146,1475451,2025-01-13,Senate,"Senate Rules Committee Vote",21,0,0,0,21
1902146,1475452,2025-01-28,Senate,"Senate Floor Vote - Final Passage",60,1,0,2,63
1902146,1480667,2025-02-04,Assembly,"Assembly Floor Vote - Final Passage",145,1,0,4,150
1902148,1471380,2025-01-13,Senate,"Senate Rules Committee Vote",21,0,0,0,21
1902148,1471381,2025-01-14,Senate,"Senate Floor Vote - Final Passage",59,1,0,3,63
1902148,1480510,2025-02-04,Assembly,"Assembly Floor Vote - Final Passage",145,1,0,4,150
1902150,1485431,2025-01-13,Senate,"Senate Rules Committee Vote",15,6,0,0,21
1902150,1485432,2025-02-10,Senate,"Senate Floor Vote - Final Passage",44,17,0,2,63
1902150,1516803,2025-03-12,Assembly,"Assembly Floor Vote - Final Passage",88,57,0,5,150
1902153,1471393,2025-01-13,Senate,"Senate Rules Committee Vote",21,0,0,0,21
1902153,1471394,2025-01-14,Senate,"Senate Floor Vote - Final Passage",60,0,0,3,63
1902153,1473639,2025-01-22,Assembly,"Assembly Floor Vote - Final Passage",146,0,0,4,150
1902155,1479410,2025-01-13,Senate,"Senate Rules Committee Vote",14,7,0,0,21
1902155,1479411,2025-02-03,Senate,"Senate Floor Vote - Final Passage",52,11,0,0,63
1902155,1480480,2025-02-04,Assembly,"Assembly Floor Vote - Final Passage",139,7,0,4,150
1902164,1479003,2025-01-13,Senate,"Senate Rules Committee Vote",14,7,0,0,21
1902164,1479004,2025-02-03,Senate,"Senate Floor Vote - Final Passage",41,22,0,0,63
1902164,1516809,2025-03-12,Assembly,"Assembly Floor Vote - Final Passage",94,50,0,6,150
1902168,1475463,2025-01-13,Senate,"Senate Rules Committee Vote",17,4,0,0,21
1902168,1475464,2025-01-28,Senate,"Senate Floor Vote - Final Passage",54,7,0,2,63
1902168,1479459,2025-02-03,Assembly,"Assembly Floor Vote - Final Passage",147,0,0,3,150
1902170,1504208,2025-03-03,Senate,"Senate Housing, Construction And Community Development Committee Vote",10,1,0,0,11
1902174,1479122,2025-01-13,Senate,"Senate Rules Committee Vote",21,0,0,0,21
1902174,1479123,2025-02-03,Senate,"Senate Floor Vote - Final Passage",62,1,0,0,63
1902174,1487310,2025-02-11,Assembly,"Assembly Floor Vote - Final Passage",104,45,0,1,150
1902175,1475442,2025-01-13,Senate,"Senate Rules Committee Vote",21,0,0,0,21
1902175,1475443,2025-01-28,Senate,"Senate Floor Vote - Final Passage",61,0,0,2,63
1902175,1480792,2025-02-04,Assembly,"Assembly Floor Vote - Final Passage",146,0,0,4,150
1902177,1471390,2025-01-13,Senate,"Senate Rules Committee Vote",21,0,0,0,21
1902177,1471391,2025-01-14,Senate,"Senate Floor Vote - Final Passage",59,1,0,3,63
1902177,1479491,2025-02-03,Assembly,"Assembly Floor Vote - Final Passage",145,2,0,3,150
1902182,1497697,2025-01-13,Senate,"Senate Rules Committee Vote",16,5,0,0,21
1902182,1497698,2025-02-24,Senate,"Senate Floor Vote - Final Passage",41,19,0,3,63
1902182,1499842,2025-02-25,Assembly,"Assembly Floor Vote - Final Passage",115,32,0,3,150
1902193,1473225,2025-01-13,Senate,"Senate Rules Committee Vote",21,0,0,0,21
1902193,1473226,2025-01-22,Senate,"Senate Floor Vote - Final Passage",58,1,0,4,63
1902193,1483386,2025-02-05,Assembly,"Assembly Floor Vote - Final Passage",145,0,0,5,150
1902195,1485826,2025-01-13,Senate,"Senate Rules Committee Vote",19,2,0,0,21
1902195,1485827,2025-02-10,Senate,"Senate Floor Vote - Final Passage",53,8,0,2,63
1902195,1501619,2025-02-26,Assembly,"Assembly Floor Vote - Final Passage",125,18,0,7,150
1902201,1479412,2025-01-13,Senate,"Senate Rules Committee Vote",14,7,0,0,21
1902201,1479413,2025-02-03,Senate,"Senate Floor Vote - Final Passage",40,23,0,0,63
1902201,1504178,2025-03-03,Assembly,"Assembly Floor Vote - Final Passage",102,46,0,2,150
1902208,1475394,2025-01-13,Senate,"Senate Rules Committee Vote",21,0,0,0,21
1902208,1475395,2025-01-28,Senate,"Senate Floor Vote - Final Passage",61,0,0,2,63
1902208,1487381,2025-02-11,Assembly,"Assembly Floor Vote - Final Passage",102,47,0,1,150
1902213,1478938,2025-01-13,Senate,"Senate Rules Committee Vote",14,7,0,0,21
1902213,1478939,2025-02-03,Senate,"Senate Floor Vote - Final Passage",43,20,0,0,63
1902213,1522762,2025-03-19,Assembly,"Assembly Floor Vote - Final Passage",98,50,0,2,150
1902214,1471417,2025-01-13,Senate,"Senate Rules Committee Vote",16,5,0,0,21
1902214,1471418,2025-01-14,Senate,"Senate Floor Vote - Final Passage",47,13,0,3,63
1902214,1589689,2025-06-11,Assembly,"Assembly Floor Vote - Final Passage",114,32,0,4,150
1902229,1471444,2025-01-14,Assembly,"Assembly Agriculture Committee: Favorable refer to committee Rules",23,0,0,0,23
1902229,1475526,2025-01-28,Assembly,"Assembly Rules Committee: Favorable",31,0,0,0,31
1902234,1473114,2025-01-13,Senate,"Senate Rules Committee Vote",21,0,0,0,21
1902234,1473115,2025-01-22,Senate,"Senate Floor Vote - Final Passage",59,0,0,4,63
1902234,1480469,2025-02-04,Assembly,"Assembly Floor Vote - Final Passage",146,0,0,4,150
1902238,1475249,2025-01-13,Senate,"Senate Rules Committee Vote",21,0,0,0,21
1902238,1475660,2025-01-28,Senate,"Senate Floor Vote - Final Passage",61,0,0,2,63
1902238,1476174,2025-01-28,Assembly,"Assembly Floor Vote - Final Passage",142,3,0,5,150
1902241,1471396,2025-01-13,Senate,"Senate Rules Committee Vote",21,0,0,0,21
1902241,1471397,2025-01-14,Senate,"Senate Floor Vote - Final Passage",57,3,0,3,63
1902241,1473458,2025-01-22,Assembly,"Assembly Floor Vote - Final Passage",145,0,0,5,150
1902244,1475351,2025-01-28,Assembly,"Assembly Insurance Committee: Favorable refer to committee Rules",21,0,0,4,25
1902244,1475352,2025-01-28,Assembly,"Assembly Rules Committee: Favorable",31,0,0,0,31
1902244,1480476,2025-02-04,Assembly,"Assembly Floor Vote - Final Passage",146,0,0,4,150
1902244,1486209,2025-02-11,Senate,"Senate Floor Vote - Final Passage",60,1,0,2,63
1902250,1479658,2025-01-13,Senate,"Senate Rules Committee Vote",21,0,0,0,21
1902250,1479659,2025-02-04,Senate,"Senate Floor Vote - Final Passage",60,1,0,2,63
1902250,1483165,2025-02-05,Assembly,"Assembly Floor Vote - Final Passage",144,1,0,5,150
1902252,1482624,2025-01-13,Senate,"Senate Rules Committee Vote",17,4,0,0,21
1902252,1482625,2025-02-05,Senate,"Senate Floor Vote - Final Passage",44,18,0,1,63
1902252,1504953,2025-03-03,Assembly,"Assembly Floor Vote - Final Passage",101,47,0,2,150
1902267,1479766,2025-02-04,Senate,"Senate Crime Victims, Crime And Correction Committee Vote",7,0,0,0,7
1902274,1573882,2025-05-20,Assembly,"Assembly Insurance Committee: Favorable refer to committee Rules",25,0,0,0,25
1902274,1584915,2025-06-04,Assembly,"Assembly Rules Committee: Favorable",20,8,0,3,31
1902276,1579094,2025-04-29,Senate,"Senate Investigations And Government Operations Committee Vote",7,0,0,0,7
1902276,1584973,2025-05-27,Senate,"Senate Floor Vote - Final Passage",51,8,0,4,63
1902276,1585355,2025-06-04,Assembly,"Assembly Floor Vote - Final Passage",106,37,0,7,150
1902276,1585356,2025-06-04,Assembly,"Assembly Floor Vote - Final Passage",106,37,0,7,150
1902292,1560035,2025-04-29,Senate,"Senate Children And Families Committee Vote",5,2,0,0,7
1902301,1479790,2025-02-04,Assembly,"Assembly Transportation Committee: Favorable",22,3,0,1,26
1902301,1517062,2025-03-12,Assembly,"Assembly Floor Vote - Final Passage",99,46,0,5,150
1902303,1528604,2025-02-24,Senate,"Senate Codes Committee Vote",13,0,0,0,13
1902303,1529568,2025-03-27,Senate,"Senate Floor Vote - Final Passage",61,0,0,2,63
1902305,1499024,2025-02-25,Assembly,"Assembly Social Services Committee: Favorable refer to committee Ways and Means",13,4,0,1,18
1902323,1514813,2025-03-11,Assembly,"Assembly Codes Committee: Favorable",16,6,0,0,22
1902343,1513128,2025-03-11,Assembly,"Assembly Transportation Committee: Favorable",25,0,0,1,26
1902343,1519401,2025-03-17,Assembly,"Assembly Floor Vote - Final Passage",146,0,0,4,150
1902343,1589233,2025-06-11,Senate,"Senate Floor Vote - Final Passage",59,0,0,4,63
1902349,1471317,2025-01-13,Assembly,"Assembly Governmental Operations Committee: Favorable refer to committee Rules",12,2,0,0,14
1902349,1471633,2025-01-14,Assembly,"Assembly Rules Committee: Favorable",20,9,0,2,31
1902360,1487110,2025-02-11,Assembly,"Assembly Alcoholism And Drug Abuse Committee: Favorable refer to committee Ways and Means",14,0,0,0,14
1902360,1579003,2025-05-27,Assembly,"Assembly Ways And Means Committee: Favorable refer to committee Rules",32,0,0,3,35
1902360,1581166,2025-05-29,Assembly,"Assembly Rules Committee: Favorable",27,0,0,4,31
1902360,1582080,2025-05-29,Assembly,"Assembly Floor Vote - Final Passage",146,0,0,4,150
1902360,1588252,2025-06-10,Senate,"Senate Floor Vote - Final Passage",58,0,0,5,63
1902361,1534079,2025-04-02,Assembly,"Assembly Correction Committee: Favorable refer to committee Codes",8,4,0,1,13
1902371,1498746,2025-01-28,Senate,"Senate Aging Committee Vote",7,0,0,0,7
1902371,1499631,2025-02-25,Senate,"Senate Floor Vote - Final Passage",61,0,0,2,63
1902384,1580275,2025-05-28,Assembly,"Assembly Codes Committee: Favorable refer to committee Rules",15,6,0,1,22
1902384,1581502,2025-05-29,Assembly,"Assembly Rules Committee: Favorable",18,9,0,4,31
1902386,1471302,2025-01-13,Assembly,"Assembly Governmental Operations Committee: Favorable refer to committee Rules",14,0,0,0,14
1902386,1471303,2025-01-13,Assembly,"Assembly Rules Committee: Favorable",28,0,0,3,31
1902386,1471686,2025-01-14,Assembly,"Assembly Floor Vote - Final Passage",149,0,0,1,150
1902386,1475613,2025-01-28,Senate,"Senate Floor Vote - Final Passage",61,0,0,2,63
1902395,1573384,2025-05-19,Assembly,"Assembly Health Committee: Favorable refer to committee Codes",16,8,0,2,26
1902395,1580680,2025-05-28,Assembly,"Assembly Codes Committee: Favorable refer to committee Rules",15,6,0,1,22
1902395,1586101,2025-06-06,Assembly,"Assembly Rules Committee: Favorable",19,8,0,4,31
1902399,1573286,2025-05-19,Assembly,"Assembly Housing Committee: Favorable refer to committee Codes",18,8,0,2,28
1902399,1585538,2025-06-05,Assembly,"Assembly Codes Committee: Favorable refer to committee Rules",15,6,0,1,22
1902399,1585925,2025-06-06,Assembly,"Assembly Rules Committee: Favorable",19,8,0,4,31
1902406,1473006,2025-01-13,Senate,"Senate Rules Committee Vote",14,7,0,0,21
1902406,1473007,2025-01-22,Senate,"Senate Floor Vote - Final Passage",35,24,0,4,63
1902406,1498543,2025-02-24,Assembly,"Assembly Floor Vote - Final Passage",97,48,0,5,150
1902419,1479731,2025-02-04,Senate,"Senate Crime Victims, Crime And Correction Committee Vote",5,2,0,0,7
1902419,1570236,2025-05-13,Senate,"Senate Finance Committee Vote",15,7,0,0,22
1902419,1574362,2025-05-20,Senate,"Senate Floor Vote - Final Passage",40,21,0,1,62
1902425,1520263,2025-03-18,Assembly,"Assembly Governmental Operations Committee: Favorable refer to committee Ways and Means",14,0,0,0,14
1902425,1532053,2025-04-01,Assembly,"Assembly Rules Committee: Favorable",30,0,0,1,31
1902425,1532054,2025-04-01,Assembly,"Assembly Ways And Means Committee: Favorable refer to committee Rules",33,0,0,2,35
1902425,1570068,2025-05-12,Assembly,"Assembly Floor Vote - Final Passage",143,0,0,7,150
1902428,1479771,2025-02-04,Assembly,"Assembly Health Committee: Favorable refer to committee Ways and Means",23,0,0,3,26
1902454,1570609,2025-03-04,Senate,"Senate Agriculture Committee Vote",9,0,0,0,9
1902454,1570610,2025-05-13,Senate,"Senate Floor Vote - Final Passage",54,3,0,5,62
1902479,1575166,2025-04-29,Senate,"Senate Veterans, Homeland Security And Military Affairs Committee Vote",9,0,0,0,9
1902479,1575167,2025-05-21,Senate,"Senate Floor Vote - Final Passage",59,0,0,3,62
1902482,1580450,2025-05-28,Assembly,"Assembly Children And Families Committee: Favorable refer to committee Ways and Means",16,0,0,1,17
1902483,1512527,2025-03-11,Assembly,"Assembly Energy Committee: Favorable refer to committee Ways and Means",13,3,0,1,17
1902485,1559303,2025-04-28,Assembly,"Assembly Consumer Affairs And Protection Committee: Favorable refer to committee Codes",14,0,0,2,16
1902485,1566264,2025-05-06,Assembly,"Assembly Codes Committee: Favorable",22,0,0,0,22
1902490,1472961,2025-01-13,Senate,"Senate Rules Committee Vote",21,0,0,0,21
1902490,1472962,2025-01-22,Senate,"Senate Floor Vote - Final Passage",59,0,0,4,63
1902490,1483041,2025-02-05,Assembly,"Assembly Floor Vote - Final Passage",145,0,0,5,150
1902507,1487111,2025-02-11,Assembly,"Assembly Alcoholism And Drug Abuse Committee: Favorable refer to committee Ways and Means",14,0,0,0,14
1902519,1559293,2025-04-28,Assembly,"Assembly Consumer Affairs And Protection Committee: Favorable",13,1,0,2,16
1902519,1565609,2025-05-05,Assembly,"Assembly Floor Vote - Final Passage",147,0,0,3,150
1902549,1574211,2025-05-20,Assembly,"Assembly Insurance Committee: Favorable refer to committee Rules",18,7,0,0,25
1902549,1586855,2025-06-09,Assembly,"Assembly Rules Committee: Favorable",17,8,0,6,31
1902549,1589033,2025-06-10,Assembly,"Assembly Floor Vote - Final Passage",102,43,0,5,150
1902552,1561860,2025-04-29,Senate,"Senate Women's Issues Committee Vote",6,1,0,0,7
1902552,1571877,2025-05-13,Senate,"Senate Health Committee Vote",11,2,0,1,14
1902584,1579308,2025-04-29,Senate,"Senate Investigations And Government Operations Committee Vote",7,0,0,0,7
1902584,1584609,2025-05-27,Senate,"Senate Floor Vote - Final Passage",51,8,0,4,63
1902584,1585429,2025-06-04,Assembly,"Assembly Floor Vote - Final Passage",108,36,0,6,150
1902587,1486066,2025-01-13,Senate,"Senate Rules Committee Vote",21,0,0,0,21
1902587,1486067,2025-02-10,Senate,"Senate Floor Vote - Final Passage",59,2,0,2,63
1902587,1501141,2025-02-26,Assembly,"Assembly Floor Vote - Final Passage",125,18,0,7,150
1902589,1484713,2025-01-13,Senate,"Senate Rules Committee Vote",21,0,0,0,21
1902589,1485453,2025-02-10,Senate,"Senate Floor Vote - Final Passage",60,1,0,2,63
1902589,1488633,2025-02-12,Assembly,"Assembly Floor Vote - Final Passage",149,0,0,1,150
1902593,1500563,2025-02-25,Senate,"Senate Local Government Committee Vote",7,0,0,0,7
1902596,1587024,2025-06-09,Assembly,"Assembly Codes Committee: Favorable refer to committee Rules",15,5,0,2,22
1902596,1588499,2025-06-11,Assembly,"Assembly Rules Committee: Favorable",19,9,0,3,31
1902602,1574868,2025-05-20,Senate,"Senate Judiciary Committee Vote",18,0,0,1,19
1902610,1574636,2025-05-20,Assembly,"Assembly Higher Education Committee: Favorable refer to committee Rules",23,0,0,3,26
1902610,1575123,2025-05-21,Assembly,"Assembly Rules Committee: Favorable",29,0,0,2,31
1902616,1471285,2025-01-13,Assembly,"Assembly Governmental Operations Committee: Favorable refer to committee Rules",14,0,0,0,14
1902616,1471286,2025-01-13,Assembly,"Assembly Rules Committee: Favorable",28,0,0,3,31
1902616,1471663,2025-01-14,Assembly,"Assembly Floor Vote - Final Passage",148,1,0,1,150
1902616,1475752,2025-01-28,Senate,"Senate Floor Vote - Final Passage",61,0,0,2,63
1902619,1480062,2025-02-04,Assembly,"Assembly Health Committee: Favorable refer to committee Ways and Means",23,0,0,3,26
1902643,1580864,2025-05-28,Senate,"Senate Budget And Revenue Committee Vote",4,3,0,0,7
1902677,1498618,2025-02-25,Assembly,"Assembly Children And Families Committee: Favorable refer to committee Ways and Means",17,0,0,0,17
1902677,1532016,2025-04-01,Assembly,"Assembly Rules Committee: Favorable",30,0,0,1,31
1902677,1532017,2025-04-01,Assembly,"Assembly Ways And Means Committee: Favorable refer to committee Rules",33,0,0,2,35
1902677,1533907,2025-04-01,Assembly,"Assembly Floor Vote - Final Passage",144,0,0,6,150
1902677,1586107,2025-06-06,Senate,"Senate Floor Vote - Final Passage",53,0,0,10,63
1902683,1471400,2025-01-13,Senate,"Senate Rules Committee Vote",16,5,0,0,21
1902683,1471401,2025-01-14,Senate,"Senate Floor Vote - Final Passage",45,15,0,3,63
1902683,1590199,2025-06-11,Assembly,"Assembly Floor Vote - Final Passage",115,31,0,4,150
1902685,1580632,2025-05-28,Assembly,"Assembly Election Law Committee: Favorable refer to committee Rules",10,5,0,1,16
1902695,1505716,2025-03-04,Senate,"Senate Health Committee Vote",14,1,0,0,15
1902710,1504187,2025-03-03,Senate,"Senate Housing, Construction And Community Development Committee Vote",11,0,0,0,11
1902734,1488657,2025-01-13,Senate,"Senate Rules Committee Vote",16,5,0,0,21
1902734,1488658,2025-02-12,Senate,"Senate Floor Vote - Final Passage",43,16,0,4,63
1902734,1515746,2025-03-11,Assembly,"Assembly Floor Vote - Final Passage",96,53,0,1,150
1902741,1534341,2025-04-02,Assembly,"Assembly Codes Committee: Held for Consideration",14,6,0,2,22
1902778,1570097,2025-05-13,Assembly,"Assembly Housing Committee: Favorable refer to committee Codes",19,8,0,1,28
1902778,1580082,2025-05-28,Assembly,"Assembly Codes Committee: Favorable refer to committee Ways and Means",15,6,0,1,22
1902778,1585967,2025-06-06,Assembly,"Assembly Ways And Means Committee: Favorable refer to committee Rules",25,10,0,0,35
1902778,1587299,2025-06-10,Assembly,"Assembly Rules Committee: Favorable",19,9,0,3,31
1902803,1580357,2025-05-28,Assembly,"Assembly Labor Committee: Favorable refer to committee Codes",29,0,0,0,29
1902803,1585390,2025-06-05,Assembly,"Assembly Codes Committee: Favorable refer to committee Rules",21,0,0,1,22
1902803,1585959,2025-06-06,Assembly,"Assembly Rules Committee: Favorable",27,0,0,4,31
1902803,1589414,2025-06-11,Assembly,"Assembly Floor Vote - Final Passage",139,0,0,11,150
1902803,1590519,2025-06-12,Senate,"Senate Floor Vote - Final Passage",38,21,0,4,63
1902806,1473009,2025-01-21,Senate,"Senate Energy And Telecommunications Committee Vote",6,3,0,0,9
1902806,1474850,2025-01-27,Senate,"Senate Floor Vote - Final Passage",40,20,0,3,63
1902806,1474851,2025-01-27,Senate,"Senate Rules Committee Vote",14,6,0,1,21
1902806,1542105,2025-04-09,Senate,"Senate Floor Vote - Final Passage",39,21,0,3,63
1902810,1498985,2025-02-25,Assembly,"Assembly Children And Families Committee: Favorable",17,0,0,0,17
1902810,1527217,2025-03-25,Assembly,"Assembly Floor Vote - Final Passage",147,2,0,1,150
1902810,1589348,2025-06-11,Senate,"Senate Floor Vote - Final Passage",58,1,0,4,63
1902812,1504818,2025-03-04,Assembly,"Assembly Environmental Conservation Committee: Favorable refer to committee Ways and Means",30,0,0,0,30
1902813,1471406,2025-01-13,Senate,"Senate Rules Committee Vote",21,0,0,0,21
1902813,1471407,2025-01-14,Senate,"Senate Floor Vote - Final Passage",60,0,0,3,63
1902813,1487306,2025-02-11,Assembly,"Assembly Floor Vote - Final Passage",116,33,0,1,150
1902817,1580390,2025-05-28,Assembly,"Assembly Codes Committee: Favorable refer to committee Rules",15,6,0,1,22
1902819,1570917,2025-01-27,Senate,"Senate Housing, Construction And Community Development Committee Vote",11,0,0,0,11
1902819,1570918,2025-05-13,Senate,"Senate Floor Vote - Final Passage",57,0,0,5,62
1902825,1471365,2025-01-14,Assembly,"Assembly Health Committee: Favorable refer to committee Rules",25,0,0,1,26
1902825,1471624,2025-01-14,Assembly,"Assembly Health Committee: Favorable refer to committee Rules",25,0,0,1,26
1902825,1472913,2025-01-21,Assembly,"Assembly Floor Vote - Final Passage",145,2,0,3,150
1902825,1479196,2025-02-03,Senate,"Senate Floor Vote - Final Passage",63,0,0,0,63
1902841,1471375,2025-01-14,Assembly,"Assembly Consumer Affairs And Protection Committee: Favorable refer to committee Rules",15,0,0,1,16
1902841,1471451,2025-01-14,Assembly,"Assembly Consumer Affairs And Protection Committee: Favorable refer to committee Rules",15,0,0,1,16
1902841,1472921,2025-01-21,Assembly,"Assembly Floor Vote - Final Passage",147,0,0,3,150
1902841,1485135,2025-02-10,Senate,"Senate Floor Vote - Final Passage",60,1,0,2,63
1902842,1472729,2025-01-21,Assembly,"Assembly Health Committee: Favorable",21,5,0,0,26
1902842,1528723,2025-03-26,Assembly,"Assembly Floor Vote - Final Passage",99,50,0,1,150
1902842,1541482,2025-04-09,Senate,"Senate Floor Vote - Final Passage",47,13,0,3,63
1902847,1580631,2025-05-28,Assembly,"Assembly Higher Education Committee: Favorable refer to committee Ways and Means",26,0,0,0,26
1902848,1580653,2025-05-20,Senate,"Senate Labor Committee Vote",13,0,0,0,13
1902848,1580654,2025-05-28,Senate,"Senate Floor Vote - Final Passage",60,1,0,2,63
1902850,1497723,2025-02-24,Assembly,"Assembly Corporations, Authorities And Commissions Committee: Favorable refer to committee Codes",22,0,0,4,26
1902850,1515017,2025-03-11,Assembly,"Assembly Codes Committee: Favorable refer to committee Ways and Means",22,0,0,0,22
1902850,1579398,2025-05-27,Assembly,"Assembly Ways And Means Committee: Favorable refer to committee Rules",32,0,0,3,35
1902850,1587295,2025-06-10,Assembly,"Assembly Rules Committee: Favorable",28,0,0,3,31
1902861,1566447,2025-05-06,Assembly,"Assembly Transportation Committee: Favorable refer to committee Codes",24,0,0,2,26
1902861,1580401,2025-05-28,Assembly,"Assembly Codes Committee: Favorable refer to committee Rules",21,0,0,1,22
1902861,1581560,2025-05-29,Assembly,"Assembly Rules Committee: Favorable",27,0,0,4,31
1902861,1582051,2025-05-29,Assembly,"Assembly Floor Vote - Final Passage",146,0,0,4,150
1902871,1570759,2025-05-13,Senate,"Senate Civil Service And Pensions Committee Vote",7,0,0,0,7
1902891,1471289,2025-01-13,Assembly,"Assembly Governmental Operations Committee: Favorable refer to committee Rules",14,0,0,0,14
1902891,1471290,2025-01-13,Assembly,"Assembly Rules Committee: Favorable",28,0,0,3,31
1902891,1471402,2025-01-14,Senate,"Senate Floor Vote - Final Passage",59,1,0,3,63
1902891,1471716,2025-01-14,Assembly,"Assembly Floor Vote - Final Passage",148,1,0,1,150
1902900,1579163,2025-05-27,Assembly,"Assembly Governmental Operations Committee: Favorable refer to committee Rules",14,0,0,0,14
1902900,1585225,2025-06-04,Assembly,"Assembly Rules Committee: Favorable",20,8,0,3,31
1902900,1585385,2025-06-04,Assembly,"Assembly Floor Vote - Final Passage",144,0,0,6,150
1902924,1579494,2025-04-29,Senate,"Senate Investigations And Government Operations Committee Vote",7,0,0,0,7
1902924,1584772,2025-05-27,Senate,"Senate Floor Vote - Final Passage",50,9,0,4,63
1902924,1585616,2025-06-04,Assembly,"Assembly Floor Vote - Final Passage",107,37,0,6,150
1902929,1526408,2025-03-25,Assembly,"Assembly Social Services Committee: Favorable refer to committee Ways and Means",13,4,0,1,18
1902929,1580920,2025-05-29,Assembly,"Assembly Ways And Means Committee: Favorable refer to committee Rules",24,10,0,1,35
1902929,1585214,2025-06-04,Assembly,"Assembly Rules Committee: Favorable",22,6,0,3,31
1902960,1578989,2025-05-27,Assembly,"Assembly Education Committee: Favorable refer to committee Ways and Means",25,3,0,3,31
1902960,1589542,2025-06-12,Assembly,"Assembly Ways And Means Committee: Favorable refer to committee Rules",34,0,0,1,35
1902978,1473103,2025-01-22,Assembly,"Assembly Codes Committee: Favorable refer to committee Rules",20,0,0,2,22
1902978,1474308,2025-01-22,Assembly,"Assembly Rules Committee: Favorable",29,0,0,2,31
1902978,1476151,2025-01-28,Assembly,"Assembly Floor Vote - Final Passage",143,2,0,5,150
1902978,1479317,2025-02-03,Senate,"Senate Floor Vote - Final Passage",55,8,0,0,63
1903011,1573442,2025-05-19,Assembly,"Assembly Housing Committee: Favorable refer to committee Rules",22,4,0,2,28
1903018,1472712,2025-01-21,Assembly,"Assembly Education Committee: Favorable refer to committee Rules",27,0,0,4,31
1903018,1474346,2025-01-22,Assembly,"Assembly Rules Committee: Favorable",29,0,0,2,31
1903018,1476254,2025-01-28,Assembly,"Assembly Floor Vote - Final Passage",143,2,0,5,150
1903018,1480087,2025-02-04,Senate,"Senate Floor Vote - Final Passage",57,4,0,2,63
1903031,1559552,2025-04-28,Assembly,"Assembly Health Committee: Favorable refer to committee Ways and Means",25,0,0,1,26
1903031,1579355,2025-05-27,Assembly,"Assembly Ways And Means Committee: Favorable refer to committee Rules",32,0,0,3,35
1903031,1581494,2025-05-29,Assembly,"Assembly Rules Committee: Favorable",27,0,0,4,31
1903031,1582145,2025-05-29,Assembly,"Assembly Floor Vote - Final Passage",146,0,0,4,150
1903031,1590353,2025-06-12,Senate,"Senate Floor Vote - Final Passage",59,0,0,4,63
1903073,1585577,2025-06-05,Assembly,"Assembly Codes Committee: Favorable refer to committee Rules",15,6,0,1,22
1903073,1593602,2025-06-16,Assembly,"Assembly Rules Committee: Favorable",20,9,0,2,31
1903126,1498626,2025-02-25,Assembly,"Assembly Governmental Operations Committee: Favorable",8,5,0,1,14
1903126,1528573,2025-03-26,Assembly,"Assembly Floor Vote - Final Passage",89,60,0,1,150
1903160,1573842,2025-05-20,Assembly,"Assembly Agriculture Committee: Favorable refer to committee Codes",23,0,0,0,23
1903160,1580457,2025-05-28,Assembly,"Assembly Codes Committee: Favorable refer to committee Rules",15,6,0,1,22
1903174,1562028,2025-04-30,Assembly,"Assembly Local Governments Committee: Favorable refer to committee Ways and Means",18,0,0,2,20
1903174,1570617,2025-05-13,Assembly,"Assembly Ways And Means Committee: Favorable",34,0,0,1,35
1903174,1573827,2025-05-19,Assembly,"Assembly Floor Vote - Final Passage",143,0,0,7,150
1903174,1589426,2025-06-11,Senate,"Senate Floor Vote - Final Passage",58,1,0,4,63
1903201,1519424,2025-03-18,Assembly,"Assembly Health Committee: Favorable refer to committee Ways and Means",19,6,0,1,26
1903201,1579389,2025-05-27,Assembly,"Assembly Ways And Means Committee: Favorable refer to committee Rules",22,10,0,3,35
1903201,1581548,2025-05-29,Assembly,"Assembly Rules Committee: Favorable",18,9,0,4,31
1903242,1486458,2025-02-11,Assembly,"Assembly Governmental Employees Committee: Favorable",14,0,0,0,14
1903242,1500149,2025-02-25,Assembly,"Assembly Floor Vote - Final Passage",146,0,0,4,150
1903242,1589882,2025-06-11,Senate,"Senate Floor Vote - Final Passage",59,0,0,4,63
1903245,1560847,2025-04-29,Assembly,"Assembly Children And Families Committee: Favorable refer to committee Ways and Means",17,0,0,0,17
1903252,1585592,2025-06-05,Assembly,"Assembly Governmental Employees Committee: Favorable refer to committee Rules",14,0,0,0,14
1903252,1588476,2025-06-11,Assembly,"Assembly Rules Committee: Favorable",28,0,0,3,31
1903271,1587309,2025-06-10,Assembly,"Assembly Ways And Means Committee: Favorable refer to committee Rules",32,0,0,3,35
1903271,1588551,2025-06-11,Assembly,"Assembly Rules Committee: Favorable",28,0,0,3,31
1903271,1589449,2025-06-11,Assembly,"Assembly Floor Vote - Final Passage",146,0,0,4,150
1903271,1590259,2025-06-12,Senate,"Senate Floor Vote - Final Passage",59,0,0,4,63
1903281,1579165,2025-05-27,Assembly,"Assembly Education Committee: Favorable refer to committee Ways and Means",28,0,0,3,31
1903281,1585968,2025-06-06,Assembly,"Assembly Ways And Means Committee: Favorable refer to committee Rules",35,0,0,0,35
1903281,1588468,2025-06-11,Assembly,"Assembly Rules Committee: Favorable",28,0,0,3,31
1903281,1589179,2025-06-11,Senate,"Senate Floor Vote - Final Passage",59,0,0,4,63
1903281,1589482,2025-06-11,Assembly,"Assembly Floor Vote - Final Passage",146,0,0,4,150
1903292,1573387,2025-05-19,Assembly,"Assembly Health Committee: Favorable refer to committee Ways and Means",16,8,0,2,26
1903297,1473082,2025-01-22,Assembly,"Assembly Codes Committee: Favorable refer to committee Rules",15,5,0,2,22
1903297,1474235,2025-01-22,Assembly,"Assembly Rules Committee: Favorable",20,9,0,2,31
1903302,1580041,2025-05-28,Assembly,"Assembly Banks Committee: Favorable refer to committee Codes",20,8,0,3,31
1903302,1585420,2025-06-05,Assembly,"Assembly Codes Committee: Favorable refer to committee Rules",14,7,0,1,22
1903307,1565899,2025-05-06,Assembly,"Assembly Consumer Affairs And Protection Committee: Favorable refer to committee Codes",16,0,0,0,16
1903307,1585762,2025-06-05,Assembly,"Assembly Codes Committee: Favorable refer to committee Ways and Means",21,0,0,1,22
1903307,1585936,2025-06-06,Assembly,"Assembly Ways And Means Committee: Favorable refer to committee Rules",34,1,0,0,35
1903307,1587004,2025-06-09,Assembly,"Assembly Rules Committee: Favorable",25,0,0,6,31
1903307,1587005,2025-06-09,Senate,"Senate Floor Vote - Final Passage",62,0,0,1,63
1903307,1587393,2025-06-09,Assembly,"Assembly Floor Vote - Final Passage",143,1,0,6,150
1903364,1571329,2025-05-06,Senate,"Senate Social Services Committee Vote",6,0,0,0,6
1903364,1571330,2025-05-14,Senate,"Senate Floor Vote - Final Passage",56,1,0,5,62
1903366,1475570,2025-01-27,Senate,"Senate Judiciary Committee Vote",14,5,0,0,19
1903406,1479419,2025-02-03,Senate,"Senate Housing, Construction And Community Development Committee Vote",8,3,0,0,11
1903406,1564859,2025-05-05,Senate,"Senate Internet And Technology Committee Vote",5,2,0,0,7
1903406,1571361,2025-05-14,Senate,"Senate Floor Vote - Final Passage",37,20,0,5,62
1903425,1504709,2025-03-03,Senate,"Senate Housing, Construction And Community Development Committee Vote",11,0,0,0,11
1903430,1512079,2025-02-11,Senate,"Senate Judiciary Committee Vote",19,0,0,0,19
1903430,1512080,2025-03-10,Senate,"Senate Floor Vote - Final Passage",60,1,0,2,63
1903430,1587888,2025-06-09,Assembly,"Assembly Floor Vote - Final Passage",104,39,0,7,150
1903442,1574471,2025-05-20,Assembly,"Assembly Energy Committee: Favorable refer to committee Codes",11,5,0,1,17
1903442,1580376,2025-05-28,Assembly,"Assembly Codes Committee: Favorable refer to committee Ways and Means",15,6,0,1,22
1903442,1580956,2025-05-29,Assembly,"Assembly Ways And Means Committee: Favorable refer to committee Rules",24,10,0,1,35
1903442,1586996,2025-06-09,Assembly,"Assembly Rules Committee: Favorable",17,8,0,6,31
1903442,1589109,2025-06-10,Assembly,"Assembly Floor Vote - Final Passage",99,46,0,5,150
1903466,1472614,2025-01-21,Senate,"Senate Floor Vote - Final Passage",49,10,0,4,63
1903466,1472979,2025-01-21,Senate,"Senate Rules Committee Vote",16,3,0,2,21
1903466,1473440,2025-01-22,Assembly,"Assembly Floor Vote - Final Passage",96,41,0,13,150
1903469,1581093,2025-05-06,Senate,"Senate Civil Service And Pensions Committee Vote",7,0,0,0,7
1903469,1581094,2025-05-28,Senate,"Senate Floor Vote - Final Passage",61,0,0,2,63
1903469,1588907,2025-06-10,Assembly,"Assembly Floor Vote - Final Passage",120,27,0,3,150
1903495,1559705,2025-02-11,Senate,"Senate Judiciary Committee Vote",13,6,0,0,19
1903495,1560492,2025-04-29,Senate,"Senate Floor Vote - Final Passage",38,23,0,1,62
1903495,1579566,2025-05-27,Assembly,"Assembly Floor Vote - Final Passage",95,50,0,5,150
1903496,1509254,2025-02-10,Senate,"Senate Internet And Technology Committee Vote",6,1,0,0,7
1903496,1509255,2025-03-10,Senate,"Senate Floor Vote - Final Passage",60,1,0,2,63
1903496,1590335,2025-06-12,Senate,"Senate Floor Vote - Final Passage",58,1,0,4,63
1903500,1471361,2025-01-14,Assembly,"Assembly Consumer Affairs And Protection Committee: Favorable refer to committee Rules",15,0,0,1,16
1903500,1471618,2025-01-14,Assembly,"Assembly Consumer Affairs And Protection Committee: Favorable refer to committee Rules",15,0,0,1,16
1903500,1472981,2025-01-21,Assembly,"Assembly Floor Vote - Final Passage",147,0,0,3,150
1903500,1475658,2025-01-28,Senate,"Senate Floor Vote - Final Passage",61,0,0,2,63
1903512,1512921,2025-02-10,Senate,"Senate Elections Committee Vote",5,2,0,0,7
1903512,1512922,2025-03-10,Senate,"Senate Floor Vote - Final Passage",40,21,0,2,63
1903512,1582095,2025-05-29,Assembly,"Assembly Floor Vote - Final Passage",135,10,0,5,150
1903533,1475260,2025-01-27,Senate,"Senate Housing, Construction And Community Development Committee Vote",8,3,0,0,11
1903550,1475269,2025-01-27,Senate,"Senate Housing, Construction And Community Development Committee Vote",8,3,0,0,11
1903550,1588463,2025-06-10,Senate,"Senate Floor Vote - Final Passage",38,20,0,5,63
1903550,1588464,2025-06-10,Senate,"Senate Rules Committee Vote",12,7,0,2,21
1903564,1532001,2025-03-25,Senate,"Senate Judiciary Committee Vote",17,1,0,1,19
1903564,1533092,2025-04-01,Senate,"Senate Floor Vote - Final Passage",55,8,0,0,63
1903580,1500742,2025-02-10,Senate,"Senate Internet And Technology Committee Vote",6,1,0,0,7
1903580,1500743,2025-02-26,Senate,"Senate Floor Vote - Final Passage",56,5,0,2,63
1903585,1504105,2025-01-27,Senate,"Senate Housing, Construction And Community Development Committee Vote",11,0,0,0,11
1903585,1504106,2025-03-03,Senate,"Senate Floor Vote - Final Passage",55,6,0,2,63
1903602,1587158,2025-06-09,Senate,"Senate Floor Vote - Final Passage",45,17,0,1,63
1903602,1587159,2025-06-09,Senate,"Senate Rules Committee Vote",14,7,0,0,21
1903647,1486162,2025-02-10,Senate,"Senate Internet And Technology Committee Vote",7,0,0,0,7
1903647,1504847,2025-03-04,Senate,"Senate Finance Committee Vote",21,0,0,1,22
1903647,1575940,2025-05-22,Senate,"Senate Floor Vote - Final Passage",57,0,0,5,62
1903795,1479784,2025-02-04,Assembly,"Assembly Health Committee: Favorable refer to committee Ways and Means",23,0,0,3,26
1903806,1534119,2025-04-02,Assembly,"Assembly Insurance Committee: Favorable",20,5,0,0,25
1903810,1509246,2025-02-04,Senate,"Senate Crime Victims, Crime And Correction Committee Vote",7,0,0,0,7
1903810,1509247,2025-03-10,Senate,"Senate Floor Vote - Final Passage",43,18,0,2,63
1903815,1589317,2025-06-11,Senate,"Senate Rules Committee Vote",19,1,0,1,21
1903815,1590474,2025-06-12,Senate,"Senate Floor Vote - Final Passage",59,0,0,4,63
1903825,1574385,2025-05-20,Assembly,"Assembly Labor Committee: Favorable refer to committee Rules",28,1,0,0,29
1903825,1574887,2025-05-21,Assembly,"Assembly Rules Committee: Favorable",29,0,0,2,31
1903825,1575837,2025-05-21,Assembly,"Assembly Floor Vote - Final Passage",141,3,0,6,150
1903829,1472874,2025-01-21,Assembly,"Assembly Health Committee: Favorable refer to committee Rules",26,0,0,0,26
1903829,1474334,2025-01-22,Assembly,"Assembly Rules Committee: Favorable",29,0,0,2,31
1903829,1476104,2025-01-28,Assembly,"Assembly Floor Vote - Final Passage",145,0,0,5,150
1903829,1485636,2025-02-10,Senate,"Senate Floor Vote - Final Passage",61,0,0,2,63
1903842,1471352,2025-01-14,Assembly,"Assembly Health Committee: Favorable refer to committee Rules",25,0,0,1,26
1903842,1471620,2025-01-14,Assembly,"Assembly Health Committee: Favorable refer to committee Rules",25,0,0,1,26
1903842,1473615,2025-01-22,Assembly,"Assembly Floor Vote - Final Passage",145,0,0,5,150
1903842,1482172,2025-02-05,Senate,"Senate Floor Vote - Final Passage",62,0,0,1,63
1903852,1471354,2025-01-14,Assembly,"Assembly Health Committee: Favorable refer to committee Rules",25,0,0,1,26
1903852,1471615,2025-01-14,Assembly,"Assembly Health Committee: Favorable refer to committee Rules",25,0,0,1,26
1903852,1473441,2025-01-22,Assembly,"Assembly Floor Vote - Final Passage",146,0,0,4,150
1903852,1480866,2025-02-05,Senate,"Senate Floor Vote - Final Passage",62,0,0,1,63
1903853,1574830,2025-05-21,Senate,"Senate Mental Health Committee Vote",7,0,0,0,7
1903857,1471357,2025-01-14,Assembly,"Assembly Children And Families Committee: Favorable refer to committee Rules",12,4,0,1,17
1903857,1471630,2025-01-14,Assembly,"Assembly Rules Committee: Favorable",20,9,0,2,31
1903863,1573892,2025-05-20,Assembly,"Assembly Education Committee: Held for Consideration",20,8,0,3,31
1903864,1473058,2025-01-22,Assembly,"Assembly Codes Committee: Favorable refer to committee Rules",20,0,0,2,22
1903864,1474174,2025-01-22,Assembly,"Assembly Rules Committee: Favorable",29,0,0,2,31
1903864,1476232,2025-01-28,Assembly,"Assembly Floor Vote - Final Passage",145,0,0,5,150
1903864,1482366,2025-02-05,Senate,"Senate Floor Vote - Final Passage",62,0,0,1,63
1903878,1563505,2025-04-29,Senate,"Senate Health Committee Vote",14,0,0,0,14
1903883,1471360,2025-01-14,Assembly,"Assembly Health Committee: Favorable refer to committee Rules",25,0,0,1,26
1903883,1471629,2025-01-14,Assembly,"Assembly Health Committee: Favorable refer to committee Rules",25,0,0,1,26
1903883,1473839,2025-01-22,Assembly,"Assembly Floor Vote - Final Passage",146,0,0,4,150
1903883,1480227,2025-02-04,Senate,"Senate Floor Vote - Final Passage",61,0,0,2,63
1903885,1471293,2025-01-13,Senate,"Senate Floor Vote - Final Passage",61,0,0,2,63
1903885,1471294,2025-01-13,Senate,"Senate Rules Committee Vote",21,0,0,0,21
1903885,1572781,2025-05-15,Assembly,"Assembly Floor Vote - Final Passage",141,0,0,9,150
1903893,1588287,2025-05-20,Senate,"Senate Cultural Affairs, Tourism, Parks And Recreation Committee Vote",7,0,0,0,7
1903893,1588288,2025-06-10,Senate,"Senate Floor Vote - Final Passage",58,0,0,5,63
1903906,1519607,2025-03-12,Senate,"Senate Commerce, Economic Development And Small Business Committee Vote",9,0,0,0,9
1903906,1519608,2025-03-18,Senate,"Senate Floor Vote - Final Passage",57,4,0,2,63
1903925,1472728,2025-01-21,Assembly,"Assembly Health Committee: Favorable refer to committee Ways and Means",26,0,0,0,26
1903925,1590763,2025-06-13,Assembly,"Assembly Rules Committee: Favorable",29,0,0,2,31
1903925,1590764,2025-06-13,Assembly,"Assembly Ways And Means Committee: Favorable refer to committee Rules",32,0,0,3,35
1903936,1574147,2025-05-20,Senate,"Senate Finance Committee Vote",22,0,0,0,22
1903943,1570946,2025-05-13,Senate,"Senate Energy And Telecommunications Committee Vote",7,2,0,0,9
1903952,1579467,2025-05-27,Senate,"Senate New York City Education Committee Vote",6,0,0,0,6
1903956,1570950,2025-05-13,Senate,"Senate Transportation Committee Vote",12,1,0,0,13
1903961,1475527,2025-01-28,Assembly,"Assembly Rules Committee: Favorable",31,0,0,0,31
1903961,1475528,2025-01-28,Assembly,"Assembly Social Services Committee: Favorable refer to committee Rules",17,0,0,1,18
1903968,1578923,2025-04-29,Senate,"Senate Investigations And Government Operations Committee Vote",7,0,0,0,7
1903968,1587795,2025-05-27,Senate,"Senate Floor Vote - Final Passage",51,8,0,4,63
1903968,1588697,2025-06-10,Assembly,"Assembly Floor Vote - Final Passage",120,27,0,3,150
1903973,1473113,2025-01-22,Assembly,"Assembly Codes Committee: Favorable refer to committee Rules",20,0,0,2,22
1903973,1474231,2025-01-22,Assembly,"Assembly Rules Committee: Favorable",29,0,0,2,31
1903973,1476105,2025-01-28,Assembly,"Assembly Floor Vote - Final Passage",145,0,0,5,150
1903973,1486156,2025-02-11,Senate,"Senate Floor Vote - Final Passage",60,1,0,2,63
1903977,1553617,2025-02-11,Senate,"Senate Environmental Conservation Committee Vote",11,0,0,0,11
1903977,1553618,2025-04-22,Senate,"Senate Floor Vote - Final Passage",50,3,0,9,62
1903977,1589668,2025-06-11,Assembly,"Assembly Floor Vote - Final Passage",91,48,0,11,150
1903993,1586153,2025-05-19,Senate,"Senate Energy And Telecommunications Committee Vote",9,0,0,0,9
1903993,1586154,2025-06-06,Senate,"Senate Floor Vote - Final Passage",52,1,0,10,63
1904005,1560511,2025-04-29,Assembly,"Assembly Corporations, Authorities And Commissions Committee: Favorable refer to committee Codes",17,8,0,1,26
1904005,1586670,2025-06-09,Assembly,"Assembly Ways And Means Committee: Favorable refer to committee Rules",21,10,0,4,35
1904005,1588557,2025-06-11,Assembly,"Assembly Rules Committee: Favorable",19,9,0,3,31
1904006,1498804,2025-02-04,Senate,"Senate Cultural Affairs, Tourism, Parks And Recreation Committee Vote",6,0,0,1,7
1904006,1499646,2025-02-25,Senate,"Senate Floor Vote - Final Passage",61,0,0,2,63
1904006,1579950,2025-05-27,Assembly,"Assembly Floor Vote - Final Passage",145,0,0,5,150
1904009,1516354,2025-03-04,Senate,"Senate Finance Committee Vote",21,0,0,1,22
1904009,1516355,2025-03-12,Senate,"Senate Floor Vote - Final Passage",60,0,0,3,63
1904021,1471372,2025-01-14,Assembly,"Assembly Consumer Affairs And Protection Committee: Favorable refer to committee Codes",10,5,0,1,16
1904021,1471604,2025-01-14,Assembly,"Assembly Consumer Affairs And Protection Committee: Favorable refer to committee Rules",10,5,0,1,16
1904027,1471283,2025-01-13,Senate,"Senate Floor Vote - Final Passage",39,22,0,2,63
1904027,1471284,2025-01-13,Senate,"Senate Rules Committee Vote",14,7,0,0,21
1904046,1590267,2025-06-12,Senate,"Senate Rules Committee Vote",17,3,0,1,21
1904046,1590815,2025-06-13,Senate,"Senate Floor Vote - Final Passage",51,8,0,4,63
1904055,1526803,2025-03-25,Assembly,"Assembly Codes Committee: Favorable",21,0,0,1,22
1904055,1533973,2025-04-01,Assembly,"Assembly Floor Vote - Final Passage",144,0,0,6,150
1904058,1580180,2025-05-28,Assembly,"Assembly Transportation Committee: Held for Consideration",16,7,0,3,26
1904073,1471359,2025-01-14,Assembly,"Assembly Health Committee: Favorable refer to committee Rules",25,0,0,1,26
1904073,1471617,2025-01-14,Assembly,"Assembly Health Committee: Favorable refer to committee Rules",25,0,0,1,26
1904073,1472912,2025-01-21,Assembly,"Assembly Floor Vote - Final Passage",147,0,0,3,150
1904073,1488576,2025-02-12,Senate,"Senate Floor Vote - Final Passage",59,0,0,4,63
1904078,1569483,2025-05-12,Senate,"Senate Insurance Committee Vote",11,0,0,0,11
1904078,1580857,2025-05-28,Senate,"Senate Finance Committee Vote",22,0,0,0,22
1904078,1588238,2025-06-10,Senate,"Senate Floor Vote - Final Passage",56,2,0,5,63
1904095,1487811,2025-02-11,Senate,"Senate Energy And Telecommunications Committee Vote",6,3,0,0,9
1904095,1590871,2025-06-12,Senate,"Senate Rules Committee Vote",14,6,0,1,21
1904095,1590872,2025-06-13,Senate,"Senate Floor Vote - Final Passage",45,14,0,4,63
1904104,1587404,2025-05-13,Senate,"Senate Finance Committee Vote",16,6,0,0,22
1904104,1587405,2025-06-09,Senate,"Senate Floor Vote - Final Passage",47,15,0,1,63
1904114,1498314,2025-02-04,Senate,"Senate Cultural Affairs, Tourism, Parks And Recreation Committee Vote",6,0,0,1,7
1904114,1498315,2025-02-24,Senate,"Senate Floor Vote - Final Passage",58,2,0,3,63
1904123,1471370,2025-01-14,Assembly,"Assembly Children And Families Committee: Favorable refer to committee Rules",16,0,0,1,17
1904123,1471439,2025-01-14,Assembly,"Assembly Rules Committee: Favorable",29,0,0,2,31
1904131,1471371,2025-01-14,Assembly,"Assembly Health Committee: Favorable refer to committee Rules",25,0,0,1,26
1904131,1471632,2025-01-14,Assembly,"Assembly Health Committee: Favorable refer to committee Rules",25,0,0,1,26
1904131,1473854,2025-01-22,Assembly,"Assembly Floor Vote - Final Passage",145,0,0,5,150
1904131,1486934,2025-02-11,Senate,"Senate Floor Vote - Final Passage",39,22,0,2,63
1904133,1574067,2025-05-20,Assembly,"Assembly Environmental Conservation Committee: Held for Consideration",21,9,0,0,30
1904139,1585271,2025-05-29,Senate,"Senate Rules Committee Vote",20,0,0,1,21
1904139,1585272,2025-06-04,Senate,"Senate Floor Vote - Final Passage",57,1,0,5,63
1904152,1498070,2025-02-24,Assembly,"Assembly Consumer Affairs And Protection Committee: Favorable refer to committee Codes",14,0,0,2,16
1904152,1535109,2025-04-02,Assembly,"Assembly Codes Committee: Favorable",20,0,0,2,22
1904152,1575294,2025-05-20,Assembly,"Assembly Floor Vote - Final Passage",120,27,0,3,150
1904162,1566485,2025-05-06,Assembly,"Assembly Codes Committee: Favorable",22,0,0,0,22
1904162,1570078,2025-05-12,Assembly,"Assembly Floor Vote - Final Passage",142,0,0,8,150
1904162,1586188,2025-06-06,Senate,"Senate Floor Vote - Final Passage",53,0,0,10,63
1904165,1584701,2025-05-13,Senate,"Senate Environmental Conservation Committee Vote",11,0,0,0,11
1904165,1585327,2025-06-04,Senate,"Senate Floor Vote - Final Passage",58,0,0,5,63
1904165,1591088,2025-06-13,Assembly,"Assembly Floor Vote - Final Passage",137,0,0,13,150
1904169,1475504,2025-01-28,Assembly,"Assembly Rules Committee: Favorable",31,0,0,0,31
1904169,1475505,2025-01-28,Assembly,"Assembly Social Services Committee: Favorable refer to committee Rules",17,0,0,1,18
1904181,1487686,2025-02-11,Senate,"Senate Civil Service And Pensions Committee Vote",6,1,0,0,7
1904181,1574556,2025-05-20,Senate,"Senate Finance Committee Vote",16,6,0,0,22
1904181,1587882,2025-06-10,Senate,"Senate Floor Vote - Final Passage",40,18,0,5,63
1904195,1590149,2025-02-04,Senate,"Senate Crime Victims, Crime And Correction Committee Vote",6,1,0,0,7
1904195,1590313,2025-06-12,Senate,"Senate Floor Vote - Final Passage",38,21,0,4,63
1904207,1471362,2025-01-14,Assembly,"Assembly Children And Families Committee: Favorable refer to committee Rules",16,0,0,1,17
1904207,1471438,2025-01-14,Assembly,"Assembly Rules Committee: Favorable",29,0,0,2,31
1904210,1557009,2025-04-08,Senate,"Senate Cultural Affairs, Tourism, Parks And Recreation Committee Vote",7,0,0,0,7
1904210,1557010,2025-04-24,Senate,"Senate Floor Vote - Final Passage",51,0,0,11,62
1904222,1585846,2025-05-28,Senate,"Senate Veterans, Homeland Security And Military Affairs Committee Vote",9,0,0,0,9
1904222,1585847,2025-06-05,Senate,"Senate Floor Vote - Final Passage",60,0,0,3,63
1904245,1573867,2025-01-27,Senate,"Senate Codes Committee Vote",9,3,0,1,13
1904245,1573868,2025-05-19,Senate,"Senate Floor Vote - Final Passage",35,21,0,6,62
1904251,1479420,2025-02-04,Assembly,"Assembly Energy Committee: Favorable refer to committee Ways and Means",15,0,0,2,17
1904251,1574224,2025-05-20,Assembly,"Assembly Ways And Means Committee: Favorable refer to committee Rules",35,0,0,0,35
1904251,1575284,2025-05-21,Assembly,"Assembly Rules Committee: Favorable",29,0,0,2,31
1904251,1575779,2025-05-21,Assembly,"Assembly Floor Vote - Final Passage",144,0,0,6,150
1904257,1471341,2025-01-13,Senate,"Senate Floor Vote - Final Passage",57,4,0,2,63
1904257,1471342,2025-01-13,Senate,"Senate Rules Committee Vote",21,0,0,0,21
1904269,1578921,2025-05-27,Assembly,"Assembly Consumer Affairs And Protection Committee: Favorable refer to committee Codes",15,0,0,1,16
1904272,1584731,2025-05-29,Senate,"Senate Rules Committee Vote",14,6,0,1,21
1904272,1584732,2025-06-04,Senate,"Senate Floor Vote - Final Passage",34,24,0,5,63
1904283,1570783,2025-03-11,Senate,"Senate Judiciary Committee Vote",19,0,0,0,19
1904283,1570784,2025-05-13,Senate,"Senate Floor Vote - Final Passage",57,0,0,5,62
1904287,1471477,2025-01-14,Assembly,"Assembly Consumer Affairs And Protection Committee: Favorable refer to committee Codes",15,0,0,1,16
1904287,1473067,2025-01-22,Assembly,"Assembly Codes Committee: Favorable refer to committee Rules",20,0,0,2,22
1904287,1474173,2025-01-22,Assembly,"Assembly Rules Committee: Favorable",29,0,0,2,31
1904290,1565096,2025-04-29,Senate,"Senate Children And Families Committee Vote",7,0,0,0,7
1904290,1565097,2025-05-05,Senate,"Senate Floor Vote - Final Passage",61,0,0,1,62
1904292,1513981,2025-03-11,Assembly,"Assembly Transportation Committee: Favorable refer to committee Ways and Means",25,0,0,1,26
1904315,1475513,2025-01-28,Assembly,"Assembly Election Law Committee: Favorable refer to committee Rules",10,5,0,1,16
1904315,1475514,2025-01-28,Assembly,"Assembly Rules Committee: Favorable",22,9,0,0,31
1904325,1475529,2025-01-28,Assembly,"Assembly Election Law Committee: Favorable refer to committee Rules",10,5,0,1,16
1904325,1475530,2025-01-28,Assembly,"Assembly Rules Committee: Favorable",22,9,0,0,31
1904328,1574531,2025-05-20,Assembly,"Assembly Small Business Committee: Held for Consideration",12,5,0,0,17
1904371,1519533,2025-03-18,Assembly,"Assembly Labor Committee: Favorable refer to committee Ways and Means",22,5,0,2,29
1904386,1526414,2025-03-25,Assembly,"Assembly People With Disabilities Committee: Favorable refer to committee Ways and Means",9,0,0,0,9
1904411,1471363,2025-01-14,Assembly,"Assembly Health Committee: Favorable refer to committee Rules",25,0,0,1,26
1904411,1471628,2025-01-14,Assembly,"Assembly Health Committee: Favorable refer to committee Rules",25,0,0,1,26
1904411,1473452,2025-01-22,Assembly,"Assembly Floor Vote - Final Passage",147,0,0,3,150
1904411,1482719,2025-02-05,Senate,"Senate Floor Vote - Final Passage",62,0,0,1,63
1904447,1589857,2025-06-12,Assembly,"Assembly Ways And Means Committee: Favorable refer to committee Rules",34,0,0,1,35
1904447,1590803,2025-06-13,Assembly,"Assembly Rules Committee: Favorable",29,0,0,2,31
1904483,1471298,2025-01-13,Assembly,"Assembly Governmental Operations Committee: Favorable refer to committee Rules",14,0,0,0,14
1904483,1471299,2025-01-13,Assembly,"Assembly Rules Committee: Favorable",28,0,0,3,31
1904483,1471673,2025-01-14,Assembly,"Assembly Floor Vote - Final Passage",149,0,0,1,150
1904483,1475935,2025-01-28,Senate,"Senate Floor Vote - Final Passage",61,0,0,2,63
1904507,1471369,2025-01-14,Assembly,"Assembly Children And Families Committee: Favorable refer to committee Rules",16,0,0,1,17
1904507,1471578,2025-01-14,Assembly,"Assembly Rules Committee: Favorable",29,0,0,2,31
1904507,1473823,2025-01-22,Assembly,"Assembly Floor Vote - Final Passage",147,0,0,3,150
1904507,1487418,2025-02-12,Senate,"Senate Floor Vote - Final Passage",58,1,0,4,63
1904543,1570419,2025-05-13,Assembly,"Assembly Insurance Committee: Favorable",24,0,0,1,25
1904543,1574991,2025-05-20,Assembly,"Assembly Floor Vote - Final Passage",147,0,0,3,150
1904543,1587215,2025-06-09,Senate,"Senate Floor Vote - Final Passage",62,0,0,1,63
1904580,1560888,2025-04-29,Assembly,"Assembly Children And Families Committee: Favorable refer to committee Ways and Means",17,0,0,0,17
1904647,1579423,2025-04-29,Senate,"Senate Investigations And Government Operations Committee Vote",7,0,0,0,7
1904647,1581005,2025-05-27,Senate,"Senate Floor Vote - Final Passage",50,9,0,4,63
1904647,1582072,2025-05-29,Assembly,"Assembly Floor Vote - Final Passage",108,38,0,4,150
1904663,1471304,2025-01-13,Senate,"Senate Floor Vote - Final Passage",61,0,0,2,63
1904663,1471305,2025-01-13,Senate,"Senate Rules Committee Vote",21,0,0,0,21
1904689,1513376,2025-03-11,Assembly,"Assembly Mental Health Committee: Favorable refer to committee Ways and Means",13,0,0,0,13
1904708,1471356,2025-01-14,Assembly,"Assembly Health Committee: Favorable refer to committee Rules",25,0,0,1,26
1904708,1471625,2025-01-14,Assembly,"Assembly Health Committee: Favorable refer to committee Rules",25,0,0,1,26
1904708,1473530,2025-01-22,Assembly,"Assembly Floor Vote - Final Passage",147,0,0,3,150
1904708,1479974,2025-02-04,Senate,"Senate Floor Vote - Final Passage",61,0,0,2,63
1904746,1471366,2025-01-14,Assembly,"Assembly Health Committee: Favorable refer to committee Rules",25,0,0,1,26
1904746,1471623,2025-01-14,Assembly,"Assembly Health Committee: Favorable refer to committee Rules",25,0,0,1,26
1904746,1473616,2025-01-22,Assembly,"Assembly Floor Vote - Final Passage",147,0,0,3,150
1904746,1487795,2025-02-12,Senate,"Senate Floor Vote - Final Passage",59,0,0,4,63
1904765,1479804,2025-02-04,Assembly,"Assembly Energy Committee: Favorable",12,3,0,2,17
1904765,1524035,2025-03-20,Assembly,"Assembly Floor Vote - Final Passage",104,39,0,7,150
1904783,1471374,2025-01-14,Assembly,"Assembly Health Committee: Favorable refer to committee Rules",25,0,0,1,26
1904783,1471582,2025-01-14,Assembly,"Assembly Health Committee: Favorable refer to committee Rules",25,0,0,1,26
1904783,1473503,2025-01-22,Assembly,"Assembly Floor Vote - Final Passage",147,0,0,3,150
1904783,1485816,2025-02-10,Senate,"Senate Floor Vote - Final Passage",61,0,0,2,63
1905342,1520279,2025-03-18,Assembly,"Assembly Health Committee: Favorable refer to committee Ways and Means",25,0,0,1,26
1905361,1479715,2025-02-04,Assembly,"Assembly Transportation Committee: Favorable refer to committee Ways and Means",24,1,0,1,26
1905361,1575810,2025-05-22,Assembly,"Assembly Ways And Means Committee: Favorable refer to committee Rules",26,5,0,4,35
1905365,1580393,2025-05-28,Assembly,"Assembly Insurance Committee: Favorable refer to committee Rules",24,0,0,1,25
1905391,1487797,2025-02-11,Senate,"Senate Budget And Revenue Committee Vote",7,0,0,0,7
1905483,1566143,2025-05-06,Assembly,"Assembly Consumer Affairs And Protection Committee: Favorable refer to committee Codes",16,0,0,0,16
1905483,1570489,2025-05-13,Assembly,"Assembly Codes Committee: Favorable",22,0,0,0,22
1905483,1575141,2025-05-20,Assembly,"Assembly Floor Vote - Final Passage",147,0,0,3,150
1905483,1587080,2025-06-09,Senate,"Senate Floor Vote - Final Passage",60,2,0,1,63
1905487,1559659,2025-04-28,Senate,"Senate Energy And Telecommunications Committee Vote",9,0,0,0,9
1905499,1574074,2025-04-08,Senate,"Senate Libraries Committee Vote",6,1,0,0,7
1905499,1574075,2025-05-20,Senate,"Senate Floor Vote - Final Passage",46,15,0,1,62
1905499,1592479,2025-06-17,Assembly,"Assembly Floor Vote - Final Passage",89,46,0,15,150
1905528,1471358,2025-01-14,Assembly,"Assembly Health Committee: Favorable refer to committee Rules",25,0,0,1,26
1905528,1471627,2025-01-14,Assembly,"Assembly Health Committee: Favorable refer to committee Rules",25,0,0,1,26
1905528,1475473,2025-01-27,Assembly,"Assembly Floor Vote - Final Passage",143,2,0,5,150
1905528,1482242,2025-02-05,Senate,"Senate Floor Vote - Final Passage",62,0,0,1,63
1905561,1479977,2025-01-27,Senate,"Senate Housing, Construction And Community Development Committee Vote",11,0,0,0,11
1905561,1479978,2025-02-04,Senate,"Senate Floor Vote - Final Passage",61,0,0,2,63
1905564,1574837,2025-05-20,Senate,"Senate Civil Service And Pensions Committee Vote",7,0,0,0,7
1905607,1574843,2025-05-20,Senate,"Senate Civil Service And Pensions Committee Vote",7,0,0,0,7
1905631,1559537,2025-04-28,Assembly,"Assembly Consumer Affairs And Protection Committee: Favorable refer to committee Codes",14,0,0,2,16
1905631,1580444,2025-05-28,Assembly,"Assembly Codes Committee: Favorable refer to committee Rules",21,0,0,1,22
1905631,1581552,2025-05-29,Assembly,"Assembly Rules Committee: Favorable",26,1,0,4,31
1905642,1486111,2025-02-10,Senate,"Senate Internet And Technology Committee Vote",6,1,0,0,7
1905642,1580845,2025-05-28,Senate,"Senate Finance Committee Vote",20,2,0,0,22
1905642,1589224,2025-06-11,Senate,"Senate Floor Vote - Final Passage",55,4,0,4,63
1905680,1589686,2025-06-09,Senate,"Senate Rules Committee Vote",21,0,0,0,21
1905680,1590502,2025-06-12,Senate,"Senate Floor Vote - Final Passage",53,6,0,4,63
1905683,1472969,2025-01-22,Senate,"Senate Social Services Committee Vote",7,0,0,0,7
1905687,1573414,2025-05-19,Assembly,"Assembly Alcoholism And Drug Abuse Committee: Favorable refer to committee Ways and Means",11,0,0,3,14
1905718,1566542,2025-05-06,Assembly,"Assembly Codes Committee: Favorable",20,2,0,0,22
1905726,1566544,2025-05-06,Senate,"Senate Education Committee Vote",14,0,0,0,14
1905726,1574532,2025-05-20,Senate,"Senate Finance Committee Vote",22,0,0,0,22
1905726,1580611,2025-05-28,Senate,"Senate Floor Vote - Final Passage",61,0,0,2,63
1905776,1509504,2025-02-11,Senate,"Senate Judiciary Committee Vote",15,4,0,0,19
1905776,1509505,2025-03-10,Senate,"Senate Floor Vote - Final Passage",52,9,0,2,63
1905811,1589191,2025-05-28,Senate,"Senate Investigations And Government Operations Committee Vote",6,1,0,0,7
1905811,1589192,2025-06-11,Senate,"Senate Floor Vote - Final Passage",45,14,0,4,63
1905828,1525097,2025-02-25,Senate,"Senate Environmental Conservation Committee Vote",11,0,0,0,11
1905828,1525098,2025-03-24,Senate,"Senate Floor Vote - Final Passage",59,0,0,4,63
1905828,1563440,2025-04-30,Assembly,"Assembly Floor Vote - Final Passage",144,1,0,5,150
1905841,1503988,2025-02-11,Senate,"Senate Consumer Protection Committee Vote",7,0,0,0,7
1905841,1503989,2025-03-03,Senate,"Senate Floor Vote - Final Passage",61,0,0,2,63
1905841,1590873,2025-06-09,Senate,"Senate Floor Vote - Final Passage",62,0,0,1,63
1905862,1519355,2025-03-18,Assembly,"Assembly Governmental Operations Committee: Favorable refer to committee Codes",14,0,0,0,14
1905862,1526126,2025-03-25,Assembly,"Assembly Codes Committee: Favorable refer to committee Rules",21,0,0,1,22
1905862,1526282,2025-03-25,Assembly,"Assembly Rules Committee: Favorable",30,0,0,1,31
1905862,1527379,2025-03-25,Assembly,"Assembly Floor Vote - Final Passage",149,0,0,1,150
1905877,1570436,2025-05-13,Assembly,"Assembly Insurance Committee: Favorable refer to committee Codes",16,8,0,1,25
1905877,1585404,2025-06-05,Assembly,"Assembly Codes Committee: Favorable refer to committee Rules",15,6,0,1,22
1905877,1586041,2025-06-06,Assembly,"Assembly Rules Committee: Favorable",19,8,0,4,31
1905880,1471300,2025-01-13,Senate,"Senate Floor Vote - Final Passage",39,22,0,2,63
1905880,1471301,2025-01-13,Senate,"Senate Rules Committee Vote",15,6,0,0,21
1905913,1574083,2025-04-08,Senate,"Senate Libraries Committee Vote",6,1,0,0,7
1905913,1574084,2025-05-20,Senate,"Senate Floor Vote - Final Passage",45,16,0,1,62
1905913,1590619,2025-06-12,Senate,"Senate Floor Vote - Final Passage",45,14,0,4,63
1905915,1557105,2025-02-25,Senate,"Senate Judiciary Committee Vote",19,0,0,0,19
1905915,1557106,2025-04-24,Senate,"Senate Floor Vote - Final Passage",51,0,0,11,62
1905984,1589287,2025-06-11,Senate,"Senate Rules Committee Vote",17,3,0,1,21
1905984,1590448,2025-06-12,Senate,"Senate Floor Vote - Final Passage",45,14,0,4,63
1905994,1471353,2025-01-14,Assembly,"Assembly Health Committee: Favorable refer to committee Rules",25,0,0,1,26
1905994,1471616,2025-01-14,Assembly,"Assembly Health Committee: Favorable refer to committee Rules",25,0,0,1,26
1905994,1473448,2025-01-22,Assembly,"Assembly Floor Vote - Final Passage",147,0,0,3,150
1905994,1482555,2025-02-05,Senate,"Senate Floor Vote - Final Passage",62,0,0,1,63
1906000,1585282,2025-05-29,Senate,"Senate Rules Committee Vote",13,7,0,1,21
1906000,1585283,2025-06-04,Senate,"Senate Floor Vote - Final Passage",35,23,0,5,63
1907238,1566553,2025-05-06,Senate,"Senate Cities 1 Committee Vote",7,0,0,0,7
1907251,1574452,2025-01-21,Senate,"Senate Health Committee Vote",12,2,0,1,15
1907251,1574453,2025-05-20,Senate,"Senate Floor Vote - Final Passage",56,5,0,1,62
1907251,1588859,2025-06-10,Assembly,"Assembly Floor Vote - Final Passage",105,41,0,4,150
1907264,1534335,2025-04-02,Senate,"Senate Environmental Conservation Committee Vote",10,1,0,0,11
1907264,1587018,2025-06-09,Senate,"Senate Rules Committee Vote",15,6,0,0,21
1907264,1588274,2025-06-10,Senate,"Senate Floor Vote - Final Passage",46,12,0,5,63
1907275,1584670,2025-05-29,Senate,"Senate Rules Committee Vote",19,1,0,1,21
1907275,1585179,2025-06-04,Senate,"Senate Floor Vote - Final Passage",55,3,0,5,63
1907283,1575701,2025-02-04,Senate,"Senate Crime Victims, Crime And Correction Committee Vote",7,0,0,0,7
1907283,1575702,2025-05-21,Senate,"Senate Floor Vote - Final Passage",45,14,0,3,62
1907300,1571296,2025-05-14,Senate,"Senate Agriculture Committee Vote",8,0,0,1,9
1907300,1583849,2025-05-28,Senate,"Senate Health Committee Vote",13,0,0,2,15
1907300,1590658,2025-06-12,Senate,"Senate Floor Vote - Final Passage",58,1,0,4,63
1907306,1486342,2025-02-11,Assembly,"Assembly Local Governments Committee: Favorable refer to committee Rules",18,0,0,2,20
1907306,1486343,2025-02-11,Assembly,"Assembly Rules Committee: Favorable",24,3,0,4,31
1907306,1487637,2025-02-12,Senate,"Senate Floor Vote - Final Passage",59,0,0,4,63
1907306,1489234,2025-02-12,Assembly,"Assembly Floor Vote - Final Passage",148,1,0,1,150
1907336,1471287,2025-01-13,Assembly,"Assembly Governmental Operations Committee: Favorable refer to committee Rules",14,0,0,0,14
1907336,1471288,2025-01-13,Assembly,"Assembly Rules Committee: Favorable",28,0,0,3,31
1907354,1475642,2025-01-28,Senate,"Senate Aging Committee Vote",7,0,0,0,7
1907355,1472285,2025-01-13,Assembly,"Assembly Floor Vote - Final Passage",140,6,0,4,150
1907359,1559636,2025-03-04,Senate,"Senate Health Committee Vote",15,0,0,0,15
1907359,1559637,2025-04-28,Senate,"Senate Floor Vote - Final Passage",60,0,0,2,62
1907361,1574811,2025-05-20,Senate,"Senate Health Committee Vote",13,0,0,1,14
1907366,1515659,2025-01-28,Senate,"Senate Aging Committee Vote",7,0,0,0,7
1907366,1515660,2025-03-11,Senate,"Senate Floor Vote - Final Passage",61,0,0,2,63
1907366,1588161,2025-06-10,Senate,"Senate Floor Vote - Final Passage",58,0,0,5,63
1907379,1587876,2025-02-04,Senate,"Senate Health Committee Vote",15,0,0,0,15
1907379,1587877,2025-06-10,Senate,"Senate Floor Vote - Final Passage",47,11,0,5,63
1907397,1585290,2025-05-29,Senate,"Senate Rules Committee Vote",20,0,0,1,21
1907397,1585291,2025-06-04,Senate,"Senate Floor Vote - Final Passage",58,0,0,5,63
1907408,1590332,2025-06-12,Senate,"Senate Floor Vote - Final Passage",51,8,0,4,63
1907408,1594953,2025-06-12,Senate,"Senate Rules Committee Vote",18,2,0,1,21
1907419,1534574,2025-04-02,Senate,"Senate Environmental Conservation Committee Vote",11,0,0,0,11
1907419,1560704,2025-04-29,Senate,"Senate Finance Committee Vote",21,1,0,0,22
1907419,1573627,2025-05-19,Senate,"Senate Floor Vote - Final Passage",56,0,0,6,62
1907419,1588182,2025-06-10,Senate,"Senate Floor Vote - Final Passage",58,0,0,5,63
1907447,1585301,2025-05-29,Senate,"Senate Rules Committee Vote",20,0,0,1,21
1907447,1585302,2025-06-04,Senate,"Senate Floor Vote - Final Passage",58,0,0,5,63
1907449,1516136,2025-02-25,Senate,"Senate Energy And Telecommunications Committee Vote",8,1,0,0,9
1907449,1516137,2025-03-12,Senate,"Senate Floor Vote - Final Passage",59,1,0,3,63
1907449,1574514,2025-05-20,Senate,"Senate Floor Vote - Final Passage",61,0,0,1,62
1907449,1579810,2025-05-27,Assembly,"Assembly Floor Vote - Final Passage",144,1,0,5,150
1907461,1571173,2025-03-18,Senate,"Senate Procurement And Contracts Committee Vote",7,0,0,0,7
1907461,1571174,2025-05-14,Senate,"Senate Floor Vote - Final Passage",47,10,0,5,62
1907461,1582053,2025-05-29,Assembly,"Assembly Floor Vote - Final Passage",144,2,0,4,150
1907467,1561779,2025-04-29,Senate,"Senate Transportation Committee Vote",13,0,0,0,13
1907467,1580862,2025-05-28,Senate,"Senate Finance Committee Vote",21,1,0,0,22
1907467,1585885,2025-06-05,Senate,"Senate Floor Vote - Final Passage",47,13,0,3,63
1907467,1592218,2025-06-16,Assembly,"Assembly Floor Vote - Final Passage",144,0,0,6,150
1907476,1561023,2025-04-29,Senate,"Senate Disabilities Committee Vote",6,0,0,0,6
1907476,1574575,2025-05-20,Senate,"Senate Finance Committee Vote",22,0,0,0,22
1907476,1586175,2025-06-06,Senate,"Senate Floor Vote - Final Passage",53,0,0,10,63
1907485,1509240,2025-01-21,Senate,"Senate Environmental Conservation Committee Vote",11,0,0,0,11
1907485,1509241,2025-03-10,Senate,"Senate Floor Vote - Final Passage",58,3,0,2,63
1907492,1589048,2025-03-04,Senate,"Senate Health Committee Vote",15,0,0,0,15
1907492,1589049,2025-06-11,Senate,"Senate Floor Vote - Final Passage",59,0,0,4,63
1907492,1591228,2025-06-13,Assembly,"Assembly Floor Vote - Final Passage",136,0,0,14,150
1907501,1498309,2025-02-10,Senate,"Senate Transportation Committee Vote",13,0,0,0,13
1907501,1498310,2025-02-24,Senate,"Senate Floor Vote - Final Passage",59,1,0,3,63
1907501,1588405,2025-06-10,Senate,"Senate Floor Vote - Final Passage",57,1,0,5,63
1907503,1518971,2025-03-04,Senate,"Senate Veterans, Homeland Security And Military Affairs Committee Vote",9,0,0,0,9
1907503,1518972,2025-03-17,Senate,"Senate Floor Vote - Final Passage",61,0,0,2,63
1907515,1585535,2025-05-19,Senate,"Senate Consumer Protection Committee Vote",6,0,0,1,7
1907515,1585536,2025-06-05,Senate,"Senate Floor Vote - Final Passage",60,0,0,3,63
1907526,1578799,2025-02-04,Senate,"Senate Veterans, Homeland Security And Military Affairs Committee Vote",9,0,0,0,9
1907526,1581371,2025-05-27,Senate,"Senate Floor Vote - Final Passage",59,0,0,4,63
1907526,1592518,2025-06-17,Assembly,"Assembly Floor Vote - Final Passage",135,0,0,15,150
1907528,1574701,2025-05-05,Senate,"Senate Codes Committee Vote",12,1,0,0,13
1907528,1574702,2025-05-20,Senate,"Senate Floor Vote - Final Passage",61,0,0,1,62
1907891,1479431,2025-02-04,Assembly,"Assembly Aging Committee: Favorable refer to committee Rules",30,0,0,0,30
1907891,1479652,2025-02-04,Assembly,"Assembly Rules Committee: Favorable",26,0,0,5,31
1907891,1482238,2025-02-05,Senate,"Senate Floor Vote - Final Passage",62,0,0,1,63
1907891,1483138,2025-02-05,Assembly,"Assembly Floor Vote - Final Passage",145,0,0,5,150
1907933,1505772,2025-02-25,Senate,"Senate Judiciary Committee Vote",19,0,0,0,19
1907933,1505773,2025-03-05,Senate,"Senate Floor Vote - Final Passage",60,1,0,2,63
1907933,1525920,2025-03-24,Assembly,"Assembly Floor Vote - Final Passage",143,4,0,3,150
1908264,1534624,2025-04-02,Senate,"Senate Environmental Conservation Committee Vote",10,1,0,0,11
1908264,1589226,2025-06-11,Senate,"Senate Floor Vote - Final Passage",42,17,0,4,63
1908264,1589227,2025-06-11,Senate,"Senate Rules Committee Vote",13,7,0,1,21
1908265,1574192,2025-05-20,Assembly,"Assembly Insurance Committee: Favorable refer to committee Rules",25,0,0,0,25
1908265,1575190,2025-05-21,Assembly,"Assembly Rules Committee: Favorable",29,0,0,2,31
1908265,1575769,2025-05-21,Assembly,"Assembly Floor Vote - Final Passage",144,0,0,6,150
1908265,1581162,2025-05-29,Senate,"Senate Floor Vote - Final Passage",56,0,0,7,63
1908272,1575877,2025-05-06,Senate,"Senate Education Committee Vote",14,0,0,0,14
1908272,1575878,2025-05-22,Senate,"Senate Floor Vote - Final Passage",56,1,0,5,62
1908272,1584795,2025-06-04,Senate,"Senate Floor Vote - Final Passage",57,1,0,5,63
1908272,1590636,2025-06-12,Senate,"Senate Floor Vote - Final Passage",59,0,0,4,63
1908272,1592604,2025-06-16,Assembly,"Assembly Floor Vote - Final Passage",145,0,0,5,150
1908282,1498645,2025-02-25,Assembly,"Assembly Children And Families Committee: Favorable refer to committee Ways and Means",17,0,0,0,17
1908283,1576171,2025-02-25,Senate,"Senate Banks Committee Vote",6,1,0,0,7
1908283,1576172,2025-05-22,Senate,"Senate Floor Vote - Final Passage",44,13,0,5,62
1908290,1473177,2025-01-21,Senate,"Senate Energy And Telecommunications Committee Vote",8,1,0,0,9
1908290,1474832,2025-01-27,Senate,"Senate Floor Vote - Final Passage",59,1,0,3,63
1908290,1474833,2025-01-27,Senate,"Senate Rules Committee Vote",20,0,0,1,21
1908302,1487097,2025-02-11,Assembly,"Assembly Alcoholism And Drug Abuse Committee: Favorable refer to committee Ways and Means",14,0,0,0,14
1908329,1574528,2025-05-20,Assembly,"Assembly Local Governments Committee: Favorable refer to committee Ways and Means",13,5,0,2,20
1908329,1579335,2025-05-27,Assembly,"Assembly Ways And Means Committee: Favorable refer to committee Rules",27,5,0,3,35
1908329,1581518,2025-05-29,Assembly,"Assembly Rules Committee: Favorable",27,0,0,4,31
1908329,1582196,2025-05-29,Assembly,"Assembly Floor Vote - Final Passage",143,3,0,4,150
1908329,1584992,2025-06-04,Senate,"Senate Floor Vote - Final Passage",58,0,0,5,63
1908335,1562667,2025-04-30,Assembly,"Assembly Environmental Conservation Committee: Favorable refer to committee Codes",23,6,0,1,30
1908335,1587014,2025-06-09,Assembly,"Assembly Codes Committee: Favorable refer to committee Ways and Means",15,5,0,2,22
1908339,1541247,2025-01-27,Senate,"Senate Codes Committee Vote",12,0,0,1,13
1908339,1541248,2025-04-08,Senate,"Senate Floor Vote - Final Passage",62,0,0,1,63
1908350,1590829,2025-05-19,Senate,"Senate Energy And Telecommunications Committee Vote",7,2,0,0,9
1908350,1590830,2025-06-12,Senate,"Senate Floor Vote - Final Passage",50,9,0,4,63
1908351,1573295,2025-05-13,Senate,"Senate Corporations, Authorities And Commissions Committee Vote",7,0,0,0,7
1908351,1573296,2025-05-19,Senate,"Senate Floor Vote - Final Passage",56,0,0,6,62
1908362,1475936,2025-01-28,Assembly,"Assembly Codes Committee: Favorable refer to committee Ways and Means",14,6,0,2,22
1908362,1560364,2025-04-29,Assembly,"Assembly Ways And Means Committee: Favorable refer to committee Rules",22,10,0,3,35
1908362,1561781,2025-04-30,Assembly,"Assembly Rules Committee: Favorable",20,9,0,2,31
1908362,1572050,2025-05-14,Assembly,"Assembly Floor Vote - Final Passage",97,50,0,3,150
1908366,1565641,2025-05-06,Assembly,"Assembly People With Disabilities Committee: Favorable refer to committee Ways and Means",9,0,0,0,9
1908366,1579013,2025-05-27,Assembly,"Assembly Ways And Means Committee: Favorable refer to committee Rules",32,0,0,3,35
1908366,1581144,2025-05-29,Assembly,"Assembly Rules Committee: Favorable",27,0,0,4,31
1908366,1582078,2025-05-29,Assembly,"Assembly Floor Vote - Final Passage",146,0,0,4,150
1908371,1586032,2025-06-06,Assembly,"Assembly Ways And Means Committee: Held for Consideration",25,10,0,0,35
1908389,1580174,2025-05-12,Senate,"Senate Women's Issues Committee Vote",7,0,0,0,7
1908389,1580664,2025-05-28,Senate,"Senate Floor Vote - Final Passage",61,0,0,2,63
1908411,1512015,2025-03-10,Senate,"Senate Housing, Construction And Community Development Committee Vote",10,1,0,0,11
1908416,1526494,2025-03-25,Assembly,"Assembly Consumer Affairs And Protection Committee: Favorable refer to committee Codes",15,0,0,1,16
1908416,1534329,2025-04-02,Assembly,"Assembly Codes Committee: Favorable refer to committee Ways and Means",20,0,0,2,22
1908416,1574662,2025-05-20,Assembly,"Assembly Ways And Means Committee: Favorable refer to committee Rules",35,0,0,0,35
1908416,1574914,2025-05-21,Assembly,"Assembly Rules Committee: Favorable",29,0,0,2,31
1908416,1575838,2025-05-21,Assembly,"Assembly Floor Vote - Final Passage",144,0,0,6,150
1908417,1499062,2025-02-04,Senate,"Senate Social Services Committee Vote",7,0,0,0,7
1908417,1499063,2025-02-25,Senate,"Senate Floor Vote - Final Passage",61,0,0,2,63
1908435,1565514,2025-05-06,Assembly,"Assembly Consumer Affairs And Protection Committee: Favorable refer to committee Codes",16,0,0,0,16
1908435,1585462,2025-06-05,Assembly,"Assembly Codes Committee: Favorable refer to committee Rules",21,0,0,1,22
1908435,1586872,2025-06-09,Assembly,"Assembly Rules Committee: Favorable",25,0,0,6,31
1908435,1587552,2025-06-09,Assembly,"Assembly Floor Vote - Final Passage",144,0,0,6,150
1908437,1515860,2025-03-12,Senate,"Senate Internet And Technology Committee Vote",6,1,0,0,7
1908450,1522181,2025-03-04,Senate,"Senate Health Committee Vote",15,0,0,0,15
1908450,1522182,2025-03-19,Senate,"Senate Floor Vote - Final Passage",60,0,0,3,63
1908459,1475608,2025-01-28,Senate,"Senate Consumer Protection Committee Vote",7,0,0,0,7
1908459,1561701,2025-04-29,Senate,"Senate Judiciary Committee Vote",17,2,0,0,19
1908459,1570754,2025-05-13,Senate,"Senate Floor Vote - Final Passage",46,11,0,5,62
1908459,1587190,2025-06-09,Senate,"Senate Floor Vote - Final Passage",51,11,0,1,63
1908459,1589619,2025-06-11,Assembly,"Assembly Floor Vote - Final Passage",96,50,0,4,150
1908469,1534072,2025-04-02,Assembly,"Assembly Environmental Conservation Committee: Favorable",19,9,0,2,30
1908473,1574072,2025-05-20,Assembly,"Assembly Environmental Conservation Committee: Favorable refer to committee Rules",22,8,0,0,30
1908488,1499992,2025-02-10,Senate,"Senate Transportation Committee Vote",13,0,0,0,13
1908488,1499993,2025-02-26,Senate,"Senate Floor Vote - Final Passage",61,0,0,2,63
1908497,1486033,2025-02-11,Assembly,"Assembly Judiciary Committee: Favorable",18,0,0,3,21
1908497,1522272,2025-03-19,Assembly,"Assembly Floor Vote - Final Passage",110,38,0,2,150
1908498,1504751,2025-03-04,Assembly,"Assembly Environmental Conservation Committee: Favorable refer to committee Codes",22,8,0,0,30
1908498,1566552,2025-05-06,Assembly,"Assembly Codes Committee: Favorable refer to committee Ways and Means",16,6,0,0,22
1908498,1590683,2025-06-13,Assembly,"Assembly Ways And Means Committee: Favorable refer to committee Rules",21,11,0,3,35
1908501,1574698,2025-05-20,Assembly,"Assembly Codes Committee: Held for Consideration",14,6,0,2,22
1908508,1479477,2025-02-04,Assembly,"Assembly Health Committee: Favorable refer to committee Codes",15,8,0,3,26
1908508,1486436,2025-02-11,Assembly,"Assembly Codes Committee: Favorable",16,6,0,0,22
1908519,1571717,2025-05-06,Senate,"Senate Consumer Protection Committee Vote",7,0,0,0,7
1908519,1571718,2025-05-14,Senate,"Senate Floor Vote - Final Passage",57,0,0,5,62
1908519,1591188,2025-06-13,Assembly,"Assembly Floor Vote - Final Passage",137,0,0,13,150
1908520,1526292,2025-03-25,Assembly,"Assembly Election Law Committee: Favorable",9,5,0,2,16
1908520,1572632,2025-05-15,Assembly,"Assembly Floor Vote - Final Passage",94,47,0,9,150
1908520,1587203,2025-06-09,Senate,"Senate Floor Vote - Final Passage",44,18,0,1,63
1908528,1534104,2025-04-02,Assembly,"Assembly Environmental Conservation Committee: Favorable refer to committee Codes",21,7,0,2,30
1908530,1580622,2025-05-28,Assembly,"Assembly Election Law Committee: Favorable refer to committee Rules",15,0,0,1,16
1908530,1581490,2025-05-29,Assembly,"Assembly Rules Committee: Favorable",27,0,0,4,31
1908530,1582183,2025-05-29,Assembly,"Assembly Floor Vote - Final Passage",146,0,0,4,150
1908530,1585581,2025-06-05,Senate,"Senate Floor Vote - Final Passage",60,0,0,3,63
1908586,1580274,2025-05-28,Assembly,"Assembly Environmental Conservation Committee: Favorable refer to committee Ways and Means",20,9,0,1,30
1908602,1479499,2025-02-04,Assembly,"Assembly Health Committee: Favorable refer to committee Ways and Means",23,0,0,3,26
1908602,1579402,2025-05-27,Assembly,"Assembly Ways And Means Committee: Favorable refer to committee Rules",30,2,0,3,35
1908602,1581506,2025-05-29,Assembly,"Assembly Rules Committee: Favorable",27,0,0,4,31
1908604,1473190,2025-01-21,Senate,"Senate Energy And Telecommunications Committee Vote",7,2,0,0,9
1908604,1474863,2025-01-27,Senate,"Senate Floor Vote - Final Passage",46,14,0,3,63
1908604,1474864,2025-01-27,Senate,"Senate Rules Committee Vote",15,5,0,1,21
1908611,1499708,2025-02-25,Senate,"Senate Energy And Telecommunications Committee Vote",8,1,0,0,9
1908624,1589207,2025-06-11,Senate,"Senate Floor Vote - Final Passage",36,23,0,4,63
1908624,1589208,2025-06-11,Senate,"Senate Rules Committee Vote",15,5,0,1,21
1908665,1570105,2025-05-13,Assembly,"Assembly Insurance Committee: Favorable",24,0,0,1,25
1908665,1573826,2025-05-19,Assembly,"Assembly Floor Vote - Final Passage",143,0,0,7,150
1908666,1526460,2025-03-25,Assembly,"Assembly Election Law Committee: Favorable refer to committee Ways and Means",14,0,0,2,16
1908670,1473199,2025-01-21,Senate,"Senate Energy And Telecommunications Committee Vote",8,1,0,0,9
1908670,1474860,2025-01-27,Senate,"Senate Floor Vote - Final Passage",59,1,0,3,63
1908670,1474861,2025-01-27,Senate,"Senate Rules Committee Vote",20,0,0,1,21
1908672,1584975,2025-05-27,Senate,"Senate Civil Service And Pensions Committee Vote",6,0,0,1,7
1908672,1584976,2025-06-04,Senate,"Senate Floor Vote - Final Passage",58,0,0,5,63
1908672,1589022,2025-06-10,Assembly,"Assembly Floor Vote - Final Passage",147,0,0,3,150
1908704,1590139,2025-05-27,Senate,"Senate New York City Education Committee Vote",6,0,0,0,6
1908704,1590523,2025-06-12,Senate,"Senate Floor Vote - Final Passage",59,0,0,4,63
1908748,1570096,2025-05-13,Assembly,"Assembly Housing Committee: Favorable refer to committee Codes",22,5,0,1,28
1908748,1585415,2025-06-05,Assembly,"Assembly Codes Committee: Favorable refer to committee Rules",15,6,0,1,22
1908748,1585941,2025-06-06,Assembly,"Assembly Rules Committee: Favorable",19,8,0,4,31
1908808,1559538,2025-04-28,Assembly,"Assembly Health Committee: Favorable refer to committee Codes",20,5,0,1,26
1908808,1570893,2025-05-13,Assembly,"Assembly Codes Committee: Favorable",16,6,0,0,22
1908811,1574863,2025-05-21,Senate,"Senate Mental Health Committee Vote",7,0,0,0,7
1908811,1581827,2025-05-29,Senate,"Senate Rules Committee Vote",20,0,0,1,21
1908811,1585132,2025-06-04,Senate,"Senate Floor Vote - Final Passage",58,0,0,5,63
1908832,1499026,2025-02-25,Assembly,"Assembly Children And Families Committee: Favorable refer to committee Ways and Means",17,0,0,0,17
1908832,1532048,2025-04-01,Assembly,"Assembly Rules Committee: Favorable",30,0,0,1,31
1908832,1532049,2025-04-01,Assembly,"Assembly Ways And Means Committee: Favorable refer to committee Rules",33,0,0,2,35
1908832,1533971,2025-04-01,Assembly,"Assembly Floor Vote - Final Passage",144,0,0,6,150
1908832,1588177,2025-06-10,Senate,"Senate Floor Vote - Final Passage",58,0,0,5,63
1908835,1471348,2025-01-14,Assembly,"Assembly Health Committee: Favorable refer to committee Rules",25,0,0,1,26
1908835,1471638,2025-01-14,Assembly,"Assembly Health Committee: Favorable refer to committee Rules",25,0,0,1,26
1908835,1475345,2025-01-27,Assembly,"Assembly Floor Vote - Final Passage",145,0,0,5,150
1908835,1485751,2025-02-10,Senate,"Senate Floor Vote - Final Passage",60,1,0,2,63
1908837,1498916,2025-02-25,Assembly,"Assembly Election Law Committee: Favorable refer to committee Ways and Means",11,5,0,0,16
1908847,1580423,2025-05-28,Assembly,"Assembly Codes Committee: Favorable refer to committee Rules",15,6,0,1,22
1908854,1486070,2025-02-11,Assembly,"Assembly Environmental Conservation Committee: Favorable refer to committee Ways and Means",28,0,0,2,30
1908864,1580286,2025-05-28,Assembly,"Assembly Environmental Conservation Committee: Favorable refer to committee Rules",20,9,0,1,30
1908866,1570939,2025-05-12,Senate,"Senate Housing, Construction And Community Development Committee Vote",10,1,0,0,11
1908866,1581826,2025-05-29,Senate,"Senate Rules Committee Vote",20,0,0,1,21
1908866,1586140,2025-06-06,Senate,"Senate Floor Vote - Final Passage",52,1,0,10,63
1908868,1540018,2025-04-08,Assembly,"Assembly Health Committee: Favorable refer to committee Ways and Means",24,0,0,2,26
1908868,1586053,2025-06-06,Assembly,"Assembly Ways And Means Committee: Favorable refer to committee Rules",35,0,0,0,35
1908868,1588496,2025-06-11,Assembly,"Assembly Rules Committee: Favorable",28,0,0,3,31
1908871,1575381,2025-04-29,Senate,"Senate Health Committee Vote",14,0,0,0,14
1908871,1575382,2025-05-21,Senate,"Senate Floor Vote - Final Passage",48,11,0,3,62
1908899,1557092,2025-04-08,Senate,"Senate Education Committee Vote",15,0,0,0,15
1908899,1557093,2025-04-24,Senate,"Senate Floor Vote - Final Passage",51,0,0,11,62
1908906,1575668,2025-01-27,Senate,"Senate Judiciary Committee Vote",15,4,0,0,19
1908906,1575669,2025-05-21,Senate,"Senate Floor Vote - Final Passage",43,16,0,3,62
1908908,1499629,2025-02-11,Senate,"Senate Corporations, Authorities And Commissions Committee Vote",6,1,0,0,7
1908908,1499630,2025-02-25,Senate,"Senate Floor Vote - Final Passage",46,15,0,2,63
1908933,1498220,2025-02-24,Assembly,"Assembly Health Committee: Favorable",24,0,0,2,26
1908933,1527235,2025-03-25,Assembly,"Assembly Floor Vote - Final Passage",108,41,0,1,150
1908933,1589391,2025-06-11,Senate,"Senate Floor Vote - Final Passage",38,21,0,4,63
1908960,1515231,2025-02-04,Senate,"Senate Cultural Affairs, Tourism, Parks And Recreation Committee Vote",6,0,0,1,7
1908960,1515232,2025-03-11,Senate,"Senate Floor Vote - Final Passage",61,0,0,2,63
1908968,1566382,2025-05-06,Senate,"Senate Consumer Protection Committee Vote",6,1,0,0,7
1908969,1497711,2025-02-24,Assembly,"Assembly Health Committee: Favorable refer to committee Ways and Means",24,0,0,2,26
1909018,1472988,2025-01-22,Assembly,"Assembly Higher Education Committee: Favorable refer to committee Rules",25,0,0,1,26
1909018,1475426,2025-01-28,Assembly,"Assembly Rules Committee: Favorable",31,0,0,0,31
1909020,1573272,2025-05-19,Assembly,"Assembly Governmental Employees Committee: Favorable refer to committee Ways and Means",13,0,0,1,14
1909032,1565605,2025-05-06,Assembly,"Assembly Consumer Affairs And Protection Committee: Favorable refer to committee Codes",11,5,0,0,16
1909032,1566741,2025-05-06,Assembly,"Assembly Codes Committee: Favorable",16,6,0,0,22
1909053,1587043,2025-06-09,Assembly,"Assembly Codes Committee: Favorable refer to committee Rules",15,5,0,2,22
1909053,1587336,2025-06-10,Assembly,"Assembly Rules Committee: Favorable",19,9,0,3,31
1909062,1570948,2025-05-12,Senate,"Senate Housing, Construction And Community Development Committee Vote",10,1,0,0,11
1909062,1581821,2025-05-29,Senate,"Senate Rules Committee Vote",20,0,0,1,21
1909062,1585811,2025-06-05,Senate,"Senate Floor Vote - Final Passage",59,1,0,3,63
1909087,1471281,2025-01-13,Senate,"Senate Floor Vote - Final Passage",61,0,0,2,63
1909087,1471282,2025-01-13,Senate,"Senate Rules Committee Vote",21,0,0,0,21
1909087,1525145,2025-03-24,Senate,"Senate Floor Vote - Final Passage",59,0,0,4,63
1909087,1586727,2025-06-06,Assembly,"Assembly Floor Vote - Final Passage",143,0,0,7,150
1909094,1497715,2025-02-24,Assembly,"Assembly Health Committee: Favorable",24,0,0,2,26
1909094,1504364,2025-03-03,Assembly,"Assembly Floor Vote - Final Passage",138,10,0,2,150
1909094,1590205,2025-06-11,Senate,"Senate Floor Vote - Final Passage",52,7,0,4,63
1909097,1498435,2025-02-24,Assembly,"Assembly Health Committee: Favorable",24,0,0,2,26
1909097,1504799,2025-03-03,Assembly,"Assembly Floor Vote - Final Passage",147,1,0,2,150
1909110,1526501,2025-03-25,Assembly,"Assembly Correction Committee: Favorable refer to committee Ways and Means",12,0,0,1,13
1909110,1561327,2025-04-29,Assembly,"Assembly Ways And Means Committee: Favorable refer to committee Rules",32,0,0,3,35
1909110,1561809,2025-04-30,Assembly,"Assembly Rules Committee: Favorable",29,0,0,2,31
1909110,1563308,2025-04-30,Assembly,"Assembly Floor Vote - Final Passage",146,1,0,3,150
1909157,1486475,2025-02-11,Assembly,"Assembly Governmental Employees Committee: Favorable refer to committee Ways and Means",14,0,0,0,14
1909157,1532023,2025-04-01,Assembly,"Assembly Rules Committee: Favorable",30,0,0,1,31
1909157,1532024,2025-04-01,Assembly,"Assembly Ways And Means Committee: Favorable refer to committee Rules",32,1,0,2,35
1909157,1533883,2025-04-01,Assembly,"Assembly Floor Vote - Final Passage",143,1,0,6,150
1909166,1506448,2025-02-04,Senate,"Senate Cultural Affairs, Tourism, Parks And Recreation Committee Vote",6,0,0,1,7
1909166,1506449,2025-03-05,Senate,"Senate Floor Vote - Final Passage",61,0,0,2,63
1909166,1536315,2025-04-02,Assembly,"Assembly Floor Vote - Final Passage",148,0,0,2,150
1909177,1514256,2025-03-11,Assembly,"Assembly Codes Committee: Favorable refer to committee Ways and Means",16,6,0,0,22
1909177,1514257,2025-03-11,Assembly,"Assembly Governmental Operations Committee: Favorable refer to committee Codes",10,4,0,0,14
1909177,1519730,2025-03-18,Assembly,"Assembly Rules Committee: Favorable",21,9,0,1,31
1909177,1519731,2025-03-18,Assembly,"Assembly Ways And Means Committee: Favorable refer to committee Rules",21,10,0,4,35
1909177,1522347,2025-03-19,Assembly,"Assembly Floor Vote - Final Passage",95,53,0,2,150
1909185,1534140,2025-04-02,Assembly,"Assembly Environmental Conservation Committee: Favorable",21,7,0,2,30
1909190,1579725,2025-05-28,Assembly,"Assembly Transportation Committee: Favorable refer to committee Rules",16,7,0,3,26
1909202,1558989,2025-04-08,Senate,"Senate Cultural Affairs, Tourism, Parks And Recreation Committee Vote",7,0,0,0,7
1909202,1558990,2025-04-28,Senate,"Senate Floor Vote - Final Passage",58,2,0,2,62
1909202,1572067,2025-05-15,Senate,"Senate Floor Vote - Final Passage",50,2,0,10,62
1909229,1574544,2025-05-20,Assembly,"Assembly Environmental Conservation Committee: Favorable refer to committee Codes",24,6,0,0,30
1909242,1580389,2025-05-28,Assembly,"Assembly Insurance Committee: Favorable refer to committee Ways and Means",24,0,0,1,25
1909242,1587317,2025-06-10,Assembly,"Assembly Ways And Means Committee: Favorable refer to committee Rules",32,0,0,3,35
1909242,1590050,2025-06-12,Assembly,"Assembly Rules Committee: Favorable",29,0,0,2,31
1909274,1472854,2025-01-21,Senate,"Senate Floor Vote - Final Passage",40,19,0,4,63
1909274,1472855,2025-01-21,Senate,"Senate Health Committee Vote",10,4,0,1,15
1909274,1472895,2025-01-21,Senate,"Senate Rules Committee Vote",13,6,0,2,21
1909274,1509539,2025-03-10,Senate,"Senate Floor Vote - Final Passage",39,22,0,2,63
1909290,1520250,2025-03-18,Assembly,"Assembly Local Governments Committee: Favorable refer to committee Ways and Means",19,0,0,1,20
1909290,1538038,2025-04-07,Assembly,"Assembly Rules Committee: Favorable",29,0,0,2,31
1909290,1538039,2025-04-07,Assembly,"Assembly Ways And Means Committee: Favorable refer to committee Rules",33,0,0,2,35
1909290,1541398,2025-04-08,Assembly,"Assembly Floor Vote - Final Passage",147,0,0,3,150
1909290,1585849,2025-06-04,Senate,"Senate Floor Vote - Final Passage",56,2,0,5,63
1909300,1570317,2025-05-13,Assembly,"Assembly Insurance Committee: Favorable refer to committee Codes",17,7,0,1,25
1909300,1574631,2025-05-20,Assembly,"Assembly Codes Committee: Favorable refer to committee Rules",14,6,0,2,22
1909300,1574902,2025-05-21,Assembly,"Assembly Rules Committee: Favorable",20,9,0,2,31
1909300,1579526,2025-05-27,Assembly,"Assembly Floor Vote - Final Passage",100,46,0,4,150
1909309,1528708,2025-03-18,Senate,"Senate Agriculture Committee Vote",9,0,0,0,9
1909309,1528709,2025-03-27,Senate,"Senate Floor Vote - Final Passage",60,1,0,2,63
1909309,1585352,2025-06-04,Assembly,"Assembly Floor Vote - Final Passage",143,0,0,7,150
1909321,1471367,2025-01-14,Assembly,"Assembly Health Committee: Favorable refer to committee Rules",25,0,0,1,26
1909321,1471626,2025-01-14,Assembly,"Assembly Health Committee: Favorable refer to committee Rules",25,0,0,1,26
1909321,1475233,2025-01-27,Assembly,"Assembly Floor Vote - Final Passage",145,0,0,5,150
1909321,1480259,2025-02-04,Senate,"Senate Floor Vote - Final Passage",61,0,0,2,63
1909325,1526446,2025-03-25,Assembly,"Assembly Corporations, Authorities And Commissions Committee: Favorable refer to committee Codes",17,8,0,1,26
1909325,1534344,2025-04-02,Assembly,"Assembly Codes Committee: Favorable",14,6,0,2,22
1909325,1572512,2025-05-14,Assembly,"Assembly Floor Vote - Final Passage",114,33,0,3,150
1909328,1580853,2025-05-28,Senate,"Senate Budget And Revenue Committee Vote",4,3,0,0,7
1909353,1578995,2025-05-27,Assembly,"Assembly Health Committee: Favorable refer to committee Ways and Means",26,0,0,0,26
1909356,1561636,2025-04-30,Assembly,"Assembly Environmental Conservation Committee: Favorable refer to committee Codes",20,9,0,1,30
1909356,1587047,2025-06-09,Assembly,"Assembly Codes Committee: Favorable refer to committee Rules",15,5,0,2,22
1909371,1570113,2025-05-13,Assembly,"Assembly Insurance Committee: Favorable",24,0,0,1,25
1909371,1579880,2025-05-27,Assembly,"Assembly Floor Vote - Final Passage",145,0,0,5,150
1909371,1586929,2025-06-09,Senate,"Senate Floor Vote - Final Passage",62,0,0,1,63
1909376,1499067,2025-02-25,Assembly,"Assembly Housing Committee: Favorable refer to committee Ways and Means",26,0,0,2,28
1909376,1575790,2025-05-22,Assembly,"Assembly Ways And Means Committee: Favorable refer to committee Rules",31,0,0,4,35
1909410,1574338,2025-05-20,Senate,"Senate Cultural Affairs, Tourism, Parks And Recreation Committee Vote",7,0,0,0,7
1909410,1585533,2025-06-04,Senate,"Senate Rules Committee Vote",20,0,0,1,21
1909410,1587925,2025-06-10,Senate,"Senate Floor Vote - Final Passage",58,0,0,5,63
1909421,1540051,2025-04-07,Senate,"Senate Investigations And Government Operations Committee Vote",7,0,0,0,7
1909421,1574526,2025-05-20,Senate,"Senate Finance Committee Vote",22,0,0,0,22
1909421,1580640,2025-05-28,Senate,"Senate Floor Vote - Final Passage",56,5,0,2,63
1909432,1479655,2025-02-04,Assembly,"Assembly Energy Committee: Favorable refer to committee Rules",15,0,0,2,17
1909432,1479656,2025-02-04,Assembly,"Assembly Rules Committee: Favorable",26,0,0,5,31
1909436,1585953,2025-05-20,Senate,"Senate Local Government Committee Vote",7,0,0,0,7
1909436,1585954,2025-06-06,Senate,"Senate Floor Vote - Final Passage",53,0,0,10,63
1909534,1471355,2025-01-14,Assembly,"Assembly Health Committee: Favorable refer to committee Rules",25,0,0,1,26
1909534,1471614,2025-01-14,Assembly,"Assembly Health Committee: Favorable refer to committee Rules",25,0,0,1,26
1909534,1475359,2025-01-27,Assembly,"Assembly Floor Vote - Final Passage",145,0,0,5,150
1909534,1486955,2025-02-11,Senate,"Senate Floor Vote - Final Passage",61,0,0,2,63
1909726,1486335,2025-02-11,Assembly,"Assembly Local Governments Committee: Favorable refer to committee Rules",18,0,0,2,20
1909726,1486336,2025-02-11,Assembly,"Assembly Rules Committee: Favorable",27,0,0,4,31
1909793,1471373,2025-01-14,Assembly,"Assembly Health Committee: Favorable refer to committee Rules",25,0,0,1,26
1909793,1471631,2025-01-14,Assembly,"Assembly Health Committee: Favorable refer to committee Rules",25,0,0,1,26
1909793,1475347,2025-01-27,Assembly,"Assembly Floor Vote - Final Passage",145,0,0,5,150
1909793,1480855,2025-02-05,Senate,"Senate Floor Vote - Final Passage",61,1,0,1,63
1909844,1472992,2025-01-22,Assembly,"Assembly Codes Committee: Favorable refer to committee Ways and Means",15,5,0,2,22
1909844,1472993,2025-01-22,Assembly,"Assembly Environmental Conservation Committee: Favorable refer to committee Codes",22,8,0,0,30
1909844,1473123,2025-01-22,Assembly,"Assembly Ways And Means Committee: Favorable refer to committee Rules",24,10,0,1,35
1909844,1474170,2025-01-22,Assembly,"Assembly Rules Committee: Favorable",20,9,0,2,31
1910249,1580846,2025-05-28,Senate,"Senate Budget And Revenue Committee Vote",7,0,0,0,7
1910276,1503323,2025-03-03,Senate,"Senate Labor Committee Vote",13,0,0,0,13
1910276,1505252,2025-03-04,Senate,"Senate Floor Vote - Final Passage",61,0,0,2,63
1910276,1505728,2025-03-04,Senate,"Senate Rules Committee Vote",20,0,0,1,21
1910279,1475804,2025-01-28,Senate,"Senate Energy And Telecommunications Committee Vote",6,3,0,0,9
1910287,1486139,2025-02-11,Senate,"Senate Environmental Conservation Committee Vote",10,1,0,0,11
1910287,1504846,2025-03-04,Senate,"Senate Finance Committee Vote",15,6,0,1,22
1910287,1559352,2025-04-28,Senate,"Senate Floor Vote - Final Passage",36,24,0,2,62
1910306,1580649,2025-05-20,Senate,"Senate Corporations, Authorities And Commissions Committee Vote",5,1,0,1,7
1910306,1580650,2025-05-28,Senate,"Senate Floor Vote - Final Passage",40,21,0,2,63
1910332,1475466,2025-01-28,Senate,"Senate Aging Committee Vote",7,0,0,0,7
1910332,1574348,2025-05-20,Senate,"Senate Finance Committee Vote",22,0,0,0,22
1910332,1590360,2025-06-12,Senate,"Senate Floor Vote - Final Passage",59,0,0,4,63
1910344,1589959,2025-06-09,Senate,"Senate Rules Committee Vote",21,0,0,0,21
1910344,1590501,2025-06-12,Senate,"Senate Floor Vote - Final Passage",58,1,0,4,63
1910365,1560009,2025-04-29,Senate,"Senate Social Services Committee Vote",4,2,0,0,6
1910394,1574459,2025-04-08,Senate,"Senate Cultural Affairs, Tourism, Parks And Recreation Committee Vote",7,0,0,0,7
1910394,1574460,2025-05-19,Senate,"Senate Floor Vote - Final Passage",56,0,0,6,62
1910394,1582045,2025-05-29,Assembly,"Assembly Floor Vote - Final Passage",145,0,0,5,150
1910412,1509611,2025-03-10,Senate,"Senate Codes Committee Vote",9,4,0,0,13
1910412,1589241,2025-06-11,Senate,"Senate Rules Committee Vote",13,7,0,1,21
1910412,1590520,2025-06-12,Senate,"Senate Floor Vote - Final Passage",40,19,0,4,63
1910444,1499184,2025-02-25,Senate,"Senate Cities 1 Committee Vote",7,0,0,0,7
1910447,1519324,2025-02-04,Senate,"Senate Health Committee Vote",15,0,0,0,15
1910447,1519325,2025-03-17,Senate,"Senate Floor Vote - Final Passage",60,1,0,2,63
1910471,1585292,2025-05-29,Senate,"Senate Rules Committee Vote",13,7,0,1,21
1910471,1585293,2025-06-04,Senate,"Senate Floor Vote - Final Passage",36,22,0,5,63
1910483,1514700,2025-03-11,Senate,"Senate Environmental Conservation Committee Vote",10,1,0,0,11
1910483,1574159,2025-05-20,Senate,"Senate Finance Committee Vote",15,7,0,0,22
1910483,1580226,2025-05-28,Senate,"Senate Floor Vote - Final Passage",33,25,0,5,63
1910553,1476204,2025-01-27,Senate,"Senate Codes Committee Vote",10,2,0,1,13
1910553,1587048,2025-06-09,Senate,"Senate Floor Vote - Final Passage",42,20,0,1,63
1910553,1587049,2025-06-09,Senate,"Senate Rules Committee Vote",14,7,0,0,21
1910563,1584893,2025-05-27,Senate,"Senate New York City Education Committee Vote",6,0,0,0,6
1910563,1584894,2025-06-04,Senate,"Senate Floor Vote - Final Passage",53,5,0,5,63
1910604,1586141,2025-05-29,Senate,"Senate Rules Committee Vote",20,0,0,1,21
1910604,1586142,2025-06-06,Senate,"Senate Floor Vote - Final Passage",53,0,0,10,63
1910615,1573860,2025-05-20,Senate,"Senate Social Services Committee Vote",5,1,0,0,6
1910619,1588368,2025-06-10,Senate,"Senate Floor Vote - Final Passage",58,0,0,5,63
1910619,1588369,2025-06-10,Senate,"Senate Rules Committee Vote",19,0,0,2,21
1910626,1581889,2025-01-21,Senate,"Senate Finance Committee Vote",21,0,0,1,22
1910626,1581890,2025-05-28,Senate,"Senate Floor Vote - Final Passage",61,0,0,2,63
1910626,1592380,2025-06-16,Assembly,"Assembly Floor Vote - Final Passage",145,0,0,5,150
1910708,1480156,2025-02-04,Assembly,"Assembly Health Committee: Favorable",23,0,0,3,26
1910713,1574324,2025-05-20,Assembly,"Assembly Judiciary Committee: Favorable refer to committee Codes",14,6,0,1,21
1910713,1580103,2025-05-28,Assembly,"Assembly Codes Committee: Favorable refer to committee Rules",17,4,0,1,22
1910713,1581149,2025-05-29,Assembly,"Assembly Rules Committee: Favorable",18,9,0,4,31
1910713,1588980,2025-06-10,Assembly,"Assembly Floor Vote - Final Passage",106,40,0,4,150
1910730,1498627,2025-02-25,Assembly,"Assembly Housing Committee: Favorable refer to committee Ways and Means",18,8,0,2,28
1910730,1574292,2025-05-20,Assembly,"Assembly Ways And Means Committee: Favorable refer to committee Rules",25,10,0,0,35
1910730,1581121,2025-05-29,Assembly,"Assembly Rules Committee: Favorable",18,9,0,4,31
1910758,1480688,2025-02-04,Senate,"Senate Agriculture Committee Vote",9,0,0,0,9
1910758,1560118,2025-04-29,Senate,"Senate Finance Committee Vote",22,0,0,0,22
1910758,1566154,2025-05-06,Senate,"Senate Floor Vote - Final Passage",61,0,0,1,62
1910775,1475568,2025-01-28,Senate,"Senate Energy And Telecommunications Committee Vote",7,2,0,0,9
1910791,1486434,2025-02-11,Assembly,"Assembly Agriculture Committee: Favorable refer to committee Codes",23,0,0,0,23
1910791,1526807,2025-03-25,Assembly,"Assembly Codes Committee: Favorable",21,0,0,1,22
1910791,1570162,2025-05-12,Assembly,"Assembly Floor Vote - Final Passage",143,0,0,7,150
1910791,1585315,2025-06-04,Senate,"Senate Floor Vote - Final Passage",57,1,0,5,63
1910796,1528935,2025-01-28,Senate,"Senate Energy And Telecommunications Committee Vote",6,3,0,0,9
1910796,1528936,2025-03-27,Senate,"Senate Floor Vote - Final Passage",52,9,0,2,63
1910850,1499709,2025-02-25,Senate,"Senate Energy And Telecommunications Committee Vote",7,2,0,0,9
1910880,1570110,2025-05-13,Assembly,"Assembly Housing Committee: Favorable refer to committee Codes",19,8,0,1,28
1910880,1585496,2025-06-05,Assembly,"Assembly Codes Committee: Favorable refer to committee Rules",15,6,0,1,22
1910892,1574061,2025-05-20,Assembly,"Assembly Agriculture Committee: Favorable refer to committee Codes",23,0,0,0,23
1910892,1590563,2025-06-13,Assembly,"Assembly Ways And Means Committee: Favorable refer to committee Rules",31,1,0,3,35
1910892,1591569,2025-06-17,Assembly,"Assembly Rules Committee: Favorable",21,9,0,1,31
1910961,1472822,2025-01-21,Assembly,"Assembly Health Committee: Favorable refer to committee Rules",26,0,0,0,26
1910961,1474312,2025-01-22,Assembly,"Assembly Rules Committee: Favorable",29,0,0,2,31
1910961,1476282,2025-01-28,Assembly,"Assembly Floor Vote - Final Passage",145,0,0,5,150
1910961,1485680,2025-02-10,Senate,"Senate Floor Vote - Final Passage",61,0,0,2,63
1910976,1515429,2025-03-11,Assembly,"Assembly Transportation Committee: Favorable refer to committee Codes",22,3,0,1,26
1910976,1540058,2025-04-08,Assembly,"Assembly Codes Committee: Favorable",16,5,0,1,22
1910988,1574651,2025-05-20,Assembly,"Assembly Judiciary Committee: Held for Consideration",14,6,0,1,21
1910994,1570114,2025-05-13,Assembly,"Assembly Housing Committee: Favorable",18,9,0,1,28
1911084,1486467,2025-02-11,Assembly,"Assembly Codes Committee: Favorable",16,6,0,0,22
1911084,1526299,2025-03-24,Assembly,"Assembly Floor Vote - Final Passage",98,49,0,3,150
1911084,1574187,2025-05-20,Senate,"Senate Floor Vote - Final Passage",43,18,0,1,62
1911098,1574878,2025-05-20,Senate,"Senate Judiciary Committee Vote",18,0,0,1,19
1911105,1534390,2025-04-02,Assembly,"Assembly Transportation Committee: Held for Consideration",18,7,0,1,26
1911160,1475247,2025-01-28,Senate,"Senate Energy And Telecommunications Committee Vote",8,1,0,0,9
1911160,1504845,2025-03-04,Senate,"Senate Finance Committee Vote",20,1,0,1,22
1911160,1519085,2025-03-17,Senate,"Senate Floor Vote - Final Passage",52,9,0,2,63
1911163,1482263,2025-02-04,Senate,"Senate Health Committee Vote",15,0,0,0,15
1911163,1574588,2025-05-20,Senate,"Senate Finance Committee Vote",22,0,0,0,22
1911163,1580652,2025-05-28,Senate,"Senate Floor Vote - Final Passage",61,0,0,2,63
1911173,1479673,2025-02-04,Assembly,"Assembly Health Committee: Favorable refer to committee Ways and Means",23,0,0,3,26
1911173,1575794,2025-05-22,Assembly,"Assembly Ways And Means Committee: Favorable refer to committee Rules",31,0,0,4,35
1911173,1579330,2025-05-27,Assembly,"Assembly Rules Committee: Favorable",26,0,0,5,31
1911173,1579692,2025-05-27,Assembly,"Assembly Floor Vote - Final Passage",145,0,0,5,150
1911209,1534105,2025-04-02,Assembly,"Assembly Codes Committee: Held for Consideration",14,6,0,2,22
1911256,1534293,2025-04-02,Assembly,"Assembly Codes Committee: Held for Consideration",14,6,0,2,22
1911360,1475640,2025-01-28,Senate,"Senate Cities 1 Committee Vote",7,0,0,0,7
1911433,1472638,2025-01-21,Senate,"Senate Floor Vote - Final Passage",59,0,0,4,63
1911433,1473127,2025-01-21,Senate,"Senate Rules Committee Vote",19,0,0,2,21
1911433,1528523,2025-03-26,Assembly,"Assembly Floor Vote - Final Passage",148,1,0,1,150
1911613,1505863,2025-01-21,Senate,"Senate Energy And Telecommunications Committee Vote",8,1,0,0,9
1911613,1505864,2025-03-05,Senate,"Senate Floor Vote - Final Passage",58,3,0,2,63
1911623,1570402,2025-05-13,Assembly,"Assembly Housing Committee: Favorable refer to committee Ways and Means",27,0,0,1,28
1911638,1562403,2025-02-11,Senate,"Senate Civil Service And Pensions Committee Vote",7,0,0,0,7
1911638,1562404,2025-04-29,Senate,"Senate Floor Vote - Final Passage",61,0,0,1,62
1911663,1498630,2025-02-25,Assembly,"Assembly Housing Committee: Favorable refer to committee Codes",17,9,0,2,28
1911663,1504285,2025-03-04,Assembly,"Assembly Codes Committee: Favorable",15,7,0,0,22
1911675,1505686,2025-03-04,Senate,"Senate Health Committee Vote",9,6,0,0,15
1911728,1475251,2025-01-28,Senate,"Senate Energy And Telecommunications Committee Vote",8,1,0,0,9
1911743,1486032,2025-02-11,Assembly,"Assembly Judiciary Committee: Favorable",12,6,0,3,21
1911756,1570427,2025-05-13,Assembly,"Assembly Codes Committee: Held for Consideration",16,6,0,0,22
1911771,1497734,2025-02-24,Assembly,"Assembly Insurance Committee: Favorable",18,4,0,3,25
1911771,1527203,2025-03-25,Assembly,"Assembly Floor Vote - Final Passage",102,47,0,1,150
1911771,1589272,2025-06-11,Senate,"Senate Floor Vote - Final Passage",38,21,0,4,63
1911798,1584594,2025-06-04,Assembly,"Assembly Banks Committee: Favorable refer to committee Rules",30,0,0,1,31
1911798,1586000,2025-06-06,Assembly,"Assembly Rules Committee: Favorable",27,0,0,4,31
1911798,1586565,2025-06-06,Assembly,"Assembly Floor Vote - Final Passage",143,0,0,7,150
1911948,1498739,2025-01-21,Senate,"Senate Environmental Conservation Committee Vote",11,0,0,0,11
1911948,1498740,2025-02-24,Senate,"Senate Floor Vote - Final Passage",59,1,0,3,63
1911989,1473109,2025-01-22,Assembly,"Assembly Correction Committee: Favorable refer to committee Rules",10,3,0,0,13
1911989,1474327,2025-01-22,Assembly,"Assembly Rules Committee: Favorable",29,0,0,2,31
1911989,1476240,2025-01-28,Assembly,"Assembly Floor Vote - Final Passage",144,0,0,6,150
1911989,1479639,2025-02-04,Senate,"Senate Floor Vote - Final Passage",61,0,0,2,63
1912028,1588301,2025-06-10,Senate,"Senate Floor Vote - Final Passage",58,0,0,5,63
1912028,1588302,2025-06-10,Senate,"Senate Rules Committee Vote",19,0,0,2,21
1912211,1475531,2025-01-28,Assembly,"Assembly Labor Committee: Favorable refer to committee Rules",28,0,0,1,29
1912211,1475532,2025-01-28,Assembly,"Assembly Rules Committee: Favorable",31,0,0,0,31
1912272,1473093,2025-01-22,Assembly,"Assembly Correction Committee: Favorable refer to committee Rules",13,0,0,0,13
1912272,1474331,2025-01-22,Assembly,"Assembly Rules Committee: Favorable",29,0,0,2,31
1912272,1476480,2025-01-28,Assembly,"Assembly Floor Vote - Final Passage",144,0,0,6,150
1912272,1486422,2025-02-11,Senate,"Senate Floor Vote - Final Passage",61,0,0,2,63
1912313,1475303,2025-01-28,Assembly,"Assembly Labor Committee: Favorable refer to committee Codes",23,5,0,1,29
1912313,1475534,2025-01-28,Assembly,"Assembly Codes Committee: Favorable refer to committee Rules",14,6,0,2,22
1912313,1475535,2025-01-28,Assembly,"Assembly Rules Committee: Favorable",31,0,0,0,31
1912348,1472875,2025-01-21,Senate,"Senate Environmental Conservation Committee Vote",11,0,0,0,11
1912348,1512998,2025-03-11,Senate,"Senate Finance Committee Vote",21,0,0,1,22
1912348,1520380,2025-03-18,Senate,"Senate Floor Vote - Final Passage",61,0,0,2,63
1914833,1585852,2025-05-28,Senate,"Senate Education Committee Vote",15,0,0,0,15
1914833,1585853,2025-06-05,Senate,"Senate Floor Vote - Final Passage",60,0,0,3,63
1914841,1499393,2025-01-27,Senate,"Senate Housing, Construction And Community Development Committee Vote",9,2,0,0,11
1914841,1499394,2025-02-25,Senate,"Senate Floor Vote - Final Passage",40,21,0,2,63
1914842,1472640,2025-01-21,Senate,"Senate Floor Vote - Final Passage",43,16,0,4,63
1914842,1473128,2025-01-21,Senate,"Senate Rules Committee Vote",13,6,0,2,21
1914854,1523976,2025-02-04,Senate,"Senate Labor Committee Vote",11,2,0,0,13
1914854,1523977,2025-03-20,Senate,"Senate Floor Vote - Final Passage",41,18,0,4,63
1914864,1576565,2025-02-25,Senate,"Senate Crime Victims, Crime And Correction Committee Vote",6,1,0,0,7
1914864,1576566,2025-05-22,Senate,"Senate Floor Vote - Final Passage",37,20,0,5,62
1914881,1472719,2025-01-21,Senate,"Senate Health Committee Vote",11,3,0,1,15
1914881,1560071,2025-04-29,Senate,"Senate Finance Committee Vote",17,5,0,0,22
1914881,1574461,2025-05-20,Senate,"Senate Floor Vote - Final Passage",48,13,0,1,62
1914888,1535672,2025-03-04,Senate,"Senate Health Committee Vote",15,0,0,0,15
1914888,1535673,2025-04-02,Senate,"Senate Floor Vote - Final Passage",45,17,0,1,63
1914905,1540577,2025-01-27,Senate,"Senate Codes Committee Vote",12,0,0,1,13
1914905,1540578,2025-04-08,Senate,"Senate Floor Vote - Final Passage",62,0,0,1,63
1914905,1570083,2025-05-12,Assembly,"Assembly Floor Vote - Final Passage",143,0,0,7,150
1914910,1509243,2025-01-21,Senate,"Senate Health Committee Vote",14,0,0,1,15
1914910,1509244,2025-03-10,Senate,"Senate Floor Vote - Final Passage",59,2,0,2,63
1914947,1590424,2025-06-12,Senate,"Senate Floor Vote - Final Passage",57,2,0,4,63
1914947,1595038,2025-06-12,Senate,"Senate Rules Committee Vote",19,1,0,1,21
1914955,1473129,2025-01-21,Senate,"Senate Floor Vote - Final Passage",59,0,0,4,63
1914955,1473130,2025-01-21,Senate,"Senate Rules Committee Vote",19,0,0,2,21
1914955,1585354,2025-06-04,Assembly,"Assembly Floor Vote - Final Passage",143,0,0,7,150
1914958,1575440,2025-05-21,Senate,"Senate Commerce, Economic Development And Small Business Committee Vote",9,0,0,0,9
1914958,1585537,2025-06-04,Senate,"Senate Rules Committee Vote",20,0,0,1,21
1914958,1587197,2025-06-09,Senate,"Senate Floor Vote - Final Passage",57,5,0,1,63
1914971,1579434,2025-04-29,Senate,"Senate Investigations And Government Operations Committee Vote",7,0,0,0,7
1914971,1592476,2025-05-27,Senate,"Senate Floor Vote - Final Passage",50,9,0,4,63
1914971,1592477,2025-06-17,Assembly,"Assembly Floor Vote - Final Passage",104,30,0,16,150
1914984,1588927,2025-02-04,Senate,"Senate Health Committee Vote",14,1,0,0,15
1914984,1589340,2025-06-11,Senate,"Senate Floor Vote - Final Passage",46,13,0,4,63
1915011,1588297,2025-06-10,Senate,"Senate Floor Vote - Final Passage",58,0,0,5,63
1915011,1588298,2025-06-10,Senate,"Senate Rules Committee Vote",19,0,0,2,21
1915012,1566836,2025-01-27,Senate,"Senate Codes Committee Vote",12,0,0,1,13
1915012,1566837,2025-05-05,Senate,"Senate Floor Vote - Final Passage",61,0,0,1,62
1915027,1580092,2025-05-28,Senate,"Senate Education Committee Vote",15,0,0,0,15
1915027,1590141,2025-06-12,Senate,"Senate Rules Committee Vote",18,2,0,1,21
1915027,1590659,2025-06-13,Senate,"Senate Floor Vote - Final Passage",55,4,0,4,63
1915036,1525214,2025-01-21,Senate,"Senate Health Committee Vote",11,3,0,1,15
1915036,1525215,2025-03-24,Senate,"Senate Floor Vote - Final Passage",39,20,0,4,63
1915040,1576095,2025-04-29,Senate,"Senate Environmental Conservation Committee Vote",10,1,0,0,11
1915040,1576096,2025-05-22,Senate,"Senate Floor Vote - Final Passage",43,14,0,5,62
1915044,1505171,2025-02-25,Senate,"Senate Local Government Committee Vote",7,0,0,0,7
1915044,1505172,2025-03-04,Senate,"Senate Floor Vote - Final Passage",61,0,0,2,63
1915044,1526113,2025-03-24,Assembly,"Assembly Floor Vote - Final Passage",147,0,0,3,150
1915048,1473195,2025-01-21,Senate,"Senate Energy And Telecommunications Committee Vote",6,3,0,0,9
1915048,1474857,2025-01-27,Senate,"Senate Floor Vote - Final Passage",39,21,0,3,63
1915048,1474858,2025-01-27,Senate,"Senate Rules Committee Vote",14,6,0,1,21
1915058,1529055,2025-01-21,Senate,"Senate Finance Committee Vote",21,0,0,1,22
1915058,1529056,2025-03-27,Senate,"Senate Floor Vote - Final Passage",61,0,0,2,63
1915076,1553475,2025-01-21,Senate,"Senate Energy And Telecommunications Committee Vote",8,1,0,0,9
1915076,1553476,2025-04-22,Senate,"Senate Floor Vote - Final Passage",48,5,0,9,62
1915078,1509499,2025-01-21,Senate,"Senate Environmental Conservation Committee Vote",11,0,0,0,11
1915078,1509500,2025-03-10,Senate,"Senate Floor Vote - Final Passage",61,0,0,2,63
1915078,1585652,2025-06-04,Assembly,"Assembly Floor Vote - Final Passage",144,0,0,6,150
1915080,1570907,2025-04-29,Senate,"Senate Transportation Committee Vote",11,2,0,0,13
1915080,1570908,2025-05-13,Senate,"Senate Floor Vote - Final Passage",52,5,0,5,62
1915084,1561103,2025-03-25,Senate,"Senate Codes Committee Vote",12,0,0,1,13
1915084,1561104,2025-04-28,Senate,"Senate Floor Vote - Final Passage",60,0,0,2,62
1915106,1528783,2025-03-05,Senate,"Senate Mental Health Committee Vote",7,0,0,0,7
1915106,1528784,2025-03-26,Senate,"Senate Floor Vote - Final Passage",61,0,0,2,63
1915112,1499526,2025-02-11,Senate,"Senate Civil Service And Pensions Committee Vote",7,0,0,0,7
1915112,1499527,2025-02-25,Senate,"Senate Floor Vote - Final Passage",61,0,0,2,63
1915112,1534678,2025-04-01,Assembly,"Assembly Floor Vote - Final Passage",144,0,0,6,150
1915122,1580886,2025-05-28,Senate,"Senate Budget And Revenue Committee Vote",6,1,0,0,7
1915124,1472639,2025-01-21,Senate,"Senate Floor Vote - Final Passage",48,11,0,4,63
1915124,1473089,2025-01-21,Senate,"Senate Rules Committee Vote",14,5,0,2,21
1915133,1571908,2025-05-13,Senate,"Senate Health Committee Vote",13,0,0,1,14
1915133,1581043,2025-05-28,Senate,"Senate Finance Committee Vote",22,0,0,0,22
1915133,1590634,2025-06-12,Senate,"Senate Floor Vote - Final Passage",59,0,0,4,63
1915139,1589376,2025-04-09,Senate,"Senate Codes Committee Vote",12,0,0,1,13
1915139,1589377,2025-06-10,Senate,"Senate Floor Vote - Final Passage",58,0,0,5,63
1915159,1580873,2025-01-21,Senate,"Senate Environmental Conservation Committee Vote",11,0,0,0,11
1915159,1580874,2025-05-28,Senate,"Senate Floor Vote - Final Passage",61,0,0,2,63
1915271,1589354,2025-06-04,Senate,"Senate Rules Committee Vote",20,0,0,1,21
1915271,1589704,2025-06-11,Senate,"Senate Floor Vote - Final Passage",59,0,0,4,63
1915271,1591280,2025-06-13,Assembly,"Assembly Floor Vote - Final Passage",137,0,0,13,150
1915278,1571786,2025-03-18,Senate,"Senate Agriculture Committee Vote",9,0,0,0,9
1915278,1571787,2025-05-14,Senate,"Senate Floor Vote - Final Passage",57,0,0,5,62
1915314,1505965,2025-03-05,Senate,"Senate Mental Health Committee Vote",7,0,0,0,7
1915395,1514484,2025-02-04,Senate,"Senate Health Committee Vote",15,0,0,0,15
1915395,1514485,2025-03-11,Senate,"Senate Floor Vote - Final Passage",61,0,0,2,63
1915395,1585867,2025-06-04,Assembly,"Assembly Floor Vote - Final Passage",143,0,0,7,150
1915444,1534020,2025-02-03,Senate,"Senate Investigations And Government Operations Committee Vote",7,0,0,0,7
1915444,1534021,2025-04-01,Senate,"Senate Floor Vote - Final Passage",63,0,0,0,63
1915461,1529122,2025-03-18,Senate,"Senate Transportation Committee Vote",13,0,0,0,13
1915461,1529123,2025-03-27,Senate,"Senate Floor Vote - Final Passage",61,0,0,2,63
1915481,1570963,2025-05-13,Senate,"Senate Higher Education Committee Vote",6,5,0,0,11
1915493,1580941,2025-05-12,Senate,"Senate Insurance Committee Vote",11,0,0,0,11
1915493,1580942,2025-05-29,Senate,"Senate Floor Vote - Final Passage",53,3,0,7,63
1915519,1472637,2025-01-21,Senate,"Senate Floor Vote - Final Passage",59,0,0,4,63
1915519,1473125,2025-01-21,Senate,"Senate Rules Committee Vote",19,0,0,2,21
1915619,1540921,2025-03-18,Senate,"Senate Agriculture Committee Vote",9,0,0,0,9
1915619,1540922,2025-04-08,Senate,"Senate Floor Vote - Final Passage",62,0,0,1,63
1915638,1587880,2025-05-22,Senate,"Senate Alcoholism And Substance Use Disorders Committee Vote",7,0,0,0,7
1915638,1587881,2025-06-10,Senate,"Senate Floor Vote - Final Passage",58,0,0,5,63
1915669,1588826,2025-02-04,Senate,"Senate Agriculture Committee Vote",9,0,0,0,9
1915669,1589258,2025-06-11,Senate,"Senate Floor Vote - Final Passage",41,18,0,4,63
1915694,1472832,2025-01-21,Senate,"Senate Environmental Conservation Committee Vote",11,0,0,0,11
1915694,1553321,2025-04-22,Senate,"Senate Floor Vote - Final Passage",53,0,0,9,62
1915694,1554726,2025-04-22,Senate,"Senate Rules Committee Vote",15,0,0,6,21
1915711,1479884,2025-02-04,Senate,"Senate Social Services Committee Vote",6,1,0,0,7
1915711,1587117,2025-06-09,Senate,"Senate Rules Committee Vote",16,5,0,0,21
1915711,1589680,2025-06-11,Senate,"Senate Floor Vote - Final Passage",44,15,0,4,63
1915722,1570958,2025-05-13,Senate,"Senate Aging Committee Vote",6,0,0,0,6
1915746,1480611,2025-02-04,Senate,"Senate Health Committee Vote",15,0,0,0,15
1915766,1576644,2025-04-29,Senate,"Senate Health Committee Vote",14,0,0,0,14
1915766,1576645,2025-05-22,Senate,"Senate Floor Vote - Final Passage",56,1,0,5,62
1915848,1573188,2025-04-29,Senate,"Senate Veterans, Homeland Security And Military Affairs Committee Vote",9,0,0,0,9
1915848,1573189,2025-05-19,Senate,"Senate Floor Vote - Final Passage",56,0,0,6,62
1917029,1534141,2025-04-02,Assembly,"Assembly Housing Committee: Favorable",21,5,0,2,28
1917029,1580878,2025-05-28,Assembly,"Assembly Floor Vote - Final Passage",97,47,0,6,150
1917029,1589528,2025-06-11,Senate,"Senate Floor Vote - Final Passage",37,22,0,4,63
1917052,1498080,2025-02-24,Assembly,"Assembly Consumer Affairs And Protection Committee: Favorable refer to committee Codes",14,0,0,2,16
1917052,1504742,2025-03-04,Assembly,"Assembly Codes Committee: Favorable",20,2,0,0,22
1917052,1512486,2025-03-10,Assembly,"Assembly Floor Vote - Final Passage",148,0,0,2,150
1917052,1586194,2025-06-05,Senate,"Senate Floor Vote - Final Passage",60,0,0,3,63
1917056,1515829,2025-03-12,Senate,"Senate Alcoholism And Substance Use Disorders Committee Vote",6,1,0,0,7
1917056,1574844,2025-05-20,Senate,"Senate Codes Committee Vote",12,1,0,0,13
1917056,1590275,2025-06-12,Senate,"Senate Floor Vote - Final Passage",34,25,0,4,63
1917093,1570988,2025-05-13,Senate,"Senate Transportation Committee Vote",11,2,0,0,13
1917096,1580414,2025-05-28,Assembly,"Assembly Codes Committee: Favorable refer to committee Rules",21,0,0,1,22
1917099,1534069,2025-04-02,Assembly,"Assembly Housing Committee: Favorable",21,5,0,2,28
1917099,1570998,2025-05-13,Assembly,"Assembly Floor Vote - Final Passage",93,52,0,5,150
1917101,1497745,2025-02-24,Assembly,"Assembly Health Committee: Favorable",24,0,0,2,26
1917101,1504150,2025-03-03,Assembly,"Assembly Floor Vote - Final Passage",134,14,0,2,150
1917101,1589448,2025-06-11,Senate,"Senate Floor Vote - Final Passage",39,20,0,4,63
1917126,1570428,2025-05-13,Assembly,"Assembly Codes Committee: Held for Consideration",16,6,0,0,22
1917138,1587571,2025-06-09,Senate,"Senate Rules Committee Vote",17,4,0,0,21
1917138,1588371,2025-06-10,Senate,"Senate Floor Vote - Final Passage",45,13,0,5,63
1917148,1563329,2025-04-29,Senate,"Senate Health Committee Vote",12,2,0,0,14
1917153,1566469,2025-05-06,Assembly,"Assembly Governmental Operations Committee: Favorable refer to committee Ways and Means",14,0,0,0,14
1917153,1590802,2025-06-13,Assembly,"Assembly Ways And Means Committee: Favorable refer to committee Rules",32,0,0,3,35
1917153,1593676,2025-06-16,Assembly,"Assembly Rules Committee: Favorable",29,0,0,2,31
1917156,1515813,2025-02-10,Senate,"Senate Elections Committee Vote",7,0,0,0,7
1917156,1515814,2025-03-11,Senate,"Senate Floor Vote - Final Passage",61,0,0,2,63
1917156,1533868,2025-04-01,Assembly,"Assembly Floor Vote - Final Passage",144,0,0,6,150
1917165,1526644,2025-03-25,Assembly,"Assembly Governmental Employees Committee: Favorable refer to committee Ways and Means",12,0,0,2,14
1917167,1574403,2025-05-20,Assembly,"Assembly Agriculture Committee: Favorable refer to committee Codes",23,0,0,0,23
1917167,1585565,2025-06-05,Assembly,"Assembly Codes Committee: Favorable refer to committee Rules",21,0,0,1,22
1917167,1585997,2025-06-06,Assembly,"Assembly Rules Committee: Favorable",27,0,0,4,31
1917174,1499279,2025-02-25,Senate,"Senate Environmental Conservation Committee Vote",11,0,0,0,11
1917186,1506557,2025-02-26,Senate,"Senate Alcoholism And Substance Use Disorders Committee Vote",7,0,0,0,7
1917186,1506558,2025-03-05,Senate,"Senate Floor Vote - Final Passage",61,0,0,2,63
1917193,1566563,2025-05-06,Assembly,"Assembly Transportation Committee: Favorable",24,0,0,2,26
1917205,1472925,2025-01-22,Assembly,"Assembly Environmental Conservation Committee: Favorable refer to committee Rules",30,0,0,0,30
1917205,1474169,2025-01-22,Assembly,"Assembly Rules Committee: Favorable",29,0,0,2,31
1917207,1475625,2025-01-28,Assembly,"Assembly Codes Committee: Favorable refer to committee Ways and Means",14,6,0,2,22
1917210,1590411,2025-06-12,Senate,"Senate Floor Vote - Final Passage",59,0,0,4,63
1917210,1592229,2025-06-16,Assembly,"Assembly Floor Vote - Final Passage",145,0,0,5,150
1917210,1594951,2025-06-12,Senate,"Senate Rules Committee Vote",20,0,0,1,21
1917220,1520256,2025-03-18,Assembly,"Assembly Judiciary Committee: Favorable",16,5,0,0,21
1917220,1536285,2025-04-02,Assembly,"Assembly Floor Vote - Final Passage",100,48,0,2,150
1917220,1589185,2025-06-11,Senate,"Senate Floor Vote - Final Passage",47,12,0,4,63
1917222,1593410,2025-06-16,Assembly,"Assembly Rules Committee: Favorable",29,0,0,2,31
1917222,1593411,2025-06-16,Assembly,"Assembly Ways And Means Committee: Favorable refer to committee Rules",32,0,0,3,35
1917240,1479767,2025-02-04,Assembly,"Assembly Transportation Committee: Favorable refer to committee Ways and Means",25,0,0,1,26
1917242,1473101,2025-01-22,Assembly,"Assembly Environmental Conservation Committee: Favorable refer to committee Rules",24,6,0,0,30
1917242,1474340,2025-01-22,Assembly,"Assembly Rules Committee: Favorable",29,0,0,2,31
1917247,1523302,2025-02-10,Senate,"Senate Elections Committee Vote",5,2,0,0,7
1917247,1523303,2025-03-19,Senate,"Senate Floor Vote - Final Passage",39,21,0,3,63
1917251,1499343,2025-02-25,Senate,"Senate Cities 1 Committee Vote",7,0,0,0,7
1917255,1574223,2025-05-20,Assembly,"Assembly Aging Committee: Favorable refer to committee Ways and Means",27,0,0,3,30
1917263,1581667,2025-05-28,Senate,"Senate Investigations And Government Operations Committee Vote",7,0,0,0,7
1917263,1587138,2025-06-09,Senate,"Senate Rules Committee Vote",21,0,0,0,21
1917263,1590913,2025-06-10,Senate,"Senate Floor Vote - Final Passage",58,0,0,5,63
1917276,1472923,2025-01-21,Senate,"Senate Energy And Telecommunications Committee Vote",8,1,0,0,9
1917276,1474855,2025-01-27,Senate,"Senate Floor Vote - Final Passage",52,8,0,3,63
1917276,1474856,2025-01-27,Senate,"Senate Rules Committee Vote",18,2,0,1,21
1917281,1573358,2025-02-04,Senate,"Senate Crime Victims, Crime And Correction Committee Vote",7,0,0,0,7
1917281,1573359,2025-05-19,Senate,"Senate Floor Vote - Final Passage",47,9,0,6,62
1917298,1523062,2025-01-21,Senate,"Senate Children And Families Committee Vote",7,0,0,0,7
1917298,1523063,2025-03-19,Senate,"Senate Floor Vote - Final Passage",57,3,0,3,63
1917298,1575756,2025-05-21,Assembly,"Assembly Floor Vote - Final Passage",143,0,0,7,150
1917308,1580868,2025-05-28,Senate,"Senate Budget And Revenue Committee Vote",6,1,0,0,7
1917309,1570102,2025-05-13,Assembly,"Assembly Housing Committee: Favorable refer to committee Codes",18,9,0,1,28
1917309,1585559,2025-06-05,Assembly,"Assembly Codes Committee: Favorable refer to committee Rules",15,6,0,1,22
1917309,1588556,2025-06-11,Assembly,"Assembly Rules Committee: Favorable",19,9,0,3,31
1917317,1504760,2025-03-04,Assembly,"Assembly Environmental Conservation Committee: Favorable refer to committee Codes",22,8,0,0,30
1917317,1566442,2025-05-06,Assembly,"Assembly Codes Committee: Favorable refer to committee Ways and Means",16,6,0,0,22
1917317,1591770,2025-06-16,Assembly,"Assembly Rules Committee: Favorable",19,10,0,2,31
1917317,1591771,2025-06-16,Assembly,"Assembly Ways And Means Committee: Favorable refer to committee Rules",21,11,0,3,35
1917332,1486460,2025-02-11,Assembly,"Assembly Housing Committee: Favorable",18,9,0,1,28
1917338,1519222,2025-03-04,Senate,"Senate Health Committee Vote",15,0,0,0,15
1917338,1519223,2025-03-17,Senate,"Senate Floor Vote - Final Passage",59,2,0,2,63
1917372,1571266,2025-05-06,Senate,"Senate Consumer Protection Committee Vote",6,1,0,0,7
1917372,1571267,2025-05-14,Senate,"Senate Floor Vote - Final Passage",41,16,0,5,62
1917382,1523629,2025-01-28,Senate,"Senate Energy And Telecommunications Committee Vote",9,0,0,0,9
1917382,1523630,2025-03-20,Senate,"Senate Floor Vote - Final Passage",59,0,0,4,63
1917407,1480574,2025-02-04,Senate,"Senate Health Committee Vote",14,1,0,0,15
1917411,1475287,2025-01-27,Senate,"Senate Judiciary Committee Vote",19,0,0,0,19
1917411,1514796,2025-03-11,Senate,"Senate Finance Committee Vote",17,4,0,1,22
1917411,1588283,2025-06-10,Senate,"Senate Floor Vote - Final Passage",46,12,0,5,63
1917437,1531983,2025-02-12,Senate,"Senate Health Committee Vote",15,0,0,0,15
1917437,1533056,2025-04-01,Senate,"Senate Floor Vote - Final Passage",63,0,0,0,63
1917440,1480651,2025-02-04,Senate,"Senate Health Committee Vote",15,0,0,0,15
1917447,1587800,2025-05-27,Senate,"Senate Transportation Committee Vote",13,0,0,0,13
1917447,1587801,2025-06-10,Senate,"Senate Floor Vote - Final Passage",57,1,0,5,63
1917447,1592327,2025-06-16,Assembly,"Assembly Floor Vote - Final Passage",144,0,0,6,150
1917456,1472947,2025-01-21,Senate,"Senate Energy And Telecommunications Committee Vote",9,0,0,0,9
1917456,1474865,2025-01-27,Senate,"Senate Floor Vote - Final Passage",54,6,0,3,63
1917456,1474866,2025-01-27,Senate,"Senate Rules Committee Vote",20,0,0,1,21
1917469,1541372,2025-01-21,Senate,"Senate Environmental Conservation Committee Vote",11,0,0,0,11
1917469,1541373,2025-04-09,Senate,"Senate Floor Vote - Final Passage",60,0,0,3,63
1917471,1479426,2025-02-04,Assembly,"Assembly Health Committee: Favorable refer to committee Ways and Means",23,0,0,3,26
1917481,1514947,2025-01-21,Senate,"Senate Energy And Telecommunications Committee Vote",8,1,0,0,9
1917481,1514948,2025-03-11,Senate,"Senate Floor Vote - Final Passage",60,1,0,2,63
1917481,1575009,2025-05-20,Assembly,"Assembly Floor Vote - Final Passage",147,0,0,3,150
1917496,1569502,2025-01-21,Senate,"Senate Finance Committee Vote",21,0,0,1,22
1917496,1569503,2025-05-12,Senate,"Senate Floor Vote - Final Passage",57,0,0,5,62
1917502,1585659,2025-06-05,Assembly,"Assembly Governmental Employees Committee: Favorable refer to committee Ways and Means",14,0,0,0,14
1917502,1585987,2025-06-06,Assembly,"Assembly Ways And Means Committee: Favorable refer to committee Rules",35,0,0,0,35
1917502,1586776,2025-06-09,Assembly,"Assembly Rules Committee: Favorable",25,0,0,6,31
1917502,1587439,2025-06-09,Assembly,"Assembly Floor Vote - Final Passage",144,0,0,6,150
1917502,1588051,2025-06-10,Senate,"Senate Floor Vote - Final Passage",58,0,0,5,63
1917511,1475576,2025-01-27,Senate,"Senate Housing, Construction And Community Development Committee Vote",11,0,0,0,11
1917516,1587165,2025-06-09,Senate,"Senate Floor Vote - Final Passage",44,18,0,1,63
1917516,1587166,2025-06-09,Senate,"Senate Rules Committee Vote",18,3,0,0,21
1917523,1560820,2025-04-29,Assembly,"Assembly Social Services Committee: Favorable refer to committee Ways and Means",16,1,0,1,18
1917523,1579400,2025-05-27,Assembly,"Assembly Ways And Means Committee: Favorable refer to committee Rules",32,0,0,3,35
1917523,1581520,2025-05-29,Assembly,"Assembly Rules Committee: Favorable",27,0,0,4,31
1917523,1582203,2025-05-29,Assembly,"Assembly Floor Vote - Final Passage",146,0,0,4,150
1917523,1588047,2025-06-10,Senate,"Senate Floor Vote - Final Passage",58,0,0,5,63
1917531,1573309,2025-05-19,Assembly,"Assembly Banks Committee: Favorable refer to committee Rules",27,0,0,4,31
1917531,1575259,2025-05-21,Assembly,"Assembly Rules Committee: Favorable",29,0,0,2,31
1917531,1580723,2025-05-28,Assembly,"Assembly Floor Vote - Final Passage",130,14,0,6,150
1917532,1573392,2025-05-19,Assembly,"Assembly Housing Committee: Favorable refer to committee Ways and Means",26,0,0,2,28
1917561,1486758,2025-02-11,Senate,"Senate Environmental Conservation Committee Vote",11,0,0,0,11
1917561,1587026,2025-06-09,Senate,"Senate Rules Committee Vote",21,0,0,0,21
1917561,1588346,2025-06-10,Senate,"Senate Floor Vote - Final Passage",58,0,0,5,63
1917591,1486452,2025-02-11,Assembly,"Assembly Environmental Conservation Committee: Favorable refer to committee Codes",22,6,0,2,30
1917591,1504512,2025-03-04,Assembly,"Assembly Codes Committee: Favorable refer to committee Ways and Means",17,5,0,0,22
1917619,1487457,2025-02-12,Senate,"Senate Health Committee Vote",15,0,0,0,15
1917619,1504886,2025-03-04,Senate,"Senate Finance Committee Vote",18,3,0,1,22
1917619,1528773,2025-03-27,Senate,"Senate Floor Vote - Final Passage",54,7,0,2,63
1917623,1560928,2025-04-29,Assembly,"Assembly Corporations, Authorities And Commissions Committee: Favorable",21,4,0,1,26
1917623,1572636,2025-05-15,Assembly,"Assembly Floor Vote - Final Passage",104,36,0,10,150
1917627,1486055,2025-02-11,Assembly,"Assembly Housing Committee: Favorable refer to committee Ways and Means",24,3,0,1,28
1917630,1486459,2025-02-11,Assembly,"Assembly Environmental Conservation Committee: Favorable refer to committee Ways and Means",28,0,0,2,30
1917630,1531988,2025-04-01,Assembly,"Assembly Rules Committee: Favorable",30,0,0,1,31
1917630,1531989,2025-04-01,Assembly,"Assembly Ways And Means Committee: Favorable refer to committee Rules",33,0,0,2,35
1917630,1533914,2025-04-01,Assembly,"Assembly Floor Vote - Final Passage",144,0,0,6,150
1917630,1575867,2025-05-22,Senate,"Senate Floor Vote - Final Passage",57,0,0,5,62
1917669,1519544,2025-03-18,Assembly,"Assembly Health Committee: Favorable refer to committee Codes",25,0,0,1,26
1917669,1580138,2025-05-28,Assembly,"Assembly Codes Committee: Favorable refer to committee Ways and Means",21,0,0,1,22
1917669,1584920,2025-06-04,Assembly,"Assembly Ways And Means Committee: Favorable refer to committee Rules",33,0,0,2,35
1917669,1585973,2025-06-06,Assembly,"Assembly Rules Committee: Favorable",27,0,0,4,31
1917671,1535192,2025-04-02,Assembly,"Assembly Election Law Committee: Held for Consideration",11,5,0,0,16
1917680,1574505,2025-05-20,Assembly,"Assembly Economic Development Committee: Held for Consideration",17,6,0,3,26
1917691,1580400,2025-05-28,Assembly,"Assembly Corporations, Authorities And Commissions Committee: Held for Consideration",17,8,0,1,26
1917707,1574502,2025-05-20,Assembly,"Assembly Economic Development Committee: Held for Consideration",17,6,0,3,26
1917727,1580930,2025-05-29,Assembly,"Assembly Ways And Means Committee: Favorable refer to committee Rules",32,2,0,1,35
1917727,1584918,2025-06-04,Assembly,"Assembly Rules Committee: Favorable",28,0,0,3,31
1917736,1579169,2025-05-27,Assembly,"Assembly Governmental Operations Committee: Held for Consideration",10,4,0,0,14
1917737,1500268,2025-02-26,Assembly,"Assembly Tourism, Arts And Sports Development Committee: Favorable",18,0,0,3,21
1917737,1504154,2025-03-03,Assembly,"Assembly Floor Vote - Final Passage",147,0,0,3,150
1917737,1582020,2025-05-29,Senate,"Senate Floor Vote - Final Passage",44,12,0,7,63
1917752,1472933,2025-01-22,Assembly,"Assembly Judiciary Committee: Favorable refer to committee Rules",20,0,0,1,21
1917752,1474208,2025-01-22,Assembly,"Assembly Rules Committee: Favorable",29,0,0,2,31
1917752,1479446,2025-02-03,Assembly,"Assembly Floor Vote - Final Passage",147,0,0,3,150
1917752,1486654,2025-02-11,Senate,"Senate Floor Vote - Final Passage",61,0,0,2,63
1917779,1587609,2025-06-09,Senate,"Senate Rules Committee Vote",21,0,0,0,21
1917779,1588386,2025-06-10,Senate,"Senate Floor Vote - Final Passage",57,1,0,5,63
1917789,1497850,2025-02-24,Assembly,"Assembly Health Committee: Favorable refer to committee Ways and Means",24,0,0,2,26
1917843,1593407,2025-06-16,Assembly,"Assembly Rules Committee: Favorable",29,0,0,2,31
1917843,1593408,2025-06-16,Assembly,"Assembly Ways And Means Committee: Favorable refer to committee Rules",32,0,0,3,35
1917854,1519847,2025-03-18,Assembly,"Assembly Health Committee: Favorable",24,1,0,1,26
1917868,1534108,2025-04-02,Assembly,"Assembly Agriculture Committee: Favorable refer to committee Codes",22,0,0,1,23
1917893,1542519,2025-04-09,Senate,"Senate Codes Committee Vote",8,4,0,1,13
1917893,1560884,2025-04-29,Senate,"Senate Finance Committee Vote",16,6,0,0,22
1917893,1581445,2025-05-29,Senate,"Senate Floor Vote - Final Passage",36,20,0,7,63
1917916,1473184,2025-01-22,Senate,"Senate Social Services Committee Vote",7,0,0,0,7
1917916,1474853,2025-01-27,Senate,"Senate Floor Vote - Final Passage",60,0,0,3,63
1917916,1474854,2025-01-27,Senate,"Senate Rules Committee Vote",20,0,0,1,21
1917936,1570305,2025-05-13,Assembly,"Assembly Judiciary Committee: Favorable",20,0,0,1,21
1917936,1573923,2025-05-19,Assembly,"Assembly Floor Vote - Final Passage",143,0,0,7,150
1917936,1590348,2025-06-13,Senate,"Senate Floor Vote - Final Passage",59,0,0,4,63
1917941,1587288,2025-06-10,Assembly,"Assembly Ways And Means Committee: Favorable refer to committee Rules",29,3,0,3,35
1917966,1498031,2025-02-04,Senate,"Senate Banks Committee Vote",7,0,0,0,7
1917966,1498032,2025-02-24,Senate,"Senate Floor Vote - Final Passage",60,0,0,3,63
1917977,1479460,2025-02-04,Assembly,"Assembly Health Committee: Favorable refer to committee Ways and Means",23,0,0,3,26
1917977,1586011,2025-06-06,Assembly,"Assembly Ways And Means Committee: Favorable refer to committee Rules",35,0,0,0,35
1917977,1587313,2025-06-10,Assembly,"Assembly Rules Committee: Favorable",28,0,0,3,31
1917977,1589151,2025-06-10,Assembly,"Assembly Floor Vote - Final Passage",147,0,0,3,150
1917977,1590828,2025-06-13,Senate,"Senate Floor Vote - Final Passage",59,0,0,4,63
1917989,1519958,2025-02-03,Senate,"Senate Insurance Committee Vote",11,0,0,0,11
1917989,1519959,2025-03-18,Senate,"Senate Floor Vote - Final Passage",61,0,0,2,63
1917989,1580957,2025-05-29,Senate,"Senate Floor Vote - Final Passage",56,0,0,7,63
1918002,1512512,2025-03-11,Assembly,"Assembly Agriculture Committee: Favorable refer to committee Codes",23,0,0,0,23
1918016,1570547,2025-01-27,Senate,"Senate Codes Committee Vote",11,1,0,1,13
1918016,1570548,2025-05-13,Senate,"Senate Floor Vote - Final Passage",37,20,0,5,62
1918016,1587201,2025-06-09,Senate,"Senate Floor Vote - Final Passage",43,19,0,1,63
1918016,1589390,2025-06-11,Assembly,"Assembly Floor Vote - Final Passage",93,46,0,11,150
1918026,1589079,2025-05-28,Senate,"Senate Finance Committee Vote",15,7,0,0,22
1918026,1589080,2025-06-11,Senate,"Senate Floor Vote - Final Passage",38,21,0,4,63
1918085,1504420,2025-03-04,Assembly,"Assembly Environmental Conservation Committee: Favorable refer to committee Codes",30,0,0,0,30
1918085,1512790,2025-03-11,Assembly,"Assembly Codes Committee: Favorable refer to committee Ways and Means",22,0,0,0,22
1918100,1573914,2025-05-20,Assembly,"Assembly Education Committee: Held for Consideration",19,9,0,3,31
1918107,1525769,2025-02-25,Senate,"Senate Environmental Conservation Committee Vote",11,0,0,0,11
1918107,1525770,2025-03-24,Senate,"Senate Floor Vote - Final Passage",59,0,0,4,63
1918108,1590759,2025-06-13,Assembly,"Assembly Rules Committee: Favorable",29,0,0,2,31
1918108,1590760,2025-06-13,Assembly,"Assembly Ways And Means Committee: Favorable refer to committee Rules",32,0,0,3,35
1918112,1586202,2025-01-28,Senate,"Senate Education Committee Vote",15,0,0,0,15
1918112,1586203,2025-06-06,Senate,"Senate Floor Vote - Final Passage",53,0,0,10,63
1918120,1537374,2025-04-03,Assembly,"Assembly Floor Vote - Final Passage",47,100,0,3,150
1918135,1570448,2025-05-13,Assembly,"Assembly Codes Committee: Held for Consideration",16,6,0,0,22
1918160,1498623,2025-02-25,Assembly,"Assembly Election Law Committee: Favorable refer to committee Ways and Means",14,2,0,0,16
1918167,1526822,2025-03-25,Assembly,"Assembly Governmental Employees Committee: Favorable",12,0,0,2,14
1918195,1534343,2025-04-02,Assembly,"Assembly Transportation Committee: Favorable refer to committee Codes",20,5,0,1,26
1918195,1539290,2025-04-08,Assembly,"Assembly Codes Committee: Favorable",16,5,0,1,22
1918195,1571966,2025-05-14,Assembly,"Assembly Floor Vote - Final Passage",109,38,0,3,150
1918221,1486112,2025-02-10,Senate,"Senate Internet And Technology Committee Vote",7,0,0,0,7
1918221,1574322,2025-05-20,Senate,"Senate Finance Committee Vote",22,0,0,0,22
1918221,1580673,2025-05-28,Senate,"Senate Floor Vote - Final Passage",61,0,0,2,63
1918242,1479478,2025-02-04,Assembly,"Assembly Health Committee: Favorable",23,0,0,3,26
1918242,1485856,2025-02-10,Assembly,"Assembly Floor Vote - Final Passage",145,0,0,5,150
1918242,1590832,2025-06-12,Senate,"Senate Floor Vote - Final Passage",59,0,0,4,63
1918284,1534135,2025-04-02,Assembly,"Assembly Agriculture Committee: Held for Consideration",15,7,0,1,23
1918306,1574035,2025-05-20,Assembly,"Assembly Economic Development Committee: Favorable refer to committee Codes",23,0,0,3,26
1918306,1585395,2025-06-05,Assembly,"Assembly Codes Committee: Favorable refer to committee Ways and Means",21,0,0,1,22
1918306,1586096,2025-06-06,Assembly,"Assembly Ways And Means Committee: Favorable refer to committee Rules",35,0,0,0,35
1918308,1586025,2025-06-06,Assembly,"Assembly Ways And Means Committee: Favorable refer to committee Rules",30,5,0,0,35
1918308,1588136,2025-06-10,Assembly,"Assembly Rules Committee: Favorable",28,0,0,3,31
1918308,1589161,2025-06-10,Assembly,"Assembly Floor Vote - Final Passage",115,32,0,3,150
1918308,1590294,2025-06-12,Senate,"Senate Floor Vote - Final Passage",45,14,0,4,63
1918330,1586890,2025-06-09,Assembly,"Assembly Codes Committee: Favorable refer to committee Rules",15,5,0,2,22
1918330,1587827,2025-06-10,Assembly,"Assembly Rules Committee: Favorable",19,9,0,3,31
1918330,1589402,2025-06-11,Assembly,"Assembly Floor Vote - Final Passage",93,46,0,11,150
1918357,1585601,2025-06-05,Assembly,"Assembly Local Governments Committee: Favorable refer to committee Codes",19,0,0,1,20
1918357,1587042,2025-06-09,Assembly,"Assembly Codes Committee: Favorable refer to committee Ways and Means",20,0,0,2,22
1918357,1589852,2025-06-12,Assembly,"Assembly Ways And Means Committee: Favorable refer to committee Rules",31,3,0,1,35
1918357,1590793,2025-06-13,Assembly,"Assembly Rules Committee: Favorable",29,0,0,2,31
1918381,1574679,2025-05-20,Assembly,"Assembly Codes Committee: Favorable refer to committee Rules",20,0,0,2,22
1918381,1581565,2025-05-29,Assembly,"Assembly Rules Committee: Favorable",26,1,0,4,31
1918381,1582211,2025-05-29,Assembly,"Assembly Floor Vote - Final Passage",133,13,0,4,150
1918392,1566537,2025-05-06,Senate,"Senate Education Committee Vote",14,0,0,0,14
1918392,1587167,2025-06-09,Senate,"Senate Floor Vote - Final Passage",62,0,0,1,63
1918392,1587168,2025-06-09,Senate,"Senate Rules Committee Vote",21,0,0,0,21
1918416,1539888,2025-04-07,Assembly,"Assembly Floor Vote - Final Passage",45,99,0,6,150
1918417,1499705,2025-02-25,Senate,"Senate Energy And Telecommunications Committee Vote",8,1,0,0,9
1918417,1512910,2025-03-11,Senate,"Senate Finance Committee Vote",20,1,0,1,22
1918417,1521294,2025-03-19,Senate,"Senate Floor Vote - Final Passage",57,3,0,3,63
1918456,1497738,2025-02-24,Assembly,"Assembly Health Committee: Favorable refer to committee Ways and Means",24,0,0,2,26
1918469,1539659,2025-04-08,Assembly,"Assembly Health Committee: Favorable refer to committee Codes",24,0,0,2,26
1918469,1574647,2025-05-20,Assembly,"Assembly Codes Committee: Favorable refer to committee Rules",20,0,0,2,22
1918469,1579332,2025-05-27,Assembly,"Assembly Rules Committee: Favorable",26,0,0,5,31
1918469,1579701,2025-05-27,Assembly,"Assembly Floor Vote - Final Passage",145,0,0,5,150
1918469,1587900,2025-06-10,Senate,"Senate Floor Vote - Final Passage",58,0,0,5,63
1919066,1473071,2025-01-22,Assembly,"Assembly Judiciary Committee: Favorable refer to committee Rules",20,0,0,1,21
1919066,1474184,2025-01-22,Assembly,"Assembly Rules Committee: Favorable",27,2,0,2,31
1919357,1586779,2025-05-13,Senate,"Senate Transportation Committee Vote",13,0,0,0,13
1919357,1587094,2025-06-09,Senate,"Senate Floor Vote - Final Passage",61,1,0,1,63
1919357,1588931,2025-06-10,Assembly,"Assembly Floor Vote - Final Passage",147,0,0,3,150
1919366,1487460,2025-02-11,Senate,"Senate Budget And Revenue Committee Vote",7,0,0,0,7
1919371,1514809,2025-03-12,Senate,"Senate Women's Issues Committee Vote",7,0,0,0,7
1919371,1571031,2025-05-13,Senate,"Senate Higher Education Committee Vote",9,2,0,0,11
1919371,1574276,2025-05-20,Senate,"Senate Finance Committee Vote",16,6,0,0,22
1919371,1586921,2025-06-09,Senate,"Senate Floor Vote - Final Passage",43,19,0,1,63
1919394,1571652,2025-02-04,Senate,"Senate Veterans, Homeland Security And Military Affairs Committee Vote",9,0,0,0,9
1919394,1571653,2025-05-14,Senate,"Senate Floor Vote - Final Passage",57,0,0,5,62
1919406,1529407,2025-03-18,Senate,"Senate Procurement And Contracts Committee Vote",7,0,0,0,7
1919406,1529408,2025-03-27,Senate,"Senate Floor Vote - Final Passage",61,0,0,2,63
1919429,1578844,2025-04-29,Senate,"Senate Investigations And Government Operations Committee Vote",7,0,0,0,7
1919429,1590362,2025-05-27,Senate,"Senate Floor Vote - Final Passage",50,9,0,4,63
1919429,1591138,2025-06-13,Assembly,"Assembly Floor Vote - Final Passage",109,26,0,15,150
1919442,1509104,2025-02-04,Senate,"Senate Banks Committee Vote",5,2,0,0,7
1919442,1509105,2025-03-10,Senate,"Senate Floor Vote - Final Passage",48,13,0,2,63
1919444,1522799,2025-03-12,Senate,"Senate Commerce, Economic Development And Small Business Committee Vote",9,0,0,0,9
1919444,1522800,2025-03-20,Senate,"Senate Floor Vote - Final Passage",59,0,0,4,63
1919458,1589759,2025-04-02,Senate,"Senate Environmental Conservation Committee Vote",10,1,0,0,11
1919458,1590513,2025-06-12,Senate,"Senate Floor Vote - Final Passage",50,9,0,4,63
1919487,1473116,2025-01-22,Assembly,"Assembly Veterans' Affairs Committee: Favorable refer to committee Rules",18,0,0,1,19
1919487,1474230,2025-01-22,Assembly,"Assembly Rules Committee: Favorable",29,0,0,2,31
1919487,1479955,2025-02-03,Assembly,"Assembly Floor Vote - Final Passage",147,0,0,3,150
1919487,1482437,2025-02-05,Senate,"Senate Floor Vote - Final Passage",62,0,0,1,63
1919490,1475555,2025-01-28,Senate,"Senate Energy And Telecommunications Committee Vote",6,3,0,0,9
1919490,1560937,2025-04-29,Senate,"Senate Finance Committee Vote",19,3,0,0,22
1919490,1590655,2025-06-12,Senate,"Senate Floor Vote - Final Passage",42,17,0,4,63
1919495,1579523,2025-02-04,Senate,"Senate Veterans, Homeland Security And Military Affairs Committee Vote",9,0,0,0,9
1919495,1580244,2025-05-27,Senate,"Senate Floor Vote - Final Passage",59,0,0,4,63
1919495,1582187,2025-05-29,Assembly,"Assembly Floor Vote - Final Passage",146,0,0,4,150
1919527,1589099,2025-05-12,Senate,"Senate Housing, Construction And Community Development Committee Vote",10,1,0,0,11
1919527,1589100,2025-06-11,Senate,"Senate Floor Vote - Final Passage",38,21,0,4,63
1919542,1589343,2025-05-14,Senate,"Senate Labor Committee Vote",13,0,0,0,13
1919542,1589623,2025-06-11,Senate,"Senate Floor Vote - Final Passage",54,5,0,4,63
1919543,1497903,2025-02-04,Senate,"Senate Veterans, Homeland Security And Military Affairs Committee Vote",9,0,0,0,9
1919543,1497904,2025-02-24,Senate,"Senate Floor Vote - Final Passage",60,0,0,3,63
1919584,1565439,2025-05-06,Senate,"Senate Civil Service And Pensions Committee Vote",7,0,0,0,7
1919615,1522345,2025-03-04,Senate,"Senate Veterans, Homeland Security And Military Affairs Committee Vote",9,0,0,0,9
1919615,1522346,2025-03-20,Senate,"Senate Floor Vote - Final Passage",59,0,0,4,63
1919661,1535642,2025-03-11,Senate,"Senate Environmental Conservation Committee Vote",11,0,0,0,11
1919661,1535643,2025-04-02,Senate,"Senate Floor Vote - Final Passage",62,0,0,1,63
1919661,1589373,2025-06-11,Senate,"Senate Floor Vote - Final Passage",59,0,0,4,63
1919661,1592496,2025-06-17,Assembly,"Assembly Floor Vote - Final Passage",141,0,0,9,150
1919681,1541451,2025-02-04,Senate,"Senate Veterans, Homeland Security And Military Affairs Committee Vote",9,0,0,0,9
1919681,1541452,2025-04-09,Senate,"Senate Floor Vote - Final Passage",60,0,0,3,63
1919693,1515919,2025-02-04,Senate,"Senate Veterans, Homeland Security And Military Affairs Committee Vote",9,0,0,0,9
1919693,1515920,2025-03-12,Senate,"Senate Floor Vote - Final Passage",60,0,0,3,63
1919718,1517299,2025-02-10,Senate,"Senate Elections Committee Vote",7,0,0,0,7
1919718,1517300,2025-03-12,Senate,"Senate Floor Vote - Final Passage",56,4,0,3,63
1919745,1589649,2025-04-29,Senate,"Senate Transportation Committee Vote",13,0,0,0,13
1919745,1590644,2025-06-12,Senate,"Senate Floor Vote - Final Passage",43,16,0,4,63
1919751,1571809,2025-01-22,Senate,"Senate Social Services Committee Vote",7,0,0,0,7
1919751,1571810,2025-05-14,Senate,"Senate Floor Vote - Final Passage",57,0,0,5,62
1919763,1514663,2025-02-03,Senate,"Senate Housing, Construction And Community Development Committee Vote",11,0,0,0,11
1919763,1514664,2025-03-11,Senate,"Senate Floor Vote - Final Passage",61,0,0,2,63
1919801,1570951,2025-05-13,Senate,"Senate Transportation Committee Vote",13,0,0,0,13
1919843,1585876,2025-05-29,Senate,"Senate Rules Committee Vote",20,0,0,1,21
1919843,1585877,2025-06-05,Senate,"Senate Floor Vote - Final Passage",49,11,0,3,63
1919858,1587604,2025-06-09,Senate,"Senate Rules Committee Vote",21,0,0,0,21
1919858,1588383,2025-06-10,Senate,"Senate Floor Vote - Final Passage",55,3,0,5,63
1919879,1498194,2025-02-04,Senate,"Senate Banks Committee Vote",7,0,0,0,7
1919879,1498195,2025-02-24,Senate,"Senate Floor Vote - Final Passage",60,0,0,3,63
1919918,1580678,2025-05-14,Senate,"Senate Local Government Committee Vote",6,0,0,1,7
1919918,1580679,2025-05-28,Senate,"Senate Floor Vote - Final Passage",55,6,0,2,63
1920044,1479895,2025-01-27,Senate,"Senate Rules Committee Vote",20,0,0,1,21
1920044,1479896,2025-02-04,Senate,"Senate Floor Vote - Final Passage",60,1,0,2,63
1920050,1587291,2025-06-10,Assembly,"Assembly Ways And Means Committee: Favorable refer to committee Rules",32,0,0,3,35
1920050,1591574,2025-06-17,Assembly,"Assembly Rules Committee: Favorable",30,0,0,1,31
1920062,1527311,2025-03-24,Senate,"Senate Insurance Committee Vote",11,0,0,0,11
1920099,1504345,2025-01-28,Senate,"Senate Corporations, Authorities And Commissions Committee Vote",7,0,0,0,7
1920099,1504346,2025-03-03,Senate,"Senate Floor Vote - Final Passage",61,0,0,2,63
1920116,1559681,2025-04-28,Senate,"Senate Housing, Construction And Community Development Committee Vote",8,3,0,0,11
1920116,1588344,2025-06-10,Senate,"Senate Floor Vote - Final Passage",35,23,0,5,63
1920116,1588345,2025-06-10,Senate,"Senate Rules Committee Vote",13,6,0,2,21
1920125,1499707,2025-02-25,Senate,"Senate Energy And Telecommunications Committee Vote",7,2,0,0,9
1920153,1472991,2025-01-21,Senate,"Senate Energy And Telecommunications Committee Vote",9,0,0,0,9
1920153,1474868,2025-01-27,Senate,"Senate Floor Vote - Final Passage",60,0,0,3,63
1920153,1474869,2025-01-27,Senate,"Senate Rules Committee Vote",20,0,0,1,21
1920153,1571785,2025-05-14,Senate,"Senate Floor Vote - Final Passage",56,1,0,5,62
1920153,1586125,2025-06-05,Assembly,"Assembly Floor Vote - Final Passage",110,35,0,5,150
1920177,1566491,2025-05-06,Assembly,"Assembly Consumer Affairs And Protection Committee: Favorable refer to committee Codes",16,0,0,0,16
1920177,1570803,2025-05-13,Assembly,"Assembly Codes Committee: Favorable",22,0,0,0,22
1920177,1589378,2025-06-11,Assembly,"Assembly Floor Vote - Final Passage",139,7,0,4,150
1920221,1575348,2025-05-12,Senate,"Senate Housing, Construction And Community Development Committee Vote",11,0,0,0,11
1920221,1575349,2025-05-21,Senate,"Senate Floor Vote - Final Passage",57,2,0,3,62
1920253,1486115,2025-02-10,Senate,"Senate Internet And Technology Committee Vote",5,2,0,0,7
1920268,1533963,2025-04-02,Assembly,"Assembly Correction Committee: Favorable refer to committee Ways and Means",11,1,0,1,13
1920277,1473090,2025-01-22,Assembly,"Assembly Codes Committee: Favorable refer to committee Rules",15,5,0,2,22
1920277,1473091,2025-01-22,Assembly,"Assembly Science And Technology Committee: Favorable refer to committee Codes",6,2,0,1,9
1920277,1474171,2025-01-22,Assembly,"Assembly Rules Committee: Favorable",20,9,0,2,31
1920287,1581468,2025-05-28,Senate,"Senate Budget And Revenue Committee Vote",6,1,0,0,7
1920364,1486440,2025-02-11,Assembly,"Assembly Local Governments Committee: Favorable refer to committee Ways and Means",18,0,0,2,20
1920364,1520084,2025-03-18,Assembly,"Assembly Ways And Means Committee: Favorable",31,0,0,4,35
1920512,1534064,2025-04-02,Assembly,"Assembly Correction Committee: Favorable",12,0,0,1,13
1920554,1487779,2025-01-28,Senate,"Senate Education Committee Vote",15,0,0,0,15
1920554,1487780,2025-02-12,Senate,"Senate Floor Vote - Final Passage",58,1,0,4,63
1920582,1588418,2025-05-20,Senate,"Senate Local Government Committee Vote",6,1,0,0,7
1920582,1588419,2025-06-10,Senate,"Senate Floor Vote - Final Passage",49,9,0,5,63
1920675,1486479,2025-02-11,Assembly,"Assembly Governmental Employees Committee: Favorable",14,0,0,0,14
1920675,1505658,2025-03-04,Assembly,"Assembly Floor Vote - Final Passage",150,0,0,0,150
1920675,1571735,2025-05-13,Senate,"Senate Floor Vote - Final Passage",57,0,0,5,62
1920701,1585478,2025-06-05,Assembly,"Assembly Governmental Operations Committee: Favorable refer to committee Codes",13,0,0,1,14
1920701,1586743,2025-06-09,Assembly,"Assembly Codes Committee: Favorable refer to committee Rules",20,0,0,2,22
1920967,1570606,2025-05-13,Assembly,"Assembly Codes Committee: Held for Consideration",16,6,0,0,22
1920984,1475320,2025-01-28,Assembly,"Assembly Codes Committee: Favorable refer to committee Rules",20,0,0,2,22
1920984,1475321,2025-01-28,Assembly,"Assembly Labor Committee: Favorable refer to committee Codes",28,0,0,1,29
1920984,1475533,2025-01-28,Assembly,"Assembly Rules Committee: Favorable",31,0,0,0,31
1920984,1480530,2025-02-04,Assembly,"Assembly Floor Vote - Final Passage",145,1,0,4,150
1920984,1485606,2025-02-10,Senate,"Senate Floor Vote - Final Passage",45,16,0,2,63
1921066,1573441,2025-05-19,Assembly,"Assembly Governmental Employees Committee: Held for Consideration",8,5,0,1,14
1921119,1580398,2025-05-28,Assembly,"Assembly Local Governments Committee: Favorable refer to committee Ways and Means",20,0,0,0,20
1921119,1585170,2025-06-04,Assembly,"Assembly Ways And Means Committee: Favorable refer to committee Rules",32,1,0,2,35
1921119,1585981,2025-06-06,Assembly,"Assembly Rules Committee: Favorable",27,0,0,4,31
1921119,1586459,2025-06-06,Assembly,"Assembly Floor Vote - Final Passage",142,1,0,7,150
1921119,1590346,2025-06-12,Senate,"Senate Floor Vote - Final Passage",55,4,0,4,63
1921194,1513400,2025-03-11,Assembly,"Assembly Governmental Operations Committee: Favorable refer to committee Ways and Means",11,3,0,0,14
1921194,1579371,2025-05-27,Assembly,"Assembly Ways And Means Committee: Favorable refer to committee Rules",23,9,0,3,35
1921194,1581542,2025-05-29,Assembly,"Assembly Rules Committee: Favorable",19,8,0,4,31
1921194,1585911,2025-06-05,Assembly,"Assembly Floor Vote - Final Passage",132,12,0,6,150
1921204,1512501,2025-03-11,Assembly,"Assembly Agriculture Committee: Favorable refer to committee Ways and Means",23,0,0,0,23
1921204,1579354,2025-05-27,Assembly,"Assembly Ways And Means Committee: Favorable refer to committee Rules",32,0,0,3,35
1921204,1581499,2025-05-29,Assembly,"Assembly Rules Committee: Favorable",27,0,0,4,31
1921204,1582190,2025-05-29,Assembly,"Assembly Floor Vote - Final Passage",146,0,0,4,150
1921204,1584962,2025-06-04,Senate,"Senate Floor Vote - Final Passage",58,0,0,5,63
1921406,1473108,2025-01-22,Assembly,"Assembly Correction Committee: Favorable refer to committee Rules",12,1,0,0,13
1921406,1474176,2025-01-22,Assembly,"Assembly Rules Committee: Favorable",29,0,0,2,31
1921406,1479662,2025-02-03,Assembly,"Assembly Floor Vote - Final Passage",147,0,0,3,150
1921406,1479663,2025-02-04,Senate,"Senate Floor Vote - Final Passage",61,0,0,2,63
1921701,1573159,2025-05-19,Assembly,"Assembly Health Committee: Favorable refer to committee Ways and Means",24,0,0,2,26
1921710,1513924,2025-03-11,Assembly,"Assembly Transportation Committee: Favorable refer to committee Codes",25,0,0,1,26
1921710,1586892,2025-06-09,Assembly,"Assembly Codes Committee: Favorable refer to committee Rules",19,1,0,2,22
1921710,1587324,2025-06-10,Assembly,"Assembly Rules Committee: Favorable",28,0,0,3,31
1921710,1588788,2025-06-10,Assembly,"Assembly Floor Vote - Final Passage",140,7,0,3,150
1921923,1479808,2025-02-04,Assembly,"Assembly Health Committee: Favorable",23,0,0,3,26
1921923,1486647,2025-02-10,Assembly,"Assembly Floor Vote - Final Passage",145,0,0,5,150
1921923,1587057,2025-06-09,Senate,"Senate Floor Vote - Final Passage",62,0,0,1,63
1921931,1513172,2025-03-11,Assembly,"Assembly Governmental Operations Committee: Favorable refer to committee Ways and Means",14,0,0,0,14
1921931,1580935,2025-05-29,Assembly,"Assembly Ways And Means Committee: Favorable refer to committee Rules",34,0,0,1,35
1921931,1584907,2025-06-04,Assembly,"Assembly Rules Committee: Favorable",20,8,0,3,31
1921956,1473092,2025-01-22,Assembly,"Assembly Higher Education Committee: Favorable refer to committee Rules",17,8,0,1,26
1921956,1474168,2025-01-22,Assembly,"Assembly Rules Committee: Favorable",21,8,0,2,31
1922032,1584685,2025-06-04,Assembly,"Assembly Transportation Committee: Favorable refer to committee Ways and Means",22,0,0,4,26
1922032,1586089,2025-06-06,Assembly,"Assembly Ways And Means Committee: Favorable refer to committee Rules",35,0,0,0,35
1922032,1586857,2025-06-09,Assembly,"Assembly Rules Committee: Favorable",25,0,0,6,31
1922076,1579172,2025-05-27,Assembly,"Assembly Governmental Operations Committee: Held for Consideration",10,4,0,0,14
1922096,1574319,2025-05-20,Assembly,"Assembly Children And Families Committee: Favorable refer to committee Ways and Means",16,0,0,1,17
1922523,1586136,2025-05-29,Senate,"Senate Rules Committee Vote",20,0,0,1,21
1922523,1586137,2025-06-06,Senate,"Senate Floor Vote - Final Passage",38,15,0,10,63
1922528,1560831,2025-04-29,Assembly,"Assembly Education Committee: Favorable refer to committee Ways and Means Correction Date:04/29/2025",26,0,0,5,31
1922528,1574696,2025-05-20,Assembly,"Assembly Ways And Means Committee: Favorable refer to committee Rules",35,0,0,0,35
1922528,1574937,2025-05-21,Assembly,"Assembly Rules Committee: Favorable",29,0,0,2,31
1922576,1559616,2025-03-18,Senate,"Senate Racing, Gaming And Wagering Committee Vote",7,0,0,0,7
1922576,1559617,2025-04-28,Senate,"Senate Floor Vote - Final Passage",60,0,0,2,62
1922626,1534332,2025-04-02,Assembly,"Assembly Higher Education Committee: Held for Consideration",16,8,0,2,26
1922634,1588875,2025-05-20,Senate,"Senate Transportation Committee Vote",11,2,0,0,13
1922634,1589360,2025-06-11,Senate,"Senate Floor Vote - Final Passage",44,15,0,4,63
1922643,1539406,2025-04-08,Senate,"Senate Labor Committee Vote",12,1,0,0,13
1922655,1534317,2025-04-02,Assembly,"Assembly Transportation Committee: Held for Consideration",18,7,0,1,26
1922663,1485253,2025-02-04,Senate,"Senate Banks Committee Vote",5,2,0,0,7
1922667,1503350,2025-03-03,Senate,"Senate Labor Committee Vote",13,0,0,0,13
1922667,1505235,2025-03-04,Senate,"Senate Floor Vote - Final Passage",61,0,0,2,63
1922667,1505715,2025-03-04,Senate,"Senate Rules Committee Vote",20,0,0,1,21
1922667,1590409,2025-06-12,Senate,"Senate Floor Vote - Final Passage",59,0,0,4,63
1922676,1560840,2025-04-29,Assembly,"Assembly Social Services Committee: Favorable",16,1,0,1,18
1922676,1575026,2025-05-20,Assembly,"Assembly Floor Vote - Final Passage",109,38,0,3,150
1922690,1574524,2025-05-20,Assembly,"Assembly Governmental Operations Committee: Held for Consideration",10,4,0,0,14
1922701,1588406,2025-02-03,Senate,"Senate Investigations And Government Operations Committee Vote",5,2,0,0,7
1922701,1588407,2025-06-09,Senate,"Senate Floor Vote - Final Passage",42,20,0,1,63
1922715,1561893,2025-03-10,Senate,"Senate Codes Committee Vote",13,0,0,0,13
1922715,1561894,2025-04-29,Senate,"Senate Floor Vote - Final Passage",61,0,0,1,62
1922715,1591056,2025-06-13,Assembly,"Assembly Floor Vote - Final Passage",135,0,0,15,150
1922717,1515297,2025-02-10,Senate,"Senate Transportation Committee Vote",13,0,0,0,13
1922717,1515298,2025-03-11,Senate,"Senate Floor Vote - Final Passage",60,1,0,2,63
1922720,1514914,2025-03-11,Assembly,"Assembly Governmental Operations Committee: Favorable",14,0,0,0,14
1922720,1519347,2025-03-17,Assembly,"Assembly Floor Vote - Final Passage",145,1,0,4,150
1922758,1571580,2025-02-03,Senate,"Senate Housing, Construction And Community Development Committee Vote",11,0,0,0,11
1922758,1571581,2025-05-14,Senate,"Senate Floor Vote - Final Passage",57,0,0,5,62
1922773,1559550,2025-04-28,Assembly,"Assembly Consumer Affairs And Protection Committee: Favorable refer to committee Codes",10,4,0,2,16
1922773,1580428,2025-05-28,Assembly,"Assembly Codes Committee: Favorable refer to committee Rules",15,6,0,1,22
1922780,1526440,2025-01-27,Senate,"Senate Judiciary Committee Vote",13,6,0,0,19
1922780,1526441,2025-03-25,Senate,"Senate Floor Vote - Final Passage",40,22,0,1,63
1922784,1575743,2025-04-29,Senate,"Senate Environmental Conservation Committee Vote",11,0,0,0,11
1922784,1575744,2025-05-21,Senate,"Senate Floor Vote - Final Passage",58,1,0,3,62
1922786,1534371,2025-04-02,Assembly,"Assembly Higher Education Committee: Favorable",24,0,0,2,26
1922827,1565390,2025-04-29,Senate,"Senate Social Services Committee Vote",4,2,0,0,6
1922827,1565391,2025-05-05,Senate,"Senate Floor Vote - Final Passage",46,15,0,1,62
1922829,1570818,2025-02-25,Senate,"Senate Crime Victims, Crime And Correction Committee Vote",7,0,0,0,7
1922829,1570819,2025-05-13,Senate,"Senate Floor Vote - Final Passage",57,0,0,5,62
1922874,1572513,2025-02-03,Senate,"Senate Investigations And Government Operations Committee Vote",6,1,0,0,7
1922874,1572514,2025-05-14,Senate,"Senate Floor Vote - Final Passage",44,13,0,5,62
1922879,1573363,2025-05-19,Assembly,"Assembly Health Committee: Favorable refer to committee Codes",24,0,0,2,26
1922879,1587031,2025-06-09,Assembly,"Assembly Codes Committee: Favorable refer to committee Rules",20,0,0,2,22
1922879,1590774,2025-06-13,Assembly,"Assembly Rules Committee: Favorable",29,0,0,2,31
1922890,1573405,2025-05-19,Assembly,"Assembly Health Committee: Favorable refer to committee Ways and Means",24,0,0,2,26
1922890,1586059,2025-06-06,Assembly,"Assembly Ways And Means Committee: Favorable refer to committee Rules",35,0,0,0,35
1922890,1586972,2025-06-09,Assembly,"Assembly Rules Committee: Favorable",25,0,0,6,31
1922890,1587352,2025-06-09,Assembly,"Assembly Floor Vote - Final Passage",144,0,0,6,150
1922890,1588157,2025-06-10,Senate,"Senate Floor Vote - Final Passage",58,0,0,5,63
1922902,1580303,2025-05-13,Senate,"Senate Ethics And Internal Governance Committee Vote",5,2,0,0,7
1922902,1580304,2025-05-28,Senate,"Senate Floor Vote - Final Passage",41,20,0,2,63
1922908,1586155,2025-05-20,Senate,"Senate Civil Service And Pensions Committee Vote",7,0,0,0,7
1922908,1586156,2025-06-06,Senate,"Senate Floor Vote - Final Passage",52,1,0,10,63
1922917,1487820,2025-02-11,Senate,"Senate Budget And Revenue Committee Vote",7,0,0,0,7
1922917,1560950,2025-04-29,Senate,"Senate Finance Committee Vote",22,0,0,0,22
1922917,1565388,2025-05-05,Senate,"Senate Floor Vote - Final Passage",61,0,0,1,62
1922917,1592775,2025-06-17,Assembly,"Assembly Floor Vote - Final Passage",141,0,0,9,150
1922926,1525672,2025-02-11,Senate,"Senate Budget And Revenue Committee Vote",7,0,0,0,7
1922926,1525673,2025-03-24,Senate,"Senate Floor Vote - Final Passage",59,0,0,4,63
1922927,1590128,2025-04-28,Senate,"Senate Housing, Construction And Community Development Committee Vote",11,0,0,0,11
1922927,1590129,2025-06-11,Senate,"Senate Floor Vote - Final Passage",59,0,0,4,63
1922933,1534289,2025-04-02,Assembly,"Assembly Codes Committee: Held for Consideration",14,6,0,2,22
1923025,1486083,2025-02-11,Assembly,"Assembly Housing Committee: Favorable refer to committee Codes",19,8,0,1,28
1923025,1498631,2025-02-25,Assembly,"Assembly Codes Committee: Favorable",15,6,0,1,22
1923033,1579138,2025-05-27,Assembly,"Assembly Governmental Operations Committee: Favorable refer to committee Rules",14,0,0,0,14
1923033,1581507,2025-05-29,Assembly,"Assembly Rules Committee: Favorable",27,0,0,4,31
1923065,1575793,2025-05-22,Assembly,"Assembly Ways And Means Committee: Favorable refer to committee Rules",24,7,0,4,35
1923065,1585977,2025-06-06,Assembly,"Assembly Rules Committee: Favorable",27,0,0,4,31
1923065,1586563,2025-06-06,Assembly,"Assembly Floor Vote - Final Passage",92,51,0,7,150
1923065,1590258,2025-06-12,Senate,"Senate Floor Vote - Final Passage",47,12,0,4,63
1923071,1573378,2025-05-19,Assembly,"Assembly Governmental Employees Committee: Held for Consideration",8,5,0,1,14
1923077,1575570,2025-05-13,Senate,"Senate Transportation Committee Vote",13,0,0,0,13
1923077,1575571,2025-05-21,Senate,"Senate Floor Vote - Final Passage",59,0,0,3,62
1923093,1487109,2025-02-11,Assembly,"Assembly Alcoholism And Drug Abuse Committee: Favorable",14,0,0,0,14
1923093,1499725,2025-02-25,Assembly,"Assembly Floor Vote - Final Passage",142,5,0,3,150
1923093,1573097,2025-05-19,Senate,"Senate Floor Vote - Final Passage",54,2,0,6,62
1923101,1534330,2025-04-02,Assembly,"Assembly Codes Committee: Held for Consideration",14,6,0,2,22
1923106,1574389,2025-05-20,Assembly,"Assembly Local Governments Committee: Held for Consideration",13,5,0,2,20
1923110,1574501,2025-05-20,Assembly,"Assembly Local Governments Committee: Held for Consideration",13,5,0,2,20
1923112,1573879,2025-05-20,Assembly,"Assembly Insurance Committee: Favorable refer to committee Rules",25,0,0,0,25
1923112,1579086,2025-05-27,Assembly,"Assembly Rules Committee: Favorable",26,0,0,5,31
1923133,1479853,2025-02-04,Senate,"Senate Labor Committee Vote",13,0,0,0,13
1923137,1540291,2025-02-24,Senate,"Senate Codes Committee Vote",11,2,0,0,13
1923137,1540292,2025-04-08,Senate,"Senate Floor Vote - Final Passage",61,1,0,1,63
1923183,1579972,2025-05-28,Assembly,"Assembly Higher Education Committee: Favorable refer to committee Ways and Means",26,0,0,0,26
1923183,1584901,2025-06-04,Assembly,"Assembly Ways And Means Committee: Favorable refer to committee Rules",33,0,0,2,35
1923183,1591938,2025-06-17,Assembly,"Assembly Rules Committee: Favorable",28,0,0,3,31
1923266,1498490,2025-01-28,Senate,"Senate Corporations, Authorities And Commissions Committee Vote",7,0,0,0,7
1923266,1498491,2025-02-24,Senate,"Senate Floor Vote - Final Passage",60,0,0,3,63
1923476,1564855,2025-05-05,Senate,"Senate Insurance Committee Vote",11,0,0,0,11
1923499,1475589,2025-01-28,Assembly,"Assembly Corporations, Authorities And Commissions Committee: Favorable",18,8,0,0,26
1923582,1579988,2025-05-28,Assembly,"Assembly Local Governments Committee: Favorable refer to committee Ways and Means",20,0,0,0,20
1923731,1573300,2025-05-13,Senate,"Senate Energy And Telecommunications Committee Vote",8,1,0,0,9
1923731,1573301,2025-05-19,Senate,"Senate Floor Vote - Final Passage",55,1,0,6,62
1924048,1497840,2025-02-24,Assembly,"Assembly Corporations, Authorities And Commissions Committee: Favorable",16,6,0,4,26
1924062,1504210,2025-03-03,Senate,"Senate Housing, Construction And Community Development Committee Vote",11,0,0,0,11
1924096,1534586,2025-04-02,Assembly,"Assembly Governmental Operations Committee: Held for Consideration",10,4,0,0,14
1924244,1580676,2025-02-03,Senate,"Senate Investigations And Government Operations Committee Vote",7,0,0,0,7
1924244,1580677,2025-05-27,Senate,"Senate Floor Vote - Final Passage",59,0,0,4,63
1924318,1588246,2025-05-20,Senate,"Senate Local Government Committee Vote",5,2,0,0,7
1924318,1588247,2025-06-10,Senate,"Senate Floor Vote - Final Passage",42,16,0,5,63
1924704,1473163,2025-01-22,Assembly,"Assembly Real Property Taxation Committee: Favorable refer to committee Ways and Means",9,0,0,1,10
1924704,1479634,2025-02-04,Assembly,"Assembly Rules Committee: Favorable",26,0,0,5,31
1924704,1479635,2025-02-04,Assembly,"Assembly Ways And Means Committee: Favorable refer to committee Rules",33,0,0,2,35
1924755,1516515,2025-03-12,Senate,"Senate Commerce, Economic Development And Small Business Committee Vote",6,3,0,0,9
1924806,1473332,2025-01-22,Assembly,"Assembly Real Property Taxation Committee: Favorable refer to committee Ways and Means",9,0,0,1,10
1924806,1479632,2025-02-04,Assembly,"Assembly Rules Committee: Favorable",26,0,0,5,31
1924806,1479633,2025-02-04,Assembly,"Assembly Ways And Means Committee: Favorable refer to committee Rules",33,0,0,2,35
1925120,1475516,2025-01-28,Assembly,"Assembly Labor Committee: Favorable refer to committee Rules",28,0,0,1,29
1925120,1475517,2025-01-28,Assembly,"Assembly Rules Committee: Favorable",31,0,0,0,31
1925222,1588562,2025-06-11,Assembly,"Assembly Ways And Means Committee: Favorable refer to committee Rules",34,0,0,1,35
1925222,1590051,2025-06-12,Assembly,"Assembly Rules Committee: Favorable",29,0,0,2,31
1925326,1473111,2025-01-22,Assembly,"Assembly Veterans' Affairs Committee: Favorable refer to committee Rules",18,0,0,1,19
1925326,1474320,2025-01-22,Assembly,"Assembly Rules Committee: Favorable",29,0,0,2,31
1925326,1479508,2025-02-03,Assembly,"Assembly Floor Vote - Final Passage",147,0,0,3,150
1925326,1480769,2025-02-05,Senate,"Senate Floor Vote - Final Passage",61,1,0,1,63
1925379,1475538,2025-01-28,Assembly,"Assembly Codes Committee: Favorable refer to committee Rules",20,0,0,2,22
1925379,1475539,2025-01-28,Assembly,"Assembly Labor Committee: Favorable refer to committee Codes",28,0,0,1,29
1925379,1475540,2025-01-28,Assembly,"Assembly Rules Committee: Favorable",31,0,0,0,31
1925379,1480467,2025-02-04,Assembly,"Assembly Floor Vote - Final Passage",145,1,0,4,150
1925379,1482486,2025-02-05,Senate,"Senate Floor Vote - Final Passage",54,8,0,1,63
1925584,1475521,2025-01-28,Assembly,"Assembly Labor Committee: Favorable refer to committee Rules",27,1,0,1,29
1925584,1475522,2025-01-28,Assembly,"Assembly Rules Committee: Favorable",31,0,0,0,31
1925633,1586147,2025-05-20,Senate,"Senate Corporations, Authorities And Commissions Committee Vote",6,0,0,1,7
1925633,1586148,2025-06-06,Senate,"Senate Floor Vote - Final Passage",51,2,0,10,63
1925686,1473180,2025-01-22,Assembly,"Assembly Real Property Taxation Committee: Favorable refer to committee Ways and Means",9,0,0,1,10
1925686,1479636,2025-02-04,Assembly,"Assembly Rules Committee: Favorable",26,0,0,5,31
1925686,1479637,2025-02-04,Assembly,"Assembly Ways And Means Committee: Favorable refer to committee Rules",33,0,0,2,35
1926912,1522454,2025-03-11,Senate,"Senate Cities 1 Committee Vote",6,1,0,0,7
1926912,1522455,2025-03-20,Senate,"Senate Floor Vote - Final Passage",38,21,0,4,63
1926953,1487293,2025-02-11,Senate,"Senate Budget And Revenue Committee Vote",6,1,0,0,7
1926957,1527762,2025-02-10,Senate,"Senate Elections Committee Vote",6,1,0,0,7
1926957,1527763,2025-03-25,Senate,"Senate Floor Vote - Final Passage",61,1,0,1,63
1926957,1588282,2025-06-10,Senate,"Senate Floor Vote - Final Passage",57,1,0,5,63
1927043,1527677,2025-03-04,Senate,"Senate Health Committee Vote",15,0,0,0,15
1927043,1527678,2025-03-26,Senate,"Senate Floor Vote - Final Passage",61,0,0,2,63
1927048,1581351,2025-05-20,Senate,"Senate Codes Committee Vote",10,3,0,0,13
1927048,1581352,2025-05-29,Senate,"Senate Floor Vote - Final Passage",44,12,0,7,63
1927083,1571797,2025-02-25,Senate,"Senate Energy And Telecommunications Committee Vote",9,0,0,0,9
1927083,1571798,2025-05-13,Senate,"Senate Floor Vote - Final Passage",57,0,0,5,62
1927112,1475365,2025-01-28,Assembly,"Assembly Insurance Committee: Favorable refer to committee Rules",21,0,0,4,25
1927112,1475366,2025-01-28,Assembly,"Assembly Rules Committee: Favorable",31,0,0,0,31
1927117,1499706,2025-02-25,Senate,"Senate Energy And Telecommunications Committee Vote",7,2,0,0,9
1927151,1586906,2025-04-07,Senate,"Senate Judiciary Committee Vote",10,9,0,0,19
1927151,1587247,2025-06-09,Senate,"Senate Floor Vote - Final Passage",34,28,0,1,63
1927162,1511831,2025-02-11,Senate,"Senate Judiciary Committee Vote",19,0,0,0,19
1927162,1511832,2025-03-10,Senate,"Senate Floor Vote - Final Passage",60,1,0,2,63
1927166,1573880,2025-05-20,Assembly,"Assembly Children And Families Committee: Favorable refer to committee Codes",11,5,0,1,17
1927166,1580189,2025-05-28,Assembly,"Assembly Codes Committee: Favorable refer to committee Rules",15,6,0,1,22
1927166,1581165,2025-05-29,Assembly,"Assembly Rules Committee: Favorable",18,9,0,4,31
1927170,1539554,2025-04-07,Senate,"Senate Investigations And Government Operations Committee Vote",7,0,0,0,7
1927191,1526333,2025-03-25,Assembly,"Assembly Governmental Employees Committee: Favorable refer to committee Ways and Means",12,0,0,2,14
1927204,1581575,2025-04-09,Senate,"Senate Codes Committee Vote",10,2,0,1,13
1927204,1581576,2025-05-28,Senate,"Senate Floor Vote - Final Passage",40,21,0,2,63
1927233,1498681,2025-02-25,Assembly,"Assembly Social Services Committee: Favorable refer to committee Ways and Means",13,4,0,1,18
1927259,1526053,2025-03-25,Assembly,"Assembly Corporations, Authorities And Commissions Committee: Favorable",19,6,0,1,26
1927374,1570470,2025-05-13,Assembly,"Assembly Codes Committee: Held for Consideration",16,6,0,0,22
1927392,1588299,2025-05-20,Senate,"Senate Education Committee Vote",14,0,0,0,14
1927392,1588300,2025-06-10,Senate,"Senate Floor Vote - Final Passage",58,0,0,5,63
1927431,1475373,2025-01-28,Assembly,"Assembly Social Services Committee: Favorable refer to committee Ways and Means",17,0,0,1,18
1927545,1519566,2025-03-18,Assembly,"Assembly Health Committee: Favorable refer to committee Codes",17,8,0,1,26
1927572,1500319,2025-02-26,Senate,"Senate Alcoholism And Substance Use Disorders Committee Vote",7,0,0,0,7
1927577,1573902,2025-05-20,Assembly,"Assembly Education Committee: Held for Consideration",20,8,0,3,31
1927594,1497644,2025-02-24,Assembly,"Assembly Consumer Affairs And Protection Committee: Favorable refer to committee Codes",11,3,0,2,16
1927594,1504301,2025-03-04,Assembly,"Assembly Codes Committee: Favorable",16,6,0,0,22
1927594,1516905,2025-03-12,Assembly,"Assembly Floor Vote - Final Passage",99,46,0,5,150
1927643,1573881,2025-05-20,Assembly,"Assembly Energy Committee: Held for Consideration",11,5,0,1,17
1927691,1526171,2025-03-25,Assembly,"Assembly Codes Committee: Favorable refer to committee Ways and Means",18,3,0,1,22
1927691,1526172,2025-03-25,Assembly,"Assembly Consumer Affairs And Protection Committee: Favorable refer to committee Codes",13,2,0,1,16
1927691,1574669,2025-05-20,Assembly,"Assembly Ways And Means Committee: Favorable refer to committee Rules",32,3,0,0,35
1927691,1581541,2025-05-29,Assembly,"Assembly Rules Committee: Favorable",25,2,0,4,31
1927691,1587249,2025-06-09,Assembly,"Assembly Floor Vote - Final Passage",117,26,0,7,150
1927691,1590670,2025-06-13,Senate,"Senate Floor Vote - Final Passage",54,5,0,4,63
1927719,1576109,2025-03-25,Senate,"Senate Codes Committee Vote",8,4,0,1,13
1927719,1576110,2025-05-21,Senate,"Senate Floor Vote - Final Passage",38,21,0,3,62
1927795,1560842,2025-04-29,Assembly,"Assembly Social Services Committee: Favorable",15,2,0,1,18
1927872,1526404,2025-03-25,Assembly,"Assembly Social Services Committee: Favorable refer to committee Ways and Means",17,0,0,1,18
1927886,1479831,2025-02-04,Assembly,"Assembly Codes Committee: Favorable refer to committee Ways and Means",20,0,0,2,22
1927927,1574435,2025-05-20,Assembly,"Assembly Governmental Operations Committee: Favorable refer to committee Ways and Means",10,4,0,0,14
1927927,1579406,2025-05-27,Assembly,"Assembly Ways And Means Committee: Favorable refer to committee Rules",25,7,0,3,35
1927927,1581538,2025-05-29,Assembly,"Assembly Rules Committee: Favorable",18,9,0,4,31
1927927,1585908,2025-06-05,Assembly,"Assembly Floor Vote - Final Passage",99,45,0,6,150
1927927,1589831,2025-06-11,Senate,"Senate Floor Vote - Final Passage",59,0,0,4,63
1927954,1497829,2025-02-24,Assembly,"Assembly Health Committee: Favorable refer to committee Ways and Means",24,0,0,2,26
1927964,1570101,2025-05-13,Assembly,"Assembly Insurance Committee: Favorable refer to committee Codes",24,0,0,1,25
1927964,1574316,2025-05-20,Assembly,"Assembly Codes Committee: Favorable refer to committee Rules",20,0,0,2,22
1927996,1509289,2025-02-03,Senate,"Senate Investigations And Government Operations Committee Vote",6,1,0,0,7
1927996,1509290,2025-03-10,Senate,"Senate Floor Vote - Final Passage",51,10,0,2,63
1928010,1514839,2025-03-11,Assembly,"Assembly Governmental Operations Committee: Favorable",14,0,0,0,14
1928010,1519485,2025-03-17,Assembly,"Assembly Floor Vote - Final Passage",146,0,0,4,150
1928028,1487863,2025-02-12,Senate,"Senate Health Committee Vote",15,0,0,0,15
1928028,1505020,2025-03-04,Senate,"Senate Finance Committee Vote",21,0,0,1,22
1928028,1527618,2025-03-26,Senate,"Senate Floor Vote - Final Passage",60,1,0,2,63
1928051,1559196,2025-04-28,Assembly,"Assembly Health Committee: Favorable refer to committee Ways and Means",25,0,0,1,26
1928051,1585988,2025-06-06,Assembly,"Assembly Ways And Means Committee: Favorable refer to committee Rules",35,0,0,0,35
1928051,1586861,2025-06-09,Assembly,"Assembly Rules Committee: Favorable",25,0,0,6,31
1928051,1587408,2025-06-09,Assembly,"Assembly Floor Vote - Final Passage",144,0,0,6,150
1928051,1590539,2025-06-12,Senate,"Senate Floor Vote - Final Passage",59,0,0,4,63
1928067,1559551,2025-04-28,Assembly,"Assembly Health Committee: Favorable refer to committee Ways and Means",25,0,0,1,26
1928126,1570628,2025-05-13,Assembly,"Assembly Codes Committee: Held for Consideration",16,6,0,0,22
1928194,1559665,2025-04-28,Senate,"Senate Energy And Telecommunications Committee Vote",8,1,0,0,9
1928194,1589313,2025-06-11,Senate,"Senate Floor Vote - Final Passage",56,3,0,4,63
1928194,1589314,2025-06-11,Senate,"Senate Rules Committee Vote",20,0,0,1,21
1928194,1592383,2025-06-17,Assembly,"Assembly Floor Vote - Final Passage",132,9,0,9,150
1928262,1479878,2025-02-04,Assembly,"Assembly Codes Committee: Favorable",14,6,0,2,22
1928262,1528765,2025-03-26,Assembly,"Assembly Floor Vote - Final Passage",93,56,0,1,150
1928270,1479520,2025-02-04,Assembly,"Assembly Energy Committee: Favorable refer to committee Rules",13,2,0,2,17
1928270,1479521,2025-02-04,Assembly,"Assembly Rules Committee: Favorable",23,3,0,5,31
1928276,1574516,2025-05-20,Assembly,"Assembly Social Services Committee: Favorable refer to committee Ways and Means",16,0,0,2,18
1928276,1580944,2025-05-29,Assembly,"Assembly Ways And Means Committee: Favorable refer to committee Rules",33,1,0,1,35
1928276,1585221,2025-06-04,Assembly,"Assembly Rules Committee: Favorable",28,0,0,3,31
1928276,1585222,2025-06-04,Senate,"Senate Floor Vote - Final Passage",58,0,0,5,63
1928276,1585379,2025-06-04,Assembly,"Assembly Floor Vote - Final Passage",143,0,0,7,150
1928292,1504483,2025-03-04,Senate,"Senate Aging Committee Vote",7,0,0,0,7
1928339,1499710,2025-01-28,Senate,"Senate Corporations, Authorities And Commissions Committee Vote",7,0,0,0,7
1928339,1499711,2025-02-25,Senate,"Senate Floor Vote - Final Passage",45,16,0,2,63
1928437,1587921,2025-02-11,Senate,"Senate Energy And Telecommunications Committee Vote",8,1,0,0,9
1928437,1587922,2025-06-10,Senate,"Senate Floor Vote - Final Passage",54,4,0,5,63
1928437,1591189,2025-06-13,Assembly,"Assembly Floor Vote - Final Passage",133,0,0,17,150
1928539,1579190,2025-05-27,Senate,"Senate Civil Service And Pensions Committee Vote",6,0,0,1,7
1928539,1590426,2025-06-12,Senate,"Senate Floor Vote - Final Passage",59,0,0,4,63
1928539,1595046,2025-06-12,Senate,"Senate Rules Committee Vote",20,0,0,1,21
1928640,1525593,2025-01-28,Senate,"Senate Corporations, Authorities And Commissions Committee Vote",7,0,0,0,7
1928640,1525594,2025-03-24,Senate,"Senate Floor Vote - Final Passage",59,0,0,4,63
1928843,1472860,2025-01-21,Assembly,"Assembly Health Committee: Favorable refer to committee Ways and Means",20,6,0,0,26
1928843,1473214,2025-01-22,Assembly,"Assembly Ways And Means Committee: Favorable refer to committee Rules",24,10,0,1,35
1928843,1574904,2025-05-21,Assembly,"Assembly Rules Committee: Favorable",20,9,0,2,31
1928843,1589434,2025-06-11,Assembly,"Assembly Floor Vote - Final Passage",98,48,0,4,150
1928843,1590476,2025-06-13,Senate,"Senate Floor Vote - Final Passage",50,9,0,4,63
1930823,1565660,2025-05-06,Assembly,"Assembly Correction Committee: Favorable refer to committee Ways and Means",8,4,0,1,13
1930823,1580915,2025-05-29,Assembly,"Assembly Ways And Means Committee: Favorable refer to committee Rules",25,9,0,1,35
1930829,1580334,2025-04-08,Senate,"Senate Cities 1 Committee Vote",5,2,0,0,7
1930829,1580335,2025-05-28,Senate,"Senate Floor Vote - Final Passage",47,14,0,2,63
1930835,1587360,2025-06-10,Assembly,"Assembly Ways And Means Committee: Favorable refer to committee Rules",32,0,0,3,35
1930835,1591980,2025-06-17,Assembly,"Assembly Rules Committee: Favorable",28,0,0,3,31
1930850,1559627,2025-04-28,Senate,"Senate Energy And Telecommunications Committee Vote",8,1,0,0,9
1930865,1526118,2025-03-25,Assembly,"Assembly Children And Families Committee: Favorable refer to committee Codes",10,5,0,2,17
1930865,1539611,2025-04-08,Assembly,"Assembly Codes Committee: Favorable refer to committee Ways and Means",16,5,0,1,22
1930865,1574312,2025-05-20,Assembly,"Assembly Ways And Means Committee: Favorable refer to committee Rules",24,11,0,0,35
1930865,1574871,2025-05-21,Assembly,"Assembly Rules Committee: Favorable",20,9,0,2,31
1930865,1579546,2025-05-27,Assembly,"Assembly Floor Vote - Final Passage",89,57,0,4,150
1930866,1573416,2025-05-19,Assembly,"Assembly Governmental Employees Committee: Favorable refer to committee Ways and Means",13,0,0,1,14
1930866,1586003,2025-06-06,Assembly,"Assembly Ways And Means Committee: Favorable refer to committee Rules",32,3,0,0,35
1930866,1586969,2025-06-09,Assembly,"Assembly Rules Committee: Favorable",25,0,0,6,31
1930877,1580416,2025-05-14,Senate,"Senate Labor Committee Vote",13,0,0,0,13
1930877,1580417,2025-05-28,Senate,"Senate Floor Vote - Final Passage",50,11,0,2,63
1930878,1527316,2025-03-25,Senate,"Senate Crime Victims, Crime And Correction Committee Vote",4,2,0,1,7
1930883,1519553,2025-03-18,Assembly,"Assembly Governmental Operations Committee: Favorable refer to committee Ways and Means",14,0,0,0,14
1930883,1570336,2025-05-13,Assembly,"Assembly Rules Committee: Favorable",27,1,0,3,31
1930883,1570337,2025-05-13,Assembly,"Assembly Ways And Means Committee: Favorable refer to committee Rules",31,3,0,1,35
1930883,1571957,2025-05-14,Assembly,"Assembly Floor Vote - Final Passage",134,13,0,3,150
1930892,1574339,2025-05-20,Assembly,"Assembly Judiciary Committee: Favorable refer to committee Rules",12,8,0,1,21
1930892,1586876,2025-06-09,Assembly,"Assembly Rules Committee: Favorable",17,8,0,6,31
1930892,1589054,2025-06-10,Assembly,"Assembly Floor Vote - Final Passage",86,59,0,5,150
1930898,1560003,2025-03-18,Senate,"Senate Energy And Telecommunications Committee Vote",7,2,0,0,9
1930898,1560004,2025-04-29,Senate,"Senate Floor Vote - Final Passage",56,5,0,1,62
1930899,1505471,2025-02-25,Senate,"Senate Judiciary Committee Vote",16,3,0,0,19
1930899,1505472,2025-03-04,Senate,"Senate Floor Vote - Final Passage",54,7,0,2,63
1930948,1540368,2025-02-11,Senate,"Senate Energy And Telecommunications Committee Vote",9,0,0,0,9
1930948,1540369,2025-04-08,Senate,"Senate Floor Vote - Final Passage",62,0,0,1,63
1930950,1569976,2025-04-09,Senate,"Senate Codes Committee Vote",11,1,0,1,13
1930950,1569977,2025-05-12,Senate,"Senate Floor Vote - Final Passage",43,14,0,5,62
1930951,1574681,2025-05-20,Assembly,"Assembly Codes Committee: Favorable refer to committee Rules",20,0,0,2,22
1930951,1590046,2025-06-12,Assembly,"Assembly Rules Committee: Favorable",28,1,0,2,31
1930951,1591225,2025-06-13,Assembly,"Assembly Floor Vote - Final Passage",124,13,0,13,150
1930987,1487432,2025-02-11,Senate,"Senate Energy And Telecommunications Committee Vote",8,1,0,0,9
1931003,1570949,2025-05-13,Senate,"Senate Energy And Telecommunications Committee Vote",5,4,0,0,9
1931026,1586161,2025-05-06,Senate,"Senate Education Committee Vote",11,3,0,0,14
1931026,1586162,2025-06-06,Senate,"Senate Floor Vote - Final Passage",35,18,0,10,63
1931030,1525807,2025-02-11,Senate,"Senate Energy And Telecommunications Committee Vote",9,0,0,0,9
1931030,1525808,2025-03-24,Senate,"Senate Floor Vote - Final Passage",58,1,0,4,63
1931030,1587826,2025-06-09,Assembly,"Assembly Floor Vote - Final Passage",144,0,0,6,150
1931044,1541905,2025-03-25,Senate,"Senate Codes Committee Vote",12,0,0,1,13
1931044,1541906,2025-04-09,Senate,"Senate Floor Vote - Final Passage",60,0,0,3,63
1931050,1565519,2025-05-06,Assembly,"Assembly Energy Committee: Favorable refer to committee Ways and Means",12,4,0,1,17
1931050,1584905,2025-06-04,Assembly,"Assembly Ways And Means Committee: Favorable refer to committee Rules",25,8,0,2,35
1931050,1586047,2025-06-06,Assembly,"Assembly Rules Committee: Favorable",19,8,0,4,31
1931070,1586874,2025-06-09,Assembly,"Assembly Codes Committee: Favorable refer to committee Rules",15,5,0,2,22
1931070,1587372,2025-06-10,Assembly,"Assembly Rules Committee: Favorable",19,9,0,3,31
1931091,1580880,2025-05-28,Senate,"Senate Budget And Revenue Committee Vote",7,0,0,0,7
1931096,1499713,2025-02-25,Senate,"Senate Energy And Telecommunications Committee Vote",9,0,0,0,9
1931102,1487898,2025-01-28,Senate,"Senate Education Committee Vote",15,0,0,0,15
1931102,1487899,2025-02-12,Senate,"Senate Floor Vote - Final Passage",53,6,0,4,63
1931108,1586889,2025-06-09,Assembly,"Assembly Codes Committee: Favorable refer to committee Rules",15,5,0,2,22
1931119,1573251,2025-05-19,Assembly,"Assembly Housing Committee: Favorable refer to committee Rules",17,9,0,2,28
1931120,1524677,2025-01-28,Senate,"Senate Energy And Telecommunications Committee Vote",8,1,0,0,9
1931120,1524678,2025-03-24,Senate,"Senate Floor Vote - Final Passage",58,1,0,4,63
1931124,1559777,2025-04-28,Senate,"Senate Energy And Telecommunications Committee Vote",8,1,0,0,9
1931124,1590214,2025-06-12,Senate,"Senate Rules Committee Vote",18,2,0,1,21
1931124,1590499,2025-06-13,Senate,"Senate Floor Vote - Final Passage",44,15,0,4,63
1931140,1587343,2025-06-10,Assembly,"Assembly Ways And Means Committee: Favorable refer to committee Rules",32,0,0,3,35
1931140,1588522,2025-06-11,Assembly,"Assembly Rules Committee: Favorable",28,0,0,3,31
1931140,1589389,2025-06-11,Assembly,"Assembly Floor Vote - Final Passage",146,0,0,4,150
1931140,1590338,2025-06-12,Senate,"Senate Floor Vote - Final Passage",59,0,0,4,63
1931163,1475542,2025-01-28,Assembly,"Assembly Insurance Committee: Favorable refer to committee Rules",21,0,0,4,25
1931163,1475543,2025-01-28,Assembly,"Assembly Rules Committee: Favorable",31,0,0,0,31
1931214,1590203,2025-06-12,Senate,"Senate Rules Committee Vote",19,1,0,1,21
1931214,1590612,2025-06-13,Senate,"Senate Floor Vote - Final Passage",56,3,0,4,63
1931290,1526759,2025-01-28,Senate,"Senate Corporations, Authorities And Commissions Committee Vote",7,0,0,0,7
1931290,1526760,2025-03-25,Senate,"Senate Floor Vote - Final Passage",62,0,0,1,63
1931304,1533836,2025-01-28,Senate,"Senate Corporations, Authorities And Commissions Committee Vote",7,0,0,0,7
1931304,1533837,2025-04-01,Senate,"Senate Floor Vote - Final Passage",63,0,0,0,63
1931381,1479470,2025-02-03,Senate,"Senate Housing, Construction And Community Development Committee Vote",8,3,0,0,11
1931389,1589900,2025-05-28,Senate,"Senate Investigations And Government Operations Committee Vote",7,0,0,0,7
1931389,1590361,2025-06-12,Senate,"Senate Floor Vote - Final Passage",59,0,0,4,63
1931389,1592521,2025-06-16,Assembly,"Assembly Floor Vote - Final Passage",145,0,0,5,150
1931412,1499835,2025-02-25,Senate,"Senate Elections Committee Vote",5,2,0,0,7
1931441,1590111,2025-06-12,Senate,"Senate Rules Committee Vote",19,1,0,1,21
1931441,1590669,2025-06-13,Senate,"Senate Floor Vote - Final Passage",57,2,0,4,63
1931441,1592523,2025-06-17,Assembly,"Assembly Floor Vote - Final Passage",119,20,0,11,150
1931466,1480393,2025-01-27,Senate,"Senate Housing, Construction And Community Development Committee Vote",11,0,0,0,11
1931466,1480394,2025-02-04,Senate,"Senate Floor Vote - Final Passage",61,0,0,2,63
1931549,1574842,2025-05-20,Senate,"Senate Labor Committee Vote",13,0,0,0,13
1931549,1590903,2025-06-10,Senate,"Senate Floor Vote - Final Passage",42,16,0,5,63
1931549,1590904,2025-06-10,Senate,"Senate Rules Committee Vote",16,3,0,2,21
1931588,1527070,2025-02-24,Senate,"Senate Codes Committee Vote",10,3,0,0,13
1931588,1527071,2025-03-25,Senate,"Senate Floor Vote - Final Passage",42,20,0,1,63
1931588,1592527,2025-06-17,Assembly,"Assembly Floor Vote - Final Passage",107,33,0,10,150
1931640,1519219,2025-02-25,Senate,"Senate Elections Committee Vote",5,2,0,0,7
1931640,1519220,2025-03-17,Senate,"Senate Floor Vote - Final Passage",40,21,0,2,63
1931658,1569451,2025-02-11,Senate,"Senate Judiciary Committee Vote",13,6,0,0,19
1931658,1569721,2025-05-12,Senate,"Senate Floor Vote - Final Passage",36,21,0,5,62
1931838,1581129,2025-05-14,Senate,"Senate Local Government Committee Vote",6,0,0,1,7
1931838,1581130,2025-05-29,Senate,"Senate Floor Vote - Final Passage",55,1,0,7,63
1932105,1525945,2025-02-11,Senate,"Senate Racing, Gaming And Wagering Committee Vote",7,0,0,0,7
1932105,1525946,2025-03-24,Senate,"Senate Floor Vote - Final Passage",59,0,0,4,63
1932105,1591507,2025-06-12,Senate,"Senate Floor Vote - Final Passage",58,1,0,4,63
1932129,1571907,2025-05-13,Senate,"Senate Health Committee Vote",9,4,0,1,14
1932182,1585858,2025-05-28,Senate,"Senate Racing, Gaming And Wagering Committee Vote",7,0,0,0,7
1932182,1585859,2025-06-05,Senate,"Senate Floor Vote - Final Passage",55,5,0,3,63
1932301,1487328,2025-02-11,Senate,"Senate Racing, Gaming And Wagering Committee Vote",7,0,0,0,7
1932454,1587818,2025-05-28,Senate,"Senate Racing, Gaming And Wagering Committee Vote",7,0,0,0,7
1932454,1587819,2025-06-10,Senate,"Senate Floor Vote - Final Passage",57,1,0,5,63
1932454,1592297,2025-06-16,Assembly,"Assembly Floor Vote - Final Passage",144,0,0,6,150
1932548,1527523,2025-02-11,Senate,"Senate Judiciary Committee Vote",17,2,0,0,19
1932548,1527524,2025-03-26,Senate,"Senate Floor Vote - Final Passage",52,9,0,2,63
1932650,1532000,2025-03-04,Senate,"Senate Education Committee Vote",15,0,0,0,15
1932650,1533646,2025-04-01,Senate,"Senate Floor Vote - Final Passage",63,0,0,0,63
1932650,1575752,2025-05-21,Assembly,"Assembly Floor Vote - Final Passage",143,0,0,7,150
1932697,1498952,2025-02-11,Senate,"Senate Racing, Gaming And Wagering Committee Vote",7,0,0,0,7
1932697,1498953,2025-02-25,Senate,"Senate Floor Vote - Final Passage",59,2,0,2,63
1932773,1504952,2025-03-04,Senate,"Senate Veterans, Homeland Security And Military Affairs Committee Vote",9,0,0,0,9
1932844,1521140,2025-03-11,Senate,"Senate Finance Committee Vote",21,0,0,1,22
1932844,1522220,2025-03-19,Senate,"Senate Floor Vote - Final Passage",60,0,0,3,63
1932872,1535593,2025-02-11,Senate,"Senate Education Committee Vote",13,2,0,0,15
1932872,1535594,2025-04-02,Senate,"Senate Floor Vote - Final Passage",50,12,0,1,63
1932872,1576122,2025-05-21,Assembly,"Assembly Floor Vote - Final Passage",139,5,0,6,150
1932944,1590465,2025-06-12,Senate,"Senate Floor Vote - Final Passage",59,0,0,4,63
1932944,1595092,2025-06-12,Senate,"Senate Rules Committee Vote",20,0,0,1,21
1933902,1573349,2025-05-19,Assembly,"Assembly Health Committee: Favorable refer to committee Ways and Means",24,0,0,2,26
1933981,1564889,2025-05-05,Senate,"Senate Insurance Committee Vote",11,0,0,0,11
1933981,1581457,2025-05-29,Senate,"Senate Rules Committee Vote",20,0,0,1,21
1933981,1586151,2025-06-06,Senate,"Senate Floor Vote - Final Passage",49,4,0,10,63
1933999,1479754,2025-01-27,Senate,"Senate Judiciary Committee Vote",19,0,0,0,19
1933999,1479755,2025-02-04,Senate,"Senate Floor Vote - Final Passage",60,1,0,2,63
1933999,1589455,2025-06-11,Senate,"Senate Floor Vote - Final Passage",58,1,0,4,63
1934046,1562057,2025-04-30,Assembly,"Assembly Labor Committee: Favorable",28,0,0,1,29
1934046,1565493,2025-05-05,Assembly,"Assembly Floor Vote - Final Passage",146,1,0,3,150
1934046,1586115,2025-06-06,Senate,"Senate Floor Vote - Final Passage",52,1,0,10,63
1934092,1526186,2025-03-25,Assembly,"Assembly Cities Committee: Favorable refer to committee Ways and Means",14,0,0,2,16
1934092,1588523,2025-06-11,Assembly,"Assembly Ways And Means Committee: Favorable refer to committee Rules",34,0,0,1,35
1934092,1590036,2025-06-12,Assembly,"Assembly Rules Committee: Favorable",29,0,0,2,31
1934113,1573395,2025-05-19,Assembly,"Assembly Health Committee: Held for Consideration",16,8,0,2,26
1934159,1560030,2025-04-28,Senate,"Senate Energy And Telecommunications Committee Vote",9,0,0,0,9
1934178,1588257,2025-05-28,Senate,"Senate Investigations And Government Operations Committee Vote",7,0,0,0,7
1934178,1588258,2025-06-10,Senate,"Senate Floor Vote - Final Passage",58,0,0,5,63
1934211,1564882,2025-05-05,Senate,"Senate Insurance Committee Vote",11,0,0,0,11
1934211,1575825,2025-05-22,Senate,"Senate Alcoholism And Substance Use Disorders Committee Vote",7,0,0,0,7
1934211,1589505,2025-06-11,Senate,"Senate Floor Vote - Final Passage",57,2,0,4,63
1934246,1573297,2025-05-19,Assembly,"Assembly Health Committee: Favorable refer to committee Ways and Means",24,0,0,2,26
1934246,1578996,2025-05-27,Assembly,"Assembly Ways And Means Committee: Favorable refer to committee Rules",32,0,0,3,35
1934246,1584813,2025-06-04,Assembly,"Assembly Rules Committee: Favorable",28,0,0,3,31
1934287,1579961,2025-05-28,Assembly,"Assembly Banks Committee: Favorable refer to committee Rules",28,0,0,3,31
1934287,1581174,2025-05-29,Assembly,"Assembly Rules Committee: Favorable",27,0,0,4,31
1934287,1582098,2025-05-29,Assembly,"Assembly Floor Vote - Final Passage",146,0,0,4,150
1934287,1586918,2025-06-09,Senate,"Senate Floor Vote - Final Passage",61,1,0,1,63
1934310,1574145,2025-05-20,Assembly,"Assembly Energy Committee: Favorable refer to committee Rules",15,1,0,1,17
1934310,1579087,2025-05-27,Assembly,"Assembly Rules Committee: Favorable",26,0,0,5,31
1934310,1579589,2025-05-27,Assembly,"Assembly Floor Vote - Final Passage",145,0,0,5,150
1934310,1585733,2025-06-05,Senate,"Senate Floor Vote - Final Passage",60,0,0,3,63
1934344,1499999,2025-02-12,Senate,"Senate Health Committee Vote",15,0,0,0,15
1934344,1500000,2025-02-26,Senate,"Senate Floor Vote - Final Passage",61,0,0,2,63
1934364,1584649,2025-06-04,Assembly,"Assembly Transportation Committee: Favorable refer to committee Ways and Means",22,0,0,4,26
1934364,1586106,2025-06-06,Assembly,"Assembly Ways And Means Committee: Favorable refer to committee Rules",35,0,0,0,35
1934364,1587305,2025-06-10,Assembly,"Assembly Rules Committee: Favorable",28,0,0,3,31
1934371,1586028,2025-06-06,Assembly,"Assembly Ways And Means Committee: Favorable refer to committee Rules",35,0,0,0,35
1934371,1586858,2025-06-09,Assembly,"Assembly Rules Committee: Favorable",25,0,0,6,31
1934371,1587508,2025-06-09,Assembly,"Assembly Floor Vote - Final Passage",144,0,0,6,150
1934371,1588175,2025-06-10,Senate,"Senate Floor Vote - Final Passage",58,0,0,5,63
1934413,1573891,2025-05-20,Assembly,"Assembly Education Committee: Held for Consideration",20,8,0,3,31
1934426,1580143,2025-05-28,Assembly,"Assembly Labor Committee: Favorable refer to committee Rules",28,1,0,0,29
1934426,1581145,2025-05-29,Assembly,"Assembly Rules Committee: Favorable",27,0,0,4,31
1934426,1582091,2025-05-29,Assembly,"Assembly Floor Vote - Final Passage",133,13,0,4,150
1934426,1590493,2025-06-12,Senate,"Senate Floor Vote - Final Passage",59,0,0,4,63
1934432,1586869,2025-05-13,Senate,"Senate Environmental Conservation Committee Vote",11,0,0,0,11
1934432,1587242,2025-06-09,Senate,"Senate Floor Vote - Final Passage",62,0,0,1,63
1934473,1574479,2025-05-20,Assembly,"Assembly Cities Committee: Favorable refer to committee Ways and Means",14,0,0,2,16
1934473,1578850,2025-05-27,Assembly,"Assembly Ways And Means Committee: Favorable refer to committee Rules",27,5,0,3,35
1934473,1581524,2025-05-29,Assembly,"Assembly Rules Committee: Favorable",27,0,0,4,31
1934490,1520302,2025-03-18,Assembly,"Assembly Local Governments Committee: Favorable refer to committee Ways and Means",19,0,0,1,20
1934490,1538046,2025-04-07,Assembly,"Assembly Rules Committee: Favorable",29,0,0,2,31
1934490,1538047,2025-04-07,Assembly,"Assembly Ways And Means Committee: Favorable refer to committee Rules",33,0,0,2,35
1934490,1541416,2025-04-08,Assembly,"Assembly Floor Vote - Final Passage",147,0,0,3,150
1934490,1588421,2025-06-10,Senate,"Senate Floor Vote - Final Passage",58,0,0,5,63
1934511,1586007,2025-06-06,Assembly,"Assembly Ways And Means Committee: Favorable refer to committee Rules",35,0,0,0,35
1934511,1587348,2025-06-10,Assembly,"Assembly Rules Committee: Favorable",28,0,0,3,31
1934592,1528645,2025-03-27,Assembly,"Assembly Rules Committee: Favorable",23,6,0,2,31
1934592,1528646,2025-03-27,Assembly,"Assembly Ways And Means Committee: Favorable refer to committee Rules",26,6,0,3,35
1934592,1528647,2025-03-27,Senate,"Senate Floor Vote - Final Passage",51,10,0,2,63
1934592,1529872,2025-03-27,Assembly,"Assembly Floor Vote - Final Passage",112,35,0,3,150
1934598,1475401,2025-01-28,Assembly,"Assembly Labor Committee: Favorable refer to committee Ways and Means",26,2,0,1,29
1934598,1579019,2025-05-27,Assembly,"Assembly Ways And Means Committee: Favorable refer to committee Rules",30,2,0,3,35
1934598,1588528,2025-06-11,Assembly,"Assembly Rules Committee: Favorable",28,0,0,3,31
1934636,1568488,2025-05-08,Assembly,"Assembly Rules Committee: Favorable",18,8,0,5,31
1934636,1568489,2025-05-08,Assembly,"Assembly Ways And Means Committee: Favorable refer to committee Rules",21,9,0,5,35
1934636,1568782,2025-05-08,Senate,"Senate Floor Vote - Final Passage",40,22,0,0,62
1934636,1568904,2025-05-08,Assembly,"Assembly Floor Vote - Final Passage",100,49,0,1,150
1934641,1475955,2025-01-28,Assembly,"Assembly Labor Committee: Favorable refer to committee Ways and Means",28,0,0,1,29
1934641,1585926,2025-06-06,Assembly,"Assembly Ways And Means Committee: Favorable refer to committee Rules",35,0,0,0,35
1934641,1587025,2025-06-09,Assembly,"Assembly Rules Committee: Favorable",25,0,0,6,31
1934641,1587391,2025-06-09,Assembly,"Assembly Floor Vote - Final Passage",142,2,0,6,150
1934641,1588178,2025-06-10,Senate,"Senate Floor Vote - Final Passage",42,16,0,5,63
1934659,1504851,2025-02-25,Senate,"Senate Energy And Telecommunications Committee Vote",9,0,0,0,9
1934659,1504852,2025-03-04,Senate,"Senate Floor Vote - Final Passage",56,5,0,2,63
1934701,1568396,2025-05-08,Senate,"Senate Finance Committee Vote",16,6,0,0,22
1934701,1568764,2025-05-08,Senate,"Senate Floor Vote - Final Passage",44,18,0,0,62
1934701,1568929,2025-05-08,Assembly,"Assembly Floor Vote - Final Passage",112,37,0,1,150
1934743,1573833,2025-05-20,Senate,"Senate Local Government Committee Vote",7,0,0,0,7
1934748,1570799,2025-05-12,Senate,"Senate Judiciary Committee Vote",17,1,0,1,19
1934784,1589223,2025-02-25,Senate,"Senate Crime Victims, Crime And Correction Committee Vote",7,0,0,0,7
1934784,1589445,2025-06-11,Senate,"Senate Floor Vote - Final Passage",45,14,0,4,63
1934805,1566998,2025-05-07,Assembly,"Assembly Rules Committee: Favorable",21,6,0,4,31
1934805,1566999,2025-05-07,Assembly,"Assembly Ways And Means Committee: Favorable refer to committee Rules",25,8,0,2,35
1934805,1567984,2025-05-07,Senate,"Senate Floor Vote - Final Passage",41,21,0,0,62
1934805,1568288,2025-05-07,Assembly,"Assembly Floor Vote - Final Passage",104,46,0,0,150
1934808,1568457,2025-05-08,Senate,"Senate Finance Committee Vote",16,6,0,0,22
1934808,1568779,2025-05-08,Senate,"Senate Floor Vote - Final Passage",45,17,0,0,62
1934808,1568956,2025-05-08,Assembly,"Assembly Floor Vote - Final Passage",109,40,0,1,150
1934824,1568470,2025-05-08,Assembly,"Assembly Rules Committee: Favorable",18,8,0,5,31
1934824,1568471,2025-05-08,Assembly,"Assembly Ways And Means Committee: Favorable refer to committee Rules",21,9,0,5,35
1934835,1567941,2025-05-07,Senate,"Senate Finance Committee Vote",15,7,0,0,22
1934835,1567942,2025-05-07,Senate,"Senate Floor Vote - Final Passage",42,20,0,0,62
1934835,1568143,2025-05-07,Assembly,"Assembly Floor Vote - Final Passage",101,49,0,0,150
1934869,1567022,2025-05-07,Assembly,"Assembly Rules Committee: Favorable",19,8,0,4,31
1934869,1567023,2025-05-07,Assembly,"Assembly Ways And Means Committee: Favorable refer to committee Rules",24,9,0,2,35
1934891,1553893,2025-02-11,Senate,"Senate Environmental Conservation Committee Vote",11,0,0,0,11
1934891,1553894,2025-04-22,Senate,"Senate Floor Vote - Final Passage",48,5,0,9,62
1934914,1568077,2025-05-08,Assembly,"Assembly Rules Committee: Favorable",21,7,0,3,31
1934914,1568078,2025-05-08,Assembly,"Assembly Ways And Means Committee: Favorable refer to committee Rules",22,9,0,4,35
1934914,1568771,2025-05-08,Senate,"Senate Floor Vote - Final Passage",35,27,0,0,62
1934914,1568928,2025-05-08,Assembly,"Assembly Floor Vote - Final Passage",103,46,0,1,150
1934922,1588374,2025-06-10,Senate,"Senate Floor Vote - Final Passage",58,0,0,5,63
1934922,1588375,2025-06-10,Senate,"Senate Rules Committee Vote",19,0,0,2,21
1934936,1488580,2025-01-27,Senate,"Senate Rules Committee Vote",18,2,0,1,21
1934936,1488581,2025-02-12,Senate,"Senate Floor Vote - Final Passage",56,3,0,4,63
1934936,1506994,2025-03-05,Assembly,"Assembly Floor Vote - Final Passage",141,7,0,2,150
1934970,1568066,2025-05-08,Assembly,"Assembly Rules Committee: Favorable",22,6,0,3,31
1934970,1568067,2025-05-08,Assembly,"Assembly Ways And Means Committee: Favorable refer to committee Rules",22,9,0,4,35
1934979,1487301,2025-01-28,Senate,"Senate Education Committee Vote",15,0,0,0,15
1934979,1487709,2025-02-12,Senate,"Senate Floor Vote - Final Passage",58,1,0,4,63
1935000,1568070,2025-05-08,Assembly,"Assembly Rules Committee: Favorable",22,6,0,3,31
1935000,1568071,2025-05-08,Assembly,"Assembly Ways And Means Committee: Favorable refer to committee Rules",22,9,0,4,35
1935006,1568734,2025-05-08,Senate,"Senate Floor Vote - Final Passage",46,16,0,0,62
1935006,1568875,2025-05-08,Assembly,"Assembly Floor Vote - Final Passage",117,32,0,1,150
1935006,1569652,2025-05-08,Senate,"Senate Finance Committee Vote",16,6,0,0,22
1935040,1567003,2025-05-07,Assembly,"Assembly Rules Committee: Favorable",19,8,0,4,31
1935040,1567004,2025-05-07,Assembly,"Assembly Ways And Means Committee: Favorable refer to committee Rules",24,9,0,2,35
1935053,1568495,2025-05-08,Assembly,"Assembly Rules Committee: Favorable",23,3,0,5,31
1935053,1568496,2025-05-08,Assembly,"Assembly Ways And Means Committee: Favorable refer to committee Rules",25,5,0,5,35
1935076,1475546,2025-01-28,Assembly,"Assembly Corporations, Authorities And Commissions Committee: Favorable refer to committee Rules",24,2,0,0,26
1935076,1475547,2025-01-28,Assembly,"Assembly Rules Committee: Favorable",31,0,0,0,31
1935113,1475453,2025-01-28,Assembly,"Assembly Labor Committee: Favorable refer to committee Codes",26,2,0,1,29
1935190,1568530,2025-05-08,Senate,"Senate Floor Vote - Final Passage",44,18,0,0,62
1935190,1569005,2025-05-08,Assembly,"Assembly Floor Vote - Final Passage",104,45,0,1,150
1935190,1569473,2025-05-08,Senate,"Senate Finance Committee Vote",16,6,0,0,22
1935197,1567627,2025-05-07,Senate,"Senate Floor Vote - Final Passage",40,22,0,0,62
1935197,1568023,2025-05-07,Assembly,"Assembly Floor Vote - Final Passage",103,47,0,0,150
1935197,1569663,2025-05-07,Senate,"Senate Finance Committee Vote",16,6,0,0,22
1935228,1590215,2025-06-12,Senate,"Senate Rules Committee Vote",20,0,0,1,21
1935228,1590656,2025-06-13,Senate,"Senate Floor Vote - Final Passage",59,0,0,4,63
1935228,1591166,2025-06-13,Assembly,"Assembly Floor Vote - Final Passage",133,0,0,17,150
1936079,1475240,2025-01-27,Senate,"Senate Housing, Construction And Community Development Committee Vote",11,0,0,0,11
1936840,1518726,2025-03-17,Senate,"Senate Investigations And Government Operations Committee Vote",7,0,0,0,7
1936840,1580887,2025-05-28,Senate,"Senate Finance Committee Vote",22,0,0,0,22
1936921,1541289,2025-03-18,Senate,"Senate Agriculture Committee Vote",9,0,0,0,9
1936921,1541290,2025-04-08,Senate,"Senate Floor Vote - Final Passage",62,0,0,1,63
1936924,1575372,2025-05-12,Senate,"Senate Judiciary Committee Vote",12,6,0,1,19
1936924,1575373,2025-05-21,Senate,"Senate Floor Vote - Final Passage",35,24,0,3,62
1936937,1589369,2025-05-19,Senate,"Senate Housing, Construction And Community Development Committee Vote",9,1,0,1,11
1936937,1589370,2025-06-11,Senate,"Senate Floor Vote - Final Passage",43,16,0,4,63
1937044,1498515,2025-02-03,Senate,"Senate Higher Education Committee Vote",11,0,0,0,11
1937044,1498516,2025-02-24,Senate,"Senate Floor Vote - Final Passage",60,0,0,3,63
1937083,1570248,2025-05-13,Senate,"Senate Children And Families Committee Vote",4,2,0,1,7
1937123,1581086,2025-05-27,Senate,"Senate Internet And Technology Committee Vote",6,1,0,0,7
1937181,1574295,2025-05-20,Assembly,"Assembly Children And Families Committee: Favorable refer to committee Ways and Means",14,2,0,1,17
1937222,1579008,2025-05-27,Assembly,"Assembly Consumer Affairs And Protection Committee: Favorable refer to committee Codes",10,5,0,1,16
1937222,1586864,2025-06-09,Assembly,"Assembly Codes Committee: Favorable refer to committee Rules",15,5,0,2,22
1937222,1587300,2025-06-10,Assembly,"Assembly Rules Committee: Favorable",19,9,0,3,31
1937238,1589209,2025-06-11,Senate,"Senate Floor Vote - Final Passage",59,0,0,4,63
1937238,1589210,2025-06-11,Senate,"Senate Rules Committee Vote",20,0,0,1,21
1937324,1581107,2025-05-29,Assembly,"Assembly Tourism, Arts And Sports Development Committee: Favorable refer to committee Ways and Means",19,0,0,2,21
1937381,1534090,2025-04-02,Assembly,"Assembly Correction Committee: Held for Consideration",9,3,0,1,13
1937442,1580951,2025-05-29,Assembly,"Assembly Ways And Means Committee: Favorable refer to committee Rules",34,0,0,1,35
1937442,1585211,2025-06-04,Assembly,"Assembly Rules Committee: Favorable",28,0,0,3,31
1937442,1585384,2025-06-04,Assembly,"Assembly Floor Vote - Final Passage",142,1,0,7,150
1937442,1590380,2025-06-12,Senate,"Senate Floor Vote - Final Passage",49,10,0,4,63
1937454,1585943,2025-06-06,Assembly,"Assembly Ways And Means Committee: Held for Consideration",25,10,0,0,35
1937458,1581314,2025-05-28,Senate,"Senate Investigations And Government Operations Committee Vote",7,0,0,0,7
1937476,1570994,2025-05-13,Senate,"Senate Energy And Telecommunications Committee Vote",9,0,0,0,9
1937484,1504357,2025-03-04,Senate,"Senate Education Committee Vote",15,0,0,0,15
1937534,1561287,2025-04-29,Assembly,"Assembly Ways And Means Committee: Favorable refer to committee Rules",30,2,0,3,35
1937534,1561811,2025-04-30,Assembly,"Assembly Rules Committee: Favorable",29,0,0,2,31
1937534,1563435,2025-04-30,Assembly,"Assembly Floor Vote - Final Passage",106,40,0,4,150
1937534,1599257,2025-05-27,Senate,"Senate Floor Vote - Final Passage",51,8,0,4,63
1937599,1589835,2025-05-20,Senate,"Senate Health Committee Vote",13,0,0,1,14
1937599,1589836,2025-06-11,Senate,"Senate Floor Vote - Final Passage",43,16,0,4,63
1937610,1479827,2025-02-03,Senate,"Senate Housing, Construction And Community Development Committee Vote",10,1,0,0,11
1937617,1497729,2025-02-24,Assembly,"Assembly Insurance Committee: Favorable",22,0,0,3,25
1937617,1504271,2025-03-03,Assembly,"Assembly Floor Vote - Final Passage",147,0,0,3,150
1937617,1577967,2025-05-22,Senate,"Senate Floor Vote - Final Passage",57,0,0,5,62
1937674,1498999,2025-02-25,Assembly,"Assembly Social Services Committee: Favorable refer to committee Codes",13,4,0,1,18
1937674,1504160,2025-03-04,Assembly,"Assembly Codes Committee: Favorable refer to committee Ways and Means",16,6,0,0,22
1937676,1574442,2025-05-20,Assembly,"Assembly Governmental Operations Committee: Favorable refer to committee Codes",10,4,0,0,14
1937676,1580425,2025-05-28,Assembly,"Assembly Codes Committee: Favorable refer to committee Rules",17,4,0,1,22
1937676,1581489,2025-05-29,Assembly,"Assembly Rules Committee: Favorable",19,8,0,4,31
1937717,1558882,2025-03-04,Senate,"Senate Education Committee Vote",15,0,0,0,15
1937717,1565016,2025-05-05,Senate,"Senate Floor Vote - Final Passage",61,0,0,1,62
1937718,1586087,2025-06-06,Assembly,"Assembly Ways And Means Committee: Held for Consideration",25,10,0,0,35
1937722,1526098,2025-03-25,Assembly,"Assembly Consumer Affairs And Protection Committee: Favorable refer to committee Codes",10,5,0,1,16
1937722,1580121,2025-05-28,Assembly,"Assembly Codes Committee: Favorable refer to committee Rules",15,6,0,1,22
1937722,1581108,2025-05-29,Assembly,"Assembly Rules Committee: Favorable",18,9,0,4,31
1937849,1573289,2025-05-19,Assembly,"Assembly Housing Committee: Favorable refer to committee Rules",17,9,0,2,28
1937849,1579080,2025-05-27,Assembly,"Assembly Rules Committee: Favorable",18,8,0,5,31
1937896,1536065,2025-02-11,Senate,"Senate Consumer Protection Committee Vote",6,1,0,0,7
1937896,1536066,2025-04-03,Senate,"Senate Floor Vote - Final Passage",40,20,0,3,63
1937896,1581084,2025-05-28,Assembly,"Assembly Floor Vote - Final Passage",98,46,0,6,150
1937954,1518834,2025-02-12,Senate,"Senate Health Committee Vote",15,0,0,0,15
1937954,1518835,2025-03-17,Senate,"Senate Floor Vote - Final Passage",59,2,0,2,63
1937972,1585340,2025-02-11,Senate,"Senate Education Committee Vote",15,0,0,0,15
1937972,1585341,2025-06-04,Senate,"Senate Floor Vote - Final Passage",58,0,0,5,63
1937977,1526155,2025-03-25,Assembly,"Assembly Correction Committee: Favorable refer to committee Ways and Means",9,3,0,1,13
1937983,1580922,2025-05-29,Assembly,"Assembly Ways And Means Committee: Favorable refer to committee Rules",32,2,0,1,35
1937983,1585169,2025-06-04,Assembly,"Assembly Rules Committee: Favorable",28,0,0,3,31
1938062,1534102,2025-04-02,Assembly,"Assembly Housing Committee: Favorable refer to committee Codes",18,8,0,2,28
1938062,1574395,2025-05-20,Assembly,"Assembly Codes Committee: Favorable refer to committee Rules",14,6,0,2,22
1938062,1581103,2025-05-29,Assembly,"Assembly Rules Committee: Favorable",18,9,0,4,31
1938140,1511614,2025-03-10,Senate,"Senate Housing, Construction And Community Development Committee Vote",11,0,0,0,11
1938332,1560999,2025-04-29,Senate,"Senate Local Government Committee Vote",7,0,0,0,7
1938409,1581302,2025-05-28,Senate,"Senate Investigations And Government Operations Committee Vote",6,1,0,0,7
1938446,1586981,2025-06-09,Senate,"Senate Floor Vote - Final Passage",57,5,0,1,63
1938446,1586982,2025-06-09,Senate,"Senate Rules Committee Vote",19,2,0,0,21
1938522,1475518,2025-01-28,Assembly,"Assembly Corporations, Authorities And Commissions Committee: Favorable refer to committee Ways and Means",26,0,0,0,26
1938522,1475519,2025-01-28,Assembly,"Assembly Rules Committee: Favorable",31,0,0,0,31
1938522,1475520,2025-01-28,Assembly,"Assembly Ways And Means Committee: Favorable refer to committee Rules",31,0,0,4,35
1938522,1476387,2025-01-28,Assembly,"Assembly Floor Vote - Final Passage",141,2,0,7,150
1938522,1505484,2025-03-04,Senate,"Senate Floor Vote - Final Passage",61,0,0,2,63
1938601,1581641,2025-05-28,Senate,"Senate Investigations And Government Operations Committee Vote",7,0,0,0,7
1938638,1528500,2025-03-03,Senate,"Senate Insurance Committee Vote",11,0,0,0,11
1938638,1528501,2025-03-26,Senate,"Senate Floor Vote - Final Passage",60,1,0,2,63
1938675,1542132,2025-04-08,Senate,"Senate Libraries Committee Vote",7,0,0,0,7
1938715,1540175,2025-03-25,Senate,"Senate Codes Committee Vote",11,1,0,1,13
1938715,1540176,2025-04-08,Senate,"Senate Floor Vote - Final Passage",61,1,0,1,63
1938794,1562452,2025-04-29,Senate,"Senate Transportation Committee Vote",13,0,0,0,13
1938832,1585585,2025-05-29,Senate,"Senate Rules Committee Vote",20,0,0,1,21
1938832,1585586,2025-06-05,Senate,"Senate Floor Vote - Final Passage",58,2,0,3,63
1938832,1592642,2025-06-17,Assembly,"Assembly Floor Vote - Final Passage",135,0,0,15,150
1939579,1589058,2025-06-09,Senate,"Senate Rules Committee Vote",20,1,0,0,21
1939579,1589059,2025-06-11,Senate,"Senate Floor Vote - Final Passage",56,3,0,4,63
1939610,1504372,2025-03-04,Senate,"Senate Aging Committee Vote",7,0,0,0,7
1939610,1580891,2025-05-28,Senate,"Senate Finance Committee Vote",22,0,0,0,22
1939610,1585763,2025-06-05,Senate,"Senate Floor Vote - Final Passage",60,0,0,3,63
1939631,1586145,2025-05-20,Senate,"Senate Social Services Committee Vote",6,0,0,0,6
1939631,1586146,2025-06-06,Senate,"Senate Floor Vote - Final Passage",53,0,0,10,63
1939646,1527443,2025-02-03,Senate,"Senate Housing, Construction And Community Development Committee Vote",8,3,0,0,11
1939646,1527444,2025-03-25,Senate,"Senate Floor Vote - Final Passage",40,22,0,1,63
1939658,1479992,2025-01-27,Senate,"Senate Rules Committee Vote",20,0,0,1,21
1939658,1479993,2025-02-04,Senate,"Senate Floor Vote - Final Passage",61,0,0,2,63
1939673,1524894,2025-02-25,Senate,"Senate Environmental Conservation Committee Vote",10,1,0,0,11
1939673,1524895,2025-03-24,Senate,"Senate Floor Vote - Final Passage",46,13,0,4,63
1939677,1580647,2025-05-20,Senate,"Senate Corporations, Authorities And Commissions Committee Vote",6,0,0,1,7
1939677,1580648,2025-05-28,Senate,"Senate Floor Vote - Final Passage",61,0,0,2,63
1939677,1592401,2025-06-17,Assembly,"Assembly Floor Vote - Final Passage",140,1,0,9,150
1939695,1587615,2025-06-09,Senate,"Senate Rules Committee Vote",21,0,0,0,21
1939695,1588390,2025-06-10,Senate,"Senate Floor Vote - Final Passage",58,0,0,5,63
1939728,1515725,2025-03-11,Senate,"Senate Judiciary Committee Vote",19,0,0,0,19
1939745,1487852,2025-02-04,Senate,"Senate Cultural Affairs, Tourism, Parks And Recreation Committee Vote",6,0,0,1,7
1939745,1487853,2025-02-12,Senate,"Senate Floor Vote - Final Passage",59,0,0,4,63
1939745,1591320,2025-06-13,Assembly,"Assembly Floor Vote - Final Passage",135,0,0,15,150
1939767,1527487,2025-03-24,Senate,"Senate Insurance Committee Vote",11,0,0,0,11
1939782,1564893,2025-05-05,Senate,"Senate Insurance Committee Vote",11,0,0,0,11
1939793,1479432,2025-02-03,Senate,"Senate Housing, Construction And Community Development Committee Vote",8,3,0,0,11
1939793,1514390,2025-03-11,Senate,"Senate Cities 1 Committee Vote",5,2,0,0,7
1939832,1501529,2025-02-25,Senate,"Senate Banks Committee Vote",5,2,0,0,7
1939836,1515406,2025-03-11,Senate,"Senate Cities 1 Committee Vote",7,0,0,0,7
1939840,1515407,2025-03-11,Senate,"Senate Cities 1 Committee Vote",7,0,0,0,7
1939863,1512420,2025-03-10,Senate,"Senate Codes Committee Vote",13,0,0,0,13
1939863,1561056,2025-04-29,Senate,"Senate Finance Committee Vote",22,0,0,0,22
1939863,1565616,2025-05-06,Senate,"Senate Floor Vote - Final Passage",61,0,0,1,62
1939878,1535614,2025-03-12,Senate,"Senate Women's Issues Committee Vote",7,0,0,0,7
1939878,1535615,2025-04-02,Senate,"Senate Floor Vote - Final Passage",62,0,0,1,63
1939883,1505608,2025-03-04,Senate,"Senate Health Committee Vote",13,2,0,0,15
1939883,1560171,2025-04-29,Senate,"Senate Finance Committee Vote",19,3,0,0,22
1939883,1574073,2025-05-20,Senate,"Senate Floor Vote - Final Passage",41,20,0,1,62
1939944,1506330,2025-02-10,Senate,"Senate Transportation Committee Vote",13,0,0,0,13
1939944,1506331,2025-03-05,Senate,"Senate Floor Vote - Final Passage",61,0,0,2,63
1940048,1589291,2025-06-11,Senate,"Senate Floor Vote - Final Passage",59,0,0,4,63
1940048,1589292,2025-06-11,Senate,"Senate Rules Committee Vote",20,0,0,1,21
1940088,1499651,2025-02-03,Senate,"Senate Investigations And Government Operations Committee Vote",7,0,0,0,7
1940088,1499652,2025-02-25,Senate,"Senate Floor Vote - Final Passage",61,0,0,2,63
1940102,1580682,2025-03-17,Senate,"Senate Investigations And Government Operations Committee Vote",6,1,0,0,7
1940102,1580683,2025-05-28,Senate,"Senate Floor Vote - Final Passage",49,12,0,2,63
1940114,1589523,2025-03-04,Senate,"Senate Agriculture Committee Vote",9,0,0,0,9
1940114,1589524,2025-06-11,Senate,"Senate Floor Vote - Final Passage",59,0,0,4,63
1940291,1588753,2025-06-09,Senate,"Senate Rules Committee Vote",17,4,0,0,21
1940291,1589219,2025-06-11,Senate,"Senate Floor Vote - Final Passage",41,18,0,4,63
1940358,1520251,2025-03-04,Senate,"Senate Higher Education Committee Vote",11,0,0,0,11
1940358,1520252,2025-03-18,Senate,"Senate Floor Vote - Final Passage",61,0,0,2,63
1940358,1570633,2025-05-13,Senate,"Senate Floor Vote - Final Passage",57,0,0,5,62
1940358,1575736,2025-05-21,Assembly,"Assembly Floor Vote - Final Passage",144,0,0,6,150
1940423,1574564,2025-05-20,Senate,"Senate Cultural Affairs, Tourism, Parks And Recreation Committee Vote",7,0,0,0,7
1940423,1587137,2025-06-09,Senate,"Senate Rules Committee Vote",21,0,0,0,21
1940423,1589337,2025-06-11,Senate,"Senate Floor Vote - Final Passage",59,0,0,4,63
1940559,1589156,2025-06-09,Senate,"Senate Rules Committee Vote",21,0,0,0,21
1940559,1589412,2025-06-11,Senate,"Senate Floor Vote - Final Passage",58,1,0,4,63
1940721,1561196,2025-04-29,Senate,"Senate Commerce, Economic Development And Small Business Committee Vote",7,1,0,1,9
1940747,1570992,2025-05-13,Senate,"Senate Aging Committee Vote",6,0,0,0,6
1940776,1589906,2025-03-18,Senate,"Senate Procurement And Contracts Committee Vote",6,1,0,0,7
1940776,1590379,2025-06-12,Senate,"Senate Floor Vote - Final Passage",59,0,0,4,63
1940776,1592652,2025-06-17,Assembly,"Assembly Floor Vote - Final Passage",139,0,0,11,150
1940816,1590844,2025-06-12,Senate,"Senate Rules Committee Vote",20,0,0,1,21
1940816,1590845,2025-06-13,Senate,"Senate Floor Vote - Final Passage",58,1,0,4,63
1940870,1572157,2025-02-11,Senate,"Senate Energy And Telecommunications Committee Vote",8,1,0,0,9
1940870,1572158,2025-05-14,Senate,"Senate Floor Vote - Final Passage",54,3,0,5,62
1940895,1573649,2025-05-13,Senate,"Senate Health Committee Vote",8,5,0,1,14
1940895,1573650,2025-05-19,Senate,"Senate Floor Vote - Final Passage",37,19,0,6,62
1940895,1589349,2025-06-11,Senate,"Senate Floor Vote - Final Passage",39,20,0,4,63
1940895,1592261,2025-06-17,Assembly,"Assembly Floor Vote - Final Passage",138,3,0,9,150
1941017,1585764,2025-05-29,Senate,"Senate Rules Committee Vote",20,0,0,1,21
1941017,1585765,2025-06-05,Senate,"Senate Floor Vote - Final Passage",59,1,0,3,63
1941041,1536297,2025-03-18,Senate,"Senate Transportation Committee Vote",13,0,0,0,13
1941041,1536298,2025-04-03,Senate,"Senate Floor Vote - Final Passage",60,0,0,3,63
1941164,1574849,2025-05-20,Senate,"Senate Health Committee Vote",10,3,0,1,14
1941164,1590180,2025-06-12,Senate,"Senate Rules Committee Vote",17,3,0,1,21
1941164,1592065,2025-06-13,Senate,"Senate Floor Vote - Final Passage",50,9,0,4,63
1941419,1580882,2025-05-28,Senate,"Senate Budget And Revenue Committee Vote",7,0,0,0,7
1941419,1591660,2025-06-12,Senate,"Senate Floor Vote - Final Passage",49,10,0,4,63
1941419,1595908,2025-06-12,Senate,"Senate Rules Committee Vote",18,2,0,1,21
1941503,1504209,2025-03-04,Senate,"Senate Education Committee Vote",15,0,0,0,15
1941503,1581474,2025-05-29,Senate,"Senate Rules Committee Vote",20,0,0,1,21
1941503,1584987,2025-06-04,Senate,"Senate Floor Vote - Final Passage",58,0,0,5,63
1941560,1581987,2025-05-29,Senate,"Senate Energy And Telecommunications Committee Vote",7,2,0,0,9
1941576,1588129,2025-05-28,Senate,"Senate Veterans, Homeland Security And Military Affairs Committee Vote",9,0,0,0,9
1941576,1588130,2025-06-10,Senate,"Senate Floor Vote - Final Passage",58,0,0,5,63
1941576,1592651,2025-06-17,Assembly,"Assembly Floor Vote - Final Passage",141,0,0,9,150
1941877,1486466,2025-02-11,Assembly,"Assembly Environmental Conservation Committee: Favorable refer to committee Ways and Means",28,0,0,2,30
1941877,1589858,2025-06-12,Assembly,"Assembly Ways And Means Committee: Favorable refer to committee Rules",34,0,0,1,35
1941877,1590786,2025-06-13,Assembly,"Assembly Rules Committee: Favorable",29,0,0,2,31
1941879,1497820,2025-02-24,Assembly,"Assembly Insurance Committee: Favorable",20,2,0,3,25
1941879,1522605,2025-03-19,Assembly,"Assembly Floor Vote - Final Passage",146,2,0,2,150
1941879,1588277,2025-06-10,Senate,"Senate Floor Vote - Final Passage",56,2,0,5,63
1941881,1534472,2025-04-02,Assembly,"Assembly Real Property Taxation Committee: Held for Consideration",7,3,0,0,10
1941886,1497714,2025-02-24,Assembly,"Assembly Health Committee: Favorable",24,0,0,2,26
1941886,1570545,2025-05-12,Assembly,"Assembly Floor Vote - Final Passage",143,0,0,7,150
1941886,1575392,2025-05-21,Senate,"Senate Floor Vote - Final Passage",59,0,0,3,62
1941894,1572316,2025-05-13,Senate,"Senate Health Committee Vote",13,0,0,1,14
1941894,1580927,2025-05-28,Senate,"Senate Finance Committee Vote",22,0,0,0,22
1941894,1590509,2025-06-12,Senate,"Senate Floor Vote - Final Passage",58,1,0,4,63
1941899,1572821,2025-02-25,Senate,"Senate Local Government Committee Vote",7,0,0,0,7
1941899,1572822,2025-05-15,Senate,"Senate Floor Vote - Final Passage",52,0,0,10,62
1941899,1576265,2025-05-21,Assembly,"Assembly Floor Vote - Final Passage",144,0,0,6,150
1941904,1573738,2025-05-19,Assembly,"Assembly Health Committee: Favorable refer to committee Rules",20,4,0,2,26
1941920,1581042,2025-05-29,Assembly,"Assembly Science And Technology Committee: Favorable refer to committee Codes",9,0,0,0,9
1941920,1585406,2025-06-05,Assembly,"Assembly Codes Committee: Favorable refer to committee Rules",21,0,0,1,22
1941920,1588498,2025-06-11,Assembly,"Assembly Rules Committee: Favorable",28,0,0,3,31
1941923,1527656,2025-03-18,Senate,"Senate Procurement And Contracts Committee Vote",7,0,0,0,7
1941923,1527657,2025-03-26,Senate,"Senate Floor Vote - Final Passage",61,0,0,2,63
1941946,1574828,2025-05-20,Senate,"Senate Labor Committee Vote",13,0,0,0,13
1941955,1519550,2025-03-18,Assembly,"Assembly Judiciary Committee: Favorable",15,6,0,0,21
1941961,1562277,2025-04-30,Assembly,"Assembly Banks Committee: Favorable refer to committee Ways and Means",28,0,0,3,31
1941961,1574345,2025-05-20,Assembly,"Assembly Ways And Means Committee: Favorable refer to committee Rules",35,0,0,0,35
1941961,1574870,2025-05-21,Assembly,"Assembly Rules Committee: Favorable",29,0,0,2,31
1941961,1580913,2025-05-28,Assembly,"Assembly Floor Vote - Final Passage",139,5,0,6,150
1941961,1584942,2025-06-04,Senate,"Senate Floor Vote - Final Passage",58,0,0,5,63
1941967,1579151,2025-05-27,Assembly,"Assembly Consumer Affairs And Protection Committee: Favorable refer to committee Codes",10,5,0,1,16
1941967,1585576,2025-06-05,Assembly,"Assembly Codes Committee: Favorable refer to committee Rules",15,6,0,1,22
1941967,1587323,2025-06-10,Assembly,"Assembly Rules Committee: Favorable",19,9,0,3,31
1941984,1485944,2025-02-11,Assembly,"Assembly Environmental Conservation Committee: Favorable refer to committee Ways and Means",28,0,0,2,30
1941984,1560336,2025-04-29,Assembly,"Assembly Ways And Means Committee: Favorable refer to committee Rules",32,0,0,3,35
1941984,1561800,2025-04-30,Assembly,"Assembly Rules Committee: Favorable",29,0,0,2,31
1941987,1565579,2025-05-06,Assembly,"Assembly Science And Technology Committee: Favorable",9,0,0,0,9
1941987,1570095,2025-05-12,Assembly,"Assembly Floor Vote - Final Passage",142,0,0,8,150
1942007,1534409,2025-04-02,Assembly,"Assembly Codes Committee: Held for Consideration",14,6,0,2,22
1942027,1570406,2025-05-13,Assembly,"Assembly Insurance Committee: Favorable",24,0,0,1,25
1942027,1580001,2025-05-27,Assembly,"Assembly Floor Vote - Final Passage",145,0,0,5,150
1942027,1589406,2025-06-11,Senate,"Senate Floor Vote - Final Passage",59,0,0,4,63
1942028,1586185,2025-05-20,Senate,"Senate Health Committee Vote",9,4,0,1,14
1942028,1586186,2025-06-06,Senate,"Senate Floor Vote - Final Passage",34,19,0,10,63
1942041,1579740,2025-05-28,Assembly,"Assembly Transportation Committee: Held for Consideration",16,7,0,3,26
1942051,1591586,2025-06-17,Assembly,"Assembly Rules Committee: Favorable",21,9,0,1,31
1942051,1591587,2025-06-17,Assembly,"Assembly Ways And Means Committee: Favorable refer to committee Rules",22,10,0,3,35
1942058,1487514,2025-02-12,Senate,"Senate Health Committee Vote",15,0,0,0,15
1942059,1499228,2025-02-10,Senate,"Senate Transportation Committee Vote",13,0,0,0,13
1942059,1499229,2025-02-25,Senate,"Senate Floor Vote - Final Passage",61,0,0,2,63
1942059,1590279,2025-06-12,Senate,"Senate Floor Vote - Final Passage",59,0,0,4,63
1942059,1592609,2025-06-16,Assembly,"Assembly Floor Vote - Final Passage",145,0,0,5,150
1942102,1486042,2025-02-11,Assembly,"Assembly Codes Committee: Favorable refer to committee Ways and Means",22,0,0,0,22
1942112,1584684,2025-06-04,Assembly,"Assembly Transportation Committee: Favorable refer to committee Ways and Means",22,0,0,4,26
1942134,1539543,2025-04-08,Senate,"Senate Civil Service And Pensions Committee Vote",7,0,0,0,7
1942137,1526182,2025-03-25,Assembly,"Assembly Election Law Committee: Favorable refer to committee Codes",9,5,0,2,16
1942137,1534467,2025-04-02,Assembly,"Assembly Codes Committee: Favorable",20,0,0,2,22
1942138,1570108,2025-05-13,Assembly,"Assembly Economic Development Committee: Favorable refer to committee Codes",22,4,0,0,26
1942138,1574341,2025-05-20,Assembly,"Assembly Codes Committee: Favorable refer to committee Rules",20,0,0,2,22
1942138,1574867,2025-05-21,Assembly,"Assembly Rules Committee: Favorable",29,0,0,2,31
1942138,1575811,2025-05-21,Assembly,"Assembly Floor Vote - Final Passage",144,0,0,6,150
1942138,1587848,2025-06-10,Senate,"Senate Floor Vote - Final Passage",57,1,0,5,63
1942152,1565625,2025-05-06,Assembly,"Assembly Consumer Affairs And Protection Committee: Favorable",11,5,0,0,16
1942154,1574358,2025-05-20,Assembly,"Assembly Codes Committee: Favorable refer to committee Rules",20,0,0,2,22
1942155,1573371,2025-05-19,Assembly,"Assembly Consumer Affairs And Protection Committee: Favorable refer to committee Codes",15,0,0,1,16
1942155,1585566,2025-06-05,Assembly,"Assembly Codes Committee: Favorable refer to committee Rules",21,0,0,1,22
1942155,1590054,2025-06-12,Assembly,"Assembly Rules Committee: Favorable",29,0,0,2,31
1942155,1591180,2025-06-13,Assembly,"Assembly Floor Vote - Final Passage",137,0,0,13,150
1942165,1586195,2025-05-13,Senate,"Senate Health Committee Vote",11,2,0,1,14
1942165,1586196,2025-06-06,Senate,"Senate Floor Vote - Final Passage",37,16,0,10,63
1942176,1566507,2025-05-06,Assembly,"Assembly Governmental Operations Committee: Favorable refer to committee Ways and Means",14,0,0,0,14
1942176,1580952,2025-05-29,Assembly,"Assembly Ways And Means Committee: Favorable refer to committee Rules",34,0,0,1,35
1942176,1585919,2025-06-06,Assembly,"Assembly Rules Committee: Favorable",27,0,0,4,31
1942176,1586552,2025-06-06,Assembly,"Assembly Floor Vote - Final Passage",143,0,0,7,150
1942176,1588014,2025-06-10,Senate,"Senate Floor Vote - Final Passage",58,0,0,5,63
1942178,1487308,2025-02-11,Senate,"Senate Budget And Revenue Committee Vote",5,2,0,0,7
1942178,1574562,2025-05-20,Senate,"Senate Finance Committee Vote",15,7,0,0,22
1942178,1585797,2025-06-05,Senate,"Senate Floor Vote - Final Passage",39,21,0,3,63
1942212,1520591,2025-03-03,Senate,"Senate Insurance Committee Vote",11,0,0,0,11
1942212,1520592,2025-03-18,Senate,"Senate Floor Vote - Final Passage",61,0,0,2,63
1942218,1586119,2025-05-20,Senate,"Senate Health Committee Vote",13,0,0,1,14
1942218,1586120,2025-06-06,Senate,"Senate Floor Vote - Final Passage",53,0,0,10,63
1942218,1588604,2025-06-10,Assembly,"Assembly Floor Vote - Final Passage",147,0,0,3,150
1942219,1591589,2025-06-17,Assembly,"Assembly Ways And Means Committee: Favorable refer to committee Rules",32,0,0,3,35
1942219,1591940,2025-06-17,Assembly,"Assembly Rules Committee: Favorable",28,0,0,3,31
1942233,1593405,2025-06-16,Assembly,"Assembly Rules Committee: Favorable",29,0,0,2,31
1942233,1593406,2025-06-16,Assembly,"Assembly Ways And Means Committee: Favorable refer to committee Rules",32,0,0,3,35
1942240,1580329,2025-05-28,Assembly,"Assembly Governmental Employees Committee: Favorable refer to committee Codes",10,4,0,0,14
1942240,1585555,2025-06-05,Assembly,"Assembly Codes Committee: Favorable refer to committee Rules",15,6,0,1,22
1942240,1586037,2025-06-06,Assembly,"Assembly Rules Committee: Favorable",26,1,0,4,31
1942252,1590006,2025-04-08,Senate,"Senate Health Committee Vote",14,0,0,1,15
1942252,1590736,2025-06-12,Senate,"Senate Floor Vote - Final Passage",58,1,0,4,63
1942260,1584667,2025-06-04,Assembly,"Assembly Judiciary Committee: Favorable refer to committee Rules",19,0,0,2,21
1942260,1588552,2025-06-11,Assembly,"Assembly Rules Committee: Favorable",28,0,0,3,31
1942260,1589713,2025-06-11,Assembly,"Assembly Floor Vote - Final Passage",146,0,0,4,150
1942260,1589714,2025-06-11,Senate,"Senate Floor Vote - Final Passage",58,1,0,4,63
1942284,1534245,2025-04-02,Assembly,"Assembly Codes Committee: Held for Consideration",14,6,0,2,22
1942292,1497716,2025-02-24,Assembly,"Assembly Higher Education Committee: Favorable",24,0,0,2,26
1942292,1504696,2025-03-03,Assembly,"Assembly Floor Vote - Final Passage",147,0,0,3,150
1942292,1585761,2025-06-04,Senate,"Senate Floor Vote - Final Passage",58,0,0,5,63
1942295,1512663,2025-03-11,Assembly,"Assembly Codes Committee: Favorable",16,6,0,0,22
1942297,1573275,2025-05-19,Assembly,"Assembly Veterans' Affairs Committee: Favorable refer to committee Rules",18,0,0,1,19
1942358,1593403,2025-06-16,Assembly,"Assembly Rules Committee: Favorable",29,0,0,2,31
1942358,1593404,2025-06-16,Assembly,"Assembly Ways And Means Committee: Favorable refer to committee Rules",32,0,0,3,35
1942377,1505612,2025-03-04,Senate,"Senate Higher Education Committee Vote",11,0,0,0,11
1942377,1580839,2025-05-28,Senate,"Senate Finance Committee Vote",22,0,0,0,22
1942377,1585573,2025-06-05,Senate,"Senate Floor Vote - Final Passage",59,1,0,3,63
1942377,1592163,2025-06-16,Assembly,"Assembly Floor Vote - Final Passage",145,0,0,5,150
1942390,1520097,2025-02-03,Senate,"Senate Housing, Construction And Community Development Committee Vote",10,1,0,0,11
1942390,1520098,2025-03-17,Senate,"Senate Floor Vote - Final Passage",50,11,0,2,63
1942405,1590077,2025-05-28,Senate,"Senate Judiciary Committee Vote",17,0,0,2,19
1942405,1590533,2025-06-13,Senate,"Senate Floor Vote - Final Passage",59,0,0,4,63
1942417,1580415,2025-05-28,Assembly,"Assembly Banks Committee: Favorable refer to committee Rules",28,0,0,3,31
1942417,1587015,2025-06-09,Assembly,"Assembly Rules Committee: Favorable",25,0,0,6,31
1942461,1588863,2025-05-14,Senate,"Senate Labor Committee Vote",12,1,0,0,13
1942461,1589265,2025-06-11,Senate,"Senate Floor Vote - Final Passage",38,21,0,4,63
1942463,1589963,2025-03-11,Senate,"Senate Judiciary Committee Vote",19,0,0,0,19
1942463,1590498,2025-06-12,Senate,"Senate Floor Vote - Final Passage",59,0,0,4,63
1942491,1486435,2025-02-11,Assembly,"Assembly Judiciary Committee: Favorable refer to committee Ways and Means",18,0,0,3,21
1942509,1574605,2025-05-20,Senate,"Senate Cities 1 Committee Vote",7,0,0,0,7
1942558,1586109,2025-05-20,Senate,"Senate Local Government Committee Vote",7,0,0,0,7
1942558,1586110,2025-06-06,Senate,"Senate Floor Vote - Final Passage",51,2,0,10,63
1942569,1580856,2025-05-28,Senate,"Senate Budget And Revenue Committee Vote",7,0,0,0,7
1942600,1573415,2025-05-19,Assembly,"Assembly Banks Committee: Favorable refer to committee Codes",17,10,0,4,31
1942616,1571934,2025-05-13,Senate,"Senate Health Committee Vote",13,0,0,1,14
1942619,1588210,2025-06-10,Senate,"Senate Floor Vote - Final Passage",58,0,0,5,63
1942619,1588211,2025-06-10,Senate,"Senate Rules Committee Vote",19,0,0,2,21
1942619,1591069,2025-06-13,Assembly,"Assembly Floor Vote - Final Passage",135,0,0,15,150
1942657,1534486,2025-04-02,Senate,"Senate Environmental Conservation Committee Vote",11,0,0,0,11
1942687,1572254,2025-05-13,Senate,"Senate Health Committee Vote",13,0,0,1,14
1942687,1581807,2025-05-29,Senate,"Senate Rules Committee Vote",19,1,0,1,21
1942687,1585739,2025-06-05,Senate,"Senate Floor Vote - Final Passage",57,3,0,3,63
1942687,1591086,2025-06-13,Assembly,"Assembly Floor Vote - Final Passage",135,2,0,13,150
1942713,1585543,2025-05-29,Senate,"Senate Rules Committee Vote",20,0,0,1,21
1942713,1585544,2025-06-05,Senate,"Senate Floor Vote - Final Passage",60,0,0,3,63
1942713,1591231,2025-06-13,Assembly,"Assembly Floor Vote - Final Passage",135,0,0,15,150
1942717,1586176,2025-05-13,Senate,"Senate Health Committee Vote",8,5,0,1,14
1942717,1586177,2025-06-06,Senate,"Senate Floor Vote - Final Passage",34,19,0,10,63
1942717,1589792,2025-06-11,Assembly,"Assembly Floor Vote - Final Passage",94,51,0,5,150
1942724,1571335,2025-05-14,Senate,"Senate Labor Committee Vote",12,1,0,0,13
1942736,1570107,2025-05-13,Assembly,"Assembly Judiciary Committee: Favorable refer to committee Codes",20,0,0,1,21
1942736,1574396,2025-05-20,Assembly,"Assembly Codes Committee: Favorable refer to committee Rules",20,0,0,2,22
1942736,1574892,2025-05-21,Assembly,"Assembly Rules Committee: Favorable",29,0,0,2,31
1942736,1575841,2025-05-21,Assembly,"Assembly Floor Vote - Final Passage",144,0,0,6,150
1942736,1586143,2025-06-06,Senate,"Senate Floor Vote - Final Passage",53,0,0,10,63
1942741,1500401,2025-02-12,Senate,"Senate Health Committee Vote",15,0,0,0,15
1942741,1500402,2025-02-26,Senate,"Senate Floor Vote - Final Passage",60,1,0,2,63
1942741,1590357,2025-06-12,Senate,"Senate Floor Vote - Final Passage",57,2,0,4,63
1942741,1592329,2025-06-16,Assembly,"Assembly Floor Vote - Final Passage",144,0,0,6,150
1942753,1532051,2025-04-01,Assembly,"Assembly Rules Committee: Favorable",30,0,0,1,31
1942753,1532052,2025-04-01,Assembly,"Assembly Ways And Means Committee: Favorable refer to committee Rules",31,2,0,2,35
1942753,1535718,2025-04-02,Assembly,"Assembly Floor Vote - Final Passage",108,40,0,2,150
1942753,1599253,2025-05-27,Senate,"Senate Floor Vote - Final Passage",50,9,0,4,63
1942794,1517604,2025-03-12,Senate,"Senate Budget And Revenue Committee Vote",5,1,0,1,7
1942816,1526168,2025-03-04,Senate,"Senate Finance Committee Vote",21,0,0,1,22
1942816,1526169,2025-03-25,Senate,"Senate Floor Vote - Final Passage",62,0,0,1,63
1942843,1588099,2025-06-10,Senate,"Senate Floor Vote - Final Passage",58,0,0,5,63
1942843,1588100,2025-06-10,Senate,"Senate Rules Committee Vote",19,0,0,2,21
1943526,1588220,2025-06-10,Senate,"Senate Floor Vote - Final Passage",58,0,0,5,63
1943526,1588221,2025-06-10,Senate,"Senate Rules Committee Vote",19,0,0,2,21
1943526,1592255,2025-06-18,Assembly,"Assembly Floor Vote - Final Passage",134,0,0,16,150
1943528,1590365,2025-06-12,Senate,"Senate Floor Vote - Final Passage",42,17,0,4,63
1943533,1574885,2025-05-20,Senate,"Senate Civil Service And Pensions Committee Vote",7,0,0,0,7
1943533,1589236,2025-06-11,Senate,"Senate Floor Vote - Final Passage",59,0,0,4,63
1943533,1589237,2025-06-11,Senate,"Senate Rules Committee Vote",20,0,0,1,21
1943533,1592406,2025-06-18,Assembly,"Assembly Floor Vote - Final Passage",133,1,0,16,150
1943569,1579512,2025-04-29,Senate,"Senate Investigations And Government Operations Committee Vote",7,0,0,0,7
1943569,1586174,2025-05-27,Senate,"Senate Floor Vote - Final Passage",51,8,0,4,63
1943569,1586853,2025-06-06,Assembly,"Assembly Floor Vote - Final Passage",103,40,0,7,150
1943600,1563324,2025-04-29,Senate,"Senate Health Committee Vote",12,2,0,0,14
1943611,1578816,2025-04-29,Senate,"Senate Investigations And Government Operations Committee Vote",7,0,0,0,7
1943611,1591942,2025-05-27,Senate,"Senate Floor Vote - Final Passage",51,8,0,4,63
1943611,1592262,2025-06-17,Assembly,"Assembly Floor Vote - Final Passage",106,28,0,16,150
1943629,1571001,2025-04-09,Senate,"Senate Codes Committee Vote",12,0,0,1,13
1943629,1571002,2025-05-13,Senate,"Senate Floor Vote - Final Passage",57,0,0,5,62
1943632,1575780,2025-05-22,Senate,"Senate Alcoholism And Substance Use Disorders Committee Vote",7,0,0,0,7
1943643,1579525,2025-04-29,Senate,"Senate Investigations And Government Operations Committee Vote",7,0,0,0,7
1943643,1591740,2025-05-27,Senate,"Senate Floor Vote - Final Passage",51,8,0,4,63
1943643,1592440,2025-06-17,Assembly,"Assembly Floor Vote - Final Passage",113,28,0,9,150
1943721,1579427,2025-04-29,Senate,"Senate Investigations And Government Operations Committee Vote",7,0,0,0,7
1943721,1581008,2025-05-27,Senate,"Senate Floor Vote - Final Passage",51,8,0,4,63
1943721,1582067,2025-05-29,Assembly,"Assembly Floor Vote - Final Passage",107,39,0,4,150
1943752,1578808,2025-04-29,Senate,"Senate Investigations And Government Operations Committee Vote",7,0,0,0,7
1943752,1584875,2025-05-27,Senate,"Senate Floor Vote - Final Passage",51,8,0,4,63
1943752,1585383,2025-06-04,Assembly,"Assembly Floor Vote - Final Passage",105,39,0,6,150
1943771,1578863,2025-04-29,Senate,"Senate Investigations And Government Operations Committee Vote",7,0,0,0,7
1943771,1591118,2025-05-27,Senate,"Senate Floor Vote - Final Passage",51,8,0,4,63
1943771,1592326,2025-06-16,Assembly,"Assembly Floor Vote - Final Passage",117,28,0,5,150
1943783,1579325,2025-04-29,Senate,"Senate Investigations And Government Operations Committee Vote",7,0,0,0,7
1943783,1590226,2025-05-27,Senate,"Senate Floor Vote - Final Passage",51,8,0,4,63
1943783,1591177,2025-06-13,Assembly,"Assembly Floor Vote - Final Passage",112,25,0,13,150
1943819,1560190,2025-04-29,Senate,"Senate Aging Committee Vote",6,0,0,0,6
1943846,1586079,2025-06-06,Assembly,"Assembly Ways And Means Committee: Held for Consideration",25,10,0,0,35
1943959,1580016,2025-05-28,Assembly,"Assembly Governmental Employees Committee: Held for Consideration",8,6,0,0,14
1943974,1526450,2025-03-25,Assembly,"Assembly People With Disabilities Committee: Favorable refer to committee Ways and Means",9,0,0,0,9
1943985,1520188,2025-03-11,Senate,"Senate Consumer Protection Committee Vote",7,0,0,0,7
1943985,1520189,2025-03-18,Senate,"Senate Floor Vote - Final Passage",61,0,0,2,63
1943993,1542097,2025-04-08,Senate,"Senate Health Committee Vote",14,0,0,1,15
1944009,1580281,2025-05-28,Assembly,"Assembly Environmental Conservation Committee: Favorable refer to committee Ways and Means",20,9,0,1,30
1944040,1559671,2025-04-29,Senate,"Senate Social Services Committee Vote",4,2,0,0,6
1944051,1589954,2025-04-08,Senate,"Senate Health Committee Vote",12,2,0,1,15
1944051,1590700,2025-06-12,Senate,"Senate Floor Vote - Final Passage",53,6,0,4,63
1944058,1534683,2025-03-12,Senate,"Senate Commerce, Economic Development And Small Business Committee Vote",9,0,0,0,9
1944058,1534684,2025-04-02,Senate,"Senate Floor Vote - Final Passage",60,2,0,1,63
1944072,1528175,2025-03-12,Senate,"Senate Women's Issues Committee Vote",7,0,0,0,7
1944072,1528176,2025-03-26,Senate,"Senate Floor Vote - Final Passage",61,0,0,2,63
1944108,1571690,2025-05-14,Senate,"Senate Agriculture Committee Vote",8,0,0,1,9
1944130,1514515,2025-03-12,Senate,"Senate Women's Issues Committee Vote",7,0,0,0,7
1944144,1486427,2025-02-11,Assembly,"Assembly Agriculture Committee: Favorable refer to committee Ways and Means",23,0,0,0,23
1944144,1591417,2025-06-16,Assembly,"Assembly Rules Committee: Favorable",29,0,0,2,31
1944144,1591418,2025-06-16,Assembly,"Assembly Ways And Means Committee: Favorable refer to committee Rules",32,0,0,3,35
1944152,1486462,2025-02-11,Assembly,"Assembly Governmental Employees Committee: Favorable refer to committee Ways and Means",14,0,0,0,14
1944152,1580926,2025-05-29,Assembly,"Assembly Ways And Means Committee: Favorable refer to committee Rules",34,0,0,1,35
1944152,1585191,2025-06-04,Assembly,"Assembly Rules Committee: Favorable",28,0,0,3,31
1944152,1585372,2025-06-04,Assembly,"Assembly Floor Vote - Final Passage",144,0,0,6,150
1944154,1487345,2025-02-11,Senate,"Senate Civil Service And Pensions Committee Vote",7,0,0,0,7
1944155,1590668,2025-06-13,Assembly,"Assembly Ways And Means Committee: Favorable refer to committee Rules",32,0,0,3,35
1944155,1591419,2025-06-16,Assembly,"Assembly Rules Committee: Favorable",29,0,0,2,31
1944182,1588222,2025-04-29,Senate,"Senate Health Committee Vote",14,0,0,0,14
1944182,1588223,2025-06-10,Senate,"Senate Floor Vote - Final Passage",58,0,0,5,63
1944208,1579149,2025-05-27,Assembly,"Assembly Governmental Operations Committee: Favorable refer to committee Rules",10,4,0,0,14
1944208,1581516,2025-05-29,Assembly,"Assembly Rules Committee: Favorable",18,9,0,4,31
1944208,1585780,2025-06-05,Senate,"Senate Floor Vote - Final Passage",38,22,0,3,63
1944208,1585897,2025-06-05,Assembly,"Assembly Floor Vote - Final Passage",84,61,0,5,150
1944259,1579134,2025-05-27,Assembly,"Assembly Education Committee: Favorable refer to committee Ways and Means",28,0,0,3,31
1944259,1593626,2025-06-16,Assembly,"Assembly Rules Committee: Favorable",29,0,0,2,31
1944259,1593627,2025-06-16,Assembly,"Assembly Ways And Means Committee: Favorable refer to committee Rules",32,0,0,3,35
1944269,1526082,2025-03-04,Senate,"Senate Disabilities Committee Vote",7,0,0,0,7
1944269,1527130,2025-03-25,Senate,"Senate Floor Vote - Final Passage",62,0,0,1,63
1944308,1479484,2025-02-04,Assembly,"Assembly Codes Committee: Favorable refer to committee Ways and Means",14,6,0,2,22
1944387,1589409,2025-04-29,Senate,"Senate Finance Committee Vote",16,6,0,0,22
1944387,1589410,2025-06-11,Senate,"Senate Floor Vote - Final Passage",39,20,0,4,63
1944391,1591616,2025-06-17,Assembly,"Assembly Rules Committee: Favorable",30,0,0,1,31
1944391,1591617,2025-06-17,Assembly,"Assembly Ways And Means Committee: Favorable refer to committee Rules",32,0,0,3,35
1944397,1564861,2025-05-05,Senate,"Senate Internet And Technology Committee Vote",3,4,0,0,7
1944438,1570945,2025-05-13,Senate,"Senate Aging Committee Vote",6,0,0,0,6
1944463,1574052,2025-04-29,Senate,"Senate Finance Committee Vote",21,1,0,0,22
1944463,1574607,2025-05-20,Senate,"Senate Floor Vote - Final Passage",58,3,0,1,62
1944476,1580446,2025-05-28,Senate,"Senate Elections Committee Vote",6,1,0,0,7
1944479,1586665,2025-06-09,Assembly,"Assembly Ways And Means Committee: Favorable refer to committee Rules",31,0,0,4,35
1944479,1588141,2025-06-10,Assembly,"Assembly Rules Committee: Favorable",19,9,0,3,31
1944504,1534385,2025-02-11,Senate,"Senate Racing, Gaming And Wagering Committee Vote",7,0,0,0,7
1944504,1534386,2025-04-02,Senate,"Senate Floor Vote - Final Passage",57,5,0,1,63
1944504,1541271,2025-04-08,Assembly,"Assembly Floor Vote - Final Passage",145,2,0,3,150
1944513,1537019,2025-03-04,Senate,"Senate Aging Committee Vote",7,0,0,0,7
1944513,1537020,2025-04-03,Senate,"Senate Floor Vote - Final Passage",59,1,0,3,63
1944546,1526624,2025-03-03,Senate,"Senate Housing, Construction And Community Development Committee Vote",9,2,0,0,11
1944546,1526625,2025-03-25,Senate,"Senate Floor Vote - Final Passage",40,22,0,1,63
1945486,1560598,2025-04-29,Senate,"Senate Civil Service And Pensions Committee Vote",7,0,0,0,7
1945505,1581990,2025-05-29,Senate,"Senate Energy And Telecommunications Committee Vote",6,3,0,0,9
1945514,1582084,2025-02-11,Senate,"Senate Judiciary Committee Vote",15,4,0,0,19
1945514,1582085,2025-05-29,Senate,"Senate Floor Vote - Final Passage",41,15,0,7,63
1945571,1480079,2025-02-04,Assembly,"Assembly Aging Committee: Favorable refer to committee Ways and Means",30,0,0,0,30
1945572,1479780,2025-02-04,Assembly,"Assembly Aging Committee: Favorable refer to committee Ways and Means",30,0,0,0,30
1945598,1585413,2025-06-05,Assembly,"Assembly Cities Committee: Favorable refer to committee Rules",15,0,0,1,16
1945598,1585980,2025-06-06,Assembly,"Assembly Rules Committee: Favorable",27,0,0,4,31
1945598,1589032,2025-06-10,Assembly,"Assembly Floor Vote - Final Passage",89,56,0,5,150
1945598,1590699,2025-06-12,Senate,"Senate Floor Vote - Final Passage",35,24,0,4,63
1945612,1580903,2025-05-29,Assembly,"Assembly Ways And Means Committee: Favorable refer to committee Rules",32,2,0,1,35
1945612,1585924,2025-06-06,Assembly,"Assembly Rules Committee: Favorable",27,0,0,4,31
1945616,1587006,2025-05-21,Senate,"Senate Mental Health Committee Vote",7,0,0,0,7
1945616,1587007,2025-06-09,Senate,"Senate Floor Vote - Final Passage",62,0,0,1,63
1945702,1588514,2025-06-11,Assembly,"Assembly Ways And Means Committee: Favorable refer to committee Rules",34,0,0,1,35
1945702,1590026,2025-06-12,Assembly,"Assembly Rules Committee: Favorable",29,0,0,2,31
1945715,1526306,2025-02-26,Senate,"Senate Alcoholism And Substance Use Disorders Committee Vote",7,0,0,0,7
1945715,1526307,2025-03-25,Senate,"Senate Floor Vote - Final Passage",62,0,0,1,63
1945724,1564872,2025-05-05,Senate,"Senate Insurance Committee Vote",11,0,0,0,11
1945724,1588190,2025-06-10,Senate,"Senate Floor Vote - Final Passage",57,1,0,5,63
1945724,1588191,2025-06-10,Senate,"Senate Rules Committee Vote",19,0,0,2,21
1945739,1570447,2025-05-13,Assembly,"Assembly Judiciary Committee: Favorable refer to committee Ways and Means",14,6,0,1,21
1945739,1579353,2025-05-27,Assembly,"Assembly Ways And Means Committee: Favorable refer to committee Rules",27,5,0,3,35
1945739,1581540,2025-05-29,Assembly,"Assembly Rules Committee: Favorable",18,9,0,4,31
1945787,1534164,2025-04-02,Assembly,"Assembly Election Law Committee: Favorable refer to committee Ways and Means",16,0,0,0,16
1945787,1574672,2025-05-20,Assembly,"Assembly Ways And Means Committee: Favorable refer to committee Rules",35,0,0,0,35
1945787,1579378,2025-05-27,Assembly,"Assembly Rules Committee: Favorable",26,0,0,5,31
1945795,1540183,2025-02-25,Senate,"Senate Environmental Conservation Committee Vote",10,1,0,0,11
1945795,1540184,2025-04-08,Senate,"Senate Floor Vote - Final Passage",52,10,0,1,63
1945803,1573345,2025-05-19,Assembly,"Assembly Governmental Employees Committee: Held for Consideration",8,5,0,1,14
1945826,1573837,2025-05-20,Assembly,"Assembly Agriculture Committee: Held for Consideration",16,7,0,0,23
1945827,1501266,2025-02-25,Senate,"Senate Banks Committee Vote",7,0,0,0,7
1945843,1579115,2025-04-29,Senate,"Senate Investigations And Government Operations Committee Vote",7,0,0,0,7
1945843,1592021,2025-05-27,Senate,"Senate Floor Vote - Final Passage",51,8,0,4,63
1945843,1592629,2025-06-17,Assembly,"Assembly Floor Vote - Final Passage",105,30,0,15,150
1945896,1565618,2025-04-29,Senate,"Senate Local Government Committee Vote",7,0,0,0,7
1945896,1565619,2025-05-06,Senate,"Senate Floor Vote - Final Passage",61,0,0,1,62
1945918,1505707,2025-03-05,Senate,"Senate Mental Health Committee Vote",7,0,0,0,7
1945949,1574287,2025-05-20,Assembly,"Assembly Agriculture Committee: Held for Consideration",16,7,0,0,23
1945977,1578802,2025-04-29,Senate,"Senate Investigations And Government Operations Committee Vote",7,0,0,0,7
1945977,1590274,2025-05-27,Senate,"Senate Floor Vote - Final Passage",51,8,0,4,63
1945977,1591053,2025-06-13,Assembly,"Assembly Floor Vote - Final Passage",111,26,0,13,150
1946025,1590165,2025-02-25,Senate,"Senate Energy And Telecommunications Committee Vote",7,2,0,0,9
1946025,1590485,2025-06-12,Senate,"Senate Floor Vote - Final Passage",45,14,0,4,63
1946069,1539309,2025-04-07,Senate,"Senate Judiciary Committee Vote",19,0,0,0,19
1946075,1580875,2025-05-28,Senate,"Senate Budget And Revenue Committee Vote",7,0,0,0,7
1946097,1503438,2025-02-24,Senate,"Senate Codes Committee Vote",11,2,0,0,13
1946097,1503439,2025-03-03,Senate,"Senate Floor Vote - Final Passage",59,2,0,2,63
1946169,1581950,2025-04-29,Senate,"Senate Aging Committee Vote",6,0,0,0,6
1946169,1581951,2025-05-29,Senate,"Senate Floor Vote - Final Passage",56,0,0,7,63
1946224,1541296,2025-02-11,Senate,"Senate Education Committee Vote",15,0,0,0,15
1946224,1541297,2025-04-08,Senate,"Senate Floor Vote - Final Passage",62,0,0,1,63
1946224,1563870,2025-04-30,Assembly,"Assembly Floor Vote - Final Passage",142,3,0,5,150
1946231,1535757,2025-02-11,Senate,"Senate Consumer Protection Committee Vote",7,0,0,0,7
1946231,1536522,2025-04-03,Senate,"Senate Floor Vote - Final Passage",42,18,0,3,63
1946232,1504949,2025-03-04,Senate,"Senate Aging Committee Vote",7,0,0,0,7
1946312,1572720,2025-05-13,Senate,"Senate Environmental Conservation Committee Vote",11,0,0,0,11
1946317,1486659,2025-02-03,Senate,"Senate Higher Education Committee Vote",11,0,0,0,11
1946317,1486660,2025-02-11,Senate,"Senate Floor Vote - Final Passage",61,0,0,2,63
1946344,1571831,2025-05-13,Senate,"Senate Health Committee Vote",13,0,0,1,14
1946371,1535173,2025-03-25,Senate,"Senate Corporations, Authorities And Commissions Committee Vote",7,0,0,0,7
1946371,1535174,2025-04-02,Senate,"Senate Floor Vote - Final Passage",62,0,0,1,63
1946410,1575849,2025-05-05,Senate,"Senate Internet And Technology Committee Vote",7,0,0,0,7
1946410,1575850,2025-05-22,Senate,"Senate Floor Vote - Final Passage",54,3,0,5,62
1946417,1543209,2025-03-11,Senate,"Senate Judiciary Committee Vote",16,3,0,0,19
1946417,1543210,2025-04-09,Senate,"Senate Floor Vote - Final Passage",37,23,0,3,63
1946417,1588403,2025-06-10,Senate,"Senate Floor Vote - Final Passage",38,20,0,5,63
1946435,1572121,2025-03-10,Senate,"Senate Housing, Construction And Community Development Committee Vote",9,2,0,0,11
1946435,1572122,2025-05-15,Senate,"Senate Floor Vote - Final Passage",34,18,0,10,62
1946450,1572099,2025-04-29,Senate,"Senate Ethics And Internal Governance Committee Vote",7,0,0,0,7
1946450,1572100,2025-05-15,Senate,"Senate Floor Vote - Final Passage",52,0,0,10,62
1946715,1486899,2025-02-11,Assembly,"Assembly Racing And Wagering Committee: Favorable",10,0,0,1,11
1946715,1501274,2025-02-26,Assembly,"Assembly Floor Vote - Final Passage",143,0,0,7,150
1947206,1485884,2025-02-11,Assembly,"Assembly Racing And Wagering Committee: Favorable refer to committee Ways and Means",10,0,0,1,11
1947242,1486601,2025-02-03,Senate,"Senate Higher Education Committee Vote",11,0,0,0,11
1947242,1486602,2025-02-11,Senate,"Senate Floor Vote - Final Passage",60,1,0,2,63
1947317,1486450,2025-02-11,Assembly,"Assembly Environmental Conservation Committee: Favorable",21,7,0,2,30
1947749,1527420,2025-03-25,Senate,"Senate Crime Victims, Crime And Correction Committee Vote",4,2,0,1,7
1947760,1572222,2025-04-08,Senate,"Senate Health Committee Vote",14,0,0,1,15
1947760,1572223,2025-05-15,Senate,"Senate Floor Vote - Final Passage",52,0,0,10,62
1947786,1580406,2025-05-28,Assembly,"Assembly Insurance Committee: Favorable refer to committee Codes",24,0,0,1,25
1947811,1581477,2025-05-28,Senate,"Senate Budget And Revenue Committee Vote",5,2,0,0,7
1947824,1576772,2025-04-29,Senate,"Senate Children And Families Committee Vote",7,0,0,0,7
1947824,1576773,2025-05-22,Senate,"Senate Floor Vote - Final Passage",57,0,0,5,62
1947824,1582029,2025-05-29,Assembly,"Assembly Floor Vote - Final Passage",146,0,0,4,150
1947843,1553759,2025-02-11,Senate,"Senate Environmental Conservation Committee Vote",11,0,0,0,11
1947843,1553760,2025-04-22,Senate,"Senate Floor Vote - Final Passage",53,0,0,9,62
1947872,1498799,2025-02-25,Assembly,"Assembly Real Property Taxation Committee: Favorable refer to committee Ways and Means",10,0,0,0,10
1947872,1586691,2025-06-09,Assembly,"Assembly Ways And Means Committee: Favorable refer to committee Rules",31,0,0,4,35
1947872,1587301,2025-06-10,Assembly,"Assembly Rules Committee: Favorable",28,0,0,3,31
1947912,1588275,2025-06-09,Senate,"Senate Rules Committee Vote",21,0,0,0,21
1947912,1588276,2025-06-10,Senate,"Senate Floor Vote - Final Passage",58,0,0,5,63
1947975,1587009,2025-06-09,Senate,"Senate Floor Vote - Final Passage",62,0,0,1,63
1947975,1587010,2025-06-09,Senate,"Senate Rules Committee Vote",21,0,0,0,21
1947977,1574202,2025-05-20,Assembly,"Assembly Insurance Committee: Favorable refer to committee Rules",25,0,0,0,25
1947977,1586854,2025-06-09,Assembly,"Assembly Rules Committee: Favorable",25,0,0,6,31
1947977,1590287,2025-06-12,Assembly,"Assembly Floor Vote - Final Passage",143,0,0,7,150
1947983,1574846,2025-05-20,Senate,"Senate Health Committee Vote",13,0,0,1,14
1947992,1584981,2025-02-11,Senate,"Senate Judiciary Committee Vote",18,1,0,0,19
1947992,1584982,2025-06-04,Senate,"Senate Floor Vote - Final Passage",55,3,0,5,63
1947992,1590367,2025-06-12,Senate,"Senate Floor Vote - Final Passage",56,3,0,4,63
1947992,1591221,2025-06-13,Assembly,"Assembly Floor Vote - Final Passage",124,13,0,13,150
1948006,1588779,2025-05-28,Senate,"Senate Investigations And Government Operations Committee Vote",7,0,0,0,7
1948006,1589244,2025-06-11,Senate,"Senate Floor Vote - Final Passage",59,0,0,4,63
1948035,1553262,2025-02-11,Senate,"Senate Environmental Conservation Committee Vote",11,0,0,0,11
1948035,1553263,2025-04-22,Senate,"Senate Floor Vote - Final Passage",52,1,0,9,62
1948076,1543012,2025-04-09,Senate,"Senate Floor Vote - Final Passage",60,0,0,3,63
1948076,1543013,2025-04-09,Senate,"Senate Rules Committee Vote",20,0,0,1,21
1948076,1591282,2025-06-13,Assembly,"Assembly Floor Vote - Final Passage",135,0,0,15,150
1948099,1584734,2025-03-03,Senate,"Senate Housing, Construction And Community Development Committee Vote",8,3,0,0,11
1948099,1584735,2025-06-04,Senate,"Senate Floor Vote - Final Passage",37,21,0,5,63
1948100,1573846,2025-05-19,Senate,"Senate Housing, Construction And Community Development Committee Vote",9,1,0,1,11
1948145,1579872,2025-05-28,Assembly,"Assembly Governmental Employees Committee: Favorable refer to committee Ways and Means",14,0,0,0,14
1948172,1541170,2025-04-08,Senate,"Senate Crime Victims, Crime And Correction Committee Vote",7,0,0,0,7
1948178,1539959,2025-02-11,Senate,"Senate Judiciary Committee Vote",15,4,0,0,19
1948178,1539960,2025-04-08,Senate,"Senate Floor Vote - Final Passage",45,17,0,1,63
1948181,1558261,2025-03-10,Senate,"Senate Codes Committee Vote",13,0,0,0,13
1948181,1558262,2025-04-24,Senate,"Senate Floor Vote - Final Passage",51,0,0,11,62
1948189,1590228,2025-06-12,Senate,"Senate Rules Committee Vote",19,1,0,1,21
1948189,1590698,2025-06-13,Senate,"Senate Floor Vote - Final Passage",59,0,0,4,63
1948192,1515894,2025-03-12,Senate,"Senate Internet And Technology Committee Vote",5,2,0,0,7
1948192,1565467,2025-05-06,Senate,"Senate Education Committee Vote",11,3,0,0,14
1948192,1590331,2025-06-12,Senate,"Senate Floor Vote - Final Passage",38,21,0,4,63
1948202,1534373,2025-04-02,Assembly,"Assembly Real Property Taxation Committee: Favorable refer to committee Ways and Means",10,0,0,0,10
1948202,1585220,2025-06-04,Assembly,"Assembly Ways And Means Committee: Favorable refer to committee Rules",33,0,0,2,35
1948202,1586046,2025-06-06,Assembly,"Assembly Rules Committee: Favorable",27,0,0,4,31
1948202,1586580,2025-06-06,Assembly,"Assembly Floor Vote - Final Passage",143,0,0,7,150
1948202,1589246,2025-06-11,Senate,"Senate Floor Vote - Final Passage",59,0,0,4,63
1948218,1486811,2025-02-03,Senate,"Senate Higher Education Committee Vote",11,0,0,0,11
1948218,1486812,2025-02-11,Senate,"Senate Floor Vote - Final Passage",58,3,0,2,63
1948247,1560447,2025-04-29,Senate,"Senate Social Services Committee Vote",4,2,0,0,6
1948287,1580623,2025-05-28,Assembly,"Assembly Higher Education Committee: Favorable refer to committee Codes",26,0,0,0,26
1948313,1573847,2025-05-20,Assembly,"Assembly Agriculture Committee: Held for Consideration",16,7,0,0,23
1948335,1486090,2025-02-11,Assembly,"Assembly Local Governments Committee: Favorable refer to committee Rules",13,5,0,2,20
1948335,1486091,2025-02-11,Assembly,"Assembly Rules Committee: Favorable",23,4,0,4,31
1948351,1570397,2025-05-13,Assembly,"Assembly Codes Committee: Held for Consideration",16,6,0,0,22
1948354,1570641,2025-05-13,Assembly,"Assembly Codes Committee: Held for Consideration",16,6,0,0,22
1948373,1574262,2025-05-20,Assembly,"Assembly Local Governments Committee: Held for Consideration",13,5,0,2,20
1948389,1574641,2025-05-20,Assembly,"Assembly Judiciary Committee: Favorable refer to committee Rules",13,7,0,1,21
1948389,1591578,2025-06-17,Assembly,"Assembly Rules Committee: Favorable",21,9,0,1,31
1948408,1574520,2025-05-20,Assembly,"Assembly Governmental Operations Committee: Favorable refer to committee Rules",14,0,0,0,14
1948408,1575443,2025-05-21,Assembly,"Assembly Rules Committee: Favorable",29,0,0,2,31
1948408,1576202,2025-05-21,Assembly,"Assembly Floor Vote - Final Passage",144,0,0,6,150
1948408,1589270,2025-06-11,Senate,"Senate Floor Vote - Final Passage",49,10,0,4,63
1948416,1498950,2025-02-11,Senate,"Senate Consumer Protection Committee Vote",7,0,0,0,7
1948416,1498951,2025-02-25,Senate,"Senate Floor Vote - Final Passage",57,4,0,2,63
1948416,1563855,2025-04-30,Assembly,"Assembly Floor Vote - Final Passage",134,11,0,5,150
1948425,1566527,2025-05-06,Assembly,"Assembly Aging Committee: Favorable refer to committee Ways and Means",28,0,0,2,30
1948425,1574411,2025-05-20,Assembly,"Assembly Ways And Means Committee: Favorable refer to committee Rules",35,0,0,0,35
1948425,1574890,2025-05-21,Assembly,"Assembly Rules Committee: Favorable",29,0,0,2,31
1948425,1575834,2025-05-21,Assembly,"Assembly Floor Vote - Final Passage",144,0,0,6,150
1948425,1590396,2025-06-13,Senate,"Senate Floor Vote - Final Passage",59,0,0,4,63
1948431,1573839,2025-05-20,Senate,"Senate Social Services Committee Vote",6,0,0,0,6
1948487,1540017,2025-04-08,Senate,"Senate Cities 1 Committee Vote",7,0,0,0,7
1948489,1590204,2025-06-12,Senate,"Senate Rules Committee Vote",18,2,0,1,21
1948489,1590556,2025-06-13,Senate,"Senate Floor Vote - Final Passage",39,20,0,4,63
1948499,1515097,2025-03-11,Assembly,"Assembly Energy Committee: Favorable refer to committee Codes",12,4,0,1,17
1948499,1527043,2025-03-25,Assembly,"Assembly Codes Committee: Favorable",19,2,0,1,22
1948518,1576054,2025-02-24,Senate,"Senate Codes Committee Vote",10,3,0,0,13
1948518,1576055,2025-05-21,Senate,"Senate Floor Vote - Final Passage",38,21,0,3,62
1948520,1581263,2025-05-29,Senate,"Senate Children And Families Committee Vote",6,0,0,1,7
1948521,1580473,2025-05-28,Assembly,"Assembly Labor Committee: Favorable refer to committee Codes",28,1,0,0,29
1948521,1585425,2025-06-05,Assembly,"Assembly Codes Committee: Favorable refer to committee Rules",20,1,0,1,22
1948522,1539318,2025-04-08,Senate,"Senate Cities 1 Committee Vote",7,0,0,0,7
1948522,1559674,2025-04-28,Senate,"Senate Housing, Construction And Community Development Committee Vote",8,3,0,0,11
1948549,1574482,2025-05-20,Assembly,"Assembly Insurance Committee: Favorable refer to committee Rules",25,0,0,0,25
1948549,1593596,2025-06-16,Assembly,"Assembly Rules Committee: Favorable",29,0,0,2,31
1948578,1580141,2025-05-28,Assembly,"Assembly Transportation Committee: Favorable refer to committee Ways and Means",23,0,0,3,26
1948578,1584900,2025-06-04,Assembly,"Assembly Ways And Means Committee: Favorable refer to committee Rules",33,0,0,2,35
1948578,1588563,2025-06-11,Assembly,"Assembly Rules Committee: Favorable",28,0,0,3,31
1948578,1589075,2025-06-11,Senate,"Senate Floor Vote - Final Passage",59,0,0,4,63
1948578,1589384,2025-06-11,Assembly,"Assembly Floor Vote - Final Passage",146,0,0,4,150
1948596,1505180,2025-03-04,Assembly,"Assembly Economic Development Committee: Favorable refer to committee Ways and Means",25,0,0,1,26
1948620,1574666,2025-05-20,Assembly,"Assembly Codes Committee: Favorable refer to committee Rules",14,6,0,2,22
1948620,1574926,2025-05-21,Assembly,"Assembly Rules Committee: Favorable",29,0,0,2,31
1948642,1580165,2025-05-28,Assembly,"Assembly Insurance Committee: Favorable refer to committee Ways and Means",23,1,0,1,25
1948642,1584911,2025-06-04,Assembly,"Assembly Ways And Means Committee: Favorable refer to committee Rules",33,0,0,2,35
1948642,1585961,2025-06-06,Assembly,"Assembly Rules Committee: Favorable",27,0,0,4,31
1948642,1586494,2025-06-06,Assembly,"Assembly Floor Vote - Final Passage",143,0,0,7,150
1948647,1571837,2025-05-13,Senate,"Senate Health Committee Vote",12,1,0,1,14
1948647,1581832,2025-05-29,Senate,"Senate Rules Committee Vote",20,0,0,1,21
1948647,1585873,2025-06-05,Senate,"Senate Floor Vote - Final Passage",56,4,0,3,63
1948655,1580606,2025-05-28,Assembly,"Assembly Election Law Committee: Favorable refer to committee Codes",10,5,0,1,16
1948655,1585713,2025-06-05,Assembly,"Assembly Codes Committee: Favorable refer to committee Rules",20,1,0,1,22
1948668,1538023,2025-04-07,Assembly,"Assembly Rules Committee: Favorable",25,4,0,2,31
1948668,1538024,2025-04-07,Assembly,"Assembly Ways And Means Committee: Favorable refer to committee Rules",27,6,0,2,35
1948677,1574862,2025-05-20,Senate,"Senate Health Committee Vote",13,0,0,1,14
1948683,1579905,2025-05-28,Assembly,"Assembly Governmental Employees Committee: Favorable refer to committee Codes",14,0,0,0,14
1948690,1573895,2025-05-20,Assembly,"Assembly Education Committee: Held for Consideration",20,8,0,3,31
1948724,1526096,2025-03-25,Assembly,"Assembly Codes Committee: Favorable refer to committee Rules",21,0,0,1,22
1948724,1526097,2025-03-25,Assembly,"Assembly Consumer Affairs And Protection Committee: Favorable refer to committee Codes",15,0,0,1,16
1948724,1526262,2025-03-25,Assembly,"Assembly Rules Committee: Favorable",30,0,0,1,31
1948724,1527372,2025-03-25,Assembly,"Assembly Floor Vote - Final Passage",149,0,0,1,150
1948726,1574557,2025-05-20,Assembly,"Assembly Real Property Taxation Committee: Favorable refer to committee Ways and Means",7,3,0,0,10
1948727,1534426,2025-04-02,Assembly,"Assembly Real Property Taxation Committee: Favorable refer to committee Ways and Means",10,0,0,0,10
1948747,1579750,2025-05-28,Assembly,"Assembly Transportation Committee: Held for Consideration",16,7,0,3,26
1948752,1573304,2025-05-19,Assembly,"Assembly Consumer Affairs And Protection Committee: Held for Consideration",10,5,0,1,16
1948769,1479718,2025-02-04,Assembly,"Assembly Economic Development Committee: Favorable",23,0,0,3,26
1948769,1486594,2025-02-10,Assembly,"Assembly Floor Vote - Final Passage",145,0,0,5,150
1948769,1588592,2025-06-10,Senate,"Senate Floor Vote - Final Passage",58,0,0,5,63
1948783,1587013,2025-06-09,Assembly,"Assembly Codes Committee: Favorable refer to committee Rules",20,0,0,2,22
1948783,1588133,2025-06-10,Assembly,"Assembly Rules Committee: Favorable",27,1,0,3,31
1948783,1589155,2025-06-10,Assembly,"Assembly Floor Vote - Final Passage",133,14,0,3,150
1948793,1515628,2025-03-11,Senate,"Senate Judiciary Committee Vote",17,2,0,0,19
1948801,1573365,2025-05-19,Assembly,"Assembly Health Committee: Favorable refer to committee Ways and Means",17,7,0,2,26
1948801,1585930,2025-06-06,Assembly,"Assembly Ways And Means Committee: Favorable refer to committee Rules",25,10,0,0,35
1948801,1587001,2025-06-09,Assembly,"Assembly Rules Committee: Favorable",17,8,0,6,31
1948802,1585920,2025-06-06,Assembly,"Assembly Ways And Means Committee: Favorable refer to committee Rules",35,0,0,0,35
1948802,1588494,2025-06-11,Assembly,"Assembly Rules Committee: Favorable",28,0,0,3,31
1948810,1580865,2025-05-28,Senate,"Senate Budget And Revenue Committee Vote",5,2,0,0,7
1948829,1586895,2025-06-09,Assembly,"Assembly Ways And Means Committee: Favorable refer to committee Rules",31,0,0,4,35
1948843,1574201,2025-05-20,Assembly,"Assembly Insurance Committee: Favorable refer to committee Rules",25,0,0,0,25
1948843,1579083,2025-05-27,Assembly,"Assembly Rules Committee: Favorable",26,0,0,5,31
1948843,1579633,2025-05-27,Assembly,"Assembly Floor Vote - Final Passage",145,0,0,5,150
1948843,1589146,2025-06-11,Senate,"Senate Floor Vote - Final Passage",59,0,0,4,63
1948846,1585976,2025-06-06,Assembly,"Assembly Ways And Means Committee: Favorable refer to committee Rules",25,10,0,0,35
1948846,1586976,2025-06-09,Assembly,"Assembly Rules Committee: Favorable",17,8,0,6,31
1948856,1585568,2025-06-05,Assembly,"Assembly Local Governments Committee: Favorable refer to committee Rules",19,0,0,1,20
1948856,1585956,2025-06-06,Assembly,"Assembly Rules Committee: Favorable",27,0,0,4,31
1948856,1586554,2025-06-06,Assembly,"Assembly Floor Vote - Final Passage",143,0,0,7,150
1948856,1589225,2025-06-11,Senate,"Senate Floor Vote - Final Passage",59,0,0,4,63
1948859,1573897,2025-05-20,Assembly,"Assembly Education Committee: Held for Consideration",20,8,0,3,31
1948867,1497902,2025-02-24,Assembly,"Assembly Insurance Committee: Favorable",22,0,0,3,25
1948867,1505750,2025-03-04,Assembly,"Assembly Floor Vote - Final Passage",145,4,0,1,150
1948867,1571607,2025-05-14,Senate,"Senate Floor Vote - Final Passage",57,0,0,5,62
1948889,1515668,2025-03-12,Senate,"Senate Internet And Technology Committee Vote",6,1,0,0,7
1948889,1560706,2025-04-29,Senate,"Senate Finance Committee Vote",22,0,0,0,22
1948899,1566457,2025-05-06,Assembly,"Assembly Corporations, Authorities And Commissions Committee: Favorable refer to committee Codes",18,7,0,1,26
1948899,1570518,2025-05-13,Assembly,"Assembly Codes Committee: Favorable refer to committee Ways and Means",19,3,0,0,22
1948920,1590102,2025-05-12,Senate,"Senate Women's Issues Committee Vote",7,0,0,0,7
1948920,1590635,2025-06-13,Senate,"Senate Floor Vote - Final Passage",58,1,0,4,63
1948927,1579975,2025-05-28,Assembly,"Assembly Local Governments Committee: Favorable refer to committee Ways and Means",20,0,0,0,20
1948927,1585198,2025-06-04,Assembly,"Assembly Ways And Means Committee: Favorable refer to committee Rules",30,3,0,2,35
1948927,1586085,2025-06-06,Assembly,"Assembly Rules Committee: Favorable",27,0,0,4,31
1948927,1586556,2025-06-06,Assembly,"Assembly Floor Vote - Final Passage",141,2,0,7,150
1948927,1589182,2025-06-11,Senate,"Senate Floor Vote - Final Passage",58,1,0,4,63
1948959,1589595,2025-05-29,Senate,"Senate Rules Committee Vote",20,0,0,1,21
1948959,1590598,2025-06-12,Senate,"Senate Floor Vote - Final Passage",58,1,0,4,63
1948960,1498682,2025-02-25,Assembly,"Assembly Real Property Taxation Committee: Favorable refer to committee Ways and Means",10,0,0,0,10
1949061,1579140,2025-05-27,Assembly,"Assembly Governmental Operations Committee: Favorable refer to committee Ways and Means",14,0,0,0,14
1949061,1590665,2025-06-13,Assembly,"Assembly Rules Committee: Favorable",29,0,0,2,31
1949061,1590666,2025-06-13,Assembly,"Assembly Ways And Means Committee: Favorable refer to committee Rules",32,0,0,3,35
1949061,1591272,2025-06-13,Assembly,"Assembly Floor Vote - Final Passage",136,0,0,14,150
1949080,1580097,2025-05-28,Assembly,"Assembly Local Governments Committee: Favorable refer to committee Rules",20,0,0,0,20
1949101,1565620,2025-05-06,Assembly,"Assembly Transportation Committee: Favorable refer to committee Codes",24,0,0,2,26
1949103,1580147,2025-05-28,Assembly,"Assembly Insurance Committee: Favorable refer to committee Rules",20,4,0,1,25
1949109,1579987,2025-05-28,Assembly,"Assembly Local Governments Committee: Favorable refer to committee Ways and Means",20,0,0,0,20
1949109,1587308,2025-06-10,Assembly,"Assembly Ways And Means Committee: Favorable refer to committee Rules",32,0,0,3,35
1949109,1588482,2025-06-11,Assembly,"Assembly Rules Committee: Favorable",28,0,0,3,31
1949122,1579209,2025-05-27,Senate,"Senate Civil Service And Pensions Committee Vote",6,0,0,1,7
1949185,1585590,2025-06-05,Assembly,"Assembly Local Governments Committee: Favorable refer to committee Ways and Means",19,0,0,1,20
1949185,1586062,2025-06-06,Assembly,"Assembly Ways And Means Committee: Favorable refer to committee Rules",33,2,0,0,35
1949185,1586971,2025-06-09,Assembly,"Assembly Rules Committee: Favorable",25,0,0,6,31
1949185,1587373,2025-06-09,Assembly,"Assembly Floor Vote - Final Passage",133,11,0,6,150
1949185,1589186,2025-06-11,Senate,"Senate Floor Vote - Final Passage",58,1,0,4,63
1949211,1540088,2025-04-08,Senate,"Senate Labor Committee Vote",13,0,0,0,13
1949220,1579174,2025-05-27,Senate,"Senate Labor Committee Vote",13,0,0,0,13
1949239,1534136,2025-04-02,Assembly,"Assembly Transportation Committee: Favorable refer to committee Codes",25,0,0,1,26
1949239,1574351,2025-05-20,Assembly,"Assembly Codes Committee: Favorable refer to committee Rules",20,0,0,2,22
1949265,1574644,2025-05-20,Assembly,"Assembly Codes Committee: Favorable refer to committee Rules",20,0,0,2,22
1949265,1586050,2025-06-06,Assembly,"Assembly Rules Committee: Favorable",27,0,0,4,31
1949265,1586567,2025-06-06,Assembly,"Assembly Floor Vote - Final Passage",134,9,0,7,150
1949304,1584662,2025-06-04,Assembly,"Assembly Transportation Committee: Favorable refer to committee Ways and Means",22,0,0,4,26
1949304,1585965,2025-06-06,Assembly,"Assembly Ways And Means Committee: Favorable refer to committee Rules",35,0,0,0,35
1949304,1586866,2025-06-09,Assembly,"Assembly Rules Committee: Favorable",25,0,0,6,31
1949304,1587569,2025-06-09,Assembly,"Assembly Floor Vote - Final Passage",144,0,0,6,150
1949304,1588215,2025-06-10,Senate,"Senate Floor Vote - Final Passage",57,1,0,5,63
1949400,1526420,2025-03-25,Assembly,"Assembly Children And Families Committee: Favorable refer to committee Codes",15,0,0,2,17
1949400,1566490,2025-05-06,Assembly,"Assembly Codes Committee: Favorable",22,0,0,0,22
1949400,1570093,2025-05-12,Assembly,"Assembly Floor Vote - Final Passage",143,0,0,7,150
1949400,1586135,2025-06-05,Senate,"Senate Floor Vote - Final Passage",60,0,0,3,63
1949414,1585724,2025-06-05,Assembly,"Assembly Governmental Operations Committee: Favorable refer to committee Rules",13,0,0,1,14
1949414,1586012,2025-06-06,Assembly,"Assembly Rules Committee: Favorable",27,0,0,4,31
1949414,1586569,2025-06-06,Assembly,"Assembly Floor Vote - Final Passage",143,0,0,7,150
1949414,1589544,2025-06-11,Senate,"Senate Floor Vote - Final Passage",57,2,0,4,63
1949549,1499027,2025-02-25,Assembly,"Assembly Children And Families Committee: Favorable refer to committee Codes",17,0,0,0,17
1949549,1504152,2025-03-04,Assembly,"Assembly Codes Committee: Favorable refer to committee Rules",22,0,0,0,22
1949549,1505405,2025-03-04,Assembly,"Assembly Rules Committee: Favorable",27,0,0,4,31
1949582,1534060,2025-04-02,Assembly,"Assembly Governmental Operations Committee: Favorable refer to committee Codes",10,4,0,0,14
1949582,1580043,2025-05-28,Assembly,"Assembly Codes Committee: Favorable refer to committee Rules",15,6,0,1,22
1949582,1584914,2025-06-04,Assembly,"Assembly Rules Committee: Favorable",20,8,0,3,31
1949582,1586620,2025-06-06,Assembly,"Assembly Floor Vote - Final Passage",95,46,0,9,150
1949582,1589169,2025-06-11,Senate,"Senate Floor Vote - Final Passage",39,20,0,4,63
1949900,1581906,2025-02-11,Senate,"Senate Environmental Conservation Committee Vote",10,1,0,0,11
1949900,1581907,2025-05-29,Senate,"Senate Floor Vote - Final Passage",39,17,0,7,63
1949905,1553593,2025-02-11,Senate,"Senate Environmental Conservation Committee Vote",10,1,0,0,11
1949905,1553594,2025-04-22,Senate,"Senate Floor Vote - Final Passage",44,9,0,9,62
1949964,1575105,2025-02-25,Senate,"Senate Crime Victims, Crime And Correction Committee Vote",7,0,0,0,7
1949964,1575106,2025-05-21,Senate,"Senate Floor Vote - Final Passage",38,21,0,3,62
1949968,1574891,2025-05-20,Senate,"Senate Transportation Committee Vote",11,2,0,0,13
1949968,1589201,2025-06-11,Senate,"Senate Rules Committee Vote",14,6,0,1,21
1949968,1590508,2025-06-12,Senate,"Senate Floor Vote - Final Passage",44,15,0,4,63
1950009,1560890,2025-04-29,Senate,"Senate Civil Service And Pensions Committee Vote",7,0,0,0,7
1950023,1587992,2025-06-04,Senate,"Senate Rules Committee Vote",20,0,0,1,21
1950023,1587993,2025-06-10,Senate,"Senate Floor Vote - Final Passage",57,1,0,5,63
1950030,1505868,2025-03-04,Senate,"Senate Agriculture Committee Vote",9,0,0,0,9
1950057,1581163,2025-05-13,Senate,"Senate Ethics And Internal Governance Committee Vote",5,2,0,0,7
1950057,1581164,2025-05-29,Senate,"Senate Floor Vote - Final Passage",37,19,0,7,63
1950091,1589015,2025-05-20,Senate,"Senate Codes Committee Vote",11,2,0,0,13
1950091,1589398,2025-06-11,Senate,"Senate Floor Vote - Final Passage",59,0,0,4,63
1950091,1592339,2025-06-17,Assembly,"Assembly Floor Vote - Final Passage",138,0,0,12,150
1950126,1499304,2025-02-25,Senate,"Senate Environmental Conservation Committee Vote",11,0,0,0,11
1950126,1580871,2025-05-28,Senate,"Senate Finance Committee Vote",22,0,0,0,22
1950126,1590527,2025-06-12,Senate,"Senate Floor Vote - Final Passage",59,0,0,4,63
1950128,1574822,2025-05-21,Senate,"Senate Mental Health Committee Vote",7,0,0,0,7
1950149,1589255,2025-05-13,Senate,"Senate Higher Education Committee Vote",11,0,0,0,11
1950149,1590000,2025-06-11,Senate,"Senate Floor Vote - Final Passage",57,2,0,4,63
1950163,1590435,2025-06-12,Senate,"Senate Floor Vote - Final Passage",58,1,0,4,63
1950163,1591318,2025-06-13,Assembly,"Assembly Floor Vote - Final Passage",135,1,0,14,150
1950163,1595122,2025-06-12,Senate,"Senate Rules Committee Vote",20,0,0,1,21
1950225,1486102,2025-02-11,Senate,"Senate Environmental Conservation Committee Vote",11,0,0,0,11
1950253,1587363,2025-06-10,Assembly,"Assembly Ways And Means Committee: Favorable refer to committee Rules",29,3,0,3,35
1950253,1591982,2025-06-17,Assembly,"Assembly Rules Committee: Favorable",28,0,0,3,31
1950262,1534416,2025-04-02,Assembly,"Assembly Correction Committee: Held for Consideration",9,3,0,1,13
1950316,1575807,2025-05-22,Assembly,"Assembly Ways And Means Committee: Favorable refer to committee Rules",29,2,0,4,35
1950316,1590029,2025-06-12,Assembly,"Assembly Rules Committee: Favorable",29,0,0,2,31
1950319,1560095,2025-04-28,Senate,"Senate Energy And Telecommunications Committee Vote",9,0,0,0,9
1950319,1580907,2025-05-28,Senate,"Senate Budget And Revenue Committee Vote",6,1,0,0,7
1950336,1587325,2025-06-10,Assembly,"Assembly Ways And Means Committee: Favorable refer to committee Rules",30,2,0,3,35
1950336,1589967,2025-06-12,Assembly,"Assembly Rules Committee: Favorable",29,0,0,2,31
1950349,1574624,2025-05-20,Assembly,"Assembly Higher Education Committee: Held for Consideration",15,8,0,3,26
1950376,1498979,2025-02-25,Assembly,"Assembly Governmental Operations Committee: Favorable refer to committee Codes",9,4,0,1,14
1950376,1504195,2025-03-04,Assembly,"Assembly Codes Committee: Favorable refer to committee Rules",16,6,0,0,22
1950376,1505420,2025-03-04,Assembly,"Assembly Rules Committee: Favorable",19,8,0,4,31
1950384,1591436,2025-06-16,Assembly,"Assembly Ways And Means Committee: Favorable refer to committee Rules",32,0,0,3,35
1950384,1591588,2025-06-17,Assembly,"Assembly Rules Committee: Favorable",30,0,0,1,31
1950392,1587142,2025-06-09,Senate,"Senate Floor Vote - Final Passage",62,0,0,1,63
1950392,1587143,2025-06-09,Senate,"Senate Rules Committee Vote",21,0,0,0,21
1950402,1534491,2025-04-02,Assembly,"Assembly Codes Committee: Held for Consideration",14,6,0,2,22
1950408,1591440,2025-06-16,Assembly,"Assembly Ways And Means Committee: Favorable refer to committee Rules",32,0,0,3,35
1950408,1591602,2025-06-17,Assembly,"Assembly Rules Committee: Favorable",30,0,0,1,31
1950438,1573406,2025-05-19,Assembly,"Assembly Banks Committee: Favorable refer to committee Codes",18,9,0,4,31
1950438,1580424,2025-05-28,Assembly,"Assembly Codes Committee: Favorable refer to committee Rules",15,6,0,1,22
1950484,1536550,2025-03-25,Senate,"Senate Corporations, Authorities And Commissions Committee Vote",7,0,0,0,7
1950484,1536551,2025-04-03,Senate,"Senate Floor Vote - Final Passage",57,3,0,3,63
1950537,1574117,2025-05-20,Assembly,"Assembly Energy Committee: Favorable refer to committee Rules",16,0,0,1,17
1950537,1588473,2025-06-11,Assembly,"Assembly Rules Committee: Favorable",28,0,0,3,31
1950537,1589382,2025-06-11,Assembly,"Assembly Floor Vote - Final Passage",146,0,0,4,150
1950585,1591420,2025-06-16,Assembly,"Assembly Rules Committee: Favorable",29,0,0,2,31
1950585,1591421,2025-06-16,Assembly,"Assembly Ways And Means Committee: Favorable refer to committee Rules",32,0,0,3,35
1950610,1566119,2025-05-06,Assembly,"Assembly Energy Committee: Favorable refer to committee Ways and Means",12,4,0,1,17
1950638,1526428,2025-03-25,Assembly,"Assembly Correction Committee: Favorable",12,0,0,1,13
1950638,1541302,2025-04-08,Assembly,"Assembly Floor Vote - Final Passage",147,0,0,3,150
1950638,1561604,2025-04-29,Senate,"Senate Floor Vote - Final Passage",55,6,0,1,62
1950646,1570390,2025-05-13,Assembly,"Assembly Codes Committee: Held for Consideration",16,6,0,0,22
1950649,1579429,2025-04-29,Senate,"Senate Investigations And Government Operations Committee Vote",7,0,0,0,7
1950649,1591451,2025-05-27,Senate,"Senate Floor Vote - Final Passage",44,15,0,4,63
1950649,1592683,2025-06-16,Assembly,"Assembly Floor Vote - Final Passage",110,35,0,5,150
1950730,1534366,2025-04-02,Assembly,"Assembly Codes Committee: Held for Consideration",14,6,0,2,22
1950776,1580987,2025-05-20,Senate,"Senate Local Government Committee Vote",7,0,0,0,7
1950776,1580988,2025-05-29,Senate,"Senate Floor Vote - Final Passage",55,1,0,7,63
1950817,1534470,2025-04-02,Assembly,"Assembly Codes Committee: Held for Consideration",14,6,0,2,22
1950820,1560868,2025-04-29,Assembly,"Assembly Mental Health Committee: Favorable refer to committee Ways and Means",13,0,0,0,13
1950820,1584921,2025-06-04,Assembly,"Assembly Ways And Means Committee: Favorable refer to committee Rules",33,0,0,2,35
1950820,1586045,2025-06-06,Assembly,"Assembly Rules Committee: Favorable",27,0,0,4,31
1950820,1586541,2025-06-06,Assembly,"Assembly Floor Vote - Final Passage",143,0,0,7,150
1950820,1588271,2025-06-10,Senate,"Senate Floor Vote - Final Passage",58,0,0,5,63
1950827,1586897,2025-06-09,Assembly,"Assembly Ways And Means Committee: Favorable refer to committee Rules",31,0,0,4,35
1950827,1587311,2025-06-10,Assembly,"Assembly Rules Committee: Favorable",28,0,0,3,31
1951030,1588401,2025-05-21,Senate,"Senate Mental Health Committee Vote",7,0,0,0,7
1951030,1588402,2025-06-10,Senate,"Senate Floor Vote - Final Passage",58,0,0,5,63
1951082,1584673,2025-06-04,Assembly,"Assembly Transportation Committee: Favorable refer to committee Ways and Means",22,0,0,4,26
1951082,1589763,2025-06-12,Assembly,"Assembly Ways And Means Committee: Favorable refer to committee Rules",34,0,0,1,35
1951082,1590676,2025-06-13,Assembly,"Assembly Rules Committee: Favorable",29,0,0,2,31
1951114,1561634,2025-04-29,Senate,"Senate Transportation Committee Vote",13,0,0,0,13
1951114,1590889,2025-06-12,Senate,"Senate Rules Committee Vote",20,0,0,1,21
1951114,1590890,2025-06-13,Senate,"Senate Floor Vote - Final Passage",57,2,0,4,63
1951512,1520331,2025-03-04,Senate,"Senate Agriculture Committee Vote",9,0,0,0,9
1951512,1520332,2025-03-18,Senate,"Senate Floor Vote - Final Passage",61,0,0,2,63
1951543,1504291,2025-03-03,Senate,"Senate Housing, Construction And Community Development Committee Vote",8,3,0,0,11
1951574,1536998,2025-03-11,Senate,"Senate Finance Committee Vote",18,3,0,1,22
1951574,1536999,2025-04-03,Senate,"Senate Floor Vote - Final Passage",45,15,0,3,63
1951608,1590147,2025-05-28,Senate,"Senate Procurement And Contracts Committee Vote",6,0,0,1,7
1951608,1590408,2025-06-12,Senate,"Senate Floor Vote - Final Passage",58,1,0,4,63
1951630,1541291,2025-02-11,Senate,"Senate Consumer Protection Committee Vote",6,1,0,0,7
1951630,1541292,2025-04-08,Senate,"Senate Floor Vote - Final Passage",55,7,0,1,63
1951630,1581262,2025-05-29,Senate,"Senate Floor Vote - Final Passage",53,3,0,7,63
1951630,1582115,2025-05-29,Assembly,"Assembly Floor Vote - Final Passage",145,0,0,5,150
1951636,1498669,2025-02-25,Senate,"Senate Crime Victims, Crime And Correction Committee Vote",7,0,0,0,7
1951743,1579345,2025-05-13,Senate,"Senate Finance Committee Vote",22,0,0,0,22
1951743,1580388,2025-05-27,Senate,"Senate Floor Vote - Final Passage",59,0,0,4,63
1951822,1567000,2025-05-05,Senate,"Senate Banks Committee Vote",5,2,0,0,7
1951822,1580855,2025-05-28,Senate,"Senate Finance Committee Vote",20,2,0,0,22
1951822,1589062,2025-06-11,Senate,"Senate Floor Vote - Final Passage",47,12,0,4,63
1951835,1587133,2025-06-09,Senate,"Senate Floor Vote - Final Passage",62,0,0,1,63
1951835,1587134,2025-06-09,Senate,"Senate Rules Committee Vote",21,0,0,0,21
1951890,1572920,2025-03-03,Senate,"Senate Housing, Construction And Community Development Committee Vote",11,0,0,0,11
1951890,1572921,2025-05-15,Senate,"Senate Floor Vote - Final Passage",52,0,0,10,62
1951948,1527447,2025-03-25,Senate,"Senate Corporations, Authorities And Commissions Committee Vote",7,0,0,0,7
1951966,1573731,2025-05-05,Senate,"Senate Banks Committee Vote",7,0,0,0,7
1951966,1573732,2025-05-19,Senate,"Senate Floor Vote - Final Passage",56,0,0,6,62
1951966,1587270,2025-06-09,Assembly,"Assembly Floor Vote - Final Passage",144,0,0,6,150
1951970,1590283,2025-06-12,Senate,"Senate Rules Committee Vote",20,0,0,1,21
1951970,1590839,2025-06-13,Senate,"Senate Floor Vote - Final Passage",59,0,0,4,63
1951970,1591246,2025-06-13,Assembly,"Assembly Floor Vote - Final Passage",134,0,0,16,150
1951994,1505139,2025-02-24,Senate,"Senate Codes Committee Vote",13,0,0,0,13
1951994,1505140,2025-03-04,Senate,"Senate Floor Vote - Final Passage",61,0,0,2,63
1951994,1575541,2025-05-21,Senate,"Senate Floor Vote - Final Passage",59,0,0,3,62
1952031,1486204,2025-02-11,Senate,"Senate Corporations, Authorities And Commissions Committee Vote",7,0,0,0,7
1952093,1559630,2025-04-28,Senate,"Senate Energy And Telecommunications Committee Vote",9,0,0,0,9
1952129,1574373,2025-05-20,Senate,"Senate Cities 1 Committee Vote",6,1,0,0,7
1952171,1485903,2025-02-11,Assembly,"Assembly Racing And Wagering Committee: Favorable refer to committee Codes",10,0,0,1,11
1952171,1499049,2025-02-25,Assembly,"Assembly Codes Committee: Favorable",21,0,0,1,22
1952179,1572500,2025-04-08,Senate,"Senate Health Committee Vote",9,5,0,1,15
1952179,1572501,2025-05-15,Senate,"Senate Floor Vote - Final Passage",32,20,0,10,62
1952187,1486053,2025-02-11,Senate,"Senate Corporations, Authorities And Commissions Committee Vote",7,0,0,0,7
1952187,1514114,2025-03-11,Senate,"Senate Finance Committee Vote",21,0,0,1,22
1952187,1543179,2025-04-09,Senate,"Senate Floor Vote - Final Passage",60,0,0,3,63
1952187,1590247,2025-06-12,Assembly,"Assembly Floor Vote - Final Passage",142,1,0,7,150
1952215,1590117,2025-05-28,Senate,"Senate Elections Committee Vote",6,1,0,0,7
1952215,1590341,2025-06-12,Senate,"Senate Floor Vote - Final Passage",57,2,0,4,63
1952215,1592336,2025-06-16,Assembly,"Assembly Floor Vote - Final Passage",142,2,0,6,150
1952221,1572534,2025-03-18,Senate,"Senate Energy And Telecommunications Committee Vote",6,3,0,0,9
1952221,1572535,2025-05-14,Senate,"Senate Floor Vote - Final Passage",35,22,0,5,62
1953301,1573844,2025-05-20,Assembly,"Assembly People With Disabilities Committee: Held for Consideration",7,2,0,0,9
1953335,1581216,2025-05-29,Assembly,"Assembly Tourism, Arts And Sports Development Committee: Held for Consideration",13,6,0,2,21
1953376,1574114,2025-05-20,Assembly,"Assembly Social Services Committee: Favorable refer to committee Rules",14,2,0,2,18
1953376,1579347,2025-05-27,Assembly,"Assembly Rules Committee: Favorable",26,0,0,5,31
1953376,1589084,2025-06-10,Assembly,"Assembly Floor Vote - Final Passage",112,34,0,4,150
1953376,1590629,2025-06-12,Senate,"Senate Floor Vote - Final Passage",49,10,0,4,63
1953393,1504782,2025-03-04,Senate,"Senate Veterans, Homeland Security And Military Affairs Committee Vote",9,0,0,0,9
1953393,1574199,2025-05-20,Senate,"Senate Finance Committee Vote",22,0,0,0,22
1953393,1580322,2025-05-27,Senate,"Senate Floor Vote - Final Passage",59,0,0,4,63
1953393,1590304,2025-06-12,Senate,"Senate Floor Vote - Final Passage",58,1,0,4,63
1953393,1592234,2025-06-16,Assembly,"Assembly Floor Vote - Final Passage",145,0,0,5,150
1953405,1580612,2025-05-28,Assembly,"Assembly Election Law Committee: Favorable refer to committee Rules",13,2,0,1,16
1953418,1562684,2025-04-30,Assembly,"Assembly Local Governments Committee: Favorable refer to committee Ways and Means",17,1,0,2,20
1953435,1591411,2025-06-16,Assembly,"Assembly Rules Committee: Favorable",29,0,0,2,31
1953435,1591412,2025-06-16,Assembly,"Assembly Ways And Means Committee: Favorable refer to committee Rules",32,0,0,3,35
1953451,1591597,2025-06-17,Assembly,"Assembly Rules Committee: Favorable",30,0,0,1,31
1953451,1591598,2025-06-17,Assembly,"Assembly Ways And Means Committee: Favorable refer to committee Rules",31,1,0,3,35
1953497,1581184,2025-05-29,Assembly,"Assembly Tourism, Arts And Sports Development Committee: Held for Consideration",13,6,0,2,21
1953514,1526368,2025-03-25,Assembly,"Assembly Correction Committee: Favorable refer to committee Ways and Means",9,3,0,1,13
1953514,1579368,2025-05-27,Assembly,"Assembly Ways And Means Committee: Favorable refer to committee Rules",22,10,0,3,35
1953542,1498006,2025-02-24,Assembly,"Assembly Consumer Affairs And Protection Committee: Favorable refer to committee Rules",14,0,0,2,16
1953542,1574877,2025-05-21,Assembly,"Assembly Rules Committee: Favorable",29,0,0,2,31
1953542,1575819,2025-05-21,Assembly,"Assembly Floor Vote - Final Passage",144,0,0,6,150
1953542,1590001,2025-06-11,Senate,"Senate Floor Vote - Final Passage",59,0,0,4,63
1953571,1574699,2025-05-20,Assembly,"Assembly Ways And Means Committee: Favorable refer to committee Rules",33,2,0,0,35
1953571,1574943,2025-05-21,Assembly,"Assembly Rules Committee: Favorable",29,0,0,2,31
1953571,1575771,2025-05-21,Assembly,"Assembly Floor Vote - Final Passage",107,37,0,6,150
1953571,1599255,2025-05-27,Senate,"Senate Floor Vote - Final Passage",51,8,0,4,63
1953577,1574676,2025-05-20,Assembly,"Assembly Higher Education Committee: Held for Consideration",15,8,0,3,26
1953578,1499037,2025-02-25,Assembly,"Assembly Social Services Committee: Favorable refer to committee Ways and Means",13,4,0,1,18
1953643,1498786,2025-02-25,Assembly,"Assembly Banks Committee: Favorable refer to committee Codes",21,8,0,2,31
1953643,1504313,2025-03-04,Assembly,"Assembly Codes Committee: Favorable",16,6,0,0,22
1953677,1574525,2025-05-20,Assembly,"Assembly Environmental Conservation Committee: Favorable refer to committee Codes",23,7,0,0,30
1953687,1580263,2025-05-28,Assembly,"Assembly Transportation Committee: Held for Consideration",16,7,0,3,26
1953704,1574383,2025-05-20,Assembly,"Assembly Higher Education Committee: Favorable refer to committee Rules",23,0,0,3,26
1953704,1579088,2025-05-27,Assembly,"Assembly Rules Committee: Favorable",26,0,0,5,31
1953704,1579591,2025-05-27,Assembly,"Assembly Floor Vote - Final Passage",143,2,0,5,150
1953708,1579158,2025-05-27,Assembly,"Assembly Governmental Operations Committee: Held for Consideration",10,4,0,0,14
1953717,1585391,2025-05-14,Senate,"Senate Local Government Committee Vote",6,0,0,1,7
1953717,1585392,2025-06-04,Senate,"Senate Floor Vote - Final Passage",56,2,0,5,63
1953738,1573838,2025-05-20,Assembly,"Assembly Agriculture Committee: Favorable refer to committee Ways and Means",23,0,0,0,23
1953749,1504844,2025-03-04,Senate,"Senate Aging Committee Vote",7,0,0,0,7
1953763,1590743,2025-06-13,Assembly,"Assembly Rules Committee: Favorable",28,1,0,2,31
1953763,1590744,2025-06-13,Assembly,"Assembly Ways And Means Committee: Favorable refer to committee Rules",29,3,0,3,35
1953763,1591217,2025-06-13,Assembly,"Assembly Floor Vote - Final Passage",123,12,0,15,150
1953770,1570111,2025-05-13,Assembly,"Assembly Environmental Conservation Committee: Favorable refer to committee Codes",20,7,0,3,30
1953782,1574499,2025-05-20,Assembly,"Assembly Real Property Taxation Committee: Favorable refer to committee Ways and Means",10,0,0,0,10
1953782,1579430,2025-05-27,Assembly,"Assembly Ways And Means Committee: Favorable refer to committee Rules",31,1,0,3,35
1953782,1581537,2025-05-29,Assembly,"Assembly Rules Committee: Favorable",27,0,0,4,31
1953782,1582201,2025-05-29,Assembly,"Assembly Floor Vote - Final Passage",144,2,0,4,150
1953782,1586189,2025-06-06,Senate,"Senate Floor Vote - Final Passage",50,3,0,10,63
1953784,1532020,2025-04-01,Assembly,"Assembly Rules Committee: Favorable",30,0,0,1,31
1953784,1532021,2025-04-01,Assembly,"Assembly Ways And Means Committee: Favorable refer to committee Rules",31,2,0,2,35
1953784,1535701,2025-04-02,Assembly,"Assembly Floor Vote - Final Passage",108,40,0,2,150
1953784,1554964,2025-04-22,Senate,"Senate Floor Vote - Final Passage",42,11,0,9,62
1953808,1574483,2025-05-20,Assembly,"Assembly Real Property Taxation Committee: Favorable refer to committee Ways and Means",10,0,0,0,10
1953808,1580940,2025-05-29,Assembly,"Assembly Ways And Means Committee: Favorable refer to committee Rules",33,1,0,1,35
1953808,1585187,2025-06-04,Assembly,"Assembly Rules Committee: Favorable",28,0,0,3,31
1953808,1585376,2025-06-04,Assembly,"Assembly Floor Vote - Final Passage",126,17,0,7,150
1953808,1585840,2025-06-05,Senate,"Senate Floor Vote - Final Passage",59,1,0,3,63
1953821,1572115,2025-04-28,Senate,"Senate Energy And Telecommunications Committee Vote",8,1,0,0,9
1953821,1572116,2025-05-15,Senate,"Senate Floor Vote - Final Passage",41,11,0,10,62
1953845,1504958,2025-03-04,Senate,"Senate Aging Committee Vote",7,0,0,0,7
1953845,1590869,2025-06-12,Senate,"Senate Rules Committee Vote",20,0,0,1,21
1953845,1590870,2025-06-13,Senate,"Senate Floor Vote - Final Passage",59,0,0,4,63
1953861,1535225,2025-02-24,Senate,"Senate Codes Committee Vote",13,0,0,0,13
1953861,1535226,2025-04-02,Senate,"Senate Floor Vote - Final Passage",59,3,0,1,63
1953935,1559127,2025-02-25,Senate,"Senate Environmental Conservation Committee Vote",11,0,0,0,11
1953935,1559128,2025-04-28,Senate,"Senate Floor Vote - Final Passage",58,2,0,2,62
1953944,1575797,2025-05-22,Assembly,"Assembly Ways And Means Committee: Favorable refer to committee Rules",29,2,0,4,35
1953944,1581496,2025-05-29,Assembly,"Assembly Rules Committee: Favorable",27,0,0,4,31
1953959,1514242,2025-03-11,Senate,"Senate Cities 1 Committee Vote",7,0,0,0,7
1953991,1541632,2025-03-25,Senate,"Senate Codes Committee Vote",11,1,0,1,13
1953991,1541633,2025-04-09,Senate,"Senate Floor Vote - Final Passage",59,1,0,3,63
1954052,1513859,2025-03-11,Assembly,"Assembly Energy Committee: Favorable",12,4,0,1,17
1954052,1575037,2025-05-20,Assembly,"Assembly Floor Vote - Final Passage",134,13,0,3,150
1954052,1585889,2025-06-05,Senate,"Senate Floor Vote - Final Passage",60,0,0,3,63
1954064,1565650,2025-05-06,Assembly,"Assembly Correction Committee: Favorable refer to committee Ways and Means",8,4,0,1,13
1954064,1574347,2025-05-20,Assembly,"Assembly Ways And Means Committee: Favorable refer to committee Rules",24,11,0,0,35
1954158,1570172,2025-05-13,Assembly,"Assembly Judiciary Committee: Favorable refer to committee Ways and Means",20,0,0,1,21
1954180,1515768,2025-03-11,Senate,"Senate Judiciary Committee Vote",16,3,0,0,19
1954210,1574279,2025-05-20,Assembly,"Assembly Higher Education Committee: Held for Consideration",15,8,0,3,26
1954222,1534607,2025-04-02,Senate,"Senate Civil Service And Pensions Committee Vote",7,0,0,0,7
1954222,1581476,2025-05-28,Senate,"Senate Finance Committee Vote",22,0,0,0,22
1954224,1570500,2025-05-13,Assembly,"Assembly Environmental Conservation Committee: Held for Consideration",19,8,0,3,30
1954232,1565784,2025-05-06,Assembly,"Assembly Consumer Affairs And Protection Committee: Favorable refer to committee Codes",11,5,0,0,16
1954254,1570446,2025-05-13,Assembly,"Assembly Codes Committee: Held for Consideration",16,6,0,0,22
1954310,1580427,2025-05-28,Assembly,"Assembly Local Governments Committee: Held for Consideration",14,6,0,0,20
1954353,1573893,2025-05-20,Assembly,"Assembly Education Committee: Held for Consideration",20,8,0,3,31
1954354,1588525,2025-06-11,Assembly,"Assembly Ways And Means Committee: Favorable refer to committee Rules",34,0,0,1,35
1954354,1591979,2025-06-17,Assembly,"Assembly Rules Committee: Favorable",28,0,0,3,31
1954358,1514636,2025-03-11,Assembly,"Assembly Mental Health Committee: Favorable refer to committee Ways and Means",13,0,0,0,13
1954385,1499755,2025-02-26,Assembly,"Assembly Tourism, Arts And Sports Development Committee: Favorable refer to committee Ways and Means",18,0,0,3,21
1954385,1532040,2025-04-01,Assembly,"Assembly Rules Committee: Favorable",30,0,0,1,31
1954385,1532041,2025-04-01,Assembly,"Assembly Ways And Means Committee: Favorable refer to committee Rules",33,0,0,2,35
1954403,1580144,2025-02-25,Senate,"Senate Judiciary Committee Vote",18,1,0,0,19
1954403,1580658,2025-05-28,Senate,"Senate Floor Vote - Final Passage",51,10,0,2,63
1954403,1587628,2025-06-09,Assembly,"Assembly Floor Vote - Final Passage",131,13,0,6,150
1954482,1590224,2025-06-12,Senate,"Senate Rules Committee Vote",14,6,0,1,21
1954482,1590690,2025-06-13,Senate,"Senate Floor Vote - Final Passage",38,21,0,4,63
1954616,1574272,2025-05-20,Assembly,"Assembly Children And Families Committee: Held for Consideration",11,5,0,1,17
1954618,1581665,2025-05-28,Senate,"Senate Procurement And Contracts Committee Vote",6,0,0,1,7
1954639,1585989,2025-06-06,Assembly,"Assembly Ways And Means Committee: Favorable refer to committee Rules",25,10,0,0,35
1954639,1587003,2025-06-09,Assembly,"Assembly Rules Committee: Favorable",17,8,0,6,31
1954706,1574232,2025-05-20,Assembly,"Assembly Insurance Committee: Favorable refer to committee Rules",25,0,0,0,25
1954706,1586862,2025-06-09,Assembly,"Assembly Rules Committee: Favorable",25,0,0,6,31
1954706,1587395,2025-06-09,Assembly,"Assembly Floor Vote - Final Passage",138,6,0,6,150
1954743,1579727,2025-05-28,Assembly,"Assembly Transportation Committee: Held for Consideration",16,7,0,3,26
1954755,1504744,2025-03-04,Assembly,"Assembly Environmental Conservation Committee: Favorable refer to committee Codes",30,0,0,0,30
1954755,1589738,2025-06-12,Assembly,"Assembly Ways And Means Committee: Favorable refer to committee Rules",28,6,0,1,35
1954755,1590663,2025-06-13,Assembly,"Assembly Rules Committee: Favorable",20,9,0,2,31
1954759,1498781,2025-02-11,Senate,"Senate Consumer Protection Committee Vote",7,0,0,0,7
1954759,1499395,2025-02-25,Senate,"Senate Floor Vote - Final Passage",61,0,0,2,63
1954765,1579917,2025-05-28,Assembly,"Assembly Corporations, Authorities And Commissions Committee: Favorable refer to committee Codes",18,7,0,1,26
1954765,1585418,2025-06-05,Assembly,"Assembly Codes Committee: Favorable refer to committee Ways and Means",18,3,0,1,22
1954765,1590751,2025-06-13,Assembly,"Assembly Rules Committee: Favorable",20,9,0,2,31
1954765,1590752,2025-06-13,Assembly,"Assembly Ways And Means Committee: Favorable refer to committee Rules",30,2,0,3,35
1954803,1588213,2025-06-10,Senate,"Senate Floor Vote - Final Passage",58,0,0,5,63
1954803,1588214,2025-06-10,Senate,"Senate Rules Committee Vote",19,0,0,2,21
1954811,1589955,2025-05-20,Senate,"Senate Labor Committee Vote",13,0,0,0,13
1954811,1590494,2025-06-12,Senate,"Senate Floor Vote - Final Passage",46,13,0,4,63
1954887,1560785,2025-04-29,Assembly,"Assembly Education Committee: Favorable Correction Date:04/29/2025",26,0,0,5,31
1954887,1565435,2025-05-05,Assembly,"Assembly Floor Vote - Final Passage",147,0,0,3,150
1954887,1590009,2025-06-11,Senate,"Senate Floor Vote - Final Passage",59,0,0,4,63
1954914,1561902,2025-04-30,Assembly,"Assembly Labor Committee: Favorable refer to committee Ways and Means",27,1,0,1,29
1954927,1559265,2025-04-28,Assembly,"Assembly Veterans' Affairs Committee: Favorable",19,0,0,0,19
1954927,1565433,2025-05-05,Assembly,"Assembly Floor Vote - Final Passage",147,0,0,3,150
1954927,1590177,2025-06-11,Senate,"Senate Floor Vote - Final Passage",59,0,0,4,63
1954969,1579159,2025-05-27,Assembly,"Assembly Consumer Affairs And Protection Committee: Favorable refer to committee Codes",15,0,0,1,16
1954969,1587055,2025-06-09,Assembly,"Assembly Codes Committee: Favorable refer to committee Rules",20,0,0,2,22
1954969,1590022,2025-06-12,Assembly,"Assembly Rules Committee: Favorable",29,0,0,2,31
1954984,1588866,2025-04-29,Senate,"Senate Environmental Conservation Committee Vote",10,1,0,0,11
1954984,1589266,2025-06-11,Senate,"Senate Floor Vote - Final Passage",40,19,0,4,63
1954997,1574511,2025-05-20,Assembly,"Assembly Energy Committee: Held for Consideration",11,5,0,1,17
1955198,1519392,2025-02-11,Senate,"Senate Education Committee Vote",11,4,0,0,15
1955198,1519393,2025-03-17,Senate,"Senate Floor Vote - Final Passage",40,21,0,2,63
1955307,1499046,2025-02-11,Senate,"Senate Consumer Protection Committee Vote",7,0,0,0,7
1955307,1499047,2025-02-25,Senate,"Senate Floor Vote - Final Passage",57,4,0,2,63
1955307,1586910,2025-06-09,Senate,"Senate Floor Vote - Final Passage",60,2,0,1,63
1956124,1586013,2025-06-06,Assembly,"Assembly Ways And Means Committee: Held for Consideration",25,10,0,0,35
1956133,1498253,2025-02-24,Assembly,"Assembly Labor Committee: Favorable",27,2,0,0,29
1956133,1536214,2025-04-02,Assembly,"Assembly Floor Vote - Final Passage",138,10,0,2,150
1956133,1589271,2025-06-11,Senate,"Senate Floor Vote - Final Passage",56,3,0,4,63
1956182,1497692,2025-02-24,Assembly,"Assembly Labor Committee: Favorable refer to committee Ways and Means",29,0,0,0,29
1956206,1572648,2025-05-13,Senate,"Senate Environmental Conservation Committee Vote",11,0,0,0,11
1956353,1534031,2025-04-02,Assembly,"Assembly Governmental Operations Committee: Favorable refer to committee Ways and Means",14,0,0,0,14
1956353,1579010,2025-05-27,Assembly,"Assembly Ways And Means Committee: Favorable refer to committee Rules",32,0,0,3,35
1956353,1581139,2025-05-29,Assembly,"Assembly Rules Committee: Favorable",27,0,0,4,31
1956353,1582089,2025-05-29,Assembly,"Assembly Floor Vote - Final Passage",146,0,0,4,150
1956353,1589393,2025-06-11,Senate,"Senate Floor Vote - Final Passage",42,17,0,4,63
1956366,1588249,2025-05-27,Senate,"Senate Civil Service And Pensions Committee Vote",6,0,0,1,7
1956366,1588250,2025-06-10,Senate,"Senate Floor Vote - Final Passage",57,1,0,5,63
1956479,1579153,2025-05-27,Assembly,"Assembly Consumer Affairs And Protection Committee: Favorable refer to committee Codes",10,5,0,1,16
1956479,1587022,2025-06-09,Assembly,"Assembly Codes Committee: Favorable refer to committee Rules",15,5,0,2,22
1956479,1588509,2025-06-11,Assembly,"Assembly Rules Committee: Favorable",19,9,0,3,31
1956516,1534591,2025-04-02,Assembly,"Assembly Environmental Conservation Committee: Favorable refer to committee Codes",19,9,0,2,30
1956516,1540024,2025-04-08,Assembly,"Assembly Codes Committee: Favorable",16,5,0,1,22
1956516,1586128,2025-06-05,Assembly,"Assembly Floor Vote - Final Passage",94,50,0,6,150
1956682,1590134,2025-05-20,Senate,"Senate Labor Committee Vote",13,0,0,0,13
1956682,1590719,2025-06-12,Senate,"Senate Floor Vote - Final Passage",59,0,0,4,63
1956695,1505438,2025-02-25,Senate,"Senate Local Government Committee Vote",7,0,0,0,7
1956695,1505439,2025-03-04,Senate,"Senate Floor Vote - Final Passage",61,0,0,2,63
1956695,1580289,2025-05-27,Assembly,"Assembly Floor Vote - Final Passage",145,0,0,5,150
1956737,1574545,2025-05-20,Senate,"Senate Cultural Affairs, Tourism, Parks And Recreation Committee Vote",7,0,0,0,7
1956737,1585518,2025-06-04,Senate,"Senate Rules Committee Vote",20,0,0,1,21
1956737,1590878,2025-06-09,Senate,"Senate Floor Vote - Final Passage",61,1,0,1,63
1956805,1587580,2025-06-09,Senate,"Senate Rules Committee Vote",21,0,0,0,21
1956805,1588356,2025-06-10,Senate,"Senate Floor Vote - Final Passage",57,1,0,5,63
1956805,1589667,2025-06-11,Assembly,"Assembly Floor Vote - Final Passage",136,10,0,4,150
1956983,1579334,2025-04-29,Senate,"Senate Investigations And Government Operations Committee Vote",7,0,0,0,7
1956983,1592489,2025-05-27,Senate,"Senate Floor Vote - Final Passage",45,14,0,4,63
1956983,1592490,2025-06-17,Assembly,"Assembly Floor Vote - Final Passage",107,27,0,16,150
1957076,1580985,2025-05-14,Senate,"Senate Labor Committee Vote",13,0,0,0,13
1957076,1580986,2025-05-29,Senate,"Senate Floor Vote - Final Passage",55,1,0,7,63
1957146,1588716,2025-05-14,Senate,"Senate Labor Committee Vote",13,0,0,0,13
1957146,1589269,2025-06-11,Senate,"Senate Floor Vote - Final Passage",59,0,0,4,63
1957173,1571904,2025-05-06,Senate,"Senate Elections Committee Vote",7,0,0,0,7
1957173,1571905,2025-05-15,Senate,"Senate Floor Vote - Final Passage",51,1,0,10,62
1957323,1579197,2025-04-29,Senate,"Senate Investigations And Government Operations Committee Vote",7,0,0,0,7
1957323,1590576,2025-05-27,Senate,"Senate Floor Vote - Final Passage",50,9,0,4,63
1957323,1591093,2025-06-13,Assembly,"Assembly Floor Vote - Final Passage",111,26,0,13,150
1957338,1588227,2025-06-04,Senate,"Senate Rules Committee Vote",20,0,0,1,21
1957338,1588228,2025-06-10,Senate,"Senate Floor Vote - Final Passage",54,4,0,5,63
1957363,1541513,2025-03-25,Senate,"Senate Codes Committee Vote",12,0,0,1,13
1957363,1541514,2025-04-09,Senate,"Senate Floor Vote - Final Passage",59,1,0,3,63
1957378,1486015,2025-02-11,Assembly,"Assembly Local Governments Committee: Favorable refer to committee Ways and Means",18,0,0,2,20
1957391,1589945,2025-05-20,Senate,"Senate Labor Committee Vote",13,0,0,0,13
1957391,1590695,2025-06-12,Senate,"Senate Floor Vote - Final Passage",50,9,0,4,63
1957415,1580983,2025-05-20,Senate,"Senate Local Government Committee Vote",6,1,0,0,7
1957415,1580984,2025-05-29,Senate,"Senate Floor Vote - Final Passage",45,11,0,7,63
1957456,1572043,2025-05-13,Senate,"Senate Health Committee Vote",13,0,0,1,14
1958654,1580167,2025-05-28,Assembly,"Assembly Corporations, Authorities And Commissions Committee: Held for Consideration",17,8,0,1,26
1958681,1589261,2025-05-27,Senate,"Senate Labor Committee Vote",13,0,0,0,13
1958681,1589262,2025-06-11,Senate,"Senate Floor Vote - Final Passage",58,1,0,4,63
1958687,1574741,2025-05-20,Assembly,"Assembly Ways And Means Committee: Favorable refer to committee Rules",33,2,0,0,35
1958687,1585207,2025-06-04,Assembly,"Assembly Rules Committee: Favorable",28,0,0,3,31
1958720,1574554,2025-05-20,Assembly,"Assembly Labor Committee: Favorable refer to committee Codes",29,0,0,0,29
1958720,1585477,2025-06-05,Assembly,"Assembly Codes Committee: Favorable refer to committee Ways and Means",21,0,0,1,22
1958728,1570418,2025-05-13,Assembly,"Assembly Codes Committee: Held for Consideration",16,6,0,0,22
1958759,1498748,2025-02-25,Assembly,"Assembly Veterans' Affairs Committee: Favorable",19,0,0,0,19
1958759,1506329,2025-03-04,Assembly,"Assembly Floor Vote - Final Passage",149,0,0,1,150
1958759,1572344,2025-05-14,Senate,"Senate Floor Vote - Final Passage",57,0,0,5,62
1958773,1581653,2025-05-14,Senate,"Senate Labor Committee Vote",13,0,0,0,13
1958773,1581654,2025-05-29,Senate,"Senate Floor Vote - Final Passage",55,1,0,7,63
1958886,1503779,2025-03-03,Senate,"Senate Labor Committee Vote",10,3,0,0,13
1958886,1505256,2025-03-04,Senate,"Senate Floor Vote - Final Passage",40,21,0,2,63
1958886,1505722,2025-03-04,Senate,"Senate Rules Committee Vote",13,7,0,1,21
1958907,1586986,2025-06-09,Senate,"Senate Floor Vote - Final Passage",51,11,0,1,63
1958907,1586987,2025-06-09,Senate,"Senate Rules Committee Vote",17,4,0,0,21
1958917,1588364,2025-06-10,Senate,"Senate Floor Vote - Final Passage",38,20,0,5,63
1958917,1588365,2025-06-10,Senate,"Senate Rules Committee Vote",15,4,0,2,21
1958921,1555535,2025-02-25,Senate,"Senate Environmental Conservation Committee Vote",11,0,0,0,11
1958921,1555536,2025-04-22,Senate,"Senate Floor Vote - Final Passage",52,1,0,9,62
1958946,1519946,2025-03-18,Senate,"Senate Transportation Committee Vote",13,0,0,0,13
1958955,1570492,2025-05-13,Assembly,"Assembly Codes Committee: Held for Consideration",16,6,0,0,22
1958966,1574328,2025-05-20,Assembly,"Assembly Higher Education Committee: Held for Consideration",15,8,0,3,26
1958986,1573422,2025-05-19,Assembly,"Assembly Veterans' Affairs Committee: Held for Consideration",13,5,0,1,19
1959054,1539837,2025-04-08,Senate,"Senate Crime Victims, Crime And Correction Committee Vote",7,0,0,0,7
1959075,1588766,2025-06-10,Senate,"Senate Floor Vote - Final Passage",54,4,0,5,63
1959075,1588767,2025-06-10,Senate,"Senate Rules Committee Vote",17,2,0,2,21
1959093,1589901,2025-05-19,Senate,"Senate Consumer Protection Committee Vote",6,0,0,1,7
1959093,1590376,2025-06-12,Senate,"Senate Floor Vote - Final Passage",59,0,0,4,63
1959106,1572004,2025-04-08,Senate,"Senate Labor Committee Vote",13,0,0,0,13
1959106,1572005,2025-05-15,Senate,"Senate Floor Vote - Final Passage",52,0,0,10,62
1959115,1590179,2025-05-27,Senate,"Senate Internet And Technology Committee Vote",6,1,0,0,7
1959115,1590446,2025-06-12,Senate,"Senate Floor Vote - Final Passage",59,0,0,4,63
1959115,1592519,2025-06-17,Assembly,"Assembly Floor Vote - Final Passage",141,0,0,9,150
1959123,1579131,2025-05-27,Assembly,"Assembly Health Committee: Favorable refer to committee Codes",26,0,0,0,26
1959123,1585456,2025-06-05,Assembly,"Assembly Codes Committee: Favorable refer to committee Rules",17,4,0,1,22
1959123,1590790,2025-06-13,Assembly,"Assembly Rules Committee: Favorable",21,8,0,2,31
1959132,1574559,2025-05-20,Assembly,"Assembly Governmental Operations Committee: Favorable refer to committee Rules",14,0,0,0,14
1959132,1585238,2025-06-04,Assembly,"Assembly Rules Committee: Favorable",28,0,0,3,31
1959132,1590243,2025-06-12,Assembly,"Assembly Floor Vote - Final Passage",132,12,0,6,150
1959132,1590244,2025-06-12,Senate,"Senate Floor Vote - Final Passage",50,9,0,4,63
1959134,1573374,2025-05-19,Assembly,"Assembly Veterans' Affairs Committee: Held for Consideration",13,5,0,1,19
1959137,1579198,2025-05-27,Senate,"Senate Civil Service And Pensions Committee Vote",6,0,0,1,7
1959170,1498680,2025-02-25,Assembly,"Assembly Banks Committee: Favorable refer to committee Codes",28,1,0,2,31
1959170,1504192,2025-03-04,Assembly,"Assembly Codes Committee: Favorable",22,0,0,0,22
1959170,1512808,2025-03-10,Assembly,"Assembly Floor Vote - Final Passage",137,11,0,2,150
1959172,1573890,2025-05-20,Assembly,"Assembly Education Committee: Held for Consideration",20,8,0,3,31
1959274,1573866,2025-05-20,Senate,"Senate Education Committee Vote",13,1,0,0,14
1959274,1587017,2025-06-09,Senate,"Senate Rules Committee Vote",19,2,0,0,21
1959274,1590472,2025-06-12,Senate,"Senate Floor Vote - Final Passage",56,3,0,4,63
1959274,1592603,2025-06-17,Assembly,"Assembly Floor Vote - Final Passage",141,0,0,9,150
1959329,1573961,2025-05-20,Assembly,"Assembly People With Disabilities Committee: Favorable refer to committee Ways and Means",9,0,0,0,9
1959329,1585164,2025-06-04,Assembly,"Assembly Ways And Means Committee: Favorable refer to committee Rules",33,0,0,2,35
1959329,1585969,2025-06-06,Assembly,"Assembly Rules Committee: Favorable",27,0,0,4,31
1959329,1586539,2025-06-06,Assembly,"Assembly Floor Vote - Final Passage",143,0,0,7,150
1959393,1590098,2025-04-09,Senate,"Senate Codes Committee Vote",8,4,0,1,13
1959393,1590315,2025-06-12,Senate,"Senate Floor Vote - Final Passage",38,21,0,4,63
1959436,1579016,2025-05-27,Assembly,"Assembly Governmental Operations Committee: Favorable refer to committee Ways and Means",14,0,0,0,14
1959484,1526112,2025-03-25,Assembly,"Assembly Governmental Employees Committee: Favorable",8,4,0,2,14
1959484,1563337,2025-04-30,Assembly,"Assembly Floor Vote - Final Passage",124,21,0,5,150
1959503,1586058,2025-06-06,Assembly,"Assembly Ways And Means Committee: Favorable refer to committee Rules",34,1,0,0,35
1959503,1587028,2025-06-09,Assembly,"Assembly Rules Committee: Favorable",25,0,0,6,31
1959503,1587392,2025-06-09,Assembly,"Assembly Floor Vote - Final Passage",144,0,0,6,150
1959503,1590729,2025-06-13,Senate,"Senate Floor Vote - Final Passage",57,2,0,4,63
1959537,1589315,2025-06-11,Senate,"Senate Floor Vote - Final Passage",59,0,0,4,63
1959537,1589316,2025-06-11,Senate,"Senate Rules Committee Vote",20,0,0,1,21
1959537,1591250,2025-06-13,Assembly,"Assembly Floor Vote - Final Passage",136,0,0,14,150
1959559,1580892,2025-05-28,Senate,"Senate Veterans, Homeland Security And Military Affairs Committee Vote",9,0,0,0,9
1959571,1590289,2025-03-04,Senate,"Senate Higher Education Committee Vote",10,1,0,0,11
1959571,1590290,2025-06-11,Senate,"Senate Floor Vote - Final Passage",56,3,0,4,63
1959578,1580879,2025-05-28,Senate,"Senate Veterans, Homeland Security And Military Affairs Committee Vote",9,0,0,0,9
1959605,1589864,2025-06-12,Assembly,"Assembly Ways And Means Committee: Favorable refer to committee Rules",32,2,0,1,35
1959605,1591952,2025-06-17,Assembly,"Assembly Rules Committee: Favorable",28,0,0,3,31
1959617,1579349,2025-04-29,Senate,"Senate Investigations And Government Operations Committee Vote",7,0,0,0,7
1959617,1590685,2025-05-27,Senate,"Senate Floor Vote - Final Passage",50,9,0,4,63
1959617,1591168,2025-06-13,Assembly,"Assembly Floor Vote - Final Passage",112,25,0,13,150
1959728,1504824,2025-03-03,Senate,"Senate Housing, Construction And Community Development Committee Vote",8,3,0,0,11
1959728,1587032,2025-06-09,Senate,"Senate Floor Vote - Final Passage",42,20,0,1,63
1959728,1587033,2025-06-09,Senate,"Senate Rules Committee Vote",15,6,0,0,21
1959816,1575812,2025-05-22,Senate,"Senate Alcoholism And Substance Use Disorders Committee Vote",7,0,0,0,7
1959858,1504957,2025-03-04,Senate,"Senate Veterans, Homeland Security And Military Affairs Committee Vote",9,0,0,0,9
1959858,1570781,2025-05-13,Senate,"Senate Finance Committee Vote",22,0,0,0,22
1959883,1574850,2025-05-20,Senate,"Senate Codes Committee Vote",9,4,0,0,13
1959961,1559301,2025-04-28,Assembly,"Assembly Codes Committee: Favorable refer to committee Ways and Means",15,6,0,1,22
1960095,1504821,2025-03-03,Senate,"Senate Housing, Construction And Community Development Committee Vote",9,2,0,0,11
1960095,1587171,2025-06-09,Senate,"Senate Rules Committee Vote",18,3,0,0,21
1960095,1588394,2025-06-10,Senate,"Senate Floor Vote - Final Passage",49,9,0,5,63
1960157,1574680,2025-05-20,Assembly,"Assembly Higher Education Committee: Favorable refer to committee Codes",23,0,0,3,26
1960157,1586905,2025-06-09,Assembly,"Assembly Codes Committee: Favorable refer to committee Ways and Means",20,0,0,2,22
1960157,1589766,2025-06-12,Assembly,"Assembly Ways And Means Committee: Favorable refer to committee Rules",34,0,0,1,35
1960157,1590667,2025-06-13,Assembly,"Assembly Rules Committee: Favorable",29,0,0,2,31
1960191,1587089,2025-05-27,Senate,"Senate Civil Service And Pensions Committee Vote",6,0,0,1,7
1960191,1587090,2025-06-09,Senate,"Senate Floor Vote - Final Passage",62,0,0,1,63
1960191,1589609,2025-06-11,Assembly,"Assembly Floor Vote - Final Passage",146,0,0,4,150
1960256,1574587,2025-05-20,Senate,"Senate Cities 1 Committee Vote",7,0,0,0,7
1960256,1590103,2025-06-12,Senate,"Senate Rules Committee Vote",20,0,0,1,21
1960256,1590319,2025-06-13,Senate,"Senate Floor Vote - Final Passage",59,0,0,4,63
1960256,1592671,2025-06-16,Assembly,"Assembly Floor Vote - Final Passage",145,0,0,5,150
1960267,1574638,2025-05-20,Assembly,"Assembly Higher Education Committee: Held for Consideration",15,8,0,3,26
1960276,1579744,2025-05-28,Assembly,"Assembly Transportation Committee: Held for Consideration",16,7,0,3,26
1961934,1571021,2025-05-13,Senate,"Senate Corporations, Authorities And Commissions Committee Vote",7,0,0,0,7
1962146,1587785,2025-02-25,Senate,"Senate Crime Victims, Crime And Correction Committee Vote",7,0,0,0,7
1962146,1588376,2025-06-10,Senate,"Senate Floor Vote - Final Passage",37,21,0,5,63
1962169,1574336,2025-05-20,Assembly,"Assembly Mental Health Committee: Favorable refer to committee Ways and Means",13,0,0,0,13
1962402,1553402,2025-04-02,Senate,"Senate Environmental Conservation Committee Vote",11,0,0,0,11
1962402,1553403,2025-04-22,Senate,"Senate Floor Vote - Final Passage",53,0,0,9,62
1962476,1519886,2025-03-18,Senate,"Senate Civil Service And Pensions Committee Vote",7,0,0,0,7
1962528,1534584,2025-04-02,Senate,"Senate Civil Service And Pensions Committee Vote",7,0,0,0,7
1962639,1589909,2025-03-25,Senate,"Senate Corporations, Authorities And Commissions Committee Vote",7,0,0,0,7
1962639,1590647,2025-06-12,Senate,"Senate Floor Vote - Final Passage",55,4,0,4,63
1962737,1584825,2025-05-13,Senate,"Senate Health Committee Vote",13,0,0,1,14
1962737,1584826,2025-06-04,Senate,"Senate Floor Vote - Final Passage",58,0,0,5,63
1962737,1589403,2025-06-11,Assembly,"Assembly Floor Vote - Final Passage",146,0,0,4,150
1962767,1499722,2025-02-25,Senate,"Senate Energy And Telecommunications Committee Vote",7,2,0,0,9
1963392,1499721,2025-02-25,Senate,"Senate Energy And Telecommunications Committee Vote",9,0,0,0,9
1963397,1519874,2025-03-18,Senate,"Senate Civil Service And Pensions Committee Vote",7,0,0,0,7
1963397,1590891,2025-06-12,Senate,"Senate Rules Committee Vote",20,0,0,1,21
1963397,1590892,2025-06-13,Senate,"Senate Floor Vote - Final Passage",59,0,0,4,63
1963397,1592299,2025-06-16,Assembly,"Assembly Floor Vote - Final Passage",145,0,0,5,150
1963399,1570538,2025-04-08,Senate,"Senate Labor Committee Vote",13,0,0,0,13
1963399,1570539,2025-05-12,Senate,"Senate Floor Vote - Final Passage",56,1,0,5,62
1963440,1505528,2025-02-25,Senate,"Senate Judiciary Committee Vote",13,6,0,0,19
1963440,1505529,2025-03-04,Senate,"Senate Floor Vote - Final Passage",39,22,0,2,63
1963441,1581303,2025-05-28,Senate,"Senate Procurement And Contracts Committee Vote",6,0,0,1,7
1963478,1516977,2025-03-12,Senate,"Senate Budget And Revenue Committee Vote",6,0,0,1,7
1963502,1563394,2025-04-29,Senate,"Senate Health Committee Vote",14,0,0,0,14
1963534,1534547,2025-04-02,Senate,"Senate Civil Service And Pensions Committee Vote",7,0,0,0,7
1963534,1589329,2025-06-11,Senate,"Senate Floor Vote - Final Passage",59,0,0,4,63
1963534,1589330,2025-06-11,Senate,"Senate Rules Committee Vote",20,0,0,1,21
1963534,1592388,2025-06-17,Assembly,"Assembly Floor Vote - Final Passage",141,0,0,9,150
1963565,1521125,2025-03-04,Senate,"Senate Agriculture Committee Vote",9,0,0,0,9
1963565,1522217,2025-03-19,Senate,"Senate Floor Vote - Final Passage",60,0,0,3,63
1963565,1592267,2025-06-16,Assembly,"Assembly Floor Vote - Final Passage",145,0,0,5,150
1963575,1574652,2025-05-20,Assembly,"Assembly Codes Committee: Favorable refer to committee Rules",20,0,0,2,22
1963575,1574910,2025-05-21,Assembly,"Assembly Rules Committee: Favorable",29,0,0,2,31
1963575,1575836,2025-05-21,Assembly,"Assembly Floor Vote - Final Passage",144,0,0,6,150
1963577,1562655,2025-04-30,Assembly,"Assembly Labor Committee: Favorable",28,0,0,1,29
1963577,1565430,2025-05-05,Assembly,"Assembly Floor Vote - Final Passage",147,0,0,3,150
1963577,1587187,2025-06-09,Senate,"Senate Floor Vote - Final Passage",61,1,0,1,63
1963584,1589927,2025-05-28,Senate,"Senate Consumer Protection Committee Vote",7,0,0,0,7
1963584,1590427,2025-06-12,Senate,"Senate Floor Vote - Final Passage",56,3,0,4,63
1963593,1590818,2025-06-13,Assembly,"Assembly Rules Committee: Favorable",29,0,0,2,31
1963593,1590819,2025-06-13,Assembly,"Assembly Ways And Means Committee: Favorable refer to committee Rules",32,0,0,3,35
1963598,1571008,2025-05-13,Senate,"Senate Transportation Committee Vote",13,0,0,0,13
1963654,1571342,2025-05-14,Senate,"Senate Labor Committee Vote",10,3,0,0,13
1963654,1581449,2025-05-29,Senate,"Senate Rules Committee Vote",13,7,0,1,21
1963654,1587121,2025-06-09,Senate,"Senate Floor Vote - Final Passage",40,22,0,1,63
1963726,1588832,2025-05-22,Senate,"Senate Alcoholism And Substance Use Disorders Committee Vote",7,0,0,0,7
1963726,1589256,2025-06-11,Senate,"Senate Floor Vote - Final Passage",49,10,0,4,63
1963780,1574082,2025-05-20,Assembly,"Assembly Environmental Conservation Committee: Favorable refer to committee Codes",24,6,0,0,30
1963780,1580172,2025-05-28,Assembly,"Assembly Codes Committee: Favorable refer to committee Rules",15,6,0,1,22
1963780,1581178,2025-05-29,Assembly,"Assembly Rules Committee: Favorable",18,9,0,4,31
1963780,1586108,2025-06-05,Assembly,"Assembly Floor Vote - Final Passage",100,45,0,5,150
1963780,1589638,2025-06-11,Senate,"Senate Floor Vote - Final Passage",43,16,0,4,63
1963790,1579164,2025-05-27,Assembly,"Assembly Governmental Operations Committee: Held for Consideration",10,4,0,0,14
1963868,1573872,2025-05-20,Assembly,"Assembly Agriculture Committee: Favorable refer to committee Ways and Means",23,0,0,0,23
1963868,1580932,2025-05-29,Assembly,"Assembly Ways And Means Committee: Favorable refer to committee Rules",34,0,0,1,35
1963868,1584892,2025-06-04,Assembly,"Assembly Rules Committee: Favorable",28,0,0,3,31
1963874,1580613,2025-05-28,Assembly,"Assembly Environmental Conservation Committee: Favorable refer to committee Rules",26,3,0,1,30
1963874,1593647,2025-06-16,Assembly,"Assembly Rules Committee: Favorable",29,0,0,2,31
1963876,1587129,2025-06-09,Senate,"Senate Floor Vote - Final Passage",49,13,0,1,63
1963876,1587130,2025-06-09,Senate,"Senate Rules Committee Vote",19,2,0,0,21
1963891,1588760,2025-05-27,Senate,"Senate Transportation Committee Vote",13,0,0,0,13
1963891,1589238,2025-06-11,Senate,"Senate Floor Vote - Final Passage",59,0,0,4,63
1963904,1591600,2025-06-17,Assembly,"Assembly Ways And Means Committee: Favorable refer to committee Rules",31,1,0,3,35
1963904,1591973,2025-06-17,Assembly,"Assembly Rules Committee: Favorable",28,0,0,3,31
1963905,1589844,2025-06-12,Assembly,"Assembly Ways And Means Committee: Favorable refer to committee Rules",32,2,0,1,35
1963905,1591949,2025-06-17,Assembly,"Assembly Rules Committee: Favorable",28,0,0,3,31
1963925,1559287,2025-04-28,Assembly,"Assembly Consumer Affairs And Protection Committee: Favorable refer to committee Codes",14,0,0,2,16
1963952,1591502,2025-06-17,Assembly,"Assembly Ways And Means Committee: Favorable refer to committee Rules",31,1,0,3,35
1963952,1591941,2025-06-17,Assembly,"Assembly Rules Committee: Favorable",28,0,0,3,31
1963998,1581647,2025-05-28,Senate,"Senate Investigations And Government Operations Committee Vote",5,2,0,0,7
1964081,1580235,2025-05-28,Assembly,"Assembly Governmental Employees Committee: Favorable refer to committee Ways and Means",14,0,0,0,14
1964815,1560476,2025-04-29,Senate,"Senate Civil Service And Pensions Committee Vote",7,0,0,0,7
1964839,1519891,2025-03-18,Senate,"Senate Civil Service And Pensions Committee Vote",7,0,0,0,7
1964860,1560845,2025-04-29,Senate,"Senate Veterans, Homeland Security And Military Affairs Committee Vote",9,0,0,0,9
1964884,1519610,2025-03-18,Senate,"Senate Civil Service And Pensions Committee Vote",7,0,0,0,7
1964892,1556476,2025-03-04,Senate,"Senate Higher Education Committee Vote",11,0,0,0,11
1964892,1556477,2025-04-24,Senate,"Senate Floor Vote - Final Passage",41,10,0,11,62
1964892,1587984,2025-06-10,Senate,"Senate Floor Vote - Final Passage",46,12,0,5,63
1964892,1591263,2025-06-13,Assembly,"Assembly Floor Vote - Final Passage",105,28,0,17,150
1964934,1581033,2025-05-20,Senate,"Senate Transportation Committee Vote",13,0,0,0,13
1964934,1581034,2025-05-29,Senate,"Senate Floor Vote - Final Passage",55,1,0,7,63
1965080,1590737,2025-06-12,Senate,"Senate Floor Vote - Final Passage",43,16,0,4,63
1965118,1570938,2025-05-13,Senate,"Senate Higher Education Committee Vote",11,0,0,0,11
1965203,1574851,2025-05-20,Senate,"Senate Women's Issues Committee Vote",7,0,0,0,7
1965317,1519994,2025-03-18,Senate,"Senate Civil Service And Pensions Committee Vote",7,0,0,0,7
1965384,1573425,2025-05-19,Assembly,"Assembly Banks Committee: Favorable refer to committee Rules",27,0,0,4,31
1965384,1586054,2025-06-06,Assembly,"Assembly Rules Committee: Favorable",27,0,0,4,31
1965384,1587447,2025-06-09,Assembly,"Assembly Floor Vote - Final Passage",105,37,0,8,150
1966049,1570422,2025-05-13,Assembly,"Assembly Codes Committee: Held for Consideration",16,6,0,0,22
1966239,1558933,2025-02-25,Senate,"Senate Banks Committee Vote",7,0,0,0,7
1966239,1558934,2025-04-28,Senate,"Senate Floor Vote - Final Passage",60,0,0,2,62
1966239,1584725,2025-06-04,Senate,"Senate Floor Vote - Final Passage",58,0,0,5,63
1966255,1575118,2025-05-20,Senate,"Senate Civil Service And Pensions Committee Vote",6,1,0,0,7
1966283,1519989,2025-03-18,Senate,"Senate Civil Service And Pensions Committee Vote",7,0,0,0,7
1966283,1590185,2025-06-12,Senate,"Senate Rules Committee Vote",20,0,0,1,21
1966283,1590355,2025-06-13,Senate,"Senate Floor Vote - Final Passage",59,0,0,4,63
1966283,1592682,2025-06-16,Assembly,"Assembly Floor Vote - Final Passage",145,0,0,5,150
1966290,1574841,2025-05-20,Senate,"Senate Health Committee Vote",13,0,0,1,14
1966298,1571935,2025-05-15,Senate,"Senate Alcoholism And Substance Use Disorders Committee Vote",7,0,0,0,7
1966311,1566476,2025-05-06,Assembly,"Assembly Corporations, Authorities And Commissions Committee: Favorable",18,7,0,1,26
1966311,1580081,2025-05-22,Assembly,"Assembly Floor Vote - Final Passage",136,2,0,12,150
1966327,1572132,2025-03-05,Senate,"Senate Mental Health Committee Vote",7,0,0,0,7
1966327,1572133,2025-05-15,Senate,"Senate Floor Vote - Final Passage",51,1,0,10,62
1966397,1593591,2025-06-16,Assembly,"Assembly Rules Committee: Favorable",29,0,0,2,31
1966397,1593592,2025-06-16,Assembly,"Assembly Ways And Means Committee: Favorable refer to committee Rules",32,0,0,3,35
1966414,1570430,2025-05-13,Assembly,"Assembly Codes Committee: Held for Consideration",16,6,0,0,22
1966443,1579002,2025-05-27,Assembly,"Assembly Health Committee: Favorable refer to committee Ways and Means",26,0,0,0,26
1966443,1585931,2025-06-06,Assembly,"Assembly Ways And Means Committee: Favorable refer to committee Rules",35,0,0,0,35
1966443,1587997,2025-06-10,Assembly,"Assembly Rules Committee: Favorable",28,0,0,3,31
1966443,1588893,2025-06-10,Assembly,"Assembly Floor Vote - Final Passage",147,0,0,3,150
1966590,1579973,2025-05-28,Assembly,"Assembly Insurance Committee: Favorable refer to committee Ways and Means",20,4,0,1,25
1966597,1579206,2025-05-27,Senate,"Senate Civil Service And Pensions Committee Vote",6,0,0,1,7
1966597,1590854,2025-06-12,Senate,"Senate Floor Vote - Final Passage",59,0,0,4,63
1966597,1595106,2025-06-12,Senate,"Senate Rules Committee Vote",20,0,0,1,21
1966621,1560939,2025-04-08,Senate,"Senate Cultural Affairs, Tourism, Parks And Recreation Committee Vote",6,1,0,0,7
1966621,1560940,2025-04-29,Senate,"Senate Floor Vote - Final Passage",44,17,0,1,62
1966621,1581021,2025-05-29,Senate,"Senate Floor Vote - Final Passage",44,12,0,7,63
1966629,1540172,2025-04-08,Senate,"Senate Civil Service And Pensions Committee Vote",7,0,0,0,7
1966990,1589801,2025-05-05,Senate,"Senate Codes Committee Vote",12,1,0,0,13
1966990,1590307,2025-06-12,Senate,"Senate Floor Vote - Final Passage",58,1,0,4,63
1966992,1586205,2025-03-25,Senate,"Senate Codes Committee Vote",11,1,0,1,13
1966992,1586206,2025-06-06,Senate,"Senate Floor Vote - Final Passage",48,5,0,10,63
1967025,1580614,2025-05-28,Assembly,"Assembly Election Law Committee: Held for Consideration",10,5,0,1,16
1967034,1573293,2025-05-19,Assembly,"Assembly Veterans' Affairs Committee: Favorable refer to committee Ways and Means",18,0,0,1,19
1967034,1578991,2025-05-27,Assembly,"Assembly Ways And Means Committee: Favorable refer to committee Rules",32,0,0,3,35
1967034,1581147,2025-05-29,Assembly,"Assembly Rules Committee: Favorable",27,0,0,4,31
1967034,1582094,2025-05-29,Assembly,"Assembly Floor Vote - Final Passage",146,0,0,4,150
1967034,1588186,2025-06-10,Senate,"Senate Floor Vote - Final Passage",58,0,0,5,63
1967061,1570459,2025-05-13,Assembly,"Assembly Environmental Conservation Committee: Favorable refer to committee Codes",20,7,0,3,30
1967061,1574693,2025-05-20,Assembly,"Assembly Codes Committee: Favorable refer to committee Ways and Means",14,6,0,2,22
1967063,1540128,2025-04-08,Senate,"Senate Agriculture Committee Vote",9,0,0,0,9
1967063,1560932,2025-04-29,Senate,"Senate Finance Committee Vote",22,0,0,0,22
1967063,1565529,2025-05-06,Senate,"Senate Floor Vote - Final Passage",60,1,0,1,62
1967076,1580627,2025-05-28,Assembly,"Assembly Election Law Committee: Favorable refer to committee Rules",11,4,0,1,16
1967076,1581532,2025-05-29,Assembly,"Assembly Rules Committee: Favorable",19,8,0,4,31
1967076,1589826,2025-06-11,Assembly,"Assembly Floor Vote - Final Passage",97,42,0,11,150
1967090,1586099,2025-06-06,Assembly,"Assembly Ways And Means Committee: Held for Consideration",20,15,0,0,35
1967095,1579751,2025-05-28,Assembly,"Assembly Transportation Committee: Held for Consideration",16,7,0,3,26
1967105,1570442,2025-05-13,Assembly,"Assembly Environmental Conservation Committee: Favorable refer to committee Ways and Means",27,0,0,3,30
1967105,1585235,2025-06-04,Assembly,"Assembly Ways And Means Committee: Favorable refer to committee Rules",33,0,0,2,35
1967105,1586904,2025-06-09,Assembly,"Assembly Rules Committee: Favorable",25,0,0,6,31
1967105,1587246,2025-06-09,Assembly,"Assembly Floor Vote - Final Passage",144,0,0,6,150
1967105,1588046,2025-06-10,Senate,"Senate Floor Vote - Final Passage",58,0,0,5,63
1967123,1574787,2025-03-10,Senate,"Senate Codes Committee Vote",13,0,0,0,13
1967123,1574788,2025-05-19,Senate,"Senate Floor Vote - Final Passage",53,3,0,6,62
1967133,1589876,2025-06-12,Assembly,"Assembly Ways And Means Committee: Held for Consideration",24,10,0,1,35
1967137,1519711,2025-03-18,Assembly,"Assembly Judiciary Committee: Favorable",21,0,0,0,21
1967137,1526124,2025-03-24,Assembly,"Assembly Floor Vote - Final Passage",147,0,0,3,150
1967137,1586164,2025-06-05,Senate,"Senate Floor Vote - Final Passage",59,1,0,3,63
1967152,1532034,2025-04-01,Assembly,"Assembly Rules Committee: Favorable",30,0,0,1,31
1967152,1532035,2025-04-01,Assembly,"Assembly Ways And Means Committee: Favorable refer to committee Rules",31,2,0,2,35
1967152,1535712,2025-04-02,Assembly,"Assembly Floor Vote - Final Passage",111,37,0,2,150
1967152,1599249,2025-05-27,Senate,"Senate Floor Vote - Final Passage",46,13,0,4,63
1967159,1586068,2025-06-06,Assembly,"Assembly Ways And Means Committee: Held for Consideration",20,15,0,0,35
1967161,1566873,2025-03-18,Senate,"Senate Local Government Committee Vote",5,2,0,0,7
1967161,1566874,2025-05-06,Senate,"Senate Floor Vote - Final Passage",41,20,0,1,62
1967187,1497839,2025-02-24,Assembly,"Assembly Higher Education Committee: Favorable refer to committee Rules",16,8,0,2,26
1967187,1498613,2025-02-25,Assembly,"Assembly Rules Committee: Favorable",19,8,0,4,31
1967187,1507008,2025-03-05,Assembly,"Assembly Floor Vote - Final Passage",96,51,0,3,150
1967187,1509133,2025-03-10,Senate,"Senate Floor Vote - Final Passage",40,21,0,2,63
1967199,1585261,2025-05-29,Senate,"Senate Rules Committee Vote",20,0,0,1,21
1967199,1585262,2025-06-04,Senate,"Senate Floor Vote - Final Passage",58,0,0,5,63
1967204,1574507,2025-05-20,Assembly,"Assembly Economic Development Committee: Held for Consideration",17,6,0,3,26
1967216,1573912,2025-05-20,Assembly,"Assembly Education Committee: Favorable refer to committee Rules",28,0,0,3,31
1967216,1575296,2025-05-21,Assembly,"Assembly Rules Committee: Favorable",29,0,0,2,31
1967234,1585416,2025-06-05,Assembly,"Assembly Codes Committee: Favorable refer to committee Ways and Means",15,6,0,1,22
1967234,1590782,2025-06-13,Assembly,"Assembly Rules Committee: Favorable",29,0,0,2,31
1967234,1590783,2025-06-13,Assembly,"Assembly Ways And Means Committee: Favorable refer to committee Rules",31,1,0,3,35
1967244,1527326,2025-03-04,Senate,"Senate Disabilities Committee Vote",7,0,0,0,7
1967244,1527327,2025-03-25,Senate,"Senate Floor Vote - Final Passage",62,0,0,1,63
1967275,1579179,2025-05-27,Assembly,"Assembly Health Committee: Favorable refer to committee Codes",18,8,0,0,26
1967275,1585541,2025-06-05,Assembly,"Assembly Codes Committee: Favorable refer to committee Ways and Means",15,6,0,1,22
1967275,1591428,2025-06-16,Assembly,"Assembly Rules Committee: Favorable",20,9,0,2,31
1967275,1591429,2025-06-16,Assembly,"Assembly Ways And Means Committee: Favorable refer to committee Rules",22,10,0,3,35
1967281,1580185,2025-05-28,Assembly,"Assembly Election Law Committee: Held for Consideration",10,5,0,1,16
1967294,1579129,2025-05-27,Assembly,"Assembly Governmental Operations Committee: Held for Consideration",10,4,0,0,14
1967299,1560424,2025-03-10,Senate,"Senate Codes Committee Vote",13,0,0,0,13
1967299,1560425,2025-04-28,Senate,"Senate Floor Vote - Final Passage",60,0,0,2,62
1967299,1582156,2025-05-29,Assembly,"Assembly Floor Vote - Final Passage",144,0,0,6,150
1967325,1570494,2025-05-13,Assembly,"Assembly Codes Committee: Held for Consideration",16,6,0,0,22
1967333,1581652,2025-05-28,Senate,"Senate Procurement And Contracts Committee Vote",6,0,0,1,7
1967364,1534676,2025-04-02,Senate,"Senate Civil Service And Pensions Committee Vote",7,0,0,0,7
1967364,1570780,2025-05-13,Senate,"Senate Finance Committee Vote",22,0,0,0,22
1967462,1566509,2025-05-06,Assembly,"Assembly Cities Committee: Favorable refer to committee Ways and Means",14,0,0,2,16
1967462,1574685,2025-05-20,Assembly,"Assembly Ways And Means Committee: Favorable refer to committee Rules",31,4,0,0,35
1967462,1574932,2025-05-21,Assembly,"Assembly Rules Committee: Favorable",29,0,0,2,31
1967462,1575854,2025-05-21,Assembly,"Assembly Floor Vote - Final Passage",119,25,0,6,150
1967462,1580691,2025-05-28,Senate,"Senate Floor Vote - Final Passage",60,1,0,2,63
1967477,1520200,2025-03-04,Senate,"Senate Agriculture Committee Vote",9,0,0,0,9
1967477,1520201,2025-03-18,Senate,"Senate Floor Vote - Final Passage",61,0,0,2,63
1967489,1499854,2025-02-26,Assembly,"Assembly Education Committee: Favorable refer to committee Ways and Means",26,0,0,5,31
1967489,1561308,2025-04-29,Assembly,"Assembly Ways And Means Committee: Favorable refer to committee Rules",32,0,0,3,35
1967489,1561795,2025-04-30,Assembly,"Assembly Rules Committee: Favorable",29,0,0,2,31
1967495,1562348,2025-04-30,Assembly,"Assembly Banks Committee: Favorable refer to committee Ways and Means",20,8,0,3,31
1967495,1579410,2025-05-27,Assembly,"Assembly Ways And Means Committee: Favorable refer to committee Rules",22,10,0,3,35
1968374,1500270,2025-02-25,Senate,"Senate Judiciary Committee Vote",19,0,0,0,19
1968374,1560936,2025-04-29,Senate,"Senate Finance Committee Vote",22,0,0,0,22
1968374,1589136,2025-06-10,Senate,"Senate Floor Vote - Final Passage",57,1,0,5,63
1968416,1587169,2025-06-09,Senate,"Senate Floor Vote - Final Passage",62,0,0,1,63
1968416,1587170,2025-06-09,Senate,"Senate Rules Committee Vote",21,0,0,0,21
1968427,1560250,2025-04-29,Senate,"Senate Local Government Committee Vote",7,0,0,0,7
1968427,1590300,2025-06-12,Senate,"Senate Rules Committee Vote",20,0,0,1,21
1968427,1590841,2025-06-13,Senate,"Senate Floor Vote - Final Passage",59,0,0,4,63
1968427,1592281,2025-06-16,Assembly,"Assembly Floor Vote - Final Passage",143,2,0,5,150
1968457,1588711,2025-04-08,Senate,"Senate Health Committee Vote",12,2,0,1,15
1968457,1588712,2025-06-10,Senate,"Senate Floor Vote - Final Passage",44,14,0,5,63
1968460,1527809,2025-03-25,Senate,"Senate Judiciary Committee Vote",18,0,0,1,19
1968460,1580896,2025-05-28,Senate,"Senate Finance Committee Vote",22,0,0,0,22
1968460,1587095,2025-06-09,Senate,"Senate Floor Vote - Final Passage",61,1,0,1,63
1968467,1571473,2025-05-13,Senate,"Senate Procurement And Contracts Committee Vote",5,2,0,0,7
1968517,1505966,2025-03-04,Senate,"Senate Health Committee Vote",15,0,0,0,15
1968568,1565506,2025-04-29,Senate,"Senate Transportation Committee Vote",13,0,0,0,13
1968568,1565507,2025-05-06,Senate,"Senate Floor Vote - Final Passage",61,0,0,1,62
1968640,1579204,2025-05-27,Senate,"Senate Corporations, Authorities And Commissions Committee Vote",6,0,0,1,7
1968640,1585511,2025-06-04,Senate,"Senate Rules Committee Vote",20,0,0,1,21
1968640,1590880,2025-06-09,Senate,"Senate Floor Vote - Final Passage",62,0,0,1,63
1968651,1505839,2025-03-04,Senate,"Senate Disabilities Committee Vote",7,0,0,0,7
1968675,1521658,2025-03-03,Senate,"Senate Housing, Construction And Community Development Committee Vote",9,2,0,0,11
1968675,1521659,2025-03-19,Senate,"Senate Floor Vote - Final Passage",42,18,0,3,63
1968720,1519236,2025-03-04,Senate,"Senate Aging Committee Vote",7,0,0,0,7
1968720,1519237,2025-03-17,Senate,"Senate Floor Vote - Final Passage",61,0,0,2,63
1968733,1590153,2025-06-04,Senate,"Senate Rules Committee Vote",19,1,0,1,21
1968733,1590445,2025-06-12,Senate,"Senate Floor Vote - Final Passage",55,4,0,4,63
1968733,1592404,2025-06-16,Assembly,"Assembly Floor Vote - Final Passage",136,8,0,6,150
1968743,1579215,2025-05-27,Senate,"Senate Disabilities Committee Vote",6,0,0,0,6
1968751,1516651,2025-03-03,Senate,"Senate Insurance Committee Vote",11,0,0,0,11
1968751,1516652,2025-03-12,Senate,"Senate Floor Vote - Final Passage",60,0,0,3,63
1968782,1519892,2025-03-03,Senate,"Senate Labor Committee Vote",13,0,0,0,13
1968782,1519893,2025-03-18,Senate,"Senate Floor Vote - Final Passage",61,0,0,2,63
1968790,1543065,2025-03-03,Senate,"Senate Labor Committee Vote",13,0,0,0,13
1968790,1543066,2025-04-09,Senate,"Senate Floor Vote - Final Passage",59,1,0,3,63
1968839,1579571,2025-04-29,Senate,"Senate Investigations And Government Operations Committee Vote",7,0,0,0,7
1968839,1592389,2025-05-27,Senate,"Senate Floor Vote - Final Passage",51,8,0,4,63
1968839,1592390,2025-06-17,Assembly,"Assembly Floor Vote - Final Passage",105,29,0,16,150
1968898,1570520,2025-05-13,Assembly,"Assembly Codes Committee: Held for Consideration",16,6,0,0,22
1968906,1573835,2025-05-20,Assembly,"Assembly Children And Families Committee: Favorable refer to committee Codes",15,1,0,1,17
1968906,1580385,2025-05-28,Assembly,"Assembly Codes Committee: Favorable refer to committee Ways and Means",21,0,0,1,22
1968912,1574337,2025-05-20,Assembly,"Assembly Insurance Committee: Favorable refer to committee Rules",25,0,0,0,25
1968912,1579329,2025-05-27,Assembly,"Assembly Rules Committee: Favorable",26,0,0,5,31
1968912,1579688,2025-05-27,Assembly,"Assembly Floor Vote - Final Passage",145,0,0,5,150
1968912,1590566,2025-06-12,Senate,"Senate Floor Vote - Final Passage",59,0,0,4,63
1968967,1579187,2025-05-27,Assembly,"Assembly Education Committee: Favorable refer to committee Ways and Means",28,0,0,3,31
1968967,1590757,2025-06-13,Assembly,"Assembly Rules Committee: Favorable",29,0,0,2,31
1968967,1590758,2025-06-13,Assembly,"Assembly Ways And Means Committee: Favorable refer to committee Rules",32,0,0,3,35
1969020,1580876,2025-05-28,Senate,"Senate Veterans, Homeland Security And Military Affairs Committee Vote",9,0,0,0,9
1969020,1587139,2025-06-09,Senate,"Senate Rules Committee Vote",19,2,0,0,21
1969020,1588370,2025-06-10,Senate,"Senate Floor Vote - Final Passage",53,5,0,5,63
1969065,1573403,2025-05-19,Assembly,"Assembly Banks Committee: Favorable refer to committee Codes",27,0,0,4,31
1969065,1580403,2025-05-28,Assembly,"Assembly Codes Committee: Favorable refer to committee Rules",21,0,0,1,22
1969065,1581535,2025-05-29,Assembly,"Assembly Rules Committee: Favorable",27,0,0,4,31
1969065,1582205,2025-05-29,Assembly,"Assembly Floor Vote - Final Passage",146,0,0,4,150
1969065,1585791,2025-06-05,Senate,"Senate Floor Vote - Final Passage",55,5,0,3,63
1969104,1573907,2025-05-20,Assembly,"Assembly Education Committee: Favorable refer to committee Ways and Means",28,0,0,3,31
1969104,1588502,2025-06-11,Assembly,"Assembly Ways And Means Committee: Favorable refer to committee Rules",34,0,0,1,35
1969104,1591607,2025-06-17,Assembly,"Assembly Rules Committee: Favorable",30,0,0,1,31
1969112,1591605,2025-06-17,Assembly,"Assembly Ways And Means Committee: Favorable refer to committee Rules",32,0,0,3,35
1969112,1591972,2025-06-17,Assembly,"Assembly Rules Committee: Favorable",28,0,0,3,31
1969139,1532036,2025-04-01,Assembly,"Assembly Rules Committee: Favorable",30,0,0,1,31
1969139,1532037,2025-04-01,Assembly,"Assembly Ways And Means Committee: Favorable refer to committee Rules",31,2,0,2,35
1969139,1535714,2025-04-02,Assembly,"Assembly Floor Vote - Final Passage",111,37,0,2,150
1969139,1580695,2025-05-27,Senate,"Senate Floor Vote - Final Passage",50,9,0,4,63
1969144,1571049,2025-05-14,Senate,"Senate Labor Committee Vote",13,0,0,0,13
1969144,1582014,2025-05-29,Senate,"Senate Energy And Telecommunications Committee Vote",9,0,0,0,9
1969144,1590565,2025-06-12,Senate,"Senate Floor Vote - Final Passage",59,0,0,4,63
1969236,1532038,2025-04-01,Assembly,"Assembly Rules Committee: Favorable",30,0,0,1,31
1969236,1532039,2025-04-01,Assembly,"Assembly Ways And Means Committee: Favorable refer to committee Rules",26,7,0,2,35
1969236,1535716,2025-04-02,Assembly,"Assembly Floor Vote - Final Passage",105,43,0,2,150
1969236,1579558,2025-05-27,Senate,"Senate Floor Vote - Final Passage",50,9,0,4,63
1969254,1505893,2025-03-04,Senate,"Senate Disabilities Committee Vote",7,0,0,0,7
1969254,1580870,2025-05-28,Senate,"Senate Finance Committee Vote",22,0,0,0,22
1969254,1588179,2025-06-10,Senate,"Senate Floor Vote - Final Passage",58,0,0,5,63
1969271,1574229,2025-05-20,Assembly,"Assembly Insurance Committee: Favorable refer to committee Rules",25,0,0,0,25
1969293,1574495,2025-05-20,Assembly,"Assembly Local Governments Committee: Favorable refer to committee Ways and Means",18,0,0,2,20
1969293,1579428,2025-05-27,Assembly,"Assembly Ways And Means Committee: Favorable refer to committee Rules",32,0,0,3,35
1969293,1581536,2025-05-29,Assembly,"Assembly Rules Committee: Favorable",27,0,0,4,31
1969293,1582202,2025-05-29,Assembly,"Assembly Floor Vote - Final Passage",146,0,0,4,150
1969293,1588404,2025-06-10,Senate,"Senate Floor Vote - Final Passage",58,0,0,5,63
1969338,1579168,2025-05-27,Senate,"Senate Civil Service And Pensions Committee Vote",6,0,0,1,7
1969411,1579729,2025-05-28,Assembly,"Assembly Transportation Committee: Favorable refer to committee Rules",23,0,0,3,26
1969455,1574449,2025-05-20,Assembly,"Assembly Economic Development Committee: Favorable refer to committee Codes",23,0,0,3,26
1969455,1580443,2025-05-28,Assembly,"Assembly Codes Committee: Favorable refer to committee Ways and Means",21,0,0,1,22
1969455,1585224,2025-06-04,Assembly,"Assembly Ways And Means Committee: Favorable refer to committee Rules",33,0,0,2,35
1969455,1585996,2025-06-06,Assembly,"Assembly Rules Committee: Favorable",27,0,0,4,31
1969455,1586802,2025-06-06,Assembly,"Assembly Floor Vote - Final Passage",143,0,0,7,150
1969473,1579160,2025-05-27,Assembly,"Assembly Real Property Taxation Committee: Favorable refer to committee Ways and Means",9,0,0,1,10
1969473,1585178,2025-06-04,Assembly,"Assembly Ways And Means Committee: Favorable refer to committee Rules",32,1,0,2,35
1969473,1585982,2025-06-06,Assembly,"Assembly Rules Committee: Favorable",27,0,0,4,31
1969473,1586578,2025-06-06,Assembly,"Assembly Floor Vote - Final Passage",139,4,0,7,150
1969473,1590369,2025-06-12,Senate,"Senate Floor Vote - Final Passage",58,1,0,4,63
1969527,1589883,2025-06-12,Assembly,"Assembly Ways And Means Committee: Held for Consideration",24,10,0,1,35
1969561,1578918,2025-05-27,Assembly,"Assembly Consumer Affairs And Protection Committee: Favorable refer to committee Codes",15,0,0,1,16
1969561,1591423,2025-06-16,Assembly,"Assembly Rules Committee: Favorable",29,0,0,2,31
1969561,1591424,2025-06-16,Assembly,"Assembly Ways And Means Committee: Favorable refer to committee Rules",32,0,0,3,35
1969643,1499380,2025-02-25,Senate,"Senate Cities 1 Committee Vote",6,1,0,0,7
1969730,1574065,2025-05-20,Assembly,"Assembly Environmental Conservation Committee: Held for Consideration",21,9,0,0,30
1969760,1561290,2025-04-29,Assembly,"Assembly Ways And Means Committee: Favorable refer to committee Rules",30,2,0,3,35
1969760,1561788,2025-04-30,Assembly,"Assembly Rules Committee: Favorable",29,0,0,2,31
1969760,1563424,2025-04-30,Assembly,"Assembly Floor Vote - Final Passage",107,38,0,5,150
1969760,1579560,2025-05-27,Senate,"Senate Floor Vote - Final Passage",51,8,0,4,63
1969832,1574468,2025-05-20,Assembly,"Assembly Social Services Committee: Favorable refer to committee Rules",16,0,0,2,18
1969832,1575421,2025-05-21,Assembly,"Assembly Rules Committee: Favorable",29,0,0,2,31
1969849,1570488,2025-05-13,Assembly,"Assembly Economic Development Committee: Favorable",26,0,0,0,26
1969849,1580184,2025-05-22,Assembly,"Assembly Floor Vote - Final Passage",138,0,0,12,150
1969849,1589355,2025-06-11,Senate,"Senate Floor Vote - Final Passage",58,1,0,4,63
1969853,1590044,2025-06-12,Assembly,"Assembly Rules Committee: Favorable",29,0,0,2,31
1969853,1590045,2025-06-12,Assembly,"Assembly Ways And Means Committee: Favorable refer to committee Rules",34,0,0,1,35
1969896,1532042,2025-04-01,Assembly,"Assembly Rules Committee: Favorable",30,0,0,1,31
1969896,1532043,2025-04-01,Assembly,"Assembly Ways And Means Committee: Favorable refer to committee Rules",31,2,0,2,35
1969896,1535705,2025-04-02,Assembly,"Assembly Floor Vote - Final Passage",112,36,0,2,150
1969896,1579559,2025-05-27,Senate,"Senate Floor Vote - Final Passage",51,8,0,4,63
1969981,1580455,2025-05-28,Assembly,"Assembly Labor Committee: Favorable refer to committee Codes",29,0,0,0,29
1969981,1587051,2025-06-09,Assembly,"Assembly Codes Committee: Favorable refer to committee Rules",18,2,0,2,22
1969981,1587339,2025-06-10,Assembly,"Assembly Rules Committee: Favorable",28,0,0,3,31
1969995,1563892,2025-04-29,Senate,"Senate Health Committee Vote",14,0,0,0,14
1970090,1575801,2025-05-22,Assembly,"Assembly Ways And Means Committee: Favorable refer to committee Rules",29,2,0,4,35
1970090,1590033,2025-06-12,Assembly,"Assembly Rules Committee: Favorable",29,0,0,2,31
1970106,1574378,2025-05-20,Assembly,"Assembly Mental Health Committee: Held for Consideration",9,4,0,0,13
1970180,1578953,2025-05-27,Assembly,"Assembly Health Committee: Favorable refer to committee Rules",26,0,0,0,26
1970180,1581161,2025-05-29,Assembly,"Assembly Rules Committee: Favorable",27,0,0,4,31
1970259,1579337,2025-05-27,Assembly,"Assembly Ways And Means Committee: Favorable refer to committee Rules",31,1,0,3,35
1970259,1581533,2025-05-29,Assembly,"Assembly Rules Committee: Favorable",27,0,0,4,31
1970272,1574109,2025-05-20,Assembly,"Assembly Energy Committee: Favorable refer to committee Rules",12,4,0,1,17
1970591,1499147,2025-02-25,Assembly,"Assembly Mental Health Committee: Favorable",13,0,0,0,13
1970591,1506390,2025-03-04,Assembly,"Assembly Floor Vote - Final Passage",149,0,0,1,150
1970593,1574340,2025-05-20,Assembly,"Assembly Mental Health Committee: Favorable refer to committee Ways and Means",13,0,0,0,13
1970596,1499215,2025-02-25,Assembly,"Assembly Mental Health Committee: Favorable refer to committee Ways and Means",13,0,0,0,13
1970615,1585560,2025-06-05,Assembly,"Assembly Local Governments Committee: Favorable refer to committee Ways and Means",19,0,0,1,20
1970615,1585922,2025-06-06,Assembly,"Assembly Ways And Means Committee: Favorable refer to committee Rules",33,2,0,0,35
1970615,1588547,2025-06-11,Assembly,"Assembly Rules Committee: Favorable",28,0,0,3,31
1970643,1519896,2025-03-18,Senate,"Senate Civil Service And Pensions Committee Vote",7,0,0,0,7
1970643,1590236,2025-06-12,Senate,"Senate Rules Committee Vote",20,0,0,1,21
1970643,1590710,2025-06-13,Senate,"Senate Floor Vote - Final Passage",59,0,0,4,63
1970648,1585937,2025-06-06,Assembly,"Assembly Ways And Means Committee: Held for Consideration",25,10,0,0,35
1970666,1519917,2025-03-18,Senate,"Senate Civil Service And Pensions Committee Vote",7,0,0,0,7
1970672,1587566,2025-06-09,Senate,"Senate Rules Committee Vote",21,0,0,0,21
1970672,1588358,2025-06-10,Senate,"Senate Floor Vote - Final Passage",58,0,0,5,63
1970674,1574303,2025-05-20,Assembly,"Assembly Judiciary Committee: Favorable refer to committee Codes",13,7,0,1,21
1970674,1579993,2025-05-28,Assembly,"Assembly Codes Committee: Favorable refer to committee Rules",15,6,0,1,22
1970674,1581128,2025-05-29,Assembly,"Assembly Rules Committee: Favorable",18,9,0,4,31
1970675,1560853,2025-04-29,Senate,"Senate Disabilities Committee Vote",6,0,0,0,6
1970680,1574250,2025-05-20,Assembly,"Assembly Children And Families Committee: Favorable refer to committee Ways and Means",16,0,0,1,17
1970680,1579380,2025-05-27,Assembly,"Assembly Ways And Means Committee: Favorable refer to committee Rules",32,0,0,3,35
1970680,1581102,2025-05-29,Assembly,"Assembly Rules Committee: Favorable",27,0,0,4,31
1970687,1570858,2025-05-13,Assembly,"Assembly Ways And Means Committee: Favorable",32,2,0,1,35
1970687,1574009,2025-05-19,Assembly,"Assembly Floor Vote - Final Passage",104,39,0,7,150
1970687,1599243,2025-05-27,Senate,"Senate Floor Vote - Final Passage",46,13,0,4,63
1970695,1586088,2025-06-06,Assembly,"Assembly Ways And Means Committee: Held for Consideration",25,10,0,0,35
1970712,1574125,2025-05-20,Assembly,"Assembly Libraries And Education Technology Committee: Favorable refer to committee Ways and Means",9,0,0,0,9
1970721,1516713,2025-03-04,Senate,"Senate Disabilities Committee Vote",7,0,0,0,7
1970721,1516714,2025-03-12,Senate,"Senate Floor Vote - Final Passage",60,0,0,3,63
1970726,1573916,2025-05-20,Assembly,"Assembly Education Committee: Held for Consideration",20,8,0,3,31
1970743,1574101,2025-05-20,Assembly,"Assembly Energy Committee: Favorable refer to committee Rules",16,0,0,1,17
1970743,1585216,2025-06-04,Assembly,"Assembly Rules Committee: Favorable",28,0,0,3,31
1970748,1593413,2025-06-16,Assembly,"Assembly Rules Committee: Favorable",29,0,0,2,31
1970748,1593414,2025-06-16,Assembly,"Assembly Ways And Means Committee: Favorable refer to committee Rules",32,0,0,3,35
1970765,1584745,2025-06-04,Assembly,"Assembly Transportation Committee: Favorable refer to committee Ways and Means",22,0,0,4,26
1970765,1586057,2025-06-06,Assembly,"Assembly Ways And Means Committee: Favorable refer to committee Rules",35,0,0,0,35
1970765,1588554,2025-06-11,Assembly,"Assembly Rules Committee: Favorable",28,0,0,3,31
1970765,1589471,2025-06-11,Assembly,"Assembly Floor Vote - Final Passage",146,0,0,4,150
1970765,1590272,2025-06-12,Senate,"Senate Floor Vote - Final Passage",59,0,0,4,63
1970767,1573434,2025-05-19,Assembly,"Assembly Governmental Employees Committee: Held for Consideration",8,5,0,1,14
1970784,1574244,2025-05-20,Assembly,"Assembly Mental Health Committee: Favorable refer to committee Codes",13,0,0,0,13
1970801,1580639,2025-05-28,Assembly,"Assembly Higher Education Committee: Favorable refer to committee Ways and Means",26,0,0,0,26
1970801,1593607,2025-06-16,Assembly,"Assembly Rules Committee: Favorable",29,0,0,2,31
1970801,1593608,2025-06-16,Assembly,"Assembly Ways And Means Committee: Favorable refer to committee Rules",32,0,0,3,35
1970802,1593593,2025-06-16,Assembly,"Assembly Rules Committee: Favorable",29,0,0,2,31
1970802,1593594,2025-06-16,Assembly,"Assembly Ways And Means Committee: Favorable refer to committee Rules",32,0,0,3,35
1970833,1579356,2025-04-29,Senate,"Senate Investigations And Government Operations Committee Vote",7,0,0,0,7
1970833,1580972,2025-05-27,Senate,"Senate Floor Vote - Final Passage",46,13,0,4,63
1970833,1582062,2025-05-29,Assembly,"Assembly Floor Vote - Final Passage",109,37,0,4,150
1970837,1570431,2025-05-13,Assembly,"Assembly Codes Committee: Held for Consideration",16,6,0,0,22
1970856,1590673,2025-06-13,Assembly,"Assembly Rules Committee: Favorable",29,0,0,2,31
1970856,1590674,2025-06-13,Assembly,"Assembly Ways And Means Committee: Favorable refer to committee Rules",30,2,0,3,35
1970859,1593636,2025-06-16,Assembly,"Assembly Rules Committee: Favorable",29,0,0,2,31
1970859,1593637,2025-06-16,Assembly,"Assembly Ways And Means Committee: Favorable refer to committee Rules",22,10,0,3,35
1970861,1560807,2025-04-29,Assembly,"Assembly Mental Health Committee: Favorable refer to committee Ways and Means",13,0,0,0,13
1970869,1579171,2025-05-27,Assembly,"Assembly Governmental Operations Committee: Favorable refer to committee Rules",14,0,0,0,14
1970875,1575828,2025-05-13,Senate,"Senate Children And Families Committee Vote",5,1,0,1,7
1970875,1575829,2025-05-22,Senate,"Senate Floor Vote - Final Passage",37,20,0,5,62
1970875,1592223,2025-06-16,Assembly,"Assembly Floor Vote - Final Passage",94,50,0,6,150
1970877,1559005,2025-03-04,Senate,"Senate Higher Education Committee Vote",11,0,0,0,11
1970877,1559006,2025-04-28,Senate,"Senate Floor Vote - Final Passage",59,1,0,2,62
1970877,1590455,2025-06-12,Assembly,"Assembly Floor Vote - Final Passage",144,0,0,6,150
1970878,1534501,2025-04-02,Assembly,"Assembly Higher Education Committee: Favorable refer to committee Ways and Means",24,0,0,2,26
1970878,1574665,2025-05-20,Assembly,"Assembly Ways And Means Committee: Favorable refer to committee Rules",35,0,0,0,35
1970878,1574925,2025-05-21,Assembly,"Assembly Rules Committee: Favorable",29,0,0,2,31
1970878,1575750,2025-05-21,Assembly,"Assembly Floor Vote - Final Passage",143,1,0,6,150
1970878,1585871,2025-06-05,Senate,"Senate Floor Vote - Final Passage",60,0,0,3,63
1970882,1570486,2025-05-13,Assembly,"Assembly Tourism, Arts And Sports Development Committee: Favorable refer to committee Ways and Means",20,0,0,1,21
1970882,1590767,2025-06-13,Assembly,"Assembly Rules Committee: Favorable",29,0,0,2,31
1970882,1590768,2025-06-13,Assembly,"Assembly Ways And Means Committee: Favorable refer to committee Rules",32,0,0,3,35
1970892,1574643,2025-05-20,Assembly,"Assembly Ways And Means Committee: Favorable refer to committee Rules",33,2,0,0,35
1970892,1591962,2025-06-17,Assembly,"Assembly Rules Committee: Favorable",28,0,0,3,31
1970923,1574478,2025-05-20,Assembly,"Assembly Social Services Committee: Favorable refer to committee Ways and Means",12,4,0,2,18
1970931,1566502,2025-05-06,Assembly,"Assembly Governmental Operations Committee: Favorable refer to committee Ways and Means",14,0,0,0,14
1970931,1585186,2025-06-04,Assembly,"Assembly Ways And Means Committee: Favorable refer to committee Rules",33,0,0,2,35
1970931,1586067,2025-06-06,Assembly,"Assembly Rules Committee: Favorable",27,0,0,4,31
1970952,1577965,2025-04-08,Senate,"Senate Crime Victims, Crime And Correction Committee Vote",7,0,0,0,7
1970952,1577966,2025-05-22,Senate,"Senate Floor Vote - Final Passage",57,0,0,5,62
1970952,1586909,2025-06-09,Senate,"Senate Floor Vote - Final Passage",62,0,0,1,63
1970952,1589424,2025-06-11,Assembly,"Assembly Floor Vote - Final Passage",105,41,0,4,150
1970959,1513614,2025-03-11,Assembly,"Assembly Mental Health Committee: Favorable refer to committee Ways and Means",13,0,0,0,13
1970989,1580635,2025-05-28,Assembly,"Assembly Election Law Committee: Favorable refer to committee Rules",15,0,0,1,16
1970994,1570297,2025-05-13,Assembly,"Assembly Environmental Conservation Committee: Held for Consideration",19,8,0,3,30
1971043,1587582,2025-06-09,Senate,"Senate Rules Committee Vote",21,0,0,0,21
1971043,1588353,2025-06-10,Senate,"Senate Floor Vote - Final Passage",58,0,0,5,63
1971075,1497722,2025-02-24,Assembly,"Assembly Health Committee: Favorable refer to committee Rules",24,0,0,2,26
1971075,1498621,2025-02-25,Assembly,"Assembly Rules Committee: Favorable",27,0,0,4,31
1971075,1501133,2025-02-26,Assembly,"Assembly Floor Vote - Final Passage",143,0,0,7,150
1971075,1519372,2025-03-17,Senate,"Senate Floor Vote - Final Passage",61,0,0,2,63
1971087,1516043,2025-03-12,Senate,"Senate Alcoholism And Substance Use Disorders Committee Vote",7,0,0,0,7
1971087,1560896,2025-04-29,Senate,"Senate Finance Committee Vote",22,0,0,0,22
1971087,1574156,2025-05-20,Senate,"Senate Floor Vote - Final Passage",61,0,0,1,62
1971127,1566875,2025-03-03,Senate,"Senate Insurance Committee Vote",11,0,0,0,11
1971127,1566876,2025-05-06,Senate,"Senate Floor Vote - Final Passage",60,1,0,1,62
1971127,1592520,2025-06-16,Assembly,"Assembly Floor Vote - Final Passage",145,0,0,5,150
1971151,1573684,2025-05-13,Senate,"Senate Corporations, Authorities And Commissions Committee Vote",7,0,0,0,7
1971151,1573685,2025-05-19,Senate,"Senate Floor Vote - Final Passage",56,0,0,6,62
1971161,1571847,2025-05-15,Senate,"Senate Alcoholism And Substance Use Disorders Committee Vote",7,0,0,0,7
1971167,1575733,2025-03-25,Senate,"Senate Judiciary Committee Vote",14,4,0,1,19
1971167,1575734,2025-05-21,Senate,"Senate Floor Vote - Final Passage",40,19,0,3,62
1971241,1571859,2025-05-15,Senate,"Senate Alcoholism And Substance Use Disorders Committee Vote",7,0,0,0,7
1971241,1580909,2025-05-28,Senate,"Senate Finance Committee Vote",22,0,0,0,22
1971241,1588259,2025-06-10,Senate,"Senate Floor Vote - Final Passage",58,0,0,5,63
1971262,1590323,2025-06-12,Senate,"Senate Rules Committee Vote",20,0,0,1,21
1971262,1590324,2025-06-13,Senate,"Senate Floor Vote - Final Passage",58,1,0,4,63
1971283,1573699,2025-05-13,Senate,"Senate Health Committee Vote",12,1,0,1,14
1971283,1573700,2025-05-19,Senate,"Senate Floor Vote - Final Passage",42,14,0,6,62
1971305,1527236,2025-03-03,Senate,"Senate Insurance Committee Vote",11,0,0,0,11
1971305,1527237,2025-03-25,Senate,"Senate Floor Vote - Final Passage",62,0,0,1,63
1971328,1573870,2025-03-03,Senate,"Senate Labor Committee Vote",13,0,0,0,13
1971328,1573871,2025-05-19,Senate,"Senate Floor Vote - Final Passage",54,2,0,6,62
1971328,1592509,2025-06-17,Assembly,"Assembly Floor Vote - Final Passage",139,2,0,9,150
1971357,1515975,2025-03-12,Senate,"Senate Alcoholism And Substance Use Disorders Committee Vote",7,0,0,0,7
1971422,1521733,2025-02-25,Senate,"Senate Local Government Committee Vote",6,1,0,0,7
1971422,1521734,2025-03-19,Senate,"Senate Floor Vote - Final Passage",42,18,0,3,63
1971434,1588348,2025-06-10,Senate,"Senate Floor Vote - Final Passage",43,15,0,5,63
1971434,1588349,2025-06-10,Senate,"Senate Rules Committee Vote",15,4,0,2,21
1971443,1559673,2025-04-29,Senate,"Senate Children And Families Committee Vote",7,0,0,0,7
1971443,1581812,2025-05-29,Senate,"Senate Rules Committee Vote",20,0,0,1,21
1971443,1585687,2025-06-05,Senate,"Senate Floor Vote - Final Passage",60,0,0,3,63
1971488,1580045,2025-05-28,Senate,"Senate Insurance Committee Vote",11,0,0,0,11
1971496,1518648,2025-03-03,Senate,"Senate Labor Committee Vote",13,0,0,0,13
1971496,1518649,2025-03-17,Senate,"Senate Floor Vote - Final Passage",54,7,0,2,63
1971532,1574833,2025-05-20,Senate,"Senate Health Committee Vote",13,0,0,1,14
1971532,1587136,2025-06-09,Senate,"Senate Rules Committee Vote",21,0,0,0,21
1971532,1588357,2025-06-10,Senate,"Senate Floor Vote - Final Passage",58,0,0,5,63
1971553,1574518,2025-05-19,Senate,"Senate Energy And Telecommunications Committee Vote",9,0,0,0,9
1971553,1580467,2025-05-28,Senate,"Senate Consumer Protection Committee Vote",7,0,0,0,7
1971559,1589283,2025-06-11,Senate,"Senate Floor Vote - Final Passage",59,0,0,4,63
1971559,1589284,2025-06-11,Senate,"Senate Rules Committee Vote",20,0,0,1,21
1971568,1589203,2025-03-03,Senate,"Senate Housing, Construction And Community Development Committee Vote",8,3,0,0,11
1971568,1589204,2025-06-10,Senate,"Senate Floor Vote - Final Passage",38,20,0,5,63
1971577,1500453,2025-02-25,Senate,"Senate Judiciary Committee Vote",19,0,0,0,19
1971623,1574835,2025-05-21,Senate,"Senate Mental Health Committee Vote",7,0,0,0,7
1971643,1536010,2025-03-11,Senate,"Senate Environmental Conservation Committee Vote",11,0,0,0,11
1971643,1536011,2025-04-03,Senate,"Senate Floor Vote - Final Passage",60,0,0,3,63
1971652,1505317,2025-02-25,Senate,"Senate Judiciary Committee Vote",17,2,0,0,19
1971652,1505318,2025-03-04,Senate,"Senate Floor Vote - Final Passage",58,3,0,2,63
1973068,1570673,2025-05-13,Assembly,"Assembly Codes Committee: Held for Consideration",16,6,0,0,22
1973107,1585203,2025-06-04,Assembly,"Assembly Ways And Means Committee: Favorable refer to committee Rules",32,1,0,2,35
1973107,1591967,2025-06-17,Assembly,"Assembly Rules Committee: Favorable",28,0,0,3,31
1973116,1570377,2025-05-13,Assembly,"Assembly Codes Committee: Held for Consideration",16,6,0,0,22
1973130,1580420,2025-05-28,Assembly,"Assembly Insurance Committee: Favorable refer to committee Rules",24,0,0,1,25
1973130,1587347,2025-06-10,Assembly,"Assembly Rules Committee: Favorable",28,0,0,3,31
1973130,1589178,2025-06-10,Assembly,"Assembly Floor Vote - Final Passage",147,0,0,3,150
1973130,1590684,2025-06-12,Senate,"Senate Floor Vote - Final Passage",58,1,0,4,63
1973134,1591561,2025-06-17,Assembly,"Assembly Rules Committee: Favorable",30,0,0,1,31
1973134,1591562,2025-06-17,Assembly,"Assembly Ways And Means Committee: Favorable refer to committee Rules",32,0,0,3,35
1973168,1520325,2025-03-18,Assembly,"Assembly Real Property Taxation Committee: Favorable refer to committee Ways and Means",10,0,0,0,10
1973168,1587298,2025-06-10,Assembly,"Assembly Ways And Means Committee: Favorable refer to committee Rules",32,0,0,3,35
1973168,1588474,2025-06-11,Assembly,"Assembly Rules Committee: Favorable",28,0,0,3,31
1973241,1562673,2025-04-30,Assembly,"Assembly Local Governments Committee: Favorable refer to committee Ways and Means",17,1,0,2,20
1973268,1570451,2025-05-13,Assembly,"Assembly Codes Committee: Held for Consideration",16,6,0,0,22
1973271,1580176,2025-05-28,Assembly,"Assembly Higher Education Committee: Favorable refer to committee Ways and Means",24,2,0,0,26
1973271,1586043,2025-06-06,Assembly,"Assembly Ways And Means Committee: Favorable refer to committee Rules",35,0,0,0,35
1973271,1587297,2025-06-10,Assembly,"Assembly Rules Committee: Favorable",19,9,0,3,31
1973310,1585570,2025-06-05,Assembly,"Assembly Local Governments Committee: Favorable refer to committee Ways and Means",19,0,0,1,20
1973310,1586072,2025-06-06,Assembly,"Assembly Ways And Means Committee: Favorable refer to committee Rules",35,0,0,0,35
1973310,1591984,2025-06-17,Assembly,"Assembly Rules Committee: Favorable",28,0,0,3,31
1973310,1592309,2025-06-17,Assembly,"Assembly Floor Vote - Final Passage",134,0,0,16,150
1973364,1593658,2025-06-16,Assembly,"Assembly Rules Committee: Favorable",29,0,0,2,31
1973364,1593659,2025-06-16,Assembly,"Assembly Ways And Means Committee: Favorable refer to committee Rules",22,10,0,3,35
1973369,1593640,2025-06-16,Assembly,"Assembly Rules Committee: Favorable",29,0,0,2,31
1973369,1593641,2025-06-16,Assembly,"Assembly Ways And Means Committee: Favorable refer to committee Rules",32,0,0,3,35
1973398,1579409,2025-05-27,Assembly,"Assembly Ways And Means Committee: Favorable refer to committee Rules",26,6,0,3,35
1973398,1581486,2025-05-29,Assembly,"Assembly Rules Committee: Favorable",26,1,0,4,31
1973398,1582184,2025-05-29,Assembly,"Assembly Floor Vote - Final Passage",98,48,0,4,150
1973502,1536945,2025-03-10,Senate,"Senate Codes Committee Vote",13,0,0,0,13
1973502,1536946,2025-04-03,Senate,"Senate Floor Vote - Final Passage",60,0,0,3,63
1973511,1564056,2025-03-25,Senate,"Senate Judiciary Committee Vote",18,0,0,1,19
1973511,1564057,2025-04-30,Senate,"Senate Floor Vote - Final Passage",60,0,0,2,62
1973553,1579226,2025-05-27,Senate,"Senate Civil Service And Pensions Committee Vote",6,0,0,1,7
1973573,1561738,2025-04-29,Senate,"Senate Cities 1 Committee Vote",5,2,0,0,7
1973574,1534648,2025-04-02,Senate,"Senate Civil Service And Pensions Committee Vote",7,0,0,0,7
1973574,1580890,2025-05-28,Senate,"Senate Finance Committee Vote",22,0,0,0,22
1973574,1588254,2025-06-10,Senate,"Senate Floor Vote - Final Passage",58,0,0,5,63
1973574,1589408,2025-06-11,Assembly,"Assembly Floor Vote - Final Passage",136,3,0,11,150
1973581,1563364,2025-04-29,Senate,"Senate Health Committee Vote",14,0,0,0,14
1973581,1590848,2025-06-12,Senate,"Senate Rules Committee Vote",20,0,0,1,21
1973581,1590849,2025-06-13,Senate,"Senate Floor Vote - Final Passage",59,0,0,4,63
1973605,1540490,2025-02-25,Senate,"Senate Environmental Conservation Committee Vote",10,1,0,0,11
1973605,1540491,2025-04-08,Senate,"Senate Floor Vote - Final Passage",54,8,0,1,63
1973622,1588328,2025-06-10,Senate,"Senate Floor Vote - Final Passage",45,13,0,5,63
1973622,1588329,2025-06-10,Senate,"Senate Rules Committee Vote",17,2,0,2,21
1973630,1570209,2025-05-13,Senate,"Senate Crime Victims, Crime And Correction Committee Vote",7,0,0,0,7
1973675,1588198,2025-03-24,Senate,"Senate Insurance Committee Vote",11,0,0,0,11
1973675,1588199,2025-06-10,Senate,"Senate Floor Vote - Final Passage",58,0,0,5,63
1973682,1574864,2025-05-20,Senate,"Senate Health Committee Vote",10,3,0,1,14
1973695,1584952,2025-03-03,Senate,"Senate Insurance Committee Vote",11,0,0,0,11
1973695,1584953,2025-06-04,Senate,"Senate Floor Vote - Final Passage",58,0,0,5,63
1973732,1586117,2025-03-25,Senate,"Senate Crime Victims, Crime And Correction Committee Vote",4,2,0,1,7
1973732,1586118,2025-06-06,Senate,"Senate Floor Vote - Final Passage",35,18,0,10,63
1973842,1560384,2025-04-29,Senate,"Senate Civil Service And Pensions Committee Vote",7,0,0,0,7
1974715,1573109,2025-03-18,Senate,"Senate Procurement And Contracts Committee Vote",7,0,0,0,7
1974715,1573110,2025-05-19,Senate,"Senate Floor Vote - Final Passage",56,0,0,6,62
1974715,1586449,2025-06-06,Assembly,"Assembly Floor Vote - Final Passage",143,0,0,7,150
1974851,1589440,2025-03-10,Senate,"Senate Codes Committee Vote",9,4,0,0,13
1974851,1589441,2025-06-11,Senate,"Senate Floor Vote - Final Passage",34,25,0,4,63
1974905,1588879,2025-05-13,Senate,"Senate Crime Victims, Crime And Correction Committee Vote",7,0,0,0,7
1974905,1588880,2025-06-10,Senate,"Senate Floor Vote - Final Passage",56,2,0,5,63
1975012,1587568,2025-06-04,Senate,"Senate Rules Committee Vote",20,0,0,1,21
1975012,1588347,2025-06-10,Senate,"Senate Floor Vote - Final Passage",57,1,0,5,63
1975072,1571846,2025-05-15,Senate,"Senate Alcoholism And Substance Use Disorders Committee Vote",7,0,0,0,7
1975131,1500004,2025-02-25,Senate,"Senate Elections Committee Vote",6,1,0,0,7
1975131,1570763,2025-05-13,Senate,"Senate Finance Committee Vote",22,0,0,0,22
1975131,1574437,2025-05-20,Senate,"Senate Floor Vote - Final Passage",61,0,0,1,62
1975136,1520881,2025-03-18,Senate,"Senate Energy And Telecommunications Committee Vote",6,3,0,0,9
1975136,1553309,2025-04-22,Senate,"Senate Floor Vote - Final Passage",38,15,0,9,62
1975136,1554731,2025-04-22,Senate,"Senate Rules Committee Vote",12,3,0,6,21
1975176,1579543,2025-05-28,Assembly,"Assembly Housing Committee: Favorable refer to committee Codes",19,8,0,1,28
1975176,1585591,2025-06-05,Assembly,"Assembly Codes Committee: Favorable refer to committee Rules",15,6,0,1,22
1975188,1580088,2025-05-28,Senate,"Senate Insurance Committee Vote",11,0,0,0,11
1975199,1561045,2025-04-29,Senate,"Senate Disabilities Committee Vote",6,0,0,0,6
1975222,1566985,2025-05-05,Senate,"Senate Banks Committee Vote",5,2,0,0,7
1975227,1522175,2025-03-12,Senate,"Senate Alcoholism And Substance Use Disorders Committee Vote",7,0,0,0,7
1975227,1522176,2025-03-19,Senate,"Senate Floor Vote - Final Passage",60,0,0,3,63
1975262,1581410,2025-05-28,Senate,"Senate Veterans, Homeland Security And Military Affairs Committee Vote",9,0,0,0,9
1975342,1581126,2025-05-14,Senate,"Senate Agriculture Committee Vote",8,0,0,1,9
1975342,1581127,2025-05-29,Senate,"Senate Floor Vote - Final Passage",54,2,0,7,63
1975370,1580889,2025-05-28,Senate,"Senate Veterans, Homeland Security And Military Affairs Committee Vote",9,0,0,0,9
1975394,1588828,2025-06-09,Senate,"Senate Rules Committee Vote",20,1,0,0,21
1975394,1589350,2025-06-11,Senate,"Senate Floor Vote - Final Passage",58,1,0,4,63
1975436,1574847,2025-05-20,Senate,"Senate Transportation Committee Vote",13,0,0,0,13
1975466,1534172,2025-04-02,Senate,"Senate Civil Service And Pensions Committee Vote",7,0,0,0,7
1975466,1570707,2025-05-13,Senate,"Senate Finance Committee Vote",21,1,0,0,22
1975549,1588334,2025-06-10,Senate,"Senate Floor Vote - Final Passage",40,18,0,5,63
1975549,1588335,2025-06-10,Senate,"Senate Floor Vote - Final Passage",40,18,0,5,63
1975549,1588336,2025-06-10,Senate,"Senate Rules Committee Vote",14,5,0,2,21
1975549,1588337,2025-06-10,Senate,"Senate Rules Committee Vote",14,5,0,2,21
1975549,1592382,2025-06-17,Assembly,"Assembly Floor Vote - Final Passage",89,46,0,15,150
1975569,1563355,2025-04-29,Senate,"Senate Health Committee Vote",14,0,0,0,14
1975604,1506103,2025-02-25,Senate,"Senate Elections Committee Vote",7,0,0,0,7
1975604,1506104,2025-03-05,Senate,"Senate Floor Vote - Final Passage",60,1,0,2,63
1975637,1522693,2025-03-11,Senate,"Senate Finance Committee Vote",18,3,0,1,22
1975637,1522694,2025-03-20,Senate,"Senate Floor Vote - Final Passage",51,8,0,4,63
1975640,1521391,2025-03-18,Senate,"Senate Energy And Telecommunications Committee Vote",8,1,0,0,9
1975743,1497705,2025-02-24,Assembly,"Assembly Higher Education Committee: Favorable refer to committee Ways and Means",24,0,0,2,26
1975743,1585184,2025-06-04,Assembly,"Assembly Ways And Means Committee: Favorable refer to committee Rules",33,0,0,2,35
1975743,1586051,2025-06-06,Assembly,"Assembly Rules Committee: Favorable",27,0,0,4,31
1975743,1586570,2025-06-06,Assembly,"Assembly Floor Vote - Final Passage",143,0,0,7,150
1975743,1588232,2025-06-10,Senate,"Senate Floor Vote - Final Passage",58,0,0,5,63
1975771,1590466,2025-06-12,Senate,"Senate Floor Vote - Final Passage",58,1,0,4,63
1975771,1592660,2025-06-16,Assembly,"Assembly Floor Vote - Final Passage",134,11,0,5,150
1975771,1594859,2025-06-12,Senate,"Senate Rules Committee Vote",19,1,0,1,21
1976043,1527510,2025-03-25,Senate,"Senate Judiciary Committee Vote",18,0,0,1,19
1976043,1570806,2025-05-13,Senate,"Senate Finance Committee Vote",22,0,0,0,22
1976043,1586187,2025-06-06,Senate,"Senate Floor Vote - Final Passage",53,0,0,10,63
1976137,1585279,2025-05-29,Senate,"Senate Rules Committee Vote",20,0,0,1,21
1976137,1585280,2025-06-04,Senate,"Senate Floor Vote - Final Passage",58,0,0,5,63
1976629,1569443,2025-04-29,Senate,"Senate Aging Committee Vote",6,0,0,0,6
1976629,1570019,2025-05-12,Senate,"Senate Floor Vote - Final Passage",57,0,0,5,62
1976676,1565196,2025-05-05,Senate,"Senate Insurance Committee Vote",11,0,0,0,11
1976676,1575786,2025-05-22,Senate,"Senate Alcoholism And Substance Use Disorders Committee Vote",7,0,0,0,7
1976795,1527794,2025-03-03,Senate,"Senate Labor Committee Vote",13,0,0,0,13
1976795,1527795,2025-03-26,Senate,"Senate Floor Vote - Final Passage",61,0,0,2,63
1976795,1589387,2025-06-11,Assembly,"Assembly Floor Vote - Final Passage",146,0,0,4,150
1976801,1590171,2025-06-12,Senate,"Senate Rules Committee Vote",20,0,0,1,21
1976801,1590359,2025-06-13,Senate,"Senate Floor Vote - Final Passage",59,0,0,4,63
1976891,1574434,2025-05-20,Assembly,"Assembly Environmental Conservation Committee: Held for Consideration",21,9,0,0,30
1976920,1586191,2025-03-25,Senate,"Senate Crime Victims, Crime And Correction Committee Vote",6,0,0,1,7
1976920,1586192,2025-06-06,Senate,"Senate Floor Vote - Final Passage",41,12,0,10,63
1976923,1574645,2025-05-20,Assembly,"Assembly Higher Education Committee: Held for Consideration",15,8,0,3,26
1976980,1561532,2025-04-07,Senate,"Senate Judiciary Committee Vote",18,1,0,0,19
1976980,1561533,2025-04-29,Senate,"Senate Floor Vote - Final Passage",44,17,0,1,62
1977026,1587834,2025-06-09,Senate,"Senate Rules Committee Vote",21,0,0,0,21
1977026,1587835,2025-06-10,Senate,"Senate Floor Vote - Final Passage",58,0,0,5,63
1977042,1498603,2025-02-25,Assembly,"Assembly Housing Committee: Favorable refer to committee Ways and Means",18,8,0,2,28
1977042,1498604,2025-02-25,Assembly,"Assembly Rules Committee: Favorable",20,7,0,4,31
1977042,1498605,2025-02-25,Assembly,"Assembly Ways And Means Committee: Favorable refer to committee Rules",25,6,0,4,35
1977080,1534541,2025-04-02,Senate,"Senate Civil Service And Pensions Committee Vote",7,0,0,0,7
1977089,1570455,2025-05-13,Assembly,"Assembly Environmental Conservation Committee: Favorable refer to committee Ways and Means",27,0,0,3,30
1977089,1590765,2025-06-13,Assembly,"Assembly Rules Committee: Favorable",29,0,0,2,31
1977089,1590766,2025-06-13,Assembly,"Assembly Ways And Means Committee: Favorable refer to committee Rules",32,0,0,3,35
1977169,1515442,2025-03-03,Senate,"Senate Insurance Committee Vote",11,0,0,0,11
1977169,1515443,2025-03-11,Senate,"Senate Floor Vote - Final Passage",61,0,0,2,63
1977171,1565600,2025-05-06,Assembly,"Assembly Correction Committee: Favorable refer to committee Ways and Means",8,4,0,1,13
1977171,1579404,2025-05-27,Assembly,"Assembly Ways And Means Committee: Favorable refer to committee Rules",22,10,0,3,35
1977182,1588303,2025-06-10,Senate,"Senate Floor Vote - Final Passage",58,0,0,5,63
1977182,1588304,2025-06-10,Senate,"Senate Rules Committee Vote",19,0,0,2,21
1977182,1591247,2025-06-13,Assembly,"Assembly Floor Vote - Final Passage",137,0,0,13,150
1977250,1593587,2025-06-16,Assembly,"Assembly Rules Committee: Favorable",29,0,0,2,31
1977250,1593588,2025-06-16,Assembly,"Assembly Ways And Means Committee: Favorable refer to committee Rules",32,0,0,3,35
1977330,1574856,2025-05-20,Senate,"Senate Health Committee Vote",13,0,0,1,14
1977330,1581455,2025-05-29,Senate,"Senate Rules Committee Vote",20,0,0,1,21
1977330,1586152,2025-06-06,Senate,"Senate Floor Vote - Final Passage",53,0,0,10,63
1977332,1586704,2025-04-07,Senate,"Senate Investigations And Government Operations Committee Vote",7,0,0,0,7
1977332,1587179,2025-06-09,Senate,"Senate Floor Vote - Final Passage",47,15,0,1,63
1977358,1542071,2025-03-25,Senate,"Senate Judiciary Committee Vote",13,5,0,1,19
1977358,1542072,2025-04-09,Senate,"Senate Floor Vote - Final Passage",36,24,0,3,63
1977383,1586121,2025-05-13,Senate,"Senate Higher Education Committee Vote",11,0,0,0,11
1977383,1586122,2025-06-06,Senate,"Senate Floor Vote - Final Passage",47,6,0,10,63
1977403,1578990,2025-05-27,Assembly,"Assembly Governmental Operations Committee: Held for Consideration",10,4,0,0,14
1977443,1570255,2025-05-13,Assembly,"Assembly Codes Committee: Held for Consideration",16,6,0,0,22
1977462,1580384,2025-05-28,Assembly,"Assembly Corporations, Authorities And Commissions Committee: Held for Consideration",17,8,0,1,26
1977508,1570852,2025-05-13,Assembly,"Assembly Codes Committee: Held for Consideration",16,6,0,0,22
1977550,1526530,2025-03-04,Senate,"Senate Higher Education Committee Vote",11,0,0,0,11
1977550,1526531,2025-03-25,Senate,"Senate Floor Vote - Final Passage",62,0,0,1,63
1977550,1590559,2025-06-12,Senate,"Senate Floor Vote - Final Passage",59,0,0,4,63
1977575,1589719,2025-03-18,Senate,"Senate Transportation Committee Vote",13,0,0,0,13
1977575,1590382,2025-06-12,Senate,"Senate Floor Vote - Final Passage",59,0,0,4,63
1977575,1592371,2025-06-16,Assembly,"Assembly Floor Vote - Final Passage",144,1,0,5,150
1977610,1565198,2025-05-05,Senate,"Senate Insurance Committee Vote",11,0,0,0,11
1977641,1569494,2025-04-07,Senate,"Senate Judiciary Committee Vote",13,6,0,0,19
1977641,1569495,2025-05-12,Senate,"Senate Floor Vote - Final Passage",38,19,0,5,62
1977685,1586082,2025-06-06,Assembly,"Assembly Ways And Means Committee: Held for Consideration",25,10,0,0,35
1977749,1579946,2025-05-28,Assembly,"Assembly Local Governments Committee: Held for Consideration",14,6,0,0,20
1977816,1498928,2025-02-25,Assembly,"Assembly Ways And Means Committee: Favorable",31,0,0,4,35
1977816,1505435,2025-03-04,Senate,"Senate Floor Vote - Final Passage",61,0,0,2,63
1977816,1506424,2025-03-04,Assembly,"Assembly Floor Vote - Final Passage",149,0,0,1,150
1977977,1562002,2025-04-30,Assembly,"Assembly Environmental Conservation Committee: Favorable refer to committee Ways and Means",23,6,0,1,30
1977977,1580936,2025-05-29,Assembly,"Assembly Ways And Means Committee: Favorable refer to committee Rules",33,1,0,1,35
1977977,1591932,2025-06-17,Assembly,"Assembly Rules Committee: Favorable",21,7,0,3,31
1978952,1585398,2025-06-04,Senate,"Senate Rules Committee Vote",17,3,0,1,21
1978952,1590741,2025-06-12,Senate,"Senate Floor Vote - Final Passage",51,8,0,4,63
1978952,1592628,2025-06-16,Assembly,"Assembly Floor Vote - Final Passage",140,5,0,5,150
1978964,1590181,2025-06-13,Senate,"Senate Rules Committee Vote",20,0,0,1,21
1978964,1590571,2025-06-13,Senate,"Senate Floor Vote - Final Passage",57,2,0,4,63
1978964,1592276,2025-06-16,Assembly,"Assembly Floor Vote - Final Passage",143,1,0,6,150
1978971,1587599,2025-06-09,Senate,"Senate Rules Committee Vote",21,0,0,0,21
1978971,1588388,2025-06-10,Senate,"Senate Floor Vote - Final Passage",58,0,0,5,63
1978987,1522183,2025-03-04,Senate,"Senate Higher Education Committee Vote",11,0,0,0,11
1978987,1522184,2025-03-19,Senate,"Senate Floor Vote - Final Passage",50,10,0,3,63
1978997,1574829,2025-05-20,Senate,"Senate Health Committee Vote",13,0,0,1,14
1978997,1588342,2025-06-10,Senate,"Senate Floor Vote - Final Passage",58,0,0,5,63
1978997,1588343,2025-06-10,Senate,"Senate Rules Committee Vote",19,0,0,2,21
1978997,1591319,2025-06-13,Assembly,"Assembly Floor Vote - Final Passage",133,0,0,17,150
1979010,1506364,2025-03-05,Senate,"Senate Mental Health Committee Vote",7,0,0,0,7
1979010,1581461,2025-05-29,Senate,"Senate Rules Committee Vote",20,0,0,1,21
1979010,1584989,2025-06-04,Senate,"Senate Floor Vote - Final Passage",58,0,0,5,63
1979018,1586762,2025-06-04,Senate,"Senate Rules Committee Vote",20,0,0,1,21
1979018,1587193,2025-06-09,Senate,"Senate Floor Vote - Final Passage",62,0,0,1,63
1979052,1516398,2025-03-04,Senate,"Senate Veterans, Homeland Security And Military Affairs Committee Vote",9,0,0,0,9
1979052,1516399,2025-03-12,Senate,"Senate Floor Vote - Final Passage",60,0,0,3,63
1979052,1591028,2025-06-11,Senate,"Senate Floor Vote - Final Passage",59,0,0,4,63
1979091,1563321,2025-04-08,Senate,"Senate Cultural Affairs, Tourism, Parks And Recreation Committee Vote",7,0,0,0,7
1979091,1563322,2025-04-30,Senate,"Senate Floor Vote - Final Passage",60,0,0,2,62
1979116,1499288,2025-02-25,Assembly,"Assembly Election Law Committee: Favorable",16,0,0,0,16
1979116,1505264,2025-03-04,Senate,"Senate Floor Vote - Final Passage",53,8,0,2,63
1979116,1505684,2025-03-04,Assembly,"Assembly Floor Vote - Final Passage",149,0,0,1,150
1979146,1580707,2025-05-12,Senate,"Senate Cities 2 Committee Vote",7,0,0,0,7
1979146,1580708,2025-05-28,Senate,"Senate Floor Vote - Final Passage",58,3,0,2,63
1979146,1582138,2025-05-29,Assembly,"Assembly Floor Vote - Final Passage",129,17,0,4,150
1979151,1517622,2025-03-12,Senate,"Senate Budget And Revenue Committee Vote",6,0,0,1,7
1979162,1571830,2025-05-13,Senate,"Senate Health Committee Vote",13,0,0,1,14
1979257,1560083,2025-04-29,Senate,"Senate Local Government Committee Vote",7,0,0,0,7
1979271,1509711,2025-03-10,Senate,"Senate Housing, Construction And Community Development Committee Vote",11,0,0,0,11
1979284,1518735,2025-03-17,Senate,"Senate Investigations And Government Operations Committee Vote",7,0,0,0,7
1979332,1588202,2025-06-10,Senate,"Senate Floor Vote - Final Passage",57,1,0,5,63
1979332,1588203,2025-06-10,Senate,"Senate Rules Committee Vote",19,0,0,2,21
1979332,1591068,2025-06-13,Assembly,"Assembly Floor Vote - Final Passage",137,0,0,13,150
1979453,1542106,2025-04-08,Senate,"Senate Libraries Committee Vote",7,0,0,0,7
1979500,1579784,2025-04-29,Senate,"Senate Investigations And Government Operations Committee Vote",7,0,0,0,7
1979500,1585131,2025-05-27,Senate,"Senate Floor Vote - Final Passage",51,8,0,4,63
1979500,1585366,2025-06-04,Assembly,"Assembly Floor Vote - Final Passage",107,36,0,7,150
1979548,1504546,2025-03-04,Senate,"Senate Finance Committee Vote",21,0,0,1,22
1979548,1508997,2025-03-04,Senate,"Senate Floor Vote - Final Passage",61,0,0,2,63
1979548,1508998,2025-03-04,Senate,"Senate Rules Committee Vote",20,0,0,1,21
1979557,1584717,2025-05-06,Senate,"Senate Elections Committee Vote",5,2,0,0,7
1979557,1585328,2025-06-04,Senate,"Senate Floor Vote - Final Passage",37,21,0,5,63
1979587,1559728,2025-04-29,Senate,"Senate Children And Families Committee Vote",7,0,0,0,7
1979587,1574498,2025-05-20,Senate,"Senate Finance Committee Vote",22,0,0,0,22
1979591,1586197,2025-05-14,Senate,"Senate Agriculture Committee Vote",8,0,0,1,9
1979591,1586198,2025-06-06,Senate,"Senate Floor Vote - Final Passage",52,1,0,10,63
1979692,1589910,2025-05-27,Senate,"Senate Internet And Technology Committee Vote",6,1,0,0,7
1979692,1590638,2025-06-12,Senate,"Senate Floor Vote - Final Passage",58,1,0,4,63
1979951,1534351,2025-04-02,Assembly,"Assembly Libraries And Education Technology Committee: Favorable refer to committee Ways and Means",9,0,0,0,9
1980713,1573412,2025-05-19,Assembly,"Assembly Consumer Affairs And Protection Committee: Favorable refer to committee Codes",15,0,0,1,16
1980713,1580660,2025-05-28,Assembly,"Assembly Codes Committee: Favorable refer to committee Rules",21,0,0,1,22
1980713,1585176,2025-06-04,Assembly,"Assembly Rules Committee: Favorable",28,0,0,3,31
1980713,1585371,2025-06-04,Assembly,"Assembly Floor Vote - Final Passage",143,0,0,7,150
1980713,1590531,2025-06-12,Senate,"Senate Floor Vote - Final Passage",59,0,0,4,63
1980748,1570435,2025-05-13,Assembly,"Assembly Codes Committee: Held for Consideration",16,6,0,0,22
1980766,1580211,2025-05-28,Assembly,"Assembly Labor Committee: Favorable refer to committee Rules",29,0,0,0,29
1980766,1581071,2025-05-29,Assembly,"Assembly Rules Committee: Favorable",27,0,0,4,31
1980766,1582050,2025-05-29,Assembly,"Assembly Floor Vote - Final Passage",146,0,0,4,150
1980786,1534125,2025-04-02,Assembly,"Assembly Environmental Conservation Committee: Favorable refer to committee Codes",21,7,0,2,30
1980786,1585489,2025-06-05,Assembly,"Assembly Codes Committee: Favorable refer to committee Rules",15,6,0,1,22
1980791,1570496,2025-05-13,Assembly,"Assembly Codes Committee: Held for Consideration",16,6,0,0,22
1980844,1589768,2025-06-12,Assembly,"Assembly Ways And Means Committee: Favorable refer to committee Rules",34,0,0,1,35
1980844,1590680,2025-06-13,Assembly,"Assembly Rules Committee: Favorable",29,0,0,2,31
1980856,1579998,2025-05-28,Assembly,"Assembly Labor Committee: Favorable refer to committee Codes",29,0,0,0,29
1980856,1586843,2025-06-09,Assembly,"Assembly Codes Committee: Favorable refer to committee Rules",20,0,0,2,22
1980856,1587384,2025-06-10,Assembly,"Assembly Rules Committee: Favorable",19,9,0,3,31
1980869,1573105,2025-05-19,Assembly,"Assembly Consumer Affairs And Protection Committee: Favorable refer to committee Codes",11,4,0,1,16
1980869,1585831,2025-06-05,Assembly,"Assembly Codes Committee: Favorable refer to committee Rules",21,0,0,1,22
1980869,1590066,2025-06-12,Assembly,"Assembly Rules Committee: Favorable",29,0,0,2,31
1980901,1593664,2025-06-16,Assembly,"Assembly Rules Committee: Favorable",29,0,0,2,31
1980901,1593665,2025-06-16,Assembly,"Assembly Ways And Means Committee: Favorable refer to committee Rules",32,0,0,3,35
1980903,1586208,2025-04-08,Senate,"Senate Agriculture Committee Vote",9,0,0,0,9
1980903,1586209,2025-06-06,Senate,"Senate Floor Vote - Final Passage",53,0,0,10,63
1980922,1593648,2025-06-16,Assembly,"Assembly Rules Committee: Favorable",29,0,0,2,31
1980922,1593649,2025-06-16,Assembly,"Assembly Ways And Means Committee: Favorable refer to committee Rules",28,4,0,3,35
1980933,1589961,2025-04-28,Senate,"Senate Energy And Telecommunications Committee Vote",9,0,0,0,9
1980933,1589962,2025-06-11,Senate,"Senate Floor Vote - Final Passage",57,2,0,4,63
1980945,1588803,2025-06-09,Senate,"Senate Rules Committee Vote",21,0,0,0,21
1980945,1589335,2025-06-11,Senate,"Senate Floor Vote - Final Passage",58,1,0,4,63
1980954,1589862,2025-06-12,Assembly,"Assembly Ways And Means Committee: Favorable refer to committee Rules",27,7,0,1,35
1980954,1590779,2025-06-13,Assembly,"Assembly Rules Committee: Favorable",29,0,0,2,31
1980963,1569705,2025-05-06,Senate,"Senate Social Services Committee Vote",6,0,0,0,6
1980963,1590399,2025-06-12,Senate,"Senate Floor Vote - Final Passage",59,0,0,4,63
1980963,1595030,2025-06-12,Senate,"Senate Rules Committee Vote",20,0,0,1,21
1980965,1574331,2025-05-20,Assembly,"Assembly Agriculture Committee: Held for Consideration",16,7,0,0,23
1980996,1579871,2025-05-28,Assembly,"Assembly Governmental Employees Committee: Favorable refer to committee Ways and Means",14,0,0,0,14
1980996,1585162,2025-06-04,Assembly,"Assembly Ways And Means Committee: Favorable refer to committee Rules",29,4,0,2,35
1980996,1586084,2025-06-06,Assembly,"Assembly Rules Committee: Favorable",25,2,0,4,31
1981004,1526406,2025-03-25,Assembly,"Assembly Children And Families Committee: Favorable",15,0,0,2,17
1981004,1534149,2025-04-01,Assembly,"Assembly Floor Vote - Final Passage",144,0,0,6,150
1981021,1573285,2025-05-19,Assembly,"Assembly Alcoholism And Drug Abuse Committee: Favorable refer to committee Rules",11,0,0,3,14
1981031,1534183,2025-03-11,Senate,"Senate Finance Committee Vote",19,2,0,1,22
1981031,1534934,2025-04-02,Senate,"Senate Floor Vote - Final Passage",52,10,0,1,63
1981036,1562686,2025-04-30,Assembly,"Assembly Governmental Employees Committee: Favorable refer to committee Ways and Means",14,0,0,0,14
1981036,1585963,2025-06-06,Assembly,"Assembly Ways And Means Committee: Favorable refer to committee Rules",35,0,0,0,35
1981036,1586977,2025-06-09,Assembly,"Assembly Rules Committee: Favorable",25,0,0,6,31
1981036,1587351,2025-06-09,Assembly,"Assembly Floor Vote - Final Passage",144,0,0,6,150
1981053,1591595,2025-06-17,Assembly,"Assembly Rules Committee: Favorable",30,0,0,1,31
1981053,1591596,2025-06-17,Assembly,"Assembly Ways And Means Committee: Favorable refer to committee Rules",32,0,0,3,35
1981057,1579075,2025-05-27,Assembly,"Assembly Health Committee: Favorable refer to committee Ways and Means",26,0,0,0,26
1981057,1585195,2025-06-04,Assembly,"Assembly Ways And Means Committee: Favorable refer to committee Rules",33,0,0,2,35
1981057,1590041,2025-06-12,Assembly,"Assembly Rules Committee: Favorable",29,0,0,2,31
1981105,1580154,2025-05-28,Assembly,"Assembly Labor Committee: Favorable refer to committee Ways and Means",29,0,0,0,29
1981105,1590671,2025-06-13,Assembly,"Assembly Rules Committee: Favorable",29,0,0,2,31
1981105,1590672,2025-06-13,Assembly,"Assembly Ways And Means Committee: Favorable refer to committee Rules",29,3,0,3,35
1981328,1560904,2025-04-29,Senate,"Senate Aging Committee Vote",6,0,0,0,6
1981463,1585913,2025-03-25,Senate,"Senate Corporations, Authorities And Commissions Committee Vote",7,0,0,0,7
1981463,1586193,2025-06-06,Senate,"Senate Floor Vote - Final Passage",53,0,0,10,63
1981540,1589279,2025-06-11,Senate,"Senate Floor Vote - Final Passage",58,1,0,4,63
1981540,1589280,2025-06-11,Senate,"Senate Rules Committee Vote",19,1,0,1,21
1981540,1591249,2025-06-13,Assembly,"Assembly Floor Vote - Final Passage",123,11,0,16,150
1981614,1562005,2025-04-30,Assembly,"Assembly Racing And Wagering Committee: Favorable refer to committee Ways and Means",11,0,0,0,11
1981614,1585995,2025-06-06,Assembly,"Assembly Ways And Means Committee: Favorable refer to committee Rules",35,0,0,0,35
1981614,1587342,2025-06-10,Assembly,"Assembly Rules Committee: Favorable",28,0,0,3,31
1981614,1588942,2025-06-10,Assembly,"Assembly Floor Vote - Final Passage",147,0,0,3,150
1981614,1590625,2025-06-12,Senate,"Senate Floor Vote - Final Passage",58,1,0,4,63
1981627,1586183,2025-05-29,Senate,"Senate Rules Committee Vote",20,0,0,1,21
1981627,1586184,2025-06-06,Senate,"Senate Floor Vote - Final Passage",53,0,0,10,63
1981651,1585893,2025-04-28,Senate,"Senate Energy And Telecommunications Committee Vote",9,0,0,0,9
1981651,1585894,2025-06-05,Senate,"Senate Floor Vote - Final Passage",60,0,0,3,63
1982300,1522786,2025-03-11,Senate,"Senate Judiciary Committee Vote",16,3,0,0,19
1982300,1522787,2025-03-20,Senate,"Senate Floor Vote - Final Passage",40,19,0,4,63
1982313,1570052,2025-03-25,Senate,"Senate Corporations, Authorities And Commissions Committee Vote",7,0,0,0,7
1982313,1570053,2025-05-12,Senate,"Senate Floor Vote - Final Passage",57,0,0,5,62
1982384,1588208,2025-06-10,Senate,"Senate Floor Vote - Final Passage",57,1,0,5,63
1982384,1588209,2025-06-10,Senate,"Senate Rules Committee Vote",18,1,0,2,21
1982456,1584694,2025-05-27,Senate,"Senate Civil Service And Pensions Committee Vote",6,0,0,1,7
1982456,1585515,2025-06-04,Senate,"Senate Rules Committee Vote",20,0,0,1,21
1982456,1590916,2025-06-10,Senate,"Senate Floor Vote - Final Passage",58,0,0,5,63
1982578,1578848,2025-04-29,Senate,"Senate Investigations And Government Operations Committee Vote",7,0,0,0,7
1982578,1584809,2025-05-27,Senate,"Senate Floor Vote - Final Passage",50,9,0,4,63
1982578,1586785,2025-06-06,Assembly,"Assembly Floor Vote - Final Passage",102,39,0,9,150
1982591,1569477,2025-05-12,Senate,"Senate Insurance Committee Vote",11,0,0,0,11
1982762,1585740,2025-05-29,Senate,"Senate Energy And Telecommunications Committee Vote",6,3,0,0,9
1982762,1585741,2025-06-05,Senate,"Senate Floor Vote - Final Passage",43,17,0,3,63
1982782,1586950,2025-05-28,Senate,"Senate Consumer Protection Committee Vote",6,1,0,0,7
1982782,1586951,2025-06-09,Senate,"Senate Floor Vote - Final Passage",41,21,0,1,63
1982816,1589575,2025-05-06,Senate,"Senate Consumer Protection Committee Vote",7,0,0,0,7
1982816,1590459,2025-06-12,Senate,"Senate Floor Vote - Final Passage",55,4,0,4,63
1982959,1574473,2025-05-20,Assembly,"Assembly Economic Development Committee: Held for Consideration",22,1,0,3,26
1982986,1574476,2025-05-20,Assembly,"Assembly Governmental Operations Committee: Favorable refer to committee Rules",14,0,0,0,14
1982986,1575420,2025-05-21,Assembly,"Assembly Rules Committee: Favorable",29,0,0,2,31
1982986,1575759,2025-05-21,Assembly,"Assembly Floor Vote - Final Passage",143,0,0,7,150
1982986,1589367,2025-06-11,Senate,"Senate Floor Vote - Final Passage",56,3,0,4,63
1983044,1566528,2025-05-06,Assembly,"Assembly Correction Committee: Favorable refer to committee Ways and Means",11,1,0,1,13
1983044,1575792,2025-05-22,Assembly,"Assembly Ways And Means Committee: Favorable refer to committee Rules",30,1,0,4,35
1983056,1559302,2025-04-28,Assembly,"Assembly Health Committee: Favorable refer to committee Ways and Means",20,5,0,1,26
1983056,1586010,2025-06-06,Assembly,"Assembly Ways And Means Committee: Favorable refer to committee Rules",25,10,0,0,35
1983056,1586847,2025-06-09,Assembly,"Assembly Rules Committee: Favorable",17,8,0,6,31
1983097,1543260,2025-03-11,Senate,"Senate Consumer Protection Committee Vote",7,0,0,0,7
1983097,1543261,2025-04-09,Senate,"Senate Floor Vote - Final Passage",59,1,0,3,63
1983103,1522387,2025-03-11,Senate,"Senate Consumer Protection Committee Vote",7,0,0,0,7
1983103,1522388,2025-03-20,Senate,"Senate Floor Vote - Final Passage",58,1,0,4,63
1983146,1560872,2025-04-29,Assembly,"Assembly Corporations, Authorities And Commissions Committee: Favorable refer to committee Ways and Means",20,5,0,1,26
1983146,1579416,2025-05-27,Assembly,"Assembly Ways And Means Committee: Favorable refer to committee Rules",22,10,0,3,35
1983146,1581505,2025-05-29,Assembly,"Assembly Rules Committee: Favorable",19,8,0,4,31
1983160,1580921,2025-05-29,Assembly,"Assembly Ways And Means Committee: Favorable refer to committee Rules",32,2,0,1,35
1983160,1585202,2025-06-04,Assembly,"Assembly Rules Committee: Favorable",28,0,0,3,31
1983238,1580250,2025-05-28,Assembly,"Assembly Labor Committee: Held for Consideration",20,9,0,0,29
1983320,1586039,2025-06-06,Assembly,"Assembly Ways And Means Committee: Held for Consideration",25,10,0,0,35
1983337,1526809,2025-03-25,Assembly,"Assembly Correction Committee: Favorable refer to committee Ways and Means",9,3,0,1,13
1983337,1574640,2025-05-20,Assembly,"Assembly Ways And Means Committee: Favorable refer to committee Rules",25,10,0,0,35
1983375,1564841,2025-05-05,Senate,"Senate Internet And Technology Committee Vote",5,2,0,0,7
1983422,1560869,2025-04-29,Assembly,"Assembly Children And Families Committee: Favorable refer to committee Rules",17,0,0,0,17
1983422,1561803,2025-04-30,Assembly,"Assembly Rules Committee: Favorable",29,0,0,2,31
1983422,1563443,2025-04-30,Assembly,"Assembly Floor Vote - Final Passage",145,0,0,5,150
1983422,1588149,2025-06-09,Senate,"Senate Floor Vote - Final Passage",62,0,0,1,63
1983428,1573346,2025-05-19,Assembly,"Assembly Veterans' Affairs Committee: Held for Consideration",13,5,0,1,19
1983430,1580633,2025-05-28,Assembly,"Assembly Higher Education Committee: Favorable refer to committee Ways and Means",20,6,0,0,26
1983430,1590691,2025-06-13,Assembly,"Assembly Rules Committee: Favorable",28,1,0,2,31
1983430,1590692,2025-06-13,Assembly,"Assembly Ways And Means Committee: Favorable refer to committee Rules",22,10,0,3,35
1983513,1580637,2025-05-28,Assembly,"Assembly Higher Education Committee: Favorable refer to committee Ways and Means",26,0,0,0,26
1983593,1526434,2025-03-25,Assembly,"Assembly People With Disabilities Committee: Favorable refer to committee Ways and Means",9,0,0,0,9
1983593,1570327,2025-05-13,Assembly,"Assembly Rules Committee: Favorable",28,0,0,3,31
1983593,1570328,2025-05-13,Assembly,"Assembly Ways And Means Committee: Favorable refer to committee Rules",34,0,0,1,35
1983593,1571131,2025-05-13,Assembly,"Assembly Floor Vote - Final Passage",145,0,0,5,150
1983671,1540022,2025-04-08,Assembly,"Assembly Health Committee: Favorable refer to committee Ways and Means",24,0,0,2,26
1983671,1579420,2025-05-27,Assembly,"Assembly Ways And Means Committee: Favorable refer to committee Rules",32,0,0,3,35
1983671,1581508,2025-05-29,Assembly,"Assembly Rules Committee: Favorable",27,0,0,4,31
1983671,1582193,2025-05-29,Assembly,"Assembly Floor Vote - Final Passage",146,0,0,4,150
1983983,1590245,2025-05-13,Senate,"Senate Health Committee Vote",13,0,0,1,14
1983983,1590722,2025-06-12,Senate,"Senate Floor Vote - Final Passage",58,1,0,4,63
1983983,1592470,2025-06-16,Assembly,"Assembly Floor Vote - Final Passage",144,0,0,6,150
1984426,1573360,2025-05-19,Assembly,"Assembly Health Committee: Favorable refer to committee Ways and Means",24,0,0,2,26
1984426,1580908,2025-05-29,Assembly,"Assembly Ways And Means Committee: Favorable refer to committee Rules",34,0,0,1,35
1984426,1585223,2025-06-04,Assembly,"Assembly Rules Committee: Favorable",28,0,0,3,31
1984531,1574541,2025-05-20,Assembly,"Assembly Governmental Operations Committee: Held for Consideration",10,4,0,0,14
1984565,1573445,2025-05-19,Assembly,"Assembly Governmental Employees Committee: Favorable refer to committee Ways and Means",13,0,0,1,14
1984581,1570407,2025-05-13,Assembly,"Assembly Codes Committee: Held for Consideration",16,6,0,0,22
1984588,1580379,2025-05-28,Assembly,"Assembly Corporations, Authorities And Commissions Committee: Held for Consideration",17,8,0,1,26
1984659,1561271,2025-04-29,Assembly,"Assembly Ways And Means Committee: Favorable refer to committee Rules",30,2,0,3,35
1984659,1561806,2025-04-30,Assembly,"Assembly Rules Committee: Favorable",29,0,0,2,31
1984659,1563436,2025-04-30,Assembly,"Assembly Floor Vote - Final Passage",106,39,0,5,150
1984659,1579561,2025-05-27,Senate,"Senate Floor Vote - Final Passage",50,9,0,4,63
1984737,1584652,2025-06-04,Assembly,"Assembly Transportation Committee: Favorable refer to committee Ways and Means",22,0,0,4,26
1984737,1585978,2025-06-06,Assembly,"Assembly Ways And Means Committee: Favorable refer to committee Rules",35,0,0,0,35
1984737,1586871,2025-06-09,Assembly,"Assembly Rules Committee: Favorable",25,0,0,6,31
1984737,1587380,2025-06-09,Assembly,"Assembly Floor Vote - Final Passage",144,0,0,6,150
1984750,1566463,2025-05-06,Senate,"Senate Elections Committee Vote",5,2,0,0,7
1984795,1573263,2025-05-19,Assembly,"Assembly Veterans' Affairs Committee: Favorable refer to committee Ways and Means",18,0,0,1,19
1984814,1526818,2025-03-25,Assembly,"Assembly Election Law Committee: Favorable",14,0,0,2,16
1984851,1573832,2025-05-20,Assembly,"Assembly Children And Families Committee: Favorable refer to committee Rules",16,0,0,1,17
1984851,1575328,2025-05-21,Assembly,"Assembly Rules Committee: Favorable",29,0,0,2,31
1984851,1575746,2025-05-21,Assembly,"Assembly Floor Vote - Final Passage",143,0,0,7,150
1984933,1586020,2025-06-06,Assembly,"Assembly Ways And Means Committee: Held for Consideration",18,17,0,0,35
1984983,1573397,2025-05-19,Assembly,"Assembly Health Committee: Held for Consideration",16,8,0,2,26
1985050,1588217,2025-06-10,Senate,"Senate Floor Vote - Final Passage",53,5,0,5,63
1985050,1588218,2025-06-10,Senate,"Senate Rules Committee Vote",17,2,0,2,21
1985050,1591071,2025-06-13,Assembly,"Assembly Floor Vote - Final Passage",108,25,0,17,150
1985077,1509283,2025-03-10,Senate,"Senate Housing, Construction And Community Development Committee Vote",9,2,0,0,11
1985107,1562660,2025-04-30,Assembly,"Assembly Local Governments Committee: Favorable refer to committee Codes",11,7,0,2,20
1985107,1570458,2025-05-13,Assembly,"Assembly Codes Committee: Favorable refer to committee Ways and Means",16,6,0,0,22
1985107,1586038,2025-06-06,Assembly,"Assembly Ways And Means Committee: Favorable refer to committee Rules",30,5,0,0,35
1985107,1586960,2025-06-09,Assembly,"Assembly Rules Committee: Favorable",25,0,0,6,31
1985107,1587332,2025-06-09,Assembly,"Assembly Floor Vote - Final Passage",106,38,0,6,150
1985107,1590482,2025-06-13,Senate,"Senate Floor Vote - Final Passage",52,7,0,4,63
1985208,1574467,2025-05-20,Assembly,"Assembly Energy Committee: Held for Consideration",11,5,0,1,17
1985295,1574660,2025-05-20,Assembly,"Assembly Judiciary Committee: Held for Consideration",14,6,0,1,21
1985329,1585575,2025-06-05,Assembly,"Assembly Codes Committee: Favorable refer to committee Rules",18,3,0,1,22
1985329,1586980,2025-06-09,Assembly,"Assembly Rules Committee: Favorable",25,0,0,6,31
1985436,1584636,2025-06-04,Assembly,"Assembly Judiciary Committee: Favorable refer to committee Codes",18,1,0,2,21
1985436,1585479,2025-06-05,Assembly,"Assembly Codes Committee: Favorable refer to committee Rules",20,1,0,1,22
1985436,1586867,2025-06-09,Assembly,"Assembly Rules Committee: Favorable",24,1,0,6,31
1985533,1509731,2025-03-10,Senate,"Senate Housing, Construction And Community Development Committee Vote",10,1,0,0,11
1985533,1540194,2025-04-08,Senate,"Senate Cities 1 Committee Vote",7,0,0,0,7
1985557,1589532,2025-06-12,Assembly,"Assembly Ways And Means Committee: Favorable refer to committee Rules",34,0,0,1,35
1985557,1590540,2025-06-13,Assembly,"Assembly Rules Committee: Favorable",20,9,0,2,31
1985641,1588314,2025-06-10,Senate,"Senate Floor Vote - Final Passage",56,2,0,5,63
1985641,1588315,2025-06-10,Senate,"Senate Rules Committee Vote",19,0,0,2,21
1985680,1574825,2025-05-20,Senate,"Senate Women's Issues Committee Vote",7,0,0,0,7
1986489,1585718,2025-06-05,Assembly,"Assembly Governmental Operations Committee: Favorable refer to committee Ways and Means",13,0,0,1,14
1986630,1570865,2025-05-13,Assembly,"Assembly Ways And Means Committee: Favorable",32,2,0,1,35
1986630,1574028,2025-05-19,Assembly,"Assembly Floor Vote - Final Passage",106,37,0,7,150
1986630,1595482,2025-05-27,Senate,"Senate Floor Vote - Final Passage",51,8,0,4,63
1986661,1590615,2025-06-12,Senate,"Senate Floor Vote - Final Passage",57,2,0,4,63
1986661,1591240,2025-06-13,Assembly,"Assembly Floor Vote - Final Passage",108,29,0,13,150
1986661,1595016,2025-06-12,Senate,"Senate Rules Committee Vote",19,1,0,1,21
1986739,1561309,2025-04-29,Assembly,"Assembly Ways And Means Committee: Favorable refer to committee Rules",30,2,0,3,35
1986739,1561826,2025-04-30,Assembly,"Assembly Rules Committee: Favorable",29,0,0,2,31
1986739,1563445,2025-04-30,Assembly,"Assembly Floor Vote - Final Passage",107,38,0,5,150
1986739,1599247,2025-05-27,Senate,"Senate Floor Vote - Final Passage",51,8,0,4,63
1986869,1561647,2025-04-30,Assembly,"Assembly Environmental Conservation Committee: Favorable refer to committee Rules",29,0,0,1,30
1986869,1561783,2025-04-30,Assembly,"Assembly Rules Committee: Favorable",29,0,0,2,31
1986869,1563427,2025-04-30,Assembly,"Assembly Floor Vote - Final Passage",145,0,0,5,150
1986869,1588420,2025-06-09,Senate,"Senate Floor Vote - Final Passage",62,0,0,1,63
1986937,1512649,2025-03-11,Assembly,"Assembly Veterans' Affairs Committee: Favorable refer to committee Ways and Means",19,0,0,0,19
1986937,1532027,2025-04-01,Assembly,"Assembly Rules Committee: Favorable",30,0,0,1,31
1986937,1532028,2025-04-01,Assembly,"Assembly Ways And Means Committee: Favorable refer to committee Rules",33,0,0,2,35
1986937,1535707,2025-04-02,Assembly,"Assembly Floor Vote - Final Passage",148,0,0,2,150
1986937,1590522,2025-06-11,Senate,"Senate Floor Vote - Final Passage",59,0,0,4,63
1987097,1574838,2025-05-20,Senate,"Senate Transportation Committee Vote",13,0,0,0,13
1987135,1570851,2025-05-13,Assembly,"Assembly Ways And Means Committee: Favorable",32,2,0,1,35
1987135,1573988,2025-05-19,Assembly,"Assembly Floor Vote - Final Passage",107,37,0,6,150
1987135,1599259,2025-05-27,Senate,"Senate Floor Vote - Final Passage",51,8,0,4,63
1987180,1574299,2025-05-20,Assembly,"Assembly Judiciary Committee: Favorable refer to committee Rules",14,6,0,1,21
1987318,1589856,2025-06-12,Assembly,"Assembly Ways And Means Committee: Favorable refer to committee Rules",34,0,0,1,35
1987318,1590808,2025-06-13,Assembly,"Assembly Rules Committee: Favorable",29,0,0,2,31
1987446,1570859,2025-05-13,Assembly,"Assembly Ways And Means Committee: Favorable",32,2,0,1,35
1987446,1574043,2025-05-19,Assembly,"Assembly Floor Vote - Final Passage",98,45,0,7,150
1987446,1599244,2025-05-27,Senate,"Senate Floor Vote - Final Passage",51,8,0,4,63
1987543,1585916,2025-05-20,Senate,"Senate Local Government Committee Vote",7,0,0,0,7
1987543,1585917,2025-06-06,Senate,"Senate Floor Vote - Final Passage",53,0,0,10,63
1987543,1589447,2025-06-11,Assembly,"Assembly Floor Vote - Final Passage",146,0,0,4,150
1988220,1589046,2025-05-19,Senate,"Senate Consumer Protection Committee Vote",6,0,0,1,7
1988220,1589047,2025-06-11,Senate,"Senate Floor Vote - Final Passage",57,2,0,4,63
1988220,1592441,2025-06-16,Assembly,"Assembly Floor Vote - Final Passage",144,0,0,6,150
1988240,1534272,2025-04-02,Senate,"Senate Civil Service And Pensions Committee Vote",7,0,0,0,7
1988240,1589217,2025-06-11,Senate,"Senate Floor Vote - Final Passage",58,1,0,4,63
1988240,1589218,2025-06-11,Senate,"Senate Rules Committee Vote",20,0,0,1,21
1988261,1588993,2025-05-20,Senate,"Senate Higher Education Committee Vote",11,0,0,0,11
1988261,1589691,2025-06-11,Senate,"Senate Floor Vote - Final Passage",59,0,0,4,63
1988318,1589681,2025-06-09,Senate,"Senate Rules Committee Vote",21,0,0,0,21
1988318,1590524,2025-06-12,Senate,"Senate Floor Vote - Final Passage",58,1,0,4,63
1988353,1590621,2025-03-25,Senate,"Senate Crime Victims, Crime And Correction Committee Vote",6,0,0,1,7
1988353,1590622,2025-06-11,Senate,"Senate Floor Vote - Final Passage",57,2,0,4,63
1988434,1588820,2025-05-28,Senate,"Senate Veterans, Homeland Security And Military Affairs Committee Vote",9,0,0,0,9
1988434,1589345,2025-06-11,Senate,"Senate Floor Vote - Final Passage",59,0,0,4,63
1988521,1580901,2025-05-28,Senate,"Senate Veterans, Homeland Security And Military Affairs Committee Vote",9,0,0,0,9
1988583,1588236,2025-06-10,Senate,"Senate Floor Vote - Final Passage",57,1,0,5,63
1988583,1588237,2025-06-10,Senate,"Senate Rules Committee Vote",19,0,0,2,21
1988583,1589380,2025-06-11,Assembly,"Assembly Floor Vote - Final Passage",146,0,0,4,150
1988608,1572773,2025-05-13,Senate,"Senate Environmental Conservation Committee Vote",11,0,0,0,11
1988608,1589220,2025-06-11,Senate,"Senate Rules Committee Vote",18,2,0,1,21
1988608,1590384,2025-06-12,Senate,"Senate Floor Vote - Final Passage",48,11,0,4,63
1988738,1539374,2025-04-07,Senate,"Senate Housing, Construction And Community Development Committee Vote",9,2,0,0,11
1988748,1571434,2025-05-13,Senate,"Senate Procurement And Contracts Committee Vote",7,0,0,0,7
1988762,1586138,2025-05-22,Senate,"Senate Alcoholism And Substance Use Disorders Committee Vote",7,0,0,0,7
1988762,1586139,2025-06-06,Senate,"Senate Floor Vote - Final Passage",52,1,0,10,63
1988772,1586759,2025-06-04,Senate,"Senate Rules Committee Vote",20,0,0,1,21
1988772,1587195,2025-06-09,Senate,"Senate Floor Vote - Final Passage",62,0,0,1,63
1988829,1570773,2025-05-13,Senate,"Senate Civil Service And Pensions Committee Vote",7,0,0,0,7
1988847,1579530,2025-04-29,Senate,"Senate Investigations And Government Operations Committee Vote",7,0,0,0,7
1988847,1592673,2025-05-27,Senate,"Senate Floor Vote - Final Passage",51,8,0,4,63
1988847,1592674,2025-06-18,Assembly,"Assembly Floor Vote - Final Passage",107,27,0,16,150
1988973,1513346,2025-03-11,Senate,"Senate Consumer Protection Committee Vote",7,0,0,0,7
1989330,1504214,2025-03-04,Assembly,"Assembly Education Committee: Favorable refer to committee Higher Education",26,2,0,3,31
1989330,1504215,2025-03-04,Assembly,"Assembly Higher Education Committee: Favorable refer to committee Rules",25,1,0,0,26
1989330,1505394,2025-03-04,Assembly,"Assembly Rules Committee: Favorable",21,6,0,4,31
1989330,1509003,2025-03-04,Assembly,"Assembly Floor Vote - Final Passage",106,44,0,0,150
1989408,1574135,2025-04-29,Senate,"Senate Health Committee Vote",9,5,0,0,14
1989408,1574136,2025-05-20,Senate,"Senate Floor Vote - Final Passage",41,20,0,1,62
1989474,1590011,2025-05-28,Senate,"Senate Procurement And Contracts Committee Vote",6,0,0,1,7
1989474,1590532,2025-06-12,Senate,"Senate Floor Vote - Final Passage",59,0,0,4,63
1989474,1592187,2025-06-16,Assembly,"Assembly Floor Vote - Final Passage",144,0,0,6,150
1989500,1571032,2025-05-13,Senate,"Senate Corporations, Authorities And Commissions Committee Vote",6,1,0,0,7
1989544,1561777,2025-04-29,Senate,"Senate Cities 1 Committee Vote",7,0,0,0,7
1989667,1588187,2025-05-15,Senate,"Senate Alcoholism And Substance Use Disorders Committee Vote",7,0,0,0,7
1989667,1588188,2025-06-10,Senate,"Senate Floor Vote - Final Passage",58,0,0,5,63
1989883,1586214,2025-04-29,Senate,"Senate Ethics And Internal Governance Committee Vote",7,0,0,0,7
1989883,1586215,2025-06-06,Senate,"Senate Floor Vote - Final Passage",50,3,0,10,63
1989953,1590833,2025-06-12,Senate,"Senate Rules Committee Vote",20,0,0,1,21
1989953,1590834,2025-06-13,Senate,"Senate Floor Vote - Final Passage",59,0,0,4,63
1989983,1570953,2025-05-13,Senate,"Senate Aging Committee Vote",6,0,0,0,6
1990005,1588338,2025-06-10,Senate,"Senate Floor Vote - Final Passage",55,3,0,5,63
1990005,1588339,2025-06-10,Senate,"Senate Rules Committee Vote",19,0,0,2,21
1990082,1586113,2025-03-11,Senate,"Senate Environmental Conservation Committee Vote",11,0,0,0,11
1990082,1586114,2025-06-06,Senate,"Senate Floor Vote - Final Passage",52,1,0,10,63
1990161,1573430,2025-05-19,Assembly,"Assembly Governmental Employees Committee: Favorable refer to committee Ways and Means",13,0,0,1,14
1990161,1585226,2025-06-04,Assembly,"Assembly Ways And Means Committee: Favorable refer to committee Rules",33,0,0,2,35
1990161,1585970,2025-06-06,Assembly,"Assembly Rules Committee: Favorable",27,0,0,4,31
1990161,1586560,2025-06-06,Assembly,"Assembly Floor Vote - Final Passage",143,0,0,7,150
1990161,1589230,2025-06-11,Senate,"Senate Floor Vote - Final Passage",59,0,0,4,63
1990218,1540004,2025-04-08,Assembly,"Assembly Energy Committee: Favorable",13,2,0,2,17
1990218,1572578,2025-05-15,Assembly,"Assembly Floor Vote - Final Passage",106,34,0,10,150
1990247,1573420,2025-05-19,Assembly,"Assembly Governmental Employees Committee: Favorable refer to committee Ways and Means",13,0,0,1,14
1990247,1585192,2025-06-04,Assembly,"Assembly Ways And Means Committee: Favorable refer to committee Rules",33,0,0,2,35
1990247,1586086,2025-06-06,Assembly,"Assembly Rules Committee: Favorable",27,0,0,4,31
1990247,1586505,2025-06-06,Assembly,"Assembly Floor Vote - Final Passage",142,0,0,8,150
1990247,1589044,2025-06-11,Senate,"Senate Floor Vote - Final Passage",59,0,0,4,63
1990249,1573367,2025-05-19,Assembly,"Assembly Governmental Employees Committee: Favorable refer to committee Ways and Means",13,0,0,1,14
1990249,1580928,2025-05-29,Assembly,"Assembly Ways And Means Committee: Favorable refer to committee Rules",34,0,0,1,35
1990249,1585218,2025-06-04,Assembly,"Assembly Rules Committee: Favorable",28,0,0,3,31
1990249,1585380,2025-06-04,Assembly,"Assembly Floor Vote - Final Passage",144,0,0,6,150
1990249,1589248,2025-06-11,Senate,"Senate Floor Vote - Final Passage",59,0,0,4,63
1990264,1573421,2025-05-19,Assembly,"Assembly Governmental Employees Committee: Favorable refer to committee Ways and Means",13,0,0,1,14
1990264,1585942,2025-06-06,Assembly,"Assembly Ways And Means Committee: Favorable refer to committee Rules",35,0,0,0,35
1990264,1587016,2025-06-09,Assembly,"Assembly Rules Committee: Favorable",25,0,0,6,31
1990264,1587378,2025-06-09,Assembly,"Assembly Floor Vote - Final Passage",144,0,0,6,150
1990264,1589189,2025-06-11,Senate,"Senate Floor Vote - Final Passage",59,0,0,4,63
1990295,1574515,2025-05-20,Assembly,"Assembly Economic Development Committee: Favorable refer to committee Codes",23,0,0,3,26
1990295,1585572,2025-06-05,Assembly,"Assembly Codes Committee: Favorable refer to committee Ways and Means",21,0,0,1,22
1990295,1585939,2025-06-06,Assembly,"Assembly Ways And Means Committee: Favorable refer to committee Rules",35,0,0,0,35
1990295,1586973,2025-06-09,Assembly,"Assembly Rules Committee: Favorable",25,0,0,6,31
1990295,1587353,2025-06-09,Assembly,"Assembly Floor Vote - Final Passage",144,0,0,6,150
1990295,1590306,2025-06-12,Senate,"Senate Floor Vote - Final Passage",59,0,0,4,63
1990489,1560968,2025-04-29,Senate,"Senate Commerce, Economic Development And Small Business Committee Vote",8,0,0,1,9
1990504,1570775,2025-05-13,Senate,"Senate Crime Victims, Crime And Correction Committee Vote",7,0,0,0,7
1990505,1589087,2025-03-18,Senate,"Senate Racing, Gaming And Wagering Committee Vote",7,0,0,0,7
1990505,1589511,2025-06-11,Senate,"Senate Floor Vote - Final Passage",57,2,0,4,63
1990505,1592546,2025-06-17,Assembly,"Assembly Floor Vote - Final Passage",141,0,0,9,150
1990515,1590469,2025-06-12,Senate,"Senate Floor Vote - Final Passage",58,1,0,4,63
1990515,1592415,2025-06-16,Assembly,"Assembly Floor Vote - Final Passage",102,42,0,6,150
1990515,1595110,2025-06-12,Senate,"Senate Rules Committee Vote",20,0,0,1,21
1990517,1580867,2025-05-28,Senate,"Senate Veterans, Homeland Security And Military Affairs Committee Vote",9,0,0,0,9
1990542,1571840,2025-05-13,Senate,"Senate Health Committee Vote",10,3,0,1,14
1990563,1579066,2025-04-29,Senate,"Senate Investigations And Government Operations Committee Vote",6,1,0,0,7
1990563,1589540,2025-05-27,Senate,"Senate Floor Vote - Final Passage",51,8,0,4,63
1990563,1589541,2025-06-11,Assembly,"Assembly Floor Vote - Final Passage",120,26,0,4,150
1990571,1574477,2025-05-20,Assembly,"Assembly Energy Committee: Favorable refer to committee Rules",12,4,0,1,17
1990571,1575429,2025-05-21,Assembly,"Assembly Rules Committee: Favorable",28,1,0,2,31
1990600,1548956,2025-04-15,Assembly,"Assembly Judiciary Committee: Favorable refer to committee Codes",15,5,0,1,21
1990600,1559291,2025-04-28,Assembly,"Assembly Codes Committee: Favorable refer to committee Rules",15,6,0,1,22
1990600,1559751,2025-04-29,Assembly,"Assembly Rules Committee: Favorable",21,8,0,2,31
1990604,1589631,2025-04-28,Senate,"Senate Housing, Construction And Community Development Committee Vote",11,0,0,0,11
1990604,1590468,2025-06-12,Senate,"Senate Floor Vote - Final Passage",58,1,0,4,63
1990636,1589221,2025-06-11,Senate,"Senate Floor Vote - Final Passage",59,0,0,4,63
1990636,1589222,2025-06-11,Senate,"Senate Rules Committee Vote",20,0,0,1,21
1990636,1592283,2025-06-17,Assembly,"Assembly Floor Vote - Final Passage",134,0,0,16,150
1990639,1587344,2025-06-10,Assembly,"Assembly Ways And Means Committee: Favorable refer to committee Rules",32,0,0,3,35
1990639,1588536,2025-06-11,Assembly,"Assembly Rules Committee: Favorable",28,0,0,3,31
1990648,1561270,2025-04-29,Assembly,"Assembly Ways And Means Committee: Favorable refer to committee Rules",30,2,0,3,35
1990648,1561787,2025-04-30,Assembly,"Assembly Rules Committee: Favorable",29,0,0,2,31
1990648,1563428,2025-04-30,Assembly,"Assembly Floor Vote - Final Passage",109,36,0,5,150
1990648,1599201,2025-05-27,Senate,"Senate Floor Vote - Final Passage",51,8,0,4,63
1990660,1561633,2025-04-30,Assembly,"Assembly Environmental Conservation Committee: Favorable refer to committee Ways and Means",23,6,0,1,30
1990660,1579390,2025-05-27,Assembly,"Assembly Ways And Means Committee: Favorable refer to committee Rules",22,10,0,3,35
1990664,1575784,2025-05-22,Assembly,"Assembly Ways And Means Committee: Favorable refer to committee Rules",29,2,0,4,35
1990664,1591948,2025-06-17,Assembly,"Assembly Rules Committee: Favorable",28,0,0,3,31
1990674,1589886,2025-06-12,Assembly,"Assembly Ways And Means Committee: Favorable refer to committee Rules",34,0,0,1,35
1990674,1590789,2025-06-13,Assembly,"Assembly Rules Committee: Favorable",29,0,0,2,31
1990730,1534604,2025-04-02,Senate,"Senate Environmental Conservation Committee Vote",11,0,0,0,11
1990736,1585552,2025-06-05,Assembly,"Assembly Codes Committee: Favorable refer to committee Rules",21,0,0,1,22
1990736,1591966,2025-06-17,Assembly,"Assembly Rules Committee: Favorable",28,0,0,3,31
1990736,1592292,2025-06-17,Assembly,"Assembly Floor Vote - Final Passage",119,15,0,16,150
1990776,1534313,2025-04-02,Assembly,"Assembly Environmental Conservation Committee: Favorable",20,8,0,2,30
1990776,1572523,2025-05-14,Assembly,"Assembly Floor Vote - Final Passage",111,36,0,3,150
1990776,1585150,2025-06-04,Senate,"Senate Floor Vote - Final Passage",57,1,0,5,63
1990782,1593634,2025-06-16,Assembly,"Assembly Rules Committee: Favorable",29,0,0,2,31
1990782,1593635,2025-06-16,Assembly,"Assembly Ways And Means Committee: Favorable refer to committee Rules",32,0,0,3,35
1990785,1514803,2025-03-11,Assembly,"Assembly Codes Committee: Favorable",19,3,0,0,22
1990785,1586213,2025-06-06,Senate,"Senate Floor Vote - Final Passage",53,0,0,10,63
1990785,1586524,2025-06-06,Assembly,"Assembly Floor Vote - Final Passage",135,8,0,7,150
1990790,1590383,2025-06-12,Senate,"Senate Floor Vote - Final Passage",59,0,0,4,63
1990790,1592301,2025-06-16,Assembly,"Assembly Floor Vote - Final Passage",144,0,0,6,150
1990790,1594994,2025-06-12,Senate,"Senate Rules Committee Vote",20,0,0,1,21
1990821,1579393,2025-04-29,Senate,"Senate Investigations And Government Operations Committee Vote",7,0,0,0,7
1990821,1590865,2025-05-27,Senate,"Senate Floor Vote - Final Passage",51,8,0,4,63
1990821,1591119,2025-06-13,Assembly,"Assembly Floor Vote - Final Passage",109,24,0,17,150
1990827,1574157,2025-05-20,Assembly,"Assembly Energy Committee: Favorable refer to committee Rules",14,2,0,1,17
1990856,1566573,2025-05-06,Assembly,"Assembly Science And Technology Committee: Favorable refer to committee Ways and Means",9,0,0,0,9
1990856,1579405,2025-05-27,Assembly,"Assembly Ways And Means Committee: Favorable refer to committee Rules",32,0,0,3,35
1990867,1570432,2025-05-13,Assembly,"Assembly Codes Committee: Held for Consideration",16,6,0,0,22
1990871,1534417,2025-04-02,Assembly,"Assembly Governmental Operations Committee: Favorable refer to committee Codes",10,4,0,0,14
1990871,1540163,2025-04-08,Assembly,"Assembly Codes Committee: Favorable",16,5,0,1,22
1990891,1580955,2025-05-29,Assembly,"Assembly Ways And Means Committee: Favorable refer to committee Rules",32,2,0,1,35
1990891,1585199,2025-06-04,Assembly,"Assembly Rules Committee: Favorable",28,0,0,3,31
1990912,1590206,2025-06-12,Senate,"Senate Rules Committee Vote",20,0,0,1,21
1990912,1590378,2025-06-13,Senate,"Senate Floor Vote - Final Passage",57,2,0,4,63
1990967,1579491,2025-04-29,Senate,"Senate Investigations And Government Operations Committee Vote",7,0,0,0,7
1990967,1592062,2025-05-27,Senate,"Senate Floor Vote - Final Passage",45,14,0,4,63
1990967,1592640,2025-06-17,Assembly,"Assembly Floor Vote - Final Passage",113,28,0,9,150
1990970,1585653,2025-04-08,Senate,"Senate Libraries Committee Vote",7,0,0,0,7
1990970,1585654,2025-06-05,Senate,"Senate Floor Vote - Final Passage",59,1,0,3,63
1990974,1569459,2025-03-11,Senate,"Senate Environmental Conservation Committee Vote",10,1,0,0,11
1990974,1569460,2025-05-12,Senate,"Senate Floor Vote - Final Passage",47,9,0,6,62
1990974,1587255,2025-06-09,Assembly,"Assembly Floor Vote - Final Passage",97,46,0,7,150
1990977,1560571,2025-04-29,Senate,"Senate Commerce, Economic Development And Small Business Committee Vote",8,0,0,1,9
1990984,1541999,2025-04-08,Senate,"Senate Libraries Committee Vote",7,0,0,0,7
1990990,1573836,2025-05-20,Senate,"Senate Local Government Committee Vote",7,0,0,0,7
1990990,1588192,2025-06-10,Senate,"Senate Floor Vote - Final Passage",57,1,0,5,63
1990990,1588193,2025-06-10,Senate,"Senate Rules Committee Vote",19,0,0,2,21
1990996,1561686,2025-04-29,Senate,"Senate Transportation Committee Vote",13,0,0,0,13
1990999,1589115,2025-04-29,Senate,"Senate Transportation Committee Vote",13,0,0,0,13
1990999,1589394,2025-06-11,Senate,"Senate Floor Vote - Final Passage",59,0,0,4,63
1990999,1591105,2025-06-13,Assembly,"Assembly Floor Vote - Final Passage",137,0,0,13,150
1991019,1527549,2025-03-18,Senate,"Senate Procurement And Contracts Committee Vote",7,0,0,0,7
1991019,1527550,2025-03-26,Senate,"Senate Floor Vote - Final Passage",61,0,0,2,63
1991029,1579103,2025-04-29,Senate,"Senate Investigations And Government Operations Committee Vote",7,0,0,0,7
1991029,1590416,2025-05-27,Senate,"Senate Floor Vote - Final Passage",45,14,0,4,63
1991029,1591301,2025-06-13,Assembly,"Assembly Floor Vote - Final Passage",109,24,0,17,150
1991040,1539389,2025-04-07,Senate,"Senate Judiciary Committee Vote",19,0,0,0,19
1991040,1590073,2025-06-12,Senate,"Senate Rules Committee Vote",20,0,0,1,21
1991040,1590451,2025-06-13,Senate,"Senate Floor Vote - Final Passage",59,0,0,4,63
1991048,1580895,2025-05-28,Senate,"Senate Veterans, Homeland Security And Military Affairs Committee Vote",9,0,0,0,9
1991055,1561683,2025-04-29,Senate,"Senate Transportation Committee Vote",13,0,0,0,13
1991090,1590232,2025-04-29,Senate,"Senate Commerce, Economic Development And Small Business Committee Vote",8,0,0,1,9
1991090,1590233,2025-06-11,Senate,"Senate Floor Vote - Final Passage",58,1,0,4,63
1991113,1574708,2025-05-13,Senate,"Senate Corporations, Authorities And Commissions Committee Vote",7,0,0,0,7
1991113,1574709,2025-05-20,Senate,"Senate Floor Vote - Final Passage",59,2,0,1,62
1991127,1586936,2025-05-20,Senate,"Senate Local Government Committee Vote",7,0,0,0,7
1991127,1586937,2025-06-09,Senate,"Senate Floor Vote - Final Passage",62,0,0,1,63
1991149,1561288,2025-04-29,Assembly,"Assembly Ways And Means Committee: Favorable refer to committee Rules",30,2,0,3,35
1991149,1561807,2025-04-30,Assembly,"Assembly Rules Committee: Favorable",29,0,0,2,31
1991149,1563444,2025-04-30,Assembly,"Assembly Floor Vote - Final Passage",108,37,0,5,150
1991149,1595764,2025-05-27,Senate,"Senate Floor Vote - Final Passage",51,8,0,4,63
1991154,1589357,2025-05-13,Senate,"Senate Transportation Committee Vote",13,0,0,0,13
1991154,1589637,2025-06-11,Senate,"Senate Floor Vote - Final Passage",59,0,0,4,63
1991169,1579032,2025-04-29,Senate,"Senate Investigations And Government Operations Committee Vote",7,0,0,0,7
1991169,1590305,2025-05-27,Senate,"Senate Floor Vote - Final Passage",45,14,0,4,63
1991169,1591243,2025-06-13,Assembly,"Assembly Floor Vote - Final Passage",112,25,0,13,150
1991178,1573217,2025-05-13,Senate,"Senate Corporations, Authorities And Commissions Committee Vote",7,0,0,0,7
1991178,1573218,2025-05-19,Senate,"Senate Floor Vote - Final Passage",35,21,0,6,62
1991184,1543098,2025-03-11,Senate,"Senate Environmental Conservation Committee Vote",11,0,0,0,11
1991184,1543099,2025-04-09,Senate,"Senate Floor Vote - Final Passage",58,2,0,3,63
1991233,1569962,2025-04-29,Senate,"Senate Commerce, Economic Development And Small Business Committee Vote",8,0,0,1,9
1991233,1569963,2025-05-12,Senate,"Senate Floor Vote - Final Passage",57,0,0,5,62
1991255,1535684,2025-03-18,Senate,"Senate Transportation Committee Vote",13,0,0,0,13
1991255,1536921,2025-04-03,Senate,"Senate Floor Vote - Final Passage",60,0,0,3,63
1991309,1563384,2025-04-29,Senate,"Senate Health Committee Vote",14,0,0,0,14
1991309,1580843,2025-05-28,Senate,"Senate Finance Committee Vote",20,2,0,0,22
1991309,1589120,2025-06-11,Senate,"Senate Floor Vote - Final Passage",54,5,0,4,63
1991383,1574819,2025-05-20,Senate,"Senate Codes Committee Vote",13,0,0,0,13
1991632,1574569,2025-05-20,Senate,"Senate Cities 1 Committee Vote",7,0,0,0,7
1991634,1585667,2025-04-29,Senate,"Senate Civil Service And Pensions Committee Vote",6,1,0,0,7
1991634,1585668,2025-06-04,Senate,"Senate Floor Vote - Final Passage",50,8,0,5,63
1991657,1574821,2025-05-20,Senate,"Senate Civil Service And Pensions Committee Vote",7,0,0,0,7
1991721,1588791,2025-06-09,Senate,"Senate Rules Committee Vote",21,0,0,0,21
1991721,1589336,2025-06-11,Senate,"Senate Floor Vote - Final Passage",59,0,0,4,63
1991721,1591032,2025-06-13,Assembly,"Assembly Floor Vote - Final Passage",136,0,0,14,150
1991751,1579189,2025-05-27,Senate,"Senate New York City Education Committee Vote",6,0,0,0,6
1991788,1560770,2025-04-29,Senate,"Senate Aging Committee Vote",6,0,0,0,6
1991816,1580295,2025-05-28,Assembly,"Assembly Governmental Employees Committee: Held for Consideration",10,4,0,0,14
1991830,1590437,2025-06-12,Senate,"Senate Floor Vote - Final Passage",59,0,0,4,63
1991830,1595078,2025-06-12,Senate,"Senate Rules Committee Vote",20,0,0,1,21
1991849,1581070,2025-05-29,Assembly,"Assembly Science And Technology Committee: Favorable refer to committee Codes",9,0,0,0,9
1991849,1589788,2025-06-12,Assembly,"Assembly Rules Committee: Favorable",21,8,0,2,31
1991849,1589789,2025-06-12,Assembly,"Assembly Ways And Means Committee: Favorable refer to committee Rules",25,9,0,1,35
1991864,1580341,2025-05-28,Assembly,"Assembly Governmental Employees Committee: Held for Consideration",9,5,0,0,14
1991880,1579219,2025-05-27,Senate,"Senate Labor Committee Vote",12,1,0,0,13
1991892,1575788,2025-05-22,Senate,"Senate Alcoholism And Substance Use Disorders Committee Vote",7,0,0,0,7
1991930,1579473,2025-04-29,Senate,"Senate Investigations And Government Operations Committee Vote",7,0,0,0,7
1991930,1585237,2025-05-27,Senate,"Senate Floor Vote - Final Passage",51,8,0,4,63
1991930,1589611,2025-06-11,Assembly,"Assembly Floor Vote - Final Passage",120,26,0,4,150
1991958,1585725,2025-06-05,Assembly,"Assembly Governmental Operations Committee: Favorable refer to committee Ways and Means",13,0,0,1,14
1991958,1590820,2025-06-13,Assembly,"Assembly Rules Committee: Favorable",29,0,0,2,31
1991958,1590821,2025-06-13,Assembly,"Assembly Ways And Means Committee: Favorable refer to committee Rules",32,0,0,3,35
1991964,1526416,2025-03-25,Assembly,"Assembly Social Services Committee: Favorable refer to committee Ways and Means",13,4,0,1,18
1991964,1579418,2025-05-27,Assembly,"Assembly Ways And Means Committee: Favorable refer to committee Rules",22,10,0,3,35
1991964,1591570,2025-05-27,Assembly,"Assembly Ways And Means Committee: Favorable refer to committee Rules",22,10,0,3,35
1992004,1585696,2025-06-05,Assembly,"Assembly Cities Committee: Favorable refer to committee Ways and Means",15,0,0,1,16
1992004,1586060,2025-06-06,Assembly,"Assembly Ways And Means Committee: Favorable refer to committee Rules",35,0,0,0,35
1992004,1588540,2025-06-11,Assembly,"Assembly Rules Committee: Favorable",28,0,0,3,31
1992016,1574431,2025-05-20,Assembly,"Assembly Environmental Conservation Committee: Favorable refer to committee Codes",30,0,0,0,30
1992016,1580409,2025-05-28,Assembly,"Assembly Codes Committee: Favorable refer to committee Rules",21,0,0,1,22
1992016,1585171,2025-06-04,Assembly,"Assembly Rules Committee: Favorable",28,0,0,3,31
1992034,1587274,2025-05-20,Senate,"Senate Codes Committee Vote",13,0,0,0,13
1992034,1587275,2025-06-09,Senate,"Senate Floor Vote - Final Passage",55,7,0,1,63
1992090,1579449,2025-05-27,Senate,"Senate Disabilities Committee Vote",6,0,0,0,6
1992099,1560784,2025-04-29,Assembly,"Assembly Education Committee: Favorable refer to committee Ways and Means Correction Date:04/29/2025",26,0,0,5,31
1992099,1574675,2025-05-20,Assembly,"Assembly Ways And Means Committee: Favorable refer to committee Rules",35,0,0,0,35
1992099,1574933,2025-05-21,Assembly,"Assembly Rules Committee: Favorable",29,0,0,2,31
1992109,1538030,2025-04-07,Assembly,"Assembly Rules Committee: Favorable",28,1,0,2,31
1992109,1538031,2025-04-07,Assembly,"Assembly Ways And Means Committee: Favorable refer to committee Rules",31,2,0,2,35
1992109,1541388,2025-04-08,Assembly,"Assembly Floor Vote - Final Passage",108,39,0,3,150
1992109,1599260,2025-05-27,Senate,"Senate Floor Vote - Final Passage",51,8,0,4,63
1992134,1514358,2025-03-11,Assembly,"Assembly Veterans' Affairs Committee: Favorable refer to committee Ways and Means",19,0,0,0,19
1992134,1538055,2025-04-07,Assembly,"Assembly Rules Committee: Favorable",29,0,0,2,31
1992134,1538056,2025-04-07,Assembly,"Assembly Ways And Means Committee: Favorable refer to committee Rules",33,0,0,2,35
1992134,1541407,2025-04-08,Assembly,"Assembly Floor Vote - Final Passage",147,0,0,3,150
1992170,1525852,2025-03-25,Assembly,"Assembly Racing And Wagering Committee: Favorable refer to committee Ways and Means",11,0,0,0,11
1992170,1538041,2025-04-07,Assembly,"Assembly Rules Committee: Favorable",29,0,0,2,31
1992170,1538042,2025-04-07,Assembly,"Assembly Ways And Means Committee: Favorable refer to committee Rules",33,0,0,2,35
1992189,1586961,2025-06-09,Senate,"Senate Floor Vote - Final Passage",62,0,0,1,63
1992189,1586962,2025-06-09,Senate,"Senate Rules Committee Vote",20,1,0,0,21
1992193,1574315,2025-05-20,Assembly,"Assembly Children And Families Committee: Held for Consideration",11,5,0,1,17
1992283,1574367,2025-05-20,Assembly,"Assembly Mental Health Committee: Favorable refer to committee Ways and Means",13,0,0,0,13
1992297,1574522,2025-05-20,Assembly,"Assembly Insurance Committee: Favorable refer to committee Rules",25,0,0,0,25
1992297,1588138,2025-06-10,Assembly,"Assembly Rules Committee: Favorable",28,0,0,3,31
1992345,1559549,2025-04-28,Assembly,"Assembly Health Committee: Favorable refer to committee Ways and Means",25,0,0,1,26
1992399,1575799,2025-05-22,Assembly,"Assembly Ways And Means Committee: Favorable refer to committee Rules",29,2,0,4,35
1992399,1581563,2025-05-29,Assembly,"Assembly Rules Committee: Favorable",27,0,0,4,31
1992439,1560398,2025-04-29,Assembly,"Assembly Ways And Means Committee: Favorable refer to committee Rules",30,2,0,3,35
1992439,1561796,2025-04-30,Assembly,"Assembly Rules Committee: Favorable",29,0,0,2,31
1992439,1563335,2025-04-30,Assembly,"Assembly Floor Vote - Final Passage",105,40,0,5,150
1992439,1599241,2025-05-27,Senate,"Senate Floor Vote - Final Passage",51,8,0,4,63
1992453,1570646,2025-05-13,Assembly,"Assembly Codes Committee: Favorable",16,6,0,0,22
1992453,1589664,2025-06-11,Assembly,"Assembly Floor Vote - Final Passage",90,50,0,10,150
1992497,1539595,2025-04-07,Senate,"Senate Housing, Construction And Community Development Committee Vote",10,1,0,0,11
1992551,1580939,2025-05-29,Assembly,"Assembly Ways And Means Committee: Favorable refer to committee Rules",32,2,0,1,35
1992551,1585166,2025-06-04,Assembly,"Assembly Rules Committee: Favorable",28,0,0,3,31
1992570,1574834,2025-05-20,Senate,"Senate Higher Education Committee Vote",11,0,0,0,11
1992570,1587155,2025-06-09,Senate,"Senate Floor Vote - Final Passage",54,8,0,1,63
1992570,1587156,2025-06-09,Senate,"Senate Rules Committee Vote",18,3,0,0,21
1992620,1586133,2025-05-12,Senate,"Senate Judiciary Committee Vote",17,1,0,1,19
1992620,1586134,2025-06-05,Senate,"Senate Floor Vote - Final Passage",42,18,0,3,63
1992624,1561983,2025-04-30,Assembly,"Assembly Labor Committee: Favorable refer to committee Codes",28,0,0,1,29
1992624,1585482,2025-06-05,Assembly,"Assembly Codes Committee: Favorable refer to committee Rules",20,1,0,1,22
1992624,1588530,2025-06-11,Assembly,"Assembly Rules Committee: Favorable",19,9,0,3,31
1992673,1584872,2025-05-06,Senate,"Senate Social Services Committee Vote",6,0,0,0,6
1992673,1584873,2025-06-04,Senate,"Senate Floor Vote - Final Passage",57,1,0,5,63
1992712,1565512,2025-05-06,Assembly,"Assembly Science And Technology Committee: Favorable refer to committee Codes",9,0,0,0,9
1992712,1574359,2025-05-20,Assembly,"Assembly Codes Committee: Favorable refer to committee Rules",20,0,0,2,22
1992712,1591879,2025-06-17,Assembly,"Assembly Rules Committee: Favorable",28,0,0,3,31
1993171,1585770,2025-04-07,Senate,"Senate Investigations And Government Operations Committee Vote",5,2,0,0,7
1993171,1585771,2025-06-04,Senate,"Senate Floor Vote - Final Passage",40,18,0,5,63
1993220,1587104,2025-06-09,Senate,"Senate Floor Vote - Final Passage",60,2,0,1,63
1993220,1587105,2025-06-09,Senate,"Senate Rules Committee Vote",21,0,0,0,21
1993295,1584680,2025-03-25,Senate,"Senate Corporations, Authorities And Commissions Committee Vote",7,0,0,0,7
1993295,1585324,2025-06-04,Senate,"Senate Floor Vote - Final Passage",36,22,0,5,63
1993516,1573214,2025-05-19,Assembly,"Assembly Veterans' Affairs Committee: Favorable refer to committee Rules",18,0,0,1,19
1993516,1574898,2025-05-21,Assembly,"Assembly Rules Committee: Favorable",29,0,0,2,31
1993516,1575822,2025-05-21,Assembly,"Assembly Floor Vote - Final Passage",143,0,0,7,150
1993518,1590056,2025-06-12,Assembly,"Assembly Rules Committee: Favorable",29,0,0,2,31
1993518,1590057,2025-06-12,Assembly,"Assembly Ways And Means Committee: Favorable refer to committee Rules",34,0,0,1,35
1993518,1592672,2025-06-16,Assembly,"Assembly Floor Vote - Final Passage",144,0,0,6,150
1993534,1520238,2025-03-18,Assembly,"Assembly Local Governments Committee: Favorable refer to committee Ways and Means",19,0,0,1,20
1993534,1561284,2025-04-29,Assembly,"Assembly Ways And Means Committee: Favorable refer to committee Rules",32,0,0,3,35
1993534,1561790,2025-04-30,Assembly,"Assembly Rules Committee: Favorable",29,0,0,2,31
1993534,1563302,2025-04-30,Assembly,"Assembly Floor Vote - Final Passage",145,0,0,5,150
1993534,1588205,2025-06-09,Senate,"Senate Floor Vote - Final Passage",61,1,0,1,63
1993562,1580686,2025-05-28,Assembly,"Assembly Insurance Committee: Favorable refer to committee Rules",18,6,0,1,25
1993562,1588150,2025-06-10,Assembly,"Assembly Rules Committee: Favorable",19,9,0,3,31
1993569,1526423,2025-03-25,Assembly,"Assembly Tourism, Arts And Sports Development Committee: Favorable refer to committee Ways and Means",19,0,0,2,21
1993569,1585182,2025-06-04,Assembly,"Assembly Ways And Means Committee: Favorable refer to committee Rules",33,0,0,2,35
1993569,1586030,2025-06-06,Assembly,"Assembly Rules Committee: Favorable",27,0,0,4,31
1993569,1586551,2025-06-06,Assembly,"Assembly Floor Vote - Final Passage",142,0,0,8,150
1993570,1578907,2025-04-29,Senate,"Senate Investigations And Government Operations Committee Vote",7,0,0,0,7
1993570,1591990,2025-05-27,Senate,"Senate Floor Vote - Final Passage",51,8,0,4,63
1993570,1592373,2025-06-17,Assembly,"Assembly Floor Vote - Final Passage",104,30,0,16,150
1993612,1587364,2025-06-10,Assembly,"Assembly Ways And Means Committee: Favorable refer to committee Rules",32,0,0,3,35
1993612,1588495,2025-06-11,Assembly,"Assembly Rules Committee: Favorable",28,0,0,3,31
1993645,1580315,2025-05-28,Assembly,"Assembly Environmental Conservation Committee: Favorable refer to committee Codes",20,9,0,1,30
1993651,1585716,2025-06-05,Assembly,"Assembly Governmental Operations Committee: Favorable refer to committee Rules",13,0,0,1,14
1993651,1586859,2025-06-09,Assembly,"Assembly Rules Committee: Favorable",25,0,0,6,31
1993651,1587545,2025-06-09,Assembly,"Assembly Floor Vote - Final Passage",144,0,0,6,150
1993651,1589353,2025-06-11,Senate,"Senate Floor Vote - Final Passage",57,2,0,4,63
1993685,1579447,2025-04-29,Senate,"Senate Investigations And Government Operations Committee Vote",7,0,0,0,7
1993685,1592015,2025-05-27,Senate,"Senate Floor Vote - Final Passage",51,8,0,4,63
1993685,1592537,2025-06-17,Assembly,"Assembly Floor Vote - Final Passage",103,31,0,16,150
1993689,1579453,2025-04-29,Senate,"Senate Investigations And Government Operations Committee Vote",7,0,0,0,7
1993689,1584895,2025-05-27,Senate,"Senate Floor Vote - Final Passage",51,8,0,4,63
1993689,1586448,2025-06-06,Assembly,"Assembly Floor Vote - Final Passage",101,39,0,10,150
1993698,1534485,2025-04-02,Assembly,"Assembly Insurance Committee: Favorable",25,0,0,0,25
1993698,1540087,2025-04-07,Assembly,"Assembly Floor Vote - Final Passage",144,0,0,6,150
1993708,1570387,2025-05-13,Assembly,"Assembly Insurance Committee: Favorable",18,6,0,1,25
1993708,1575062,2025-05-20,Assembly,"Assembly Floor Vote - Final Passage",147,0,0,3,150
1993708,1587252,2025-06-09,Senate,"Senate Floor Vote - Final Passage",61,1,0,1,63
1993776,1579472,2025-04-29,Senate,"Senate Investigations And Government Operations Committee Vote",7,0,0,0,7
1993776,1592011,2025-05-27,Senate,"Senate Floor Vote - Final Passage",50,9,0,4,63
1993776,1592524,2025-06-17,Assembly,"Assembly Floor Vote - Final Passage",107,27,0,16,150
1993776,1592525,2025-06-17,Assembly,"Assembly Floor Vote - Final Passage",107,27,0,16,150
1993781,1585277,2025-05-20,Senate,"Senate Labor Committee Vote",13,0,0,0,13
1993781,1585278,2025-06-04,Senate,"Senate Floor Vote - Final Passage",57,1,0,5,63
1993786,1570453,2025-05-13,Assembly,"Assembly Codes Committee: Held for Consideration",16,6,0,0,22
1993793,1587315,2025-06-10,Assembly,"Assembly Ways And Means Committee: Favorable refer to committee Rules",32,0,0,3,35
1993793,1588513,2025-06-11,Assembly,"Assembly Rules Committee: Favorable",28,0,0,3,31
1993799,1525846,2025-03-25,Assembly,"Assembly Racing And Wagering Committee: Favorable refer to committee Ways and Means",11,0,0,0,11
1993799,1574271,2025-05-20,Assembly,"Assembly Ways And Means Committee: Favorable refer to committee Rules",35,0,0,0,35
1993805,1586022,2025-06-06,Assembly,"Assembly Ways And Means Committee: Held for Consideration",18,17,0,0,35
1993827,1587310,2025-06-10,Assembly,"Assembly Ways And Means Committee: Favorable refer to committee Rules",32,0,0,3,35
1993827,1590047,2025-06-12,Assembly,"Assembly Rules Committee: Favorable",29,0,0,2,31
1993829,1526479,2025-03-25,Assembly,"Assembly Codes Committee: Favorable",21,0,0,1,22
1993829,1533871,2025-04-01,Assembly,"Assembly Floor Vote - Final Passage",144,0,0,6,150
1993829,1589435,2025-06-11,Senate,"Senate Floor Vote - Final Passage",58,1,0,4,63
1993860,1573221,2025-05-19,Assembly,"Assembly Health Committee: Favorable refer to committee Codes",19,5,0,2,26
1993860,1580140,2025-05-28,Assembly,"Assembly Codes Committee: Favorable refer to committee Rules",17,4,0,1,22
1993860,1581135,2025-05-29,Assembly,"Assembly Rules Committee: Favorable",25,2,0,4,31
1993860,1586116,2025-06-05,Assembly,"Assembly Floor Vote - Final Passage",138,7,0,5,150
1993860,1589368,2025-06-11,Senate,"Senate Floor Vote - Final Passage",47,12,0,4,63
1993863,1581032,2025-05-29,Assembly,"Assembly Science And Technology Committee: Favorable refer to committee Rules",9,0,0,0,9
1993863,1587304,2025-06-10,Assembly,"Assembly Rules Committee: Favorable",28,0,0,3,31
1993863,1588642,2025-06-10,Assembly,"Assembly Floor Vote - Final Passage",147,0,0,3,150
1993879,1573351,2025-05-19,Assembly,"Assembly Governmental Employees Committee: Favorable refer to committee Rules",13,0,0,1,14
1993879,1575416,2025-05-21,Assembly,"Assembly Rules Committee: Favorable",29,0,0,2,31
1993879,1575757,2025-05-21,Assembly,"Assembly Floor Vote - Final Passage",143,0,0,7,150
1993879,1589385,2025-06-11,Senate,"Senate Floor Vote - Final Passage",59,0,0,4,63
1993883,1574231,2025-05-20,Assembly,"Assembly Racing And Wagering Committee: Favorable refer to committee Ways and Means",10,0,0,1,11
1993889,1581693,2025-05-29,Senate,"Senate Children And Families Committee Vote",6,0,0,1,7
1993889,1585523,2025-06-04,Senate,"Senate Rules Committee Vote",20,0,0,1,21
1993889,1590914,2025-06-10,Senate,"Senate Floor Vote - Final Passage",58,0,0,5,63
1993889,1590915,2025-06-10,Senate,"Senate Floor Vote - Final Passage",58,0,0,5,63
1993895,1580199,2025-05-28,Assembly,"Assembly Insurance Committee: Favorable refer to committee Rules",21,3,0,1,25
1993907,1574325,2025-05-20,Assembly,"Assembly Insurance Committee: Favorable refer to committee Rules",25,0,0,0,25
1993907,1581125,2025-05-29,Assembly,"Assembly Rules Committee: Favorable",27,0,0,4,31
1993925,1570388,2025-05-13,Assembly,"Assembly Tourism, Arts And Sports Development Committee: Favorable",20,0,0,1,21
1993925,1574057,2025-05-19,Assembly,"Assembly Floor Vote - Final Passage",143,0,0,7,150
1993940,1514311,2025-03-11,Assembly,"Assembly Veterans' Affairs Committee: Favorable refer to committee Ways and Means",19,0,0,0,19
1993940,1579223,2025-05-27,Assembly,"Assembly Ways And Means Committee: Favorable refer to committee Rules",32,0,0,3,35
1993940,1581515,2025-05-29,Assembly,"Assembly Rules Committee: Favorable",27,0,0,4,31
1993952,1585906,2025-05-13,Senate,"Senate Energy And Telecommunications Committee Vote",8,1,0,0,9
1993952,1585907,2025-06-05,Senate,"Senate Floor Vote - Final Passage",56,4,0,3,63
1993955,1579200,2025-04-29,Senate,"Senate Investigations And Government Operations Committee Vote",7,0,0,0,7
1993955,1590284,2025-05-27,Senate,"Senate Floor Vote - Final Passage",51,8,0,4,63
1993955,1591067,2025-06-13,Assembly,"Assembly Floor Vote - Final Passage",111,26,0,13,150
1993961,1534142,2025-04-02,Assembly,"Assembly Environmental Conservation Committee: Favorable",28,0,0,2,30
1993961,1574872,2025-05-20,Assembly,"Assembly Floor Vote - Final Passage",142,5,0,3,150
1993967,1587294,2025-06-10,Assembly,"Assembly Ways And Means Committee: Favorable refer to committee Rules",32,0,0,3,35
1993967,1591981,2025-06-17,Assembly,"Assembly Rules Committee: Favorable",28,0,0,3,31
1993999,1585457,2025-06-05,Assembly,"Assembly Governmental Employees Committee: Favorable refer to committee Rules",14,0,0,0,14
1993999,1586077,2025-06-06,Assembly,"Assembly Rules Committee: Favorable",27,0,0,4,31
1993999,1586575,2025-06-06,Assembly,"Assembly Floor Vote - Final Passage",142,0,0,8,150
1993999,1589243,2025-06-11,Senate,"Senate Floor Vote - Final Passage",59,0,0,4,63
1994018,1578949,2025-05-27,Assembly,"Assembly Consumer Affairs And Protection Committee: Favorable refer to committee Codes",15,0,0,1,16
1994070,1574533,2025-05-20,Assembly,"Assembly Real Property Taxation Committee: Favorable refer to committee Ways and Means",10,0,0,0,10
1994070,1579412,2025-05-27,Assembly,"Assembly Ways And Means Committee: Favorable refer to committee Rules",32,0,0,3,35
1994070,1581492,2025-05-29,Assembly,"Assembly Rules Committee: Favorable",27,0,0,4,31
1994070,1582189,2025-05-29,Assembly,"Assembly Floor Vote - Final Passage",146,0,0,4,150
1994070,1588153,2025-06-10,Senate,"Senate Floor Vote - Final Passage",56,2,0,5,63
1994078,1586166,2025-05-12,Senate,"Senate Women's Issues Committee Vote",7,0,0,0,7
1994078,1586167,2025-06-06,Senate,"Senate Floor Vote - Final Passage",53,0,0,10,63
1994134,1570753,2025-05-13,Senate,"Senate Children And Families Committee Vote",6,0,0,1,7
1994134,1580881,2025-05-28,Senate,"Senate Finance Committee Vote",22,0,0,0,22
1994134,1589397,2025-06-11,Senate,"Senate Floor Vote - Final Passage",59,0,0,4,63
1994161,1574309,2025-05-20,Senate,"Senate Education Committee Vote",14,0,0,0,14
1994471,1584740,2025-06-04,Assembly,"Assembly Transportation Committee: Favorable refer to committee Ways and Means",22,0,0,4,26
1994471,1593666,2025-06-16,Assembly,"Assembly Rules Committee: Favorable",29,0,0,2,31
1994471,1593667,2025-06-16,Assembly,"Assembly Ways And Means Committee: Favorable refer to committee Rules",32,0,0,3,35
1994523,1590169,2025-06-12,Senate,"Senate Rules Committee Vote",20,0,0,1,21
1994523,1590503,2025-06-13,Senate,"Senate Floor Vote - Final Passage",58,1,0,4,63
1994523,1591317,2025-06-13,Assembly,"Assembly Floor Vote - Final Passage",134,0,0,16,150
1994539,1586157,2025-04-08,Senate,"Senate Civil Service And Pensions Committee Vote",7,0,0,0,7
1994539,1586158,2025-06-06,Senate,"Senate Floor Vote - Final Passage",53,0,0,10,63
1994569,1579000,2025-05-27,Assembly,"Assembly Ways And Means Committee: Favorable refer to committee Rules",30,2,0,3,35
1994569,1591934,2025-06-17,Assembly,"Assembly Rules Committee: Favorable",28,0,0,3,31
1994598,1563143,2025-04-29,Senate,"Senate Women's Issues Committee Vote",7,0,0,0,7
1994598,1581817,2025-05-29,Senate,"Senate Rules Committee Vote",20,0,0,1,21
1994598,1584866,2025-06-04,Senate,"Senate Floor Vote - Final Passage",58,0,0,5,63
1994635,1585177,2025-06-04,Assembly,"Assembly Ways And Means Committee: Favorable refer to committee Rules",32,1,0,2,35
1994635,1588535,2025-06-11,Assembly,"Assembly Rules Committee: Favorable",28,0,0,3,31
1994643,1563967,2025-03-18,Senate,"Senate Transportation Committee Vote",13,0,0,0,13
1994643,1563968,2025-04-30,Senate,"Senate Floor Vote - Final Passage",60,0,0,2,62
1994671,1562412,2025-03-25,Senate,"Senate Judiciary Committee Vote",18,0,0,1,19
1994671,1562413,2025-04-29,Senate,"Senate Floor Vote - Final Passage",61,0,0,1,62
1994671,1588114,2025-06-10,Senate,"Senate Floor Vote - Final Passage",58,0,0,5,63
1994681,1587871,2025-06-09,Senate,"Senate Rules Committee Vote",21,0,0,0,21
1994681,1587872,2025-06-10,Senate,"Senate Floor Vote - Final Passage",58,0,0,5,63
1994703,1589666,2025-06-09,Senate,"Senate Rules Committee Vote",21,0,0,0,21
1994703,1590479,2025-06-12,Senate,"Senate Floor Vote - Final Passage",57,2,0,4,63
1994854,1562880,2025-04-07,Senate,"Senate Housing, Construction And Community Development Committee Vote",11,0,0,0,11
1994854,1562881,2025-04-30,Senate,"Senate Floor Vote - Final Passage",60,0,0,2,62
1994863,1571419,2025-05-13,Senate,"Senate Energy And Telecommunications Committee Vote",6,3,0,0,9
1994863,1590198,2025-06-12,Senate,"Senate Rules Committee Vote",18,2,0,1,21
1994863,1592215,2025-06-13,Senate,"Senate Floor Vote - Final Passage",54,5,0,4,63
1994874,1579441,2025-04-29,Senate,"Senate Investigations And Government Operations Committee Vote",7,0,0,0,7
1994874,1591986,2025-05-27,Senate,"Senate Floor Vote - Final Passage",51,8,0,4,63
1994874,1592346,2025-06-17,Assembly,"Assembly Floor Vote - Final Passage",105,29,0,16,150
1994883,1579479,2025-04-29,Senate,"Senate Investigations And Government Operations Committee Vote",7,0,0,0,7
1994883,1586611,2025-05-27,Senate,"Senate Floor Vote - Final Passage",51,8,0,4,63
1994883,1587491,2025-06-09,Assembly,"Assembly Floor Vote - Final Passage",107,37,0,6,150
1994915,1589840,2025-04-08,Senate,"Senate Education Committee Vote",15,0,0,0,15
1994915,1590592,2025-06-12,Senate,"Senate Floor Vote - Final Passage",59,0,0,4,63
1994936,1589352,2025-05-20,Senate,"Senate Transportation Committee Vote",13,0,0,0,13
1994936,1589699,2025-06-11,Senate,"Senate Floor Vote - Final Passage",58,1,0,4,63
1994936,1592379,2025-06-17,Assembly,"Assembly Floor Vote - Final Passage",134,0,0,16,150
1995004,1572082,2025-05-13,Senate,"Senate Health Committee Vote",13,0,0,1,14
1995004,1590606,2025-06-12,Senate,"Senate Floor Vote - Final Passage",59,0,0,4,63
1995004,1595044,2025-06-12,Senate,"Senate Rules Committee Vote",20,0,0,1,21
1995254,1574659,2025-05-20,Assembly,"Assembly Ways And Means Committee: Favorable refer to committee Rules",33,2,0,0,35
1995254,1591960,2025-06-17,Assembly,"Assembly Rules Committee: Favorable",28,0,0,3,31
1995268,1580465,2025-05-28,Assembly,"Assembly Corporations, Authorities And Commissions Committee: Held for Consideration",17,8,0,1,26
1995293,1574491,2025-05-20,Assembly,"Assembly Economic Development Committee: Favorable refer to committee Rules",17,6,0,3,26
1995293,1579357,2025-05-27,Assembly,"Assembly Rules Committee: Favorable",18,8,0,5,31
1995335,1573887,2025-04-29,Senate,"Senate Finance Committee Vote",22,0,0,0,22
1995335,1573888,2025-05-19,Senate,"Senate Floor Vote - Final Passage",56,0,0,6,62
1995341,1574465,2025-05-20,Assembly,"Assembly Local Governments Committee: Favorable refer to committee Rules",18,0,0,2,20
1995341,1579333,2025-05-27,Assembly,"Assembly Rules Committee: Favorable",26,0,0,5,31
1995345,1570245,2025-05-13,Assembly,"Assembly Codes Committee: Held for Consideration",16,6,0,0,22
1995364,1529005,2025-03-17,Senate,"Senate Investigations And Government Operations Committee Vote",7,0,0,0,7
1995364,1529006,2025-03-27,Senate,"Senate Floor Vote - Final Passage",61,0,0,2,63
1995440,1540240,2025-04-08,Senate,"Senate Agriculture Committee Vote",8,1,0,0,9
1995440,1570291,2025-05-13,Senate,"Senate Finance Committee Vote",22,0,0,0,22
1995440,1587966,2025-06-10,Senate,"Senate Floor Vote - Final Passage",48,10,0,5,63
1995490,1513518,2025-03-11,Assembly,"Assembly Governmental Operations Committee: Favorable refer to committee Ways and Means",14,0,0,0,14
1995490,1517401,2025-03-13,Assembly,"Assembly Ways And Means Committee: Favorable",34,0,0,1,35
1995490,1521186,2025-03-18,Assembly,"Assembly Floor Vote - Final Passage",148,0,0,2,150
1995497,1588318,2025-06-10,Senate,"Senate Floor Vote - Final Passage",58,0,0,5,63
1995497,1588319,2025-06-10,Senate,"Senate Rules Committee Vote",19,0,0,2,21
1996033,1586168,2025-04-08,Senate,"Senate Education Committee Vote",15,0,0,0,15
1996033,1586169,2025-06-06,Senate,"Senate Floor Vote - Final Passage",52,1,0,10,63
1996039,1540141,2025-04-08,Senate,"Senate Civil Service And Pensions Committee Vote",7,0,0,0,7
1996045,1561840,2025-04-29,Senate,"Senate Environmental Conservation Committee Vote",11,0,0,0,11
1996045,1585550,2025-06-04,Senate,"Senate Rules Committee Vote",20,0,0,1,21
1996045,1587087,2025-06-09,Senate,"Senate Floor Vote - Final Passage",62,0,0,1,63
1996128,1581658,2025-05-28,Senate,"Senate Procurement And Contracts Committee Vote",6,0,0,1,7
1996708,1579318,2025-04-29,Senate,"Senate Investigations And Government Operations Committee Vote",7,0,0,0,7
1996708,1589242,2025-05-27,Senate,"Senate Floor Vote - Final Passage",51,8,0,4,63
1996708,1589545,2025-06-11,Assembly,"Assembly Floor Vote - Final Passage",120,26,0,4,150
1996742,1587111,2025-06-09,Senate,"Senate Floor Vote - Final Passage",59,3,0,1,63
1996742,1587112,2025-06-09,Senate,"Senate Rules Committee Vote",21,0,0,0,21
1999466,1579312,2025-04-29,Senate,"Senate Investigations And Government Operations Committee Vote",7,0,0,0,7
1999466,1589436,2025-05-27,Senate,"Senate Floor Vote - Final Passage",50,9,0,4,63
1999466,1589437,2025-06-11,Assembly,"Assembly Floor Vote - Final Passage",121,25,0,4,150
1999538,1585213,2025-06-04,Assembly,"Assembly Ways And Means Committee: Favorable refer to committee Rules",32,1,0,2,35
1999538,1586001,2025-06-06,Assembly,"Assembly Rules Committee: Favorable",27,0,0,4,31
1999547,1584742,2025-06-04,Assembly,"Assembly Judiciary Committee: Favorable refer to committee Rules",19,0,0,2,21
1999547,1585984,2025-06-06,Assembly,"Assembly Rules Committee: Favorable",27,0,0,4,31
1999547,1586653,2025-06-06,Assembly,"Assembly Floor Vote - Final Passage",141,0,0,9,150
1999547,1587775,2025-06-10,Senate,"Senate Floor Vote - Final Passage",58,0,0,5,63
1999612,1579842,2025-04-29,Senate,"Senate Investigations And Government Operations Committee Vote",7,0,0,0,7
1999612,1587767,2025-05-27,Senate,"Senate Floor Vote - Final Passage",51,8,0,4,63
1999612,1588924,2025-06-10,Assembly,"Assembly Floor Vote - Final Passage",120,27,0,3,150
1999624,1561935,2025-04-30,Assembly,"Assembly Racing And Wagering Committee: Favorable refer to committee Codes",11,0,0,0,11
1999624,1580049,2025-05-28,Assembly,"Assembly Codes Committee: Favorable refer to committee Ways and Means",21,0,0,1,22
1999624,1586002,2025-06-06,Assembly,"Assembly Ways And Means Committee: Favorable refer to committee Rules",35,0,0,0,35
1999624,1590706,2025-06-13,Assembly,"Assembly Rules Committee: Favorable",20,9,0,2,31
1999640,1580604,2025-05-28,Assembly,"Assembly Election Law Committee: Favorable refer to committee Rules",10,5,0,1,16
1999640,1581504,2025-05-29,Assembly,"Assembly Rules Committee: Favorable",18,9,0,4,31
1999640,1587211,2025-06-09,Assembly,"Assembly Floor Vote - Final Passage",97,46,0,7,150
1999661,1587302,2025-06-10,Assembly,"Assembly Ways And Means Committee: Favorable refer to committee Rules",32,0,0,3,35
1999661,1588553,2025-06-11,Assembly,"Assembly Rules Committee: Favorable",28,0,0,3,31
1999661,1589078,2025-06-11,Senate,"Senate Floor Vote - Final Passage",58,1,0,4,63
1999661,1589646,2025-06-11,Assembly,"Assembly Floor Vote - Final Passage",146,0,0,4,150
1999707,1570933,2025-05-13,Senate,"Senate Corporations, Authorities And Commissions Committee Vote",7,0,0,0,7
1999763,1571026,2025-05-14,Senate,"Senate Local Government Committee Vote",6,0,0,1,7
1999763,1580728,2025-05-28,Senate,"Senate Finance Committee Vote",22,0,0,0,22
1999763,1586123,2025-06-06,Senate,"Senate Floor Vote - Final Passage",53,0,0,10,63
1999763,1587213,2025-06-09,Assembly,"Assembly Floor Vote - Final Passage",144,0,0,6,150
1999796,1580201,2025-05-28,Senate,"Senate Racing, Gaming And Wagering Committee Vote",7,0,0,0,7
1999796,1590140,2025-06-12,Senate,"Senate Rules Committee Vote",18,2,0,1,21
1999796,1590732,2025-06-13,Senate,"Senate Floor Vote - Final Passage",55,4,0,4,63
1999796,1592528,2025-06-17,Assembly,"Assembly Floor Vote - Final Passage",134,5,0,11,150
1999839,1588330,2025-06-10,Senate,"Senate Floor Vote - Final Passage",54,4,0,5,63
1999839,1588331,2025-06-10,Senate,"Senate Rules Committee Vote",18,1,0,2,21
1999839,1592535,2025-06-16,Assembly,"Assembly Floor Vote - Final Passage",144,0,0,6,150
1999862,1576770,2025-03-25,Senate,"Senate Crime Victims, Crime And Correction Committee Vote",6,0,0,1,7
1999862,1576771,2025-05-22,Senate,"Senate Floor Vote - Final Passage",47,10,0,5,62
1999892,1566531,2025-05-06,Senate,"Senate Cities 1 Committee Vote",7,0,0,0,7
1999898,1588969,2025-05-13,Senate,"Senate Environmental Conservation Committee Vote",10,1,0,0,11
1999898,1589454,2025-06-11,Senate,"Senate Floor Vote - Final Passage",57,2,0,4,63
1999898,1592481,2025-06-17,Assembly,"Assembly Floor Vote - Final Passage",139,2,0,9,150
2004678,1526121,2025-03-25,Assembly,"Assembly Codes Committee: Favorable refer to committee Rules",21,0,0,1,22
2004678,1526122,2025-03-25,Assembly,"Assembly Consumer Affairs And Protection Committee: Favorable refer to committee Codes",14,1,0,1,16
2004678,1526278,2025-03-25,Assembly,"Assembly Rules Committee: Favorable",30,0,0,1,31
2005027,1539345,2025-04-08,Assembly,"Assembly Energy Committee: Favorable refer to committee Rules",15,0,0,2,17
2005027,1540302,2025-04-08,Assembly,"Assembly Rules Committee: Favorable",30,0,0,1,31
2005027,1541312,2025-04-08,Assembly,"Assembly Floor Vote - Final Passage",147,0,0,3,150
2005027,1562462,2025-04-30,Senate,"Senate Floor Vote - Final Passage",60,0,0,2,62
2005216,1520287,2025-03-18,Assembly,"Assembly Banks Committee: Favorable refer to committee Codes",21,8,0,2,31
2005216,1566482,2025-05-06,Assembly,"Assembly Codes Committee: Favorable",16,6,0,0,22
2005216,1580902,2025-05-28,Assembly,"Assembly Floor Vote - Final Passage",102,42,0,6,150
2005298,1519720,2025-03-18,Assembly,"Assembly Local Governments Committee: Favorable refer to committee Ways and Means",19,0,0,1,20
2005298,1519721,2025-03-18,Assembly,"Assembly Rules Committee: Favorable",30,0,0,1,31
2005298,1519722,2025-03-18,Assembly,"Assembly Ways And Means Committee: Favorable refer to committee Rules",31,0,0,4,35
2005298,1521204,2025-03-18,Assembly,"Assembly Floor Vote - Final Passage",148,0,0,2,150
2005298,1562058,2025-04-30,Senate,"Senate Floor Vote - Final Passage",59,1,0,2,62
2005625,1586200,2025-04-08,Senate,"Senate Crime Victims, Crime And Correction Committee Vote",7,0,0,0,7
2005625,1586201,2025-06-06,Senate,"Senate Floor Vote - Final Passage",50,3,0,10,63
2005632,1579104,2025-04-29,Senate,"Senate Investigations And Government Operations Committee Vote",7,0,0,0,7
2005632,1580204,2025-05-27,Senate,"Senate Floor Vote - Final Passage",51,8,0,4,63
2005632,1589470,2025-06-11,Assembly,"Assembly Floor Vote - Final Passage",120,26,0,4,150
2005706,1583748,2025-05-28,Senate,"Senate Health Committee Vote",13,0,0,2,15
2005706,1585517,2025-06-04,Senate,"Senate Rules Committee Vote",20,0,0,1,21
2005706,1590917,2025-06-10,Senate,"Senate Floor Vote - Final Passage",58,0,0,5,63
2005720,1578887,2025-04-29,Senate,"Senate Investigations And Government Operations Committee Vote",7,0,0,0,7
2005720,1588607,2025-05-27,Senate,"Senate Floor Vote - Final Passage",51,8,0,4,63
2005720,1589530,2025-06-11,Assembly,"Assembly Floor Vote - Final Passage",120,26,0,4,150
2005728,1574888,2025-05-20,Senate,"Senate Civil Service And Pensions Committee Vote",7,0,0,0,7
2005792,1540016,2025-04-08,Senate,"Senate Civil Service And Pensions Committee Vote",7,0,0,0,7
2005792,1561189,2025-04-29,Senate,"Senate Finance Committee Vote",22,0,0,0,22
2005822,1590250,2025-06-12,Senate,"Senate Rules Committee Vote",19,1,0,1,21
2005822,1590734,2025-06-13,Senate,"Senate Floor Vote - Final Passage",57,2,0,4,63
2005822,1592687,2025-06-17,Assembly,"Assembly Floor Vote - Final Passage",122,12,0,16,150
2005839,1585275,2025-04-08,Senate,"Senate Crime Victims, Crime And Correction Committee Vote",7,0,0,0,7
2005839,1585276,2025-06-04,Senate,"Senate Floor Vote - Final Passage",58,0,0,5,63
2005847,1579548,2025-04-29,Senate,"Senate Investigations And Government Operations Committee Vote",7,0,0,0,7
2005847,1584882,2025-05-27,Senate,"Senate Floor Vote - Final Passage",51,8,0,4,63
2005847,1585345,2025-06-04,Assembly,"Assembly Floor Vote - Final Passage",108,36,0,6,150
2005868,1574094,2025-05-19,Senate,"Senate Energy And Telecommunications Committee Vote",6,3,0,0,9
2005892,1525986,2025-03-25,Assembly,"Assembly Consumer Affairs And Protection Committee: Favorable refer to committee Codes",15,0,0,1,16
2005892,1526284,2025-03-25,Assembly,"Assembly Codes Committee: Favorable refer to committee Rules",21,0,0,1,22
2005892,1526285,2025-03-25,Assembly,"Assembly Rules Committee: Favorable",30,0,0,1,31
2005892,1527381,2025-03-25,Assembly,"Assembly Floor Vote - Final Passage",149,0,0,1,150
2005929,1539877,2025-04-08,Senate,"Senate Civil Service And Pensions Committee Vote",7,0,0,0,7
2006004,1540072,2025-04-08,Senate,"Senate Civil Service And Pensions Committee Vote",7,0,0,0,7
2006066,1570816,2025-05-13,Senate,"Senate Civil Service And Pensions Committee Vote",7,0,0,0,7
2006132,1574836,2025-05-20,Senate,"Senate Civil Service And Pensions Committee Vote",7,0,0,0,7
2006132,1580877,2025-05-28,Senate,"Senate Finance Committee Vote",22,0,0,0,22
2006132,1590366,2025-06-12,Senate,"Senate Floor Vote - Final Passage",59,0,0,4,63
2006132,1592630,2025-06-16,Assembly,"Assembly Floor Vote - Final Passage",144,0,0,6,150
2006282,1590842,2025-06-12,Senate,"Senate Rules Committee Vote",20,0,0,1,21
2006282,1590843,2025-06-13,Senate,"Senate Floor Vote - Final Passage",58,1,0,4,63
2006374,1589942,2025-05-28,Senate,"Senate Insurance Committee Vote",11,0,0,0,11
2006374,1590452,2025-06-12,Senate,"Senate Floor Vote - Final Passage",53,6,0,4,63
2006374,1592227,2025-06-16,Assembly,"Assembly Floor Vote - Final Passage",139,5,0,6,150
2006551,1526453,2025-03-25,Assembly,"Assembly Corporations, Authorities And Commissions Committee: Favorable",25,0,0,1,26
2006551,1534191,2025-04-01,Assembly,"Assembly Floor Vote - Final Passage",144,0,0,6,150
2006551,1590349,2025-06-12,Senate,"Senate Floor Vote - Final Passage",59,0,0,4,63
2006631,1519422,2025-03-18,Assembly,"Assembly Real Property Taxation Committee: Favorable refer to committee Ways and Means",10,0,0,0,10
2006631,1519732,2025-03-18,Assembly,"Assembly Rules Committee: Favorable",30,0,0,1,31
2006631,1519733,2025-03-18,Assembly,"Assembly Ways And Means Committee: Favorable refer to committee Rules",31,0,0,4,35
2006631,1521199,2025-03-18,Assembly,"Assembly Floor Vote - Final Passage",148,0,0,2,150
2006631,1561588,2025-04-29,Senate,"Senate Floor Vote - Final Passage",58,3,0,1,62
2006797,1520096,2025-03-18,Assembly,"Assembly Local Governments Committee: Favorable",19,0,0,1,20
2006797,1525885,2025-03-24,Assembly,"Assembly Floor Vote - Final Passage",147,0,0,3,150
2007095,1561291,2025-04-29,Assembly,"Assembly Ways And Means Committee: Favorable refer to committee Rules",31,1,0,3,35
2007095,1561782,2025-04-30,Assembly,"Assembly Rules Committee: Favorable",29,0,0,2,31
2007095,1563422,2025-04-30,Assembly,"Assembly Floor Vote - Final Passage",106,39,0,5,150
2007095,1599250,2025-05-27,Senate,"Senate Floor Vote - Final Passage",51,8,0,4,63
2007104,1589086,2025-05-06,Senate,"Senate Consumer Protection Committee Vote",7,0,0,0,7
2007104,1589684,2025-06-11,Senate,"Senate Floor Vote - Final Passage",53,6,0,4,63
2007141,1570748,2025-05-13,Senate,"Senate Crime Victims, Crime And Correction Committee Vote",6,1,0,0,7
2007166,1590781,2025-06-13,Assembly,"Assembly Ways And Means Committee: Favorable refer to committee Rules",30,2,0,3,35
2007166,1591974,2025-06-17,Assembly,"Assembly Rules Committee: Favorable",28,0,0,3,31
2007203,1586091,2025-06-06,Assembly,"Assembly Ways And Means Committee: Favorable refer to committee Rules",35,0,0,0,35
2007203,1588538,2025-06-11,Assembly,"Assembly Rules Committee: Favorable",28,0,0,3,31
2007239,1586008,2025-06-06,Assembly,"Assembly Ways And Means Committee: Favorable refer to committee Rules",35,0,0,0,35
2007239,1587333,2025-06-10,Assembly,"Assembly Rules Committee: Favorable",28,0,0,3,31
2007271,1585524,2025-06-05,Assembly,"Assembly Local Governments Committee: Favorable refer to committee Rules",19,0,0,1,20
2007271,1585921,2025-06-06,Assembly,"Assembly Rules Committee: Favorable",27,0,0,4,31
2007271,1586533,2025-06-06,Assembly,"Assembly Floor Vote - Final Passage",141,0,0,9,150
2007330,1585209,2025-06-04,Assembly,"Assembly Ways And Means Committee: Favorable refer to committee Rules",27,6,0,2,35
2007330,1586056,2025-06-06,Assembly,"Assembly Rules Committee: Favorable",27,0,0,4,31
2007330,1586852,2025-06-06,Assembly,"Assembly Floor Vote - Final Passage",90,51,0,9,150
2007330,1590689,2025-06-13,Senate,"Senate Floor Vote - Final Passage",46,13,0,4,63
2007491,1565622,2025-05-06,Assembly,"Assembly Consumer Affairs And Protection Committee: Favorable refer to committee Codes",11,5,0,0,16
2007491,1570650,2025-05-13,Assembly,"Assembly Codes Committee: Favorable",16,6,0,0,22
2007499,1570351,2025-05-13,Assembly,"Assembly Rules Committee: Favorable",27,1,0,3,31
2007499,1570352,2025-05-13,Assembly,"Assembly Ways And Means Committee: Favorable refer to committee Rules",32,2,0,1,35
2007499,1571044,2025-05-13,Assembly,"Assembly Floor Vote - Final Passage",134,11,0,5,150
2007499,1579562,2025-05-27,Senate,"Senate Floor Vote - Final Passage",54,5,0,4,63
2007502,1520255,2025-03-18,Assembly,"Assembly Health Committee: Favorable",25,0,0,1,26
2007508,1570449,2025-04-08,Senate,"Senate Crime Victims, Crime And Correction Committee Vote",7,0,0,0,7
2007508,1570450,2025-05-12,Senate,"Senate Floor Vote - Final Passage",49,8,0,5,62
2007511,1588140,2025-06-10,Assembly,"Assembly Ways And Means Committee: Favorable refer to committee Rules",32,0,0,3,35
2007511,1588527,2025-06-11,Assembly,"Assembly Rules Committee: Favorable",28,0,0,3,31
2007527,1566554,2025-05-06,Assembly,"Assembly Transportation Committee: Favorable refer to committee Ways and Means",24,0,0,2,26
2007527,1579413,2025-05-27,Assembly,"Assembly Ways And Means Committee: Favorable refer to committee Rules",32,0,0,3,35
2007527,1585208,2025-06-04,Assembly,"Assembly Rules Committee: Favorable",28,0,0,3,31
2007527,1585377,2025-06-04,Assembly,"Assembly Floor Vote - Final Passage",144,0,0,6,150
2007527,1587440,2025-06-09,Senate,"Senate Floor Vote - Final Passage",61,1,0,1,63
2007543,1585915,2025-06-06,Assembly,"Assembly Ways And Means Committee: Favorable refer to committee Rules",35,0,0,0,35
2007543,1586985,2025-06-09,Assembly,"Assembly Rules Committee: Favorable",25,0,0,6,31
2007636,1586784,2025-06-04,Senate,"Senate Rules Committee Vote",20,0,0,1,21
2007636,1587202,2025-06-09,Senate,"Senate Floor Vote - Final Passage",62,0,0,1,63
2007684,1586149,2025-05-13,Senate,"Senate Crime Victims, Crime And Correction Committee Vote",7,0,0,0,7
2007684,1586150,2025-06-06,Senate,"Senate Floor Vote - Final Passage",46,7,0,10,63
2007720,1570600,2025-05-13,Senate,"Senate Crime Victims, Crime And Correction Committee Vote",7,0,0,0,7
2007845,1570935,2025-05-12,Senate,"Senate Housing, Construction And Community Development Committee Vote",11,0,0,0,11
2007979,1570848,2025-05-13,Senate,"Senate Civil Service And Pensions Committee Vote",7,0,0,0,7
2007979,1588057,2025-06-10,Senate,"Senate Floor Vote - Final Passage",58,0,0,5,63
2007979,1588058,2025-06-10,Senate,"Senate Rules Committee Vote",19,0,0,2,21
2008041,1561758,2025-04-29,Senate,"Senate Women's Issues Committee Vote",7,0,0,0,7
2008066,1519484,2025-03-18,Assembly,"Assembly Labor Committee: Favorable refer to committee Codes",26,1,0,2,29
2008066,1526257,2025-03-25,Assembly,"Assembly Codes Committee: Favorable refer to committee Rules",21,0,0,1,22
2008066,1526258,2025-03-25,Assembly,"Assembly Rules Committee: Favorable",30,0,0,1,31
2008165,1576060,2025-04-30,Senate,"Senate Higher Education Committee Vote",11,0,0,0,11
2008165,1576061,2025-05-22,Senate,"Senate Floor Vote - Final Passage",57,0,0,5,62
2008226,1520470,2025-03-18,Assembly,"Assembly Labor Committee: Favorable refer to committee Codes",27,0,0,2,29
2008226,1526271,2025-03-25,Assembly,"Assembly Codes Committee: Favorable refer to committee Rules",21,0,0,1,22
2008226,1526272,2025-03-25,Assembly,"Assembly Rules Committee: Favorable",30,0,0,1,31
2008226,1527627,2025-03-25,Assembly,"Assembly Floor Vote - Final Passage",149,0,0,1,150
2008388,1519440,2025-03-18,Assembly,"Assembly Governmental Operations Committee: Favorable refer to committee Codes",14,0,0,0,14
2008388,1526424,2025-03-25,Assembly,"Assembly Codes Committee: Favorable refer to committee Ways and Means",21,0,0,1,22
2008388,1532004,2025-04-01,Assembly,"Assembly Rules Committee: Favorable",30,0,0,1,31
2008388,1532005,2025-04-01,Assembly,"Assembly Ways And Means Committee: Favorable refer to committee Rules",33,0,0,2,35
2008388,1535702,2025-04-02,Assembly,"Assembly Floor Vote - Final Passage",146,2,0,2,150
2008388,1562850,2025-04-30,Senate,"Senate Floor Vote - Final Passage",60,0,0,2,62
2008473,1584605,2025-06-04,Assembly,"Assembly Banks Committee: Favorable refer to committee Rules",21,9,0,1,31
2008473,1585934,2025-06-06,Assembly,"Assembly Rules Committee: Favorable",19,8,0,4,31
2008473,1587417,2025-06-09,Assembly,"Assembly Floor Vote - Final Passage",96,46,0,8,150
2008473,1588184,2025-06-10,Senate,"Senate Floor Vote - Final Passage",58,0,0,5,63
2008742,1590192,2025-04-29,Senate,"Senate Aging Committee Vote",6,0,0,0,6
2008742,1590193,2025-06-11,Senate,"Senate Floor Vote - Final Passage",59,0,0,4,63
2008789,1569724,2025-05-12,Senate,"Senate Insurance Committee Vote",11,0,0,0,11
2008789,1588309,2025-06-10,Senate,"Senate Floor Vote - Final Passage",58,0,0,5,63
2008789,1588310,2025-06-10,Senate,"Senate Rules Committee Vote",19,0,0,2,21
2008964,1570850,2025-05-13,Senate,"Senate Civil Service And Pensions Committee Vote",7,0,0,0,7
2009203,1570742,2025-05-13,Senate,"Senate Civil Service And Pensions Committee Vote",7,0,0,0,7
2009435,1571698,2025-05-14,Senate,"Senate Agriculture Committee Vote",8,0,0,1,9
2009435,1589305,2025-06-11,Senate,"Senate Floor Vote - Final Passage",59,0,0,4,63
2009435,1589306,2025-06-11,Senate,"Senate Rules Committee Vote",20,0,0,1,21
2009487,1575413,2025-05-13,Senate,"Senate Procurement And Contracts Committee Vote",7,0,0,0,7
2009487,1575414,2025-05-21,Senate,"Senate Floor Vote - Final Passage",59,0,0,3,62
2009559,1589458,2025-05-13,Senate,"Senate Health Committee Vote",13,0,0,1,14
2009559,1589459,2025-06-11,Senate,"Senate Floor Vote - Final Passage",59,0,0,4,63
2009705,1588531,2025-06-11,Assembly,"Assembly Ways And Means Committee: Favorable refer to committee Rules",34,0,0,1,35
2009705,1590065,2025-06-12,Assembly,"Assembly Rules Committee: Favorable",29,0,0,2,31
2009711,1586863,2025-04-07,Senate,"Senate Housing, Construction And Community Development Committee Vote",9,2,0,0,11
2009711,1587189,2025-06-09,Senate,"Senate Floor Vote - Final Passage",41,21,0,1,63
2009732,1574534,2025-05-20,Assembly,"Assembly Labor Committee: Favorable refer to committee Rules",28,1,0,0,29
2009732,1591560,2025-06-17,Assembly,"Assembly Rules Committee: Favorable",30,0,0,1,31
2009745,1542492,2025-04-09,Senate,"Senate Codes Committee Vote",9,3,0,1,13
2009820,1566570,2025-05-06,Senate,"Senate Cities 1 Committee Vote",6,1,0,0,7
2009896,1590881,2025-06-12,Senate,"Senate Rules Committee Vote",17,3,0,1,21
2009896,1590882,2025-06-13,Senate,"Senate Floor Vote - Final Passage",47,12,0,4,63
2009896,1591083,2025-06-13,Assembly,"Assembly Floor Vote - Final Passage",107,29,0,14,150
2010006,1588481,2025-06-11,Assembly,"Assembly Ways And Means Committee: Favorable refer to committee Rules",34,0,0,1,35
2010006,1590025,2025-06-12,Assembly,"Assembly Rules Committee: Favorable",29,0,0,2,31
2010021,1584630,2025-06-04,Assembly,"Assembly Banks Committee: Held for Consideration",20,10,0,1,31
2010026,1534292,2025-04-02,Assembly,"Assembly Insurance Committee: Favorable",25,0,0,0,25
2010026,1575122,2025-05-20,Assembly,"Assembly Floor Vote - Final Passage",147,0,0,3,150
2010026,1590398,2025-06-12,Senate,"Senate Floor Vote - Final Passage",59,0,0,4,63
2010032,1585999,2025-06-06,Assembly,"Assembly Ways And Means Committee: Held for Consideration",25,10,0,0,35
2010049,1562636,2025-04-30,Assembly,"Assembly Local Governments Committee: Favorable refer to committee Codes",11,7,0,2,20
2010049,1570420,2025-05-13,Assembly,"Assembly Codes Committee: Favorable refer to committee Ways and Means",16,6,0,0,22
2010049,1579422,2025-05-27,Assembly,"Assembly Ways And Means Committee: Favorable refer to committee Rules",26,6,0,3,35
2010049,1581485,2025-05-29,Assembly,"Assembly Rules Committee: Favorable",26,1,0,4,31
2010049,1590202,2025-06-12,Assembly,"Assembly Floor Vote - Final Passage",100,44,0,6,150
2010049,1590608,2025-06-12,Senate,"Senate Floor Vote - Final Passage",40,19,0,4,63
2010051,1579734,2025-05-28,Assembly,"Assembly Transportation Committee: Held for Consideration",16,7,0,3,26
2010066,1573396,2025-05-19,Assembly,"Assembly Consumer Affairs And Protection Committee: Favorable refer to committee Codes",15,0,0,1,16
2010066,1585635,2025-06-05,Assembly,"Assembly Codes Committee: Favorable refer to committee Rules",21,0,0,1,22
2010066,1586052,2025-06-06,Assembly,"Assembly Rules Committee: Favorable",27,0,0,4,31
2010066,1586521,2025-06-06,Assembly,"Assembly Floor Vote - Final Passage",140,0,0,10,150
2010066,1590623,2025-06-12,Senate,"Senate Floor Vote - Final Passage",58,1,0,4,63
2010067,1570408,2025-05-13,Assembly,"Assembly Codes Committee: Held for Consideration",16,6,0,0,22
2010069,1589773,2025-06-12,Assembly,"Assembly Ways And Means Committee: Favorable refer to committee Rules",34,0,0,1,35
2010069,1590664,2025-06-13,Assembly,"Assembly Rules Committee: Favorable",29,0,0,2,31
2010069,1591270,2025-06-13,Assembly,"Assembly Floor Vote - Final Passage",133,0,0,17,150
2010076,1574432,2025-05-20,Assembly,"Assembly Libraries And Education Technology Committee: Held for Consideration",7,2,0,0,9
2010079,1570457,2025-05-13,Assembly,"Assembly Codes Committee: Held for Consideration",16,6,0,0,22
2010080,1575430,2025-05-21,Senate,"Senate Commerce, Economic Development And Small Business Committee Vote",9,0,0,0,9
2010080,1589303,2025-06-11,Senate,"Senate Floor Vote - Final Passage",59,0,0,4,63
2010080,1589304,2025-06-11,Senate,"Senate Rules Committee Vote",20,0,0,1,21
2010081,1580291,2025-05-28,Assembly,"Assembly Environmental Conservation Committee: Favorable refer to committee Codes",21,8,0,1,30
2010084,1579188,2025-05-27,Assembly,"Assembly Health Committee: Favorable refer to committee Rules",26,0,0,0,26
2010084,1585181,2025-06-04,Assembly,"Assembly Rules Committee: Favorable",28,0,0,3,31
2010084,1585374,2025-06-04,Assembly,"Assembly Floor Vote - Final Passage",144,0,0,6,150
2010084,1590687,2025-06-12,Senate,"Senate Floor Vote - Final Passage",59,0,0,4,63
2010096,1570499,2025-05-13,Assembly,"Assembly Tourism, Arts And Sports Development Committee: Favorable refer to committee Ways and Means",20,0,0,1,21
2010096,1574661,2025-05-20,Assembly,"Assembly Ways And Means Committee: Favorable refer to committee Rules",35,0,0,0,35
2010096,1574921,2025-05-21,Assembly,"Assembly Rules Committee: Favorable",29,0,0,2,31
2010096,1575740,2025-05-21,Assembly,"Assembly Floor Vote - Final Passage",143,0,0,7,150
2010122,1585983,2025-06-06,Assembly,"Assembly Ways And Means Committee: Favorable refer to committee Rules",35,0,0,0,35
2010122,1588485,2025-06-11,Assembly,"Assembly Rules Committee: Favorable",28,0,0,3,31
2010141,1580137,2025-05-28,Assembly,"Assembly Insurance Committee: Favorable refer to committee Rules",24,0,0,1,25
2010141,1591405,2025-06-16,Assembly,"Assembly Rules Committee: Favorable",29,0,0,2,31
2010152,1587306,2025-06-10,Assembly,"Assembly Ways And Means Committee: Favorable refer to committee Rules",32,0,0,3,35
2010152,1590024,2025-06-12,Assembly,"Assembly Rules Committee: Favorable",29,0,0,2,31
2010194,1585612,2025-06-05,Assembly,"Assembly Codes Committee: Favorable refer to committee Rules",21,0,0,1,22
2010194,1588151,2025-06-10,Assembly,"Assembly Rules Committee: Favorable",27,1,0,3,31
2010194,1589176,2025-06-10,Assembly,"Assembly Floor Vote - Final Passage",133,14,0,3,150
2010195,1585597,2025-06-05,Assembly,"Assembly Local Governments Committee: Favorable refer to committee Ways and Means",19,0,0,1,20
2010195,1586027,2025-06-06,Assembly,"Assembly Ways And Means Committee: Favorable refer to committee Rules",35,0,0,0,35
2010195,1587321,2025-06-10,Assembly,"Assembly Rules Committee: Favorable",28,0,0,3,31
2010195,1589171,2025-06-10,Assembly,"Assembly Floor Vote - Final Passage",147,0,0,3,150
2010195,1589172,2025-06-11,Senate,"Senate Floor Vote - Final Passage",59,0,0,4,63
2010221,1526021,2025-03-25,Assembly,"Assembly Cities Committee: Favorable refer to committee Ways and Means",13,1,0,2,16
2010221,1538028,2025-04-07,Assembly,"Assembly Rules Committee: Favorable",29,0,0,2,31
2010221,1538029,2025-04-07,Assembly,"Assembly Ways And Means Committee: Favorable refer to committee Rules",33,0,0,2,35
2010221,1543495,2025-04-09,Assembly,"Assembly Floor Vote - Final Passage",149,0,0,1,150
2010221,1584814,2025-06-04,Senate,"Senate Floor Vote - Final Passage",58,0,0,5,63
2010243,1570693,2025-05-13,Assembly,"Assembly Codes Committee: Held for Consideration",16,6,0,0,22
2010255,1574686,2025-05-20,Assembly,"Assembly Higher Education Committee: Held for Consideration",15,8,0,3,26
2010265,1585414,2025-06-05,Assembly,"Assembly Governmental Employees Committee: Favorable refer to committee Ways and Means",14,0,0,0,14
2010265,1586014,2025-06-06,Assembly,"Assembly Ways And Means Committee: Favorable refer to committee Rules",35,0,0,0,35
2010265,1586782,2025-06-09,Assembly,"Assembly Rules Committee: Favorable",25,0,0,6,31
2010265,1587244,2025-06-09,Assembly,"Assembly Floor Vote - Final Passage",144,0,0,6,150
2010265,1588293,2025-06-10,Senate,"Senate Floor Vote - Final Passage",58,0,0,5,63
2010273,1570456,2025-05-13,Assembly,"Assembly Local Governments Committee: Favorable refer to committee Ways and Means",18,0,0,2,20
2010273,1574695,2025-05-20,Assembly,"Assembly Ways And Means Committee: Favorable refer to committee Rules",35,0,0,0,35
2010273,1574931,2025-05-21,Assembly,"Assembly Rules Committee: Favorable",29,0,0,2,31
2010273,1575847,2025-05-21,Assembly,"Assembly Floor Vote - Final Passage",143,0,0,7,150
2010273,1588012,2025-06-10,Senate,"Senate Floor Vote - Final Passage",57,1,0,5,63
2010301,1591454,2025-06-16,Assembly,"Assembly Ways And Means Committee: Favorable refer to committee Rules",28,4,0,3,35
2010301,1591975,2025-06-17,Assembly,"Assembly Rules Committee: Favorable",28,0,0,3,31
2010302,1570658,2025-05-13,Assembly,"Assembly Codes Committee: Held for Consideration",16,6,0,0,22
2010305,1573383,2025-05-19,Assembly,"Assembly Governmental Employees Committee: Favorable refer to committee Ways and Means",13,0,0,1,14
2010305,1580919,2025-05-29,Assembly,"Assembly Ways And Means Committee: Favorable refer to committee Rules",34,0,0,1,35
2010305,1585173,2025-06-04,Assembly,"Assembly Rules Committee: Favorable",28,0,0,3,31
2010305,1585373,2025-06-04,Assembly,"Assembly Floor Vote - Final Passage",144,0,0,6,150
2010305,1588239,2025-06-10,Senate,"Senate Floor Vote - Final Passage",58,0,0,5,63
2010311,1534110,2025-04-02,Assembly,"Assembly Economic Development Committee: Favorable refer to committee Ways and Means",25,0,0,1,26
2010311,1538036,2025-04-07,Assembly,"Assembly Rules Committee: Favorable",29,0,0,2,31
2010311,1538037,2025-04-07,Assembly,"Assembly Ways And Means Committee: Favorable refer to committee Rules",30,3,0,2,35
2010311,1541408,2025-04-08,Assembly,"Assembly Floor Vote - Final Passage",144,3,0,3,150
2010311,1565194,2025-05-05,Senate,"Senate Floor Vote - Final Passage",60,1,0,1,62
2010312,1574630,2025-05-20,Assembly,"Assembly Judiciary Committee: Favorable refer to committee Rules",20,0,0,1,21
2010317,1574064,2025-05-20,Assembly,"Assembly Environmental Conservation Committee: Favorable refer to committee Codes",23,7,0,0,30
2010317,1580169,2025-05-28,Assembly,"Assembly Codes Committee: Favorable refer to committee Rules",15,6,0,1,22
2010317,1581138,2025-05-29,Assembly,"Assembly Rules Committee: Favorable",18,9,0,4,31
2010735,1575336,2025-05-06,Senate,"Senate Civil Service And Pensions Committee Vote",7,0,0,0,7
2010735,1575337,2025-05-21,Senate,"Senate Floor Vote - Final Passage",59,0,0,3,62
2010735,1587232,2025-06-09,Assembly,"Assembly Floor Vote - Final Passage",144,0,0,6,150
2010819,1534549,2025-04-02,Senate,"Senate Civil Service And Pensions Committee Vote",7,0,0,0,7
2010819,1587131,2025-06-09,Senate,"Senate Floor Vote - Final Passage",62,0,0,1,63
2010819,1587132,2025-06-09,Senate,"Senate Rules Committee Vote",21,0,0,0,21
2010819,1589669,2025-06-11,Assembly,"Assembly Floor Vote - Final Passage",146,0,0,4,150
2010852,1539994,2025-04-08,Senate,"Senate Civil Service And Pensions Committee Vote",7,0,0,0,7
2010964,1590883,2025-06-12,Senate,"Senate Rules Committee Vote",20,0,0,1,21
2010964,1590884,2025-06-13,Senate,"Senate Floor Vote - Final Passage",59,0,0,4,63
2010983,1588966,2025-05-06,Senate,"Senate Cities 1 Committee Vote",7,0,0,0,7
2010983,1589259,2025-06-11,Senate,"Senate Floor Vote - Final Passage",59,0,0,4,63
2010999,1526080,2025-03-25,Assembly,"Assembly Corporations, Authorities And Commissions Committee: Favorable refer to committee Ways and Means",25,0,0,1,26
2011093,1570822,2025-05-13,Senate,"Senate Civil Service And Pensions Committee Vote",7,0,0,0,7
2011093,1581117,2025-05-28,Senate,"Senate Finance Committee Vote",22,0,0,0,22
2011093,1589247,2025-06-11,Senate,"Senate Floor Vote - Final Passage",59,0,0,4,63
2011153,1589848,2025-06-09,Senate,"Senate Rules Committee Vote",19,2,0,0,21
2011153,1590514,2025-06-12,Senate,"Senate Floor Vote - Final Passage",47,12,0,4,63
2011153,1592296,2025-06-17,Assembly,"Assembly Floor Vote - Final Passage",131,4,0,15,150
2011225,1588768,2025-05-27,Senate,"Senate Civil Service And Pensions Committee Vote",6,0,0,1,7
2011225,1590994,2025-06-11,Senate,"Senate Floor Vote - Final Passage",59,0,0,4,63
2011225,1590995,2025-06-11,Senate,"Senate Rules Committee Vote",20,0,0,1,21
2011286,1588738,2025-05-27,Senate,"Senate Civil Service And Pensions Committee Vote",6,0,0,1,7
2011286,1590981,2025-06-11,Senate,"Senate Floor Vote - Final Passage",59,0,0,4,63
2011286,1590982,2025-06-11,Senate,"Senate Rules Committee Vote",20,0,0,1,21
2011331,1588754,2025-05-27,Senate,"Senate Civil Service And Pensions Committee Vote",6,0,0,1,7
2011331,1590986,2025-06-11,Senate,"Senate Floor Vote - Final Passage",59,0,0,4,63
2011331,1590987,2025-06-11,Senate,"Senate Rules Committee Vote",20,0,0,1,21
2011487,1585895,2025-04-30,Senate,"Senate Higher Education Committee Vote",11,0,0,0,11
2011487,1585896,2025-06-05,Senate,"Senate Floor Vote - Final Passage",59,1,0,3,63
2011487,1592500,2025-06-17,Assembly,"Assembly Floor Vote - Final Passage",140,1,0,9,150
2011517,1579569,2025-04-29,Senate,"Senate Investigations And Government Operations Committee Vote",7,0,0,0,7
2011517,1590633,2025-05-27,Senate,"Senate Floor Vote - Final Passage",51,8,0,4,63
2011517,1591142,2025-06-13,Assembly,"Assembly Floor Vote - Final Passage",112,25,0,13,150
2011526,1590008,2025-05-28,Senate,"Senate Health Committee Vote",13,0,0,2,15
2011526,1590327,2025-06-12,Senate,"Senate Floor Vote - Final Passage",59,0,0,4,63
2011526,1591260,2025-06-13,Assembly,"Assembly Floor Vote - Final Passage",133,0,0,17,150
2011609,1535349,2025-04-02,Senate,"Senate Civil Service And Pensions Committee Vote",7,0,0,0,7
2011609,1570550,2025-05-13,Senate,"Senate Finance Committee Vote",22,0,0,0,22
2011609,1590696,2025-06-12,Senate,"Senate Floor Vote - Final Passage",59,0,0,4,63
2011609,1592395,2025-06-16,Assembly,"Assembly Floor Vote - Final Passage",143,1,0,6,150
2011719,1580634,2025-05-28,Assembly,"Assembly Higher Education Committee: Favorable refer to committee Ways and Means",26,0,0,0,26
2011786,1574694,2025-05-20,Assembly,"Assembly Higher Education Committee: Favorable refer to committee Ways and Means",23,0,0,3,26
2011786,1579369,2025-05-27,Assembly,"Assembly Ways And Means Committee: Favorable refer to committee Rules",32,0,0,3,35
2011786,1581301,2025-05-29,Assembly,"Assembly Rules Committee: Favorable",27,0,0,4,31
2011786,1582083,2025-05-29,Assembly,"Assembly Floor Vote - Final Passage",146,0,0,4,150
2011786,1590299,2025-06-12,Senate,"Senate Floor Vote - Final Passage",59,0,0,4,63
2011822,1574519,2025-05-20,Assembly,"Assembly Energy Committee: Favorable refer to committee Ways and Means",11,5,0,1,17
2011822,1580945,2025-05-29,Assembly,"Assembly Ways And Means Committee: Favorable refer to committee Rules",24,10,0,1,35
2011844,1587602,2025-05-29,Senate,"Senate Rules Committee Vote",20,0,0,1,21
2011844,1588389,2025-06-10,Senate,"Senate Floor Vote - Final Passage",58,0,0,5,63
2011901,1584798,2025-04-07,Senate,"Senate Housing, Construction And Community Development Committee Vote",9,2,0,0,11
2011901,1584799,2025-06-04,Senate,"Senate Floor Vote - Final Passage",35,23,0,5,63
2011916,1561310,2025-04-29,Assembly,"Assembly Ways And Means Committee: Favorable refer to committee Rules",30,2,0,3,35
2011916,1561786,2025-04-30,Assembly,"Assembly Rules Committee: Favorable",29,0,0,2,31
2011916,1563442,2025-04-30,Assembly,"Assembly Floor Vote - Final Passage",102,43,0,5,150
2011916,1599246,2025-05-27,Senate,"Senate Floor Vote - Final Passage",51,8,0,4,63
2011956,1560969,2025-04-29,Senate,"Senate Disabilities Committee Vote",6,0,0,0,6
2011956,1579180,2025-05-27,Senate,"Senate New York City Education Committee Vote",6,0,0,0,6
2011983,1573855,2025-05-20,Assembly,"Assembly Economic Development Committee: Favorable refer to committee Codes",23,0,0,3,26
2011983,1585599,2025-06-05,Assembly,"Assembly Codes Committee: Favorable refer to committee Ways and Means",21,0,0,1,22
2011983,1585974,2025-06-06,Assembly,"Assembly Ways And Means Committee: Favorable refer to committee Rules",35,0,0,0,35
2011983,1586888,2025-06-09,Assembly,"Assembly Rules Committee: Favorable",25,0,0,6,31
2011983,1587229,2025-06-09,Assembly,"Assembly Floor Vote - Final Passage",144,0,0,6,150
2011983,1587230,2025-06-09,Senate,"Senate Floor Vote - Final Passage",62,0,0,1,63
2011987,1579739,2025-05-28,Assembly,"Assembly Transportation Committee: Favorable refer to committee Codes",17,6,0,3,26
2012026,1586673,2025-06-09,Assembly,"Assembly Ways And Means Committee: Favorable refer to committee Rules",31,0,0,4,35
2012026,1587340,2025-06-10,Assembly,"Assembly Rules Committee: Favorable",28,0,0,3,31
2012086,1574264,2025-05-20,Assembly,"Assembly Children And Families Committee: Favorable refer to committee Rules",16,0,0,1,17
2012086,1575292,2025-05-21,Assembly,"Assembly Rules Committee: Favorable",29,0,0,2,31
2012160,1579130,2025-05-27,Assembly,"Assembly Governmental Operations Committee: Favorable refer to committee Ways and Means",14,0,0,0,14
2012160,1586021,2025-06-06,Assembly,"Assembly Ways And Means Committee: Favorable refer to committee Rules",35,0,0,0,35
2012160,1586868,2025-06-09,Assembly,"Assembly Rules Committee: Favorable",25,0,0,6,31
2012160,1587560,2025-06-09,Assembly,"Assembly Floor Vote - Final Passage",143,1,0,6,150
2012279,1574812,2025-05-20,Senate,"Senate Corporations, Authorities And Commissions Committee Vote",6,0,0,1,7
2012310,1579411,2025-04-29,Senate,"Senate Investigations And Government Operations Committee Vote",7,0,0,0,7
2012310,1591464,2025-05-27,Senate,"Senate Floor Vote - Final Passage",51,8,0,4,63
2012310,1592079,2025-06-16,Assembly,"Assembly Floor Vote - Final Passage",116,28,0,6,150
2012312,1589263,2025-05-28,Senate,"Senate Education Committee Vote",12,3,0,0,15
2012312,1589264,2025-06-11,Senate,"Senate Floor Vote - Final Passage",52,7,0,4,63
2012318,1583905,2025-05-28,Senate,"Senate Health Committee Vote",13,0,0,2,15
2012318,1587029,2025-06-09,Senate,"Senate Floor Vote - Final Passage",62,0,0,1,63
2012318,1587030,2025-06-09,Senate,"Senate Rules Committee Vote",21,0,0,0,21
2012336,1570089,2025-04-07,Senate,"Senate Judiciary Committee Vote",18,1,0,0,19
2012336,1570090,2025-05-12,Senate,"Senate Floor Vote - Final Passage",43,14,0,5,62
2012367,1589847,2025-06-12,Assembly,"Assembly Ways And Means Committee: Held for Consideration",24,10,0,1,35
2012424,1584831,2025-04-30,Senate,"Senate Higher Education Committee Vote",11,0,0,0,11
2012424,1584832,2025-06-04,Senate,"Senate Floor Vote - Final Passage",58,0,0,5,63
2012437,1560837,2025-04-29,Assembly,"Assembly Education Committee: Favorable refer to committee Rules Correction Date:04/29/2025",26,0,0,5,31
2012437,1561794,2025-04-30,Assembly,"Assembly Rules Committee: Favorable",29,0,0,2,31
2012437,1563310,2025-04-30,Assembly,"Assembly Floor Vote - Final Passage",145,0,0,5,150
2012437,1587935,2025-06-09,Senate,"Senate Floor Vote - Final Passage",62,0,0,1,63
2012464,1579394,2025-05-27,Assembly,"Assembly Governmental Operations Committee: Favorable refer to committee Ways and Means",14,0,0,0,14
2012464,1585153,2025-06-04,Assembly,"Assembly Ways And Means Committee: Favorable refer to committee Rules",33,0,0,2,35
2012464,1585950,2025-06-06,Assembly,"Assembly Rules Committee: Favorable",27,0,0,4,31
2012464,1586450,2025-06-06,Assembly,"Assembly Floor Vote - Final Passage",140,0,0,10,150
2012464,1589388,2025-06-11,Senate,"Senate Floor Vote - Final Passage",59,0,0,4,63
2012478,1586690,2025-06-09,Assembly,"Assembly Ways And Means Committee: Favorable refer to committee Rules",31,0,0,4,35
2012478,1588145,2025-06-10,Assembly,"Assembly Rules Committee: Favorable",28,0,0,3,31
2012478,1588146,2025-06-10,Senate,"Senate Floor Vote - Final Passage",58,0,0,5,63
2012478,1589166,2025-06-10,Assembly,"Assembly Floor Vote - Final Passage",147,0,0,3,150
2012483,1586098,2025-06-06,Assembly,"Assembly Ways And Means Committee: Favorable refer to committee Rules",35,0,0,0,35
2012483,1588515,2025-06-11,Assembly,"Assembly Rules Committee: Favorable",28,0,0,3,31
2012489,1526134,2025-03-25,Assembly,"Assembly Tourism, Arts And Sports Development Committee: Favorable",19,0,0,2,21
2012489,1533867,2025-04-01,Assembly,"Assembly Floor Vote - Final Passage",143,1,0,6,150
2012527,1574484,2025-05-20,Assembly,"Assembly Local Governments Committee: Favorable refer to committee Ways and Means",18,0,0,2,20
2012527,1579381,2025-05-27,Assembly,"Assembly Ways And Means Committee: Favorable refer to committee Rules",32,0,0,3,35
2012527,1581498,2025-05-29,Assembly,"Assembly Rules Committee: Favorable",27,0,0,4,31
2012527,1582188,2025-05-29,Assembly,"Assembly Floor Vote - Final Passage",146,0,0,4,150
2012535,1560964,2025-04-29,Senate,"Senate Civil Service And Pensions Committee Vote",7,0,0,0,7
2012535,1574561,2025-05-20,Senate,"Senate Finance Committee Vote",22,0,0,0,22
2012535,1581006,2025-05-29,Senate,"Senate Floor Vote - Final Passage",56,0,0,7,63
2012556,1586064,2025-06-06,Assembly,"Assembly Ways And Means Committee: Favorable refer to committee Rules",35,0,0,0,35
2012556,1589466,2025-06-12,Assembly,"Assembly Rules Committee: Favorable",29,0,0,2,31
2012561,1581672,2025-05-29,Senate,"Senate Children And Families Committee Vote",6,0,0,1,7
2012567,1579166,2025-05-27,Assembly,"Assembly Governmental Operations Committee: Favorable refer to committee Rules",14,0,0,0,14
2012567,1588142,2025-06-10,Assembly,"Assembly Rules Committee: Favorable",28,0,0,3,31
2012567,1589168,2025-06-10,Assembly,"Assembly Floor Vote - Final Passage",147,0,0,3,150
2012567,1590561,2025-06-13,Senate,"Senate Floor Vote - Final Passage",59,0,0,4,63
2012573,1585229,2025-06-04,Assembly,"Assembly Ways And Means Committee: Favorable refer to committee Rules",32,1,0,2,35
2012573,1588510,2025-06-11,Assembly,"Assembly Rules Committee: Favorable",28,0,0,3,31
2012574,1526876,2025-03-25,Assembly,"Assembly Tourism, Arts And Sports Development Committee: Favorable refer to committee Ways and Means",19,0,0,2,21
2012574,1575804,2025-05-22,Assembly,"Assembly Ways And Means Committee: Favorable refer to committee Rules",31,0,0,4,35
2012574,1579324,2025-05-27,Assembly,"Assembly Rules Committee: Favorable",26,0,0,5,31
2012602,1580173,2025-05-28,Assembly,"Assembly Labor Committee: Favorable refer to committee Codes",25,4,0,0,29
2012602,1586902,2025-06-09,Assembly,"Assembly Codes Committee: Favorable refer to committee Rules",15,5,0,2,22
2012602,1587326,2025-06-10,Assembly,"Assembly Rules Committee: Favorable",19,9,0,3,31
2012606,1566529,2025-05-06,Assembly,"Assembly Codes Committee: Favorable",22,0,0,0,22
2012616,1576187,2025-04-30,Senate,"Senate Higher Education Committee Vote",10,1,0,0,11
2012616,1576188,2025-05-22,Senate,"Senate Floor Vote - Final Passage",45,12,0,5,62
2012897,1579462,2025-05-27,Senate,"Senate Disabilities Committee Vote",6,0,0,0,6
2012915,1579323,2025-04-29,Senate,"Senate Investigations And Government Operations Committee Vote",7,0,0,0,7
2012915,1591496,2025-05-27,Senate,"Senate Floor Vote - Final Passage",51,8,0,4,63
2012915,1592219,2025-06-16,Assembly,"Assembly Floor Vote - Final Passage",117,27,0,6,150
2012973,1585865,2025-05-15,Senate,"Senate Alcoholism And Substance Use Disorders Committee Vote",7,0,0,0,7
2012973,1585866,2025-06-05,Senate,"Senate Floor Vote - Final Passage",44,16,0,3,63
2012973,1592411,2025-06-16,Assembly,"Assembly Floor Vote - Final Passage",144,0,0,6,150
2012998,1585640,2025-05-21,Senate,"Senate Commerce, Economic Development And Small Business Committee Vote",6,3,0,0,9
2012998,1585641,2025-06-05,Senate,"Senate Floor Vote - Final Passage",43,17,0,3,63
2013016,1534277,2025-04-02,Senate,"Senate Environmental Conservation Committee Vote",11,0,0,0,11
2013083,1581012,2025-05-20,Senate,"Senate Higher Education Committee Vote",11,0,0,0,11
2013083,1581013,2025-05-29,Senate,"Senate Floor Vote - Final Passage",54,2,0,7,63
2013092,1566585,2025-05-06,Senate,"Senate Cities 1 Committee Vote",7,0,0,0,7
2013163,1585898,2025-05-06,Senate,"Senate Elections Committee Vote",5,2,0,0,7
2013163,1585899,2025-06-05,Senate,"Senate Floor Vote - Final Passage",37,23,0,3,63
2013638,1579468,2025-04-29,Senate,"Senate Investigations And Government Operations Committee Vote",7,0,0,0,7
2013638,1591336,2025-05-27,Senate,"Senate Floor Vote - Final Passage",51,8,0,4,63
2013638,1592485,2025-06-16,Assembly,"Assembly Floor Vote - Final Passage",117,27,0,6,150
2013787,1590420,2025-06-12,Senate,"Senate Floor Vote - Final Passage",58,1,0,4,63
2013787,1592398,2025-06-17,Assembly,"Assembly Floor Vote - Final Passage",135,0,0,15,150
2013787,1594783,2025-06-12,Senate,"Senate Rules Committee Vote",19,1,0,1,21
2013802,1585604,2025-04-02,Senate,"Senate Environmental Conservation Committee Vote",10,1,0,0,11
2013802,1585605,2025-06-04,Senate,"Senate Floor Vote - Final Passage",49,9,0,5,63
2013817,1587581,2025-06-09,Senate,"Senate Rules Committee Vote",21,0,0,0,21
2013817,1588372,2025-06-10,Senate,"Senate Floor Vote - Final Passage",58,0,0,5,63
2013880,1590438,2025-06-12,Senate,"Senate Floor Vote - Final Passage",57,2,0,4,63
2013880,1595090,2025-06-12,Senate,"Senate Rules Committee Vote",19,1,0,1,21
2013932,1539850,2025-04-08,Senate,"Senate Civil Service And Pensions Committee Vote",7,0,0,0,7
2013976,1590885,2025-05-13,Senate,"Senate Transportation Committee Vote",13,0,0,0,13
2013976,1590886,2025-06-12,Senate,"Senate Floor Vote - Final Passage",59,0,0,4,63
2013976,1591026,2025-06-13,Assembly,"Assembly Floor Vote - Final Passage",135,1,0,14,150
2013992,1590419,2025-06-12,Senate,"Senate Floor Vote - Final Passage",58,1,0,4,63
2013992,1592377,2025-06-17,Assembly,"Assembly Floor Vote - Final Passage",134,0,0,16,150
2013992,1592378,2025-06-17,Assembly,"Assembly Floor Vote - Final Passage",134,0,0,16,150
2013992,1594787,2025-06-12,Senate,"Senate Rules Committee Vote",19,1,0,1,21
2014044,1579313,2025-04-29,Senate,"Senate Investigations And Government Operations Committee Vote",7,0,0,0,7
2014044,1590874,2025-05-27,Senate,"Senate Floor Vote - Final Passage",48,11,0,4,63
2014044,1591285,2025-06-13,Assembly,"Assembly Floor Vote - Final Passage",104,29,0,17,150
2014167,1579309,2025-04-29,Senate,"Senate Investigations And Government Operations Committee Vote",7,0,0,0,7
2014167,1591945,2025-05-27,Senate,"Senate Floor Vote - Final Passage",51,8,0,4,63
2014167,1592702,2025-06-17,Assembly,"Assembly Floor Vote - Final Passage",106,28,0,16,150
2014193,1563305,2025-04-08,Senate,"Senate Libraries Committee Vote",7,0,0,0,7
2014193,1563306,2025-04-30,Senate,"Senate Floor Vote - Final Passage",60,0,0,2,62
2014237,1565662,2025-04-08,Senate,"Senate Agriculture Committee Vote",9,0,0,0,9
2014237,1565663,2025-05-06,Senate,"Senate Floor Vote - Final Passage",61,0,0,1,62
2014311,1563330,2025-04-29,Senate,"Senate Health Committee Vote",14,0,0,0,14
2014311,1587044,2025-06-09,Senate,"Senate Rules Committee Vote",21,0,0,0,21
2014311,1587863,2025-06-10,Senate,"Senate Floor Vote - Final Passage",58,0,0,5,63
2014360,1580899,2025-05-28,Senate,"Senate Budget And Revenue Committee Vote",7,0,0,0,7
2014360,1587151,2025-06-09,Senate,"Senate Rules Committee Vote",21,0,0,0,21
2014360,1588382,2025-06-10,Senate,"Senate Floor Vote - Final Passage",58,0,0,5,63
2014381,1574150,2025-05-20,Assembly,"Assembly Economic Development Committee: Favorable refer to committee Rules",23,0,0,3,26
2014381,1575158,2025-05-21,Assembly,"Assembly Rules Committee: Favorable",29,0,0,2,31
2014381,1576167,2025-05-21,Assembly,"Assembly Floor Vote - Final Passage",143,0,0,7,150
2014419,1574527,2025-05-20,Assembly,"Assembly Environmental Conservation Committee: Held for Consideration",21,9,0,0,30
2014421,1570467,2025-05-13,Assembly,"Assembly Local Governments Committee: Favorable refer to committee Ways and Means",18,0,0,2,20
2014421,1574646,2025-05-20,Assembly,"Assembly Ways And Means Committee: Favorable refer to committee Rules",35,0,0,0,35
2014421,1574906,2025-05-21,Assembly,"Assembly Rules Committee: Favorable",29,0,0,2,31
2014421,1575833,2025-05-21,Assembly,"Assembly Floor Vote - Final Passage",143,0,0,7,150
2014421,1584789,2025-06-04,Senate,"Senate Floor Vote - Final Passage",58,0,0,5,63
2014443,1580422,2025-05-28,Assembly,"Assembly Local Governments Committee: Held for Consideration",14,6,0,0,20
2014446,1586683,2025-06-09,Assembly,"Assembly Ways And Means Committee: Favorable refer to committee Rules",25,6,0,4,35
2014446,1587362,2025-06-10,Assembly,"Assembly Rules Committee: Favorable",28,0,0,3,31
2014446,1588587,2025-06-10,Assembly,"Assembly Floor Vote - Final Passage",102,45,0,3,150
2014446,1590301,2025-06-12,Senate,"Senate Floor Vote - Final Passage",45,14,0,4,63
2014450,1575791,2025-05-22,Assembly,"Assembly Ways And Means Committee: Favorable refer to committee Rules",30,1,0,4,35
2014450,1579326,2025-05-27,Assembly,"Assembly Rules Committee: Favorable",26,0,0,5,31
2014450,1580193,2025-05-27,Assembly,"Assembly Floor Vote - Final Passage",106,39,0,5,150
2014450,1599252,2025-05-27,Senate,"Senate Floor Vote - Final Passage",51,8,0,4,63
2014455,1573913,2025-05-20,Assembly,"Assembly Education Committee: Favorable refer to committee Ways and Means",27,1,0,3,31
2014455,1580950,2025-05-29,Assembly,"Assembly Ways And Means Committee: Favorable refer to committee Rules",34,0,0,1,35
2014455,1585233,2025-06-04,Assembly,"Assembly Rules Committee: Favorable",28,0,0,3,31
2014455,1585394,2025-06-04,Assembly,"Assembly Floor Vote - Final Passage",141,3,0,6,150
2014455,1590260,2025-06-12,Senate,"Senate Floor Vote - Final Passage",54,5,0,4,63
2014459,1585587,2025-06-05,Assembly,"Assembly Codes Committee: Favorable refer to committee Rules",21,0,0,1,22
2014459,1586078,2025-06-06,Assembly,"Assembly Rules Committee: Favorable",27,0,0,4,31
2014459,1586593,2025-06-06,Assembly,"Assembly Floor Vote - Final Passage",135,5,0,10,150
2014462,1593609,2025-06-16,Assembly,"Assembly Rules Committee: Favorable",29,0,0,2,31
2014462,1593610,2025-06-16,Assembly,"Assembly Ways And Means Committee: Favorable refer to committee Rules",31,1,0,3,35
2014465,1573903,2025-05-20,Assembly,"Assembly Education Committee: Held for Consideration",20,8,0,3,31
2014466,1585945,2025-06-06,Assembly,"Assembly Ways And Means Committee: Held for Consideration",25,10,0,0,35
2014467,1585979,2025-06-06,Assembly,"Assembly Ways And Means Committee: Favorable refer to committee Rules",35,0,0,0,35
2014467,1587012,2025-06-09,Assembly,"Assembly Rules Committee: Favorable",25,0,0,6,31
2014470,1589860,2025-06-12,Assembly,"Assembly Ways And Means Committee: Favorable refer to committee Rules",30,4,0,1,35
2014470,1593573,2025-06-16,Assembly,"Assembly Rules Committee: Favorable",29,0,0,2,31
2014476,1589586,2025-06-12,Assembly,"Assembly Ways And Means Committee: Favorable refer to committee Rules",34,0,0,1,35
2014476,1590746,2025-06-13,Assembly,"Assembly Rules Committee: Favorable",29,0,0,2,31
2014479,1580451,2025-05-28,Assembly,"Assembly Corporations, Authorities And Commissions Committee: Held for Consideration",17,8,0,1,26
2014486,1574475,2025-05-20,Assembly,"Assembly Ways And Means Committee: Favorable refer to committee Rules",30,5,0,0,35
2014486,1575431,2025-05-21,Assembly,"Assembly Rules Committee: Favorable",29,0,0,2,31
2014486,1576182,2025-05-21,Assembly,"Assembly Floor Vote - Final Passage",94,49,0,7,150
2014486,1590735,2025-06-12,Senate,"Senate Floor Vote - Final Passage",44,15,0,4,63
2014487,1570857,2025-05-13,Assembly,"Assembly Ways And Means Committee: Favorable",32,2,0,1,35
2014487,1574046,2025-05-19,Assembly,"Assembly Floor Vote - Final Passage",110,33,0,7,150
2014487,1599245,2025-05-27,Senate,"Senate Floor Vote - Final Passage",51,8,0,4,63
2014505,1574376,2025-05-20,Assembly,"Assembly Insurance Committee: Held for Consideration",17,8,0,0,25
2014506,1570098,2025-05-13,Assembly,"Assembly Insurance Committee: Favorable",24,0,0,1,25
2014506,1586548,2025-06-06,Assembly,"Assembly Floor Vote - Final Passage",140,1,0,9,150
2014506,1588268,2025-06-10,Senate,"Senate Floor Vote - Final Passage",57,1,0,5,63
2014509,1580638,2025-05-28,Assembly,"Assembly Higher Education Committee: Favorable refer to committee Rules",26,0,0,0,26
2014509,1581525,2025-05-29,Assembly,"Assembly Rules Committee: Favorable",27,0,0,4,31
2014509,1582197,2025-05-29,Assembly,"Assembly Floor Vote - Final Passage",146,0,0,4,150
2014509,1589383,2025-06-11,Senate,"Senate Floor Vote - Final Passage",59,0,0,4,63
2014516,1580931,2025-05-29,Assembly,"Assembly Ways And Means Committee: Favorable refer to committee Rules",33,1,0,1,35
2014516,1585174,2025-06-04,Assembly,"Assembly Rules Committee: Favorable",28,0,0,3,31
2014517,1534354,2025-04-02,Assembly,"Assembly Economic Development Committee: Favorable refer to committee Ways and Means",25,0,0,1,26
2014517,1538021,2025-04-07,Assembly,"Assembly Rules Committee: Favorable",29,0,0,2,31
2014517,1538022,2025-04-07,Assembly,"Assembly Ways And Means Committee: Favorable refer to committee Rules",30,3,0,2,35
2014517,1543487,2025-04-09,Assembly,"Assembly Floor Vote - Final Passage",146,3,0,1,150
2014517,1588910,2025-06-10,Senate,"Senate Floor Vote - Final Passage",57,1,0,5,63
2014541,1565898,2025-05-06,Assembly,"Assembly People With Disabilities Committee: Favorable refer to committee Rules",9,0,0,0,9
2014541,1570335,2025-05-13,Assembly,"Assembly Rules Committee: Favorable",28,0,0,3,31
2014541,1591089,2025-06-13,Assembly,"Assembly Floor Vote - Final Passage",133,0,0,17,150
2014550,1593605,2025-06-16,Assembly,"Assembly Rules Committee: Favorable",29,0,0,2,31
2014550,1593606,2025-06-16,Assembly,"Assembly Ways And Means Committee: Favorable refer to committee Rules",32,0,0,3,35
2014567,1573303,2025-05-19,Assembly,"Assembly Governmental Employees Committee: Favorable refer to committee Ways and Means",13,0,0,1,14
2014567,1584909,2025-06-04,Assembly,"Assembly Ways And Means Committee: Favorable refer to committee Rules",33,0,0,2,35
2014567,1586061,2025-06-06,Assembly,"Assembly Rules Committee: Favorable",27,0,0,4,31
2014567,1586525,2025-06-06,Assembly,"Assembly Floor Vote - Final Passage",140,0,0,10,150
2014567,1589341,2025-06-11,Senate,"Senate Floor Vote - Final Passage",59,0,0,4,63
2014569,1574493,2025-05-20,Assembly,"Assembly Governmental Operations Committee: Favorable refer to committee Ways and Means",14,0,0,0,14
2014569,1579342,2025-05-27,Assembly,"Assembly Ways And Means Committee: Favorable refer to committee Rules",32,0,0,3,35
2014569,1581484,2025-05-29,Assembly,"Assembly Rules Committee: Favorable",27,0,0,4,31
2014569,1582182,2025-05-29,Assembly,"Assembly Floor Vote - Final Passage",146,0,0,4,150
2014569,1589365,2025-06-11,Senate,"Senate Floor Vote - Final Passage",59,0,0,4,63
2014577,1562931,2025-04-30,Assembly,"Assembly Local Governments Committee: Favorable",17,1,0,2,20
2014577,1565429,2025-05-05,Assembly,"Assembly Floor Vote - Final Passage",146,1,0,3,150
2014577,1589359,2025-06-10,Senate,"Senate Floor Vote - Final Passage",58,0,0,5,63
2014580,1584736,2025-06-04,Assembly,"Assembly Transportation Committee: Favorable refer to committee Rules",22,0,0,4,26
2014580,1586978,2025-06-09,Assembly,"Assembly Rules Committee: Favorable",25,0,0,6,31
2014580,1587365,2025-06-09,Assembly,"Assembly Floor Vote - Final Passage",144,0,0,6,150
2014580,1589184,2025-06-11,Senate,"Senate Floor Vote - Final Passage",59,0,0,4,63
2014587,1574657,2025-05-20,Assembly,"Assembly Ways And Means Committee: Favorable refer to committee Rules",33,2,0,0,35
2014587,1574915,2025-05-21,Assembly,"Assembly Rules Committee: Favorable",29,0,0,2,31
2014587,1575862,2025-05-21,Assembly,"Assembly Floor Vote - Final Passage",106,37,0,7,150
2014587,1599258,2025-05-27,Senate,"Senate Floor Vote - Final Passage",51,8,0,4,63
2014592,1559543,2025-04-28,Assembly,"Assembly Health Committee: Favorable refer to committee Ways and Means",25,0,0,1,26
2014598,1570855,2025-05-13,Assembly,"Assembly Ways And Means Committee: Favorable",32,2,0,1,35
2014598,1573952,2025-05-19,Assembly,"Assembly Floor Vote - Final Passage",105,38,0,7,150
2014598,1599254,2025-05-27,Senate,"Senate Floor Vote - Final Passage",51,8,0,4,63
2014607,1585955,2025-06-06,Assembly,"Assembly Ways And Means Committee: Favorable refer to committee Rules",35,0,0,0,35
2014607,1590069,2025-06-12,Assembly,"Assembly Rules Committee: Favorable",29,0,0,2,31
2014609,1570874,2025-05-13,Assembly,"Assembly Ways And Means Committee: Favorable",32,2,0,1,35
2014609,1574034,2025-05-19,Assembly,"Assembly Floor Vote - Final Passage",108,35,0,7,150
2014609,1599242,2025-05-27,Senate,"Senate Floor Vote - Final Passage",51,8,0,4,63
2014615,1591575,2025-06-17,Assembly,"Assembly Rules Committee: Favorable",30,0,0,1,31
2014615,1591576,2025-06-17,Assembly,"Assembly Ways And Means Committee: Favorable refer to committee Rules",32,0,0,3,35
2014622,1590798,2025-06-13,Assembly,"Assembly Rules Committee: Favorable",29,0,0,2,31
2014622,1590799,2025-06-13,Assembly,"Assembly Ways And Means Committee: Favorable refer to committee Rules",31,1,0,3,35
2014623,1586036,2025-06-06,Assembly,"Assembly Ways And Means Committee: Favorable refer to committee Rules",35,0,0,0,35
2014623,1591413,2025-06-16,Assembly,"Assembly Rules Committee: Favorable",29,0,0,2,31
2014625,1573863,2025-05-20,Assembly,"Assembly Agriculture Committee: Favorable refer to committee Ways and Means",23,0,0,0,23
2014631,1574392,2025-05-20,Assembly,"Assembly Ways And Means Committee: Favorable refer to committee Rules",33,2,0,0,35
2014631,1575344,2025-05-21,Assembly,"Assembly Rules Committee: Favorable",29,0,0,2,31
2014631,1575749,2025-05-21,Assembly,"Assembly Floor Vote - Final Passage",105,38,0,7,150
2014631,1599248,2025-05-27,Senate,"Senate Floor Vote - Final Passage",51,8,0,4,63
2014642,1580402,2025-05-28,Assembly,"Assembly Corporations, Authorities And Commissions Committee: Favorable refer to committee Rules",25,0,0,1,26
2014642,1581531,2025-05-29,Assembly,"Assembly Rules Committee: Favorable",27,0,0,4,31
2014642,1585912,2025-06-05,Assembly,"Assembly Floor Vote - Final Passage",142,3,0,5,150
2014642,1587035,2025-06-09,Senate,"Senate Floor Vote - Final Passage",62,0,0,1,63
2015084,1528641,2025-03-27,Assembly,"Assembly Rules Committee: Favorable",29,0,0,2,31
2015084,1528642,2025-03-27,Assembly,"Assembly Ways And Means Committee: Favorable refer to committee Rules",32,0,0,3,35
2015084,1570073,2025-05-12,Assembly,"Assembly Floor Vote - Final Passage",143,0,0,7,150
2015084,1574118,2025-05-20,Senate,"Senate Floor Vote - Final Passage",61,0,0,1,62
2015097,1570766,2025-05-13,Senate,"Senate Crime Victims, Crime And Correction Committee Vote",7,0,0,0,7
2015133,1584688,2025-05-20,Senate,"Senate Cultural Affairs, Tourism, Parks And Recreation Committee Vote",7,0,0,0,7
2015133,1585325,2025-06-04,Senate,"Senate Floor Vote - Final Passage",58,0,0,5,63
2015133,1588897,2025-06-10,Assembly,"Assembly Floor Vote - Final Passage",147,0,0,3,150
2015390,1562646,2025-04-30,Assembly,"Assembly Governmental Employees Committee: Favorable refer to committee Ways and Means",14,0,0,0,14
2015390,1579408,2025-05-27,Assembly,"Assembly Ways And Means Committee: Favorable refer to committee Rules",30,2,0,3,35
2015390,1585196,2025-06-04,Assembly,"Assembly Rules Committee: Favorable",28,0,0,3,31
2015390,1585378,2025-06-04,Assembly,"Assembly Floor Vote - Final Passage",144,0,0,6,150
2015390,1588244,2025-06-10,Senate,"Senate Floor Vote - Final Passage",58,0,0,5,63
2015461,1533978,2025-04-02,Assembly,"Assembly Higher Education Committee: Favorable refer to committee Ways and Means",24,0,0,2,26
2015461,1579379,2025-05-27,Assembly,"Assembly Ways And Means Committee: Favorable refer to committee Rules",32,0,0,3,35
2015461,1581058,2025-05-29,Assembly,"Assembly Rules Committee: Favorable",27,0,0,4,31
2015461,1582093,2025-05-29,Assembly,"Assembly Floor Vote - Final Passage",144,2,0,4,150
2015461,1586144,2025-06-06,Senate,"Senate Floor Vote - Final Passage",39,14,0,10,63
2015544,1588793,2025-06-09,Senate,"Senate Rules Committee Vote",21,0,0,0,21
2015544,1589332,2025-06-11,Senate,"Senate Floor Vote - Final Passage",59,0,0,4,63
2015571,1590187,2025-06-12,Assembly,"Assembly Floor Vote - Final Passage",119,22,0,9,150
2015571,1590322,2025-06-12,Senate,"Senate Floor Vote - Final Passage",58,1,0,4,63
2015571,1594803,2025-06-12,Senate,"Senate Rules Committee Vote",20,0,0,1,21
2015580,1539296,2025-04-08,Senate,"Senate Civil Service And Pensions Committee Vote",7,0,0,0,7
2015580,1574212,2025-05-20,Senate,"Senate Finance Committee Vote",22,0,0,0,22
2015580,1590457,2025-06-13,Senate,"Senate Floor Vote - Final Passage",59,0,0,4,63
2015586,1588326,2025-06-10,Senate,"Senate Floor Vote - Final Passage",57,1,0,5,63
2015586,1588327,2025-06-10,Senate,"Senate Rules Committee Vote",19,0,0,2,21
2015586,1592463,2025-06-17,Assembly,"Assembly Floor Vote - Final Passage",141,0,0,9,150
2015601,1589356,2025-05-20,Senate,"Senate Transportation Committee Vote",13,0,0,0,13
2015601,1589701,2025-06-11,Senate,"Senate Floor Vote - Final Passage",58,1,0,4,63
2015645,1590010,2025-05-27,Senate,"Senate Internet And Technology Committee Vote",7,0,0,0,7
2015645,1590555,2025-06-12,Senate,"Senate Floor Vote - Final Passage",58,1,0,4,63
2015672,1590189,2025-06-12,Senate,"Senate Rules Committee Vote",20,0,0,1,21
2015672,1590489,2025-06-13,Senate,"Senate Floor Vote - Final Passage",59,0,0,4,63
2015683,1579095,2025-04-29,Senate,"Senate Investigations And Government Operations Committee Vote",7,0,0,0,7
2015683,1587061,2025-05-27,Senate,"Senate Floor Vote - Final Passage",51,8,0,4,63
2015683,1587401,2025-06-09,Assembly,"Assembly Floor Vote - Final Passage",110,34,0,6,150
2015775,1590410,2025-06-12,Senate,"Senate Floor Vote - Final Passage",58,1,0,4,63
2015775,1592391,2025-06-17,Assembly,"Assembly Floor Vote - Final Passage",141,0,0,9,150
2015775,1594780,2025-06-12,Senate,"Senate Rules Committee Vote",20,0,0,1,21
2015803,1560224,2025-04-29,Senate,"Senate Civil Service And Pensions Committee Vote",7,0,0,0,7
2015808,1539399,2025-04-08,Senate,"Senate Cities 1 Committee Vote",7,0,0,0,7
2015808,1566848,2025-05-06,Senate,"Senate Civil Service And Pensions Committee Vote",7,0,0,0,7
2015808,1590905,2025-06-10,Senate,"Senate Floor Vote - Final Passage",58,0,0,5,63
2015808,1590906,2025-06-10,Senate,"Senate Rules Committee Vote",19,0,0,2,21
2015833,1574673,2025-05-13,Senate,"Senate Health Committee Vote",13,0,0,1,14
2015833,1574674,2025-05-20,Senate,"Senate Floor Vote - Final Passage",61,0,0,1,62
2015860,1587866,2025-05-13,Senate,"Senate Transportation Committee Vote",11,2,0,0,13
2015860,1587867,2025-06-10,Senate,"Senate Floor Vote - Final Passage",44,14,0,5,63
2015903,1589142,2025-05-28,Senate,"Senate Consumer Protection Committee Vote",7,0,0,0,7
2015903,1589143,2025-06-11,Senate,"Senate Floor Vote - Final Passage",53,6,0,4,63
2015959,1580139,2025-05-28,Senate,"Senate Racing, Gaming And Wagering Committee Vote",7,0,0,0,7
2016051,1534490,2025-04-02,Assembly,"Assembly Higher Education Committee: Favorable",24,0,0,2,26
2016051,1539487,2025-04-07,Assembly,"Assembly Floor Vote - Final Passage",143,1,0,6,150
2016051,1585660,2025-06-04,Senate,"Senate Floor Vote - Final Passage",58,0,0,5,63
2016245,1570942,2025-05-13,Senate,"Senate Energy And Telecommunications Committee Vote",8,1,0,0,9
2016245,1581816,2025-05-29,Senate,"Senate Rules Committee Vote",20,0,0,1,21
2016245,1586190,2025-06-06,Senate,"Senate Floor Vote - Final Passage",50,3,0,10,63
2016245,1592516,2025-06-17,Assembly,"Assembly Floor Vote - Final Passage",111,31,0,8,150
2016310,1589254,2025-05-13,Senate,"Senate Procurement And Contracts Committee Vote",7,0,0,0,7
2016310,1589996,2025-06-11,Senate,"Senate Floor Vote - Final Passage",59,0,0,4,63
2016310,1592315,2025-06-16,Assembly,"Assembly Floor Vote - Final Passage",144,0,0,6,150
2016328,1591579,2025-06-17,Assembly,"Assembly Rules Committee: Favorable",30,0,0,1,31
2016328,1591580,2025-06-17,Assembly,"Assembly Ways And Means Committee: Favorable refer to committee Rules",32,0,0,3,35
2016340,1587115,2025-06-09,Senate,"Senate Floor Vote - Final Passage",50,12,0,1,63
2016340,1587116,2025-06-09,Senate,"Senate Rules Committee Vote",18,3,0,0,21
2016346,1587303,2025-06-10,Assembly,"Assembly Ways And Means Committee: Favorable refer to committee Rules",30,2,0,3,35
2016346,1588504,2025-06-11,Assembly,"Assembly Rules Committee: Favorable",28,0,0,3,31
2016363,1589865,2025-06-12,Assembly,"Assembly Ways And Means Committee: Favorable refer to committee Rules",32,2,0,1,35
2016363,1593589,2025-06-16,Assembly,"Assembly Rules Committee: Favorable",29,0,0,2,31
2016375,1590747,2025-06-13,Assembly,"Assembly Rules Committee: Favorable",29,0,0,2,31
2016375,1590748,2025-06-13,Assembly,"Assembly Ways And Means Committee: Favorable refer to committee Rules",30,2,0,3,35
2016422,1585986,2025-06-06,Assembly,"Assembly Ways And Means Committee: Favorable refer to committee Rules",35,0,0,0,35
2016422,1589975,2025-06-12,Assembly,"Assembly Rules Committee: Favorable",29,0,0,2,31
2016425,1585994,2025-06-06,Assembly,"Assembly Ways And Means Committee: Favorable refer to committee Rules",35,0,0,0,35
2016425,1593584,2025-06-16,Assembly,"Assembly Rules Committee: Favorable",29,0,0,2,31
2016426,1585935,2025-06-06,Assembly,"Assembly Ways And Means Committee: Favorable refer to committee Rules",35,0,0,0,35
2016426,1593630,2025-06-16,Assembly,"Assembly Rules Committee: Favorable",29,0,0,2,31
2016432,1591599,2025-06-17,Assembly,"Assembly Ways And Means Committee: Favorable refer to committee Rules",32,0,0,3,35
2016432,1591971,2025-06-17,Assembly,"Assembly Rules Committee: Favorable",28,0,0,3,31
2016452,1574648,2025-05-20,Assembly,"Assembly Judiciary Committee: Favorable refer to committee Rules",20,0,0,1,21
2016452,1579344,2025-05-27,Assembly,"Assembly Rules Committee: Favorable",26,0,0,5,31
2016452,1579535,2025-05-27,Assembly,"Assembly Floor Vote - Final Passage",144,1,0,5,150
2016452,1586180,2025-06-06,Senate,"Senate Floor Vote - Final Passage",53,0,0,10,63
2016458,1573848,2025-05-20,Senate,"Senate Local Government Committee Vote",7,0,0,0,7
2016458,1590115,2025-06-12,Senate,"Senate Rules Committee Vote",20,0,0,1,21
2016458,1590343,2025-06-13,Senate,"Senate Floor Vote - Final Passage",56,3,0,4,63
2016458,1592634,2025-06-16,Assembly,"Assembly Floor Vote - Final Passage",144,0,0,6,150
2016461,1579183,2025-05-27,Assembly,"Assembly Governmental Operations Committee: Favorable refer to committee Codes",14,0,0,0,14
2016461,1585583,2025-06-05,Assembly,"Assembly Codes Committee: Favorable refer to committee Rules",15,6,0,1,22
2016485,1574810,2025-05-20,Senate,"Senate Civil Service And Pensions Committee Vote",7,0,0,0,7
2016507,1559685,2025-04-29,Senate,"Senate Social Services Committee Vote",6,0,0,0,6
2016517,1584635,2025-06-04,Assembly,"Assembly Judiciary Committee: Favorable refer to committee Ways and Means",19,0,0,2,21
2016517,1587293,2025-06-10,Assembly,"Assembly Ways And Means Committee: Favorable refer to committee Rules",32,0,0,3,35
2016517,1588559,2025-06-11,Assembly,"Assembly Rules Committee: Favorable",28,0,0,3,31
2016528,1585165,2025-06-04,Assembly,"Assembly Ways And Means Committee: Favorable refer to committee Rules",32,1,0,2,35
2016528,1586005,2025-06-06,Assembly,"Assembly Rules Committee: Favorable",27,0,0,4,31
2016529,1574112,2025-05-20,Assembly,"Assembly Racing And Wagering Committee: Favorable refer to committee Codes",10,0,0,1,11
2016529,1586803,2025-06-09,Assembly,"Assembly Codes Committee: Favorable refer to committee Ways and Means",19,1,0,2,22
2016529,1589863,2025-06-12,Assembly,"Assembly Ways And Means Committee: Favorable refer to committee Rules",34,0,0,1,35
2016529,1590769,2025-06-13,Assembly,"Assembly Rules Committee: Favorable",29,0,0,2,31
2016530,1587145,2025-06-09,Senate,"Senate Floor Vote - Final Passage",46,16,0,1,63
2016530,1587146,2025-06-09,Senate,"Senate Rules Committee Vote",18,3,0,0,21
2016564,1579919,2025-04-29,Senate,"Senate Investigations And Government Operations Committee Vote",7,0,0,0,7
2016564,1590727,2025-05-27,Senate,"Senate Floor Vote - Final Passage",51,8,0,4,63
2016564,1591213,2025-06-13,Assembly,"Assembly Floor Vote - Final Passage",109,24,0,17,150
2016567,1579175,2025-05-27,Assembly,"Assembly Governmental Operations Committee: Held for Consideration",10,4,0,0,14
2016908,1575313,2025-04-29,Senate,"Senate Women's Issues Committee Vote",7,0,0,0,7
2016908,1575314,2025-05-21,Senate,"Senate Floor Vote - Final Passage",59,0,0,3,62
2017077,1588759,2025-05-27,Senate,"Senate Civil Service And Pensions Committee Vote",6,0,0,1,7
2017077,1590983,2025-06-11,Senate,"Senate Floor Vote - Final Passage",59,0,0,4,63
2017077,1590984,2025-06-11,Senate,"Senate Rules Committee Vote",20,0,0,1,21
2017091,1590292,2025-06-12,Senate,"Senate Rules Committee Vote",20,0,0,1,21
2017091,1590837,2025-06-13,Senate,"Senate Floor Vote - Final Passage",59,0,0,4,63
2017240,1590213,2025-06-12,Senate,"Senate Rules Committee Vote",19,1,0,1,21
2017240,1590374,2025-06-13,Senate,"Senate Floor Vote - Final Passage",55,4,0,4,63
2017240,1591258,2025-06-13,Assembly,"Assembly Floor Vote - Final Passage",127,5,0,18,150
2017368,1571832,2025-05-13,Senate,"Senate Health Committee Vote",13,0,0,1,14
2017557,1533536,2025-04-01,Senate,"Senate Floor Vote - Final Passage",63,0,0,0,63
2017557,1533537,2025-04-01,Senate,"Senate Rules Committee Vote",21,0,0,0,21
2017557,1537928,2025-04-01,Assembly,"Assembly Floor Vote - Final Passage",144,0,0,6,150
2017565,1532013,2025-04-01,Assembly,"Assembly Rules Committee: Favorable",30,0,0,1,31
2017565,1532014,2025-04-01,Assembly,"Assembly Ways And Means Committee: Favorable refer to committee Rules",33,0,0,2,35
2017573,1590660,2025-06-13,Assembly,"Assembly Rules Committee: Favorable",29,0,0,2,31
2017573,1590661,2025-06-13,Assembly,"Assembly Ways And Means Committee: Favorable refer to committee Rules",28,4,0,3,35
2017683,1585946,2025-06-06,Assembly,"Assembly Ways And Means Committee: Held for Consideration",25,10,0,0,35
2017688,1574095,2025-05-20,Assembly,"Assembly Environmental Conservation Committee: Held for Consideration",21,9,0,0,30
2017732,1590429,2025-06-12,Senate,"Senate Floor Vote - Final Passage",46,13,0,4,63
2017732,1592402,2025-06-16,Assembly,"Assembly Floor Vote - Final Passage",113,31,0,6,150
2017732,1595091,2025-06-12,Senate,"Senate Rules Committee Vote",15,5,0,1,21
2017755,1585991,2025-06-06,Assembly,"Assembly Ways And Means Committee: Favorable refer to committee Rules",35,0,0,0,35
2017755,1590059,2025-06-12,Assembly,"Assembly Rules Committee: Favorable",29,0,0,2,31
2017769,1590887,2025-06-12,Senate,"Senate Rules Committee Vote",20,0,0,1,21
2017769,1590888,2025-06-13,Senate,"Senate Floor Vote - Final Passage",58,1,0,4,63
2017801,1586724,2025-06-09,Assembly,"Assembly Codes Committee: Favorable refer to committee Rules",20,0,0,2,22
2017801,1587350,2025-06-10,Assembly,"Assembly Rules Committee: Favorable",28,0,0,3,31
2017801,1589181,2025-06-10,Assembly,"Assembly Floor Vote - Final Passage",133,14,0,3,150
2017822,1579488,2025-04-29,Senate,"Senate Investigations And Government Operations Committee Vote",7,0,0,0,7
2017822,1591465,2025-05-27,Senate,"Senate Floor Vote - Final Passage",51,8,0,4,63
2017822,1592680,2025-06-16,Assembly,"Assembly Floor Vote - Final Passage",118,26,0,6,150
2017829,1560754,2025-04-29,Senate,"Senate Aging Committee Vote",6,0,0,0,6
2017829,1585547,2025-06-04,Senate,"Senate Rules Committee Vote",20,0,0,1,21
2017829,1591078,2025-06-11,Senate,"Senate Floor Vote - Final Passage",59,0,0,4,63
2017893,1579076,2025-04-29,Senate,"Senate Investigations And Government Operations Committee Vote",7,0,0,0,7
2017893,1590738,2025-05-27,Senate,"Senate Floor Vote - Final Passage",50,9,0,4,63
2017893,1591219,2025-06-13,Assembly,"Assembly Floor Vote - Final Passage",110,23,0,17,150
2017976,1570423,2025-05-13,Assembly,"Assembly Economic Development Committee: Favorable refer to committee Ways and Means",26,0,0,0,26
2017976,1575803,2025-05-22,Assembly,"Assembly Ways And Means Committee: Favorable refer to committee Rules",28,3,0,4,35
2017976,1579392,2025-05-27,Assembly,"Assembly Rules Committee: Favorable",26,0,0,5,31
2017976,1579538,2025-05-27,Assembly,"Assembly Floor Vote - Final Passage",143,2,0,5,150
2017976,1585240,2025-06-04,Senate,"Senate Floor Vote - Final Passage",56,2,0,5,63
2018001,1571023,2025-05-13,Senate,"Senate Energy And Telecommunications Committee Vote",8,1,0,0,9
2018003,1570892,2025-05-13,Assembly,"Assembly Codes Committee: Held for Consideration",16,6,0,0,22
2018017,1565642,2025-05-06,Assembly,"Assembly Energy Committee: Favorable refer to committee Ways and Means",16,0,0,1,17
2018018,1589267,2025-06-09,Senate,"Senate Rules Committee Vote",19,2,0,0,21
2018018,1589268,2025-06-11,Senate,"Senate Floor Vote - Final Passage",37,22,0,4,63
2018018,1592478,2025-06-17,Assembly,"Assembly Floor Vote - Final Passage",82,49,0,19,150
2018020,1574318,2025-05-20,Assembly,"Assembly Education Committee: Held for Consideration",20,8,0,3,31
2018039,1593577,2025-06-16,Assembly,"Assembly Rules Committee: Favorable",29,0,0,2,31
2018039,1593578,2025-06-16,Assembly,"Assembly Ways And Means Committee: Favorable refer to committee Rules",32,0,0,3,35
2018082,1580253,2025-05-28,Assembly,"Assembly Corporations, Authorities And Commissions Committee: Favorable refer to committee Codes",18,7,0,1,26
2018082,1587054,2025-06-09,Assembly,"Assembly Codes Committee: Favorable refer to committee Ways and Means",18,2,0,2,22
2018082,1589846,2025-06-12,Assembly,"Assembly Ways And Means Committee: Favorable refer to committee Rules",28,6,0,1,35
2018082,1590806,2025-06-13,Assembly,"Assembly Rules Committee: Favorable",22,7,0,2,31
2018094,1571009,2025-05-13,Senate,"Senate Higher Education Committee Vote",11,0,0,0,11
2018094,1588041,2025-06-10,Senate,"Senate Floor Vote - Final Passage",53,5,0,5,63
2018094,1588042,2025-06-10,Senate,"Senate Rules Committee Vote",19,0,0,2,21
2018102,1566481,2025-05-06,Assembly,"Assembly Higher Education Committee: Favorable refer to committee Ways and Means",26,0,0,0,26
2018102,1574658,2025-05-20,Assembly,"Assembly Ways And Means Committee: Favorable refer to committee Rules",35,0,0,0,35
2018102,1574923,2025-05-21,Assembly,"Assembly Rules Committee: Favorable",29,0,0,2,31
2018102,1575840,2025-05-21,Assembly,"Assembly Floor Vote - Final Passage",142,1,0,7,150
2018102,1585513,2025-06-05,Senate,"Senate Floor Vote - Final Passage",60,0,0,3,63
2018105,1574087,2025-05-20,Assembly,"Assembly Libraries And Education Technology Committee: Favorable refer to committee Ways and Means",7,2,0,0,9
2018116,1559722,2025-04-29,Senate,"Senate Civil Service And Pensions Committee Vote",7,0,0,0,7
2018130,1570762,2025-05-13,Senate,"Senate Civil Service And Pensions Committee Vote",7,0,0,0,7
2018134,1570401,2025-05-13,Assembly,"Assembly Economic Development Committee: Favorable refer to committee Ways and Means",26,0,0,0,26
2018134,1579367,2025-05-27,Assembly,"Assembly Ways And Means Committee: Favorable refer to committee Rules",31,1,0,3,35
2018134,1581561,2025-05-29,Assembly,"Assembly Rules Committee: Favorable",27,0,0,4,31
2018134,1582210,2025-05-29,Assembly,"Assembly Floor Vote - Final Passage",144,1,0,5,150
2018134,1584941,2025-06-04,Senate,"Senate Floor Vote - Final Passage",56,2,0,5,63
2018146,1579407,2025-04-29,Senate,"Senate Investigations And Government Operations Committee Vote",7,0,0,0,7
2018146,1591343,2025-05-27,Senate,"Senate Floor Vote - Final Passage",51,8,0,4,63
2018146,1592480,2025-06-16,Assembly,"Assembly Floor Vote - Final Passage",117,27,0,6,150
2018155,1573201,2025-05-19,Assembly,"Assembly Veterans' Affairs Committee: Favorable refer to committee Rules",18,0,0,1,19
2018155,1574988,2025-05-21,Assembly,"Assembly Rules Committee: Favorable",29,0,0,2,31
2018155,1575934,2025-05-21,Assembly,"Assembly Floor Vote - Final Passage",143,0,0,7,150
2018195,1574485,2025-05-20,Assembly,"Assembly Governmental Operations Committee: Held for Consideration",10,4,0,0,14
2018199,1559548,2025-04-28,Assembly,"Assembly Health Committee: Favorable",25,0,0,1,26
2018199,1565426,2025-05-05,Assembly,"Assembly Floor Vote - Final Passage",147,0,0,3,150
2018199,1585644,2025-06-05,Senate,"Senate Floor Vote - Final Passage",60,0,0,3,63
2018216,1566488,2025-05-06,Assembly,"Assembly People With Disabilities Committee: Favorable refer to committee Ways and Means",9,0,0,0,9
2018216,1580933,2025-05-29,Assembly,"Assembly Ways And Means Committee: Favorable refer to committee Rules",34,0,0,1,35
2018216,1585215,2025-06-04,Assembly,"Assembly Rules Committee: Favorable",28,0,0,3,31
2018216,1585382,2025-06-04,Assembly,"Assembly Floor Vote - Final Passage",144,0,0,6,150
2018216,1585841,2025-06-05,Senate,"Senate Floor Vote - Final Passage",60,0,0,3,63
2018232,1561630,2025-04-30,Assembly,"Assembly Tourism, Arts And Sports Development Committee: Favorable refer to committee Rules",17,0,0,4,21
2018232,1561805,2025-04-30,Assembly,"Assembly Rules Committee: Favorable",29,0,0,2,31
2018232,1563431,2025-04-30,Assembly,"Assembly Floor Vote - Final Passage",145,0,0,5,150
2018232,1585135,2025-06-04,Senate,"Senate Floor Vote - Final Passage",58,0,0,5,63
2018235,1578770,2025-05-27,Assembly,"Assembly Governmental Operations Committee: Favorable refer to committee Ways and Means",14,0,0,0,14
2018235,1590745,2025-06-13,Assembly,"Assembly Ways And Means Committee: Favorable refer to committee Rules",32,0,0,3,35
2018235,1593663,2025-06-16,Assembly,"Assembly Rules Committee: Favorable",29,0,0,2,31
2018246,1561642,2025-04-30,Assembly,"Assembly Tourism, Arts And Sports Development Committee: Favorable refer to committee Ways and Means",17,0,0,4,21
2018246,1586699,2025-06-09,Assembly,"Assembly Ways And Means Committee: Favorable refer to committee Rules",31,0,0,4,35
2018246,1587369,2025-06-10,Assembly,"Assembly Rules Committee: Favorable",28,0,0,3,31
2018249,1575579,2025-05-13,Senate,"Senate Children And Families Committee Vote",4,2,0,1,7
2018249,1575580,2025-05-21,Senate,"Senate Floor Vote - Final Passage",37,22,0,3,62
2018255,1570471,2025-05-13,Assembly,"Assembly Economic Development Committee: Favorable refer to committee Ways and Means",26,0,0,0,26
2018255,1574705,2025-05-20,Assembly,"Assembly Ways And Means Committee: Favorable refer to committee Rules",32,3,0,0,35
2018255,1574944,2025-05-21,Assembly,"Assembly Rules Committee: Favorable",29,0,0,2,31
2018255,1575848,2025-05-21,Assembly,"Assembly Floor Vote - Final Passage",141,2,0,7,150
2018255,1584748,2025-06-04,Senate,"Senate Floor Vote - Final Passage",56,2,0,5,63
2018297,1560955,2025-04-29,Senate,"Senate Civil Service And Pensions Committee Vote",7,0,0,0,7
2018309,1579520,2025-04-29,Senate,"Senate Investigations And Government Operations Committee Vote",7,0,0,0,7
2018309,1591601,2025-05-27,Senate,"Senate Floor Vote - Final Passage",51,8,0,4,63
2018309,1592666,2025-06-17,Assembly,"Assembly Floor Vote - Final Passage",113,28,0,9,150
2018322,1579839,2025-05-28,Assembly,"Assembly Higher Education Committee: Favorable refer to committee Ways and Means",26,0,0,0,26
2018322,1586015,2025-06-06,Assembly,"Assembly Ways And Means Committee: Favorable refer to committee Rules",35,0,0,0,35
2018322,1587011,2025-06-09,Assembly,"Assembly Rules Committee: Favorable",25,0,0,6,31
2018322,1587209,2025-06-09,Assembly,"Assembly Floor Vote - Final Passage",144,0,0,6,150
2018322,1590518,2025-06-12,Senate,"Senate Floor Vote - Final Passage",57,2,0,4,63
2018333,1580642,2025-05-28,Assembly,"Assembly Election Law Committee: Favorable refer to committee Rules",15,0,0,1,16
2018333,1581556,2025-05-29,Assembly,"Assembly Rules Committee: Favorable",27,0,0,4,31
2018333,1582207,2025-05-29,Assembly,"Assembly Floor Vote - Final Passage",143,2,0,5,150
2018342,1566038,2025-04-29,Senate,"Senate Transportation Committee Vote",13,0,0,0,13
2018342,1566039,2025-05-06,Senate,"Senate Floor Vote - Final Passage",61,0,0,1,62
2018342,1589656,2025-06-11,Assembly,"Assembly Floor Vote - Final Passage",146,0,0,4,150
2018354,1590761,2025-06-13,Assembly,"Assembly Rules Committee: Favorable",29,0,0,2,31
2018354,1590762,2025-06-13,Assembly,"Assembly Ways And Means Committee: Favorable refer to committee Rules",30,2,0,3,35
2018372,1580158,2025-05-28,Assembly,"Assembly Codes Committee: Favorable refer to committee Rules",21,0,0,1,22
2018372,1584902,2025-06-04,Assembly,"Assembly Rules Committee: Favorable",28,0,0,3,31
2018372,1585396,2025-06-04,Assembly,"Assembly Floor Vote - Final Passage",144,0,0,6,150
2018372,1586917,2025-06-09,Senate,"Senate Floor Vote - Final Passage",62,0,0,1,63
2018424,1574237,2025-05-19,Senate,"Senate Energy And Telecommunications Committee Vote",6,3,0,0,9
2018564,1574375,2025-05-20,Assembly,"Assembly Judiciary Committee: Favorable refer to committee Ways and Means",20,0,0,1,21
2018564,1586017,2025-06-06,Assembly,"Assembly Ways And Means Committee: Favorable refer to committee Rules",35,0,0,0,35
2018564,1586860,2025-06-09,Assembly,"Assembly Rules Committee: Favorable",25,0,0,6,31
2018690,1570395,2025-05-13,Senate,"Senate Civil Service And Pensions Committee Vote",7,0,0,0,7
2018690,1587144,2025-06-09,Senate,"Senate Rules Committee Vote",21,0,0,0,21
2018690,1590506,2025-06-12,Senate,"Senate Floor Vote - Final Passage",59,0,0,4,63
2018690,1592282,2025-06-16,Assembly,"Assembly Floor Vote - Final Passage",142,2,0,6,150
2018806,1539311,2025-04-08,Assembly,"Assembly Energy Committee: Favorable",13,2,0,2,17
2018806,1580033,2025-05-22,Assembly,"Assembly Floor Vote - Final Passage",124,14,0,12,150
2019103,1585505,2025-05-20,Senate,"Senate Cultural Affairs, Tourism, Parks And Recreation Committee Vote",7,0,0,0,7
2019103,1585891,2025-06-05,Senate,"Senate Floor Vote - Final Passage",60,0,0,3,63
2019103,1592700,2025-06-17,Assembly,"Assembly Floor Vote - Final Passage",141,0,0,9,150
2019171,1579167,2025-04-29,Senate,"Senate Investigations And Government Operations Committee Vote",7,0,0,0,7
2019171,1589431,2025-05-27,Senate,"Senate Floor Vote - Final Passage",51,8,0,4,63
2019171,1589432,2025-06-11,Assembly,"Assembly Floor Vote - Final Passage",120,26,0,4,150
2019376,1579391,2025-05-27,Assembly,"Assembly Ways And Means Committee: Favorable refer to committee Rules",27,5,0,3,35
2019376,1581487,2025-05-29,Assembly,"Assembly Rules Committee: Favorable",27,0,0,4,31
2019376,1582186,2025-05-29,Assembly,"Assembly Floor Vote - Final Passage",101,44,0,5,150
2019376,1590330,2025-06-12,Senate,"Senate Floor Vote - Final Passage",47,12,0,4,63
2019513,1560297,2025-04-28,Senate,"Senate Housing, Construction And Community Development Committee Vote",10,1,0,0,11
2019524,1590132,2025-05-13,Senate,"Senate Aging Committee Vote",6,0,0,0,6
2019524,1590345,2025-06-12,Senate,"Senate Floor Vote - Final Passage",59,0,0,4,63
2019529,1586102,2025-04-28,Senate,"Senate Energy And Telecommunications Committee Vote",7,2,0,0,9
2019529,1586103,2025-06-05,Senate,"Senate Floor Vote - Final Passage",40,20,0,3,63
2019543,1569698,2025-05-12,Senate,"Senate Cities 2 Committee Vote",6,1,0,0,7
2019543,1573858,2025-05-20,Senate,"Senate Education Committee Vote",14,0,0,0,14
2019543,1591591,2025-06-12,Senate,"Senate Floor Vote - Final Passage",54,5,0,4,63
2019543,1595892,2025-06-12,Senate,"Senate Rules Committee Vote",19,1,0,1,21
2019566,1588312,2025-06-10,Senate,"Senate Floor Vote - Final Passage",58,0,0,5,63
2019566,1588313,2025-06-10,Senate,"Senate Rules Committee Vote",18,1,0,2,21
2019568,1588305,2025-06-10,Senate,"Senate Floor Vote - Final Passage",57,1,0,5,63
2019568,1588306,2025-06-10,Senate,"Senate Rules Committee Vote",19,0,0,2,21
2019568,1589645,2025-06-11,Assembly,"Assembly Floor Vote - Final Passage",146,0,0,4,150
2019583,1535621,2025-04-03,Assembly,"Assembly Rules Committee: Favorable",30,0,0,1,31
2019583,1535622,2025-04-03,Assembly,"Assembly Ways And Means Committee: Favorable refer to committee Rules",33,0,0,2,35
2019583,1536895,2025-04-03,Senate,"Senate Floor Vote - Final Passage",60,0,0,3,63
2019583,1541044,2025-04-03,Assembly,"Assembly Floor Vote - Final Passage",148,0,0,2,150
2019728,1589888,2025-05-05,Senate,"Senate Codes Committee Vote",13,0,0,0,13
2019728,1590356,2025-06-12,Senate,"Senate Floor Vote - Final Passage",59,0,0,4,63
2019826,1579018,2025-04-29,Senate,"Senate Investigations And Government Operations Committee Vote",7,0,0,0,7
2019826,1590859,2025-05-27,Senate,"Senate Floor Vote - Final Passage",51,8,0,4,63
2019826,1591045,2025-06-13,Assembly,"Assembly Floor Vote - Final Passage",112,25,0,13,150
2019862,1585824,2025-05-13,Senate,"Senate Transportation Committee Vote",13,0,0,0,13
2019862,1585825,2025-06-05,Senate,"Senate Floor Vote - Final Passage",59,1,0,3,63
2019862,1587428,2025-06-09,Assembly,"Assembly Floor Vote - Final Passage",144,0,0,6,150
2019957,1578910,2025-04-29,Senate,"Senate Investigations And Government Operations Committee Vote",7,0,0,0,7
2019957,1581344,2025-05-27,Senate,"Senate Floor Vote - Final Passage",51,8,0,4,63
2019957,1582044,2025-05-29,Assembly,"Assembly Floor Vote - Final Passage",105,40,0,5,150
2019980,1590392,2025-06-12,Senate,"Senate Floor Vote - Final Passage",58,1,0,4,63
2019980,1595048,2025-06-12,Senate,"Senate Rules Committee Vote",20,0,0,1,21
2020000,1587127,2025-06-09,Senate,"Senate Floor Vote - Final Passage",62,0,0,1,63
2020000,1587128,2025-06-09,Senate,"Senate Rules Committee Vote",21,0,0,0,21
2020067,1584728,2025-05-29,Senate,"Senate Rules Committee Vote",16,4,0,1,21
2020067,1585247,2025-06-04,Senate,"Senate Floor Vote - Final Passage",36,22,0,5,63
2020094,1585313,2025-05-20,Senate,"Senate Corporations, Authorities And Commissions Committee Vote",6,0,0,1,7
2020094,1585314,2025-06-04,Senate,"Senate Floor Vote - Final Passage",57,1,0,5,63
2020419,1589585,2025-06-09,Senate,"Senate Rules Committee Vote",21,0,0,0,21
2020419,1590581,2025-06-12,Senate,"Senate Floor Vote - Final Passage",59,0,0,4,63
2020419,1591104,2025-06-13,Assembly,"Assembly Floor Vote - Final Passage",137,0,0,13,150
2020452,1584653,2025-06-04,Assembly,"Assembly Transportation Committee: Favorable refer to committee Codes",18,4,0,4,26
2020452,1586886,2025-06-09,Assembly,"Assembly Codes Committee: Favorable refer to committee Ways and Means",16,4,0,2,22
2020452,1588480,2025-06-11,Assembly,"Assembly Ways And Means Committee: Favorable refer to committee Rules",25,9,0,1,35
2020452,1589966,2025-06-12,Assembly,"Assembly Rules Committee: Favorable",20,9,0,2,31
2020457,1548897,2025-04-15,Assembly,"Assembly Judiciary Committee: Favorable",20,0,0,1,21
2020457,1559625,2025-04-28,Assembly,"Assembly Floor Vote - Final Passage",146,0,0,4,150
2020459,1590772,2025-06-13,Assembly,"Assembly Rules Committee: Favorable",29,0,0,2,31
2020459,1590773,2025-06-13,Assembly,"Assembly Ways And Means Committee: Favorable refer to committee Rules",30,2,0,3,35
2020493,1593582,2025-06-16,Assembly,"Assembly Rules Committee: Favorable",29,0,0,2,31
2020493,1593583,2025-06-16,Assembly,"Assembly Ways And Means Committee: Favorable refer to committee Rules",32,0,0,3,35
2020516,1587354,2025-06-10,Assembly,"Assembly Ways And Means Committee: Favorable refer to committee Rules",32,0,0,3,35
2020516,1590795,2025-06-13,Assembly,"Assembly Rules Committee: Favorable",29,0,0,2,31
2020546,1574656,2025-05-20,Assembly,"Assembly Judiciary Committee: Favorable refer to committee Rules",20,0,0,1,21
2020546,1574916,2025-05-21,Assembly,"Assembly Rules Committee: Favorable",29,0,0,2,31
2020546,1575747,2025-05-21,Assembly,"Assembly Floor Vote - Final Passage",143,0,0,7,150
2020546,1586124,2025-06-05,Senate,"Senate Floor Vote - Final Passage",59,1,0,3,63
2020552,1590901,2025-06-12,Senate,"Senate Rules Committee Vote",20,0,0,1,21
2020552,1590902,2025-06-13,Senate,"Senate Floor Vote - Final Passage",59,0,0,4,63
2020552,1592224,2025-06-16,Assembly,"Assembly Floor Vote - Final Passage",136,9,0,5,150
2020631,1585584,2025-06-05,Assembly,"Assembly Local Governments Committee: Favorable refer to committee Ways and Means",19,0,0,1,20
2020631,1586009,2025-06-06,Assembly,"Assembly Ways And Means Committee: Favorable refer to committee Rules",35,0,0,0,35
2020631,1587296,2025-06-10,Assembly,"Assembly Rules Committee: Favorable",28,0,0,3,31
2020631,1589157,2025-06-10,Assembly,"Assembly Floor Vote - Final Passage",146,1,0,3,150
2020631,1590288,2025-06-12,Senate,"Senate Floor Vote - Final Passage",59,0,0,4,63
2020679,1589874,2025-06-12,Assembly,"Assembly Ways And Means Committee: Favorable refer to committee Rules",32,2,0,1,35
2020679,1593646,2025-06-16,Assembly,"Assembly Rules Committee: Favorable",29,0,0,2,31
2020826,1561628,2025-04-30,Assembly,"Assembly Labor Committee: Favorable refer to committee Ways and Means",28,0,0,1,29
2020826,1575781,2025-05-22,Assembly,"Assembly Ways And Means Committee: Favorable refer to committee Rules",31,0,0,4,35
2020826,1579352,2025-05-27,Assembly,"Assembly Rules Committee: Favorable",26,0,0,5,31
2020826,1579536,2025-05-27,Assembly,"Assembly Floor Vote - Final Passage",145,0,0,5,150
2020826,1587235,2025-06-09,Senate,"Senate Floor Vote - Final Passage",62,0,0,1,63
2021029,1538003,2025-04-07,Assembly,"Assembly Rules Committee: Favorable",29,0,0,2,31
2021029,1538004,2025-04-07,Assembly,"Assembly Ways And Means Committee: Favorable refer to committee Rules",33,0,0,2,35
2021029,1546523,2025-04-07,Assembly,"Assembly Floor Vote - Final Passage",144,0,0,6,150
2021029,1546524,2025-04-07,Senate,"Senate Floor Vote - Final Passage",61,0,0,2,63
2021382,1585642,2025-05-12,Senate,"Senate Judiciary Committee Vote",17,1,0,1,19
2021382,1585643,2025-06-05,Senate,"Senate Floor Vote - Final Passage",40,20,0,3,63
2021404,1582025,2025-05-29,Senate,"Senate Energy And Telecommunications Committee Vote",8,1,0,0,9
2021449,1586083,2025-06-06,Assembly,"Assembly Ways And Means Committee: Favorable refer to committee Rules",35,0,0,0,35
2021449,1588471,2025-06-11,Assembly,"Assembly Rules Committee: Favorable",28,0,0,3,31
2021477,1588483,2025-06-11,Assembly,"Assembly Ways And Means Committee: Favorable refer to committee Rules",32,2,0,1,35
2021477,1593683,2025-06-16,Assembly,"Assembly Rules Committee: Favorable",29,0,0,2,31
2021517,1574513,2025-05-20,Assembly,"Assembly Energy Committee: Favorable refer to committee Ways and Means",16,0,0,1,17
2021517,1585180,2025-06-04,Assembly,"Assembly Ways And Means Committee: Favorable refer to committee Rules",33,0,0,2,35
2021517,1586992,2025-06-09,Assembly,"Assembly Rules Committee: Favorable",25,0,0,6,31
2021529,1561897,2025-04-30,Assembly,"Assembly Environmental Conservation Committee: Favorable refer to committee Codes",23,6,0,1,30
2021529,1574265,2025-05-20,Assembly,"Assembly Codes Committee: Favorable refer to committee Rules",14,6,0,2,22
2021531,1580953,2025-05-29,Assembly,"Assembly Ways And Means Committee: Favorable refer to committee Rules",33,1,0,1,35
2021531,1584903,2025-06-04,Assembly,"Assembly Rules Committee: Favorable",28,0,0,3,31
2021531,1585403,2025-06-04,Assembly,"Assembly Floor Vote - Final Passage",110,34,0,6,150
2021531,1586930,2025-06-09,Senate,"Senate Floor Vote - Final Passage",55,7,0,1,63
2021553,1562663,2025-04-30,Assembly,"Assembly Tourism, Arts And Sports Development Committee: Favorable refer to committee Ways and Means",17,0,0,4,21
2021553,1579339,2025-05-27,Assembly,"Assembly Ways And Means Committee: Favorable refer to committee Rules",32,0,0,3,35
2021553,1581550,2025-05-29,Assembly,"Assembly Rules Committee: Favorable",27,0,0,4,31
2021579,1574649,2025-05-20,Assembly,"Assembly Ways And Means Committee: Favorable refer to committee Rules",33,2,0,0,35
2021579,1574876,2025-05-21,Assembly,"Assembly Rules Committee: Favorable",29,0,0,2,31
2021579,1575808,2025-05-21,Assembly,"Assembly Floor Vote - Final Passage",101,42,0,7,150
2021579,1599068,2025-05-27,Senate,"Senate Floor Vote - Final Passage",50,9,0,4,63
2021601,1588524,2025-06-11,Assembly,"Assembly Ways And Means Committee: Favorable refer to committee Rules",32,2,0,1,35
2021601,1591555,2025-06-17,Assembly,"Assembly Rules Committee: Favorable",30,0,0,1,31
2021874,1578896,2025-04-29,Senate,"Senate Investigations And Government Operations Committee Vote",7,0,0,0,7
2021874,1591792,2025-05-27,Senate,"Senate Floor Vote - Final Passage",51,8,0,4,63
2021874,1592499,2025-06-17,Assembly,"Assembly Floor Vote - Final Passage",115,26,0,9,150
2022135,1570319,2025-05-13,Senate,"Senate Crime Victims, Crime And Correction Committee Vote",6,1,0,0,7
2022162,1586159,2025-05-29,Senate,"Senate Rules Committee Vote",20,0,0,1,21
2022162,1586160,2025-06-06,Senate,"Senate Floor Vote - Final Passage",53,0,0,10,63
2022195,1588366,2025-06-10,Senate,"Senate Floor Vote - Final Passage",58,0,0,5,63
2022195,1588367,2025-06-10,Senate,"Senate Rules Committee Vote",19,0,0,2,21
2022200,1589934,2025-05-27,Senate,"Senate Civil Service And Pensions Committee Vote",6,0,0,1,7
2022200,1590212,2025-06-12,Senate,"Senate Rules Committee Vote",20,0,0,1,21
2022200,1590649,2025-06-13,Senate,"Senate Floor Vote - Final Passage",59,0,0,4,63
2022200,1592631,2025-06-16,Assembly,"Assembly Floor Vote - Final Passage",144,0,0,6,150
2022482,1543287,2025-04-10,Assembly,"Assembly Rules Committee: Favorable",28,0,0,3,31
2022482,1543288,2025-04-10,Assembly,"Assembly Ways And Means Committee: Favorable refer to committee Rules",32,0,0,3,35
2022482,1543289,2025-04-10,Senate,"Senate Floor Vote - Final Passage",57,0,0,5,62
2022482,1548866,2025-04-10,Assembly,"Assembly Floor Vote - Final Passage",142,0,0,8,150
2022522,1585708,2025-05-13,Senate,"Senate Energy And Telecommunications Committee Vote",6,3,0,0,9
2022522,1585709,2025-06-05,Senate,"Senate Floor Vote - Final Passage",40,20,0,3,63
2022542,1574854,2025-05-20,Senate,"Senate Judiciary Committee Vote",18,0,0,1,19
2022611,1589601,2025-05-28,Senate,"Senate Commerce, Economic Development And Small Business Committee Vote",9,0,0,0,9
2022611,1590370,2025-06-12,Senate,"Senate Floor Vote - Final Passage",59,0,0,4,63
2022627,1581805,2025-05-29,Senate,"Senate Children And Families Committee Vote",6,0,0,1,7
2022692,1560920,2025-04-29,Senate,"Senate Aging Committee Vote",6,0,0,0,6
2022692,1585540,2025-06-04,Senate,"Senate Rules Committee Vote",20,0,0,1,21
2022692,1588410,2025-06-10,Senate,"Senate Floor Vote - Final Passage",58,0,0,5,63
2022853,1586131,2025-05-14,Senate,"Senate Agriculture Committee Vote",8,0,0,1,9
2022853,1586132,2025-06-05,Senate,"Senate Floor Vote - Final Passage",60,0,0,3,63
2022853,1586896,2025-06-06,Assembly,"Assembly Floor Vote - Final Passage",139,0,0,11,150
2022957,1589791,2025-06-12,Assembly,"Assembly Ways And Means Committee: Favorable refer to committee Rules",33,1,0,1,35
2022957,1590686,2025-06-13,Assembly,"Assembly Rules Committee: Favorable",23,6,0,2,31
2022977,1587361,2025-06-10,Assembly,"Assembly Ways And Means Committee: Favorable refer to committee Rules",30,2,0,3,35
2022977,1591537,2025-06-17,Assembly,"Assembly Rules Committee: Favorable",30,0,0,1,31
2022986,1574654,2025-05-20,Assembly,"Assembly Codes Committee: Favorable refer to committee Ways and Means",20,0,0,2,22
2022992,1587334,2025-06-10,Assembly,"Assembly Ways And Means Committee: Favorable refer to committee Rules",22,10,0,3,35
2022992,1588518,2025-06-11,Assembly,"Assembly Rules Committee: Favorable",28,0,0,3,31
2023105,1587787,2025-05-20,Senate,"Senate Higher Education Committee Vote",11,0,0,0,11
2023105,1588413,2025-06-10,Senate,"Senate Floor Vote - Final Passage",58,0,0,5,63
2023167,1589187,2025-05-20,Senate,"Senate Transportation Committee Vote",13,0,0,0,13
2023167,1589513,2025-06-11,Senate,"Senate Floor Vote - Final Passage",58,1,0,4,63
2023167,1591241,2025-06-13,Assembly,"Assembly Floor Vote - Final Passage",137,0,0,13,150
2023262,1590108,2025-05-13,Senate,"Senate Transportation Committee Vote",13,0,0,0,13
2023262,1590326,2025-06-13,Senate,"Senate Floor Vote - Final Passage",58,1,0,4,63
2023262,1592288,2025-06-16,Assembly,"Assembly Floor Vote - Final Passage",144,0,0,6,150
2023291,1585446,2025-06-05,Assembly,"Assembly Governmental Employees Committee: Favorable refer to committee Ways and Means",14,0,0,0,14
2023291,1585949,2025-06-06,Assembly,"Assembly Ways And Means Committee: Favorable refer to committee Rules",35,0,0,0,35
2023291,1586850,2025-06-09,Assembly,"Assembly Rules Committee: Favorable",25,0,0,6,31
2023291,1587516,2025-06-09,Assembly,"Assembly Floor Vote - Final Passage",144,0,0,6,150
2023291,1590282,2025-06-12,Senate,"Senate Floor Vote - Final Passage",59,0,0,4,63
2023293,1574497,2025-05-20,Assembly,"Assembly Aging Committee: Favorable refer to committee Ways and Means",27,0,0,3,30
2023293,1579421,2025-05-27,Assembly,"Assembly Ways And Means Committee: Favorable refer to committee Rules",32,0,0,3,35
2023293,1581495,2025-05-29,Assembly,"Assembly Rules Committee: Favorable",27,0,0,4,31
2023293,1582194,2025-05-29,Assembly,"Assembly Floor Vote - Final Passage",145,0,0,5,150
2023293,1589404,2025-06-11,Senate,"Senate Floor Vote - Final Passage",59,0,0,4,63
2023301,1585528,2025-06-05,Assembly,"Assembly Local Governments Committee: Favorable refer to committee Ways and Means",19,0,0,1,20
2023301,1586093,2025-06-06,Assembly,"Assembly Ways And Means Committee: Favorable refer to committee Rules",35,0,0,0,35
2023301,1591549,2025-06-17,Assembly,"Assembly Rules Committee: Favorable",30,0,0,1,31
2023309,1588564,2025-06-11,Assembly,"Assembly Ways And Means Committee: Favorable refer to committee Rules",34,0,0,1,35
2023309,1590035,2025-06-12,Assembly,"Assembly Rules Committee: Favorable",29,0,0,2,31
2023315,1585990,2025-06-06,Assembly,"Assembly Ways And Means Committee: Favorable refer to committee Rules",35,0,0,0,35
2023315,1590060,2025-06-12,Assembly,"Assembly Rules Committee: Favorable",29,0,0,2,31
2023327,1574845,2025-05-20,Senate,"Senate Civil Service And Pensions Committee Vote",7,0,0,0,7
2023330,1593644,2025-06-16,Assembly,"Assembly Rules Committee: Favorable",29,0,0,2,31
2023330,1593645,2025-06-16,Assembly,"Assembly Ways And Means Committee: Favorable refer to committee Rules",32,0,0,3,35
2023333,1573348,2025-05-19,Assembly,"Assembly Housing Committee: Favorable refer to committee Codes",22,4,0,2,28
2023333,1580391,2025-05-28,Assembly,"Assembly Codes Committee: Favorable refer to committee Rules",15,6,0,1,22
2023340,1566501,2025-05-06,Assembly,"Assembly Higher Education Committee: Favorable",26,0,0,0,26
2023342,1591624,2025-06-16,Assembly,"Assembly Rules Committee: Favorable",29,0,0,2,31
2023342,1591625,2025-06-16,Assembly,"Assembly Ways And Means Committee: Favorable refer to committee Rules",32,0,0,3,35
2023342,1592300,2025-06-16,Assembly,"Assembly Floor Vote - Final Passage",144,0,0,6,150
2023346,1589374,2025-05-27,Senate,"Senate Transportation Committee Vote",13,0,0,0,13
2023346,1589375,2025-06-11,Senate,"Senate Floor Vote - Final Passage",58,1,0,4,63
2023346,1591077,2025-06-13,Assembly,"Assembly Floor Vote - Final Passage",137,0,0,13,150
2023352,1587328,2025-06-10,Assembly,"Assembly Ways And Means Committee: Favorable refer to committee Rules",32,0,0,3,35
2023352,1590049,2025-06-12,Assembly,"Assembly Rules Committee: Favorable",29,0,0,2,31
2023364,1574225,2025-05-20,Assembly,"Assembly Local Governments Committee: Favorable refer to committee Rules",18,0,0,2,20
2023364,1575288,2025-05-21,Assembly,"Assembly Rules Committee: Favorable",29,0,0,2,31
2023364,1575787,2025-05-21,Assembly,"Assembly Floor Vote - Final Passage",143,0,0,7,150
2023364,1590442,2025-06-13,Senate,"Senate Floor Vote - Final Passage",58,1,0,4,63
2023382,1588104,2025-06-10,Assembly,"Assembly Ways And Means Committee: Favorable refer to committee Rules",32,0,0,3,35
2023382,1588565,2025-06-11,Assembly,"Assembly Rules Committee: Favorable",28,0,0,3,31
2023382,1589474,2025-06-11,Assembly,"Assembly Floor Vote - Final Passage",146,0,0,4,150
2023382,1589475,2025-06-11,Senate,"Senate Floor Vote - Final Passage",59,0,0,4,63
2023384,1560881,2025-04-29,Assembly,"Assembly Corporations, Authorities And Commissions Committee: Favorable",25,0,0,1,26
2023384,1565424,2025-05-05,Assembly,"Assembly Floor Vote - Final Passage",147,0,0,3,150
2023384,1585872,2025-06-05,Senate,"Senate Floor Vote - Final Passage",60,0,0,3,63
2023387,1580325,2025-05-28,Assembly,"Assembly Labor Committee: Favorable refer to committee Codes",28,1,0,0,29
2023387,1587058,2025-06-09,Assembly,"Assembly Codes Committee: Favorable refer to committee Rules",17,3,0,2,22
2023387,1590037,2025-06-12,Assembly,"Assembly Rules Committee: Favorable",26,3,0,2,31
2023394,1565546,2025-05-06,Assembly,"Assembly Consumer Affairs And Protection Committee: Favorable refer to committee Codes",16,0,0,0,16
2023394,1580098,2025-05-28,Assembly,"Assembly Codes Committee: Favorable refer to committee Rules",21,0,0,1,22
2023396,1574683,2025-05-20,Assembly,"Assembly Ways And Means Committee: Favorable refer to committee Rules",33,2,0,0,35
2023396,1574929,2025-05-21,Assembly,"Assembly Rules Committee: Favorable",29,0,0,2,31
2023396,1575844,2025-05-21,Assembly,"Assembly Floor Vote - Final Passage",104,39,0,7,150
2023396,1599251,2025-05-27,Senate,"Senate Floor Vote - Final Passage",51,8,0,4,63
2023401,1585719,2025-06-05,Assembly,"Assembly Governmental Operations Committee: Favorable refer to committee Ways and Means",13,0,0,1,14
2023401,1588566,2025-06-11,Assembly,"Assembly Ways And Means Committee: Favorable refer to committee Rules",34,0,0,1,35
2023412,1574831,2025-05-21,Senate,"Senate Mental Health Committee Vote",7,0,0,0,7
2023417,1579366,2025-05-27,Assembly,"Assembly Ways And Means Committee: Favorable refer to committee Rules",31,1,0,3,35
2023417,1581557,2025-05-29,Assembly,"Assembly Rules Committee: Favorable",27,0,0,4,31
2023430,1579120,2025-05-27,Assembly,"Assembly Health Committee: Favorable refer to committee Rules",26,0,0,0,26
2023442,1587312,2025-06-10,Assembly,"Assembly Ways And Means Committee: Favorable refer to committee Rules",32,0,0,3,35
2023442,1590034,2025-06-12,Assembly,"Assembly Rules Committee: Favorable",29,0,0,2,31
2023444,1580597,2025-05-28,Assembly,"Assembly Election Law Committee: Favorable refer to committee Rules",15,0,0,1,16
2023444,1581528,2025-05-29,Assembly,"Assembly Rules Committee: Favorable",27,0,0,4,31
2023447,1573411,2025-05-19,Assembly,"Assembly Health Committee: Favorable refer to committee Codes",24,0,0,2,26
2023447,1580418,2025-05-28,Assembly,"Assembly Codes Committee: Favorable refer to committee Ways and Means",21,0,0,1,22
2023447,1580916,2025-05-29,Assembly,"Assembly Ways And Means Committee: Favorable refer to committee Rules",34,0,0,1,35
2023447,1586097,2025-06-06,Assembly,"Assembly Rules Committee: Favorable",27,0,0,4,31
2023447,1586584,2025-06-06,Assembly,"Assembly Floor Vote - Final Passage",139,0,0,11,150
2023447,1588234,2025-06-10,Senate,"Senate Floor Vote - Final Passage",58,0,0,5,63
2023454,1588520,2025-06-11,Assembly,"Assembly Ways And Means Committee: Favorable refer to committee Rules",34,0,0,1,35
2023454,1590039,2025-06-12,Assembly,"Assembly Rules Committee: Favorable",29,0,0,2,31
2023458,1584645,2025-06-04,Assembly,"Assembly Judiciary Committee: Favorable refer to committee Rules",13,6,0,2,21
2023458,1586026,2025-06-06,Assembly,"Assembly Rules Committee: Favorable",26,1,0,4,31
2023459,1570415,2025-05-13,Assembly,"Assembly Insurance Committee: Favorable",24,0,0,1,25
2023459,1581035,2025-05-28,Assembly,"Assembly Floor Vote - Final Passage",144,0,0,6,150
2023459,1589326,2025-06-11,Senate,"Senate Floor Vote - Final Passage",59,0,0,4,63
2023460,1573290,2025-05-19,Assembly,"Assembly Health Committee: Favorable refer to committee Codes",14,10,0,2,26
2023460,1580023,2025-05-28,Assembly,"Assembly Codes Committee: Favorable refer to committee Rules",15,6,0,1,22
2023460,1581197,2025-05-29,Assembly,"Assembly Rules Committee: Favorable",18,9,0,4,31
2023466,1589869,2025-06-12,Assembly,"Assembly Ways And Means Committee: Favorable refer to committee Rules",31,3,0,1,35
2023466,1593633,2025-06-16,Assembly,"Assembly Rules Committee: Favorable",29,0,0,2,31
2023471,1588519,2025-06-11,Assembly,"Assembly Ways And Means Committee: Favorable refer to committee Rules",32,2,0,1,35
2023471,1590032,2025-06-12,Assembly,"Assembly Rules Committee: Favorable",29,0,0,2,31
2023476,1591565,2025-06-17,Assembly,"Assembly Rules Committee: Favorable",30,0,0,1,31
2023476,1591566,2025-06-17,Assembly,"Assembly Ways And Means Committee: Favorable refer to committee Rules",31,1,0,3,35
2023478,1589866,2025-06-12,Assembly,"Assembly Ways And Means Committee: Favorable refer to committee Rules",24,10,0,1,35
2023478,1591581,2025-06-17,Assembly,"Assembly Rules Committee: Favorable",21,9,0,1,31
2023479,1548731,2025-04-15,Assembly,"Assembly Judiciary Committee: Favorable",20,0,0,1,21
2023479,1560260,2025-04-28,Assembly,"Assembly Floor Vote - Final Passage",146,0,0,4,150
2023479,1588165,2025-06-10,Senate,"Senate Floor Vote - Final Passage",58,0,0,5,63
2023486,1590784,2025-06-13,Assembly,"Assembly Rules Committee: Favorable",29,0,0,2,31
2023486,1590785,2025-06-13,Assembly,"Assembly Ways And Means Committee: Favorable refer to committee Rules",30,2,0,3,35
2023494,1593638,2025-06-16,Assembly,"Assembly Rules Committee: Favorable",29,0,0,2,31
2023494,1593639,2025-06-16,Assembly,"Assembly Ways And Means Committee: Favorable refer to committee Rules",32,0,0,3,35
2023501,1574494,2025-05-20,Assembly,"Assembly Social Services Committee: Favorable refer to committee Ways and Means",12,4,0,2,18
2023506,1574138,2025-05-20,Assembly,"Assembly Local Governments Committee: Favorable refer to committee Ways and Means",18,0,0,2,20
2023506,1579001,2025-05-27,Assembly,"Assembly Ways And Means Committee: Favorable refer to committee Rules",32,0,0,3,35
2023506,1581154,2025-05-29,Assembly,"Assembly Rules Committee: Favorable",27,0,0,4,31
2023506,1582087,2025-05-29,Assembly,"Assembly Floor Vote - Final Passage",145,0,0,5,150
2023510,1579162,2025-05-27,Assembly,"Assembly Health Committee: Favorable refer to committee Rules",26,0,0,0,26
2023513,1579979,2025-05-28,Assembly,"Assembly Local Governments Committee: Favorable refer to committee Ways and Means",20,0,0,0,20
2023513,1585197,2025-06-04,Assembly,"Assembly Ways And Means Committee: Favorable refer to committee Rules",33,0,0,2,35
2023513,1591977,2025-06-17,Assembly,"Assembly Rules Committee: Favorable",28,0,0,3,31
2023519,1562036,2025-04-30,Assembly,"Assembly Racing And Wagering Committee: Favorable refer to committee Ways and Means",11,0,0,0,11
2023519,1578992,2025-05-27,Assembly,"Assembly Ways And Means Committee: Favorable refer to committee Rules",32,0,0,3,35
2023519,1586023,2025-06-06,Assembly,"Assembly Rules Committee: Favorable",27,0,0,4,31
2023519,1586497,2025-06-06,Assembly,"Assembly Floor Vote - Final Passage",138,1,0,11,150
2023519,1590310,2025-06-13,Senate,"Senate Floor Vote - Final Passage",55,4,0,4,63
2023535,1579953,2025-05-28,Assembly,"Assembly Governmental Employees Committee: Favorable refer to committee Ways and Means",14,0,0,0,14
2023535,1586024,2025-06-06,Assembly,"Assembly Ways And Means Committee: Favorable refer to committee Rules",35,0,0,0,35
2023535,1586865,2025-06-09,Assembly,"Assembly Rules Committee: Favorable",25,0,0,6,31
2023535,1587236,2025-06-09,Assembly,"Assembly Floor Vote - Final Passage",144,0,0,6,150
2023535,1590454,2025-06-12,Senate,"Senate Floor Vote - Final Passage",59,0,0,4,63
2023543,1588744,2025-05-27,Senate,"Senate Civil Service And Pensions Committee Vote",6,0,0,1,7
2023543,1590979,2025-06-11,Senate,"Senate Floor Vote - Final Passage",59,0,0,4,63
2023543,1590980,2025-06-11,Senate,"Senate Rules Committee Vote",20,0,0,1,21
2023581,1574814,2025-05-20,Senate,"Senate Labor Committee Vote",13,0,0,0,13
2023581,1588350,2025-06-10,Senate,"Senate Floor Vote - Final Passage",48,10,0,5,63
2023581,1588351,2025-06-10,Senate,"Senate Rules Committee Vote",17,2,0,2,21
2023581,1592083,2025-06-16,Assembly,"Assembly Floor Vote - Final Passage",126,18,0,6,150
2023649,1590456,2025-06-12,Senate,"Senate Floor Vote - Final Passage",59,0,0,4,63
2023649,1594949,2025-06-12,Senate,"Senate Rules Committee Vote",20,0,0,1,21
2023888,1548065,2025-04-15,Senate,"Senate Floor Vote - Final Passage",53,1,0,8,62
2023888,1552384,2025-04-15,Assembly,"Assembly Floor Vote - Final Passage",141,0,0,9,150
2023888,1552385,2025-04-15,Assembly,"Assembly Rules Committee: Favorable",24,0,0,7,31
2023888,1552386,2025-04-15,Assembly,"Assembly Ways And Means Committee: Favorable refer to committee Rules",29,0,0,6,35
2023956,1579510,2025-04-29,Senate,"Senate Investigations And Government Operations Committee Vote",7,0,0,0,7
2023956,1584582,2025-05-27,Senate,"Senate Floor Vote - Final Passage",51,8,0,4,63
2023956,1592650,2025-06-17,Assembly,"Assembly Floor Vote - Final Passage",106,28,0,16,150
2024008,1574827,2025-05-20,Senate,"Senate Civil Service And Pensions Committee Vote",7,0,0,0,7
2024013,1561798,2025-04-30,Assembly,"Assembly Labor Committee: Favorable refer to committee Rules",26,2,0,1,29
2024013,1561799,2025-04-30,Assembly,"Assembly Rules Committee: Favorable",29,0,0,2,31
2024013,1570990,2025-05-13,Assembly,"Assembly Floor Vote - Final Passage",142,3,0,5,150
2024013,1584883,2025-06-04,Senate,"Senate Floor Vote - Final Passage",58,0,0,5,63
2024032,1579431,2025-05-27,Senate,"Senate Transportation Committee Vote",13,0,0,0,13
2024032,1586983,2025-06-09,Senate,"Senate Floor Vote - Final Passage",57,5,0,1,63
2024032,1586984,2025-06-09,Senate,"Senate Rules Committee Vote",21,0,0,0,21
2024032,1589386,2025-06-11,Assembly,"Assembly Floor Vote - Final Passage",115,31,0,4,150
2024041,1588391,2025-06-10,Senate,"Senate Floor Vote - Final Passage",56,2,0,5,63
2024041,1588392,2025-06-10,Senate,"Senate Rules Committee Vote",18,1,0,2,21
2024041,1592472,2025-06-17,Assembly,"Assembly Floor Vote - Final Passage",134,0,0,16,150
2024075,1573350,2025-05-19,Assembly,"Assembly Consumer Affairs And Protection Committee: Favorable refer to committee Codes",15,0,0,1,16
2024075,1580114,2025-05-28,Assembly,"Assembly Codes Committee: Favorable refer to committee Rules",21,0,0,1,22
2024075,1581151,2025-05-29,Assembly,"Assembly Rules Committee: Favorable",27,0,0,4,31
2024084,1585139,2025-05-13,Senate,"Senate Health Committee Vote",10,3,0,1,14
2024084,1585140,2025-06-04,Senate,"Senate Floor Vote - Final Passage",36,22,0,5,63
2024115,1585874,2025-04-29,Senate,"Senate Judiciary Committee Vote",16,3,0,0,19
2024115,1585875,2025-06-05,Senate,"Senate Floor Vote - Final Passage",39,21,0,3,63
2024115,1592514,2025-06-17,Assembly,"Assembly Floor Vote - Final Passage",94,41,0,15,150
2024127,1587318,2025-06-10,Assembly,"Assembly Ways And Means Committee: Favorable refer to committee Rules",32,0,0,3,35
2024127,1591970,2025-06-17,Assembly,"Assembly Rules Committee: Favorable",28,0,0,3,31
2024273,1573381,2025-05-19,Assembly,"Assembly Governmental Employees Committee: Favorable refer to committee Ways and Means",13,0,0,1,14
2024273,1585205,2025-06-04,Assembly,"Assembly Ways And Means Committee: Favorable refer to committee Rules",33,0,0,2,35
2024273,1585993,2025-06-06,Assembly,"Assembly Rules Committee: Favorable",27,0,0,4,31
2024273,1586583,2025-06-06,Assembly,"Assembly Floor Vote - Final Passage",139,0,0,11,150
2024273,1589249,2025-06-11,Senate,"Senate Floor Vote - Final Passage",59,0,0,4,63
2024429,1585600,2025-06-05,Assembly,"Assembly Real Property Taxation Committee: Favorable refer to committee Ways and Means",9,0,0,1,10
2024429,1586044,2025-06-06,Assembly,"Assembly Ways And Means Committee: Favorable refer to committee Rules",35,0,0,0,35
2024429,1591650,2025-06-16,Assembly,"Assembly Rules Committee: Favorable",29,0,0,2,31
2024429,1592328,2025-06-16,Assembly,"Assembly Floor Vote - Final Passage",144,0,0,6,150
2024432,1593613,2025-06-16,Assembly,"Assembly Rules Committee: Favorable",29,0,0,2,31
2024432,1593614,2025-06-16,Assembly,"Assembly Ways And Means Committee: Favorable refer to committee Rules",32,0,0,3,35
2024452,1593672,2025-06-16,Assembly,"Assembly Rules Committee: Favorable",29,0,0,2,31
2024452,1593673,2025-06-16,Assembly,"Assembly Ways And Means Committee: Favorable refer to committee Rules",32,0,0,3,35
2024467,1586063,2025-06-06,Assembly,"Assembly Ways And Means Committee: Favorable refer to committee Rules",30,5,0,0,35
2024467,1588134,2025-06-10,Assembly,"Assembly Rules Committee: Favorable",28,0,0,3,31
2024467,1589158,2025-06-10,Assembly,"Assembly Floor Vote - Final Passage",115,32,0,3,150
2024485,1562480,2025-04-29,Senate,"Senate Judiciary Committee Vote",15,4,0,0,19
2024494,1579935,2025-05-28,Assembly,"Assembly Governmental Employees Committee: Favorable refer to committee Ways and Means",14,0,0,0,14
2024512,1579959,2025-05-28,Assembly,"Assembly Governmental Employees Committee: Favorable refer to committee Ways and Means",14,0,0,0,14
2024552,1580375,2025-05-28,Assembly,"Assembly Corporations, Authorities And Commissions Committee: Favorable refer to committee Ways and Means",25,0,0,1,26
2024552,1586065,2025-06-06,Assembly,"Assembly Ways And Means Committee: Favorable refer to committee Rules",35,0,0,0,35
2024552,1586993,2025-06-09,Assembly,"Assembly Rules Committee: Favorable",25,0,0,6,31
2024552,1587359,2025-06-09,Assembly,"Assembly Floor Vote - Final Passage",144,0,0,6,150
2024552,1590302,2025-06-13,Senate,"Senate Floor Vote - Final Passage",59,0,0,4,63
2024558,1586094,2025-06-06,Assembly,"Assembly Ways And Means Committee: Favorable refer to committee Rules",35,0,0,0,35
2024558,1591958,2025-06-17,Assembly,"Assembly Rules Committee: Favorable",28,0,0,3,31
2024596,1566462,2025-05-06,Assembly,"Assembly Cities Committee: Favorable",14,0,0,2,16
2024596,1570524,2025-05-12,Assembly,"Assembly Floor Vote - Final Passage",142,1,0,7,150
2024601,1573834,2025-05-20,Assembly,"Assembly Agriculture Committee: Favorable refer to committee Ways and Means",23,0,0,0,23
2024601,1584943,2025-06-04,Assembly,"Assembly Ways And Means Committee: Favorable refer to committee Rules",33,0,0,2,35
2024601,1585910,2025-06-06,Assembly,"Assembly Rules Committee: Favorable",27,0,0,4,31
2024618,1586095,2025-06-06,Assembly,"Assembly Ways And Means Committee: Favorable refer to committee Rules",35,0,0,0,35
2024618,1590055,2025-06-12,Assembly,"Assembly Rules Committee: Favorable",29,0,0,2,31
2024624,1586877,2025-05-29,Senate,"Senate Children And Families Committee Vote",6,0,0,1,7
2024624,1587196,2025-06-09,Senate,"Senate Floor Vote - Final Passage",52,10,0,1,63
2024705,1550954,2025-04-17,Assembly,"Assembly Rules Committee: Favorable",22,0,0,9,31
2024705,1550955,2025-04-17,Assembly,"Assembly Ways And Means Committee: Favorable refer to committee Rules",28,0,0,7,35
2024705,1551004,2025-04-17,Senate,"Senate Floor Vote - Final Passage",50,1,0,11,62
2024705,1553319,2025-04-17,Assembly,"Assembly Floor Vote - Final Passage",141,0,0,9,150
2024716,1571857,2025-05-13,Senate,"Senate Health Committee Vote",13,0,0,1,14
2024763,1585122,2025-05-20,Senate,"Senate Codes Committee Vote",13,0,0,0,13
2024763,1585123,2025-06-04,Senate,"Senate Floor Vote - Final Passage",58,0,0,5,63
2024845,1585480,2025-05-19,Senate,"Senate Consumer Protection Committee Vote",6,0,0,1,7
2024845,1585888,2025-06-05,Senate,"Senate Floor Vote - Final Passage",60,0,0,3,63
2024853,1589324,2025-06-11,Senate,"Senate Floor Vote - Final Passage",58,1,0,4,63
2024853,1589325,2025-06-11,Senate,"Senate Rules Committee Vote",19,1,0,1,21
2024853,1592385,2025-06-16,Assembly,"Assembly Floor Vote - Final Passage",134,10,0,6,150
2024859,1589998,2025-05-28,Senate,"Senate Consumer Protection Committee Vote",6,1,0,0,7
2024859,1590731,2025-06-12,Senate,"Senate Floor Vote - Final Passage",52,7,0,4,63
2024884,1585624,2025-05-27,Senate,"Senate Disabilities Committee Vote",6,0,0,0,6
2024884,1585625,2025-06-05,Senate,"Senate Floor Vote - Final Passage",60,0,0,3,63
2024896,1585759,2025-05-13,Senate,"Senate Higher Education Committee Vote",11,0,0,0,11
2024896,1585760,2025-06-05,Senate,"Senate Floor Vote - Final Passage",60,0,0,3,63
2024896,1589396,2025-06-11,Assembly,"Assembly Floor Vote - Final Passage",146,0,0,4,150
2024964,1579282,2025-04-29,Senate,"Senate Investigations And Government Operations Committee Vote",7,0,0,0,7
2024964,1581423,2025-05-27,Senate,"Senate Floor Vote - Final Passage",47,12,0,4,63
2024964,1582160,2025-05-29,Assembly,"Assembly Floor Vote - Final Passage",108,36,0,6,150
2024966,1570944,2025-05-13,Senate,"Senate Corporations, Authorities And Commissions Committee Vote",7,0,0,0,7
2025199,1589653,2025-06-11,Senate,"Senate Rules Committee Vote",20,0,0,1,21
2025199,1590473,2025-06-12,Senate,"Senate Floor Vote - Final Passage",59,0,0,4,63
2025199,1592279,2025-06-16,Assembly,"Assembly Floor Vote - Final Passage",141,3,0,6,150
2025221,1561791,2025-04-29,Senate,"Senate Environmental Conservation Committee Vote",8,3,0,0,11
2025230,1573399,2025-05-19,Assembly,"Assembly Health Committee: Favorable refer to committee Rules",17,7,0,2,26
2025230,1575274,2025-05-21,Assembly,"Assembly Rules Committee: Favorable",20,9,0,2,31
2025293,1585230,2025-06-04,Assembly,"Assembly Ways And Means Committee: Favorable refer to committee Rules",28,5,0,2,35
2025293,1586105,2025-06-06,Assembly,"Assembly Rules Committee: Favorable",27,0,0,4,31
2025293,1586458,2025-06-06,Assembly,"Assembly Floor Vote - Final Passage",89,48,0,13,150
2025293,1589433,2025-06-11,Senate,"Senate Floor Vote - Final Passage",46,13,0,4,63
2025321,1579426,2025-04-29,Senate,"Senate Investigations And Government Operations Committee Vote",7,0,0,0,7
2025321,1580419,2025-05-27,Senate,"Senate Floor Vote - Final Passage",51,8,0,4,63
2025321,1585669,2025-06-05,Senate,"Senate Floor Vote - Final Passage",52,8,0,3,63
2025321,1591062,2025-06-13,Assembly,"Assembly Floor Vote - Final Passage",105,28,0,17,150
2025350,1566273,2025-05-06,Senate,"Senate Civil Service And Pensions Committee Vote",7,0,0,0,7
2025350,1580910,2025-05-28,Senate,"Senate Finance Committee Vote",22,0,0,0,22
2025413,1553235,2025-04-22,Assembly,"Assembly Rules Committee: Favorable",24,0,0,7,31
2025413,1553236,2025-04-22,Assembly,"Assembly Ways And Means Committee: Favorable refer to committee Rules",30,0,0,5,35
2025413,1553306,2025-04-22,Senate,"Senate Floor Vote - Final Passage",53,0,0,9,62
2025413,1558676,2025-04-22,Assembly,"Assembly Floor Vote - Final Passage",134,0,0,16,150
2025423,1589285,2025-06-11,Senate,"Senate Floor Vote - Final Passage",58,1,0,4,63
2025423,1589286,2025-06-11,Senate,"Senate Rules Committee Vote",19,1,0,1,21
2025428,1579487,2025-04-29,Senate,"Senate Investigations And Government Operations Committee Vote",7,0,0,0,7
2025428,1591342,2025-05-27,Senate,"Senate Floor Vote - Final Passage",51,8,0,4,63
2025428,1592491,2025-06-16,Assembly,"Assembly Floor Vote - Final Passage",116,28,0,6,150
2025448,1570814,2025-05-13,Senate,"Senate Civil Service And Pensions Committee Vote",7,0,0,0,7
2025462,1588809,2025-06-09,Senate,"Senate Rules Committee Vote",21,0,0,0,21
2025462,1589338,2025-06-11,Senate,"Senate Floor Vote - Final Passage",58,1,0,4,63
2025482,1585486,2025-04-29,Senate,"Senate Environmental Conservation Committee Vote",11,0,0,0,11
2025482,1585828,2025-06-05,Senate,"Senate Floor Vote - Final Passage",52,8,0,3,63
2025548,1573853,2025-04-29,Senate,"Senate Environmental Conservation Committee Vote",11,0,0,0,11
2025548,1573854,2025-05-19,Senate,"Senate Floor Vote - Final Passage",49,7,0,6,62
2025564,1587076,2025-06-04,Senate,"Senate Rules Committee Vote",18,2,0,1,21
2025564,1587077,2025-06-09,Senate,"Senate Floor Vote - Final Passage",54,8,0,1,63
2025564,1592294,2025-06-18,Assembly,"Assembly Floor Vote - Final Passage",106,28,0,16,150
2025627,1579741,2025-05-28,Assembly,"Assembly Transportation Committee: Favorable refer to committee Rules",23,0,0,3,26
2025631,1580377,2025-05-28,Assembly,"Assembly Banks Committee: Favorable refer to committee Codes",20,8,0,3,31
2025631,1587023,2025-06-09,Assembly,"Assembly Codes Committee: Favorable refer to committee Rules",15,5,0,2,22
2025641,1579173,2025-05-27,Assembly,"Assembly Real Property Taxation Committee: Favorable refer to committee Ways and Means",9,0,0,1,10
2025641,1585168,2025-06-04,Assembly,"Assembly Ways And Means Committee: Favorable refer to committee Rules",33,0,0,2,35
2025641,1585998,2025-06-06,Assembly,"Assembly Rules Committee: Favorable",27,0,0,4,31
2025669,1579945,2025-05-28,Assembly,"Assembly Governmental Employees Committee: Favorable refer to committee Ways and Means",14,0,0,0,14
2025669,1586069,2025-06-06,Assembly,"Assembly Ways And Means Committee: Favorable refer to committee Rules",35,0,0,0,35
2025669,1586881,2025-06-09,Assembly,"Assembly Rules Committee: Favorable",25,0,0,6,31
2025669,1587243,2025-06-09,Assembly,"Assembly Floor Vote - Final Passage",144,0,0,6,150
2025669,1589205,2025-06-11,Senate,"Senate Floor Vote - Final Passage",59,0,0,4,63
2025672,1586126,2025-05-29,Senate,"Senate Rules Committee Vote",19,1,0,1,21
2025672,1586127,2025-06-06,Senate,"Senate Floor Vote - Final Passage",52,1,0,10,63
2025672,1591035,2025-06-13,Assembly,"Assembly Floor Vote - Final Passage",133,0,0,17,150
2025691,1580383,2025-05-28,Assembly,"Assembly Insurance Committee: Favorable refer to committee Ways and Means",24,0,0,1,25
2025694,1561657,2025-04-30,Assembly,"Assembly Environmental Conservation Committee: Favorable refer to committee Rules",29,0,0,1,30
2025694,1561784,2025-04-30,Assembly,"Assembly Rules Committee: Favorable",29,0,0,2,31
2025694,1570934,2025-05-13,Assembly,"Assembly Floor Vote - Final Passage",144,1,0,5,150
2025694,1584833,2025-06-04,Senate,"Senate Floor Vote - Final Passage",58,0,0,5,63
2025698,1584739,2025-06-04,Assembly,"Assembly Judiciary Committee: Favorable refer to committee Codes",18,1,0,2,21
2025698,1587059,2025-06-09,Assembly,"Assembly Codes Committee: Favorable refer to committee Rules",18,2,0,2,22
2025708,1580255,2025-05-28,Assembly,"Assembly Labor Committee: Favorable refer to committee Codes",29,0,0,0,29
2025708,1593597,2025-06-16,Assembly,"Assembly Rules Committee: Favorable",29,0,0,2,31
2025708,1593598,2025-06-16,Assembly,"Assembly Ways And Means Committee: Favorable refer to committee Rules",32,0,0,3,35
2025789,1573382,2025-05-19,Assembly,"Assembly Health Committee: Favorable refer to committee Codes",16,8,0,2,26
2025789,1580106,2025-05-28,Assembly,"Assembly Codes Committee: Favorable refer to committee Rules",15,6,0,1,22
2025789,1581522,2025-05-29,Assembly,"Assembly Rules Committee: Favorable",18,9,0,4,31
2025793,1574323,2025-05-20,Assembly,"Assembly Higher Education Committee: Favorable refer to committee Rules",23,0,0,3,26
2025793,1574874,2025-05-21,Assembly,"Assembly Rules Committee: Favorable",29,0,0,2,31
2025793,1575770,2025-05-21,Assembly,"Assembly Floor Vote - Final Passage",142,1,0,7,150
2025793,1586163,2025-06-06,Senate,"Senate Floor Vote - Final Passage",53,0,0,10,63
2025829,1586911,2025-06-09,Assembly,"Assembly Ways And Means Committee: Favorable refer to committee Rules",27,4,0,4,35
2025829,1588479,2025-06-11,Assembly,"Assembly Rules Committee: Favorable",19,9,0,3,31
2025834,1585423,2025-06-05,Assembly,"Assembly Codes Committee: Favorable refer to committee Ways and Means",15,6,0,1,22
2025885,1585512,2025-05-19,Senate,"Senate Consumer Protection Committee Vote",6,0,0,1,7
2025885,1585886,2025-06-05,Senate,"Senate Floor Vote - Final Passage",60,0,0,3,63
2025935,1571421,2025-05-14,Senate,"Senate Agriculture Committee Vote",7,1,0,1,9
2025941,1581684,2025-05-28,Senate,"Senate Judiciary Committee Vote",17,0,0,2,19
2025947,1585747,2025-05-20,Senate,"Senate Higher Education Committee Vote",11,0,0,0,11
2025947,1585748,2025-06-05,Senate,"Senate Floor Vote - Final Passage",60,0,0,3,63
2025947,1586610,2025-06-06,Assembly,"Assembly Floor Vote - Final Passage",137,0,0,13,150
2025948,1589614,2025-05-27,Senate,"Senate Internet And Technology Committee Vote",6,1,0,0,7
2025948,1590517,2025-06-12,Senate,"Senate Floor Vote - Final Passage",59,0,0,4,63
2025948,1592637,2025-06-16,Assembly,"Assembly Floor Vote - Final Passage",143,2,0,5,150
2025952,1585506,2025-05-20,Senate,"Senate Social Services Committee Vote",6,0,0,0,6
2025952,1585829,2025-06-05,Senate,"Senate Floor Vote - Final Passage",60,0,0,3,63
2025971,1579490,2025-05-27,Senate,"Senate Transportation Committee Vote",13,0,0,0,13
2025971,1585519,2025-06-04,Senate,"Senate Rules Committee Vote",20,0,0,1,21
2025971,1590542,2025-06-12,Senate,"Senate Floor Vote - Final Passage",59,0,0,4,63
2025995,1569951,2025-05-01,Senate,"Senate Rules Committee Vote",18,0,0,3,21
2025995,1569952,2025-05-12,Senate,"Senate Floor Vote - Final Passage",57,0,0,5,62
2025995,1570584,2025-05-12,Assembly,"Assembly Floor Vote - Final Passage",143,0,0,7,150
2026025,1569972,2025-05-01,Senate,"Senate Rules Committee Vote",18,0,0,3,21
2026025,1569973,2025-05-12,Senate,"Senate Floor Vote - Final Passage",57,0,0,5,62
2026025,1570594,2025-05-12,Assembly,"Assembly Floor Vote - Final Passage",143,0,0,7,150
2026049,1579550,2025-04-29,Senate,"Senate Investigations And Government Operations Committee Vote",7,0,0,0,7
2026049,1586933,2025-05-27,Senate,"Senate Floor Vote - Final Passage",51,8,0,4,63
2026049,1587264,2025-06-09,Assembly,"Assembly Floor Vote - Final Passage",111,33,0,6,150
2026097,1561892,2025-04-30,Assembly,"Assembly Banks Committee: Favorable",19,9,0,3,31
2026097,1589411,2025-06-11,Assembly,"Assembly Floor Vote - Final Passage",139,0,0,11,150
2026097,1590704,2025-06-12,Senate,"Senate Floor Vote - Final Passage",59,0,0,4,63
2026161,1588380,2025-04-29,Senate,"Senate Investigations And Government Operations Committee Vote",7,0,0,0,7
2026161,1588381,2025-06-09,Senate,"Senate Floor Vote - Final Passage",53,9,0,1,63
2026161,1592286,2025-06-16,Assembly,"Assembly Floor Vote - Final Passage",118,26,0,6,150
2026264,1556397,2025-04-24,Assembly,"Assembly Rules Committee: Favorable",23,0,0,8,31
2026264,1556398,2025-04-24,Assembly,"Assembly Ways And Means Committee: Favorable refer to committee Rules",27,0,0,8,35
2026264,1556885,2025-04-24,Senate,"Senate Floor Vote - Final Passage",49,2,0,11,62
2026264,1560251,2025-04-24,Assembly,"Assembly Floor Vote - Final Passage",136,0,0,14,150
2026287,1579505,2025-05-27,Senate,"Senate Civil Service And Pensions Committee Vote",6,0,0,1,7
2026326,1589587,2025-05-20,Senate,"Senate Judiciary Committee Vote",17,1,0,1,19
2026326,1590587,2025-06-12,Senate,"Senate Floor Vote - Final Passage",41,18,0,4,63
2026374,1560811,2025-04-29,Assembly,"Assembly Corporations, Authorities And Commissions Committee: Favorable refer to committee Ways and Means",24,1,0,1,26
2026374,1575796,2025-05-22,Assembly,"Assembly Ways And Means Committee: Favorable refer to committee Rules",31,0,0,4,35
2026374,1579396,2025-05-27,Assembly,"Assembly Rules Committee: Favorable",26,0,0,5,31
2026374,1579542,2025-05-27,Assembly,"Assembly Floor Vote - Final Passage",145,0,0,5,150
2026374,1588036,2025-06-10,Senate,"Senate Floor Vote - Final Passage",58,0,0,5,63
2026414,1569944,2025-05-01,Senate,"Senate Rules Committee Vote",18,0,0,3,21
2026414,1569945,2025-05-12,Senate,"Senate Floor Vote - Final Passage",57,0,0,5,62
2026414,1570596,2025-05-12,Assembly,"Assembly Floor Vote - Final Passage",143,0,0,7,150
2026430,1580181,2025-05-28,Assembly,"Assembly Higher Education Committee: Favorable refer to committee Ways and Means",26,0,0,0,26
2026430,1584922,2025-06-04,Assembly,"Assembly Ways And Means Committee: Favorable refer to committee Rules",33,0,0,2,35
2026430,1585964,2025-06-06,Assembly,"Assembly Rules Committee: Favorable",27,0,0,4,31
2026451,1586074,2025-06-06,Assembly,"Assembly Ways And Means Committee: Favorable refer to committee Rules",35,0,0,0,35
2026451,1591956,2025-06-17,Assembly,"Assembly Rules Committee: Favorable",28,0,0,3,31
2026454,1586006,2025-06-06,Assembly,"Assembly Ways And Means Committee: Favorable refer to committee Rules",35,0,0,0,35
2026454,1591954,2025-06-17,Assembly,"Assembly Rules Committee: Favorable",28,0,0,3,31
2026461,1587152,2025-06-09,Senate,"Senate Floor Vote - Final Passage",62,0,0,1,63
2026461,1587153,2025-06-09,Senate,"Senate Rules Committee Vote",21,0,0,0,21
2026467,1586034,2025-06-06,Assembly,"Assembly Ways And Means Committee: Favorable refer to committee Rules",35,0,0,0,35
2026467,1587019,2025-06-09,Assembly,"Assembly Rules Committee: Favorable",25,0,0,6,31
2026467,1587020,2025-06-09,Senate,"Senate Floor Vote - Final Passage",54,8,0,1,63
2026467,1587398,2025-06-09,Assembly,"Assembly Floor Vote - Final Passage",110,34,0,6,150
2026468,1585520,2025-05-27,Senate,"Senate Corporations, Authorities And Commissions Committee Vote",6,0,0,1,7
2026468,1585892,2025-06-05,Senate,"Senate Floor Vote - Final Passage",60,0,0,3,63
2026476,1586080,2025-06-06,Assembly,"Assembly Ways And Means Committee: Favorable refer to committee Rules",35,0,0,0,35
2026476,1586958,2025-06-09,Assembly,"Assembly Rules Committee: Favorable",25,0,0,6,31
2026480,1589461,2025-06-12,Assembly,"Assembly Rules Committee: Favorable",29,0,0,2,31
2026480,1589462,2025-06-12,Assembly,"Assembly Ways And Means Committee: Favorable refer to committee Rules",34,0,0,1,35
2026484,1585966,2025-06-06,Assembly,"Assembly Ways And Means Committee: Favorable refer to committee Rules",35,0,0,0,35
2026484,1593650,2025-06-16,Assembly,"Assembly Rules Committee: Favorable",29,0,0,2,31
2026485,1581362,2025-05-28,Senate,"Senate Procurement And Contracts Committee Vote",6,0,0,1,7
2026485,1589055,2025-06-11,Senate,"Senate Floor Vote - Final Passage",42,17,0,4,63
2026485,1589056,2025-06-11,Senate,"Senate Rules Committee Vote",16,4,0,1,21
2026489,1559282,2025-04-28,Assembly,"Assembly Veterans' Affairs Committee: Favorable",19,0,0,0,19
2026489,1566164,2025-05-05,Assembly,"Assembly Floor Vote - Final Passage",147,0,0,3,150
2026491,1559163,2025-04-28,Assembly,"Assembly Veterans' Affairs Committee: Favorable",19,0,0,0,19
2026491,1566201,2025-05-05,Assembly,"Assembly Floor Vote - Final Passage",147,0,0,3,150
2026544,1586956,2025-05-28,Senate,"Senate Investigations And Government Operations Committee Vote",7,0,0,0,7
2026544,1586957,2025-06-09,Senate,"Senate Floor Vote - Final Passage",53,9,0,1,63
2026544,1592254,2025-06-18,Assembly,"Assembly Floor Vote - Final Passage",107,27,0,16,150
2026665,1589751,2025-06-12,Assembly,"Assembly Ways And Means Committee: Favorable refer to committee Rules",24,10,0,1,35
2026665,1591552,2025-06-17,Assembly,"Assembly Rules Committee: Favorable",21,9,0,1,31
2026691,1566484,2025-05-06,Assembly,"Assembly Aging Committee: Favorable refer to committee Ways and Means",28,0,0,2,30
2026691,1579397,2025-05-27,Assembly,"Assembly Ways And Means Committee: Favorable refer to committee Rules",32,0,0,3,35
2026691,1581523,2025-05-29,Assembly,"Assembly Rules Committee: Favorable",27,0,0,4,31
2026691,1582199,2025-05-29,Assembly,"Assembly Floor Vote - Final Passage",145,0,0,5,150
2026691,1590726,2025-06-12,Senate,"Senate Floor Vote - Final Passage",59,0,0,4,63
2026706,1578962,2025-05-27,Senate,"Senate Labor Committee Vote",13,0,0,0,13
2026713,1574861,2025-05-20,Senate,"Senate Civil Service And Pensions Committee Vote",7,0,0,0,7
2026783,1590453,2025-06-12,Senate,"Senate Floor Vote - Final Passage",58,1,0,4,63
2026783,1595120,2025-06-12,Senate,"Senate Rules Committee Vote",19,1,0,1,21
2026921,1569456,2025-04-29,Senate,"Senate Rules Committee Vote",21,0,0,0,21
2026921,1569731,2025-05-12,Senate,"Senate Floor Vote - Final Passage",56,1,0,5,62
2026921,1573862,2025-05-19,Assembly,"Assembly Floor Vote - Final Passage",142,0,0,8,150
2026995,1589957,2025-06-11,Senate,"Senate Rules Committee Vote",20,0,0,1,21
2026995,1590511,2025-06-12,Senate,"Senate Floor Vote - Final Passage",59,0,0,4,63
2026999,1589063,2025-05-13,Senate,"Senate Transportation Committee Vote",12,1,0,0,13
2026999,1589064,2025-06-11,Senate,"Senate Floor Vote - Final Passage",57,2,0,4,63
2026999,1592541,2025-06-16,Assembly,"Assembly Floor Vote - Final Passage",114,30,0,6,150
2027005,1559766,2025-04-29,Senate,"Senate Floor Vote - Final Passage",57,4,0,1,62
2027005,1564790,2025-04-29,Assembly,"Assembly Floor Vote - Final Passage",149,0,0,1,150
2027005,1564791,2025-04-29,Senate,"Senate Rules Committee Vote",20,1,0,0,21
2027007,1587160,2025-06-09,Senate,"Senate Floor Vote - Final Passage",62,0,0,1,63
2027007,1587161,2025-06-09,Senate,"Senate Rules Committee Vote",21,0,0,0,21
2027007,1592080,2025-06-16,Assembly,"Assembly Floor Vote - Final Passage",144,0,0,6,150
2027029,1590191,2025-06-12,Senate,"Senate Rules Committee Vote",20,0,0,1,21
2027029,1590593,2025-06-13,Senate,"Senate Floor Vote - Final Passage",59,0,0,4,63
2027029,1592428,2025-06-18,Assembly,"Assembly Floor Vote - Final Passage",134,0,0,16,150
2027038,1559697,2025-04-29,Assembly,"Assembly Rules Committee: Favorable",29,0,0,2,31
2027038,1559698,2025-04-29,Assembly,"Assembly Ways And Means Committee: Favorable refer to committee Rules",33,0,0,2,35
2027093,1585789,2025-05-13,Senate,"Senate Corporations, Authorities And Commissions Committee Vote",7,0,0,0,7
2027093,1585790,2025-06-05,Senate,"Senate Floor Vote - Final Passage",60,0,0,3,63
2027140,1589299,2025-06-11,Senate,"Senate Floor Vote - Final Passage",58,1,0,4,63
2027140,1589300,2025-06-11,Senate,"Senate Rules Committee Vote",20,0,0,1,21
2027140,1591325,2025-06-13,Assembly,"Assembly Floor Vote - Final Passage",133,3,0,14,150
2027150,1579195,2025-05-27,Senate,"Senate Corporations, Authorities And Commissions Committee Vote",6,0,0,1,7
2027184,1585501,2025-05-20,Senate,"Senate Cities 1 Committee Vote",7,0,0,0,7
2027184,1585884,2025-06-05,Senate,"Senate Floor Vote - Final Passage",57,3,0,3,63
2027184,1586708,2025-06-06,Assembly,"Assembly Floor Vote - Final Passage",136,1,0,13,150
2027210,1588923,2025-06-04,Senate,"Senate Rules Committee Vote",18,2,0,1,21
2027210,1589346,2025-06-11,Senate,"Senate Floor Vote - Final Passage",39,20,0,4,63
2027277,1586621,2025-05-27,Senate,"Senate Civil Service And Pensions Committee Vote",6,0,0,1,7
2027277,1587162,2025-06-09,Senate,"Senate Rules Committee Vote",21,0,0,0,21
2027277,1588385,2025-06-10,Senate,"Senate Floor Vote - Final Passage",58,0,0,5,63
2027277,1591094,2025-06-13,Assembly,"Assembly Floor Vote - Final Passage",136,0,0,14,150
2027358,1588825,2025-06-09,Senate,"Senate Rules Committee Vote",19,2,0,0,21
2027358,1589344,2025-06-11,Senate,"Senate Floor Vote - Final Passage",55,4,0,4,63
2027379,1585727,2025-05-13,Senate,"Senate Energy And Telecommunications Committee Vote",9,0,0,0,9
2027379,1585728,2025-06-05,Senate,"Senate Floor Vote - Final Passage",55,5,0,3,63
2027392,1590439,2025-06-12,Senate,"Senate Floor Vote - Final Passage",44,15,0,4,63
2027392,1591292,2025-06-13,Assembly,"Assembly Floor Vote - Final Passage",92,44,0,14,150
2027392,1595126,2025-06-12,Senate,"Senate Rules Committee Vote",15,5,0,1,21
2027506,1566176,2025-05-06,Assembly,"Assembly Aging Committee: Favorable",28,0,0,2,30
2027506,1570282,2025-05-12,Assembly,"Assembly Floor Vote - Final Passage",143,0,0,7,150
2027506,1587241,2025-06-09,Senate,"Senate Floor Vote - Final Passage",62,0,0,1,63
2027529,1589762,2025-06-12,Assembly,"Assembly Ways And Means Committee: Favorable refer to committee Rules",33,1,0,1,35
2027529,1590681,2025-06-13,Assembly,"Assembly Rules Committee: Favorable",29,0,0,2,31
2027541,1585188,2025-05-12,Senate,"Senate Judiciary Committee Vote",18,0,0,1,19
2027541,1585189,2025-06-04,Senate,"Senate Floor Vote - Final Passage",58,0,0,5,63
2027547,1589812,2025-05-20,Senate,"Senate Transportation Committee Vote",13,0,0,0,13
2027547,1590574,2025-06-12,Senate,"Senate Floor Vote - Final Passage",59,0,0,4,63
2027547,1592271,2025-06-16,Assembly,"Assembly Floor Vote - Final Passage",144,0,0,6,150
2027562,1584853,2025-05-12,Senate,"Senate Judiciary Committee Vote",13,5,0,1,19
2027562,1584854,2025-06-04,Senate,"Senate Floor Vote - Final Passage",36,22,0,5,63
2027697,1591620,2025-06-17,Assembly,"Assembly Ways And Means Committee: Favorable refer to committee Rules",31,1,0,3,35
2027697,1591976,2025-06-17,Assembly,"Assembly Rules Committee: Favorable",28,0,0,3,31
2027697,1592295,2025-06-18,Assembly,"Assembly Floor Vote - Final Passage",109,25,0,16,150
2027704,1574860,2025-05-20,Senate,"Senate Women's Issues Committee Vote",7,0,0,0,7
2027704,1591653,2025-06-12,Senate,"Senate Floor Vote - Final Passage",59,0,0,4,63
2027704,1595900,2025-06-12,Senate,"Senate Rules Committee Vote",20,0,0,1,21
2027740,1580094,2025-05-28,Assembly,"Assembly Corporations, Authorities And Commissions Committee: Favorable refer to committee Codes",17,8,0,1,26
2027798,1588955,2025-05-27,Senate,"Senate Internet And Technology Committee Vote",5,2,0,0,7
2027798,1589371,2025-06-11,Senate,"Senate Floor Vote - Final Passage",40,19,0,4,63
2027809,1580372,2025-05-28,Assembly,"Assembly Local Governments Committee: Favorable refer to committee Ways and Means",20,0,0,0,20
2027809,1585219,2025-06-04,Assembly,"Assembly Ways And Means Committee: Favorable refer to committee Rules",29,4,0,2,35
2027809,1585952,2025-06-06,Assembly,"Assembly Rules Committee: Favorable",27,0,0,4,31
2027809,1586900,2025-06-06,Assembly,"Assembly Floor Vote - Final Passage",131,6,0,13,150
2027809,1589039,2025-06-11,Senate,"Senate Floor Vote - Final Passage",58,1,0,4,63
2027833,1580245,2025-05-28,Assembly,"Assembly Corporations, Authorities And Commissions Committee: Favorable refer to committee Rules",25,0,0,1,26
2027833,1581503,2025-05-29,Assembly,"Assembly Rules Committee: Favorable",27,0,0,4,31
2027833,1582192,2025-05-29,Assembly,"Assembly Floor Vote - Final Passage",144,0,0,6,150
2027833,1587967,2025-06-10,Senate,"Senate Floor Vote - Final Passage",58,0,0,5,63
2027865,1563349,2025-05-01,Assembly,"Assembly Rules Committee: Favorable",27,0,0,4,31
2027865,1563350,2025-05-01,Assembly,"Assembly Ways And Means Committee: Favorable refer to committee Rules",32,0,0,3,35
2027865,1563351,2025-05-01,Senate,"Senate Floor Vote - Final Passage",50,4,0,8,62
2027865,1566796,2025-05-01,Assembly,"Assembly Floor Vote - Final Passage",140,0,0,10,150
2027873,1587349,2025-06-10,Assembly,"Assembly Ways And Means Committee: Favorable refer to committee Rules",32,0,0,3,35
2027873,1588548,2025-06-11,Assembly,"Assembly Rules Committee: Favorable",28,0,0,3,31
2027888,1587172,2025-06-09,Senate,"Senate Floor Vote - Final Passage",48,14,0,1,63
2027888,1587173,2025-06-09,Senate,"Senate Rules Committee Vote",20,1,0,0,21
2027925,1585665,2025-05-13,Senate,"Senate Environmental Conservation Committee Vote",11,0,0,0,11
2027925,1585666,2025-06-05,Senate,"Senate Floor Vote - Final Passage",58,2,0,3,63
2027972,1589841,2025-05-13,Senate,"Senate Transportation Committee Vote",13,0,0,0,13
2027972,1590595,2025-06-12,Senate,"Senate Floor Vote - Final Passage",59,0,0,4,63
2028050,1588765,2025-06-09,Senate,"Senate Rules Committee Vote",21,0,0,0,21
2028050,1589240,2025-06-11,Senate,"Senate Floor Vote - Final Passage",59,0,0,4,63
2028062,1587091,2025-05-28,Senate,"Senate Consumer Protection Committee Vote",6,1,0,0,7
2028062,1587092,2025-06-09,Senate,"Senate Floor Vote - Final Passage",59,3,0,1,63
2028079,1565753,2025-05-06,Assembly,"Assembly Higher Education Committee: Favorable",26,0,0,0,26
2028090,1574840,2025-05-20,Senate,"Senate Women's Issues Committee Vote",7,0,0,0,7
2028090,1587176,2025-06-09,Senate,"Senate Floor Vote - Final Passage",62,0,0,1,63
2028090,1587177,2025-06-09,Senate,"Senate Rules Committee Vote",21,0,0,0,21
2028095,1566258,2025-05-06,Assembly,"Assembly Higher Education Committee: Favorable",26,0,0,0,26
2028119,1585348,2025-05-12,Senate,"Senate Judiciary Committee Vote",18,0,0,1,19
2028119,1585349,2025-06-04,Senate,"Senate Floor Vote - Final Passage",56,2,0,5,63
2028133,1565885,2025-05-06,Assembly,"Assembly Energy Committee: Favorable",16,0,0,1,17
2028133,1574852,2025-05-20,Assembly,"Assembly Floor Vote - Final Passage",147,0,0,3,150
2028141,1571254,2025-05-13,Senate,"Senate Aging Committee Vote",6,0,0,0,6
2028141,1585531,2025-06-04,Senate,"Senate Rules Committee Vote",20,0,0,1,21
2028141,1590879,2025-06-09,Senate,"Senate Floor Vote - Final Passage",62,0,0,1,63
2028147,1566389,2025-05-06,Assembly,"Assembly Energy Committee: Favorable refer to committee Ways and Means",12,4,0,1,17
2028147,1585932,2025-06-06,Assembly,"Assembly Ways And Means Committee: Favorable refer to committee Rules",24,11,0,0,35
2028179,1571029,2025-05-13,Senate,"Senate Procurement And Contracts Committee Vote",7,0,0,0,7
2028189,1565527,2025-05-06,Assembly,"Assembly Higher Education Committee: Favorable",26,0,0,0,26
2028227,1566231,2025-05-06,Assembly,"Assembly Governmental Operations Committee: Favorable refer to committee Rules",14,0,0,0,14
2028227,1579090,2025-05-27,Assembly,"Assembly Rules Committee: Favorable",26,0,0,5,31
2028227,1579590,2025-05-27,Assembly,"Assembly Floor Vote - Final Passage",145,0,0,5,150
2028227,1587248,2025-06-09,Senate,"Senate Floor Vote - Final Passage",62,0,0,1,63
2028275,1573840,2025-05-20,Senate,"Senate Social Services Committee Vote",6,0,0,0,6
2028315,1566032,2025-05-06,Assembly,"Assembly Corporations, Authorities And Commissions Committee: Favorable refer to committee Ways and Means",19,6,0,1,26
2028315,1576478,2025-05-22,Assembly,"Assembly Ways And Means Committee: Favorable refer to committee Rules",21,10,0,4,35
2028315,1579328,2025-05-27,Assembly,"Assembly Rules Committee: Favorable",26,0,0,5,31
2028315,1580203,2025-05-27,Assembly,"Assembly Floor Vote - Final Passage",145,0,0,5,150
2028315,1589381,2025-06-11,Senate,"Senate Floor Vote - Final Passage",56,3,0,4,63
2028321,1588477,2025-06-11,Assembly,"Assembly Ways And Means Committee: Favorable refer to committee Rules",34,0,0,1,35
2028321,1590031,2025-06-12,Assembly,"Assembly Rules Committee: Favorable",29,0,0,2,31
2028329,1588359,2025-06-10,Senate,"Senate Floor Vote - Final Passage",58,0,0,5,63
2028329,1588360,2025-06-10,Senate,"Senate Rules Committee Vote",19,0,0,2,21
2028329,1591031,2025-06-13,Assembly,"Assembly Floor Vote - Final Passage",123,10,0,17,150
2028341,1578988,2025-05-27,Assembly,"Assembly Governmental Operations Committee: Favorable refer to committee Rules",14,0,0,0,14
2028341,1585940,2025-06-06,Assembly,"Assembly Rules Committee: Favorable",27,0,0,4,31
2028341,1588996,2025-06-10,Assembly,"Assembly Floor Vote - Final Passage",145,0,0,5,150
2028342,1586100,2025-06-06,Assembly,"Assembly Ways And Means Committee: Favorable refer to committee Rules",35,0,0,0,35
2028342,1586990,2025-06-09,Assembly,"Assembly Rules Committee: Favorable",25,0,0,6,31
2028342,1586991,2025-06-09,Senate,"Senate Floor Vote - Final Passage",53,9,0,1,63
2028342,1587358,2025-06-09,Assembly,"Assembly Floor Vote - Final Passage",110,34,0,6,150
2028346,1570112,2025-05-13,Assembly,"Assembly Environmental Conservation Committee: Favorable",27,0,0,3,30
2028346,1573865,2025-05-19,Assembly,"Assembly Floor Vote - Final Passage",143,0,0,7,150
2028346,1585370,2025-06-04,Senate,"Senate Floor Vote - Final Passage",57,1,0,5,63
2028378,1574529,2025-05-20,Senate,"Senate Cities 1 Committee Vote",7,0,0,0,7
2028378,1590253,2025-06-12,Senate,"Senate Rules Committee Vote",20,0,0,1,21
2028378,1590733,2025-06-13,Senate,"Senate Floor Vote - Final Passage",59,0,0,4,63
2028378,1592679,2025-06-16,Assembly,"Assembly Floor Vote - Final Passage",143,1,0,6,150
2028406,1590217,2025-06-12,Senate,"Senate Rules Committee Vote",20,0,0,1,21
2028406,1590657,2025-06-13,Senate,"Senate Floor Vote - Final Passage",59,0,0,4,63
2028406,1592407,2025-06-16,Assembly,"Assembly Floor Vote - Final Passage",144,0,0,6,150
2028418,1570756,2025-05-13,Senate,"Senate Civil Service And Pensions Committee Vote",7,0,0,0,7
2028420,1591409,2025-06-16,Assembly,"Assembly Rules Committee: Favorable",20,9,0,2,31
2028420,1591410,2025-06-16,Assembly,"Assembly Ways And Means Committee: Favorable refer to committee Rules",23,9,0,3,35
2028431,1585582,2025-06-05,Assembly,"Assembly Local Governments Committee: Favorable refer to committee Ways and Means",19,0,0,1,20
2028431,1586031,2025-06-06,Assembly,"Assembly Ways And Means Committee: Favorable refer to committee Rules",35,0,0,0,35
2028431,1586912,2025-06-09,Assembly,"Assembly Rules Committee: Favorable",25,0,0,6,31
2028431,1587250,2025-06-09,Assembly,"Assembly Floor Vote - Final Passage",144,0,0,6,150
2028431,1589034,2025-06-11,Senate,"Senate Floor Vote - Final Passage",58,1,0,4,63
2028444,1590255,2025-06-12,Senate,"Senate Rules Committee Vote",20,0,0,1,21
2028444,1590742,2025-06-13,Senate,"Senate Floor Vote - Final Passage",58,1,0,4,63
2028444,1591222,2025-06-13,Assembly,"Assembly Floor Vote - Final Passage",133,0,0,17,150
2028499,1570767,2025-05-13,Senate,"Senate Civil Service And Pensions Committee Vote",7,0,0,0,7
2028560,1579442,2025-05-20,Senate,"Senate Transportation Committee Vote",13,0,0,0,13
2028560,1580408,2025-05-27,Senate,"Senate Floor Vote - Final Passage",58,1,0,4,63
2028560,1586165,2025-06-06,Senate,"Senate Floor Vote - Final Passage",52,1,0,10,63
2028560,1587891,2025-06-09,Assembly,"Assembly Floor Vote - Final Passage",144,0,0,6,150
2028577,1580883,2025-05-28,Senate,"Senate Veterans, Homeland Security And Military Affairs Committee Vote",9,0,0,0,9
2028600,1590794,2025-06-13,Assembly,"Assembly Ways And Means Committee: Favorable refer to committee Rules",29,3,0,3,35
2028600,1591968,2025-06-17,Assembly,"Assembly Rules Committee: Favorable",28,0,0,3,31
2028600,1592293,2025-06-18,Assembly,"Assembly Floor Vote - Final Passage",118,16,0,16,150
2028604,1579977,2025-05-28,Assembly,"Assembly Governmental Employees Committee: Favorable refer to committee Ways and Means",14,0,0,0,14
2028605,1584916,2025-06-04,Assembly,"Assembly Ways And Means Committee: Favorable refer to committee Rules",33,0,0,2,35
2028605,1585927,2025-06-06,Assembly,"Assembly Rules Committee: Favorable",27,0,0,4,31
2028605,1586488,2025-06-06,Assembly,"Assembly Floor Vote - Final Passage",99,38,0,13,150
2028605,1587188,2025-06-09,Senate,"Senate Floor Vote - Final Passage",53,9,0,1,63
2028633,1574296,2025-05-20,Assembly,"Assembly Racing And Wagering Committee: Favorable refer to committee Ways and Means",10,0,0,1,11
2028633,1589758,2025-06-12,Assembly,"Assembly Ways And Means Committee: Favorable refer to committee Rules",34,0,0,1,35
2028633,1591452,2025-06-16,Assembly,"Assembly Rules Committee: Favorable",29,0,0,2,31
2028639,1587286,2025-06-10,Assembly,"Assembly Ways And Means Committee: Favorable refer to committee Rules",29,3,0,3,35
2028639,1590058,2025-06-12,Assembly,"Assembly Rules Committee: Favorable",29,0,0,2,31
2028651,1586891,2025-06-09,Assembly,"Assembly Ways And Means Committee: Favorable refer to committee Rules",27,4,0,4,35
2028651,1588006,2025-06-10,Assembly,"Assembly Rules Committee: Favorable",28,0,0,3,31
2028651,1588909,2025-06-10,Assembly,"Assembly Floor Vote - Final Passage",130,17,0,3,150
2028651,1589334,2025-06-11,Senate,"Senate Floor Vote - Final Passage",58,1,0,4,63
2028673,1584633,2025-06-04,Assembly,"Assembly Transportation Committee: Favorable refer to committee Ways and Means",22,0,0,4,26
2028673,1586040,2025-06-06,Assembly,"Assembly Ways And Means Committee: Favorable refer to committee Rules",35,0,0,0,35
2028673,1586979,2025-06-09,Assembly,"Assembly Rules Committee: Favorable",25,0,0,6,31
2028675,1589875,2025-06-12,Assembly,"Assembly Ways And Means Committee: Favorable refer to committee Rules",34,0,0,1,35
2028675,1590775,2025-06-13,Assembly,"Assembly Rules Committee: Favorable",29,0,0,2,31
2028678,1580407,2025-05-28,Assembly,"Assembly Codes Committee: Favorable refer to committee Rules",21,0,0,1,22
2028678,1581526,2025-05-29,Assembly,"Assembly Rules Committee: Favorable",27,0,0,4,31
2028695,1580086,2025-05-28,Assembly,"Assembly Corporations, Authorities And Commissions Committee: Favorable refer to committee Codes",18,7,0,1,26
2028698,1580283,2025-05-28,Assembly,"Assembly Codes Committee: Favorable refer to committee Ways and Means",15,6,0,1,22
2028703,1587375,2025-06-10,Assembly,"Assembly Ways And Means Committee: Favorable refer to committee Rules",32,0,0,3,35
2028703,1588529,2025-06-11,Assembly,"Assembly Rules Committee: Favorable",28,0,0,3,31
2028703,1589472,2025-06-11,Assembly,"Assembly Floor Vote - Final Passage",146,0,0,4,150
2028703,1589473,2025-06-11,Senate,"Senate Floor Vote - Final Passage",58,1,0,4,63
2028709,1574466,2025-05-20,Assembly,"Assembly Racing And Wagering Committee: Favorable refer to committee Ways and Means",10,0,0,1,11
2028713,1593585,2025-06-16,Assembly,"Assembly Rules Committee: Favorable",29,0,0,2,31
2028713,1593586,2025-06-16,Assembly,"Assembly Ways And Means Committee: Favorable refer to committee Rules",32,0,0,3,35
2028714,1591592,2025-06-17,Assembly,"Assembly Rules Committee: Favorable",30,0,0,1,31
2028714,1591593,2025-06-17,Assembly,"Assembly Ways And Means Committee: Favorable refer to committee Rules",32,0,0,3,35
2028725,1574496,2025-05-20,Assembly,"Assembly Real Property Taxation Committee: Favorable refer to committee Ways and Means",10,0,0,0,10
2028725,1579415,2025-05-27,Assembly,"Assembly Ways And Means Committee: Favorable refer to committee Rules",32,0,0,3,35
2028725,1585194,2025-06-04,Assembly,"Assembly Rules Committee: Favorable",28,0,0,3,31
2028725,1585375,2025-06-04,Assembly,"Assembly Floor Vote - Final Passage",144,0,0,6,150
2028725,1590328,2025-06-13,Senate,"Senate Floor Vote - Final Passage",57,2,0,4,63
2028728,1589853,2025-06-12,Assembly,"Assembly Ways And Means Committee: Favorable refer to committee Rules",34,0,0,1,35
2028728,1591951,2025-06-17,Assembly,"Assembly Rules Committee: Favorable",28,0,0,3,31
2028742,1580190,2025-05-28,Assembly,"Assembly Labor Committee: Favorable refer to committee Codes",28,1,0,0,29
2028815,1565505,2025-05-06,Senate,"Senate Floor Vote - Final Passage",57,4,0,1,62
2028815,1566005,2025-05-06,Senate,"Senate Rules Committee Vote",19,1,0,1,21
2028815,1569348,2025-05-06,Assembly,"Assembly Floor Vote - Final Passage",148,0,0,2,150
2028823,1565805,2025-05-06,Assembly,"Assembly Rules Committee: Favorable",29,0,0,2,31
2028823,1565806,2025-05-06,Assembly,"Assembly Ways And Means Committee: Favorable refer to committee Rules",32,0,0,3,35
2028863,1589213,2025-06-11,Senate,"Senate Floor Vote - Final Passage",57,2,0,4,63
2028863,1589214,2025-06-11,Senate,"Senate Rules Committee Vote",19,1,0,1,21
2028863,1591184,2025-06-13,Assembly,"Assembly Floor Vote - Final Passage",109,27,0,14,150
2028887,1581791,2025-05-29,Senate,"Senate Children And Families Committee Vote",6,0,0,1,7
2028907,1574509,2025-05-19,Senate,"Senate Housing, Construction And Community Development Committee Vote",10,0,0,1,11
2028907,1590909,2025-06-10,Senate,"Senate Floor Vote - Final Passage",41,17,0,5,63
2028907,1590910,2025-06-10,Senate,"Senate Rules Committee Vote",17,2,0,2,21
2028921,1579519,2025-05-27,Senate,"Senate Disabilities Committee Vote",6,0,0,0,6
2028924,1590394,2025-06-12,Senate,"Senate Floor Vote - Final Passage",59,0,0,4,63
2028924,1595052,2025-06-12,Senate,"Senate Rules Committee Vote",20,0,0,1,21
2028936,1588354,2025-06-09,Senate,"Senate Rules Committee Vote",20,1,0,0,21
2028936,1588355,2025-06-10,Senate,"Senate Floor Vote - Final Passage",58,0,0,5,63
2028936,1592493,2025-06-16,Assembly,"Assembly Floor Vote - Final Passage",144,0,0,6,150
2028942,1589729,2025-05-20,Senate,"Senate Health Committee Vote",13,0,0,1,14
2028942,1590693,2025-06-12,Senate,"Senate Floor Vote - Final Passage",50,9,0,4,63
2028942,1591095,2025-06-13,Assembly,"Assembly Floor Vote - Final Passage",133,0,0,17,150
2028962,1575303,2025-05-20,Senate,"Senate Labor Committee Vote",11,2,0,0,13
2028992,1589307,2025-06-11,Senate,"Senate Floor Vote - Final Passage",59,0,0,4,63
2028992,1589308,2025-06-11,Senate,"Senate Rules Committee Vote",20,0,0,1,21
2028992,1592431,2025-06-16,Assembly,"Assembly Floor Vote - Final Passage",144,0,0,6,150
2029048,1585564,2025-06-05,Assembly,"Assembly Local Governments Committee: Favorable refer to committee Ways and Means",19,0,0,1,20
2029048,1591446,2025-06-16,Assembly,"Assembly Ways And Means Committee: Favorable refer to committee Rules",32,0,0,3,35
2029048,1591964,2025-06-17,Assembly,"Assembly Rules Committee: Favorable",28,0,0,3,31
2029534,1573873,2025-05-20,Assembly,"Assembly Children And Families Committee: Favorable refer to committee Codes",16,0,0,1,17
2029534,1580104,2025-05-28,Assembly,"Assembly Codes Committee: Favorable refer to committee Ways and Means",21,0,0,1,22
2029534,1589764,2025-06-12,Assembly,"Assembly Ways And Means Committee: Favorable refer to committee Rules",34,0,0,1,35
2029534,1590662,2025-06-13,Assembly,"Assembly Rules Committee: Favorable",29,0,0,2,31
2029579,1579417,2025-05-27,Assembly,"Assembly Ways And Means Committee: Favorable refer to committee Rules",27,5,0,3,35
2029579,1581555,2025-05-29,Assembly,"Assembly Rules Committee: Favorable",26,1,0,4,31
2029579,1582118,2025-05-29,Assembly,"Assembly Floor Vote - Final Passage",95,49,0,6,150
2029623,1570320,2025-05-13,Assembly,"Assembly Local Governments Committee: Favorable refer to committee Ways and Means",18,0,0,2,20
2029623,1579341,2025-05-27,Assembly,"Assembly Ways And Means Committee: Favorable refer to committee Rules",32,0,0,3,35
2029623,1581488,2025-05-29,Assembly,"Assembly Rules Committee: Favorable",27,0,0,4,31
2029623,1582180,2025-05-29,Assembly,"Assembly Floor Vote - Final Passage",144,0,0,6,150
2029623,1588352,2025-06-10,Senate,"Senate Floor Vote - Final Passage",58,0,0,5,63
2029648,1570284,2025-05-13,Assembly,"Assembly Local Governments Committee: Favorable refer to committee Ways and Means",18,0,0,2,20
2029648,1585193,2025-06-04,Assembly,"Assembly Ways And Means Committee: Favorable refer to committee Rules",33,0,0,2,35
2029648,1586075,2025-06-06,Assembly,"Assembly Rules Committee: Favorable",27,0,0,4,31
2029648,1586585,2025-06-06,Assembly,"Assembly Floor Vote - Final Passage",137,0,0,13,150
2029648,1587075,2025-06-09,Senate,"Senate Floor Vote - Final Passage",62,0,0,1,63
2029696,1570379,2025-05-13,Assembly,"Assembly Local Governments Committee: Favorable refer to committee Ways and Means",18,0,0,2,20
2029696,1585190,2025-06-04,Assembly,"Assembly Ways And Means Committee: Favorable refer to committee Rules",33,0,0,2,35
2029696,1585985,2025-06-06,Assembly,"Assembly Rules Committee: Favorable",27,0,0,4,31
2029696,1586568,2025-06-06,Assembly,"Assembly Floor Vote - Final Passage",137,0,0,13,150
2029696,1587068,2025-06-09,Senate,"Senate Floor Vote - Final Passage",62,0,0,1,63
2029719,1570385,2025-05-13,Assembly,"Assembly Local Governments Committee: Favorable refer to committee Ways and Means",18,0,0,2,20
2029719,1579425,2025-05-27,Assembly,"Assembly Ways And Means Committee: Favorable refer to committee Rules",32,0,0,3,35
2029719,1581491,2025-05-29,Assembly,"Assembly Rules Committee: Favorable",27,0,0,4,31
2029719,1582181,2025-05-29,Assembly,"Assembly Floor Vote - Final Passage",144,0,0,6,150
2029719,1587085,2025-06-09,Senate,"Senate Floor Vote - Final Passage",62,0,0,1,63
2029733,1568781,2025-05-08,Senate,"Senate Floor Vote - Final Passage",46,16,0,0,62
2029733,1569384,2025-05-08,Senate,"Senate Finance Committee Vote",16,6,0,0,22
2029733,1571363,2025-05-13,Assembly,"Assembly Floor Vote - Final Passage",109,36,0,5,150
2029736,1570123,2025-05-13,Assembly,"Assembly Environmental Conservation Committee: Favorable",27,0,0,3,30
2029736,1573997,2025-05-19,Assembly,"Assembly Floor Vote - Final Passage",141,2,0,7,150
2029736,1590040,2025-06-11,Senate,"Senate Floor Vote - Final Passage",59,0,0,4,63
2029754,1568405,2025-05-08,Senate,"Senate Rules Committee Vote",18,3,0,0,21
2029754,1568739,2025-05-08,Senate,"Senate Floor Vote - Final Passage",57,5,0,0,62
2029780,1570490,2025-05-13,Assembly,"Assembly Environmental Conservation Committee: Favorable",27,0,0,3,30
2029780,1573943,2025-05-19,Assembly,"Assembly Floor Vote - Final Passage",141,2,0,7,150
2029780,1584782,2025-06-04,Senate,"Senate Floor Vote - Final Passage",58,0,0,5,63
2029788,1570472,2025-05-13,Assembly,"Assembly Environmental Conservation Committee: Favorable",27,0,0,3,30
2029788,1573991,2025-05-19,Assembly,"Assembly Floor Vote - Final Passage",141,2,0,7,150
2029788,1584760,2025-06-04,Senate,"Senate Floor Vote - Final Passage",58,0,0,5,63
2029808,1570330,2025-05-13,Assembly,"Assembly Rules Committee: Favorable",23,5,0,3,31
2029808,1570331,2025-05-13,Assembly,"Assembly Ways And Means Committee: Favorable refer to committee Rules",24,10,0,1,35
2029850,1590403,2025-06-12,Senate,"Senate Floor Vote - Final Passage",45,14,0,4,63
2029850,1591290,2025-06-13,Assembly,"Assembly Floor Vote - Final Passage",92,44,0,14,150
2029850,1595071,2025-06-12,Senate,"Senate Rules Committee Vote",15,5,0,1,21
2029858,1588361,2025-06-10,Senate,"Senate Floor Vote - Final Passage",58,0,0,5,63
2029858,1588362,2025-06-10,Senate,"Senate Rules Committee Vote",19,0,0,2,21
2029858,1590270,2025-06-12,Assembly,"Assembly Floor Vote - Final Passage",143,0,0,7,150
2029876,1587163,2025-06-09,Senate,"Senate Floor Vote - Final Passage",61,1,0,1,63
2029876,1587164,2025-06-09,Senate,"Senate Rules Committee Vote",21,0,0,0,21
2029876,1591043,2025-06-13,Assembly,"Assembly Floor Vote - Final Passage",133,0,0,17,150
2029881,1588894,2025-06-04,Senate,"Senate Rules Committee Vote",19,1,0,1,21
2029881,1589363,2025-06-11,Senate,"Senate Floor Vote - Final Passage",58,1,0,4,63
2029881,1592501,2025-06-18,Assembly,"Assembly Floor Vote - Final Passage",132,2,0,16,150
2029899,1587109,2025-06-09,Senate,"Senate Floor Vote - Final Passage",61,1,0,1,63
2029899,1587110,2025-06-09,Senate,"Senate Rules Committee Vote",21,0,0,0,21
2029899,1591269,2025-06-13,Assembly,"Assembly Floor Vote - Final Passage",136,0,0,14,150
2029901,1590391,2025-06-12,Senate,"Senate Floor Vote - Final Passage",59,0,0,4,63
2029901,1595049,2025-06-12,Senate,"Senate Rules Committee Vote",20,0,0,1,21
2029921,1589202,2025-05-20,Senate,"Senate Transportation Committee Vote",13,0,0,0,13
2029921,1590097,2025-06-11,Senate,"Senate Floor Vote - Final Passage",59,0,0,4,63
2029970,1590190,2025-06-04,Senate,"Senate Rules Committee Vote",19,1,0,1,21
2029970,1590586,2025-06-12,Senate,"Senate Floor Vote - Final Passage",58,1,0,4,63
2029970,1592526,2025-06-18,Assembly,"Assembly Floor Vote - Final Passage",132,2,0,16,150
2029975,1575400,2025-05-21,Senate,"Senate Mental Health Committee Vote",7,0,0,0,7
2029995,1589660,2025-05-28,Senate,"Senate Consumer Protection Committee Vote",7,0,0,0,7
2029995,1590652,2025-06-12,Senate,"Senate Floor Vote - Final Passage",58,1,0,4,63
2030050,1585532,2025-06-04,Senate,"Senate Rules Committee Vote",16,4,0,1,21
2030050,1588409,2025-06-10,Senate,"Senate Floor Vote - Final Passage",43,15,0,5,63
2030067,1580894,2025-05-28,Senate,"Senate Veterans, Homeland Security And Military Affairs Committee Vote",9,0,0,0,9
2030068,1585311,2025-05-27,Senate,"Senate Corporations, Authorities And Commissions Committee Vote",6,0,0,1,7
2030068,1585312,2025-06-04,Senate,"Senate Floor Vote - Final Passage",57,1,0,5,63
2030082,1587955,2025-06-04,Senate,"Senate Rules Committee Vote",20,0,0,1,21
2030082,1587956,2025-06-10,Senate,"Senate Floor Vote - Final Passage",57,1,0,5,63
2030082,1589839,2025-06-11,Assembly,"Assembly Floor Vote - Final Passage",126,13,0,11,150
2030086,1589281,2025-06-11,Senate,"Senate Floor Vote - Final Passage",59,0,0,4,63
2030086,1589282,2025-06-11,Senate,"Senate Rules Committee Vote",20,0,0,1,21
2030086,1591296,2025-06-13,Assembly,"Assembly Floor Vote - Final Passage",137,0,0,13,150
2030093,1575301,2025-05-20,Senate,"Senate Health Committee Vote",13,0,0,1,14
2030094,1574824,2025-05-20,Senate,"Senate Civil Service And Pensions Committee Vote",7,0,0,0,7
2030094,1581168,2025-05-28,Senate,"Senate Finance Committee Vote",22,0,0,0,22
2030094,1590500,2025-06-12,Senate,"Senate Floor Vote - Final Passage",59,0,0,4,63
2030094,1592344,2025-06-16,Assembly,"Assembly Floor Vote - Final Passage",144,0,0,6,150
2030099,1589275,2025-06-11,Senate,"Senate Floor Vote - Final Passage",59,0,0,4,63
2030099,1589276,2025-06-11,Senate,"Senate Rules Committee Vote",20,0,0,1,21
2030099,1591229,2025-06-13,Assembly,"Assembly Floor Vote - Final Passage",137,0,0,13,150
2030109,1589295,2025-06-11,Senate,"Senate Floor Vote - Final Passage",59,0,0,4,63
2030109,1589296,2025-06-11,Senate,"Senate Rules Committee Vote",20,0,0,1,21
2030109,1591300,2025-06-13,Assembly,"Assembly Floor Vote - Final Passage",133,0,0,17,150
2030110,1585962,2025-06-06,Assembly,"Assembly Ways And Means Committee: Favorable refer to committee Rules",35,0,0,0,35
2030110,1591947,2025-06-17,Assembly,"Assembly Rules Committee: Favorable",28,0,0,3,31
2030117,1586092,2025-06-06,Assembly,"Assembly Ways And Means Committee: Favorable refer to committee Rules",35,0,0,0,35
2030117,1586998,2025-06-09,Assembly,"Assembly Rules Committee: Favorable",25,0,0,6,31
2030117,1587371,2025-06-09,Assembly,"Assembly Floor Vote - Final Passage",144,0,0,6,150
2030117,1588167,2025-06-10,Senate,"Senate Floor Vote - Final Passage",57,1,0,5,63
2030125,1590430,2025-06-12,Senate,"Senate Floor Vote - Final Passage",59,0,0,4,63
2030125,1595069,2025-06-12,Senate,"Senate Rules Committee Vote",20,0,0,1,21
2030126,1579743,2025-05-28,Assembly,"Assembly Transportation Committee: Favorable refer to committee Codes",23,0,0,3,26
2030126,1586822,2025-06-09,Assembly,"Assembly Codes Committee: Favorable refer to committee Rules",20,0,0,2,22
2030126,1589457,2025-06-12,Assembly,"Assembly Rules Committee: Favorable",29,0,0,2,31
2030130,1589798,2025-05-20,Senate,"Senate Judiciary Committee Vote",14,4,0,1,19
2030130,1590560,2025-06-12,Senate,"Senate Floor Vote - Final Passage",38,21,0,4,63
2030134,1589293,2025-06-11,Senate,"Senate Floor Vote - Final Passage",59,0,0,4,63
2030134,1589294,2025-06-11,Senate,"Senate Rules Committee Vote",20,0,0,1,21
2030134,1592381,2025-06-17,Assembly,"Assembly Floor Vote - Final Passage",141,0,0,9,150
2030379,1590749,2025-06-13,Assembly,"Assembly Rules Committee: Favorable",29,0,0,2,31
2030379,1590750,2025-06-13,Assembly,"Assembly Ways And Means Committee: Favorable refer to committee Rules",32,0,0,3,35
2030407,1589320,2025-06-11,Senate,"Senate Floor Vote - Final Passage",59,0,0,4,63
2030407,1589321,2025-06-11,Senate,"Senate Rules Committee Vote",19,1,0,1,21
2030407,1591328,2025-06-13,Assembly,"Assembly Floor Vote - Final Passage",122,11,0,17,150
2030422,1590119,2025-06-12,Senate,"Senate Rules Committee Vote",19,1,0,1,21
2030422,1590852,2025-06-13,Senate,"Senate Floor Vote - Final Passage",56,3,0,4,63
2030442,1574663,2025-05-20,Assembly,"Assembly Judiciary Committee: Favorable refer to committee Rules",20,0,0,1,21
2030442,1579351,2025-05-27,Assembly,"Assembly Rules Committee: Favorable",26,0,0,5,31
2030442,1579529,2025-05-27,Assembly,"Assembly Floor Vote - Final Passage",145,0,0,5,150
2030442,1587893,2025-06-10,Senate,"Senate Floor Vote - Final Passage",58,0,0,5,63
2030449,1581055,2025-05-29,Assembly,"Assembly Science And Technology Committee: Favorable refer to committee Rules",8,1,0,0,9
2030449,1584896,2025-06-04,Assembly,"Assembly Rules Committee: Favorable",28,0,0,3,31
2030466,1574700,2025-05-20,Assembly,"Assembly Judiciary Committee: Favorable refer to committee Rules",20,0,0,1,21
2030466,1574942,2025-05-21,Assembly,"Assembly Rules Committee: Favorable",20,9,0,2,31
2030466,1585688,2025-06-04,Assembly,"Assembly Floor Vote - Final Passage",97,47,0,6,150
2030466,1587978,2025-06-10,Senate,"Senate Floor Vote - Final Passage",45,13,0,5,63
2030486,1583772,2025-05-28,Senate,"Senate Health Committee Vote",13,0,0,2,15
2030500,1574664,2025-05-20,Assembly,"Assembly Judiciary Committee: Favorable refer to committee Ways and Means",20,0,0,1,21
2030500,1591444,2025-06-16,Assembly,"Assembly Ways And Means Committee: Favorable refer to committee Rules",32,0,0,3,35
2030500,1591606,2025-06-17,Assembly,"Assembly Rules Committee: Favorable",30,0,0,1,31
2030510,1591426,2025-06-16,Assembly,"Assembly Rules Committee: Favorable",29,0,0,2,31
2030510,1591427,2025-06-16,Assembly,"Assembly Ways And Means Committee: Favorable refer to committee Rules",32,0,0,3,35
2030515,1574688,2025-05-20,Assembly,"Assembly Judiciary Committee: Favorable refer to committee Codes",20,0,0,1,21
2030515,1585779,2025-06-05,Assembly,"Assembly Codes Committee: Favorable refer to committee Rules",21,0,0,1,22
2030518,1574653,2025-05-20,Assembly,"Assembly Judiciary Committee: Favorable refer to committee Rules",20,0,0,1,21
2030518,1585159,2025-06-04,Assembly,"Assembly Rules Committee: Favorable",28,0,0,3,31
2030518,1585381,2025-06-04,Assembly,"Assembly Floor Vote - Final Passage",144,0,0,6,150
2030518,1589035,2025-06-11,Senate,"Senate Floor Vote - Final Passage",50,9,0,4,63
2030529,1574650,2025-05-20,Assembly,"Assembly Judiciary Committee: Favorable refer to committee Rules",20,0,0,1,21
2030529,1588478,2025-06-11,Assembly,"Assembly Rules Committee: Favorable",28,0,0,3,31
2030529,1589379,2025-06-11,Assembly,"Assembly Floor Vote - Final Passage",146,0,0,4,150
2030546,1593670,2025-06-16,Assembly,"Assembly Rules Committee: Favorable",29,0,0,2,31
2030546,1593671,2025-06-16,Assembly,"Assembly Ways And Means Committee: Favorable refer to committee Rules",32,0,0,3,35
2030594,1580898,2025-05-28,Senate,"Senate Budget And Revenue Committee Vote",5,2,0,0,7
2030606,1581155,2025-05-28,Senate,"Senate Budget And Revenue Committee Vote",6,1,0,0,7
2030619,1590405,2025-06-12,Senate,"Senate Floor Vote - Final Passage",38,21,0,4,63
2030619,1594882,2025-06-12,Senate,"Senate Rules Committee Vote",15,5,0,1,21
2030633,1581356,2025-05-28,Senate,"Senate Budget And Revenue Committee Vote",6,1,0,0,7
2030674,1593611,2025-06-16,Assembly,"Assembly Rules Committee: Favorable",29,0,0,2,31
2030674,1593612,2025-06-16,Assembly,"Assembly Ways And Means Committee: Favorable refer to committee Rules",30,2,0,3,35
2030678,1589877,2025-06-12,Assembly,"Assembly Ways And Means Committee: Favorable refer to committee Rules",34,0,0,1,35
2030678,1590792,2025-06-13,Assembly,"Assembly Rules Committee: Favorable",29,0,0,2,31
2030691,1585723,2025-06-05,Assembly,"Assembly Governmental Operations Committee: Favorable refer to committee Ways and Means",13,0,0,1,14
2030691,1588484,2025-06-11,Assembly,"Assembly Ways And Means Committee: Favorable refer to committee Rules",34,0,0,1,35
2030691,1593697,2025-06-16,Assembly,"Assembly Rules Committee: Favorable",29,0,0,2,31
2030702,1590739,2025-06-13,Assembly,"Assembly Rules Committee: Favorable",29,0,0,2,31
2030702,1590740,2025-06-13,Assembly,"Assembly Ways And Means Committee: Favorable refer to committee Rules",27,5,0,3,35
2030709,1593628,2025-06-16,Assembly,"Assembly Rules Committee: Favorable",29,0,0,2,31
2030709,1593629,2025-06-16,Assembly,"Assembly Ways And Means Committee: Favorable refer to committee Rules",32,0,0,3,35
2030717,1581183,2025-05-28,Senate,"Senate Budget And Revenue Committee Vote",6,1,0,0,7
2030733,1586680,2025-06-09,Assembly,"Assembly Ways And Means Committee: Favorable refer to committee Rules",25,6,0,4,35
2030733,1587314,2025-06-10,Assembly,"Assembly Rules Committee: Favorable",28,0,0,3,31
2030733,1588572,2025-06-10,Assembly,"Assembly Floor Vote - Final Passage",136,11,0,3,150
2030733,1589180,2025-06-11,Senate,"Senate Floor Vote - Final Passage",59,0,0,4,63
2030767,1588521,2025-06-11,Assembly,"Assembly Ways And Means Committee: Favorable refer to committee Rules",28,6,0,1,35
2030767,1590053,2025-06-12,Assembly,"Assembly Rules Committee: Favorable",29,0,0,2,31
2030788,1590810,2025-06-13,Assembly,"Assembly Rules Committee: Favorable",29,0,0,2,31
2030788,1590811,2025-06-13,Assembly,"Assembly Ways And Means Committee: Favorable refer to committee Rules",27,5,0,3,35
2030806,1575022,2025-05-20,Senate,"Senate Judiciary Committee Vote",16,2,0,1,19
2030806,1587039,2025-06-09,Senate,"Senate Floor Vote - Final Passage",40,22,0,1,63
2030806,1587040,2025-06-09,Senate,"Senate Rules Committee Vote",15,6,0,0,21
2030806,1588646,2025-06-10,Assembly,"Assembly Floor Vote - Final Passage",95,51,0,4,150
2030807,1579346,2025-05-27,Assembly,"Assembly Ways And Means Committee: Favorable refer to committee Rules",32,0,0,3,35
2030807,1581545,2025-05-29,Assembly,"Assembly Rules Committee: Favorable",27,0,0,4,31
2030812,1590753,2025-06-13,Assembly,"Assembly Rules Committee: Favorable",29,0,0,2,31
2030812,1590754,2025-06-13,Assembly,"Assembly Ways And Means Committee: Favorable refer to committee Rules",32,0,0,3,35
2030812,1591218,2025-06-13,Assembly,"Assembly Floor Vote - Final Passage",133,0,0,17,150
2030815,1589234,2025-06-11,Senate,"Senate Floor Vote - Final Passage",56,3,0,4,63
2030815,1589235,2025-06-11,Senate,"Senate Rules Committee Vote",20,0,0,1,21
2030819,1574058,2025-05-20,Assembly,"Assembly Real Property Taxation Committee: Favorable refer to committee Ways and Means",7,3,0,0,10
2030819,1578955,2025-05-27,Assembly,"Assembly Ways And Means Committee: Favorable refer to committee Rules",22,10,0,3,35
2030819,1585914,2025-06-06,Assembly,"Assembly Rules Committee: Favorable",19,8,0,4,31
2030820,1579141,2025-05-27,Assembly,"Assembly Real Property Taxation Committee: Favorable refer to committee Ways and Means",9,0,0,1,10
2030820,1586042,2025-06-06,Assembly,"Assembly Ways And Means Committee: Favorable refer to committee Rules",35,0,0,0,35
2030820,1586994,2025-06-09,Assembly,"Assembly Rules Committee: Favorable",25,0,0,6,31
2030820,1587367,2025-06-09,Assembly,"Assembly Floor Vote - Final Passage",144,0,0,6,150
2030820,1588160,2025-06-10,Senate,"Senate Floor Vote - Final Passage",57,1,0,5,63
2030827,1580441,2025-05-28,Assembly,"Assembly Governmental Employees Committee: Favorable refer to committee Ways and Means",14,0,0,0,14
2030829,1588560,2025-06-11,Assembly,"Assembly Ways And Means Committee: Favorable refer to committee Rules",28,6,0,1,35
2030829,1590048,2025-06-12,Assembly,"Assembly Rules Committee: Favorable",29,0,0,2,31
2030835,1581483,2025-05-28,Senate,"Senate Budget And Revenue Committee Vote",4,3,0,0,7
2030841,1585495,2025-06-05,Assembly,"Assembly Governmental Operations Committee: Favorable refer to committee Rules",13,0,0,1,14
2030841,1590038,2025-06-12,Assembly,"Assembly Rules Committee: Favorable",29,0,0,2,31
2030844,1580075,2025-05-28,Assembly,"Assembly Corporations, Authorities And Commissions Committee: Favorable refer to committee Ways and Means",25,0,0,1,26
2030844,1585947,2025-06-06,Assembly,"Assembly Ways And Means Committee: Favorable refer to committee Rules",35,0,0,0,35
2030844,1586794,2025-06-09,Assembly,"Assembly Rules Committee: Favorable",25,0,0,6,31
2030844,1587805,2025-06-09,Assembly,"Assembly Floor Vote - Final Passage",144,0,0,6,150
2030844,1590507,2025-06-12,Senate,"Senate Floor Vote - Final Passage",59,0,0,4,63
2030848,1590158,2025-06-04,Senate,"Senate Rules Committee Vote",19,1,0,1,21
2030848,1590467,2025-06-12,Senate,"Senate Floor Vote - Final Passage",58,1,0,4,63
2030848,1592291,2025-06-16,Assembly,"Assembly Floor Vote - Final Passage",144,0,0,6,150
2030850,1574500,2025-05-20,Assembly,"Assembly Environmental Conservation Committee: Favorable refer to committee Codes",30,0,0,0,30
2030850,1579954,2025-05-28,Assembly,"Assembly Codes Committee: Favorable refer to committee Rules",19,2,0,1,22
2030850,1591584,2025-06-17,Assembly,"Assembly Rules Committee: Favorable",30,0,0,1,31
2030858,1573461,2025-05-19,Assembly,"Assembly Health Committee: Favorable refer to committee Ways and Means",24,0,0,2,26
2030858,1586073,2025-06-06,Assembly,"Assembly Ways And Means Committee: Favorable refer to committee Rules",35,0,0,0,35
2030858,1590812,2025-06-13,Assembly,"Assembly Rules Committee: Favorable",29,0,0,2,31
2030861,1579350,2025-05-27,Assembly,"Assembly Ways And Means Committee: Favorable refer to committee Rules",27,5,0,3,35
2030861,1581567,2025-05-29,Assembly,"Assembly Rules Committee: Favorable",26,1,0,4,31
2030861,1582147,2025-05-29,Assembly,"Assembly Floor Vote - Final Passage",97,47,0,6,150
2030861,1590526,2025-06-12,Senate,"Senate Floor Vote - Final Passage",45,14,0,4,63
2030873,1585589,2025-06-05,Assembly,"Assembly Local Governments Committee: Favorable refer to committee Ways and Means",19,0,0,1,20
2030873,1588472,2025-06-11,Assembly,"Assembly Ways And Means Committee: Favorable refer to committee Rules",34,0,0,1,35
2030873,1591978,2025-06-17,Assembly,"Assembly Rules Committee: Favorable",28,0,0,3,31
2030881,1593599,2025-06-16,Assembly,"Assembly Rules Committee: Favorable",29,0,0,2,31
2030881,1593600,2025-06-16,Assembly,"Assembly Ways And Means Committee: Favorable refer to committee Rules",32,0,0,3,35
2030882,1589277,2025-06-11,Senate,"Senate Floor Vote - Final Passage",59,0,0,4,63
2030882,1589278,2025-06-11,Senate,"Senate Rules Committee Vote",20,0,0,1,21
2030882,1591291,2025-06-13,Assembly,"Assembly Floor Vote - Final Passage",133,0,0,17,150
2030883,1584671,2025-06-04,Assembly,"Assembly Transportation Committee: Favorable refer to committee Codes",22,0,0,4,26
2030883,1586879,2025-06-09,Assembly,"Assembly Codes Committee: Favorable refer to committee Ways and Means",16,4,0,2,22
2030883,1588512,2025-06-11,Assembly,"Assembly Ways And Means Committee: Favorable refer to committee Rules",29,5,0,1,35
2030883,1589979,2025-06-12,Assembly,"Assembly Rules Committee: Favorable",20,9,0,2,31
2030945,1593579,2025-06-16,Assembly,"Assembly Rules Committee: Favorable",29,0,0,2,31
2030945,1593580,2025-06-16,Assembly,"Assembly Ways And Means Committee: Favorable refer to committee Rules",32,0,0,3,35
2030948,1580133,2025-05-28,Senate,"Senate Commerce, Economic Development And Small Business Committee Vote",9,0,0,0,9
2030956,1579745,2025-05-28,Assembly,"Assembly Transportation Committee: Favorable refer to committee Rules",23,0,0,3,26
2030956,1581562,2025-05-29,Assembly,"Assembly Rules Committee: Favorable",27,0,0,4,31
2030956,1582170,2025-05-29,Assembly,"Assembly Floor Vote - Final Passage",143,0,0,7,150
2030973,1574655,2025-05-20,Assembly,"Assembly Judiciary Committee: Favorable refer to committee Rules",20,0,0,1,21
2030973,1575163,2025-05-21,Assembly,"Assembly Rules Committee: Favorable",29,0,0,2,31
2030973,1576052,2025-05-21,Assembly,"Assembly Floor Vote - Final Passage",143,0,0,7,150
2030973,1588417,2025-06-10,Senate,"Senate Floor Vote - Final Passage",58,0,0,5,63
2031108,1589694,2025-05-29,Senate,"Senate Energy And Telecommunications Committee Vote",6,3,0,0,9
2031108,1590515,2025-06-12,Senate,"Senate Floor Vote - Final Passage",41,18,0,4,63
2031198,1580084,2025-05-28,Senate,"Senate Insurance Committee Vote",11,0,0,0,11
2031238,1588241,2025-06-04,Senate,"Senate Rules Committee Vote",20,0,0,1,21
2031238,1588242,2025-06-10,Senate,"Senate Floor Vote - Final Passage",57,1,0,5,63
2031249,1588320,2025-06-10,Senate,"Senate Floor Vote - Final Passage",57,1,0,5,63
2031249,1588321,2025-06-10,Senate,"Senate Rules Committee Vote",19,0,0,2,21
2031249,1591298,2025-06-13,Assembly,"Assembly Floor Vote - Final Passage",136,0,0,14,150
2031261,1590402,2025-06-12,Senate,"Senate Floor Vote - Final Passage",59,0,0,4,63
2031261,1591266,2025-06-13,Assembly,"Assembly Floor Vote - Final Passage",136,0,0,14,150
2031261,1594988,2025-06-12,Senate,"Senate Rules Committee Vote",20,0,0,1,21
2031267,1586071,2025-06-06,Assembly,"Assembly Ways And Means Committee: Favorable refer to committee Rules",35,0,0,0,35
2031267,1586963,2025-06-09,Assembly,"Assembly Rules Committee: Favorable",25,0,0,6,31
2031273,1574100,2025-05-20,Assembly,"Assembly Economic Development Committee: Favorable refer to committee Rules",23,0,0,3,26
2031273,1574945,2025-05-21,Assembly,"Assembly Rules Committee: Favorable",29,0,0,2,31
2031273,1575741,2025-05-21,Assembly,"Assembly Floor Vote - Final Passage",143,0,0,7,150
2031273,1590530,2025-06-12,Senate,"Senate Floor Vote - Final Passage",59,0,0,4,63
2031288,1574404,2025-05-20,Assembly,"Assembly Insurance Committee: Favorable refer to committee Rules",24,1,0,0,25
2031288,1574947,2025-05-21,Assembly,"Assembly Rules Committee: Favorable",29,0,0,2,31
2031288,1575738,2025-05-21,Assembly,"Assembly Floor Vote - Final Passage",143,0,0,7,150
2031288,1588408,2025-06-10,Senate,"Senate Floor Vote - Final Passage",57,1,0,5,63
2031310,1574512,2025-05-20,Assembly,"Assembly Energy Committee: Favorable refer to committee Rules",16,0,0,1,17
2031310,1575310,2025-05-21,Assembly,"Assembly Rules Committee: Favorable",29,0,0,2,31
2031310,1576032,2025-05-21,Assembly,"Assembly Floor Vote - Final Passage",143,0,0,7,150
2031337,1573380,2025-05-19,Assembly,"Assembly Banks Committee: Favorable refer to committee Rules",27,0,0,4,31
2031337,1575327,2025-05-21,Assembly,"Assembly Rules Committee: Favorable",29,0,0,2,31
2031337,1575737,2025-05-21,Assembly,"Assembly Floor Vote - Final Passage",143,0,0,7,150
2031337,1588002,2025-06-10,Senate,"Senate Floor Vote - Final Passage",56,2,0,5,63
2031355,1574560,2025-05-20,Assembly,"Assembly Energy Committee: Favorable refer to committee Rules",16,0,0,1,17
2031362,1585632,2025-05-27,Senate,"Senate Labor Committee Vote",13,0,0,0,13
2031362,1585633,2025-06-05,Senate,"Senate Floor Vote - Final Passage",56,4,0,3,63
2031362,1590277,2025-06-12,Senate,"Senate Floor Vote - Final Passage",57,2,0,4,63
2031362,1592627,2025-06-16,Assembly,"Assembly Floor Vote - Final Passage",144,0,0,6,150
2031363,1590176,2025-06-12,Senate,"Senate Rules Committee Vote",20,0,0,1,21
2031363,1590549,2025-06-13,Senate,"Senate Floor Vote - Final Passage",59,0,0,4,63
2031363,1591210,2025-06-13,Assembly,"Assembly Floor Vote - Final Passage",133,0,0,17,150
2031409,1589949,2025-05-20,Senate,"Senate Transportation Committee Vote",13,0,0,0,13
2031409,1590484,2025-06-12,Senate,"Senate Floor Vote - Final Passage",58,1,0,4,63
2031456,1588831,2025-06-09,Senate,"Senate Rules Committee Vote",21,0,0,0,21
2031456,1589347,2025-06-11,Senate,"Senate Floor Vote - Final Passage",42,17,0,4,63
2031456,1591054,2025-06-13,Assembly,"Assembly Floor Vote - Final Passage",132,1,0,17,150
2031457,1590064,2025-05-28,Senate,"Senate Elections Committee Vote",7,0,0,0,7
2031457,1590268,2025-06-12,Senate,"Senate Floor Vote - Final Passage",59,0,0,4,63
2031465,1585502,2025-05-29,Senate,"Senate Rules Committee Vote",19,1,0,1,21
2031465,1585883,2025-06-05,Senate,"Senate Floor Vote - Final Passage",60,0,0,3,63
2031465,1592469,2025-06-18,Assembly,"Assembly Floor Vote - Final Passage",133,1,0,16,150
2031470,1574176,2025-05-20,Assembly,"Assembly Cities Committee: Favorable refer to committee Ways and Means",14,0,0,2,16
2031470,1579403,2025-05-27,Assembly,"Assembly Ways And Means Committee: Favorable refer to committee Rules",26,6,0,3,35
2031470,1581509,2025-05-29,Assembly,"Assembly Rules Committee: Favorable",25,2,0,4,31
2031470,1582165,2025-05-29,Assembly,"Assembly Floor Vote - Final Passage",134,9,0,7,150
2031470,1587207,2025-06-09,Senate,"Senate Floor Vote - Final Passage",62,0,0,1,63
2031485,1586129,2025-05-27,Senate,"Senate Civil Service And Pensions Committee Vote",6,0,0,1,7
2031496,1587217,2025-05-27,Senate,"Senate Civil Service And Pensions Committee Vote",6,0,0,1,7
2031505,1581453,2025-05-27,Senate,"Senate Civil Service And Pensions Committee Vote",6,0,0,1,7
2031512,1587140,2025-06-09,Senate,"Senate Floor Vote - Final Passage",60,2,0,1,63
2031512,1587141,2025-06-09,Senate,"Senate Rules Committee Vote",21,0,0,0,21
2031517,1579023,2025-05-27,Senate,"Senate Civil Service And Pensions Committee Vote",6,0,0,1,7
2031518,1587082,2025-05-27,Senate,"Senate Internet And Technology Committee Vote",5,2,0,0,7
2031518,1587083,2025-06-09,Senate,"Senate Floor Vote - Final Passage",45,17,0,1,63
2031533,1590441,2025-06-12,Senate,"Senate Floor Vote - Final Passage",59,0,0,4,63
2031533,1591211,2025-06-13,Assembly,"Assembly Floor Vote - Final Passage",123,10,0,17,150
2031533,1595004,2025-06-12,Senate,"Senate Rules Committee Vote",20,0,0,1,21
2031560,1573941,2025-05-20,Assembly,"Assembly Agriculture Committee: Favorable refer to committee Codes",23,0,0,0,23
2031560,1585549,2025-06-05,Assembly,"Assembly Codes Committee: Favorable refer to committee Rules",21,0,0,1,22
2031560,1588005,2025-06-10,Assembly,"Assembly Rules Committee: Favorable",28,0,0,3,31
2031560,1588896,2025-06-10,Assembly,"Assembly Floor Vote - Final Passage",147,0,0,3,150
2031560,1590375,2025-06-12,Senate,"Senate Floor Vote - Final Passage",58,1,0,4,63
2031598,1590170,2025-06-12,Senate,"Senate Rules Committee Vote",20,0,0,1,21
2031598,1590510,2025-06-13,Senate,"Senate Floor Vote - Final Passage",59,0,0,4,63
2031598,1592473,2025-06-18,Assembly,"Assembly Floor Vote - Final Passage",134,0,0,16,150
2031642,1579790,2025-05-28,Senate,"Senate Education Committee Vote",15,0,0,0,15
2031643,1574155,2025-05-20,Assembly,"Assembly Agriculture Committee: Favorable refer to committee Ways and Means",23,0,0,0,23
2031643,1585217,2025-06-04,Assembly,"Assembly Ways And Means Committee: Favorable refer to committee Rules",33,0,0,2,35
2031643,1586019,2025-06-06,Assembly,"Assembly Rules Committee: Favorable",27,0,0,4,31
2031643,1586661,2025-06-06,Assembly,"Assembly Floor Vote - Final Passage",137,0,0,13,150
2031643,1588261,2025-06-10,Senate,"Senate Floor Vote - Final Passage",58,0,0,5,63
2031696,1588195,2025-06-10,Senate,"Senate Floor Vote - Final Passage",43,15,0,5,63
2031696,1588196,2025-06-10,Senate,"Senate Rules Committee Vote",17,2,0,2,21
2031696,1592221,2025-06-16,Assembly,"Assembly Floor Vote - Final Passage",88,56,0,6,150
2031723,1573210,2025-05-19,Assembly,"Assembly Governmental Employees Committee: Favorable refer to committee Ways and Means",13,0,0,1,14
2031723,1579370,2025-05-27,Assembly,"Assembly Ways And Means Committee: Favorable refer to committee Rules",32,0,0,3,35
2031723,1581553,2025-05-29,Assembly,"Assembly Rules Committee: Favorable",27,0,0,4,31
2031723,1582154,2025-05-29,Assembly,"Assembly Floor Vote - Final Passage",143,0,0,7,150
2031723,1589825,2025-06-11,Senate,"Senate Floor Vote - Final Passage",59,0,0,4,63
2031724,1574146,2025-05-20,Assembly,"Assembly Economic Development Committee: Favorable refer to committee Ways and Means",23,0,0,3,26
2031724,1575805,2025-05-22,Assembly,"Assembly Ways And Means Committee: Favorable refer to committee Rules",28,3,0,4,35
2031724,1585960,2025-06-06,Assembly,"Assembly Rules Committee: Favorable",27,0,0,4,31
2031724,1586573,2025-06-06,Assembly,"Assembly Floor Vote - Final Passage",135,2,0,13,150
2031724,1590776,2025-06-12,Senate,"Senate Floor Vote - Final Passage",58,1,0,4,63
2031729,1589932,2025-06-09,Senate,"Senate Rules Committee Vote",19,2,0,0,21
2031729,1590688,2025-06-12,Senate,"Senate Floor Vote - Final Passage",58,1,0,4,63
2031739,1589297,2025-06-11,Senate,"Senate Floor Vote - Final Passage",59,0,0,4,63
2031739,1589298,2025-06-11,Senate,"Senate Rules Committee Vote",19,1,0,1,21
2031739,1591029,2025-06-13,Assembly,"Assembly Floor Vote - Final Passage",122,11,0,17,150
2031769,1574123,2025-05-20,Assembly,"Assembly Environmental Conservation Committee: Favorable refer to committee Rules",30,0,0,0,30
2031769,1575069,2025-05-21,Assembly,"Assembly Rules Committee: Favorable",29,0,0,2,31
2031769,1575739,2025-05-21,Assembly,"Assembly Floor Vote - Final Passage",143,0,0,7,150
2031769,1585152,2025-06-04,Senate,"Senate Floor Vote - Final Passage",58,0,0,5,63
2031774,1588224,2025-05-27,Senate,"Senate Transportation Committee Vote",13,0,0,0,13
2031774,1588225,2025-06-10,Senate,"Senate Floor Vote - Final Passage",57,1,0,5,63
2031779,1587944,2025-05-27,Senate,"Senate Labor Committee Vote",13,0,0,0,13
2031779,1587945,2025-06-10,Senate,"Senate Floor Vote - Final Passage",57,1,0,5,63
2031779,1592358,2025-06-17,Assembly,"Assembly Floor Vote - Final Passage",126,15,0,9,150
2031781,1589366,2025-06-04,Senate,"Senate Rules Committee Vote",18,2,0,1,21
2031781,1589793,2025-06-11,Senate,"Senate Floor Vote - Final Passage",38,21,0,4,63
2031781,1592394,2025-06-17,Assembly,"Assembly Floor Vote - Final Passage",132,3,0,15,150
2031782,1587174,2025-06-09,Senate,"Senate Floor Vote - Final Passage",62,0,0,1,63
2031782,1587175,2025-06-09,Senate,"Senate Rules Committee Vote",21,0,0,0,21
2031782,1591174,2025-06-13,Assembly,"Assembly Floor Vote - Final Passage",133,0,0,17,150
2031784,1590450,2025-06-12,Senate,"Senate Floor Vote - Final Passage",59,0,0,4,63
2031784,1591216,2025-06-13,Assembly,"Assembly Floor Vote - Final Passage",133,0,0,17,150
2031784,1594890,2025-06-12,Senate,"Senate Rules Committee Vote",20,0,0,1,21
2031790,1573947,2025-05-20,Assembly,"Assembly Social Services Committee: Favorable refer to committee Rules",13,3,0,2,18
2031790,1575008,2025-05-21,Assembly,"Assembly Rules Committee: Favorable",29,0,0,2,31
2031790,1587821,2025-06-10,Senate,"Senate Floor Vote - Final Passage",56,2,0,5,63
2031790,1588943,2025-06-10,Assembly,"Assembly Floor Vote - Final Passage",132,13,0,5,150
2031817,1589183,2025-06-04,Senate,"Senate Rules Committee Vote",20,0,0,1,21
2031817,1589500,2025-06-11,Senate,"Senate Floor Vote - Final Passage",59,0,0,4,63
2031820,1579593,2025-05-27,Senate,"Senate Banks Committee Vote",4,2,0,1,7
2031828,1588395,2025-06-09,Senate,"Senate Rules Committee Vote",21,0,0,0,21
2031828,1588396,2025-06-10,Senate,"Senate Floor Vote - Final Passage",55,3,0,5,63
2031836,1589231,2025-06-11,Senate,"Senate Floor Vote - Final Passage",45,14,0,4,63
2031836,1589232,2025-06-11,Senate,"Senate Rules Committee Vote",20,0,0,1,21
2031849,1574186,2025-05-20,Assembly,"Assembly Social Services Committee: Favorable refer to committee Rules",14,2,0,2,18
2031849,1575045,2025-05-21,Assembly,"Assembly Rules Committee: Favorable",29,0,0,2,31
2031849,1576010,2025-05-21,Assembly,"Assembly Floor Vote - Final Passage",143,0,0,7,150
2031849,1586922,2025-06-09,Senate,"Senate Floor Vote - Final Passage",61,1,0,1,63
2031875,1574191,2025-05-20,Assembly,"Assembly Mental Health Committee: Favorable refer to committee Rules",13,0,0,0,13
2031878,1580179,2025-05-27,Senate,"Senate Banks Committee Vote",6,0,0,1,7
2031880,1587102,2025-06-09,Senate,"Senate Floor Vote - Final Passage",62,0,0,1,63
2031880,1587103,2025-06-09,Senate,"Senate Rules Committee Vote",21,0,0,0,21
2031892,1593624,2025-06-16,Assembly,"Assembly Rules Committee: Favorable",29,0,0,2,31
2031892,1593625,2025-06-16,Assembly,"Assembly Ways And Means Committee: Favorable refer to committee Rules",32,0,0,3,35
2031899,1590249,2025-06-12,Senate,"Senate Rules Committee Vote",20,0,0,1,21
2031899,1590730,2025-06-13,Senate,"Senate Floor Vote - Final Passage",59,0,0,4,63
2031899,1591185,2025-06-13,Assembly,"Assembly Floor Vote - Final Passage",136,0,0,14,150
2031905,1590208,2025-06-12,Senate,"Senate Rules Committee Vote",20,0,0,1,21
2031905,1590387,2025-06-13,Senate,"Senate Floor Vote - Final Passage",59,0,0,4,63
2031905,1592278,2025-06-16,Assembly,"Assembly Floor Vote - Final Passage",144,0,0,6,150
2031942,1578889,2025-05-27,Assembly,"Assembly Consumer Affairs And Protection Committee: Favorable refer to committee Codes",10,5,0,1,16
2031942,1591403,2025-06-16,Assembly,"Assembly Rules Committee: Favorable",20,9,0,2,31
2031942,1591404,2025-06-16,Assembly,"Assembly Ways And Means Committee: Favorable refer to committee Rules",22,10,0,3,35
2031943,1589974,2025-05-27,Senate,"Senate Civil Service And Pensions Committee Vote",6,0,0,1,7
2031943,1590240,2025-06-12,Senate,"Senate Rules Committee Vote",16,4,0,1,21
2031943,1590512,2025-06-13,Senate,"Senate Floor Vote - Final Passage",52,7,0,4,63
2031943,1592280,2025-06-16,Assembly,"Assembly Floor Vote - Final Passage",142,2,0,6,150
2031947,1573767,2025-05-19,Assembly,"Assembly Veterans' Affairs Committee: Favorable refer to committee Ways and Means",18,0,0,1,19
2031949,1585526,2025-06-04,Senate,"Senate Rules Committee Vote",20,0,0,1,21
2031949,1585527,2025-06-05,Senate,"Senate Floor Vote - Final Passage",60,0,0,3,63
2031950,1587961,2025-06-10,Senate,"Senate Floor Vote - Final Passage",58,0,0,5,63
2031950,1591183,2025-06-13,Assembly,"Assembly Floor Vote - Final Passage",137,0,0,13,150
2031959,1589799,2025-06-04,Senate,"Senate Rules Committee Vote",20,0,0,1,21
2031959,1590572,2025-06-12,Senate,"Senate Floor Vote - Final Passage",56,3,0,4,63
2031968,1587698,2025-05-28,Senate,"Senate Housing, Construction And Community Development Committee Vote",9,1,0,1,11
2031968,1588284,2025-06-10,Senate,"Senate Floor Vote - Final Passage",38,20,0,5,63
2032020,1574003,2025-05-20,Assembly,"Assembly Labor Committee: Favorable refer to committee Ways and Means",29,0,0,0,29
2032020,1590777,2025-06-13,Assembly,"Assembly Rules Committee: Favorable",29,0,0,2,31
2032020,1590778,2025-06-13,Assembly,"Assembly Ways And Means Committee: Favorable refer to committee Rules",32,0,0,3,35
2032030,1587149,2025-06-09,Senate,"Senate Floor Vote - Final Passage",62,0,0,1,63
2032030,1587150,2025-06-09,Senate,"Senate Rules Committee Vote",21,0,0,0,21
2032067,1590385,2025-06-12,Senate,"Senate Floor Vote - Final Passage",58,1,0,4,63
2032067,1592340,2025-06-16,Assembly,"Assembly Floor Vote - Final Passage",144,0,0,6,150
2032067,1594808,2025-06-12,Senate,"Senate Rules Committee Vote",19,1,0,1,21
2032076,1574510,2025-05-20,Assembly,"Assembly Aging Committee: Favorable refer to committee Ways and Means",27,0,0,3,30
2032076,1585992,2025-06-06,Assembly,"Assembly Ways And Means Committee: Favorable refer to committee Rules",35,0,0,0,35
2032076,1586944,2025-06-09,Assembly,"Assembly Rules Committee: Favorable",25,0,0,6,31
2032076,1587271,2025-06-09,Assembly,"Assembly Floor Vote - Final Passage",144,0,0,6,150
2032089,1590395,2025-06-12,Senate,"Senate Floor Vote - Final Passage",47,12,0,4,63
2032089,1592357,2025-06-17,Assembly,"Assembly Floor Vote - Final Passage",141,0,0,9,150
2032089,1594774,2025-06-12,Senate,"Senate Rules Committee Vote",19,1,0,1,21
2032100,1589327,2025-06-11,Senate,"Senate Floor Vote - Final Passage",59,0,0,4,63
2032100,1589328,2025-06-11,Senate,"Senate Rules Committee Vote",20,0,0,1,21
2032100,1592273,2025-06-16,Assembly,"Assembly Floor Vote - Final Passage",144,0,0,6,150
2032127,1590677,2025-06-13,Assembly,"Assembly Rules Committee: Favorable",20,9,0,2,31
2032127,1590678,2025-06-13,Assembly,"Assembly Ways And Means Committee: Favorable refer to committee Rules",23,9,0,3,35
2032204,1580399,2025-05-28,Assembly,"Assembly Labor Committee: Favorable refer to committee Rules",27,2,0,0,29
2032204,1581045,2025-05-29,Assembly,"Assembly Rules Committee: Favorable",27,0,0,4,31
2032204,1586171,2025-06-05,Assembly,"Assembly Floor Vote - Final Passage",130,15,0,5,150
2032204,1587228,2025-06-09,Senate,"Senate Floor Vote - Final Passage",56,6,0,1,63
2032208,1573152,2025-05-19,Assembly,"Assembly Veterans' Affairs Committee: Favorable refer to committee Ways and Means",18,0,0,1,19
2032209,1593652,2025-06-16,Assembly,"Assembly Rules Committee: Favorable",29,0,0,2,31
2032209,1593653,2025-06-16,Assembly,"Assembly Ways And Means Committee: Favorable refer to committee Rules",32,0,0,3,35
2032212,1586894,2025-06-09,Assembly,"Assembly Ways And Means Committee: Favorable refer to committee Rules",31,0,0,4,35
2032212,1587319,2025-06-10,Assembly,"Assembly Rules Committee: Favorable",28,0,0,3,31
2032234,1589880,2025-06-12,Assembly,"Assembly Ways And Means Committee: Favorable refer to committee Rules",34,0,0,1,35
2032234,1590809,2025-06-13,Assembly,"Assembly Rules Committee: Favorable",29,0,0,2,31
2032236,1591614,2025-06-17,Assembly,"Assembly Rules Committee: Favorable",30,0,0,1,31
2032236,1591615,2025-06-17,Assembly,"Assembly Ways And Means Committee: Favorable refer to committee Rules",32,0,0,3,35
2032238,1586893,2025-06-09,Assembly,"Assembly Codes Committee: Favorable refer to committee Rules",15,5,0,2,22
2032242,1574553,2025-05-20,Assembly,"Assembly Education Committee: Favorable refer to committee Ways and Means",28,0,0,3,31
2032242,1586975,2025-06-09,Assembly,"Assembly Ways And Means Committee: Favorable refer to committee Rules",31,0,0,4,35
2032242,1587943,2025-06-10,Assembly,"Assembly Rules Committee: Favorable",28,0,0,3,31
2032255,1574104,2025-05-20,Assembly,"Assembly Small Business Committee: Favorable refer to committee Ways and Means",17,0,0,0,17
2032255,1585210,2025-06-04,Assembly,"Assembly Ways And Means Committee: Favorable refer to committee Rules",33,0,0,2,35
2032270,1573781,2025-05-19,Assembly,"Assembly Veterans' Affairs Committee: Favorable refer to committee Ways and Means",18,0,0,1,19
2032270,1585160,2025-06-04,Assembly,"Assembly Ways And Means Committee: Favorable refer to committee Rules",33,0,0,2,35
2032270,1585948,2025-06-06,Assembly,"Assembly Rules Committee: Favorable",27,0,0,4,31
2032270,1586840,2025-06-06,Assembly,"Assembly Floor Vote - Final Passage",137,0,0,13,150
2032270,1590584,2025-06-13,Senate,"Senate Floor Vote - Final Passage",59,0,0,4,63
2032274,1573777,2025-05-19,Assembly,"Assembly Veterans' Affairs Committee: Favorable refer to committee Codes",18,0,0,1,19
2032274,1590787,2025-06-13,Assembly,"Assembly Rules Committee: Favorable",29,0,0,2,31
2032274,1590788,2025-06-13,Assembly,"Assembly Ways And Means Committee: Favorable refer to committee Rules",32,0,0,3,35
2032298,1589095,2025-05-28,Senate,"Senate Housing, Construction And Community Development Committee Vote",9,1,0,1,11
2032298,1589096,2025-06-11,Senate,"Senate Floor Vote - Final Passage",55,4,0,4,63
2032300,1573741,2025-05-19,Assembly,"Assembly Veterans' Affairs Committee: Favorable refer to committee Rules",18,0,0,1,19
2032300,1586959,2025-06-09,Assembly,"Assembly Rules Committee: Favorable",25,0,0,6,31
2032300,1587335,2025-06-09,Assembly,"Assembly Floor Vote - Final Passage",144,0,0,6,150
2032300,1590286,2025-06-12,Senate,"Senate Floor Vote - Final Passage",59,0,0,4,63
2032301,1574637,2025-05-20,Assembly,"Assembly Higher Education Committee: Favorable refer to committee Rules",23,0,0,3,26
2032301,1585975,2025-06-06,Assembly,"Assembly Rules Committee: Favorable",27,0,0,4,31
2032301,1587430,2025-06-09,Assembly,"Assembly Floor Vote - Final Passage",144,0,0,6,150
2032301,1588200,2025-06-10,Senate,"Senate Floor Vote - Final Passage",58,0,0,5,63
2032303,1574128,2025-05-20,Assembly,"Assembly Labor Committee: Favorable refer to committee Rules",29,0,0,0,29
2032303,1575145,2025-05-21,Assembly,"Assembly Rules Committee: Favorable",29,0,0,2,31
2032303,1580182,2025-05-27,Assembly,"Assembly Floor Vote - Final Passage",126,19,0,5,150
2032304,1574604,2025-05-20,Assembly,"Assembly Higher Education Committee: Favorable refer to committee Rules",23,0,0,3,26
2032304,1575306,2025-05-21,Assembly,"Assembly Rules Committee: Favorable",29,0,0,2,31
2032304,1576308,2025-05-21,Assembly,"Assembly Floor Vote - Final Passage",143,0,0,7,150
2032304,1587069,2025-06-09,Senate,"Senate Floor Vote - Final Passage",62,0,0,1,63
2032305,1574333,2025-05-20,Assembly,"Assembly Higher Education Committee: Favorable refer to committee Rules",23,0,0,3,26
2032305,1574858,2025-05-21,Assembly,"Assembly Rules Committee: Favorable",29,0,0,2,31
2032305,1575758,2025-05-21,Assembly,"Assembly Floor Vote - Final Passage",143,0,0,7,150
2032305,1588294,2025-06-10,Senate,"Senate Floor Vote - Final Passage",58,0,0,5,63
2032306,1574091,2025-05-20,Assembly,"Assembly Labor Committee: Favorable refer to committee Codes",29,0,0,0,29
2032306,1585400,2025-06-05,Assembly,"Assembly Codes Committee: Favorable refer to committee Rules",21,0,0,1,22
2032306,1586033,2025-06-06,Assembly,"Assembly Rules Committee: Favorable",27,0,0,4,31
2032306,1587711,2025-06-09,Assembly,"Assembly Floor Vote - Final Passage",144,0,0,6,150
2032307,1573279,2025-05-19,Assembly,"Assembly Veterans' Affairs Committee: Favorable refer to committee Ways and Means",18,0,0,1,19
2032309,1573780,2025-05-19,Assembly,"Assembly Veterans' Affairs Committee: Favorable refer to committee Ways and Means",18,0,0,1,19
2032311,1581170,2025-05-27,Senate,"Senate Internet And Technology Committee Vote",7,0,0,0,7
2032311,1585500,2025-06-04,Senate,"Senate Rules Committee Vote",20,0,0,1,21
2032311,1587914,2025-06-10,Senate,"Senate Floor Vote - Final Passage",58,0,0,5,63
2032312,1573778,2025-05-19,Assembly,"Assembly Veterans' Affairs Committee: Favorable refer to committee Ways and Means",18,0,0,1,19
2032377,1589322,2025-06-11,Senate,"Senate Floor Vote - Final Passage",59,0,0,4,63
2032377,1589323,2025-06-11,Senate,"Senate Rules Committee Vote",20,0,0,1,21
2032430,1580596,2025-05-28,Assembly,"Assembly Environmental Conservation Committee: Favorable refer to committee Rules",29,0,0,1,30
2032430,1581549,2025-05-29,Assembly,"Assembly Rules Committee: Favorable",27,0,0,4,31
2032430,1582169,2025-05-29,Assembly,"Assembly Floor Vote - Final Passage",141,2,0,7,150
2032430,1584791,2025-06-04,Senate,"Senate Floor Vote - Final Passage",58,0,0,5,63
2032438,1590094,2025-06-04,Senate,"Senate Rules Committee Vote",20,0,0,1,21
2032438,1590303,2025-06-12,Senate,"Senate Floor Vote - Final Passage",59,0,0,4,63
2032438,1592245,2025-06-16,Assembly,"Assembly Floor Vote - Final Passage",137,7,0,6,150
2032456,1582131,2025-05-28,Senate,"Senate Housing, Construction And Community Development Committee Vote",9,1,0,1,11
2032456,1590911,2025-06-10,Senate,"Senate Floor Vote - Final Passage",57,1,0,5,63
2032456,1590912,2025-06-10,Senate,"Senate Rules Committee Vote",19,0,0,2,21
2032480,1586875,2025-05-28,Senate,"Senate Judiciary Committee Vote",17,0,0,2,19
2032480,1587222,2025-06-09,Senate,"Senate Floor Vote - Final Passage",61,1,0,1,63
2032480,1592632,2025-06-16,Assembly,"Assembly Floor Vote - Final Passage",143,1,0,6,150
2032490,1589017,2025-05-28,Senate,"Senate Judiciary Committee Vote",16,1,0,2,19
2032490,1589401,2025-06-11,Senate,"Senate Floor Vote - Final Passage",56,3,0,4,63
2032490,1592483,2025-06-17,Assembly,"Assembly Floor Vote - Final Passage",90,45,0,15,150
2032497,1580615,2025-05-28,Assembly,"Assembly Environmental Conservation Committee: Favorable refer to committee Rules",29,0,0,1,30
2032497,1581566,2025-05-29,Assembly,"Assembly Rules Committee: Favorable",27,0,0,4,31
2032497,1582168,2025-05-29,Assembly,"Assembly Floor Vote - Final Passage",141,2,0,7,150
2032497,1585307,2025-06-04,Senate,"Senate Floor Vote - Final Passage",58,0,0,5,63
2032498,1585447,2025-06-05,Assembly,"Assembly Governmental Employees Committee: Favorable refer to committee Ways and Means",14,0,0,0,14
2032498,1585929,2025-06-06,Assembly,"Assembly Ways And Means Committee: Favorable refer to committee Rules",35,0,0,0,35
2032498,1587002,2025-06-09,Assembly,"Assembly Rules Committee: Favorable",25,0,0,6,31
2032498,1587221,2025-06-09,Assembly,"Assembly Floor Vote - Final Passage",144,0,0,6,150
2032498,1589392,2025-06-11,Senate,"Senate Floor Vote - Final Passage",59,0,0,4,63
2032503,1590142,2025-06-12,Senate,"Senate Rules Committee Vote",20,0,0,1,21
2032503,1590504,2025-06-13,Senate,"Senate Floor Vote - Final Passage",58,1,0,4,63
2032503,1591265,2025-06-13,Assembly,"Assembly Floor Vote - Final Passage",136,0,0,14,150
2032512,1582130,2025-05-28,Senate,"Senate Housing, Construction And Community Development Committee Vote",10,0,0,1,11
2032512,1585522,2025-06-04,Senate,"Senate Rules Committee Vote",20,0,0,1,21
2032512,1590876,2025-06-09,Senate,"Senate Floor Vote - Final Passage",62,0,0,1,63
2032514,1585957,2025-06-06,Assembly,"Assembly Ways And Means Committee: Favorable refer to committee Rules",30,5,0,0,35
2032514,1587021,2025-06-09,Assembly,"Assembly Rules Committee: Favorable",25,0,0,6,31
2032514,1587210,2025-06-09,Assembly,"Assembly Floor Vote - Final Passage",96,47,0,7,150
2032514,1590724,2025-06-12,Senate,"Senate Floor Vote - Final Passage",47,12,0,4,63
2032548,1589592,2025-05-28,Senate,"Senate Judiciary Committee Vote",17,0,0,2,19
2032548,1590597,2025-06-12,Senate,"Senate Floor Vote - Final Passage",59,0,0,4,63
2032548,1592536,2025-06-16,Assembly,"Assembly Floor Vote - Final Passage",144,0,0,6,150
2032551,1581697,2025-05-29,Senate,"Senate Children And Families Committee Vote",6,0,0,1,7
2032551,1590907,2025-06-10,Senate,"Senate Floor Vote - Final Passage",58,0,0,5,63
2032551,1590908,2025-06-10,Senate,"Senate Rules Committee Vote",19,0,0,2,21
2032562,1581272,2025-05-29,Senate,"Senate Children And Families Committee Vote",6,0,0,1,7
2032562,1587050,2025-06-09,Senate,"Senate Rules Committee Vote",20,1,0,0,21
2032562,1589163,2025-06-11,Senate,"Senate Floor Vote - Final Passage",54,5,0,4,63
2032562,1592531,2025-06-17,Assembly,"Assembly Floor Vote - Final Passage",141,1,0,8,150
2032588,1589273,2025-06-11,Senate,"Senate Floor Vote - Final Passage",58,1,0,4,63
2032588,1589274,2025-06-11,Senate,"Senate Rules Committee Vote",20,0,0,1,21
2032588,1592376,2025-06-16,Assembly,"Assembly Floor Vote - Final Passage",144,0,0,6,150
2032620,1588340,2025-06-10,Senate,"Senate Floor Vote - Final Passage",58,0,0,5,63
2032620,1588341,2025-06-10,Senate,"Senate Rules Committee Vote",19,0,0,2,21
2032620,1592085,2025-06-16,Assembly,"Assembly Floor Vote - Final Passage",144,0,0,6,150
2032677,1590796,2025-06-13,Assembly,"Assembly Rules Committee: Favorable",29,0,0,2,31
2032677,1590797,2025-06-13,Assembly,"Assembly Ways And Means Committee: Favorable refer to committee Rules",26,6,0,3,35
2032697,1589855,2025-06-12,Assembly,"Assembly Ways And Means Committee: Favorable refer to committee Rules",34,0,0,1,35
2032697,1591652,2025-06-16,Assembly,"Assembly Rules Committee: Favorable",29,0,0,2,31
2032697,1592325,2025-06-16,Assembly,"Assembly Floor Vote - Final Passage",144,0,0,6,150
2032717,1586882,2025-06-09,Assembly,"Assembly Codes Committee: Favorable refer to committee Rules",18,2,0,2,22
2032728,1588837,2025-06-09,Senate,"Senate Rules Committee Vote",20,1,0,0,21
2032728,1589351,2025-06-11,Senate,"Senate Floor Vote - Final Passage",58,1,0,4,63
2032742,1590804,2025-06-13,Assembly,"Assembly Rules Committee: Favorable",29,0,0,2,31
2032742,1590805,2025-06-13,Assembly,"Assembly Ways And Means Committee: Favorable refer to committee Rules",26,6,0,3,35
2032753,1585470,2025-06-05,Assembly,"Assembly Real Property Taxation Committee: Favorable refer to committee Ways and Means",9,0,0,1,10
2032753,1586055,2025-06-06,Assembly,"Assembly Ways And Means Committee: Favorable refer to committee Rules",35,0,0,0,35
2032753,1593677,2025-06-16,Assembly,"Assembly Rules Committee: Favorable",29,0,0,2,31
2032754,1588517,2025-06-11,Assembly,"Assembly Ways And Means Committee: Favorable refer to committee Rules",33,1,0,1,35
2032754,1590068,2025-06-12,Assembly,"Assembly Rules Committee: Favorable",29,0,0,2,31
2032755,1591619,2025-06-17,Assembly,"Assembly Ways And Means Committee: Favorable refer to committee Rules",32,0,0,3,35
2032755,1591969,2025-06-17,Assembly,"Assembly Rules Committee: Favorable",28,0,0,3,31
2032765,1593616,2025-06-16,Assembly,"Assembly Rules Committee: Favorable",29,0,0,2,31
2032765,1593617,2025-06-16,Assembly,"Assembly Ways And Means Committee: Favorable refer to committee Rules",32,0,0,3,35
2032773,1593620,2025-06-16,Assembly,"Assembly Rules Committee: Favorable",29,0,0,2,31
2032773,1593621,2025-06-16,Assembly,"Assembly Ways And Means Committee: Favorable refer to committee Rules",32,0,0,3,35
2032778,1585861,2025-05-27,Senate,"Senate Banks Committee Vote",6,0,0,1,7
2032778,1585862,2025-06-05,Senate,"Senate Floor Vote - Final Passage",59,1,0,3,63
2032795,1585580,2025-06-05,Assembly,"Assembly Real Property Taxation Committee: Favorable refer to committee Ways and Means",9,0,0,1,10
2032795,1586090,2025-06-06,Assembly,"Assembly Ways And Means Committee: Favorable refer to committee Rules",35,0,0,0,35
2032795,1591563,2025-06-17,Assembly,"Assembly Rules Committee: Favorable",30,0,0,1,31
2032810,1579214,2025-05-27,Assembly,"Assembly Real Property Taxation Committee: Favorable refer to committee Ways and Means",9,0,0,1,10
2032810,1585183,2025-06-04,Assembly,"Assembly Ways And Means Committee: Favorable refer to committee Rules",32,1,0,2,35
2032810,1585923,2025-06-06,Assembly,"Assembly Rules Committee: Favorable",27,0,0,4,31
2032810,1587198,2025-06-09,Senate,"Senate Floor Vote - Final Passage",61,1,0,1,63
2032810,1587769,2025-06-09,Assembly,"Assembly Floor Vote - Final Passage",144,0,0,6,150
2032816,1585578,2025-06-05,Assembly,"Assembly Local Governments Committee: Favorable refer to committee Ways and Means",19,0,0,1,20
2032816,1585951,2025-06-06,Assembly,"Assembly Ways And Means Committee: Favorable refer to committee Rules",35,0,0,0,35
2032816,1586966,2025-06-09,Assembly,"Assembly Rules Committee: Favorable",25,0,0,6,31
2032816,1587224,2025-06-09,Assembly,"Assembly Floor Vote - Final Passage",143,0,0,7,150
2032816,1590577,2025-06-12,Senate,"Senate Floor Vote - Final Passage",58,1,0,4,63
2032823,1590800,2025-06-13,Assembly,"Assembly Rules Committee: Favorable",29,0,0,2,31
2032823,1590801,2025-06-13,Assembly,"Assembly Ways And Means Committee: Favorable refer to committee Rules",32,0,0,3,35
2032835,1580355,2025-05-28,Assembly,"Assembly Corporations, Authorities And Commissions Committee: Favorable refer to committee Ways and Means",25,0,0,1,26
2032843,1580368,2025-05-28,Assembly,"Assembly Housing Committee: Favorable refer to committee Ways and Means",27,0,0,1,28
2032843,1585201,2025-06-04,Assembly,"Assembly Ways And Means Committee: Favorable refer to committee Rules",31,2,0,2,35
2032843,1586016,2025-06-06,Assembly,"Assembly Rules Committee: Favorable",27,0,0,4,31
2032843,1587225,2025-06-09,Assembly,"Assembly Floor Vote - Final Passage",142,2,0,6,150
2032843,1587226,2025-06-09,Senate,"Senate Floor Vote - Final Passage",62,0,0,1,63
2032847,1580277,2025-05-28,Assembly,"Assembly Corporations, Authorities And Commissions Committee: Favorable refer to committee Ways and Means",18,7,0,1,26
2032885,1589309,2025-06-11,Senate,"Senate Floor Vote - Final Passage",59,0,0,4,63
2032885,1589310,2025-06-11,Senate,"Senate Rules Committee Vote",20,0,0,1,21
2032885,1592487,2025-06-16,Assembly,"Assembly Floor Vote - Final Passage",144,0,0,6,150
2032913,1580434,2025-05-28,Assembly,"Assembly Children And Families Committee: Favorable refer to committee Codes",16,0,0,1,17
2032913,1593678,2025-06-16,Assembly,"Assembly Rules Committee: Favorable",29,0,0,2,31
2032913,1593679,2025-06-16,Assembly,"Assembly Ways And Means Committee: Favorable refer to committee Rules",32,0,0,3,35
2032933,1587045,2025-06-09,Senate,"Senate Floor Vote - Final Passage",62,0,0,1,63
2032933,1587046,2025-06-09,Senate,"Senate Rules Committee Vote",21,0,0,0,21
2032933,1589503,2025-06-11,Assembly,"Assembly Floor Vote - Final Passage",146,0,0,4,150
2032996,1579539,2025-05-28,Assembly,"Assembly Housing Committee: Favorable refer to committee Ways and Means",27,0,0,1,28
2032996,1580918,2025-05-29,Assembly,"Assembly Ways And Means Committee: Favorable refer to committee Rules",34,0,0,1,35
2032996,1585185,2025-06-04,Assembly,"Assembly Rules Committee: Favorable",28,0,0,3,31
2032996,1585344,2025-06-04,Assembly,"Assembly Floor Vote - Final Passage",144,0,0,6,150
2032996,1588400,2025-06-10,Senate,"Senate Floor Vote - Final Passage",57,1,0,5,63
2033041,1580054,2025-05-28,Assembly,"Assembly Housing Committee: Favorable refer to committee Ways and Means",27,0,0,1,28
2033075,1580445,2025-05-28,Assembly,"Assembly Local Governments Committee: Favorable refer to committee Rules",20,0,0,0,20
2033075,1581534,2025-05-29,Assembly,"Assembly Rules Committee: Favorable",27,0,0,4,31
2033075,1582172,2025-05-29,Assembly,"Assembly Floor Vote - Final Passage",142,0,0,8,150
2033075,1589198,2025-06-11,Senate,"Senate Floor Vote - Final Passage",58,1,0,4,63
2033077,1580293,2025-05-28,Assembly,"Assembly Labor Committee: Favorable refer to committee Codes",27,2,0,0,29
2033077,1585405,2025-06-05,Assembly,"Assembly Codes Committee: Favorable refer to committee Ways and Means",20,1,0,1,22
2033077,1588555,2025-06-11,Assembly,"Assembly Ways And Means Committee: Favorable refer to committee Rules",33,1,0,1,35
2033077,1590701,2025-06-13,Assembly,"Assembly Rules Committee: Favorable",29,0,0,2,31
2033106,1589288,2025-06-11,Senate,"Senate Floor Vote - Final Passage",59,0,0,4,63
2033106,1589289,2025-06-11,Senate,"Senate Rules Committee Vote",20,0,0,1,21
2033106,1592626,2025-06-16,Assembly,"Assembly Floor Vote - Final Passage",144,0,0,6,150
2033110,1581044,2025-05-29,Assembly,"Assembly Science And Technology Committee: Favorable refer to committee Codes",9,0,0,0,9
2033138,1579181,2025-05-27,Assembly,"Assembly Consumer Affairs And Protection Committee: Favorable refer to committee Codes",15,0,0,1,16
2033138,1587034,2025-06-09,Assembly,"Assembly Codes Committee: Favorable refer to committee Rules",20,0,0,2,22
2033138,1588561,2025-06-11,Assembly,"Assembly Rules Committee: Favorable",19,9,0,3,31
2033149,1590425,2025-06-12,Senate,"Senate Floor Vote - Final Passage",58,1,0,4,63
2033149,1592475,2025-06-16,Assembly,"Assembly Floor Vote - Final Passage",144,0,0,6,150
2033149,1594793,2025-06-12,Senate,"Senate Rules Committee Vote",20,0,0,1,21
2033174,1593698,2025-06-16,Assembly,"Assembly Rules Committee: Favorable",29,0,0,2,31
2033174,1593699,2025-06-16,Assembly,"Assembly Ways And Means Committee: Favorable refer to committee Rules",32,0,0,3,35
2033182,1585567,2025-06-05,Assembly,"Assembly Real Property Taxation Committee: Favorable refer to committee Ways and Means",9,0,0,1,10
2033182,1586081,2025-06-06,Assembly,"Assembly Ways And Means Committee: Favorable refer to committee Rules",35,0,0,0,35
2033182,1586965,2025-06-09,Assembly,"Assembly Rules Committee: Favorable",25,0,0,6,31
2033182,1587216,2025-06-09,Assembly,"Assembly Floor Vote - Final Passage",143,0,0,7,150
2033182,1589405,2025-06-11,Senate,"Senate Floor Vote - Final Passage",57,2,0,4,63
2033192,1593656,2025-06-16,Assembly,"Assembly Rules Committee: Favorable",29,0,0,2,31
2033192,1593657,2025-06-16,Assembly,"Assembly Ways And Means Committee: Favorable refer to committee Rules",32,0,0,3,35
2033194,1591568,2025-06-17,Assembly,"Assembly Ways And Means Committee: Favorable refer to committee Rules",32,0,0,3,35
2033194,1591950,2025-06-17,Assembly,"Assembly Rules Committee: Favorable",28,0,0,3,31
2033211,1585422,2025-06-05,Assembly,"Assembly Local Governments Committee: Favorable refer to committee Ways and Means",19,0,0,1,20
2033211,1586076,2025-06-06,Assembly,"Assembly Ways And Means Committee: Favorable refer to committee Rules",35,0,0,0,35
2033211,1589460,2025-06-12,Assembly,"Assembly Rules Committee: Favorable",29,0,0,2,31
2033220,1578766,2025-05-27,Assembly,"Assembly Economic Development Committee: Favorable refer to committee Ways and Means",24,0,0,2,26
2033220,1585200,2025-06-04,Assembly,"Assembly Ways And Means Committee: Favorable refer to committee Rules",32,1,0,2,35
2033220,1586066,2025-06-06,Assembly,"Assembly Rules Committee: Favorable",27,0,0,4,31
2033220,1587631,2025-06-09,Assembly,"Assembly Floor Vote - Final Passage",141,3,0,6,150
2033220,1590266,2025-06-12,Senate,"Senate Floor Vote - Final Passage",58,1,0,4,63
2033221,1579170,2025-05-27,Assembly,"Assembly Governmental Operations Committee: Favorable refer to committee Ways and Means",14,0,0,0,14
2033221,1585156,2025-06-04,Assembly,"Assembly Ways And Means Committee: Favorable refer to committee Rules",33,0,0,2,35
2033221,1586035,2025-06-06,Assembly,"Assembly Rules Committee: Favorable",27,0,0,4,31
2033221,1587214,2025-06-09,Assembly,"Assembly Floor Vote - Final Passage",144,0,0,6,150
2033221,1589229,2025-06-11,Senate,"Senate Floor Vote - Final Passage",57,2,0,4,63
2033228,1580636,2025-05-28,Assembly,"Assembly Environmental Conservation Committee: Favorable refer to committee Rules",28,1,0,1,30
2033228,1581559,2025-05-29,Assembly,"Assembly Rules Committee: Favorable",27,0,0,4,31
2033228,1582163,2025-05-29,Assembly,"Assembly Floor Vote - Final Passage",137,5,0,8,150
2033228,1587084,2025-06-09,Senate,"Senate Floor Vote - Final Passage",61,1,0,1,63
2033238,1585933,2025-06-06,Assembly,"Assembly Ways And Means Committee: Favorable refer to committee Rules",35,0,0,0,35
2033238,1586995,2025-06-09,Assembly,"Assembly Rules Committee: Favorable",25,0,0,6,31
2033238,1587223,2025-06-09,Assembly,"Assembly Floor Vote - Final Passage",143,0,0,7,150
2033238,1587923,2025-06-10,Senate,"Senate Floor Vote - Final Passage",41,17,0,5,63
2033261,1589834,2025-06-12,Assembly,"Assembly Ways And Means Committee: Favorable refer to committee Rules",32,2,0,1,35
2033261,1590780,2025-06-13,Assembly,"Assembly Rules Committee: Favorable",29,0,0,2,31
2033350,1593575,2025-06-16,Assembly,"Assembly Rules Committee: Favorable",29,0,0,2,31
2033350,1593576,2025-06-16,Assembly,"Assembly Ways And Means Committee: Favorable refer to committee Rules",32,0,0,3,35
2033351,1590568,2025-06-13,Assembly,"Assembly Rules Committee: Favorable",29,0,0,2,31
2033351,1590569,2025-06-13,Assembly,"Assembly Ways And Means Committee: Favorable refer to committee Rules",32,0,0,3,35
2033354,1590807,2025-06-13,Assembly,"Assembly Ways And Means Committee: Favorable refer to committee Rules",32,0,0,3,35
2033354,1591953,2025-06-17,Assembly,"Assembly Rules Committee: Favorable",28,0,0,3,31
2033369,1589872,2025-06-12,Assembly,"Assembly Ways And Means Committee: Favorable refer to committee Rules",34,0,0,1,35
2033369,1593581,2025-06-16,Assembly,"Assembly Rules Committee: Favorable",29,0,0,2,31
2033393,1593642,2025-06-16,Assembly,"Assembly Rules Committee: Favorable",29,0,0,2,31
2033393,1593643,2025-06-16,Assembly,"Assembly Ways And Means Committee: Favorable refer to committee Rules",31,1,0,3,35
2033397,1580381,2025-05-28,Assembly,"Assembly Environmental Conservation Committee: Favorable refer to committee Rules",29,0,0,1,30
2033397,1581501,2025-05-29,Assembly,"Assembly Rules Committee: Favorable",27,0,0,4,31
2033397,1582173,2025-05-29,Assembly,"Assembly Floor Vote - Final Passage",142,0,0,8,150
2033397,1586945,2025-06-09,Senate,"Senate Floor Vote - Final Passage",62,0,0,1,63
2033413,1580624,2025-05-28,Assembly,"Assembly Environmental Conservation Committee: Favorable refer to committee Rules",29,0,0,1,30
2033413,1581481,2025-05-29,Assembly,"Assembly Rules Committee: Favorable",27,0,0,4,31
2033413,1582132,2025-05-29,Assembly,"Assembly Floor Vote - Final Passage",140,2,0,8,150
2033413,1585255,2025-06-04,Senate,"Senate Floor Vote - Final Passage",58,0,0,5,63
2033425,1580396,2025-05-28,Assembly,"Assembly Environmental Conservation Committee: Favorable refer to committee Rules",29,0,0,1,30
2033425,1581527,2025-05-29,Assembly,"Assembly Rules Committee: Favorable",27,0,0,4,31
2033425,1582171,2025-05-29,Assembly,"Assembly Floor Vote - Final Passage",141,1,0,8,150
2033425,1589776,2025-06-11,Senate,"Senate Floor Vote - Final Passage",59,0,0,4,63
2033434,1580032,2025-05-28,Assembly,"Assembly Governmental Employees Committee: Favorable refer to committee Ways and Means",14,0,0,0,14
2033434,1585204,2025-06-04,Assembly,"Assembly Ways And Means Committee: Favorable refer to committee Rules",33,0,0,2,35
2033434,1586049,2025-06-06,Assembly,"Assembly Rules Committee: Favorable",27,0,0,4,31
2033553,1578768,2025-05-27,Assembly,"Assembly Real Property Taxation Committee: Favorable refer to committee Ways and Means",9,0,0,1,10
2033553,1585972,2025-06-06,Assembly,"Assembly Ways And Means Committee: Favorable refer to committee Rules",35,0,0,0,35
2033553,1586964,2025-06-09,Assembly,"Assembly Rules Committee: Favorable",25,0,0,6,31
2033553,1587218,2025-06-09,Assembly,"Assembly Floor Vote - Final Passage",143,0,0,7,150
2033553,1590570,2025-06-12,Senate,"Senate Floor Vote - Final Passage",59,0,0,4,63
2033636,1580610,2025-05-28,Assembly,"Assembly Environmental Conservation Committee: Favorable refer to committee Rules",29,0,0,1,30
2033636,1581564,2025-05-29,Assembly,"Assembly Rules Committee: Favorable",27,0,0,4,31
2033636,1582162,2025-05-29,Assembly,"Assembly Floor Vote - Final Passage",140,2,0,8,150
2033636,1585249,2025-06-04,Senate,"Senate Floor Vote - Final Passage",58,0,0,5,63
2033647,1580625,2025-05-28,Assembly,"Assembly Environmental Conservation Committee: Favorable refer to committee Rules",29,0,0,1,30
2033647,1590043,2025-06-12,Assembly,"Assembly Rules Committee: Favorable",29,0,0,2,31
2033647,1591090,2025-06-13,Assembly,"Assembly Floor Vote - Final Passage",136,0,0,14,150
2033654,1579907,2025-05-28,Assembly,"Assembly Banks Committee: Favorable refer to committee Ways and Means",28,0,0,3,31
2033655,1579722,2025-05-28,Assembly,"Assembly Housing Committee: Favorable refer to committee Ways and Means",25,2,0,1,28
2033655,1586029,2025-06-06,Assembly,"Assembly Ways And Means Committee: Favorable refer to committee Rules",25,10,0,0,35
2033655,1586970,2025-06-09,Assembly,"Assembly Rules Committee: Favorable",23,2,0,6,31
2033660,1579813,2025-05-28,Assembly,"Assembly Higher Education Committee: Favorable refer to committee Rules",24,2,0,0,26
2033664,1590440,2025-06-12,Senate,"Senate Floor Vote - Final Passage",57,2,0,4,63
2033664,1592442,2025-06-17,Assembly,"Assembly Floor Vote - Final Passage",141,0,0,9,150
2033664,1594776,2025-06-12,Senate,"Senate Rules Committee Vote",18,2,0,1,21
2033671,1579761,2025-05-28,Assembly,"Assembly Corporations, Authorities And Commissions Committee: Favorable refer to committee Ways and Means",17,8,0,1,26
2033671,1586018,2025-06-06,Assembly,"Assembly Ways And Means Committee: Favorable refer to committee Rules",25,10,0,0,35
2033671,1589468,2025-06-12,Assembly,"Assembly Rules Committee: Favorable",20,9,0,2,31
2033679,1580598,2025-05-28,Assembly,"Assembly Environmental Conservation Committee: Favorable refer to committee Rules",29,0,0,1,30
2033679,1581551,2025-05-29,Assembly,"Assembly Rules Committee: Favorable",27,0,0,4,31
2033679,1582167,2025-05-29,Assembly,"Assembly Floor Vote - Final Passage",137,5,0,8,150
2033679,1589549,2025-06-11,Senate,"Senate Floor Vote - Final Passage",56,3,0,4,63
2033840,1590183,2025-06-12,Senate,"Senate Rules Committee Vote",20,0,0,1,21
2033840,1590492,2025-06-13,Senate,"Senate Floor Vote - Final Passage",59,0,0,4,63
2033846,1593571,2025-06-16,Assembly,"Assembly Rules Committee: Favorable",29,0,0,2,31
2033846,1593572,2025-06-16,Assembly,"Assembly Ways And Means Committee: Favorable refer to committee Rules",32,0,0,3,35
2033849,1589193,2025-06-09,Senate,"Senate Rules Committee Vote",18,3,0,0,21
2033849,1589194,2025-06-11,Senate,"Senate Floor Vote - Final Passage",54,5,0,4,63
2033851,1588784,2025-06-09,Senate,"Senate Rules Committee Vote",21,0,0,0,21
2033851,1589333,2025-06-11,Senate,"Senate Floor Vote - Final Passage",59,0,0,4,63
2033856,1588324,2025-06-10,Senate,"Senate Floor Vote - Final Passage",58,0,0,5,63
2033856,1588325,2025-06-10,Senate,"Senate Rules Committee Vote",19,0,0,2,21
2033866,1588316,2025-06-10,Senate,"Senate Floor Vote - Final Passage",52,6,0,5,63
2033866,1588317,2025-06-10,Senate,"Senate Rules Committee Vote",18,1,0,2,21
2033875,1588147,2025-06-04,Senate,"Senate Rules Committee Vote",20,0,0,1,21
2033875,1588148,2025-06-10,Senate,"Senate Floor Vote - Final Passage",53,5,0,5,63
2033875,1588963,2025-06-10,Assembly,"Assembly Floor Vote - Final Passage",101,45,0,4,150
2033889,1590423,2025-06-12,Senate,"Senate Floor Vote - Final Passage",59,0,0,4,63
2033889,1591262,2025-06-13,Assembly,"Assembly Floor Vote - Final Passage",136,0,0,14,150
2033889,1595213,2025-06-12,Senate,"Senate Rules Committee Vote",20,0,0,1,21
2033924,1588378,2025-06-10,Senate,"Senate Floor Vote - Final Passage",56,2,0,5,63
2033924,1588379,2025-06-10,Senate,"Senate Rules Committee Vote",18,1,0,2,21
2033929,1589148,2025-06-09,Senate,"Senate Rules Committee Vote",21,0,0,0,21
2033929,1589149,2025-06-11,Senate,"Senate Floor Vote - Final Passage",59,0,0,4,63
2033954,1588307,2025-06-10,Senate,"Senate Floor Vote - Final Passage",58,0,0,5,63
2033954,1588308,2025-06-10,Senate,"Senate Rules Committee Vote",19,0,0,2,21
2033968,1588230,2025-06-10,Senate,"Senate Floor Vote - Final Passage",56,2,0,5,63
2033968,1588231,2025-06-10,Senate,"Senate Rules Committee Vote",19,0,0,2,21
2033970,1588266,2025-06-10,Senate,"Senate Floor Vote - Final Passage",58,0,0,5,63
2033970,1588267,2025-06-10,Senate,"Senate Rules Committee Vote",19,0,0,2,21
2033988,1593622,2025-06-16,Assembly,"Assembly Rules Committee: Favorable",29,0,0,2,31
2033988,1593623,2025-06-16,Assembly,"Assembly Ways And Means Committee: Favorable refer to committee Rules",32,0,0,3,35
2033994,1587036,2025-06-09,Senate,"Senate Floor Vote - Final Passage",62,0,0,1,63
2033994,1587037,2025-06-09,Senate,"Senate Rules Committee Vote",21,0,0,0,21
2033994,1591096,2025-06-13,Assembly,"Assembly Floor Vote - Final Passage",137,0,0,13,150
2033998,1586988,2025-06-09,Senate,"Senate Floor Vote - Final Passage",62,0,0,1,63
2033998,1586989,2025-06-09,Senate,"Senate Rules Committee Vote",21,0,0,0,21
2034003,1586700,2025-06-09,Assembly,"Assembly Ways And Means Committee: Favorable refer to committee Rules",31,0,0,4,35
2034003,1587913,2025-06-10,Assembly,"Assembly Rules Committee: Favorable",28,0,0,3,31
2034059,1590650,2025-06-12,Senate,"Senate Rules Committee Vote",20,0,0,1,21
2034059,1590651,2025-06-13,Senate,"Senate Floor Vote - Final Passage",57,2,0,4,63
2034072,1587147,2025-06-09,Senate,"Senate Floor Vote - Final Passage",62,0,0,1,63
2034072,1587148,2025-06-09,Senate,"Senate Rules Committee Vote",21,0,0,0,21
2034072,1591264,2025-06-13,Assembly,"Assembly Floor Vote - Final Passage",125,11,0,14,150
2034073,1590320,2025-06-12,Senate,"Senate Floor Vote - Final Passage",46,13,0,4,63
2034073,1592427,2025-06-18,Assembly,"Assembly Floor Vote - Final Passage",101,33,0,16,150
2034073,1594784,2025-06-12,Senate,"Senate Rules Committee Vote",15,5,0,1,21
2034076,1587027,2025-06-09,Assembly,"Assembly Ways And Means Committee: Favorable refer to committee Rules",31,0,0,4,35
2034076,1587366,2025-06-10,Assembly,"Assembly Rules Committee: Favorable",28,0,0,3,31
2034076,1588624,2025-06-10,Assembly,"Assembly Floor Vote - Final Passage",143,4,0,3,150
2034076,1589228,2025-06-11,Senate,"Senate Floor Vote - Final Passage",40,19,0,4,63
2034089,1590074,2025-06-12,Senate,"Senate Rules Committee Vote",20,0,0,1,21
2034089,1590464,2025-06-13,Senate,"Senate Floor Vote - Final Passage",59,0,0,4,63
2034089,1592635,2025-06-16,Assembly,"Assembly Floor Vote - Final Passage",144,0,0,6,150
2034218,1588543,2025-06-11,Assembly,"Assembly Ways And Means Committee: Favorable refer to committee Rules",30,4,0,1,35
2034218,1590042,2025-06-12,Assembly,"Assembly Rules Committee: Favorable",29,0,0,2,31
2034263,1585574,2025-06-05,Assembly,"Assembly Cities Committee: Favorable refer to committee Ways and Means",15,0,0,1,16
2034263,1586070,2025-06-06,Assembly,"Assembly Ways And Means Committee: Favorable refer to committee Rules",35,0,0,0,35
2034263,1587931,2025-06-10,Assembly,"Assembly Rules Committee: Favorable",28,0,0,3,31
2034263,1588938,2025-06-10,Assembly,"Assembly Floor Vote - Final Passage",145,2,0,3,150
2034266,1586718,2025-06-04,Senate,"Senate Rules Committee Vote",20,0,0,1,21
2034266,1587182,2025-06-09,Senate,"Senate Floor Vote - Final Passage",62,0,0,1,63
2034266,1591277,2025-06-13,Assembly,"Assembly Floor Vote - Final Passage",136,0,0,14,150
2034308,1585561,2025-06-05,Assembly,"Assembly Cities Committee: Favorable refer to committee Ways and Means",15,0,0,1,16
2034308,1585958,2025-06-06,Assembly,"Assembly Ways And Means Committee: Favorable refer to committee Rules",35,0,0,0,35
2034308,1586974,2025-06-09,Assembly,"Assembly Rules Committee: Favorable",25,0,0,6,31
2034308,1587227,2025-06-09,Assembly,"Assembly Floor Vote - Final Passage",143,0,0,7,150
2034308,1590590,2025-06-12,Senate,"Senate Floor Vote - Final Passage",59,0,0,4,63
2034318,1585562,2025-06-05,Assembly,"Assembly Cities Committee: Favorable refer to committee Ways and Means",15,0,0,1,16
2034318,1586048,2025-06-06,Assembly,"Assembly Ways And Means Committee: Favorable refer to committee Rules",35,0,0,0,35
2034318,1586999,2025-06-09,Assembly,"Assembly Rules Committee: Favorable",25,0,0,6,31
2034318,1587219,2025-06-09,Assembly,"Assembly Floor Vote - Final Passage",143,0,0,7,150
2034318,1590412,2025-06-12,Senate,"Senate Floor Vote - Final Passage",42,17,0,4,63
2034318,1590413,2025-06-12,Senate,"Senate Floor Vote - Final Passage",42,17,0,4,63
2034343,1589014,2025-06-04,Senate,"Senate Rules Committee Vote",18,2,0,1,21
2034343,1589399,2025-06-11,Senate,"Senate Floor Vote - Final Passage",50,9,0,4,63
2034343,1591295,2025-06-13,Assembly,"Assembly Floor Vote - Final Passage",110,26,0,14,150
2034346,1590401,2025-06-12,Senate,"Senate Floor Vote - Final Passage",58,1,0,4,63
2034346,1594763,2025-06-12,Senate,"Senate Rules Committee Vote",20,0,0,1,21
2034377,1587620,2025-06-09,Senate,"Senate Rules Committee Vote",21,0,0,0,21
2034377,1588393,2025-06-10,Senate,"Senate Floor Vote - Final Passage",58,0,0,5,63
2034489,1588501,2025-06-11,Assembly,"Assembly Ways And Means Committee: Favorable refer to committee Rules",32,2,0,1,35
2034489,1590028,2025-06-12,Assembly,"Assembly Rules Committee: Favorable",29,0,0,2,31
2034492,1586903,2025-06-09,Assembly,"Assembly Ways And Means Committee: Favorable refer to committee Rules",31,0,0,4,35
2034492,1587307,2025-06-10,Assembly,"Assembly Rules Committee: Favorable",28,0,0,3,31
2034493,1588544,2025-06-11,Assembly,"Assembly Ways And Means Committee: Favorable refer to committee Rules",34,0,0,1,35
2034493,1589787,2025-06-12,Assembly,"Assembly Rules Committee: Favorable",29,0,0,2,31
2034519,1590552,2025-06-13,Assembly,"Assembly Rules Committee: Favorable",29,0,0,2,31
2034519,1590553,2025-06-13,Assembly,"Assembly Ways And Means Committee: Favorable refer to committee Rules",32,0,0,3,35
2034709,1590406,2025-06-12,Senate,"Senate Floor Vote - Final Passage",45,14,0,4,63
2034709,1592384,2025-06-16,Assembly,"Assembly Floor Vote - Final Passage",142,2,0,6,150
2034709,1595019,2025-06-12,Senate,"Senate Rules Committee Vote",17,3,0,1,21
2034730,1585507,2025-06-05,Assembly,"Assembly Codes Committee: Favorable refer to committee Ways and Means",15,6,0,1,22
2034730,1587287,2025-06-10,Assembly,"Assembly Ways And Means Committee: Favorable refer to committee Rules",22,10,0,3,35
2034730,1588537,2025-06-11,Assembly,"Assembly Rules Committee: Favorable",19,9,0,3,31
2034734,1590443,2025-06-12,Senate,"Senate Floor Vote - Final Passage",59,0,0,4,63
2034734,1591070,2025-06-13,Assembly,"Assembly Floor Vote - Final Passage",133,0,0,17,150
2034734,1595166,2025-06-12,Senate,"Senate Rules Committee Vote",20,0,0,1,21
2034742,1585680,2025-06-05,Assembly,"Assembly Governmental Operations Committee: Favorable refer to committee Codes",9,4,0,1,14
2034742,1587008,2025-06-09,Assembly,"Assembly Codes Committee: Favorable refer to committee Rules",15,5,0,2,22
2034742,1588137,2025-06-10,Assembly,"Assembly Rules Committee: Favorable",19,9,0,3,31
2034763,1590082,2025-06-12,Senate,"Senate Rules Committee Vote",20,0,0,1,21
2034763,1590573,2025-06-13,Senate,"Senate Floor Vote - Final Passage",59,0,0,4,63
2034763,1592225,2025-06-16,Assembly,"Assembly Floor Vote - Final Passage",144,0,0,6,150
2034779,1585827,2025-06-05,Assembly,"Assembly Codes Committee: Favorable refer to committee Rules",21,0,0,1,22
2034779,1585944,2025-06-06,Assembly,"Assembly Rules Committee: Favorable",27,0,0,4,31
2034779,1587208,2025-06-09,Assembly,"Assembly Floor Vote - Final Passage",144,0,0,6,150
2034779,1587886,2025-06-10,Senate,"Senate Floor Vote - Final Passage",58,0,0,5,63
2034829,1584607,2025-06-04,Assembly,"Assembly Banks Committee: Favorable refer to committee Ways and Means",23,7,0,1,31
2034830,1584951,2025-06-04,Assembly,"Assembly Transportation Committee: Favorable refer to committee Codes",22,0,0,4,26
2034946,1588475,2025-06-11,Assembly,"Assembly Ways And Means Committee: Favorable refer to committee Rules",24,10,0,1,35
2034946,1590052,2025-06-12,Assembly,"Assembly Rules Committee: Favorable",20,9,0,2,31
2034951,1588255,2025-06-04,Senate,"Senate Rules Committee Vote",20,0,0,1,21
2034951,1588256,2025-06-10,Senate,"Senate Floor Vote - Final Passage",58,0,0,5,63
2034957,1591582,2025-06-16,Assembly,"Assembly Ways And Means Committee: Favorable refer to committee Rules",32,0,0,3,35
2034957,1591583,2025-06-17,Assembly,"Assembly Rules Committee: Favorable",30,0,0,1,31
2034972,1588500,2025-06-11,Assembly,"Assembly Ways And Means Committee: Favorable refer to committee Rules",34,0,0,1,35
2034972,1590067,2025-06-12,Assembly,"Assembly Rules Committee: Favorable",29,0,0,2,31
2034980,1590222,2025-06-12,Senate,"Senate Rules Committee Vote",20,0,0,1,21
2034980,1590682,2025-06-13,Senate,"Senate Floor Vote - Final Passage",58,1,0,4,63
2034980,1591107,2025-06-13,Assembly,"Assembly Floor Vote - Final Passage",133,0,0,17,150
2034988,1591407,2025-06-16,Assembly,"Assembly Rules Committee: Favorable",29,0,0,2,31
2034988,1591408,2025-06-16,Assembly,"Assembly Ways And Means Committee: Favorable refer to committee Rules",32,0,0,3,35
2034988,1592644,2025-06-16,Assembly,"Assembly Floor Vote - Final Passage",144,0,0,6,150
2035023,1588503,2025-06-11,Assembly,"Assembly Ways And Means Committee: Favorable refer to committee Rules",33,1,0,1,35
2035023,1589465,2025-06-12,Assembly,"Assembly Rules Committee: Favorable",29,0,0,2,31
2035055,1589024,2025-06-04,Senate,"Senate Rules Committee Vote",18,2,0,1,21
2035055,1589947,2025-06-11,Senate,"Senate Floor Vote - Final Passage",51,8,0,4,63
2035055,1592444,2025-06-18,Assembly,"Assembly Floor Vote - Final Passage",106,28,0,16,150
2035105,1587107,2025-06-09,Senate,"Senate Floor Vote - Final Passage",57,5,0,1,63
2035105,1587108,2025-06-09,Senate,"Senate Rules Committee Vote",21,0,0,0,21
2035131,1589850,2025-06-12,Assembly,"Assembly Ways And Means Committee: Favorable refer to committee Rules",34,0,0,1,35
2035131,1593595,2025-06-16,Assembly,"Assembly Rules Committee: Favorable",29,0,0,2,31
2035146,1591572,2025-06-17,Assembly,"Assembly Ways And Means Committee: Favorable refer to committee Rules",29,3,0,3,35
2035146,1591957,2025-06-17,Assembly,"Assembly Rules Committee: Favorable",28,0,0,3,31
2035161,1590630,2025-06-13,Assembly,"Assembly Rules Committee: Favorable",29,0,0,2,31
2035161,1590631,2025-06-13,Assembly,"Assembly Ways And Means Committee: Favorable refer to committee Rules",32,0,0,3,35
2035170,1588511,2025-06-11,Assembly,"Assembly Ways And Means Committee: Favorable refer to committee Rules",32,2,0,1,35
2035170,1591965,2025-06-17,Assembly,"Assembly Rules Committee: Favorable",28,0,0,3,31
2035182,1591573,2025-06-16,Assembly,"Assembly Ways And Means Committee: Favorable refer to committee Rules",32,0,0,3,35
2035182,1591961,2025-06-17,Assembly,"Assembly Rules Committee: Favorable",28,0,0,3,31
2035254,1587119,2025-06-09,Senate,"Senate Floor Vote - Final Passage",59,3,0,1,63
2035254,1587120,2025-06-09,Senate,"Senate Rules Committee Vote",21,0,0,0,21
2035254,1592507,2025-06-16,Assembly,"Assembly Floor Vote - Final Passage",98,46,0,6,150
2035274,1590173,2025-06-12,Senate,"Senate Rules Committee Vote",20,0,0,1,21
2035274,1590373,2025-06-13,Senate,"Senate Floor Vote - Final Passage",59,0,0,4,63
2035285,1587066,2025-06-09,Senate,"Senate Floor Vote - Final Passage",53,9,0,1,63
2035285,1587067,2025-06-09,Senate,"Senate Rules Committee Vote",19,2,0,0,21
2035423,1590219,2025-06-12,Senate,"Senate Rules Committee Vote",14,6,0,1,21
2035423,1590679,2025-06-13,Senate,"Senate Floor Vote - Final Passage",38,21,0,4,63
2035423,1592410,2025-06-17,Assembly,"Assembly Floor Vote - Final Passage",110,31,0,9,150
2035482,1590220,2025-06-12,Senate,"Senate Rules Committee Vote",20,0,0,1,21
2035482,1590497,2025-06-13,Senate,"Senate Floor Vote - Final Passage",58,1,0,4,63
2035482,1592445,2025-06-18,Assembly,"Assembly Floor Vote - Final Passage",134,0,0,16,150
2035499,1587316,2025-06-10,Assembly,"Assembly Ways And Means Committee: Favorable refer to committee Rules",31,1,0,3,35
2035499,1588516,2025-06-11,Assembly,"Assembly Rules Committee: Favorable",28,0,0,3,31
2035499,1589476,2025-06-11,Assembly,"Assembly Floor Vote - Final Passage",115,31,0,4,150
2035499,1590280,2025-06-12,Senate,"Senate Floor Vote - Final Passage",51,8,0,4,63
2035506,1589583,2025-06-09,Senate,"Senate Rules Committee Vote",21,0,0,0,21
2035506,1590358,2025-06-12,Senate,"Senate Floor Vote - Final Passage",57,2,0,4,63
2035506,1592454,2025-06-18,Assembly,"Assembly Floor Vote - Final Passage",133,1,0,16,150
2035523,1587056,2025-06-09,Assembly,"Assembly Codes Committee: Favorable refer to committee Rules",20,0,0,2,22
2035523,1587329,2025-06-10,Assembly,"Assembly Rules Committee: Favorable",28,0,0,3,31
2035523,1587981,2025-06-10,Senate,"Senate Floor Vote - Final Passage",57,1,0,5,63
2035523,1588940,2025-06-10,Assembly,"Assembly Floor Vote - Final Passage",147,0,0,3,150
2035526,1587113,2025-06-09,Senate,"Senate Floor Vote - Final Passage",61,1,0,1,63
2035526,1587114,2025-06-09,Senate,"Senate Rules Committee Vote",21,0,0,0,21
2035780,1591510,2025-06-16,Assembly,"Assembly Ways And Means Committee: Favorable refer to committee Rules",23,9,0,3,35
2035780,1591511,2025-06-17,Assembly,"Assembly Rules Committee: Favorable",21,9,0,1,31
2035783,1591571,2025-06-16,Assembly,"Assembly Ways And Means Committee: Favorable refer to committee Rules",32,0,0,3,35
2035783,1591963,2025-06-17,Assembly,"Assembly Rules Committee: Favorable",28,0,0,3,31
2035786,1589016,2025-06-09,Senate,"Senate Rules Committee Vote",19,2,0,0,21
2035786,1589400,2025-06-11,Senate,"Senate Floor Vote - Final Passage",52,7,0,4,63
2035786,1592492,2025-06-16,Assembly,"Assembly Floor Vote - Final Passage",144,0,0,6,150
2035790,1589342,2025-06-09,Senate,"Senate Rules Committee Vote",21,0,0,0,21
2035790,1589674,2025-06-11,Senate,"Senate Floor Vote - Final Passage",58,1,0,4,63
2035803,1586692,2025-06-09,Assembly,"Assembly Ways And Means Committee: Favorable refer to committee Rules",29,2,0,4,35
2035803,1587322,2025-06-10,Assembly,"Assembly Rules Committee: Favorable",28,0,0,3,31
2035803,1588960,2025-06-10,Assembly,"Assembly Floor Vote - Final Passage",143,4,0,3,150
2035803,1590449,2025-06-12,Senate,"Senate Floor Vote - Final Passage",58,1,0,4,63
2035812,1586697,2025-06-09,Assembly,"Assembly Ways And Means Committee: Favorable refer to committee Rules",31,0,0,4,35
2035815,1590444,2025-06-12,Senate,"Senate Floor Vote - Final Passage",59,0,0,4,63
2035815,1592659,2025-06-17,Assembly,"Assembly Floor Vote - Final Passage",141,0,0,9,150
2035815,1595063,2025-06-12,Senate,"Senate Rules Committee Vote",20,0,0,1,21
2035824,1589012,2025-06-09,Senate,"Senate Rules Committee Vote",21,0,0,0,21
2035824,1589395,2025-06-11,Senate,"Senate Floor Vote - Final Passage",59,0,0,4,63
2035982,1590397,2025-06-12,Senate,"Senate Floor Vote - Final Passage",58,1,0,4,63
2035982,1591100,2025-06-13,Assembly,"Assembly Floor Vote - Final Passage",132,4,0,14,150
2035982,1595017,2025-06-12,Senate,"Senate Rules Committee Vote",20,0,0,1,21
2036017,1590725,2025-06-12,Senate,"Senate Floor Vote - Final Passage",59,0,0,4,63
2036017,1592542,2025-06-16,Assembly,"Assembly Floor Vote - Final Passage",144,0,0,6,150
2036017,1594795,2025-06-12,Senate,"Senate Rules Committee Vote",20,0,0,1,21
2036036,1588322,2025-06-10,Senate,"Senate Floor Vote - Final Passage",58,0,0,5,63
2036036,1588323,2025-06-10,Senate,"Senate Rules Committee Vote",19,0,0,2,21
2036036,1591099,2025-06-13,Assembly,"Assembly Floor Vote - Final Passage",136,0,0,14,150
2036058,1590145,2025-06-12,Senate,"Senate Rules Committee Vote",20,0,0,1,21
2036058,1590417,2025-06-13,Senate,"Senate Floor Vote - Final Passage",59,0,0,4,63
2036058,1592690,2025-06-17,Assembly,"Assembly Floor Vote - Final Passage",141,0,0,9,150
2036060,1589318,2025-06-11,Senate,"Senate Floor Vote - Final Passage",43,16,0,4,63
2036060,1589319,2025-06-11,Senate,"Senate Rules Committee Vote",17,3,0,1,21
2036060,1592446,2025-06-16,Assembly,"Assembly Floor Vote - Final Passage",88,56,0,6,150
2036063,1587097,2025-06-09,Senate,"Senate Floor Vote - Final Passage",62,0,0,1,63
2036063,1587098,2025-06-09,Senate,"Senate Rules Committee Vote",21,0,0,0,21
2036063,1591293,2025-06-13,Assembly,"Assembly Floor Vote - Final Passage",136,0,0,14,150
2036068,1589290,2025-06-09,Senate,"Senate Rules Committee Vote",21,0,0,0,21
2036068,1589444,2025-06-11,Senate,"Senate Floor Vote - Final Passage",58,1,0,4,63
2036068,1591278,2025-06-13,Assembly,"Assembly Floor Vote - Final Passage",136,0,0,14,150
2036076,1590381,2025-06-12,Senate,"Senate Floor Vote - Final Passage",59,0,0,4,63
2036076,1594863,2025-06-12,Senate,"Senate Rules Committee Vote",20,0,0,1,21
2036078,1590400,2025-06-12,Senate,"Senate Floor Vote - Final Passage",46,13,0,4,63
2036078,1595123,2025-06-12,Senate,"Senate Rules Committee Vote",18,2,0,1,21
2036080,1590579,2025-06-12,Senate,"Senate Floor Vote - Final Passage",59,0,0,4,63
2036080,1595003,2025-06-12,Senate,"Senate Rules Committee Vote",20,0,0,1,21
2036085,1588550,2025-06-11,Assembly,"Assembly Ways And Means Committee: Favorable refer to committee Rules",34,0,0,1,35
2036085,1589747,2025-06-12,Assembly,"Assembly Rules Committee: Favorable",29,0,0,2,31
2036086,1588490,2025-06-11,Assembly,"Assembly Ways And Means Committee: Favorable refer to committee Rules",34,0,0,1,35
2036086,1589743,2025-06-12,Assembly,"Assembly Rules Committee: Favorable",29,0,0,2,31
2036133,1588332,2025-06-10,Senate,"Senate Floor Vote - Final Passage",58,0,0,5,63
2036133,1588333,2025-06-10,Senate,"Senate Rules Committee Vote",19,0,0,2,21
2036133,1591181,2025-06-13,Assembly,"Assembly Floor Vote - Final Passage",133,0,0,17,150
2036134,1587346,2025-06-10,Assembly,"Assembly Ways And Means Committee: Favorable refer to committee Rules",31,1,0,3,35
2036134,1588505,2025-06-11,Assembly,"Assembly Rules Committee: Favorable",28,0,0,3,31
2036135,1588206,2025-06-10,Senate,"Senate Floor Vote - Final Passage",57,1,0,5,63
2036135,1588207,2025-06-10,Senate,"Senate Rules Committee Vote",19,0,0,2,21
2036193,1593674,2025-06-16,Assembly,"Assembly Rules Committee: Favorable",29,0,0,2,31
2036193,1593675,2025-06-16,Assembly,"Assembly Ways And Means Committee: Favorable refer to committee Rules",32,0,0,3,35
2036202,1590421,2025-06-12,Senate,"Senate Floor Vote - Final Passage",59,0,0,4,63
2036202,1595236,2025-06-12,Senate,"Senate Rules Committee Vote",20,0,0,1,21
2036207,1588546,2025-06-11,Assembly,"Assembly Ways And Means Committee: Favorable refer to committee Rules",31,3,0,1,35
2036207,1589728,2025-06-12,Assembly,"Assembly Rules Committee: Favorable",29,0,0,2,31
2036215,1588497,2025-06-11,Assembly,"Assembly Ways And Means Committee: Favorable refer to committee Rules",34,0,0,1,35
2036215,1589725,2025-06-12,Assembly,"Assembly Rules Committee: Favorable",29,0,0,2,31
2036226,1589311,2025-06-11,Senate,"Senate Floor Vote - Final Passage",57,2,0,4,63
2036226,1589312,2025-06-11,Senate,"Senate Rules Committee Vote",20,0,0,1,21
2036226,1592467,2025-06-16,Assembly,"Assembly Floor Vote - Final Passage",144,0,0,6,150
2036244,1588558,2025-06-11,Assembly,"Assembly Ways And Means Committee: Favorable refer to committee Rules",34,0,0,1,35
2036244,1589775,2025-06-12,Assembly,"Assembly Rules Committee: Favorable",29,0,0,2,31
2036251,1589861,2025-06-12,Assembly,"Assembly Ways And Means Committee: Favorable refer to committee Rules",34,0,0,1,35
2036251,1590791,2025-06-13,Assembly,"Assembly Rules Committee: Favorable",29,0,0,2,31
2036277,1591772,2025-06-16,Assembly,"Assembly Rules Committee: Favorable",29,0,0,2,31
2036277,1591773,2025-06-16,Assembly,"Assembly Ways And Means Committee: Favorable refer to committee Rules",32,0,0,3,35
2036277,1592468,2025-06-17,Assembly,"Assembly Floor Vote - Final Passage",135,0,0,15,150
2036281,1591784,2025-06-16,Assembly,"Assembly Rules Committee: Favorable",29,0,0,2,31
2036281,1591785,2025-06-16,Assembly,"Assembly Ways And Means Committee: Favorable refer to committee Rules",32,0,0,3,35
2036281,1592164,2025-06-16,Assembly,"Assembly Floor Vote - Final Passage",144,0,0,6,150
2036299,1590433,2025-06-12,Senate,"Senate Floor Vote - Final Passage",58,1,0,4,63
2036299,1595047,2025-06-12,Senate,"Senate Rules Committee Vote",20,0,0,1,21
2036302,1593618,2025-06-16,Assembly,"Assembly Rules Committee: Favorable",29,0,0,2,31
2036302,1593619,2025-06-16,Assembly,"Assembly Ways And Means Committee: Favorable refer to committee Rules",32,0,0,3,35
2036305,1590393,2025-06-12,Senate,"Senate Floor Vote - Final Passage",59,0,0,4,63
2036305,1594760,2025-06-12,Senate,"Senate Rules Committee Vote",20,0,0,1,21
2036307,1591608,2025-06-17,Assembly,"Assembly Rules Committee: Favorable",30,0,0,1,31
2036307,1591609,2025-06-17,Assembly,"Assembly Ways And Means Committee: Favorable refer to committee Rules",32,0,0,3,35
2036317,1590160,2025-06-12,Senate,"Senate Rules Committee Vote",20,0,0,1,21
2036317,1590496,2025-06-13,Senate,"Senate Floor Vote - Final Passage",59,0,0,4,63
2036317,1592434,2025-06-18,Assembly,"Assembly Floor Vote - Final Passage",134,0,0,16,150
2036362,1590447,2025-06-12,Senate,"Senate Floor Vote - Final Passage",58,1,0,4,63
2036362,1591259,2025-06-13,Assembly,"Assembly Floor Vote - Final Passage",132,1,0,17,150
2036362,1595127,2025-06-12,Senate,"Senate Rules Committee Vote",20,0,0,1,21
2036362,1595128,2025-06-12,Senate,"Senate Rules Committee Vote",20,0,0,1,21
2036373,1590389,2025-06-12,Senate,"Senate Floor Vote - Final Passage",58,1,0,4,63
2036373,1591179,2025-06-13,Assembly,"Assembly Floor Vote - Final Passage",123,10,0,17,150
2036373,1595036,2025-06-12,Senate,"Senate Rules Committee Vote",20,0,0,1,21
2036381,1590431,2025-06-12,Senate,"Senate Floor Vote - Final Passage",59,0,0,4,63
2036381,1591257,2025-06-13,Assembly,"Assembly Floor Vote - Final Passage",136,0,0,14,150
2036381,1594923,2025-06-12,Senate,"Senate Rules Committee Vote",20,0,0,1,21
2036409,1589783,2025-06-12,Assembly,"Assembly Rules Committee: Favorable",20,9,0,2,31
2036409,1589784,2025-06-12,Assembly,"Assembly Ways And Means Committee: Favorable refer to committee Rules",30,4,0,1,35
2036415,1589734,2025-06-12,Assembly,"Assembly Rules Committee: Favorable",20,9,0,2,31
2036415,1589735,2025-06-12,Assembly,"Assembly Ways And Means Committee: Favorable refer to committee Rules",24,10,0,1,35
2036415,1590480,2025-06-12,Assembly,"Assembly Floor Vote - Final Passage",96,48,0,6,150
2036415,1590481,2025-06-12,Senate,"Senate Floor Vote - Final Passage",38,21,0,4,63
2036417,1590186,2025-06-12,Senate,"Senate Rules Committee Vote",20,0,0,1,21
2036417,1590368,2025-06-13,Senate,"Senate Floor Vote - Final Passage",59,0,0,4,63
2036417,1592494,2025-06-17,Assembly,"Assembly Floor Vote - Final Passage",92,49,0,9,150
2036423,1590184,2025-06-13,Senate,"Senate Rules Committee Vote",13,7,0,1,21
2036423,1590432,2025-06-13,Senate,"Senate Floor Vote - Final Passage",37,22,0,4,63
2036423,1592400,2025-06-17,Assembly,"Assembly Floor Vote - Final Passage",91,50,0,9,150
2036428,1591612,2025-06-17,Assembly,"Assembly Rules Committee: Favorable",30,0,0,1,31
2036428,1591613,2025-06-17,Assembly,"Assembly Ways And Means Committee: Favorable refer to committee Rules",32,0,0,3,35
2036430,1590618,2025-06-12,Senate,"Senate Floor Vote - Final Passage",36,23,0,4,63
2036430,1594846,2025-06-12,Senate,"Senate Rules Committee Vote",13,7,0,1,21
2036436,1590404,2025-06-12,Senate,"Senate Floor Vote - Final Passage",38,21,0,4,63
2036436,1592425,2025-06-17,Assembly,"Assembly Floor Vote - Final Passage",88,47,0,15,150
2036436,1594798,2025-06-12,Senate,"Senate Rules Committee Vote",13,7,0,1,21
2036440,1590422,2025-06-12,Senate,"Senate Floor Vote - Final Passage",58,1,0,4,63
2036440,1591284,2025-06-13,Assembly,"Assembly Floor Vote - Final Passage",136,0,0,14,150
2036440,1595093,2025-06-12,Senate,"Senate Rules Committee Vote",20,0,0,1,21
2036441,1588508,2025-06-11,Assembly,"Assembly Ways And Means Committee: Favorable refer to committee Rules",24,10,0,1,35
2036441,1589769,2025-06-12,Assembly,"Assembly Rules Committee: Favorable",20,9,0,2,31
2036444,1591610,2025-06-17,Assembly,"Assembly Rules Committee: Favorable",21,9,0,1,31
2036444,1591611,2025-06-17,Assembly,"Assembly Ways And Means Committee: Favorable refer to committee Rules",22,10,0,3,35
2036452,1590628,2025-06-12,Senate,"Senate Floor Vote - Final Passage",37,22,0,4,63
2036452,1592403,2025-06-17,Assembly,"Assembly Floor Vote - Final Passage",88,47,0,15,150
2036452,1594788,2025-06-12,Senate,"Senate Rules Committee Vote",14,6,0,1,21
2036460,1590434,2025-06-12,Senate,"Senate Floor Vote - Final Passage",34,25,0,4,63
2036460,1592323,2025-06-16,Assembly,"Assembly Floor Vote - Final Passage",83,62,0,5,150
2036460,1594789,2025-06-12,Senate,"Senate Rules Committee Vote",13,7,0,1,21
2036489,1590242,2025-06-12,Assembly,"Assembly Floor Vote - Final Passage",93,49,0,8,150
2036489,1590640,2025-06-12,Senate,"Senate Floor Vote - Final Passage",36,23,0,4,63
2036489,1594764,2025-06-12,Senate,"Senate Rules Committee Vote",14,6,0,1,21
2036496,1589726,2025-06-12,Assembly,"Assembly Rules Committee: Favorable",21,8,0,2,31
2036496,1589727,2025-06-12,Assembly,"Assembly Ways And Means Committee: Favorable refer to committee Rules",24,10,0,1,35
2036539,1590225,2025-06-12,Senate,"Senate Rules Committee Vote",20,0,0,1,21
2036539,1590703,2025-06-13,Senate,"Senate Floor Vote - Final Passage",58,1,0,4,63
2036539,1591098,2025-06-13,Assembly,"Assembly Floor Vote - Final Passage",136,0,0,14,150
2036570,1593398,2025-06-16,Assembly,"Assembly Rules Committee: Favorable",19,10,0,2,31
2036570,1593399,2025-06-16,Assembly,"Assembly Ways And Means Committee: Favorable refer to committee Rules",21,11,0,3,35
2036651,1588549,2025-06-11,Assembly,"Assembly Ways And Means Committee: Favorable refer to committee Rules",34,0,0,1,35
2036651,1589741,2025-06-12,Assembly,"Assembly Rules Committee: Favorable",29,0,0,2,31
2036657,1593489,2025-06-16,Assembly,"Assembly Rules Committee: Favorable",29,0,0,2,31
2036657,1593490,2025-06-16,Assembly,"Assembly Ways And Means Committee: Favorable refer to committee Rules",32,0,0,3,35
2036828,1590172,2025-06-12,Senate,"Senate Rules Committee Vote",14,6,0,1,21
2036828,1590340,2025-06-13,Senate,"Senate Floor Vote - Final Passage",39,20,0,4,63
2036828,1592331,2025-06-17,Assembly,"Assembly Floor Vote - Final Passage",95,46,0,9,150
2036884,1589755,2025-06-12,Assembly,"Assembly Rules Committee: Favorable",29,0,0,2,31
2036884,1589756,2025-06-12,Assembly,"Assembly Ways And Means Committee: Favorable refer to committee Rules",34,0,0,1,35
2036884,1590248,2025-06-12,Assembly,"Assembly Floor Vote - Final Passage",141,0,0,9,150
2036884,1590868,2025-06-12,Senate,"Senate Floor Vote - Final Passage",45,14,0,4,63
2037417,1591603,2025-06-17,Assembly,"Assembly Ways And Means Committee: Favorable refer to committee Rules",22,10,0,3,35
2037417,1591933,2025-06-17,Assembly,"Assembly Rules Committee: Favorable",19,9,0,3,31
