bill_id,roll_call_id,date,chamber,description,yea,nay,nv,absent,total
1899824,1472966,2025-01-22,House,"Deferred to another day",9,5,0,1,15
1899824,1476212,2025-01-29,House,"Deferred to the 41st legislative day",8,7,0,0,15
1899825,1473105,2025-01-22,Senate,"Do Pass Amended",7,2,0,0,9
1899825,1474996,2025-01-27,Senate,"Do Pass Amended",30,4,0,1,35
1899825,1480578,2025-02-05,House,"Motion to amend",8,4,0,1,13
1899825,1480579,2025-02-05,House,"Do Pass Amended",5,7,0,1,13
1899825,1480580,2025-02-05,House,"Deferred to the 41st legislative day",9,3,0,1,13
1899826,1474206,2025-01-24,House,"Do Pass",10,3,0,0,13
1899826,1474953,2025-01-27,House,"Do Pass",58,10,0,1,69
1899826,1507311,2025-03-06,Senate,"Do Pass Amended",8,0,0,1,9
1899826,1509524,2025-03-10,Senate,"Do Pass Amended",34,0,0,1,35
1899826,1514262,2025-03-11,House,"Concurred in amendments",68,0,0,2,70
1899827,1472090,2025-01-17,House,"Do Pass",15,0,0,0,15
1899827,1472647,2025-01-21,House,"Do Pass",66,0,0,3,69
1899827,1500073,2025-02-26,Senate,"Do Pass",8,0,0,1,9
1899827,1501526,2025-02-27,Senate,"Do Pass",35,0,0,0,35
1899828,1473980,2025-01-23,House,"Referred to",11,1,0,1,13
1899828,1497785,2025-02-24,House,"Do Pass Amended",9,0,0,0,9
1899828,1499686,2025-02-25,House,"Do Pass Amended",70,0,0,0,70
1899828,1505938,2025-03-05,Senate,"Do Pass",6,0,0,1,7
1899828,1511864,2025-03-10,Senate,"Do Pass Amended",33,0,0,2,35
1899829,1479841,2025-02-04,Senate,"Do Pass Amended",6,0,0,1,7
1899829,1483783,2025-02-06,Senate,"Do Pass Amended",35,0,0,0,35
1899829,1500258,2025-02-26,House,"Do Pass",13,0,0,0,13
1899829,1502080,2025-02-27,House,"Do Pass Amended",52,18,0,0,70
1899830,1474226,2025-01-24,Senate,"Deferred to the 41st legislative day",8,1,0,0,9
1899831,1473576,2025-01-23,House,"Referred to",9,3,0,1,13
1899831,1497283,2025-02-24,House,"Deferred to the 41st legislative day",8,0,0,1,9
1899832,1482703,2025-02-05,Senate,"Referred to",8,0,0,1,9
1899832,1498717,2025-02-25,Joint,"Do Pass Amended",17,0,0,1,18
1899832,1504030,2025-03-03,Senate,"Do Pass Amended",29,6,0,0,35
1899832,1508185,2025-03-06,House,"Do Pass Amended",41,28,0,1,70
1899832,1515584,2025-03-11,Senate,"Concurred in amendments",32,2,0,1,35
1899833,1471903,2025-01-16,Senate,"Do Pass Amended",7,0,0,0,7
1899833,1472722,2025-01-21,Senate,"Do Pass Amended",32,0,0,3,35
1899833,1476221,2025-01-29,House,"Do Pass",13,0,0,0,13
1899833,1477371,2025-01-30,House,"Do Pass Amended",58,8,0,2,68
1899834,1472113,2025-01-17,House,"Deferred to another day",15,0,0,0,15
1899834,1474246,2025-01-24,House,"Do Pass",12,2,0,1,15
1899834,1475125,2025-01-27,House,"Do Pass",65,3,0,1,69
1899834,1483283,2025-02-06,Senate,"Do Pass",7,0,0,0,7
1899834,1484499,2025-02-07,Senate,"Do Pass",35,0,0,0,35
1899835,1472200,2025-01-17,Senate,"Motion to amend",7,0,0,0,7
1899835,1472201,2025-01-17,Senate,"Do Pass Amended",7,0,0,0,7
1899835,1474124,2025-01-23,Senate,"Do Pass Amended",30,4,0,1,35
1899835,1477758,2025-01-30,House,"Do Pass",10,3,0,0,13
1899835,1479170,2025-02-03,House,"Do Pass Amended",54,14,0,0,68
1899836,1473047,2025-01-22,Senate,"Deferred to the 41st legislative day",7,2,0,0,9
1899836,1475001,2025-01-27,Senate,"Placed on calendar pursuant to JR 6F-6",16,18,0,1,35
1899837,1472222,2025-01-17,Senate,"Do Pass",7,0,0,0,7
1899837,1473162,2025-01-22,Senate,"Do Pass Amended",35,0,0,0,35
1899837,1477740,2025-01-30,House,"Do Pass",13,0,0,0,13
1899837,1479161,2025-02-03,House,"Do Pass Amended",68,0,0,0,68
1899838,1473564,2025-01-23,Senate,"Do Pass",6,0,0,1,7
1899838,1474425,2025-01-24,Senate,"Do Pass",35,0,0,0,35
1899838,1477267,2025-01-30,House,"Do Pass",12,1,0,0,13
1899838,1478963,2025-02-03,House,"Do Pass",62,6,1,0,69
1899839,1494739,2025-02-20,Senate,"Do Pass Amended",6,2,0,1,9
1899839,1497959,2025-02-24,Senate,"Do Pass Amended",24,11,0,0,35
1899839,1503103,2025-03-03,House,"Deferred to another day",7,2,0,0,9
1899839,1505946,2025-03-05,House,"Do Pass",8,0,0,1,9
1899839,1507813,2025-03-06,House,"Do Pass Amended",51,18,0,1,70
1899840,1472115,2025-01-17,House,"Do Pass",13,2,0,0,15
1899840,1472635,2025-01-21,House,"Do Pass",59,7,0,3,69
1899840,1483085,2025-02-06,Senate,"Do Pass",7,0,0,0,7
1899840,1484091,2025-02-07,Senate,"Do Pass",35,0,0,0,35
1899841,1473323,2025-01-22,Senate,"Do Pass",9,0,0,0,9
1899841,1474031,2025-01-23,Senate,"Do Pass",34,0,0,1,35
1899841,1476194,2025-01-29,House,"Do Pass",11,0,0,2,13
1899841,1477938,2025-01-30,House,"Do Pass",59,7,0,2,68
1899842,1472118,2025-01-17,House,"Do Pass",12,3,0,0,15
1899842,1472613,2025-01-21,House,"Do Pass",54,12,0,3,69
1899842,1483033,2025-02-06,Senate,"Do Pass",6,0,0,1,7
1899842,1484249,2025-02-07,Senate,"Do Pass",35,0,0,0,35
1899843,1473077,2025-01-22,Senate,"Do Pass",6,3,0,0,9
1899843,1474141,2025-01-23,Senate,"Do Pass",21,13,0,1,35
1899843,1478722,2025-02-03,House,"Do Pass Amended",12,1,0,0,13
1899843,1482460,2025-02-05,House,"Motion to amend",34,33,0,1,68
1899843,1482461,2025-02-05,House,"Do Pass Amended",38,29,0,1,68
1899844,1474222,2025-01-24,House,"Do Pass Amended",13,0,0,0,13
1899844,1475601,2025-01-28,House,"Do Pass Amended",69,0,0,0,69
1899844,1504211,2025-03-04,Senate,"Do Pass",7,0,0,2,9
1899844,1506102,2025-03-05,Senate,"Do Pass Amended",34,0,0,1,35
1901505,1472122,2025-01-17,Senate,"Do Pass",7,0,0,0,7
1901505,1472670,2025-01-21,Senate,"Do Pass",32,0,0,3,35
1901505,1475664,2025-01-28,House,"Do Pass",13,0,0,0,13
1901505,1476523,2025-01-29,House,"Do Pass",68,0,0,1,69
1901507,1473305,2025-01-22,Senate,"Do Pass",7,0,0,0,7
1901507,1473792,2025-01-23,Senate,"Do Pass",34,0,0,1,35
1901507,1480762,2025-02-05,House,"Do Pass",12,0,0,1,13
1901507,1483854,2025-02-06,House,"Do Pass",65,3,0,1,69
1901508,1473027,2025-01-22,Senate,"Do Pass",9,0,0,0,9
1901508,1474532,2025-01-24,Senate,"Do Pass Amended",31,4,0,0,35
1901508,1478742,2025-02-03,House,"Do Pass",13,0,0,0,13
1901508,1480238,2025-02-04,House,"Do Pass Amended",61,6,0,1,68
1901513,1472980,2025-01-22,Senate,"Do Pass",6,1,0,0,7
1901513,1474113,2025-01-23,Senate,"Do Pass",32,2,0,1,35
1901513,1477414,2025-01-30,House,"Do Pass",11,1,0,1,13
1901513,1479329,2025-02-03,House,"Do Pass",42,26,0,0,68
1901516,1475945,2025-01-28,House,"Referred as Amended to",12,1,0,0,13
1901516,1496806,2025-02-21,House,"Do Pass Amended",8,0,0,1,9
1901516,1499569,2025-02-25,House,"Do Pass Amended",69,1,0,0,70
1901516,1503507,2025-03-03,Senate,"Do Pass",7,0,0,0,7
1901516,1505452,2025-03-04,Senate,"Do Pass Amended",27,8,0,0,35
1901516,1507662,2025-03-06,House,"Concurred in amendments",66,3,0,1,70
1901522,1479998,2025-02-04,Senate,"Referred to",9,0,0,0,9
1901522,1482514,2025-02-05,Joint,"Referred to",14,0,0,3,17
1901522,1491729,2025-02-18,Senate,"Do Pass",9,0,0,0,9
1901522,1493763,2025-02-19,Senate,"Do Pass",32,2,0,1,35
1901522,1503958,2025-03-03,House,"Referred to",12,1,0,0,13
1901522,1505757,2025-03-05,House,"Do Pass",8,0,0,1,9
1901522,1508124,2025-03-06,House,"Do Pass",62,7,0,1,70
1901524,1477337,2025-01-30,House,"Do Pass",12,1,0,0,13
1901524,1479007,2025-02-03,House,"Do Pass",54,14,0,0,68
1901524,1503123,2025-03-03,Senate,"Do Pass",7,0,0,0,7
1901524,1504919,2025-03-04,Senate,"Do Pass",24,11,0,0,35
1901527,1475107,2025-01-27,House,"Referred as Amended to",12,1,0,0,13
1901527,1480695,2025-02-05,Joint,"Referred to",14,0,0,3,17
1901527,1497475,2025-02-24,House,"Do Pass",5,4,0,0,9
1901527,1499613,2025-02-25,House,"Do Pass Amended",31,39,0,0,70
1901531,1475741,2025-01-28,Senate,"Do Pass",7,2,0,0,9
1901531,1484777,2025-02-10,Senate,"Do Pass",5,4,0,0,9
1901531,1487223,2025-02-11,Senate,"Do Pass",21,13,0,1,35
1901531,1488495,2025-02-12,Senate,"Do Pass",25,10,0,0,35
1901531,1500383,2025-02-26,House,"Referred to",11,2,0,0,13
1901531,1503092,2025-03-03,House,"Do Pass",9,0,0,0,9
1901531,1504776,2025-03-04,House,"Do Pass",54,16,0,0,70
1901534,1484711,2025-02-10,Senate,"Do Pass",6,3,0,0,9
1901534,1487210,2025-02-11,Senate,"Do Pass",20,14,0,1,35
1901534,1488519,2025-02-12,Senate,Reconsidered,33,2,0,0,35
1901534,1488520,2025-02-12,Senate,"Do Pass",31,4,0,0,35
1901534,1500803,2025-02-26,House,"Referred to",8,4,0,1,13
1901534,1503929,2025-03-03,House,"Do Pass",8,1,0,0,9
1901534,1505103,2025-03-04,House,"Do Pass",58,12,0,0,70
1901540,1473228,2025-01-22,Senate,"Do Pass",7,0,0,0,7
1901540,1473915,2025-01-23,Senate,"Do Pass",34,0,0,1,35
1901540,1476319,2025-01-29,House,"Do Pass",13,0,0,0,13
1901540,1477946,2025-01-30,House,"Do Pass",66,0,0,2,68
1901543,1472597,2025-01-21,Senate,"Do Pass",7,0,0,0,7
1901543,1473243,2025-01-22,Senate,"Do Pass",31,4,0,0,35
1901543,1504352,2025-03-04,House,"Do Pass",11,2,0,0,13
1901543,1506721,2025-03-05,House,"Do Pass",43,27,0,0,70
1901546,1473568,2025-01-23,Senate,"Do Pass",6,0,0,1,7
1901546,1474428,2025-01-24,Senate,"Do Pass",35,0,0,0,35
1901546,1501104,2025-02-27,House,"Do Pass",13,0,0,0,13
1901546,1503496,2025-03-03,House,"Do Pass",68,1,0,1,70
1901549,1473246,2025-01-22,House,"Do Pass",13,0,0,0,13
1901549,1473927,2025-01-23,House,"Do Pass",69,0,0,0,69
1901549,1477544,2025-01-30,Senate,"Do Pass",7,0,0,0,7
1901549,1479182,2025-02-03,Senate,"Do Pass",35,0,0,0,35
1901555,1482649,2025-02-05,Senate,"Referred to",8,0,0,1,9
1901555,1499404,2025-02-25,Joint,"Do Pass Amended",13,4,0,1,18
1901555,1503457,2025-03-03,Senate,"Do Pass Amended",14,21,0,0,35
1901557,1472106,2025-01-17,Senate,"Motion to amend",7,0,0,0,7
1901557,1472107,2025-01-17,Senate,"Do Pass Amended",7,0,0,0,7
1901557,1473363,2025-01-22,Senate,"Do Pass Amended",35,0,0,0,35
1901557,1477272,2025-01-30,House,"Do Pass",13,0,0,0,13
1901557,1479114,2025-02-03,House,"Do Pass Amended",68,0,0,0,68
1901560,1476871,2025-01-29,Senate,"Deferred to the 41st legislative day",7,0,0,0,7
1901565,1473723,2025-01-23,Senate,"Do Pass Amended",9,0,0,0,9
1901565,1475628,2025-01-28,Senate,"Do Pass Amended",35,0,0,0,35
1901565,1483981,2025-02-07,House,"Motion to amend",6,5,0,2,13
1901565,1485028,2025-02-10,House,"Deferred to another day",10,2,0,1,13
1901565,1487685,2025-02-12,House,"Do Pass Amended",10,0,0,3,13
1901565,1492646,2025-02-18,House,"Do Pass Amended",65,5,0,0,70
1901565,1500263,2025-02-26,Joint,"Motion to amend",6,0,0,0,6
1901565,1500264,2025-02-26,Joint,"Conference Committee Report adopted",6,0,0,0,6
1901565,1503402,2025-03-03,House,"Conference Committee Report adopted",68,1,0,1,70
1901565,1503752,2025-03-03,Senate,"Conference Committee Report adopted",34,1,0,0,35
1901567,1472593,2025-01-21,House,"Do Pass",12,0,0,1,13
1901567,1473357,2025-01-22,House,"Do Pass",66,0,0,3,69
1901567,1482466,2025-02-05,Senate,"Do Pass",4,0,0,3,7
1901567,1483525,2025-02-06,Senate,"Do Pass",35,0,0,0,35
1901572,1476109,2025-01-29,House,"Do Pass",8,4,0,1,13
1901572,1477353,2025-01-30,House,"Do Pass",42,24,0,2,68
1901572,1499895,2025-02-26,Senate,"Do Pass",7,2,0,0,9
1901572,1504880,2025-03-04,Senate,"Do Pass",25,10,0,0,35
1901575,1475409,2025-01-28,Senate,"Do Pass",8,1,0,0,9
1901575,1484601,2025-02-10,Senate,"Do Pass",7,2,0,0,9
1901575,1486826,2025-02-11,Senate,"Do Pass",28,6,0,1,35
1901575,1500139,2025-02-26,House,"Referred to",10,1,0,2,13
1901575,1505935,2025-03-05,House,"Do Pass",8,0,0,1,9
1901575,1507783,2025-03-06,House,"Do Pass",56,13,0,1,70
1901577,1471912,2025-01-16,Senate,"Do Pass",9,0,0,0,9
1901577,1472134,2025-01-17,Senate,"Do Pass",34,0,0,1,35
1901577,1476227,2025-01-29,House,"Do Pass",8,5,0,0,13
1901577,1477352,2025-01-30,House,"Do Pass",52,14,0,2,68
1901583,1473541,2025-01-23,Senate,"Do Pass",6,1,0,0,7
1901583,1474403,2025-01-24,Senate,"Do Pass",33,2,0,0,35
1901583,1500090,2025-02-26,House,"Do Pass",13,0,0,0,13
1901583,1503554,2025-03-03,House,"Do Pass",69,0,0,1,70
1901585,1475241,2025-01-28,Senate,"Do Pass Amended",7,0,0,0,7
1901585,1477438,2025-01-30,Senate,"Do Pass Amended",33,2,0,0,35
1901585,1501117,2025-02-27,House,"Do Pass",6,7,0,0,13
1901585,1501118,2025-02-27,House,"Deferred to the 41st legislative day",7,6,0,0,13
1901585,1504267,2025-03-04,House,"Do Pass Amended",13,0,0,0,13
1901585,1505652,2025-03-04,House,Reconsidered,13,0,0,0,13
1901585,1507659,2025-03-06,House,"Do Pass Amended",67,2,0,1,70
1901585,1514891,2025-03-11,Senate,"Concurred in amendments",34,0,0,1,35
1901591,1474044,2025-01-23,Senate,Tabled,7,0,0,0,7
1901594,1491802,2025-02-18,Senate,Tabled,5,2,0,0,7
1901597,1477898,2025-01-30,Senate,"Do Pass",8,0,0,1,9
1901597,1479275,2025-02-03,Senate,"Do Pass",35,0,0,0,35
1901597,1484285,2025-02-07,House,"Do Pass",12,0,0,1,13
1901597,1485566,2025-02-10,House,"Do Pass",64,4,0,1,69
1901602,1492119,2025-02-18,House,Tabled,8,0,0,1,9
1901605,1479604,2025-02-04,Senate,"Do Pass",9,0,0,0,9
1901605,1491731,2025-02-18,Senate,"Do Pass",9,0,0,0,9
1901605,1493576,2025-02-19,Senate,"Do Pass",34,0,0,1,35
1901605,1503865,2025-03-03,House,"Referred to",13,0,0,0,13
1901605,1506695,2025-03-05,House,"Do Pass",7,0,0,2,9
1901605,1508219,2025-03-06,House,"Do Pass",65,4,0,1,70
1901607,1473069,2025-01-22,Senate,"Do Pass Amended",6,0,0,1,7
1901607,1474986,2025-01-27,Senate,"Do Pass Amended",34,0,0,1,35
1901607,1478702,2025-02-03,House,"Deferred to another day",7,6,0,0,13
1901607,1480517,2025-02-05,House,"Deferred to the 41st legislative day",10,2,0,1,13
1901612,1473319,2025-01-22,Senate,"Do Pass",7,0,0,0,7
1901612,1474006,2025-01-23,Senate,"Do Pass",34,0,0,1,35
1901612,1477521,2025-01-30,House,"Do Pass",12,0,0,1,13
1901612,1479313,2025-02-03,House,"Do Pass",68,0,0,0,68
1901618,1472230,2025-01-17,House,"Do Pass",11,2,0,0,13
1901618,1472846,2025-01-21,House,"Do Pass",59,7,0,3,69
1901618,1500251,2025-02-26,Senate,"Do Pass",7,1,0,1,9
1901618,1504096,2025-03-03,Senate,"Do Pass",31,3,0,1,35
1901619,1474450,2025-01-24,Senate,"Do Pass",7,2,0,0,9
1901619,1475088,2025-01-27,Senate,"Do Pass Amended",26,8,0,1,35
1901619,1499796,2025-02-26,House,"Deferred to the 41st legislative day",7,5,0,1,13
1901624,1475093,2025-01-27,House,"Do Pass",12,1,0,0,13
1901624,1475682,2025-01-28,House,"Do Pass",68,1,0,0,69
1901624,1505018,2025-03-04,Senate,"Do Pass",7,0,0,2,9
1901624,1506764,2025-03-05,Senate,"Do Pass",34,0,0,1,35
1901627,1484009,2025-02-07,Joint,"Do Pass",17,0,0,1,18
1901627,1485194,2025-02-10,Senate,"Do Pass",33,1,0,1,35
1901627,1492647,2025-02-18,House,"Do Pass",62,8,0,0,70
1901632,1475670,2025-01-28,Senate,"Do Pass",7,2,0,0,9
1901632,1485479,2025-02-10,Senate,"Do Pass",6,3,0,0,9
1901632,1486913,2025-02-11,Senate,"Do Pass",22,12,0,1,35
1901632,1487954,2025-02-12,Senate,Reconsidered,34,1,0,0,35
1901632,1487955,2025-02-12,Senate,"Do Pass",27,8,0,0,35
1901632,1500882,2025-02-26,House,"Referred to",7,5,0,1,13
1901632,1503098,2025-03-03,House,"Do Pass",9,0,0,0,9
1901632,1504632,2025-03-04,House,"Do Pass",55,15,0,0,70
1901635,1473611,2025-01-23,Senate,"Do Pass",6,0,0,1,7
1901635,1474329,2025-01-24,Senate,"Do Pass",35,0,0,0,35
1901635,1477085,2025-01-30,House,"Do Pass",13,0,0,0,13
1901635,1479061,2025-02-03,House,"Do Pass",68,0,0,0,68
1901640,1475319,2025-01-28,Senate,"Do Pass",7,0,0,0,7
1901640,1476452,2025-01-29,Senate,"Do Pass",35,0,0,0,35
1901640,1498595,2025-02-25,House,"Do Pass",13,0,0,0,13
1901640,1500023,2025-02-26,House,"Do Pass",70,0,0,0,70
1901642,1474459,2025-01-24,Senate,"Do Pass",6,3,0,0,9
1901642,1476001,2025-01-28,Senate,"Do Pass Amended",18,17,0,0,35
1901642,1500542,2025-02-26,House,"Do Pass Amended",4,8,0,1,13
1901642,1500543,2025-02-26,House,"Deferred to the 41st legislative day",9,3,0,1,13
1905318,1484096,2025-02-07,Senate,"Referred to",7,0,0,0,7
1905318,1501238,2025-02-27,Joint,"Do Pass Amended",15,3,0,0,18
1905318,1503838,2025-03-03,Senate,"Do Pass Amended",22,13,0,0,35
1905318,1506934,2025-03-05,House,"Do Pass Amended",57,13,0,0,70
1905405,1477558,2025-01-30,Senate,"Do Pass",9,0,0,0,9
1905405,1479343,2025-02-03,Senate,"Do Pass",35,0,0,0,35
1905405,1487406,2025-02-12,House,"Do Pass",11,0,0,2,13
1905405,1489814,2025-02-13,House,"Do Pass",63,6,0,0,69
1905490,1498294,2025-02-24,Senate,Tabled,8,1,0,0,9
1905579,1474481,2025-01-24,Senate,"Do Pass",6,0,0,1,7
1905579,1484938,2025-02-10,Senate,"Do Pass",9,0,0,0,9
1905579,1486394,2025-02-11,Senate,"Do Pass",33,1,0,1,35
1905579,1499051,2025-02-25,House,"Do Pass",10,1,0,2,13
1905579,1500303,2025-02-26,House,"Do Pass",67,2,0,1,70
1905664,1472532,2025-01-17,Senate,"Do Pass",8,1,0,0,9
1905664,1472687,2025-01-21,Senate,"Do Pass",23,9,0,3,35
1905664,1478668,2025-02-03,House,"Do Pass",8,5,0,0,13
1905664,1479924,2025-02-04,House,"Do Pass",29,38,0,1,68
1905750,1474407,2025-01-24,Senate,"Do Pass",6,0,0,1,7
1905750,1475148,2025-01-27,Senate,"Do Pass",34,0,0,1,35
1905750,1479417,2025-02-04,House,"Do Pass",13,0,0,0,13
1905750,1482224,2025-02-05,House,"Do Pass",65,2,0,1,68
1905839,1496213,2025-02-21,Joint,"Do Pass",16,0,0,2,18
1905839,1498145,2025-02-24,Senate,"Do Pass",35,0,0,0,35
1905839,1500655,2025-02-26,House,"Do Pass",69,1,0,0,70
1905924,1474196,2025-01-24,Senate,"Do Pass",7,0,0,0,7
1905924,1474955,2025-01-27,Senate,"Do Pass",34,0,0,1,35
1905924,1479453,2025-02-04,House,"Do Pass",13,0,0,0,13
1905924,1482408,2025-02-05,House,"Do Pass",65,2,0,1,68
1907247,1473405,2025-01-22,House,"Do Pass",4,0,0,1,5
1907247,1475122,2025-01-27,House,"Do Pass",68,0,0,1,69
1907247,1482887,2025-02-05,Senate,"Do Pass",4,0,0,1,5
1907247,1484390,2025-02-07,Senate,"Do Pass",35,0,0,0,35
1907262,1473421,2025-01-22,House,"Do Pass",4,0,0,1,5
1907262,1475161,2025-01-27,House,"Do Pass",68,0,0,1,69
1907262,1482714,2025-02-05,Senate,"Do Pass",4,0,0,1,5
1907262,1484341,2025-02-07,Senate,"Do Pass",35,0,0,0,35
1907279,1473948,2025-01-23,House,"Do Pass Amended",2,11,0,0,13
1907279,1473949,2025-01-23,House,"Deferred to the 41st legislative day",12,1,0,0,13
1907297,1473791,2025-01-23,House,"Do Pass",13,0,0,0,13
1907297,1475173,2025-01-27,House,"Do Pass",68,0,0,1,69
1907297,1484539,2025-02-07,Senate,"Do Pass",7,0,0,0,7
1907297,1485419,2025-02-10,Senate,"Do Pass",34,0,0,1,35
1907313,1493149,2025-02-19,House,"Do Pass",2,9,0,2,13
1907313,1493150,2025-02-19,House,"Deferred to the 41st legislative day",10,1,0,2,13
1907331,1487330,2025-02-12,House,"Referred to",12,1,0,0,13
1907331,1492666,2025-02-18,House,"Referred to",8,0,0,1,9
1907331,1494855,2025-02-20,Joint,"Report out of committee without recommendation",18,0,0,0,18
1907331,1496975,2025-02-21,House,"Placed on calendar pursuant to JR 6F-6",50,19,0,1,70
1907331,1496976,2025-02-21,House,"Motion to amend",37,32,0,1,70
1907331,1496977,2025-02-21,House,"Do Pass Amended",34,35,0,1,70
1907331,1497783,2025-02-24,House,Reconsidered,35,35,0,0,70
1907349,1473416,2025-01-22,House,"Do Pass",4,0,0,1,5
1907349,1475212,2025-01-27,House,"Do Pass",68,0,0,1,69
1907349,1482656,2025-02-05,Senate,"Do Pass",4,0,0,1,5
1907349,1484311,2025-02-07,Senate,"Do Pass",35,0,0,0,35
1907369,1476217,2025-01-29,House,"Deferred to the 41st legislative day",9,6,0,0,15
1907383,1479568,2025-02-04,Senate,"Do Pass",5,2,0,2,9
1907383,1482300,2025-02-05,Senate,"Do Pass",17,16,0,2,35
1907383,1483400,2025-02-06,Senate,Reconsidered,17,18,0,0,35
1907401,1486513,2025-02-11,House,"Do Pass",9,0,0,0,9
1907401,1489825,2025-02-13,House,"Do Pass",46,22,0,1,69
1907401,1492634,2025-02-18,House,Reconsidered,63,7,0,0,70
1907401,1492635,2025-02-18,House,"Do Pass",63,7,0,0,70
1907401,1499415,2025-02-25,Senate,"Do Pass",8,0,0,1,9
1907401,1501366,2025-02-27,Senate,"Do Pass",32,2,0,1,35
1907418,1477198,2025-01-30,House,"Deferred to the 41st legislative day",9,4,0,0,13
1907418,1479437,2025-02-04,House,Reconsidered,13,0,0,0,13
1907418,1479438,2025-02-04,House,"Referred as Amended to",7,6,0,0,13
1907418,1484689,2025-02-10,House,"Do Pass",8,0,0,1,9
1907418,1486494,2025-02-11,House,"Do Pass Amended",47,21,0,1,69
1907418,1498794,2025-02-25,Senate,"Referred to",5,0,0,2,7
1907418,1503115,2025-03-03,Senate,"Do Pass",6,3,0,0,9
1907418,1504873,2025-03-04,Senate,"Do Pass Amended",23,12,0,0,35
1907439,1475468,2025-01-27,House,"Do Pass Amended",8,7,0,0,15
1907439,1477735,2025-01-30,House,"Do Pass Amended",34,32,0,2,68
1907439,1479350,2025-02-03,House,Reconsidered,35,33,0,0,68
1907454,1473253,2025-01-22,House,"Do Pass",9,4,0,0,13
1907454,1473923,2025-01-23,House,"Do Pass",38,31,0,0,69
1907454,1498710,2025-02-25,Senate,"Deferred to the 41st legislative day",4,3,0,0,7
1907470,1473745,2025-01-23,House,"Do Pass",13,0,0,0,13
1907470,1474952,2025-01-27,House,"Do Pass",68,0,0,1,69
1907470,1484552,2025-02-07,Senate,"Do Pass",7,0,0,0,7
1907470,1485330,2025-02-10,Senate,"Do Pass",34,0,0,1,35
1907489,1473399,2025-01-22,House,"Do Pass",4,0,0,1,5
1907489,1475041,2025-01-27,House,"Do Pass",68,0,0,1,69
1907489,1482469,2025-02-05,Senate,"Do Pass",4,0,0,1,5
1907489,1484458,2025-02-07,Senate,"Do Pass",35,0,0,0,35
1907506,1472539,2025-01-21,House,"Do Pass",13,0,0,0,13
1907506,1473677,2025-01-23,House,"Do Pass",69,0,0,0,69
1907506,1477364,2025-01-30,Senate,"Do Pass",7,0,0,0,7
1907506,1478880,2025-02-03,Senate,"Do Pass",35,0,0,0,35
1907520,1475329,2025-01-28,House,"Referred to",11,2,0,0,13
1907520,1496296,2025-02-21,Joint,"Do Pass",17,0,0,1,18
1907520,1497762,2025-02-24,House,"Do Pass",70,0,0,0,70
1907520,1501495,2025-02-27,Senate,"Do Pass",32,2,0,1,35
1907533,1493055,2025-02-19,Senate,"Deferred to the 41st legislative day",7,1,0,1,9
1908262,1497292,2025-02-24,House,"Do Pass Amended",9,0,0,0,9
1908262,1499688,2025-02-25,House,"Do Pass Amended",63,7,0,0,70
1908262,1503091,2025-03-03,Senate,"Do Pass",7,2,0,0,9
1908262,1505262,2025-03-04,Senate,"Do Pass Amended",26,9,0,0,35
1908291,1474349,2025-01-24,Joint,"Do Pass",15,0,0,3,18
1908291,1474949,2025-01-27,House,"Do Pass",68,0,0,1,69
1908291,1480412,2025-02-04,Senate,"Do Pass",35,0,0,0,35
1908321,1476337,2025-01-29,Senate,"Referred as Amended to",5,2,0,0,7
1908321,1480844,2025-02-05,Joint,"Referred to",14,0,0,3,17
1908321,1492506,2025-02-18,Senate,"Do Pass Amended",5,3,0,1,9
1908321,1495406,2025-02-20,Senate,"Do Pass Amended",21,14,0,0,35
1908321,1505258,2025-03-04,House,"Do Pass",7,1,0,1,9
1908321,1506794,2025-03-05,House,"Do Pass Amended",60,10,0,0,70
1908347,1479406,2025-02-03,House,"Referred to",9,3,0,1,13
1908347,1497379,2025-02-24,House,"Do Pass",9,0,0,0,9
1908347,1499277,2025-02-25,House,"Do Pass",0,70,0,0,70
1908380,1482167,2025-02-05,Senate,"Referred to",8,0,0,1,9
1908380,1501243,2025-02-27,Joint,"Do Pass Amended",18,0,0,0,18
1908380,1503627,2025-03-03,Senate,"Do Pass Amended",35,0,0,0,35
1908380,1506632,2025-03-05,House,"Do Pass Amended",68,1,0,1,70
1908408,1478685,2025-02-03,Senate,Tabled,8,0,0,1,9
1908436,1482637,2025-02-05,Senate,"Referred to",4,0,0,1,5
1908436,1496903,2025-02-21,Joint,"Do Pass",16,0,0,2,18
1908436,1498131,2025-02-24,Senate,"Do Pass",35,0,0,0,35
1908436,1500166,2025-02-26,House,"Do Pass",69,0,0,1,70
1908468,1480771,2025-02-05,House,"Referred to",13,0,0,2,15
1908468,1501190,2025-02-27,Joint,"Do Pass Amended",16,2,0,0,18
1908468,1503519,2025-03-03,House,"Do Pass Amended",61,8,0,1,70
1908468,1506066,2025-03-05,Senate,"Do Pass Amended",34,0,0,1,35
1908496,1475889,2025-01-27,House,"Do Pass",15,0,0,0,15
1908496,1488074,2025-02-12,Joint,"Do Pass Amended",15,0,0,3,18
1908496,1492636,2025-02-18,House,"Do Pass Amended",68,2,0,0,70
1908496,1496959,2025-02-21,Senate,"Do Pass Amended",32,1,0,2,35
1908526,1496744,2025-02-21,House,"Do Pass",8,0,0,1,9
1908526,1498471,2025-02-24,House,"Do Pass",53,17,0,0,70
1908526,1503083,2025-03-03,Senate,"Do Pass",9,0,0,0,9
1908526,1505261,2025-03-04,Senate,"Do Pass",31,4,0,0,35
1908548,1475244,2025-01-27,House,"Referred to",14,1,0,0,15
1908548,1482163,2025-02-05,Joint,"Referred to",14,0,0,3,17
1908548,1497408,2025-02-24,House,"Do Pass",6,3,0,0,9
1908548,1499325,2025-02-25,House,"Do Pass",56,14,0,0,70
1908548,1504272,2025-03-04,Senate,"Deferred to the 41st legislative day",4,3,0,0,7
1908548,1507687,2025-03-06,Senate,"Placed on calendar pursuant to JR 6F-6",23,11,0,1,35
1908548,1507688,2025-03-06,Senate,"Do Pass",23,11,0,1,35
1908577,1480724,2025-02-05,House,"Referred to",11,4,0,0,15
1908577,1496382,2025-02-21,Joint,Tabled,16,0,0,2,18
1908603,1514258,2025-03-11,Joint,"Do Pass Amended",16,1,0,1,18
1908603,1517114,2025-03-13,Senate,"Do Pass Amended",33,2,0,0,35
1908603,1517115,2025-03-13,House,"Do Pass Amended",58,12,0,0,70
1908628,1474369,2025-01-24,Joint,"Do Pass",15,0,0,3,18
1908628,1474967,2025-01-27,House,"Do Pass",68,0,0,1,69
1908628,1480095,2025-02-04,Senate,"Do Pass",35,0,0,0,35
1908661,1473480,2025-01-23,Senate,"Do Pass",4,3,0,0,7
1908661,1475677,2025-01-28,Senate,"Do Pass Amended",18,17,0,0,35
1908661,1484033,2025-02-07,House,"Do Pass",8,7,0,0,15
1908661,1485222,2025-02-10,House,"Motion to amend",42,26,0,1,69
1908661,1485223,2025-02-10,House,"Do Pass Amended",31,37,0,1,69
1908689,1475503,2025-01-27,House,"Referred to",9,6,0,0,15
1908689,1482699,2025-02-05,Joint,"Referred to",14,0,0,3,17
1908689,1497294,2025-02-24,House,"Do Pass Amended",8,1,0,0,9
1908689,1499676,2025-02-25,House,"Do Pass Amended",66,4,0,0,70
1908689,1504772,2025-03-04,Senate,"Referred to",6,0,0,1,7
1908689,1507124,2025-03-06,Senate,"Do Pass",9,0,0,0,9
1908689,1511360,2025-03-10,Senate,"Do Pass Amended",30,2,0,3,35
1908713,1475877,2025-01-28,House,"Deferred to the 41st legislative day",8,5,0,0,13
1908713,1489979,2025-02-13,House,Reconsidered,12,0,0,1,13
1908713,1492058,2025-02-18,House,"Referred to",11,0,0,2,13
1908713,1496482,2025-02-21,House,Tabled,7,1,0,1,9
1911912,1483164,2025-02-06,Senate,"Do Pass",7,0,0,0,7
1911912,1484220,2025-02-07,Senate,"Do Pass",35,0,0,0,35
1911912,1503212,2025-03-03,House,"Do Pass",12,0,0,1,13
1911912,1504608,2025-03-04,House,"Do Pass",70,0,0,0,70
1911934,1473825,2025-01-23,House,"Deferred to the 41st legislative day",9,4,0,0,13
1911962,1483229,2025-02-06,Senate,"Do Pass Amended",7,0,0,0,7
1911962,1485401,2025-02-10,Senate,"Do Pass Amended",31,3,0,1,35
1911962,1503193,2025-03-03,House,"Do Pass",3,9,0,1,13
1911962,1503194,2025-03-03,House,"Deferred to the 41st legislative day",9,3,0,1,13
1911990,1477848,2025-01-30,Senate,"Do Pass",5,4,0,0,9
1911990,1479243,2025-02-03,Senate,"Do Pass",14,21,0,0,35
1912018,1473874,2025-01-23,House,"Do Pass",13,0,0,0,13
1912018,1475058,2025-01-27,House,"Do Pass",68,0,0,1,69
1912018,1496662,2025-02-21,Senate,"Do Pass",7,0,0,0,7
1912018,1498320,2025-02-24,Senate,"Do Pass",35,0,0,0,35
1912047,1478746,2025-02-03,Senate,"Do Pass Amended",8,0,0,1,9
1912047,1482961,2025-02-05,Senate,"Do Pass Amended",32,1,0,2,35
1912047,1499954,2025-02-26,House,"Do Pass Amended",12,1,0,0,13
1912047,1499955,2025-02-26,House,Reconsidered,13,0,0,0,13
1912047,1499956,2025-02-26,House,"Do Pass Amended",11,2,0,0,13
1912047,1503604,2025-03-03,House,"Do Pass Amended",60,9,0,1,70
1912073,1514340,2025-03-11,Joint,"Do Pass Amended",11,7,0,0,18
1912073,1517182,2025-03-13,House,"Do Pass Amended",64,6,0,0,70
1912073,1517183,2025-03-13,Senate,"Do Pass Amended",31,3,0,1,35
1912103,1486988,2025-02-11,Senate,"Do Pass Amended",5,1,0,1,7
1912103,1492759,2025-02-18,Senate,"Do Pass Amended",33,2,0,0,35
1912103,1500546,2025-02-26,House,"Do Pass",13,0,0,0,13
1912103,1503356,2025-03-03,House,"Motion to amend",38,31,0,1,70
1912103,1503357,2025-03-03,House,"Do Pass Amended",66,3,0,1,70
1912103,1506886,2025-03-05,Senate,"Concurred in amendments",20,14,0,1,35
1912128,1483629,2025-02-06,Senate,"Do Pass Amended",6,0,0,1,7
1912128,1485210,2025-02-10,Senate,"Do Pass Amended",34,0,0,1,35
1912128,1503926,2025-03-03,House,"Do Pass",10,2,0,1,13
1912128,1505036,2025-03-04,House,"Do Pass Amended",47,23,0,0,70
1912156,1489300,2025-02-13,Joint,"Do Pass Amended",11,0,0,7,18
1912156,1493530,2025-02-19,Senate,"Do Pass Amended",34,0,0,1,35
1912156,1498470,2025-02-24,House,"Do Pass",51,19,0,0,70
1912185,1475748,2025-01-28,Senate,"Do Pass Amended",7,0,0,0,7
1912185,1477645,2025-01-30,Senate,"Do Pass Amended",33,2,0,0,35
1912185,1505820,2025-03-05,House,"Do Pass",11,1,0,1,13
1912185,1508022,2025-03-06,House,"Do Pass Amended",63,6,0,1,70
1912212,1473544,2025-01-23,Senate,"Do Pass Amended",9,0,0,0,9
1912212,1475211,2025-01-27,Senate,"Do Pass Amended",34,0,0,1,35
1912212,1501000,2025-02-26,House,"Do Pass",13,0,0,0,13
1912212,1503605,2025-03-03,House,"Do Pass Amended",68,1,0,1,70
1912240,1477501,2025-01-30,Joint,"Do Pass Amended",17,0,0,0,17
1912240,1480098,2025-02-04,House,"Do Pass Amended",67,0,0,1,68
1912240,1487113,2025-02-11,Senate,"Do Pass Amended",34,0,0,1,35
1912268,1486080,2025-02-11,Senate,"Do Pass Amended",6,0,0,1,7
1912268,1489836,2025-02-13,Senate,"Do Pass Amended",35,0,0,0,35
1912268,1500136,2025-02-26,House,"Do Pass",13,0,0,0,13
1912268,1501475,2025-02-27,House,"Do Pass Amended",70,0,0,0,70
1912297,1475186,2025-01-27,Senate,"Do Pass Amended",9,0,0,0,9
1912297,1482953,2025-02-05,Senate,"Do Pass Amended",16,17,0,2,35
1912297,1483291,2025-02-06,Senate,Reconsidered,33,2,0,0,35
1912297,1483292,2025-02-06,Senate,"Do Pass Amended",35,0,0,0,35
1912297,1499975,2025-02-26,House,"Do Pass",13,0,0,0,13
1912297,1501514,2025-02-27,House,"Do Pass Amended",70,0,0,0,70
1912325,1476152,2025-01-29,Senate,"Do Pass",5,4,0,0,9
1912325,1479048,2025-02-03,Senate,"Do Pass Amended",32,3,0,0,35
1912325,1503489,2025-03-03,House,"Do Pass Amended",12,1,0,0,13
1912325,1507885,2025-03-06,House,"Do Pass Amended",63,6,0,1,70
1912325,1515716,2025-03-12,Joint,"Motion to amend",6,0,0,0,6
1912325,1515717,2025-03-12,Joint,"Conference Committee Report adopted",6,0,0,0,6
1912325,1516185,2025-03-12,House,"Conference Committee Report adopted",66,4,0,0,70
1912325,1516186,2025-03-12,Senate,"Conference Committee Report adopted",32,2,0,1,35
1914807,1472097,2025-01-17,House,"Do Pass Amended",11,2,0,0,13
1914807,1473189,2025-01-22,House,"Do Pass Amended",61,5,0,3,69
1914807,1507406,2025-03-06,Senate,"Do Pass",6,1,0,2,9
1914807,1509554,2025-03-10,Senate,"Do Pass Amended",29,4,0,2,35
1914809,1473994,2025-01-23,Senate,"Do Pass Amended",9,0,0,0,9
1914809,1475208,2025-01-27,Senate,"Do Pass Amended",34,0,0,1,35
1914809,1500657,2025-02-26,House,"Do Pass",12,0,0,1,13
1914809,1501867,2025-02-27,House,"Do Pass Amended",65,4,0,1,70
1914809,1505550,2025-03-04,Senate,"Concurred in amendments",35,0,0,0,35
1914812,1474878,2025-01-27,House,"Deferred to the 41st legislative day",13,0,0,0,13
1917815,1474263,2025-01-24,Senate,"Do Pass Amended",6,0,0,1,7
1917815,1477448,2025-01-30,Senate,"Adopt Resolution as amended",35,0,0,0,35
1917815,1483072,2025-02-06,House,"Do Pass",13,0,0,0,13
1917815,1484088,2025-02-07,House,"Concurred in Resolution",67,0,0,2,69
1917985,1475911,2025-01-28,Senate,"Do Pass",6,1,0,0,7
1917985,1495648,2025-02-20,Senate,"Do Pass Amended",5,3,0,1,9
1917985,1498508,2025-02-24,Senate,"Do Pass Amended",27,8,0,0,35
1917985,1505746,2025-03-05,House,"Referred to",15,0,0,0,15
1917985,1508025,2025-03-06,House,"Do Pass",9,0,0,0,9
1917985,1511533,2025-03-10,House,"Do Pass Amended",69,0,0,1,70
1918155,1483709,2025-02-06,House,"Deferred to the 41st legislative day",7,6,0,0,13
1918323,1473120,2025-01-22,House,"Do Pass",13,0,0,0,13
1918323,1473743,2025-01-23,House,"Do Pass",69,0,0,0,69
1918323,1477443,2025-01-30,Senate,"Do Pass",7,0,0,0,7
1918323,1479335,2025-02-03,Senate,"Do Pass",35,0,0,0,35
1918488,1475634,2025-01-28,Senate,"Do Pass Amended",5,2,0,0,7
1918488,1477456,2025-01-30,Senate,"Do Pass Amended",34,1,0,0,35
1918488,1496180,2025-02-21,House,"Do Pass",13,2,0,0,15
1918488,1496376,2025-02-21,House,Reconsidered,8,7,0,0,15
1918488,1497837,2025-02-24,House,"Do Pass",61,9,0,0,70
1918491,1474225,2025-01-24,House,"Do Pass",10,3,0,0,13
1918491,1474969,2025-01-27,House,"Do Pass",49,19,0,1,69
1918491,1503479,2025-03-03,Senate,"Do Pass",7,2,0,0,9
1918491,1505008,2025-03-04,Senate,"Do Pass",23,12,0,0,35
1918778,1473241,2025-01-22,House,"Do Pass Amended",13,0,0,0,13
1918778,1475184,2025-01-27,House,"Do Pass Amended",68,0,0,1,69
1918778,1500206,2025-02-26,Senate,"Do Pass",5,3,0,1,9
1918778,1502073,2025-02-27,Senate,"Do Pass Amended",24,10,0,1,35
1919133,1472112,2025-01-17,House,"Do Pass",11,2,0,0,13
1919133,1472617,2025-01-21,House,"Do Pass Amended",61,5,0,3,69
1919133,1491858,2025-02-18,Senate,"Do Pass",7,0,0,0,7
1919133,1493796,2025-02-19,Senate,"Do Pass Amended",34,0,0,1,35
1919199,1476224,2025-01-29,Senate,"Motion to amend",7,0,0,0,7
1919199,1476225,2025-01-29,Senate,"Do Pass Amended",7,0,0,0,7
1919199,1479962,2025-02-04,Senate,"Do Pass Amended",35,0,0,0,35
1919199,1494885,2025-02-20,House,"Do Pass",12,0,0,1,13
1919199,1496619,2025-02-21,House,"Do Pass",65,3,0,2,70
1919264,1474234,2025-01-24,Senate,"Deferred to the 41st legislative day",7,2,0,0,9
1919264,1496640,2025-02-21,Senate,Reconsidered,8,0,0,1,9
1919264,1497470,2025-02-24,Senate,"Do Pass Amended",6,3,0,0,9
1919264,1499464,2025-02-25,Senate,"Do Pass Amended",32,3,0,0,35
1919264,1504440,2025-03-04,House,"Do Pass Amended",12,0,0,1,13
1919264,1508178,2025-03-06,House,"Do Pass Amended",69,0,0,1,70
1919264,1514893,2025-03-11,Senate,"Concurred in amendments",32,3,0,0,35
1919295,1478661,2025-02-03,House,"Do Pass Amended",10,5,0,0,15
1919295,1482626,2025-02-05,House,"Do Pass Amended",18,49,0,1,68
1919312,1475391,2025-01-28,House,"Do Pass",5,8,0,0,13
1919312,1475392,2025-01-28,House,"Deferred to the 41st legislative day",8,5,0,0,13
1919336,1472558,2025-01-21,House,"Do Pass",12,0,0,1,13
1919336,1473425,2025-01-22,House,"Do Pass Amended",66,0,0,3,69
1919336,1487374,2025-02-12,Senate,"Do Pass",6,0,0,1,7
1919336,1489459,2025-02-13,Senate,"Do Pass Amended",35,0,0,0,35
1919531,1473022,2025-01-22,Senate,"Do Pass Amended",6,0,0,1,7
1919531,1474426,2025-01-24,Senate,"Do Pass Amended",35,0,0,0,35
1919531,1477264,2025-01-30,House,"Do Pass",13,0,0,0,13
1919531,1478940,2025-02-03,House,"Do Pass Amended",68,0,0,0,68
1919731,1474236,2025-01-24,Senate,"Do Pass Amended",8,1,0,0,9
1919731,1475665,2025-01-28,Senate,"Do Pass Amended",32,3,0,0,35
1919731,1500998,2025-02-26,House,"Motion to amend",11,2,0,0,13
1919731,1500999,2025-02-26,House,"Do Pass Amended",11,2,0,0,13
1919731,1504497,2025-03-04,House,"Do Pass Amended",66,4,0,0,70
1919731,1507526,2025-03-06,Senate,"Concurred in amendments",31,2,0,2,35
1920109,1485574,2025-02-10,House,"Do Pass",8,0,0,1,9
1920109,1486928,2025-02-11,House,"Do Pass",68,0,0,1,69
1920109,1496206,2025-02-21,Senate,"Do Pass",7,1,0,1,9
1920109,1498459,2025-02-24,Senate,"Do Pass",35,0,0,0,35
1920238,1485886,2025-02-11,House,"Do Pass Amended",9,4,0,0,13
1920238,1489408,2025-02-13,House,"Do Pass Amended",24,44,0,1,69
1920371,1473617,2025-01-23,House,"Do Pass Amended",12,1,0,0,13
1920371,1474988,2025-01-27,House,"Do Pass Amended",68,0,0,1,69
1920371,1503331,2025-03-03,Senate,"Do Pass",9,0,0,0,9
1920371,1505230,2025-03-04,Senate,"Do Pass Amended",35,0,0,0,35
1920506,1474223,2025-01-24,House,"Deferred to the 41st legislative day",13,0,0,0,13
1920641,1477159,2025-01-30,House,"Do Pass Amended",12,1,0,0,13
1920641,1479920,2025-02-04,House,"Do Pass Amended",63,4,0,1,68
1920641,1505821,2025-03-05,Senate,"Do Pass",7,0,0,0,7
1920641,1507678,2025-03-06,Senate,"Do Pass Amended",34,0,0,1,35
1922161,1476136,2025-01-29,Senate,"Do Pass Amended",8,1,0,0,9
1922161,1478919,2025-02-03,Senate,"Do Pass Amended",33,2,0,0,35
1922161,1505825,2025-03-05,House,"Do Pass",12,1,0,0,13
1922161,1508142,2025-03-06,House,"Do Pass Amended",58,11,0,1,70
1922163,1475013,2025-01-27,House,"Do Pass Amended",9,3,0,1,13
1922163,1476729,2025-01-29,House,"Do Pass Amended",37,31,0,1,69
1922163,1504354,2025-03-03,Senate,"Deferred to the 41st legislative day",5,4,0,0,9
1922163,1509648,2025-03-10,Senate,"Placed on calendar pursuant to JR 6F-6",20,14,0,1,35
1922163,1509649,2025-03-10,Senate,"Do Pass Amended",20,12,0,3,35
1922163,1514546,2025-03-11,House,"Concurred in amendments",52,17,0,1,70
1923219,1487039,2025-02-11,House,"Do Pass",8,0,0,1,9
1923219,1487878,2025-02-12,House,"Do Pass",68,0,0,1,69
1923219,1496664,2025-02-21,Senate,"Do Pass",8,0,0,1,9
1923219,1498278,2025-02-24,Senate,"Do Pass",35,0,0,0,35
1923349,1475584,2025-01-28,House,"Deferred to the 41st legislative day",10,2,0,1,13
1923473,1473050,2025-01-22,House,"Do Pass Amended",7,6,0,0,13
1923473,1484640,2025-02-10,House,"Do Pass Amended",8,2,0,3,13
1923473,1489415,2025-02-13,House,"Do Pass Amended",47,22,0,0,69
1923473,1504565,2025-03-03,Senate,"Do Pass Amended",8,1,0,0,9
1923473,1509705,2025-03-10,Senate,"Do Pass Amended",23,11,0,1,35
1923473,1514692,2025-03-11,House,"Concurred in amendments",51,18,0,1,70
1923598,1483461,2025-02-06,House,"Do Pass",7,5,0,1,13
1923598,1485476,2025-02-10,House,"Do Pass Amended",57,11,0,1,69
1923598,1501103,2025-02-27,Senate,"Do Pass Amended",6,3,0,0,9
1923598,1505312,2025-03-04,Senate,"Motion to amend",19,15,0,1,35
1923598,1505313,2025-03-04,Senate,Tabled,27,7,0,1,35
1923720,1479414,2025-02-03,House,"Do Pass",12,0,0,1,13
1923720,1482536,2025-02-05,House,"Do Pass",65,2,0,1,68
1923720,1494771,2025-02-20,Senate,"Do Pass Amended",7,0,0,0,7
1923720,1497950,2025-02-24,Senate,"Do Pass Amended",35,0,0,0,35
1923720,1500186,2025-02-26,House,"Concurred in amendments",70,0,0,0,70
1923845,1476788,2025-01-29,Senate,"Do Pass",7,0,0,0,7
1923845,1477774,2025-01-30,Senate,"Do Pass",35,0,0,0,35
1923845,1501290,2025-02-27,House,"Do Pass",12,0,0,1,13
1923845,1503933,2025-03-03,House,"Do Pass",68,1,0,1,70
1923969,1473986,2025-01-23,House,"Deferred to the 41st legislative day",12,1,0,0,13
1924088,1475388,2025-01-28,Senate,"Do Pass",7,0,0,0,7
1924088,1476559,2025-01-29,Senate,"Do Pass",35,0,0,0,35
1924088,1501194,2025-02-27,House,"Do Pass",13,0,0,0,13
1924088,1503372,2025-03-03,House,"Do Pass",68,1,0,1,70
1924211,1474443,2025-01-24,House,"Do Pass",13,0,0,0,13
1924211,1475500,2025-01-27,House,"Do Pass",66,2,0,1,69
1924211,1500439,2025-02-26,Senate,"Do Pass",7,1,0,1,9
1924211,1501373,2025-02-27,Senate,"Do Pass",22,11,0,2,35
1924329,1474291,2025-01-24,Senate,"Do Pass",7,0,0,0,7
1924329,1475218,2025-01-27,Senate,"Do Pass",34,0,0,1,35
1924329,1501454,2025-02-27,House,"Do Pass",12,0,0,1,13
1924329,1503940,2025-03-03,House,"Do Pass",68,1,0,1,70
1926901,1478730,2025-02-03,House,"Do Pass",2,11,0,0,13
1926901,1478731,2025-02-03,House,"Deferred to the 41st legislative day",10,2,0,1,13
1927037,1475813,2025-01-28,Senate,"Do Pass",6,1,0,0,7
1927037,1476484,2025-01-29,Senate,"Do Pass",33,2,0,0,35
1927037,1498629,2025-02-25,House,"Do Pass",12,1,0,0,13
1927037,1500082,2025-02-26,House,"Do Pass",65,5,0,0,70
1927346,1475355,2025-01-28,Senate,"Do Pass Amended",8,1,0,0,9
1927346,1477385,2025-01-30,Senate,"Do Pass Amended",33,2,0,0,35
1927346,1484729,2025-02-10,House,"Do Pass",12,0,0,1,13
1927346,1486528,2025-02-11,House,"Do Pass Amended",68,0,0,1,69
1927509,1475377,2025-01-28,House,"Do Pass",12,0,0,1,13
1927509,1477459,2025-01-30,House,"Do Pass Amended",56,9,0,3,68
1927509,1487634,2025-02-12,Senate,"Do Pass",6,0,0,1,7
1927509,1489328,2025-02-13,Senate,"Do Pass Amended",35,0,0,0,35
1927676,1474219,2025-01-24,Senate,"Do Pass",7,0,0,0,7
1927676,1475172,2025-01-27,Senate,"Do Pass",34,0,0,1,35
1927676,1501041,2025-02-27,House,"Do Pass",12,0,0,1,13
1927676,1504109,2025-03-03,House,"Do Pass",68,1,0,1,70
1927840,1474309,2025-01-24,House,"Do Pass",14,0,0,1,15
1927840,1474884,2025-01-27,House,"Do Pass",67,1,0,1,69
1927840,1488785,2025-02-13,Senate,"Do Pass",6,0,0,1,7
1927840,1492386,2025-02-18,Senate,"Do Pass",35,0,0,0,35
1928007,1474242,2025-01-24,House,"Do Pass",14,0,0,1,15
1928007,1475160,2025-01-27,House,"Do Pass",67,1,0,1,69
1928007,1488617,2025-02-13,Senate,"Do Pass",6,0,0,1,7
1928007,1492907,2025-02-18,Senate,"Do Pass",35,0,0,0,35
1928169,1475102,2025-01-27,House,"Do Pass Amended",7,5,0,1,13
1928169,1476541,2025-01-29,House,"Do Pass Amended",40,28,0,1,69
1928169,1505291,2025-03-03,Senate,"Deferred to the 41st legislative day",5,4,0,0,9
1928333,1479817,2025-02-04,House,"Do Pass",9,3,0,1,13
1928333,1482431,2025-02-05,House,"Do Pass",54,13,0,1,68
1928333,1497222,2025-02-24,Senate,"Do Pass Amended",7,0,0,0,7
1928333,1501546,2025-02-27,Senate,"Do Pass Amended",32,3,0,0,35
1928333,1505006,2025-03-04,House,"Concurred in amendments",69,1,0,0,70
1929933,1496163,2025-02-20,House,"Do Pass",6,6,0,1,13
1929933,1496164,2025-02-20,House,"Report out of committee without recommendation as amended",7,5,0,1,13
1929933,1497862,2025-02-24,House,"Placed on calendar pursuant to JR 6F-6",30,40,0,0,70
1929958,1478988,2025-02-03,House,Tabled,15,0,0,0,15
1929959,1477807,2025-01-30,House,"Do Pass",6,7,0,0,13
1929959,1477808,2025-01-30,House,"Deferred to the 41st legislative day",7,6,0,0,13
1929960,1476568,2025-01-29,House,"Do Pass Amended",11,1,0,1,13
1929960,1479294,2025-02-03,House,"Do Pass Amended",53,15,0,0,68
1929960,1498701,2025-02-25,Senate,"Do Pass",7,0,0,2,9
1929960,1500759,2025-02-26,Senate,"Do Pass Amended",34,0,0,1,35
1929962,1478658,2025-02-03,House,"Do Pass Amended",13,0,0,0,13
1929962,1482666,2025-02-05,House,"Do Pass Amended",66,1,0,1,68
1929962,1498816,2025-02-25,Senate,"Do Pass",7,0,0,0,7
1929962,1500341,2025-02-26,Senate,"Do Pass Amended",34,0,0,1,35
1929963,1477086,2025-01-29,Senate,"Do Pass",3,1,0,1,5
1929963,1479014,2025-02-03,Senate,"Do Pass",6,29,0,0,35
1931711,1497381,2025-02-24,House,"Deferred to the 41st legislative day",7,2,0,0,9
1932404,1479482,2025-02-04,Senate,"Do Pass Amended",5,1,0,1,7
1932404,1483550,2025-02-06,Senate,"Do Pass Amended",18,17,0,0,35
1932404,1500131,2025-02-26,House,"Do Pass",5,8,0,0,13
1932404,1500132,2025-02-26,House,"Report out of committee without recommendation",10,3,0,0,13
1932404,1501579,2025-02-27,House,"Placed on calendar pursuant to JR 6F-6",49,21,0,0,70
1932404,1501580,2025-02-27,House,"Do Pass Amended",37,33,0,0,70
1933091,1476269,2025-01-29,House,"Deferred to the 41st legislative day",7,6,0,0,13
1933094,1475264,2025-01-28,House,Tabled,12,1,0,0,13
1933094,1494919,2025-02-20,House,"Removed from table",13,0,0,0,13
1933094,1494920,2025-02-20,House,"Do Pass Amended",13,0,0,0,13
1933094,1499340,2025-02-25,House,"Do Pass Amended",70,0,0,0,70
1933094,1504474,2025-03-04,Senate,"Do Pass",7,0,0,0,7
1933094,1506082,2025-03-05,Senate,"Do Pass Amended",34,0,0,1,35
1933939,1493187,2025-02-19,Senate,Tabled,7,0,0,0,7
1934036,1475751,2025-01-28,House,Tabled,13,0,0,0,13
1934139,1479188,2025-02-03,Senate,"Do Pass",7,0,0,0,7
1934139,1480222,2025-02-04,Senate,"Do Pass",35,0,0,0,35
1934139,1494842,2025-02-20,House,"Do Pass",12,0,0,1,13
1934139,1496978,2025-02-21,House,"Do Pass",68,1,0,1,70
1934236,1480535,2025-02-05,Senate,"Referred to",6,0,0,1,7
1934236,1491755,2025-02-18,Senate,Tabled,8,1,0,0,9
1934337,1496489,2025-02-21,House,"Do Pass Amended",7,6,0,0,13
1934337,1499650,2025-02-25,House,"Do Pass Amended",40,30,0,0,70
1934337,1505827,2025-03-04,Senate,"Deferred to the 41st legislative day",5,4,0,0,9
1934431,1489120,2025-02-12,House,Tabled,13,0,0,0,13
1935707,1477378,2025-01-30,Senate,"Do Pass Amended",7,0,0,0,7
1935707,1480061,2025-02-04,Senate,"Do Pass Amended",35,0,0,0,35
1935707,1506387,2025-03-05,House,"Do Pass",13,0,0,0,13
1935707,1508352,2025-03-06,House,"Do Pass Amended",69,0,0,1,70
1936084,1496526,2025-02-20,Senate,Tabled,9,0,0,0,9
1936456,1479216,2025-02-03,Senate,"Do Pass",8,0,0,1,9
1936456,1480239,2025-02-04,Senate,"Do Pass",35,0,0,0,35
1936456,1503801,2025-03-03,House,"Do Pass",12,0,0,1,13
1936456,1506984,2025-03-05,House,"Do Pass",70,0,0,0,70
1936459,1482565,2025-02-05,House,"Do Pass",3,9,0,1,13
1936459,1482566,2025-02-05,House,"Deferred to the 41st legislative day",12,0,0,1,13
1936791,1477874,2025-01-30,House,"Do Pass",3,10,0,0,13
1936791,1477875,2025-01-30,House,"Deferred to the 41st legislative day",11,2,0,0,13
1936817,1496448,2025-02-21,House,Tabled,9,2,0,2,13
1936822,1478747,2025-02-03,House,"Referred to",13,2,0,0,15
1936822,1497661,2025-02-24,House,"Deferred to the 41st legislative day",5,4,0,0,9
1936987,1478666,2025-02-03,Senate,"Do Pass",7,0,0,0,7
1936987,1480136,2025-02-04,Senate,"Do Pass",35,0,0,0,35
1936987,1504302,2025-03-04,House,"Do Pass",10,0,0,3,13
1936987,1507775,2025-03-06,House,"Do Pass",68,1,0,1,70
1937165,1484300,2025-02-07,House,"Deferred to the 41st legislative day",10,3,0,0,13
1937292,1485032,2025-02-10,Senate,"Do Pass",8,1,0,0,9
1937292,1486403,2025-02-11,Senate,"Do Pass Amended",34,0,0,1,35
1937292,1503112,2025-03-03,House,"Do Pass",12,0,0,1,13
1937292,1504664,2025-03-04,House,"Do Pass Amended",70,0,0,0,70
1937423,1477153,2025-01-30,Senate,"Do Pass",9,0,0,0,9
1937423,1479150,2025-02-03,Senate,"Do Pass",35,0,0,0,35
1937423,1496614,2025-02-21,House,"Do Pass",13,0,0,0,13
1937423,1499401,2025-02-25,House,"Do Pass",64,5,0,1,70
1937558,1478693,2025-02-03,House,"Deferred to the 41st legislative day",9,4,0,0,13
1937825,1485049,2025-02-10,Senate,"Do Pass Amended",9,0,0,0,9
1937825,1488542,2025-02-12,Senate,"Do Pass Amended",35,0,0,0,35
1937825,1503290,2025-03-03,House,"Do Pass Amended",12,0,0,1,13
1937825,1506876,2025-03-05,House,"Do Pass Amended",70,0,0,0,70
1937825,1515350,2025-03-11,Joint,"Motion to amend",6,0,0,0,6
1937825,1515351,2025-03-11,Joint,"Concurred in amendments",6,0,0,0,6
1937825,1515695,2025-03-11,Joint,"Conference Committee Report adopted",6,0,0,0,6
1937825,1516660,2025-03-12,House,"Conference Committee Report adopted",70,0,0,0,70
1937825,1516661,2025-03-12,Senate,"Conference Committee Report adopted",32,3,0,0,35
1939329,1480802,2025-02-05,House,"Referred as Amended to",12,2,0,1,15
1939329,1496412,2025-02-21,Joint,"Do Pass",14,3,0,1,18
1939329,1497874,2025-02-24,House,"Do Pass Amended",59,11,0,0,70
1939329,1501532,2025-02-27,Senate,"Do Pass Amended",25,10,0,0,35
1939573,1482683,2025-02-05,House,"Do Pass",8,7,0,0,15
1939573,1483848,2025-02-06,House,"Do Pass",34,34,0,1,69
1939573,1484288,2025-02-07,House,Reconsidered,43,24,0,2,69
1939573,1484289,2025-02-07,House,"Do Pass Amended",44,23,0,2,69
1939573,1494849,2025-02-20,Senate,"Motion to amend",4,3,0,0,7
1939573,1494850,2025-02-20,Senate,"Do Pass Amended",4,3,0,0,7
1939573,1499694,2025-02-25,Senate,"Motion to amend",19,16,0,0,35
1939573,1499695,2025-02-25,Senate,"Do Pass Amended",19,16,0,0,35
1939573,1502117,2025-02-27,House,"Concurred in amendments",52,18,0,0,70
1939616,1484930,2025-02-10,Senate,"Do Pass",8,1,0,0,9
1939616,1488502,2025-02-12,Senate,"Do Pass Amended",33,2,0,0,35
1939616,1503094,2025-03-03,House,"Motion to amend",7,5,0,1,13
1939616,1503095,2025-03-03,House,"Do Pass Amended",3,9,0,1,13
1939616,1503096,2025-03-03,House,"Deferred to the 41st legislative day",10,2,0,1,13
1939665,1479143,2025-02-03,House,"Do Pass",13,0,0,0,13
1939665,1480036,2025-02-04,House,"Do Pass",48,19,0,1,68
1939665,1501442,2025-02-27,Senate,"Do Pass",6,1,0,0,7
1939665,1503788,2025-03-03,Senate,"Do Pass",27,8,0,0,35
1939711,1480854,2025-02-05,Senate,"Do Pass",6,0,0,1,7
1939711,1484484,2025-02-07,Senate,"Do Pass",34,1,0,0,35
1939711,1495843,2025-02-20,House,"Do Pass",11,1,0,1,13
1939711,1496628,2025-02-21,House,"Do Pass",47,21,0,2,70
1939762,1480539,2025-02-05,Senate,"Referred as Amended to",7,0,0,0,7
1939762,1501339,2025-02-27,Joint,"Do Pass Amended",18,0,0,0,18
1939762,1503719,2025-03-03,Senate,"Do Pass Amended",24,11,0,0,35
1939762,1509541,2025-03-10,House,"Do Pass Amended",42,27,0,1,70
1939811,1483606,2025-02-06,Senate,"Deferred to the 41st legislative day",5,4,0,0,9
1939918,1486912,2025-02-11,House,"Do Pass",13,0,0,0,13
1939918,1488245,2025-02-12,House,"Do Pass",68,0,0,1,69
1939918,1494980,2025-02-20,Senate,"Do Pass",6,0,0,1,7
1939918,1496871,2025-02-21,Senate,"Do Pass",33,0,0,2,35
1940196,1483156,2025-02-06,Senate,"Referred to",7,0,0,0,7
1940196,1496634,2025-02-21,Joint,"Do Pass",13,3,0,2,18
1940196,1498303,2025-02-24,Senate,"Do Pass",30,5,0,0,35
1940196,1500654,2025-02-26,House,"Do Pass",69,1,0,0,70
1940477,1483975,2025-02-07,House,"Motion to amend",10,3,0,0,13
1940477,1483976,2025-02-07,House,"Do Pass Amended",13,0,0,0,13
1940477,1486897,2025-02-11,House,"Do Pass Amended",68,0,0,1,69
1940477,1494248,2025-02-19,House,"Do Pass Amended",69,1,0,0,70
1940477,1504964,2025-03-04,Senate,"Do Pass",6,0,0,1,7
1940477,1506117,2025-03-05,Senate,"Do Pass Amended",34,0,0,1,35
1940760,1495715,2025-02-20,House,"Do Pass",13,0,0,0,13
1940760,1496795,2025-02-21,House,"Do Pass",59,10,0,1,70
1940760,1500164,2025-02-26,Senate,"Do Pass",7,0,0,0,7
1940760,1501849,2025-02-27,Senate,"Do Pass",31,3,0,1,35
1941042,1479469,2025-02-04,House,"Referred to",11,0,0,2,13
1941042,1484058,2025-02-07,Joint,Tabled,17,0,0,1,18
1941542,1492800,2025-02-18,House,"Do Pass",13,0,0,0,13
1941542,1493750,2025-02-19,House,"Do Pass",69,1,0,0,70
1941542,1497297,2025-02-24,Senate,"Do Pass",7,0,0,0,7
1941542,1499492,2025-02-25,Senate,"Do Pass",35,0,0,0,35
1941742,1479173,2025-02-03,House,"Do Pass",13,0,0,0,13
1941742,1480219,2025-02-04,House,"Do Pass",67,0,0,1,68
1941742,1498632,2025-02-25,Senate,"Do Pass",7,0,0,0,7
1941742,1500308,2025-02-26,Senate,"Do Pass",34,0,0,1,35
1941745,1491801,2025-02-18,House,"Deferred to the 41st legislative day",7,6,0,0,13
1941747,1483972,2025-02-07,House,Tabled,12,0,0,1,13
1941825,1482641,2025-02-05,House,"Deferred to the 41st legislative day",8,4,0,1,13
1941830,1480513,2025-02-05,House,"Do Pass",4,8,0,1,13
1941830,1480514,2025-02-05,House,"Deferred to the 41st legislative day",9,3,0,1,13
1941831,1484670,2025-02-10,Senate,"Do Pass",7,2,0,0,9
1941831,1488280,2025-02-12,Senate,"Do Pass Amended",33,2,0,0,35
1941831,1506480,2025-03-05,House,"Do Pass",10,3,0,0,13
1941831,1507910,2025-03-06,House,"Do Pass Amended",55,14,0,1,70
1941833,1493191,2025-02-19,Senate,Tabled,7,0,0,0,7
1941856,1484121,2025-02-07,Senate,"Deferred to the 41st legislative day",4,3,0,0,7
1941857,1483937,2025-02-07,House,"Do Pass Amended",12,3,0,0,15
1941857,1486470,2025-02-11,House,"Do Pass Amended",30,38,0,1,69
1941858,1478738,2025-02-03,Senate,"Do Pass",5,3,0,1,9
1941858,1479765,2025-02-04,Senate,"Do Pass",13,22,0,0,35
1941859,1482162,2025-02-05,Senate,"Referred as Amended to",6,0,0,1,7
1941859,1496238,2025-02-21,Joint,Tabled,10,6,0,2,18
1941860,1480867,2025-02-05,Senate,Tabled,8,0,0,1,9
1941864,1478673,2025-02-03,House,"Do Pass Amended",7,5,0,1,13
1941864,1482329,2025-02-05,House,"Do Pass Amended",28,39,0,1,68
1942160,1482196,2025-02-05,House,"Do Pass",10,2,0,1,13
1942160,1483849,2025-02-06,House,"Do Pass",56,12,0,1,69
1942160,1503841,2025-03-03,Senate,"Do Pass",9,0,0,0,9
1942160,1505369,2025-03-04,Senate,"Do Pass",35,0,0,0,35
1942327,1482675,2025-02-05,Senate,"Do Pass",8,0,0,1,9
1942327,1483582,2025-02-06,Senate,"Do Pass",35,0,0,0,35
1942327,1503698,2025-03-03,House,"Do Pass",13,0,0,0,13
1942327,1506660,2025-03-05,House,"Do Pass",70,0,0,0,70
1942456,1480827,2025-02-05,Senate,"Do Pass",5,2,0,0,7
1942456,1483470,2025-02-06,Senate,"Do Pass",20,15,0,0,35
1942456,1498664,2025-02-25,House,"Deferred to the 41st legislative day",7,5,0,1,13
1942591,1486411,2025-02-11,Senate,"Deferred to the 41st legislative day",5,4,0,0,9
1942728,1486113,2025-02-11,House,"Referred as Amended to",12,1,0,0,13
1942728,1497349,2025-02-24,House,"Deferred to the 41st legislative day",7,2,0,0,9
1942942,1479702,2025-02-04,Senate,"Do Pass Amended",4,2,0,1,7
1942942,1483694,2025-02-06,Senate,"Do Pass Amended",34,1,0,0,35
1942942,1496144,2025-02-20,House,"Do Pass",10,2,0,1,13
1942942,1497743,2025-02-24,House,"Do Pass",62,8,0,0,70
1943014,1496540,2025-02-21,Joint,Tabled,13,3,0,2,18
1943086,1484610,2025-02-10,Senate,"Do Pass Amended",6,0,0,1,7
1943086,1488084,2025-02-12,Senate,"Do Pass Amended",35,0,0,0,35
1943086,1501295,2025-02-27,House,"Do Pass",12,0,0,1,13
1943086,1503942,2025-03-03,House,"Do Pass Amended",68,1,0,1,70
1943156,1479509,2025-02-04,House,"Do Pass Amended",8,5,0,0,13
1943156,1483850,2025-02-06,House,"Do Pass Amended",42,26,0,1,69
1943156,1491788,2025-02-18,Senate,"Do Pass",4,3,0,0,7
1943156,1493600,2025-02-19,Senate,"Do Pass Amended",17,17,0,1,35
1943156,1495558,2025-02-20,Senate,Reconsidered,16,19,0,0,35
1943207,1483648,2025-02-06,House,"Referred to",12,0,0,1,13
1943207,1496606,2025-02-21,Joint,Tabled,15,1,0,2,18
1943307,1476622,2025-01-29,House,"Adopt Resolution",68,0,0,1,69
1943307,1480371,2025-02-04,Senate,"Concurred in Resolution",35,0,0,0,35
1943356,1496605,2025-02-21,Joint,"Do Pass Amended",12,4,0,2,18
1943356,1499623,2025-02-25,House,"Do Pass Amended",44,26,0,0,70
1943356,1499624,2025-02-25,House,Reconsidered,44,24,0,2,70
1943356,1499625,2025-02-25,House,"Do Pass Amended",47,22,0,1,70
1943356,1504035,2025-03-03,Senate,"Do Pass Amended",28,6,0,1,35
1943356,1506922,2025-03-05,House,"Concurred in amendments",59,11,0,0,70
1943405,1482133,2025-02-05,House,"Deferred to the 41st legislative day",13,0,0,0,13
1943615,1491722,2025-02-18,House,"Do Pass Amended",12,0,0,1,13
1943615,1496617,2025-02-21,House,"Do Pass Amended",66,3,0,1,70
1943615,1504768,2025-03-04,Senate,"Do Pass",7,0,0,0,7
1943615,1507745,2025-03-06,Senate,"Do Pass Amended",31,3,0,1,35
1943723,1485994,2025-02-11,Senate,"Do Pass",6,0,0,1,7
1943723,1489538,2025-02-13,Senate,"Do Pass",35,0,0,0,35
1943723,1497396,2025-02-24,House,"Do Pass",12,0,0,1,13
1943723,1499329,2025-02-25,House,"Do Pass",70,0,0,0,70
1943825,1496788,2025-02-21,House,"Do Pass Amended",8,3,0,2,13
1943825,1499189,2025-02-25,House,"Do Pass Amended",56,14,0,0,70
1943825,1505282,2025-03-04,Senate,"Deferred to the 41st legislative day",6,0,0,1,7
1943901,1483161,2025-02-06,House,Tabled,13,0,0,0,13
1943967,1479496,2025-02-04,Senate,"Deferred to the 41st legislative day",4,2,0,1,7
1944100,1479515,2025-02-04,House,"Do Pass Amended",13,0,0,0,13
1944100,1483851,2025-02-06,House,"Do Pass Amended",68,0,0,1,69
1944100,1491787,2025-02-18,Senate,"Do Pass",7,0,0,0,7
1944100,1493605,2025-02-19,Senate,"Do Pass Amended",34,0,0,1,35
1944167,1480052,2025-02-04,House,"Do Pass",13,0,0,0,13
1944167,1482575,2025-02-05,House,"Do Pass",65,2,0,1,68
1944167,1487933,2025-02-12,Senate,"Do Pass",4,3,0,0,7
1944167,1489830,2025-02-13,Senate,"Do Pass",11,24,0,0,35
1944235,1484060,2025-02-07,Senate,"Do Pass Amended",6,3,0,0,9
1944235,1486569,2025-02-11,Senate,"Do Pass Amended",30,4,0,1,35
1944235,1505666,2025-03-05,House,"Do Pass",10,3,0,0,13
1944235,1507726,2025-03-06,House,"Motion to amend",37,32,0,1,70
1944235,1507727,2025-03-06,House,"Do Pass Amended",64,5,0,1,70
1944235,1515881,2025-03-12,House,"Conference Committee report not adopted, no committee appointed",39,31,0,0,70
1944235,1515882,2025-03-12,Senate,"Conference Committee Report adopted",31,4,0,0,35
1944235,1515883,2025-03-12,Joint,"Motion to amend",5,1,0,0,6
1944235,1515884,2025-03-12,Joint,"Conference Committee Report adopted",5,1,0,0,6
1944299,1487538,2025-02-12,House,"Deferred to the 41st legislative day",8,4,0,1,13
1944363,1482237,2025-02-05,House,"Do Pass Amended",7,6,0,0,13
1944363,1484449,2025-02-07,House,"Do Pass Amended",26,41,0,2,69
1944495,1496202,2025-02-21,House,"Deferred to the 41st legislative day",8,4,0,1,13
1944557,1483116,2025-02-06,House,"Do Pass Amended",9,4,0,0,13
1944557,1485599,2025-02-10,House,"Do Pass Amended",29,39,0,1,69
1944671,1483507,2025-02-06,Senate,"Do Pass",6,0,0,1,7
1944671,1484340,2025-02-07,Senate,"Do Pass",35,0,0,0,35
1944671,1506675,2025-03-05,House,"Do Pass",12,0,0,1,13
1944671,1507963,2025-03-06,House,"Do Pass",69,0,0,1,70
1944780,1479490,2025-02-04,House,"Do Pass Amended",13,0,0,0,13
1944780,1484065,2025-02-07,House,"Do Pass Amended",64,3,0,2,69
1944780,1487292,2025-02-12,Senate,"Do Pass",7,0,0,0,7
1944780,1489419,2025-02-13,Senate,"Do Pass Amended",35,0,0,0,35
1944886,1486615,2025-02-11,Senate,"Deferred to the 41st legislative day",5,1,0,1,7
1944994,1483332,2025-02-06,Senate,"Do Pass Amended",5,2,0,0,7
1944994,1485278,2025-02-10,Senate,"Do Pass Amended",25,9,0,1,35
1944994,1498711,2025-02-25,House,"Do Pass Amended",11,0,0,2,13
1944994,1501839,2025-02-27,House,"Do Pass Amended",48,22,0,0,70
1944994,1505176,2025-03-04,Senate,"Concurred in amendments",31,4,0,0,35
1945096,1491915,2025-02-18,House,"Do Pass",9,4,0,0,13
1945096,1493691,2025-02-19,House,"Do Pass",43,27,0,0,70
1945096,1499876,2025-02-26,Senate,"Do Pass",3,4,0,0,7
1945096,1499877,2025-02-26,Senate,"Deferred to the 41st legislative day",4,3,0,0,7
1945096,1505162,2025-03-04,Senate,"Placed on calendar pursuant to JR 6F-6",17,18,0,0,35
1945134,1479476,2025-02-04,House,"Do Pass",12,1,0,0,13
1945134,1482447,2025-02-05,House,"Do Pass",43,24,0,1,68
1945134,1503087,2025-03-03,Senate,"Do Pass",7,0,0,0,7
1945134,1505132,2025-03-04,Senate,"Do Pass",35,0,0,0,35
1945165,1479423,2025-02-04,House,"Do Pass",13,0,0,0,13
1945165,1482723,2025-02-05,House,"Do Pass",65,2,0,1,68
1945165,1503088,2025-03-03,Senate,"Do Pass",7,0,0,0,7
1945165,1505330,2025-03-04,Senate,"Do Pass",35,0,0,0,35
1945349,1483602,2025-02-06,Senate,"Deferred to the 41st legislative day",7,2,0,0,9
1945349,1491803,2025-02-18,Senate,Reconsidered,5,4,0,0,9
1945349,1498281,2025-02-24,Senate,Tabled,6,0,0,3,9
1945492,1484135,2025-02-07,House,"Do Pass",11,1,0,1,13
1945492,1485161,2025-02-10,House,"Do Pass",52,16,0,1,69
1945492,1507700,2025-03-06,Senate,"Do Pass",4,4,0,1,9
1945492,1507701,2025-03-06,Senate,"Do Pass",4,3,0,2,9
1945492,1507702,2025-03-06,Senate,"Referred to",5,2,0,2,9
1945492,1511837,2025-03-10,Senate,"Placed on calendar pursuant to JR 6F-6",26,8,0,1,35
1945492,1511838,2025-03-10,Senate,"Do Pass",23,11,0,1,35
1945531,1485841,2025-02-10,House,Tabled,13,0,0,0,13
1945567,1489174,2025-02-13,House,"Do Pass Amended",7,6,0,0,13
1945567,1494173,2025-02-19,House,"Do Pass Amended",39,31,0,0,70
1945567,1503452,2025-03-03,Senate,"Do Pass",5,2,0,0,7
1945567,1505011,2025-03-04,Senate,"Do Pass Amended",20,14,0,1,35
1945567,1516989,2025-03-13,House,"Veto override",27,43,0,0,70
1945607,1479428,2025-02-04,House,"Do Pass",13,0,0,0,13
1945607,1482248,2025-02-05,House,"Do Pass",65,2,0,1,68
1945607,1498587,2025-02-25,Senate,"Do Pass",6,0,0,1,7
1945607,1500403,2025-02-26,Senate,"Do Pass",34,0,0,1,35
1945645,1489127,2025-02-13,Senate,"Do Pass Amended",5,0,0,2,7
1945645,1493824,2025-02-19,Senate,"Do Pass Amended",34,0,0,1,35
1945645,1507200,2025-03-06,House,"Do Pass",12,0,0,1,13
1945645,1509688,2025-03-10,House,"Do Pass Amended",69,0,0,1,70
1945684,1488706,2025-02-12,Senate,"Deferred to the 41st legislative day",4,3,0,0,7
1945723,1477621,2025-01-30,House,"Adopt Resolution",67,0,0,1,68
1945762,1491851,2025-02-18,Senate,"Deferred to the 41st legislative day",4,3,0,0,7
1945800,1489311,2025-02-12,Senate,"Do Pass",7,0,0,0,7
1945800,1494367,2025-02-19,Senate,"Do Pass Amended",34,0,0,1,35
1945800,1500865,2025-02-26,House,"Do Pass",13,0,0,0,13
1945800,1502038,2025-02-27,House,"Do Pass Amended",70,0,0,0,70
1945839,1496241,2025-02-21,Senate,"Do Pass Amended",2,4,0,1,7
1945839,1496242,2025-02-21,Senate,"Deferred to the 41st legislative day",4,2,0,1,7
1945876,1482523,2025-02-05,House,"Do Pass",12,0,0,1,13
1945876,1483852,2025-02-06,House,"Do Pass",68,0,0,1,69
1945876,1499074,2025-02-25,Senate,"Do Pass",7,0,0,0,7
1945876,1500740,2025-02-26,Senate,"Do Pass",34,0,0,1,35
1945913,1477963,2025-01-30,Senate,"Adopt Resolution",35,0,0,0,35
1945953,1496546,2025-02-21,Joint,"Do Pass",9,7,0,2,18
1945953,1496547,2025-02-21,Joint,"Do Pass Amended",13,3,0,2,18
1945953,1499618,2025-02-25,House,"Do Pass Amended",62,8,0,0,70
1945953,1503968,2025-03-03,Senate,"Do Pass Amended",32,2,0,1,35
1945953,1506835,2025-03-05,House,"Concurred in amendments",66,4,0,0,70
1945986,1482579,2025-02-05,Senate,"Do Pass",2,3,0,2,7
1945986,1484245,2025-02-07,Senate,"Deferred to the 41st legislative day",4,3,0,0,7
1946048,1495688,2025-02-20,House,"Deferred to the 41st legislative day",12,0,0,1,13
1946093,1484331,2025-02-07,Senate,"Deferred to the 41st legislative day",6,3,0,0,9
1946189,1496181,2025-02-21,House,"Deferred to the 41st legislative day",9,3,0,1,13
1946245,1497703,2025-02-24,Senate,"Do Pass",5,4,0,0,9
1946245,1499247,2025-02-25,Senate,"Do Pass Amended",15,20,0,0,35
1946292,1487296,2025-02-12,Senate,"Referred to",6,0,0,1,7
1946292,1494973,2025-02-20,Senate,"Deferred to the 41st legislative day",5,3,0,1,9
1946340,1497285,2025-02-24,House,Tabled,12,0,0,1,13
1946388,1485863,2025-02-11,House,"Do Pass",13,0,0,0,13
1946388,1487743,2025-02-12,House,"Do Pass",68,0,0,1,69
1946388,1505717,2025-03-05,Senate,"Do Pass",7,0,0,0,7
1946388,1507848,2025-03-06,Senate,"Do Pass",34,0,0,1,35
1946432,1485833,2025-02-10,House,"Deferred to the 41st legislative day",11,1,0,1,13
1946476,1497791,2025-02-24,House,"Do Pass",11,1,0,1,13
1946476,1499674,2025-02-25,House,"Do Pass",53,15,0,2,70
1946476,1507282,2025-03-06,Senate,"Do Pass",5,0,0,4,9
1946476,1511394,2025-03-10,Senate,"Do Pass Amended",32,2,0,1,35
1946476,1515590,2025-03-11,House,"Failed to concur, no committee appointed",61,8,0,1,70
1946586,1489621,2025-02-13,House,"Do Pass",13,0,0,0,13
1946586,1492855,2025-02-18,House,"Do Pass",65,5,0,0,70
1946586,1499730,2025-02-26,Senate,"Do Pass",7,0,0,0,7
1946586,1501618,2025-02-27,Senate,"Do Pass",35,0,0,0,35
1946678,1484095,2025-02-07,Senate,"Do Pass",7,0,0,0,7
1946678,1487122,2025-02-11,Senate,"Do Pass",31,3,0,1,35
1946678,1504874,2025-03-04,House,"Motion to amend",10,3,0,0,13
1946678,1504875,2025-03-04,House,"Referred as Amended to",9,4,0,0,13
1946678,1508139,2025-03-06,House,"Do Pass",7,2,0,0,9
1946678,1512145,2025-03-10,House,"Do Pass Amended",37,32,0,1,70
1946775,1484032,2025-02-07,Senate,"Do Pass Amended",7,0,0,0,7
1946775,1486481,2025-02-11,Senate,"Do Pass Amended",34,0,0,1,35
1946775,1501114,2025-02-27,House,"Do Pass",11,0,0,2,13
1946775,1507679,2025-03-06,House,"Do Pass Amended",68,1,0,1,70
1946867,1484294,2025-02-07,Senate,"Referred to",7,0,0,0,7
1946867,1501449,2025-02-27,Joint,"Do Pass Amended",14,4,0,0,18
1946867,1504114,2025-03-03,Senate,"Do Pass Amended",16,19,0,0,35
1946965,1482632,2025-02-05,Senate,"Motion to amend",6,0,0,1,7
1946965,1482633,2025-02-05,Senate,"Do Pass Amended",6,0,0,1,7
1946965,1484277,2025-02-07,Senate,"Do Pass Amended",35,0,0,0,35
1946965,1504528,2025-03-04,House,"Do Pass",12,0,0,1,13
1946965,1506983,2025-03-05,House,"Do Pass Amended",70,0,0,0,70
1947054,1483688,2025-02-06,House,"Do Pass",13,0,0,0,13
1947054,1484310,2025-02-07,House,"Do Pass",66,1,0,2,69
1947054,1506143,2025-03-05,Senate,"Do Pass Amended",6,0,0,1,7
1947054,1512421,2025-03-10,Senate,"Do Pass Amended",34,0,0,1,35
1947054,1515582,2025-03-11,House,"Concurred in amendments",67,2,0,1,70
1947148,1489745,2025-02-13,Senate,"Deferred to the 41st legislative day",5,2,0,2,9
1947244,1483990,2025-02-07,Senate,"Do Pass Amended",7,0,0,0,7
1947244,1487188,2025-02-11,Senate,"Do Pass Amended",34,0,0,1,35
1947244,1499334,2025-02-25,House,"Do Pass",10,3,0,0,13
1947244,1500474,2025-02-26,House,"Do Pass Amended",31,39,0,0,70
1947336,1483631,2025-02-06,House,"Do Pass",13,0,0,0,13
1947336,1484315,2025-02-07,House,"Do Pass",66,1,0,2,69
1947336,1505813,2025-03-05,Senate,Tabled,6,0,0,1,7
1947426,1488954,2025-02-13,House,"Do Pass",13,0,0,0,13
1947426,1492637,2025-02-18,House,"Do Pass",65,5,0,0,70
1947426,1497215,2025-02-24,Senate,"Do Pass",7,0,0,0,7
1947426,1499303,2025-02-25,Senate,"Do Pass",35,0,0,0,35
1947449,1486044,2025-02-10,House,"Adopt Resolution",13,0,0,0,13
1947449,1488286,2025-02-12,House,"Adopt Resolution",63,5,0,1,69
1947449,1495456,2025-02-19,Senate,"Concurred in Resolution",5,0,0,0,5
1947449,1496953,2025-02-21,Senate,"Concurred in Resolution",31,2,0,2,35
1947510,1480522,2025-02-05,Senate,"Do Pass Amended",7,0,0,0,7
1947510,1484264,2025-02-07,Senate,"Do Pass Amended",35,0,0,0,35
1947510,1501109,2025-02-27,House,"Do Pass",11,0,0,2,13
1947510,1503657,2025-03-03,House,"Do Pass Amended",68,1,0,1,70
1947541,1491772,2025-02-18,Senate,Tabled,6,1,0,0,7
1947572,1485184,2025-02-10,House,Tabled,11,0,0,2,13
1947634,1483137,2025-02-06,House,Tabled,12,0,0,1,13
1947665,1483978,2025-02-07,Senate,"Report out of committee without recommendation",6,1,0,0,7
1947665,1484932,2025-02-10,Senate,"Placed on calendar pursuant to JR 6F-6",12,22,0,1,35
1947698,1497309,2025-02-24,House,"Do Pass",11,1,0,1,13
1947698,1499683,2025-02-25,House,Tabled,66,2,0,2,70
1947701,1484703,2025-02-10,House,"Deferred to the 41st legislative day",12,1,0,0,13
1947705,1497397,2025-02-24,House,"Do Pass",11,2,0,0,13
1947705,1499300,2025-02-25,House,Tabled,64,4,0,2,70
1947720,1496985,2025-02-21,Senate,"Do Pass",9,0,0,0,9
1947720,1499438,2025-02-25,Senate,"Do Pass",34,1,0,0,35
1947720,1506905,2025-03-05,House,Tabled,10,3,0,0,13
1947721,1496828,2025-02-21,House,"Do Pass",9,2,0,2,13
1947721,1499697,2025-02-25,House,"Do Pass",32,38,0,0,70
1947721,1499698,2025-02-25,House,Reconsidered,32,36,0,2,70
1947724,1486560,2025-02-11,House,"Do Pass Amended",12,0,0,1,13
1947724,1492639,2025-02-18,House,"Do Pass Amended",64,6,0,0,70
1947724,1500052,2025-02-26,Senate,"Do Pass",5,2,0,0,7
1947724,1501519,2025-02-27,Senate,"Do Pass Amended",28,6,0,1,35
1947730,1497610,2025-02-24,Senate,"Do Pass",2,4,0,1,7
1947730,1497611,2025-02-24,Senate,"Deferred to the 41st legislative day",5,2,0,0,7
1947734,1485885,2025-02-10,House,"Do Pass Amended",8,7,0,0,15
1947734,1489412,2025-02-13,House,"Do Pass Amended",28,40,0,1,69
1947739,1496948,2025-02-21,Senate,"Do Pass",9,0,0,0,9
1947739,1499596,2025-02-25,Senate,Tabled,35,0,0,0,35
1947744,1494968,2025-02-20,Senate,"Do Pass Amended",8,0,0,1,9
1947744,1498525,2025-02-24,Senate,"Do Pass Amended",35,0,0,0,35
1947744,1503157,2025-03-03,House,"Do Pass",13,0,0,0,13
1947744,1506813,2025-03-05,House,"Do Pass Amended",70,0,0,0,70
1947746,1484540,2025-02-10,Senate,"Do Pass",7,0,0,0,7
1947746,1486919,2025-02-11,Senate,"Do Pass",34,0,0,1,35
1947746,1501277,2025-02-27,House,"Do Pass",12,0,0,1,13
1947746,1503566,2025-03-03,House,"Do Pass",68,1,0,1,70
1947753,1486241,2025-02-11,Senate,"Do Pass",6,0,0,1,7
1947753,1488306,2025-02-12,Senate,"Do Pass",35,0,0,0,35
1947753,1498570,2025-02-25,House,"Do Pass",13,0,0,0,13
1947753,1500156,2025-02-26,House,"Do Pass",70,0,0,0,70
1947756,1496791,2025-02-21,House,"Do Pass",8,0,0,1,9
1947756,1498277,2025-02-24,House,"Do Pass",56,14,0,0,70
1947756,1507488,2025-03-06,Senate,Tabled,6,0,0,3,9
1947765,1484579,2025-02-10,Senate,"Do Pass Amended",7,0,0,0,7
1947765,1488191,2025-02-12,Senate,"Do Pass Amended",35,0,0,0,35
1947765,1501384,2025-02-27,House,"Do Pass",11,0,0,2,13
1947765,1503482,2025-03-03,House,"Do Pass Amended",68,1,0,1,70
1947769,1485877,2025-02-10,House,Tabled,12,3,0,0,15
1947772,1492975,2025-02-18,House,Tabled,11,2,0,0,13
1947781,1496219,2025-02-21,Senate,"Do Pass Amended",6,0,0,1,7
1947781,1499274,2025-02-25,Senate,"Do Pass Amended",35,0,0,0,35
1947781,1504165,2025-03-04,House,"Do Pass",5,6,0,2,13
1947781,1504166,2025-03-04,House,"Report out of committee without recommendation",11,0,0,2,13
1947781,1506786,2025-03-05,House,"Placed on calendar pursuant to JR 6F-6",62,8,0,0,70
1947781,1509642,2025-03-10,House,"Motion to amend",35,34,0,1,70
1947781,1509643,2025-03-10,House,"Do Pass Amended",27,42,0,1,70
1947785,1484650,2025-02-10,House,"Do Pass",8,0,0,1,9
1947785,1489866,2025-02-13,House,"Do Pass",45,24,0,0,69
1947785,1497290,2025-02-24,Senate,"Do Pass",5,4,0,0,9
1947785,1499561,2025-02-25,Senate,"Do Pass",24,11,0,0,35
1947788,1486385,2025-02-10,House,Tabled,15,0,0,0,15
1947794,1488301,2025-02-12,Senate,"Do Pass Amended",9,0,0,0,9
1947794,1494414,2025-02-19,Senate,"Do Pass Amended",33,1,0,1,35
1947794,1503084,2025-03-03,House,"Do Pass",13,0,0,0,13
1947794,1506676,2025-03-05,House,"Do Pass Amended",69,1,0,0,70
1947800,1479975,2025-02-04,Senate,"Adopt Resolution",35,0,0,0,35
1947800,1489697,2025-02-13,House,"Concurred in Resolution",69,0,0,0,69
1947810,1484542,2025-02-10,Senate,Tabled,6,0,0,1,7
1947815,1480276,2025-02-04,Senate,"Adopt Resolution",35,0,0,0,35
1947815,1489395,2025-02-13,House,"Concurred in Resolution",69,0,0,0,69
1947822,1493231,2025-02-18,House,"Referred to",13,0,0,0,13
1947822,1501742,2025-02-27,Joint,Tabled,16,2,0,0,18
1947828,1493169,2025-02-18,House,"Fiscal Note Requested",13,0,0,0,13
1947828,1496136,2025-02-20,House,"Referred to",9,3,0,1,13
1947828,1497782,2025-02-24,House,"Deferred to the 41st legislative day",9,0,0,0,9
1947831,1479877,2025-02-04,House,"Adopt Resolution",34,33,0,1,68
1947837,1480399,2025-02-04,Senate,"Adopt Resolution",34,1,0,0,35
1947837,1492648,2025-02-18,House,"Concurred in Resolution",70,0,0,0,70
1947841,1488725,2025-02-13,House,"Do Pass",11,2,0,0,13
1947841,1492643,2025-02-18,House,"Do Pass",57,13,0,0,70
1947841,1499901,2025-02-26,Senate,"Do Pass",7,0,0,0,7
1947841,1501364,2025-02-27,Senate,"Do Pass",35,0,0,0,35
1947848,1494067,2025-02-19,House,"Do Pass Amended",10,4,0,1,15
1947848,1498373,2025-02-24,House,"Do Pass Amended",61,8,0,1,70
1947848,1504230,2025-03-04,Senate,Tabled,6,0,0,1,7
1947852,1486008,2025-02-11,House,"Do Pass Amended",9,4,0,0,13
1947852,1489612,2025-02-13,House,"Do Pass Amended",34,34,0,1,69
1947852,1492640,2025-02-18,House,Reconsidered,43,27,0,0,70
1947852,1492641,2025-02-18,House,"Do Pass Amended",40,30,0,0,70
1947852,1507257,2025-03-06,Senate,"Do Pass",4,3,0,0,7
1947852,1509722,2025-03-10,Senate,"Do Pass Amended",15,19,0,1,35
1947854,1494112,2025-02-19,Senate,"Do Pass",8,0,0,1,9
1947854,1495425,2025-02-20,Senate,"Do Pass Amended",35,0,0,0,35
1947854,1505830,2025-03-05,House,"Do Pass",13,0,0,0,13
1947854,1508133,2025-03-06,House,"Do Pass Amended",69,0,0,1,70
1947858,1484668,2025-02-10,Senate,"Do Pass Amended",9,0,0,0,9
1947858,1489746,2025-02-13,Senate,"Do Pass Amended",35,0,0,0,35
1947858,1501002,2025-02-26,House,"Do Pass Amended",13,0,0,0,13
1947858,1505521,2025-03-04,House,"Do Pass Amended",58,12,0,0,70
1947858,1507964,2025-03-06,Senate,"Concurred in amendments",33,0,0,2,35
1947863,1495663,2025-02-20,Senate,"Do Pass Amended",8,0,0,1,9
1947863,1498355,2025-02-24,Senate,"Do Pass Amended",35,0,0,0,35
1947863,1505112,2025-03-04,House,"Do Pass",8,0,0,1,9
1947863,1506946,2025-03-05,House,"Do Pass Amended",69,1,0,0,70
1947868,1483305,2025-02-06,Senate,"Do Pass Amended",9,0,0,0,9
1947868,1485144,2025-02-10,Senate,"Do Pass Amended",34,0,0,1,35
1947868,1503854,2025-03-03,House,"Do Pass",12,0,0,1,13
1947868,1505259,2025-03-04,House,"Do Pass Amended",70,0,0,0,70
1947876,1487319,2025-02-12,House,"Do Pass",12,0,0,1,13
1947876,1489778,2025-02-13,House,"Do Pass",63,6,0,0,69
1947876,1501562,2025-02-27,Senate,"Do Pass",6,1,0,0,7
1947876,1503686,2025-03-03,Senate,"Do Pass",21,13,0,1,35
1947880,1496154,2025-02-21,Senate,"Do Pass",7,0,0,0,7
1947880,1498341,2025-02-24,Senate,"Do Pass",35,0,0,0,35
1947880,1504292,2025-03-04,House,"Do Pass",7,6,0,0,13
1947880,1506617,2025-03-05,House,"Do Pass Amended",13,57,0,0,70
1947886,1485891,2025-02-10,House,Tabled,15,0,0,0,15
1947892,1491774,2025-02-18,Senate,"Do Pass Amended",9,0,0,0,9
1947892,1495517,2025-02-20,Senate,"Do Pass Amended",35,0,0,0,35
1947892,1504728,2025-03-04,House,"Do Pass",7,0,0,2,9
1947892,1506985,2025-03-05,House,"Do Pass Amended",70,0,0,0,70
1947894,1495197,2025-02-20,Senate,"Do Pass Amended",9,0,0,0,9
1947894,1498521,2025-02-24,Senate,"Do Pass Amended",35,0,0,0,35
1947894,1507252,2025-03-06,House,"Do Pass",8,3,0,2,13
1947894,1512457,2025-03-10,House,"Do Pass Amended",53,16,0,1,70
1947901,1483267,2025-02-06,House,"Do Pass Amended",9,4,0,0,13
1947901,1485765,2025-02-10,House,"Do Pass Amended",36,32,0,1,69
1947901,1500748,2025-02-26,Senate,"Deferred to the 41st legislative day",6,1,0,0,7
1947908,1493125,2025-02-19,House,"Adopt Resolution",11,1,0,1,13
1947908,1495498,2025-02-20,House,"Adopt Resolution",64,6,0,0,70
1947908,1505719,2025-03-04,Senate,"Do Pass",7,2,0,0,9
1947908,1507873,2025-03-06,Senate,"Concurred in Resolution",34,0,0,1,35
1947914,1495047,2025-02-20,Senate,"Do Pass Amended",7,2,0,0,9
1947914,1498526,2025-02-24,Senate,"Do Pass Amended",19,16,0,0,35
1947914,1503293,2025-03-03,House,"Do Pass",6,7,0,0,13
1947914,1503294,2025-03-03,House,"Deferred to the 41st legislative day",7,6,0,0,13
1947918,1494978,2025-02-20,Senate,Tabled,9,0,0,0,9
1947923,1492989,2025-02-19,Senate,"Do Pass Amended",6,1,0,0,7
1947923,1496558,2025-02-21,Senate,"Do Pass Amended",30,3,0,2,35
1947923,1504174,2025-03-04,House,"Do Pass",8,5,0,0,13
1947923,1506488,2025-03-05,House,"Do Pass Amended",65,5,0,0,70
1947928,1486069,2025-02-11,House,"Do Pass",12,0,0,1,13
1947928,1489516,2025-02-13,House,"Do Pass",61,7,0,1,69
1947928,1496594,2025-02-21,Senate,"Do Pass",5,0,0,2,7
1947928,1498135,2025-02-24,Senate,"Do Pass",35,0,0,0,35
1947934,1488251,2025-02-12,Senate,"Do Pass Amended",7,0,0,0,7
1947934,1492756,2025-02-18,Senate,"Do Pass Amended",35,0,0,0,35
1947934,1498586,2025-02-25,House,"Do Pass",12,0,0,1,13
1947934,1500709,2025-02-26,House,"Do Pass Amended",68,2,0,0,70
1947937,1486250,2025-02-10,House,Tabled,14,0,0,1,15
1947944,1487531,2025-02-12,House,"Motion to amend",8,7,0,0,15
1947944,1487532,2025-02-12,House,"Do Pass Amended",8,7,0,0,15
1947944,1492899,2025-02-18,House,"Do Pass Amended",28,42,0,0,70
1947950,1492249,2025-02-18,Senate,"Do Pass",7,0,0,0,7
1947950,1493690,2025-02-19,Senate,"Do Pass",34,0,0,1,35
1947950,1503756,2025-03-03,House,"Deferred to the 41st legislative day",8,4,0,1,13
1947956,1486152,2025-02-10,House,"Do Pass",11,1,0,1,13
1947956,1489776,2025-02-13,House,"Do Pass",65,3,0,1,69
1947956,1501321,2025-02-27,Senate,"Do Pass",3,3,0,1,7
1947956,1501322,2025-02-27,Senate,"Report out of committee without recommendation",4,2,0,1,7
1947956,1504102,2025-03-03,Senate,"Placed on calendar pursuant to JR 6F-6",31,4,0,0,35
1947956,1504103,2025-03-03,Senate,"Do Pass Amended",35,0,0,0,35
1947956,1506973,2025-03-05,House,"Concurred in amendments",70,0,0,0,70
1947961,1493589,2025-02-19,Senate,"Do Pass Amended",4,3,0,0,7
1947961,1498503,2025-02-24,Senate,"Do Pass Amended",28,7,0,0,35
1947961,1504332,2025-03-04,House,"Deferred to the 41st legislative day",7,4,0,2,13
1947964,1489495,2025-02-12,Senate,"Do Pass Amended",7,0,0,0,7
1947964,1495757,2025-02-20,Senate,"Do Pass Amended",35,0,0,0,35
1947964,1503498,2025-03-03,House,"Do Pass Amended",8,4,0,1,13
1947964,1506775,2025-03-05,House,"Do Pass Amended",30,40,0,0,70
1947969,1493277,2025-02-19,House,"Do Pass Amended",13,0,0,0,13
1947969,1496834,2025-02-21,House,"Do Pass Amended",68,1,0,1,70
1947969,1501168,2025-02-27,Senate,"Do Pass",7,0,0,0,7
1947969,1503645,2025-03-03,Senate,"Do Pass Amended",35,0,0,0,35
1947976,1496231,2025-02-21,Senate,Tabled,9,0,0,0,9
1947979,1485946,2025-02-11,House,"Referred to",10,3,0,0,13
1947979,1497447,2025-02-24,House,"Deferred to the 41st legislative day",8,1,0,0,9
1947984,1487337,2025-02-12,House,"Motion to amend",8,7,0,0,15
1947984,1487338,2025-02-12,House,"Do Pass Amended",6,9,0,0,15
1947984,1487339,2025-02-12,House,"Deferred to the 41st legislative day",9,6,0,0,15
1947995,1484063,2025-02-07,Senate,"Do Pass Amended",6,1,0,0,7
1947995,1489112,2025-02-13,Senate,"Do Pass Amended",17,18,0,0,35
1948011,1487388,2025-02-12,House,"Do Pass",8,7,0,0,15
1948011,1489819,2025-02-13,House,"Do Pass",28,40,0,1,69
1948015,1486260,2025-02-10,House,"Do Pass",11,0,0,2,13
1948015,1487567,2025-02-12,House,"Do Pass",68,0,0,1,69
1948015,1493153,2025-02-19,Senate,"Do Pass",6,0,0,1,7
1948015,1496067,2025-02-20,Senate,"Do Pass",35,0,0,0,35
1948021,1492966,2025-02-19,Senate,"Do Pass",3,4,0,0,7
1948021,1492967,2025-02-19,Senate,"Deferred to the 41st legislative day",4,3,0,0,7
1948029,1492941,2025-02-18,Senate,"Deferred to the 41st legislative day",5,1,0,1,7
1948031,1497773,2025-02-24,House,"Deferred to the 41st legislative day",9,3,0,1,13
1948038,1487309,2025-02-12,House,"Do Pass Amended",8,4,0,1,13
1948038,1492638,2025-02-18,House,"Do Pass Amended",32,37,0,1,70
1948044,1483285,2025-02-06,Senate,"Do Pass",4,3,0,0,7
1948044,1484383,2025-02-07,Senate,"Do Pass",13,22,0,0,35
1948047,1486489,2025-02-11,Senate,"Deferred to the 41st legislative day",7,2,0,0,9
1948051,1491862,2025-02-18,House,"Do Pass",8,0,0,1,9
1948051,1494627,2025-02-19,House,"Do Pass",69,1,0,0,70
1948051,1499548,2025-02-25,Senate,"Do Pass",9,0,0,0,9
1948051,1503899,2025-03-03,Senate,"Do Pass",32,2,0,1,35
1948056,1493197,2025-02-19,Senate,Tabled,7,0,0,0,7
1948060,1483174,2025-02-06,House,"Do Pass",7,6,0,0,13
1948060,1484230,2025-02-07,House,"Do Pass Amended",39,28,0,2,69
1948060,1504644,2025-03-04,Senate,"Deferred to the 41st legislative day",5,2,0,0,7
1948071,1495271,2025-02-20,Senate,Tabled,8,0,0,1,9
1948074,1496618,2025-02-21,House,"Do Pass",8,0,0,1,9
1948074,1498295,2025-02-24,House,"Do Pass",56,14,0,0,70
1948074,1508127,2025-03-06,Senate,Tabled,6,0,0,3,9
1948078,1484790,2025-02-10,House,"Deferred to the 41st legislative day",12,1,0,0,13
1948085,1484725,2025-02-10,House,"Do Pass",10,2,0,1,13
1948085,1488395,2025-02-12,House,"Do Pass Amended",59,9,0,1,69
1948085,1498666,2025-02-25,Senate,"Do Pass",4,3,0,2,9
1948085,1501189,2025-02-27,Senate,Tabled,6,3,0,0,9
1948087,1493829,2025-02-18,House,"Do Pass",13,0,0,0,13
1948087,1496108,2025-02-20,House,"Do Pass",69,1,0,0,70
1948087,1504743,2025-03-03,Senate,"Do Pass",5,0,0,0,5
1948087,1506826,2025-03-05,Senate,"Do Pass",34,0,0,1,35
1948092,1488353,2025-02-12,House,Tabled,15,0,0,0,15
1948102,1485544,2025-02-10,House,"Deferred to the 41st legislative day",11,1,0,1,13
1948108,1494900,2025-02-20,Senate,"Do Pass",4,3,0,0,7
1948108,1496604,2025-02-21,Senate,"Do Pass",20,13,0,2,35
1948108,1506068,2025-03-05,House,"Do Pass",6,7,0,0,13
1948108,1506069,2025-03-05,House,"Deferred to the 41st legislative day",8,5,0,0,13
1948108,1511771,2025-03-10,House,"Placed on calendar pursuant to JR 6F-6",36,33,0,1,70
1948108,1511772,2025-03-10,House,"Do Pass",35,34,0,1,70
1948108,1511773,2025-03-10,House,Reconsidered,35,34,0,1,70
1948114,1484335,2025-02-07,Senate,"Do Pass",9,0,0,0,9
1948114,1485649,2025-02-10,Senate,"Do Pass",34,0,0,1,35
1948114,1505673,2025-03-05,House,"Do Pass",13,0,0,0,13
1948114,1508028,2025-03-06,House,"Do Pass",69,0,0,1,70
1948118,1498048,2025-02-24,House,Tabled,13,0,0,0,13
1948127,1479906,2025-02-04,House,"Adopt Resolution",55,12,0,1,68
1948127,1486339,2025-02-11,Senate,"Concurred in Resolution",31,3,0,1,35
1948133,1496214,2025-02-21,Senate,"Do Pass",6,2,0,1,9
1948133,1498203,2025-02-24,Senate,"Do Pass",28,7,0,0,35
1948133,1506904,2025-03-05,House,Tabled,12,1,0,0,13
1948139,1495465,2025-02-20,Senate,"Do Pass",3,3,0,1,7
1948139,1495466,2025-02-20,Senate,Tabled,7,0,0,0,7
1948143,1497001,2025-02-21,Senate,Tabled,9,0,0,0,9
1948150,1496481,2025-02-21,Senate,Tabled,9,0,0,0,9
1948151,1496138,2025-02-21,Senate,"Do Pass",7,1,0,1,9
1948151,1498448,2025-02-24,Senate,"Do Pass",31,4,0,0,35
1948151,1506546,2025-03-05,House,Tabled,12,1,0,0,13
1948157,1496195,2025-02-21,House,Tabled,12,0,0,1,13
1948163,1488941,2025-02-13,Senate,"Do Pass",4,2,0,1,7
1948163,1492315,2025-02-18,Senate,"Do Pass",16,19,0,0,35
1948165,1488680,2025-02-12,Senate,"Do Pass",7,0,0,0,7
1948165,1492684,2025-02-18,Senate,"Do Pass",35,0,0,0,35
1948165,1500389,2025-02-26,House,"Do Pass",12,0,0,1,13
1948165,1502130,2025-02-27,House,"Do Pass",70,0,0,0,70
1948169,1484282,2025-02-07,House,"Do Pass",11,1,0,1,13
1948169,1485418,2025-02-10,House,"Do Pass",59,9,0,1,69
1948169,1508172,2025-03-06,Senate,"Do Pass",7,1,0,1,9
1948169,1511938,2025-03-10,Senate,"Do Pass",19,15,0,1,35
1948175,1485966,2025-02-10,House,"Do Pass",9,6,0,0,15
1948175,1488619,2025-02-10,House,"Do Pass Amended",9,6,0,0,15
1948175,1492642,2025-02-18,House,"Do Pass Amended",31,39,0,0,70
1948180,1495133,2025-02-20,House,"Do Pass",12,0,0,1,13
1948180,1496969,2025-02-21,House,"Do Pass",68,1,0,1,70
1948180,1505902,2025-03-05,Senate,Tabled,6,0,0,1,7
1948186,1484556,2025-02-10,House,"Do Pass Amended",10,1,0,2,13
1948186,1489871,2025-02-13,House,"Do Pass Amended",60,9,0,0,69
1948186,1507518,2025-03-06,Senate,"Do Pass Amended",7,1,0,1,9
1948186,1509596,2025-03-10,Senate,"Do Pass Amended",19,15,0,1,35
1948186,1515559,2025-03-11,House,"Concurred in amendments",63,6,0,1,70
1948186,1531119,2025-03-31,Senate,"Veto override",16,16,0,3,35
1948186,1531120,2025-03-31,House,"Veto override",50,18,0,2,70
1948191,1488718,2025-02-12,House,"Do Pass",5,8,0,0,13
1948191,1488719,2025-02-12,House,"Deferred to the 41st legislative day",8,5,0,0,13
1948191,1493979,2025-02-19,House,"Placed on calendar pursuant to JR 6F-6",43,27,0,0,70
1948191,1493980,2025-02-19,House,"Do Pass",45,25,0,0,70
1948191,1503234,2025-03-03,Senate,"Do Pass",5,3,0,1,9
1948191,1505138,2025-03-04,Senate,"Do Pass",22,12,0,1,35
1948194,1486236,2025-02-10,House,"Deferred to the 41st legislative day",9,5,0,1,15
1948194,1497402,2025-02-21,House,Reconsidered,8,7,0,0,15
1948201,1493707,2025-02-19,House,"Do Pass",13,0,0,0,13
1948201,1496017,2025-02-20,House,"Do Pass",65,5,0,0,70
1948201,1504409,2025-03-04,Senate,"Do Pass",6,0,0,1,7
1948201,1507889,2025-03-06,Senate,"Do Pass",33,1,0,1,35
1948209,1496227,2025-02-21,Senate,"Do Pass",6,2,0,1,9
1948209,1498236,2025-02-24,Senate,"Do Pass",31,4,0,0,35
1948209,1506978,2025-03-05,House,Tabled,12,1,0,0,13
1948217,1483993,2025-02-07,Senate,"Do Pass",9,0,0,0,9
1948217,1486904,2025-02-11,Senate,"Do Pass",34,0,0,1,35
1948217,1505743,2025-03-05,House,"Do Pass",12,1,0,0,13
1948217,1507902,2025-03-06,House,"Do Pass",63,6,0,1,70
1948231,1496434,2025-02-21,House,"Do Pass",8,0,0,1,9
1948231,1498280,2025-02-24,House,"Do Pass",58,12,0,0,70
1948231,1507442,2025-03-06,Senate,Tabled,6,0,0,3,9
1948237,1487580,2025-02-12,Senate,Tabled,5,0,0,2,7
1948243,1486650,2025-02-11,House,"Deferred to the 41st legislative day",10,2,0,1,13
1948248,1496452,2025-02-21,Senate,"Do Pass",9,0,0,0,9
1948248,1499471,2025-02-25,Senate,"Do Pass",16,19,0,0,35
1948251,1497873,2025-02-24,Senate,"Do Pass Amended",8,1,0,0,9
1948251,1499606,2025-02-25,Senate,"Do Pass Amended",32,3,0,0,35
1948251,1506620,2025-03-05,House,"Do Pass",13,0,0,0,13
1948251,1509251,2025-03-10,House,"Do Pass Amended",45,24,0,1,70
1948260,1489232,2025-02-13,House,"Deferred to the 41st legislative day",13,0,0,0,13
1948275,1495636,2025-02-20,House,Tabled,12,0,0,1,13
1948700,1496494,2025-02-21,Senate,"Deferred to the 41st legislative day",8,1,0,0,9
1949151,1497304,2025-02-24,House,"Do Pass",12,1,0,0,13
1949151,1499682,2025-02-25,House,"Do Pass",36,34,0,0,70
1949151,1505799,2025-03-04,Senate,"Do Pass",8,1,0,0,9
1949151,1508225,2025-03-06,Senate,Tabled,34,0,0,1,35
1949296,1497282,2025-02-24,House,"Deferred to the 41st legislative day",5,4,0,0,9
1949445,1486211,2025-02-10,House,"Do Pass Amended",8,4,0,1,13
1949445,1489756,2025-02-13,House,"Do Pass Amended",31,37,0,1,69
1949890,1493095,2025-02-19,House,"Deferred to the 41st legislative day",7,6,0,0,13
1951381,1483940,2025-02-07,House,"Do Pass Amended",10,2,0,1,13
1951381,1488097,2025-02-12,House,"Do Pass Amended",46,22,0,1,69
1951381,1507319,2025-03-06,Senate,"Do Pass Amended",5,3,0,1,9
1951381,1509527,2025-03-10,Senate,"Do Pass Amended",25,9,0,1,35
1951381,1514141,2025-03-11,House,"Concurred in amendments",56,13,0,1,70
1951399,1496171,2025-02-20,Senate,"Do Pass Amended",6,3,0,0,9
1951399,1499603,2025-02-25,Senate,"Do Pass Amended",14,21,0,0,35
1951404,1515564,2025-03-11,Joint,Tabled,17,0,0,1,18
1951652,1485951,2025-02-11,Senate,"Do Pass Amended",4,3,0,0,7
1951652,1489486,2025-02-13,Senate,"Do Pass Amended",11,24,0,0,35
1951785,1484571,2025-02-10,House,"Deferred to the 41st legislative day",10,1,0,2,13
1951877,1488247,2025-02-12,Senate,"Do Pass",9,0,0,0,9
1951877,1489633,2025-02-13,Senate,"Do Pass",35,0,0,0,35
1951877,1501012,2025-02-26,House,"Do Pass",8,5,0,0,13
1951877,1503646,2025-03-03,House,"Do Pass",14,55,0,1,70
1951973,1496205,2025-02-21,Senate,"Do Pass Amended",6,0,0,1,7
1951973,1499433,2025-02-25,Senate,"Do Pass Amended",35,0,0,0,35
1951973,1506585,2025-03-05,House,"Do Pass Amended",7,6,0,0,13
1951973,1509272,2025-03-10,House,"Do Pass Amended",7,62,0,1,70
1952067,1496861,2025-02-21,Senate,"Do Pass Amended",7,0,0,0,7
1952067,1499531,2025-02-25,Senate,"Do Pass Amended",33,2,0,0,35
1952067,1504505,2025-03-04,House,"Do Pass",9,3,0,1,13
1952067,1506742,2025-03-05,House,"Do Pass Amended",59,11,0,0,70
1952161,1485894,2025-02-11,House,"Deferred to the 41st legislative day",10,3,0,0,13
1953051,1494752,2025-02-20,House,"Do Pass Amended",10,2,0,1,13
1953051,1497623,2025-02-24,House,"Do Pass Amended",60,10,0,0,70
1953051,1507434,2025-03-06,Senate,"Do Pass",2,5,0,0,7
1953051,1507435,2025-03-06,Senate,"Deferred to the 41st legislative day",5,2,0,0,7
1953293,1485473,2025-02-10,House,"Deferred to the 41st legislative day",13,0,0,0,13
1953423,1492312,2025-02-18,House,"Deferred to the 41st legislative day",10,2,0,1,13
1953554,1484585,2025-02-10,House,"Do Pass Amended",10,1,0,2,13
1953554,1489827,2025-02-13,House,"Do Pass Amended",48,21,0,0,69
1953554,1505343,2025-03-03,Senate,"Do Pass",8,1,0,0,9
1953554,1506724,2025-03-05,Senate,"Do Pass Amended",34,0,0,1,35
1953696,1486181,2025-02-11,House,"Deferred to the 41st legislative day",11,2,0,0,13
1953833,1489149,2025-02-13,House,"Do Pass Amended",6,7,0,0,13
1953833,1489150,2025-02-13,House,"Deferred to the 41st legislative day",10,3,0,0,13
1953833,1494438,2025-02-19,House,"Placed on calendar pursuant to JR 6F-6",41,29,0,0,70
1953833,1494439,2025-02-19,House,"Do Pass Amended",44,26,0,0,70
1953833,1505745,2025-03-05,Senate,"Do Pass Amended",5,2,0,0,7
1953833,1512164,2025-03-10,Senate,"Do Pass Amended",30,4,0,1,35
1953833,1515424,2025-03-11,House,"Failed to concur, appoint Conference Committee",35,34,0,1,70
1953833,1515808,2025-03-12,Joint,"Concurred in amendments",5,0,0,1,6
1953833,1515809,2025-03-12,Joint,"Conference Committee Report adopted",5,0,0,1,6
1953833,1516742,2025-03-12,House,"Conference Committee Report adopted",56,14,0,0,70
1953833,1516743,2025-03-12,Senate,"Conference Committee Report adopted",32,3,0,0,35
1954325,1483853,2025-02-06,House,"Adopt Resolution",68,0,0,1,69
1954325,1486976,2025-02-11,Senate,"Concurred in Resolution",34,0,0,1,35
1954682,1493017,2025-02-19,Senate,Tabled,5,0,0,2,7
1955031,1489645,2025-02-13,House,"Deferred to the 41st legislative day",10,2,0,1,13
1955168,1485395,2025-02-10,House,"Motion to amend",7,4,0,2,13
1955168,1485396,2025-02-10,House,"Do Pass Amended",8,3,0,2,13
1955168,1489876,2025-02-13,House,"Do Pass Amended",33,36,0,0,69
1955168,1492864,2025-02-18,House,Reconsidered,34,36,0,0,70
1955238,1493076,2025-02-19,Senate,"Referred as Amended to",5,1,0,1,7
1955238,1501157,2025-02-27,Joint,Tabled,13,4,0,1,18
1955311,1487632,2025-02-12,House,"Do Pass Amended",11,1,0,1,13
1955311,1492644,2025-02-18,House,"Do Pass Amended",64,5,0,1,70
1955311,1503766,2025-03-03,Senate,"Do Pass",7,1,0,1,9
1955311,1505462,2025-03-04,Senate,"Do Pass Amended",32,2,0,1,35
1955377,1488704,2025-02-13,Senate,"Adopt Resolution",5,0,0,2,7
1955377,1494163,2025-02-19,Senate,"Adopt Resolution",32,2,0,1,35
1955377,1496950,2025-02-21,House,"Concurred in Resolution",63,6,0,1,70
1955443,1493225,2025-02-19,House,"Motion to amend",13,0,0,0,13
1955443,1493226,2025-02-19,House,"Referred to",13,0,0,0,13
1955443,1500641,2025-02-26,Joint,"Do Pass",15,3,0,0,18
1955443,1501749,2025-02-27,House,"Do Pass Amended",68,2,0,0,70
1955443,1505555,2025-03-04,Senate,"Do Pass Amended",33,1,0,1,35
1955511,1489290,2025-02-13,House,"Motion to amend",8,5,0,0,13
1955511,1489291,2025-02-13,House,"Do Pass Amended",7,6,0,0,13
1955511,1493748,2025-02-19,House,"Do Pass Amended",34,36,0,0,70
1955511,1496112,2025-02-20,House,Reconsidered,35,35,0,0,70
1955606,1487311,2025-02-12,House,"Deferred to the 41st legislative day",7,5,0,1,13
1955629,1494763,2025-02-20,Senate,"Do Pass Amended",4,5,0,0,9
1955629,1494764,2025-02-20,Senate,"Deferred to the 41st legislative day",5,4,0,0,9
1955652,1495592,2025-02-20,House,"Do Pass",12,1,0,0,13
1955652,1496700,2025-02-21,House,"Do Pass",69,0,0,1,70
1955652,1505840,2025-03-05,Senate,"Do Pass",7,0,0,0,7
1955652,1508245,2025-03-06,Senate,"Do Pass",34,0,0,1,35
1955675,1497246,2025-02-24,House,Tabled,12,0,0,1,13
1955698,1486447,2025-02-11,House,Tabled,11,2,0,0,13
1955721,1486567,2025-02-11,Senate,"Do Pass Amended",7,0,0,0,7
1955721,1492779,2025-02-18,Senate,"Do Pass Amended",7,28,0,0,35
1955743,1488681,2025-02-12,House,"Do Pass",11,2,0,0,13
1955743,1492645,2025-02-18,House,"Do Pass",62,8,0,0,70
1955743,1508155,2025-03-06,Senate,Tabled,6,1,0,2,9
1955885,1497482,2025-02-24,House,"Do Pass",9,4,0,0,13
1955885,1499689,2025-02-25,House,"Do Pass",37,32,0,1,70
1956113,1494003,2025-02-19,House,Tabled,15,0,0,0,15
1956120,1493439,2025-02-19,House,"Do Pass Amended",13,0,0,0,13
1956120,1496578,2025-02-21,House,"Do Pass Amended",68,1,0,1,70
1956120,1501651,2025-02-27,Senate,"Do Pass Amended",9,0,0,0,9
1956120,1505086,2025-03-04,Senate,"Do Pass Amended",34,0,0,1,35
1956120,1508123,2025-03-06,House,"Concurred in amendments",69,0,0,1,70
1956128,1489337,2025-02-13,Senate,"Deferred to the 41st legislative day",5,3,0,1,9
1956139,1492681,2025-02-18,House,"Adopt Resolution",13,0,0,0,13
1956139,1494463,2025-02-19,House,"Adopt Resolution",49,21,0,0,70
1956139,1500317,2025-02-26,Senate,"Concurred in Resolution",6,0,0,1,7
1956139,1504069,2025-03-03,Senate,"Concurred in Resolution",17,18,0,0,35
1956147,1488784,2025-02-12,House,"Do Pass Amended",12,1,0,0,13
1956147,1494449,2025-02-19,House,"Do Pass Amended",61,9,0,0,70
1956147,1507398,2025-03-06,Senate,"Do Pass",6,1,0,2,9
1956147,1511376,2025-03-10,Senate,"Do Pass Amended",21,12,0,2,35
1956153,1489632,2025-02-13,Senate,"Do Pass",5,3,0,1,9
1956153,1492769,2025-02-18,Senate,"Do Pass Amended",12,23,0,0,35
1956165,1493418,2025-02-19,House,Tabled,13,0,0,0,13
1956174,1493833,2025-02-19,House,Tabled,13,0,0,0,13
1956186,1485840,2025-02-11,House,"Deferred to the 41st legislative day",7,5,0,1,13
1956195,1494871,2025-02-20,Senate,Tabled,9,0,0,0,9
1956205,1488951,2025-02-13,House,"Referred to",13,0,0,0,13
1956205,1499949,2025-02-26,Joint,Tabled,13,4,0,1,18
1956213,1489779,2025-02-13,Senate,"Do Pass",5,3,0,1,9
1956213,1492793,2025-02-18,Senate,"Do Pass",15,20,0,0,35
1956223,1488278,2025-02-12,House,Tabled,12,0,0,1,13
1956233,1496824,2025-02-21,House,"Do Pass",2,9,0,2,13
1956233,1496825,2025-02-21,House,"Deferred to the 41st legislative day",9,2,0,2,13
1956242,1496271,2025-02-21,House,"Deferred to the 41st legislative day",8,3,0,2,13
1956250,1496454,2025-02-21,House,Tabled,11,0,0,2,13
1956258,1494808,2025-02-20,Senate,Tabled,8,0,0,1,9
1956285,1493010,2025-02-19,House,"Do Pass",10,5,0,0,15
1956285,1495286,2025-02-20,House,"Do Pass",38,32,0,0,70
1956285,1507205,2025-03-06,Senate,"Do Pass",5,2,0,0,7
1956285,1511281,2025-03-10,Senate,"Motion to amend",18,16,0,1,35
1956285,1511282,2025-03-10,Senate,"Do Pass Amended",32,2,0,1,35
1956285,1514929,2025-03-11,House,"Concurred in amendments",36,34,0,0,70
1956295,1497310,2025-02-24,House,"Do Pass Amended",11,1,0,1,13
1956295,1499577,2025-02-25,House,"Do Pass Amended",36,34,0,0,70
1956295,1505636,2025-03-04,Senate,"Do Pass Amended",5,3,0,1,9
1956295,1509574,2025-03-10,Senate,Tabled,25,8,0,2,35
1956304,1493202,2025-02-19,House,"Deferred to the 41st legislative day",14,1,0,0,15
1956321,1492521,2025-02-18,House,"Do Pass Amended",9,4,0,0,13
1956321,1495747,2025-02-20,House,"Do Pass Amended",66,4,0,0,70
1956321,1506667,2025-03-05,Senate,"Do Pass Amended",5,0,0,2,7
1956321,1511668,2025-03-10,Senate,"Do Pass Amended",31,1,0,3,35
1956321,1515606,2025-03-11,House,"Concurred in amendments",65,5,0,0,70
1956330,1496622,2025-02-21,House,"Do Pass",11,0,0,2,13
1956330,1498454,2025-02-24,House,"Do Pass",66,4,0,0,70
1956330,1507900,2025-03-06,Senate,"Do Pass Amended",7,0,0,0,7
1956330,1509762,2025-03-10,Senate,"Do Pass Amended",34,0,0,1,35
1956330,1515450,2025-03-11,House,"Concurred in amendments",66,4,0,0,70
1956352,1494955,2025-02-20,House,"Do Pass",3,8,0,2,13
1956352,1494956,2025-02-20,House,"Deferred to the 41st legislative day",8,3,1,1,13
1956361,1494252,2025-02-19,Senate,Tabled,7,0,0,0,7
1956369,1496679,2025-02-21,House,"Do Pass Amended",8,4,0,1,13
1956369,1499453,2025-02-25,House,"Do Pass Amended",36,34,0,0,70
1956369,1505815,2025-03-04,Senate,"Do Pass",5,4,0,0,9
1956369,1512437,2025-03-10,Senate,"Do Pass Amended",17,16,0,2,35
1956369,1512438,2025-03-10,Senate,Reconsidered,16,18,0,1,35
1956377,1488148,2025-02-12,Senate,"Adopt Resolution",5,0,0,2,7
1956377,1489551,2025-02-13,Senate,"Adopt Resolution",35,0,0,0,35
1956377,1495411,2025-02-20,House,"Concurred in Resolution",54,16,0,0,70
1956387,1491911,2025-02-18,Senate,"Do Pass",4,5,0,0,9
1956387,1491912,2025-02-18,Senate,"Deferred to the 41st legislative day",5,4,0,0,9
1956397,1496233,2025-02-21,House,"Do Pass Amended",9,3,0,1,13
1956397,1499311,2025-02-25,House,"Do Pass Amended",39,31,0,0,70
1956397,1505796,2025-03-05,Senate,"Do Pass",6,0,0,1,7
1956397,1509747,2025-03-10,Senate,"Do Pass Amended",13,21,0,1,35
1956407,1493273,2025-02-19,House,Tabled,10,0,0,3,13
1956412,1491871,2025-02-18,House,"Do Pass",10,2,0,1,13
1956412,1494019,2025-02-19,House,"Do Pass",51,19,0,0,70
1956412,1498752,2025-02-25,Senate,"Do Pass",4,3,0,0,7
1956412,1500272,2025-02-26,Senate,"Do Pass Amended",5,29,0,1,35
1956424,1498270,2025-02-24,Senate,Tabled,9,0,0,0,9
1956433,1497892,2025-02-24,Senate,"Do Pass",4,5,0,0,9
1956433,1497893,2025-02-24,Senate,"Deferred to the 41st legislative day",5,4,0,0,9
1956433,1499192,2025-02-25,Senate,"Placed on calendar pursuant to JR 6F-6",15,20,0,0,35
1956451,1487640,2025-02-12,House,Tabled,11,0,0,2,13
1956464,1494641,2025-02-20,Senate,"Deferred to the 41st legislative day",5,2,0,0,7
1956472,1488181,2025-02-12,House,Tabled,12,0,0,1,13
1956480,1493164,2025-02-19,Senate,"Do Pass Amended",5,3,0,1,9
1956480,1496933,2025-02-21,Senate,"Do Pass Amended",17,16,0,2,35
1956480,1497801,2025-02-24,Senate,Reconsidered,19,16,0,0,35
1956480,1497802,2025-02-24,Senate,"Do Pass Amended",18,17,0,0,35
1956480,1503134,2025-03-03,House,"Deferred to the 41st legislative day",12,0,0,1,13
1956480,1503135,2025-03-03,House,Reconsidered,10,3,0,0,13
1956480,1503136,2025-03-03,House,"Motion to amend",9,4,0,0,13
1956480,1506976,2025-03-05,House,Tabled,11,2,0,0,13
1956493,1496203,2025-02-21,Senate,Tabled,6,0,0,1,7
1956522,1491951,2025-02-18,Senate,Tabled,7,0,0,2,9
1956540,1495084,2025-02-20,Senate,"Do Pass",6,0,0,1,7
1956540,1496756,2025-02-21,Senate,"Do Pass",21,12,0,2,35
1956540,1504380,2025-03-04,House,"Do Pass",4,9,0,0,13
1956540,1504381,2025-03-04,House,"Deferred to the 41st legislative day",10,3,0,0,13
1956548,1488660,2025-02-13,Senate,"Do Pass Amended",4,3,0,0,7
1956548,1493898,2025-02-19,Senate,"Do Pass Amended",19,15,0,1,35
1956548,1500117,2025-02-26,House,"Do Pass",8,7,0,0,15
1956548,1501552,2025-02-27,House,"Do Pass Amended",31,39,0,0,70
1956548,1503695,2025-03-03,House,Reconsidered,29,39,0,2,70
1956557,1496609,2025-02-21,Senate,"Do Pass Amended",7,1,0,1,9
1956557,1499283,2025-02-25,Senate,"Adopt Resolution",32,3,0,0,35
1956566,1486609,2025-02-10,House,"Do Pass Amended",9,2,0,2,13
1956566,1489781,2025-02-13,House,"Do Pass Amended",44,24,0,1,69
1956566,1505099,2025-03-03,Senate,"Do Pass",4,1,0,0,5
1956566,1506931,2025-03-05,Senate,"Do Pass Amended",25,8,0,2,35
1956574,1496528,2025-02-21,Senate,"Do Pass",8,0,0,1,9
1956574,1498450,2025-02-24,Senate,"Do Pass Amended",31,4,0,0,35
1956574,1503878,2025-03-03,House,"Do Pass",10,2,0,1,13
1956574,1506989,2025-03-05,House,"Do Pass Amended",32,38,0,0,70
1956577,1488679,2025-02-12,Senate,"Do Pass Amended",7,0,0,0,7
1956577,1494380,2025-02-19,Senate,"Do Pass Amended",34,0,0,1,35
1956577,1506119,2025-03-05,House,"Do Pass",12,0,0,1,13
1956577,1508362,2025-03-06,House,"Do Pass Amended",69,0,0,1,70
1956598,1496137,2025-02-20,Senate,"Do Pass Amended",8,1,0,0,9
1956598,1499170,2025-02-25,Senate,"Do Pass Amended",30,5,0,0,35
1956598,1506726,2025-03-05,House,"Do Pass",9,4,0,0,13
1956598,1509673,2025-03-10,House,"Do Pass Amended",35,34,0,1,70
1956598,1509674,2025-03-10,House,Reconsidered,46,23,0,1,70
1956598,1509675,2025-03-10,House,"Do Pass Amended",53,16,0,1,70
1956598,1514564,2025-03-11,Senate,"Concurred in amendments",29,6,0,0,35
1956625,1487429,2025-02-12,Senate,"Do Pass Amended",5,3,0,1,9
1956625,1492523,2025-02-18,Senate,Tabled,35,0,0,0,35
1956694,1488614,2025-02-12,House,"Do Pass Amended",9,4,0,0,13
1956694,1493771,2025-02-19,House,"Do Pass Amended",35,35,0,0,70
1956694,1495327,2025-02-20,House,Reconsidered,34,36,0,0,70
1956732,1494819,2025-02-20,House,"Adopt Resolution",9,3,0,1,13
1956732,1496552,2025-02-21,House,"Adopt Resolution",60,9,0,1,70
1956732,1504530,2025-03-04,Senate,"Deferred to the 41st legislative day",4,3,0,0,7
1956772,1494836,2025-02-20,House,"Do Pass",8,4,0,1,13
1956772,1496550,2025-02-21,House,"Do Pass",47,22,0,1,70
1956772,1507470,2025-03-06,Senate,"Do Pass",3,4,0,0,7
1956772,1507471,2025-03-06,Senate,"Deferred to the 41st legislative day",4,3,0,0,7
1956803,1497380,2025-02-24,House,"Do Pass",12,0,0,1,13
1956803,1499555,2025-02-25,House,"Adopt Resolution",70,0,0,0,70
1956803,1505665,2025-03-04,Senate,"Do Pass",8,0,0,1,9
1956803,1508171,2025-03-06,Senate,"Concurred in Resolution",34,0,0,1,35
1956840,1489136,2025-02-13,House,"Do Pass",6,6,0,1,13
1956840,1489137,2025-02-13,House,"Deferred to the 41st legislative day",8,4,0,1,13
1956876,1497384,2025-02-24,House,"Do Pass",12,0,0,1,13
1956876,1499289,2025-02-25,House,"Adopt Resolution",70,0,0,0,70
1956876,1505822,2025-03-04,Senate,"Do Pass",8,0,0,1,9
1956876,1508241,2025-03-06,Senate,"Concurred in Resolution",34,0,0,1,35
1956911,1492739,2025-02-18,House,"Do Pass Amended",13,0,0,0,13
1956911,1495609,2025-02-20,House,"Do Pass Amended",69,1,0,0,70
1956911,1500291,2025-02-26,Senate,"Do Pass",6,0,0,1,7
1956911,1501559,2025-02-27,Senate,"Do Pass Amended",35,0,0,0,35
1956946,1491925,2025-02-18,House,"Do Pass",9,3,0,1,13
1956946,1493859,2025-02-19,House,"Do Pass",38,32,0,0,70
1956946,1500032,2025-02-26,Senate,"Do Pass",4,3,0,0,7
1956946,1501506,2025-02-27,Senate,"Do Pass",14,21,0,0,35
1956981,1485828,2025-02-10,House,"Adopt Resolution",9,2,0,2,13
1956981,1488009,2025-02-12,House,"Adopt Resolution",40,28,0,1,69
1956981,1505662,2025-03-04,Senate,"Do Pass",5,3,0,1,9
1956981,1507708,2025-03-06,Senate,"Concurred in Resolution",17,17,0,1,35
1957017,1496923,2025-02-21,House,Tabled,9,1,0,3,13
1957056,1496612,2025-02-21,House,"Deferred to the 41st legislative day",12,3,0,0,15
1957091,1488676,2025-02-13,Senate,"Do Pass",4,3,0,0,7
1957091,1492538,2025-02-18,Senate,"Do Pass",19,16,0,0,35
1957091,1500140,2025-02-26,House,"Do Pass",10,5,0,0,15
1957091,1502094,2025-02-27,House,"Do Pass",36,34,0,0,70
1957122,1497795,2025-02-24,House,"Do Pass Amended",4,8,0,1,13
1957122,1497796,2025-02-24,House,"Deferred to the 41st legislative day",9,3,0,1,13
1957122,1499608,2025-02-25,House,"Placed on calendar pursuant to JR 6F-6",32,36,0,2,70
1957122,1499609,2025-02-25,House,"Do Pass Amended",4,9,0,0,13
1957122,1499610,2025-02-25,House,"Do Not Pass as amended",9,4,0,0,13
1957163,1494674,2025-02-20,House,Tabled,13,0,0,0,13
1957197,1491868,2025-02-18,House,"Do Pass",12,1,0,0,13
1957197,1494430,2025-02-19,House,"Do Pass",38,32,0,0,70
1957197,1508180,2025-03-06,Senate,"Do Pass",7,0,0,2,9
1957197,1511345,2025-03-10,Senate,"Do Pass",34,0,0,1,35
1957234,1487415,2025-02-12,Senate,"Deferred to the 41st legislative day",5,4,0,0,9
1957271,1497559,2025-02-24,House,"Deferred to the 41st legislative day",9,4,0,0,13
1957302,1489682,2025-02-13,Senate,Tabled,8,0,0,1,9
1957412,1491757,2025-02-18,House,"Deferred to the 41st legislative day",7,5,0,1,13
1957448,1488610,2025-02-12,House,"Do Pass Amended",11,2,0,0,13
1957448,1493742,2025-02-19,House,"Do Pass Amended",49,21,0,0,70
1957448,1504518,2025-03-03,Senate,"Do Pass Amended",7,2,0,0,9
1957448,1509735,2025-03-10,Senate,"Do Pass Amended",27,6,0,2,35
1957448,1514770,2025-03-11,House,"Concurred in amendments",58,9,0,3,70
2000048,1514337,2025-03-11,Joint,"Do Pass",18,0,0,0,18
2000048,1517478,2025-03-13,Senate,"Do Pass",34,1,0,0,35
2000048,1517479,2025-03-13,House,"Do Pass",59,11,0,0,70
