bill_id,roll_call_id,date,chamber,description,yea,nay,nv,absent,total
1904300,1471130,2025-01-07,House,"House Floor: HR 1 PN 1",196,6,0,1,203
1904442,1471123,2025-01-07,Senate,"Senate Floor: SR 3",46,2,1,0,49
1904517,1471124,2025-01-07,Senate,"Senate Floor: SR 6, Recommit to the Committee on Rules",27,21,1,0,49
1904585,1471125,2025-01-07,Senate,"Senate Floor: SR 5, Recommit to the Committee on Rules",27,21,1,0,49
1904656,1471126,2025-01-07,Senate,"Senate Floor: SR 4, Recommit to the Committee on Rules",27,21,1,0,49
1904723,1471127,2025-01-07,Senate,"Senate Floor: SR 2",46,2,1,0,49
1904788,1471128,2025-01-07,Senate,"Senate Floor: SR 1, Reconsidered",46,2,1,0,49
1905317,1593863,2025-06-23,House,"House Judiciary: Report Bill As Amended",26,0,0,0,26
1905317,1593864,2025-06-23,House,"House Judiciary: Adopt Amendment A00770",26,0,0,0,26
1905317,1596338,2025-06-30,House,"House Rules: Re-report Bill As Committed",33,0,0,0,33
1905317,1597003,2025-07-01,House,"House Appropriations: Re-report Bill As Committed",37,0,0,0,37
1905317,1597086,2025-07-01,House,"House Floor: HB 18 PN 1974, FINAL PASSAGE",202,0,0,1,203
1905317,1601436,2025-09-09,Senate,"Senate Judiciary: Reported as Committed",13,0,1,0,14
1905489,1567305,2025-05-07,House,"House Education: Report Bill As Committed",26,0,0,0,26
1905489,1594124,2025-06-24,House,"House Appropriations: Re-report Bill As Committed",37,0,0,0,37
1905489,1594322,2025-06-24,House,"House Floor: HB 17 PN 2, FINAL PASSAGE",195,8,0,0,203
1905489,1598786,2025-07-16,Senate,"Senate Education: Reported as Committed",9,2,0,0,11
1905578,1475257,2025-01-28,House,"House Veterans Affairs And Emergency Preparedness: Report Bill As Committed",26,0,0,0,26
1905578,1527546,2025-03-26,House,"House Floor: HR 2 PN 33",201,0,0,1,202
1905838,1476206,2025-01-29,House,"House Health: Report Bill As Amended",25,1,0,0,26
1905838,1479539,2025-02-04,House,"House Appropriations: Re-report Bill As Committed",37,0,0,0,37
1905838,1479959,2025-02-04,House,"House Floor: HB 27 PN 8, FINAL PASSAGE",171,31,0,0,202
1905838,1588443,2025-06-11,Senate,"Senate Health And Human Services: Reported as Committed",12,0,1,0,13
1907244,1476115,2025-01-29,House,"House Health: Report Bill As Amended",25,1,0,0,26
1907244,1476116,2025-01-29,House,"House Health: Adopt Amendment A00007",26,0,0,0,26
1907244,1476117,2025-01-29,House,"House Health: Adopt Amendment A00013",25,1,0,0,26
1907244,1518476,2025-03-17,House,"House Floor: HB 33 PN 441, FINAL PASSAGE",194,8,0,0,202
1907244,1518477,2025-03-17,House,"House Appropriations: Re-report Bill As Committed",37,0,0,0,37
1907270,1590973,2025-06-16,House,"House Agriculture And Rural Affairs: Report Bill As Committed",26,0,0,0,26
1907270,1596533,2025-06-30,House,"House Floor: HR 5 PN 35",200,3,0,0,203
1907356,1565480,2025-05-06,House,"House Professional Licensure: Report Bill As Committed",26,0,0,0,26
1907356,1586586,2025-06-09,House,"House Appropriations: Re-report Bill As Committed",37,0,0,0,37
1907356,1586812,2025-06-09,House,"House Floor: HB 30 PN 11, FINAL PASSAGE",202,0,0,1,203
1907382,1478769,2025-02-03,House,"House Judiciary: Report Bill As Committed",25,1,0,0,26
1907382,1519616,2025-03-18,House,"House Floor: HB 36 PN 15, FINAL PASSAGE",173,29,0,0,202
1907382,1519617,2025-03-18,House,"House Appropriations: Re-report Bill As Committed",37,0,0,0,37
1907398,1478648,2025-02-03,House,"House Transportation: Re-refer Bill To Another Committee",26,0,0,0,26
1907484,1569357,2025-05-12,House,"House Intergovernmental Affairs And Operations: Report Bill As Committed",20,6,0,0,26
1908413,1480607,2025-02-05,House,"House Health: Report Bill As Amended A00005",26,0,0,0,26
1908413,1480608,2025-02-05,House,"House Health: Adopt Amendment A00005",26,0,0,0,26
1908413,1520765,2025-03-19,House,"House Appropriations: Re-report Bill As Committed",37,0,0,0,37
1908413,1521193,2025-03-19,House,"House Floor: HB 60 PN 474, FINAL PASSAGE",202,0,0,0,202
1908762,1475913,2025-01-28,House,"House Housing And Community Development: Report Bill As Committed",14,12,0,0,26
1908762,1570280,2025-05-13,House,"House Floor: HB 67 PN 55, FINAL PASSAGE",128,75,0,0,203
1908762,1570281,2025-05-13,House,"House Appropriations: Re-report Bill As Committed",37,0,0,0,37
1908798,1519380,2025-03-17,House,"House Consumer Protection, Technology And Utilities: Report Bill As Committed",24,2,0,0,26
1908798,1565682,2025-05-06,House,"House Floor: HB 81 PN 32, FINAL PASSAGE",123,80,0,0,203
1908798,1565683,2025-05-06,House,"House Appropriations: Re-report Bill As Committed",36,1,0,0,37
1908910,1519360,2025-03-18,House,"House Commerce: Adopt Amendment A00126",26,0,0,0,26
1908910,1519361,2025-03-18,House,"House Commerce: Report Bill As Amended",26,0,0,0,26
1908910,1555075,2025-04-23,House,"House Floor: HB 78 PN 1024, 2025 A174",203,0,0,0,203
1909024,1475301,2025-01-28,House,"House Agriculture And Rural Affairs: Report Bill As Committed",20,6,0,0,26
1909024,1480808,2025-02-05,House,"House Floor: HB 77 PN 29, FINAL PASSAGE",150,52,0,0,202
1909024,1480809,2025-02-05,House,"House Appropriations: Re-report Bill As Committed",37,0,0,0,37
1909063,1586631,2025-06-09,House,"House Transportation: Report Bill As Committed",26,0,0,0,26
1909142,1541426,2025-04-09,House,"House Health: Report Bill As Amended A00328",26,0,0,0,26
1909142,1541427,2025-04-09,House,"House Health: Adopt Amendment A00328",26,0,0,0,26
1909142,1570179,2025-05-13,House,"House Floor: HB 79 PN 1326, FINAL PASSAGE",187,16,0,0,203
1909142,1570180,2025-05-13,House,"House Appropriations: Re-report Bill As Committed",37,0,0,0,37
1909297,1569353,2025-05-12,House,"House Aging And Older Adult Services: Report Bill As Committed",26,0,0,0,26
1909373,1591388,2025-06-17,House,"House Professional Licensure: Report Bill As Amended",26,0,0,0,26
1909373,1591389,2025-06-17,House,"House Professional Licensure: Adopt Amendment A01065",26,0,0,0,26
1909373,1597000,2025-07-01,House,"House Rules: Re-report Bill As Committed",33,0,0,0,33
1909373,1597636,2025-07-07,House,"House Floor: HB 80 PN 1941, FINAL PASSAGE",203,0,0,0,203
1909373,1597637,2025-07-07,House,"House Appropriations: Re-report Bill As Committed",37,0,0,0,37
1909406,1541363,2025-04-09,House,"House Health: Report Bill As Amended A00299",26,0,0,0,26
1909406,1541364,2025-04-09,House,"House Health: Adopt Amendment A00299",26,0,0,0,26
1911584,1539289,2025-04-08,House,"House Commerce: Report Bill As Committed",26,0,0,0,26
1911584,1565588,2025-05-06,House,"House Floor: HB 96 PN 79, 2025 A439",203,0,0,0,203
1911584,1567264,2025-05-07,House,"House Floor: HB 96 PN 1627, FINAL PASSAGE",201,2,0,0,203
1911584,1567265,2025-05-07,House,"House Appropriations: Re-report Bill As Committed",37,0,0,0,37
1911584,1588611,2025-06-11,Senate,"Senate Urban Affairs And Housing: Reported as Committed",11,0,0,0,11
1911674,1476522,2025-01-29,House,"House Health: Report Bill As Committed",26,0,0,0,26
1911849,1565508,2025-05-06,House,"House Professional Licensure: Report Bill As Amended",26,0,0,0,26
1911849,1565509,2025-05-06,House,"House Professional Licensure: Adopt Amendment A00455",26,0,0,0,26
1911908,1524698,2025-03-24,House,"House Game And Fisheries: Bring Up The Bill For Consideration",25,0,1,0,26
1911908,1524699,2025-03-24,House,"House Game And Fisheries: Adopt Amendment",25,0,1,0,26
1911908,1567196,2025-05-07,House,"House Floor: HB 103 PN 1113, FINAL PASSAGE",148,55,0,0,203
1911908,1567197,2025-05-07,House,"House Appropriations: Re-report Bill As Committed",37,0,0,0,37
1911908,1594168,2025-06-24,Senate,"Senate Game And Fisheries: Reported as Amended",11,0,0,0,11
1911908,1594169,2025-06-24,Senate,"Senate Game And Fisheries: Adopt Amendment A01289",11,0,0,0,11
1911908,1594860,2025-06-25,Senate,"Senate Appropriations: Re-Reported as Committed",22,0,0,0,22
1911908,1595450,2025-06-26,Senate,"Senate Floor: HB 103 PN 1999, Final Passage",50,0,0,0,50
1911908,1596434,2025-06-30,House,"House Rules: Re-report Bill As Committed",33,0,0,0,33
1911908,1596525,2025-06-30,House,"House Floor: HB 103 PN 1999, CONCURRENCE",201,2,0,0,203
1912162,1591458,2025-06-17,House,"House Judiciary: Report Bill As Committed",15,11,0,0,26
1912162,1598191,2025-07-14,House,"House Rules: Re-report Bill As Committed",18,15,0,0,33
1912225,1591466,2025-06-17,House,"House Judiciary: Report Bill As Amended",25,1,0,0,26
1912225,1591467,2025-06-17,House,"House Judiciary: Adopt Amendment A01141",25,1,0,0,26
1914873,1538069,2025-04-07,House,"House Environmental And Natural Resource Protection: Adopt Amendment A00274",14,12,0,0,26
1914873,1538070,2025-04-07,House,"House Environmental And Natural Resource Protection: Report Bill As Amended",14,12,0,0,26
1914921,1474681,2025-01-27,House,"House Education: Report Bill As Committed",26,0,0,0,26
1914921,1476881,2025-01-29,House,"House Floor: HR 9 PN 98",199,3,0,0,202
1915019,1475450,2025-01-28,House,"House Insurance: Report Bill As Committed",26,0,0,0,26
1915019,1518370,2025-03-17,House,"House Floor: HB 111 PN 89, FINAL PASSAGE",153,49,0,0,202
1915019,1518371,2025-03-17,House,"House Appropriations: Re-report Bill As Committed",37,0,0,0,37
1915770,1480505,2025-02-05,House,"House Labor And Industry: Adopt Amendment A00036",12,14,0,0,26
1915770,1480506,2025-02-05,House,"House Labor And Industry: Report Bill As Committed",15,11,0,0,26
1915770,1520842,2025-03-19,House,"House Floor: HB 118 PN 100, 2025 A143",101,101,0,0,202
1915770,1524694,2025-03-24,House,"House Floor: HB 118 PN 100, FINAL PASSAGE",117,85,0,0,202
1915770,1524695,2025-03-24,House,"House Appropriations: Re-report Bill As Committed",22,15,0,0,37
1915812,1587644,2025-06-10,House,"House Communications And Technology: Report Bill As Amended",26,0,0,0,26
1915812,1587645,2025-06-10,House,"House Communications And Technology: Adopt Amendment A00934",26,0,0,0,26
1915812,1596458,2025-06-30,House,"House Rules: Re-report Bill As Committed",33,0,0,0,33
1915812,1596563,2025-06-30,House,"House Floor: HB 129 PN 1875, 2025 A1080",96,107,0,0,203
1915812,1596564,2025-06-30,House,"House Floor: HB 129 PN 1875, 2025 A1335",203,0,0,0,203
1915812,1597043,2025-07-01,House,"House Floor: HB 129 PN 2061, FINAL PASSAGE",159,43,0,1,203
1915812,1597044,2025-07-01,House,"House Appropriations: Re-report Bill As Committed",36,1,0,0,37
1916135,1520900,2025-03-19,House,"House Children And Youth: Adopt Amendment A00112",26,0,0,0,26
1916135,1520901,2025-03-19,House,"House Children And Youth: Report Bill As Amended A00112",26,0,0,0,26
1916135,1539494,2025-04-08,House,"House Floor: HB 156 PN 1047, 2025 A303",202,1,0,0,203
1916135,1541801,2025-04-09,House,"House Floor: HB 156 PN 1302, FINAL PASSAGE",176,27,0,0,203
1916135,1541802,2025-04-09,House,"House Appropriations: Re-report Bill As Committed",37,0,0,0,37
1917015,1525115,2025-03-24,House,"House Game And Fisheries: Bring Up The Bill For Consideration",25,0,1,0,26
1917292,1526220,2025-03-25,House,"House Judiciary: Bring Up The Bill For Consideration",26,0,0,0,26
1917355,1480628,2025-02-05,House,"House Health: Report Bill As Amended A00009",26,0,0,0,26
1917355,1480629,2025-02-05,House,"House Health: Adopt Amendment A00009",26,0,0,0,26
1917355,1520736,2025-03-19,House,"House Appropriations: Re-report Bill As Committed",37,0,0,0,37
1917355,1521051,2025-03-19,House,"House Floor: HB 157 PN 475, FINAL PASSAGE",194,8,0,0,202
1917413,1480641,2025-02-05,House,"House Local Government: Adopt Amendment A00040",25,1,0,0,26
1917413,1480642,2025-02-05,House,"House Local Government: Report Bill As Amended",25,1,0,0,26
1917583,1478718,2025-02-03,House,"House Judiciary: Report Bill As Committed",25,1,0,0,26
1918483,1480706,2025-02-05,House,"House Labor And Industry: Adopt Amendment A00037",14,12,0,0,26
1918483,1480707,2025-02-05,House,"House Labor And Industry: Report Bill As Amended",14,12,0,0,26
1918483,1538108,2025-04-07,House,"House Appropriations: Re-report Bill As Committed",23,14,0,0,37
1918483,1538529,2025-04-07,House,"House Floor: HB 183 PN 506, FINAL PASSAGE",118,85,0,0,203
1919572,1567396,2025-05-07,House,"House Education: Report Bill As Amended",23,3,0,0,26
1919572,1567397,2025-05-07,House,"House Education: Adopt Amendment A00465",26,0,0,0,26
1919572,1584655,2025-06-04,House,"House Floor: HB 191 PN 1646, 2025 A637",202,0,0,1,203
1919572,1586581,2025-06-09,House,"House Appropriations: Re-report Bill As Committed",37,0,0,0,37
1919572,1586800,2025-06-09,House,"House Floor: HB 191 PN 1840, FINAL PASSAGE",169,33,0,1,203
1919691,1539695,2025-04-08,House,"House State Government: Report Bill As Committed",24,2,0,0,26
1919691,1564873,2025-05-05,House,"House Floor: HB 193 PN 140, FINAL PASSAGE",150,53,0,0,203
1919691,1564874,2025-05-05,House,"House Appropriations: Re-report Bill As Committed",37,0,0,0,37
1919811,1474720,2025-01-27,House,"House Education: Report Bill As Amended",18,8,0,0,26
1919811,1474721,2025-01-27,House,"House Education: Adopt Amendment A00006",21,5,0,0,26
1919811,1478681,2025-02-03,House,"House Floor: HB 190 PN 318, FINAL PASSAGE",161,41,0,0,202
1919811,1478682,2025-02-03,House,"House Appropriations: Re-report Bill As Committed",37,0,0,0,37
1920372,1476865,2025-01-29,House,"House Health: Report Bill As Committed",26,0,0,0,26
1920505,1583700,2025-06-03,House,"House Communications And Technology: Report Bill As Amended",26,0,0,0,26
1920505,1583701,2025-06-03,House,"House Communications And Technology: Adopt Amendment A00806",26,0,0,0,26
1922510,1479572,2025-02-04,House,"House State Government: Adopt Resolution",22,4,0,0,26
1922510,1480649,2025-02-05,House,"House Floor: HR 12 PN 167",198,4,0,0,202
1923784,1480756,2025-02-05,House,"House Local Government: Report Bill As Committed",26,0,0,0,26
1923784,1527516,2025-03-26,House,"House Floor: HB 209 PN 157, FINAL PASSAGE",194,7,0,1,202
1923784,1527517,2025-03-26,House,"House Appropriations: Re-report Bill As Committed",37,0,0,0,37
1923784,1587285,2025-06-10,Senate,"Senate Local Government: Reported as Committed",11,0,0,0,11
1923784,1594880,2025-06-25,Senate,"Senate Floor: HB 209 PN 157, Final Passage",49,1,0,0,50
1923784,1594881,2025-06-25,Senate,"Senate Appropriations: Re-Reported as Committed",22,0,0,0,22
1924115,1475341,2025-01-28,House,"House Insurance: Report Bill As Committed",26,0,0,0,26
1924115,1479514,2025-02-04,House,"House Appropriations: Re-report Bill As Committed",37,0,0,0,37
1924115,1479932,2025-02-04,House,"House Floor: HB 211 PN 148, FINAL PASSAGE",202,0,0,0,202
1924115,1594127,2025-06-24,Senate,"Senate Banking And Insurance: Reported as Committed",14,0,0,0,14
1924115,1594897,2025-06-25,Senate,"Senate Appropriations: Re-Reported as Committed",22,0,0,0,22
1924115,1595463,2025-06-26,Senate,"Senate Floor: HB 211 PN 148, Final Passage",50,0,0,0,50
1924225,1586451,2025-06-09,House,"House Transportation: Adopt Amendment A00765",26,0,0,0,26
1924225,1586452,2025-06-09,House,"House Transportation: Report Bill As Amended",25,1,0,0,26
1924225,1590937,2025-06-16,House,"House Rules: Re-report Bill As Committed",33,0,0,0,33
1924225,1591618,2025-06-17,House,"House Appropriations: Re-report Bill As Committed",37,0,0,0,37
1924225,1593979,2025-06-23,House,"House Floor: HB 205 PN 1868, FINAL PASSAGE",132,71,0,0,203
1927231,1474684,2025-01-27,House,"House Transportation: Report Bill As Committed",26,0,0,0,26
1927231,1479893,2025-02-04,House,"House Floor: HB 257 PN 203, FINAL PASSAGE",202,0,0,0,202
1927231,1479894,2025-02-04,House,"House Appropriations: Re-report Bill As Committed",37,0,0,0,37
1927231,1584606,2025-06-04,Senate,"Senate Transportation: Reported as Committed",14,0,0,0,14
1927231,1587842,2025-06-10,Senate,"Senate Floor: HB 257 PN 203, Motion to consider the bill on second consideration",50,0,0,0,50
1927231,1588574,2025-06-11,Senate,"Senate Floor: HB 257 PN 203, Re-referred to the Committee on Appropriations",49,0,0,1,50
1927231,1594317,2025-06-24,Senate,"Senate Appropriations: Re-Reported as Committed",22,0,0,0,22
1927231,1599298,2025-08-12,Senate,"Senate Floor: HB 257 PN 203, 2025 A1615, PITTMAN Amendment No. A-1615",27,22,0,1,50
1927231,1599299,2025-08-12,Senate,"Senate Floor: HB 257 PN 203, 2025 A1617, Motion to Table SAVAL Amendment No. A-1617",27,22,0,1,50
1927231,1599300,2025-08-12,Senate,"Senate Floor: HB 257 PN 203, 2025 A1637, Motion to Table BOSCOLA Amendment No. A-1637",27,22,0,1,50
1927231,1599301,2025-08-12,Senate,"Senate Floor: HB 257 PN 203, Third Consideration as Amended",27,22,0,1,50
1927231,1599302,2025-08-12,Senate,"Senate Floor: HB 257 PN 2211, Final Passage",27,22,0,1,50
1927231,1599332,2025-08-13,House,"House Rules: Re-report Bill As Committed",15,18,0,0,33
1927231,1599339,2025-08-13,House,"House Rules: Re-report Bill As Committed",15,18,0,0,33
1927470,1474719,2025-01-27,House,"House Transportation: Report Bill As Committed",26,0,0,0,26
1927470,1518368,2025-03-17,House,"House Floor: HB 240 PN 192, FINAL PASSAGE",202,0,0,0,202
1927470,1518369,2025-03-17,House,"House Appropriations: Re-report Bill As Committed",37,0,0,0,37
1927470,1584604,2025-06-04,Senate,"Senate Transportation: Reported as Committed",14,0,0,0,14
1927470,1587477,2025-06-10,Senate,"Senate Appropriations: Re-Reported as Committed",22,0,0,0,22
1927470,1593969,2025-06-23,Senate,"Senate Floor: HB 240 PN 192, Final Passage",50,0,0,0,50
1927519,1586636,2025-06-09,House,"House Transportation: Report Bill As Committed",26,0,0,0,26
1927613,1519464,2025-03-18,House,"House Transportation: Report Bill As Committed",26,0,0,0,26
1927613,1556711,2025-04-24,House,"House Floor: HB 238 PN 190, FINAL PASSAGE",203,0,0,0,203
1927613,1556712,2025-04-24,House,"House Appropriations: Re-report Bill As Committed",37,0,0,0,37
1927613,1584612,2025-06-04,Senate,"Senate Transportation: Reported as Committed",14,0,0,0,14
1927613,1587452,2025-06-10,Senate,"Senate Appropriations: Re-Reported as Committed",22,0,0,0,22
1927903,1526476,2025-03-25,House,"House Veterans Affairs And Emergency Preparedness: Report Bill As Committed",26,0,0,0,26
1928238,1556670,2025-04-24,House,"House Finance: Report Bill As Amended",25,1,0,0,26
1928238,1556671,2025-04-24,House,"House Finance: Adopt Amendment A00407",26,0,0,0,26
1928238,1571251,2025-05-14,House,"House Floor: HB 242 PN 1485, 2025 A735",203,0,0,0,203
1928238,1583157,2025-06-02,House,"House Floor: HB 242 PN 1720, FINAL PASSAGE",200,3,0,0,203
1928238,1583158,2025-06-02,House,"House Appropriations: Re-report Bill As Committed",37,0,0,0,37
1928575,1475306,2025-01-28,House,"House Insurance: Report Bill As Committed",26,0,0,0,26
1928575,1480811,2025-02-05,House,"House Floor: HB 261 PN 169, FINAL PASSAGE",202,0,0,0,202
1928575,1480812,2025-02-05,House,"House Appropriations: Re-report Bill As Committed",37,0,0,0,37
1928575,1594120,2025-06-24,Senate,"Senate Banking And Insurance: Reported as Committed",14,0,0,0,14
1928575,1594868,2025-06-25,Senate,"Senate Appropriations: Re-Reported as Committed",22,0,0,0,22
1928575,1595423,2025-06-26,Senate,"Senate Floor: HB 261 PN 169, Final Passage",50,0,0,0,50
1930984,1519536,2025-03-18,House,"House Labor And Industry: Report Bill As Committed",14,12,0,0,26
1930984,1565472,2025-05-06,House,"House Appropriations: Re-report Bill As Committed",22,15,0,0,37
1930984,1566384,2025-05-06,House,"House Floor: HB 265 PN 210, FINAL PASSAGE",105,98,0,0,203
1931141,1505778,2025-03-05,House,"House Human Services: Report Bill As Committed",24,2,0,0,26
1931141,1541644,2025-04-09,House,"House Floor: HB 269 PN 214, 2025 A258",203,0,0,0,203
1931141,1553668,2025-04-22,House,"House Floor: HB 269 PN 1331, FINAL PASSAGE",195,8,0,0,203
1931141,1553669,2025-04-22,House,"House Appropriations: Re-report Bill As Committed",37,0,0,0,37
1931400,1569355,2025-05-12,House,"House Intergovernmental Affairs And Operations: Report Bill As Committed",14,12,0,0,26
1931400,1588746,2025-06-11,House,"House Floor: HB 276 PN 220, FINAL PASSAGE",108,95,0,0,203
1931400,1588747,2025-06-11,House,"House Appropriations: Re-report Bill As Committed",22,15,0,0,37
1931463,1476213,2025-01-29,House,"House Labor And Industry: Adopt Amendment",26,0,0,0,26
1931463,1476214,2025-01-29,House,"House Labor And Industry: Report Bill As Amended",26,0,0,0,26
1931463,1519687,2025-03-18,House,"House Floor: HB 274 PN 374, 2025 A50",189,13,0,0,202
1931463,1521043,2025-03-19,House,"House Floor: HB 274 PN 1026, FINAL PASSAGE",198,4,0,0,202
1931463,1521044,2025-03-19,House,"House Appropriations: Re-report Bill As Committed",37,0,0,0,37
1931463,1598539,2025-07-16,Senate,"Senate Labor And Industry: Reported as Committed",11,0,0,0,11
1931527,1474658,2025-01-27,House,"House Judiciary: Report Bill As Committed",26,0,0,0,26
1931648,1518482,2025-03-17,House,"House Housing And Community Development: Adopt Amendment A00029",26,0,0,0,26
1931648,1518483,2025-03-17,House,"House Housing And Community Development: Report Bill As Amended",14,12,0,0,26
1931648,1555171,2025-04-23,House,"House Floor: HB 273 PN 981, FINAL PASSAGE",110,93,0,0,203
1931648,1555172,2025-04-23,House,"House Appropriations: Re-report Bill As Committed",22,15,0,0,37
1931707,1476868,2025-01-29,House,"House Health: Report Bill As Committed",26,0,0,0,26
1931707,1480366,2025-02-04,House,"House Floor: HR 16 PN 248",197,5,0,0,202
1933938,1565065,2025-05-05,House,"House Judiciary: Report Bill As Amended",25,1,0,0,26
1933938,1565066,2025-05-05,House,"House Judiciary: Adopt Amendment A00347",26,0,0,0,26
1933938,1583144,2025-06-02,House,"House Floor: HB 282 PN 1594, 2025 A807",203,0,0,0,203
1933938,1583804,2025-06-03,House,"House Appropriations: Re-report Bill As Committed",37,0,0,0,37
1933938,1584057,2025-06-03,House,"House Floor: HB 282 PN 1800, FINAL PASSAGE",153,50,0,0,203
1934235,1570441,2025-05-13,House,"House State Government: Report Bill As Committed",14,12,0,0,26
1934912,1474691,2025-01-27,House,"House Transportation: Report Bill As Committed",26,0,0,0,26
1934912,1478793,2025-02-03,House,"House Floor: HB 291 PN 226, FINAL PASSAGE",183,19,0,0,202
1934912,1478794,2025-02-03,House,"House Appropriations: Re-report Bill As Committed",37,0,0,0,37
1935294,1479857,2025-02-04,House,"House State Government: Adopt Resolution",25,1,0,0,26
1935294,1480816,2025-02-05,House,"House Floor: HR 22 PN 254",202,0,0,0,202
1935356,1475252,2025-01-28,Senate,"Senate Transportation: Reported as Amended",10,4,0,0,14
1935356,1475253,2025-01-28,Senate,"Senate Transportation: Adopt Amendment A00010",11,3,0,0,14
1935356,1476149,2025-01-29,Senate,"Senate Appropriations: Re-Reported as Committed",14,8,0,0,22
1935356,1478771,2025-02-03,Senate,"Senate Floor: SB 35 PN 130, Final Passage",27,21,0,1,49
1935368,1527377,2025-03-26,Senate,"Senate Veterans Affairs And Emergency Preparedness: Reported as Committed",11,0,0,0,11
1935368,1569467,2025-05-12,Senate,"Senate Appropriations: Re-Reported as Committed",22,0,0,0,22
1935368,1570222,2025-05-13,Senate,"Senate Floor: SB 90 PN 45, Final Passage",49,0,0,1,50
1935368,1594136,2025-06-24,House,"House Veterans Affairs And Emergency Preparedness: Report Bill As Committed",26,0,0,0,26
1935368,1596484,2025-06-30,House,"House Floor: SB 90 PN 45, FINAL PASSAGE",203,0,0,0,203
1935368,1596485,2025-06-30,House,"House Appropriations: Re-report Bill As Committed",37,0,0,0,37
1935423,1583760,2025-06-03,Senate,"Senate Law And Justice: Reported as Committed",11,0,0,0,11
1935481,1527371,2025-03-26,Senate,"Senate Veterans Affairs And Emergency Preparedness: Reported as Committed",11,0,0,0,11
1935619,1533788,2025-04-01,Senate,"Senate Labor And Industry: Reported as Committed",11,0,0,0,11
1935643,1532316,2025-04-01,Senate,"Senate Veterans Affairs And Emergency Preparedness: Reported as Amended",11,0,0,0,11
1935643,1532317,2025-04-01,Senate,"Senate Veterans Affairs And Emergency Preparedness: Adopt Amendment A00259",11,0,0,0,11
1935643,1586716,2025-06-09,Senate,"Senate Floor: SB 64 PN 509, 2025 A995, BARTOLOTTA Amendment No. A-0995",38,12,0,0,50
1935643,1594335,2025-06-24,Senate,"Senate Appropriations: Adopt Amendment A01114",22,0,0,0,22
1935643,1594336,2025-06-24,Senate,"Senate Appropriations: Re-Reported as Amended",17,5,0,0,22
1935643,1601444,2025-09-09,Senate,"Senate Floor: SB 64 PN 985, Final Passage",37,12,0,1,50
1935666,1588590,2025-06-11,Senate,"Senate Urban Affairs And Housing: Reported as Amended",11,0,0,0,11
1935666,1588591,2025-06-11,Senate,"Senate Urban Affairs And Housing: Adopt Amendment A00776",11,0,0,0,11
1935763,1475309,2025-01-28,Senate,"Senate Transportation: Reported as Committed",10,4,0,0,14
1935763,1476128,2025-01-29,Senate,"Senate Appropriations: Re-Reported as Committed",14,8,0,0,22
1935763,1478775,2025-02-03,Senate,"Senate Floor: SB 149 PN 101, Final Passage",28,20,0,1,49
1935774,1601438,2025-09-09,Senate,"Senate Judiciary: Reported as Committed",13,0,1,0,14
1935854,1531919,2025-04-01,Senate,"Senate Health And Human Services: Reported as Committed",13,0,0,0,13
1935854,1564995,2025-05-05,Senate,"Senate Appropriations: Re-Reported as Committed",22,0,0,0,22
1935854,1566041,2025-05-06,Senate,"Senate Floor: SB 115 PN 66, 2025 A492, PICOZZI Amendment No. A-0492",48,2,0,0,50
1935854,1567515,2025-05-07,Senate,"Senate Floor: SB 115 PN 757, Final Passage",47,3,0,0,50
1935854,1591380,2025-06-17,House,"House Professional Licensure: Re-refer Bill To Another Committee",26,0,0,0,26
1935865,1532065,2025-04-01,Senate,"Senate Labor And Industry: Reported as Committed",11,0,0,0,11
1935865,1594331,2025-06-24,Senate,"Senate Appropriations: Adopt Amendment A00965",17,5,0,0,22
1935865,1594332,2025-06-24,Senate,"Senate Appropriations: Re-Reported as Amended",22,0,0,0,22
1935865,1594936,2025-06-25,Senate,"Senate Floor: SB 101 PN 986, Final Passage",49,1,0,0,50
1935865,1594937,2025-06-25,Senate,"Senate Floor: SB 101 PN 986, Final Passage - Reconsideration",47,3,0,0,50
1935875,1583902,2025-06-03,Senate,"Senate State Government: Reported as Committed",11,0,0,0,11
1935902,1475343,2025-01-28,Senate,"Senate Veterans Affairs And Emergency Preparedness: Reported as Amended",11,0,0,0,11
1935902,1475344,2025-01-28,Senate,"Senate Veterans Affairs And Emergency Preparedness: Adopt Amendment A00017",11,0,0,0,11
1935902,1524922,2025-03-24,Senate,"Senate Appropriations: Re-Reported as Committed",22,0,0,0,22
1935902,1526305,2025-03-25,Senate,"Senate Floor: SB 146 PN 131, Final Passage",49,0,0,0,49
1935912,1569507,2025-05-12,Senate,"Senate Veterans Affairs And Emergency Preparedness: Reported as Committed",11,0,0,0,11
1935912,1583067,2025-06-02,Senate,"Senate Appropriations: Reported as Committed",22,0,0,0,22
1935912,1586681,2025-06-09,Senate,"Senate Floor: SB 95 PN 50, 2025 A975, HUGHES Amendment No. A-0975",50,0,0,0,50
1935912,1587788,2025-06-10,Senate,"Senate Floor: SB 95 PN 918, Final Passage",50,0,0,0,50
1935912,1594141,2025-06-24,House,"House Veterans Affairs And Emergency Preparedness: Report Bill As Committed",26,0,0,0,26
1935912,1594982,2025-06-25,House,"House Floor: SB 95 PN 918, 2025 A1308",158,45,0,0,203
1935912,1594983,2025-06-25,House,"House Floor: SB 95 PN 918, 2025 A1309",111,92,0,0,203
1935912,1596455,2025-06-30,House,"House Appropriations: Adopt Amendment A01406",37,0,0,0,37
1935912,1596456,2025-06-30,House,"House Appropriations: Re-report Bill As Amended",37,0,0,0,37
1935912,1596825,2025-06-30,House,"House Floor: SB 95 PN 1019, FINAL PASSAGE",126,77,0,0,203
1935912,1596826,2025-06-30,Senate,"Senate Floor: SB 95 PN 1019, Concur in House Amendments",48,2,0,0,50
1935912,1596827,2025-06-30,Senate,"Senate Rules And Executive Nominations: Re-Reported as Committed",17,0,0,0,17
1935924,1525922,2025-03-25,Senate,"Senate Judiciary: Reported as Committed",11,3,0,0,14
1935924,1532471,2025-04-01,Senate,"Senate Floor: SB 96 PN 51, Final Passage",37,12,0,0,49
1935924,1532472,2025-04-01,Senate,"Senate Appropriations: Re-Reported as Committed",15,7,0,0,22
1935957,1565737,2025-05-06,Senate,"Senate Education: Reported as Committed",6,5,0,0,11
1935969,1527227,2025-03-26,Senate,"Senate Veterans Affairs And Emergency Preparedness: Reported as Committed",11,0,0,0,11
1935992,1475384,2025-01-28,Senate,"Senate Veterans Affairs And Emergency Preparedness: Reported as Committed",11,0,0,0,11
1936015,1526327,2025-03-25,Senate,"Senate Judiciary: Reported as Amended",10,4,0,0,14
1936015,1526328,2025-03-25,Senate,"Senate Judiciary: Adopt Amendment A00177",10,4,0,0,14
1936015,1533130,2025-04-01,Senate,"Senate Floor: SB 92 PN 472, Final Passage",33,16,0,0,49
1936025,1527256,2025-03-26,Senate,"Senate Transportation: Reported as Amended",14,0,0,0,14
1936025,1527257,2025-03-26,Senate,"Senate Transportation: Adopt Amendment A00192",14,0,0,0,14
1936025,1601431,2025-09-09,Senate,"Senate Appropriations: Re-Reported as Committed",21,0,1,0,22
1936025,1601685,2025-09-10,Senate,"Senate Floor: SB 65 PN 486, Final Passage",50,0,0,0,50
1936073,1475599,2025-01-28,Senate,"Senate Transportation: Reported as Committed",14,0,0,0,14
1936073,1476400,2025-01-29,Senate,"Senate Floor: SB 78 PN 34, motion to consider bill on second consideration",49,0,0,0,49
1936073,1525037,2025-03-24,Senate,"Senate Floor: SB 78 PN 34, Final Passage",49,0,0,0,49
1936073,1594114,2025-06-24,House,"House Transportation: Report Bill As Committed",26,0,0,0,26
1936073,1594824,2025-06-25,House,"House Floor: SB 78 PN 34, 2025 A1311",194,9,0,0,203
1936073,1594825,2025-06-25,House,"House Floor: SB 78 PN 34, 2025 A1306",197,6,0,0,203
1936073,1594995,2025-06-25,House,"House Appropriations: Re-report Bill As Committed",37,0,0,0,37
1936073,1595322,2025-06-26,House,"House Floor: SB 78 PN 1011, FINAL PASSAGE",202,0,0,1,203
1936073,1595402,2025-06-26,Senate,"Senate Floor: SB 78 PN 1011, Concur in House Amendments",50,0,0,0,50
1936073,1595403,2025-06-26,Senate,"Senate Rules And Executive Nominations: Re-Reported as Committed",17,0,0,0,17
1936099,1474764,2025-01-27,Senate,"Senate Labor And Industry: Reported as Committed",7,4,0,0,11
1936099,1476134,2025-01-29,Senate,"Senate Floor: SB 153 PN 103, Final Passage",29,20,0,0,49
1936099,1476135,2025-01-29,Senate,"Senate Appropriations: Re-Reported as Committed",14,8,0,0,22
1936119,1475898,2025-01-28,Senate,"Senate Veterans Affairs And Emergency Preparedness: Reported as Committed",11,0,0,0,11
1936119,1524794,2025-03-24,Senate,"Senate Appropriations: Re-Reported as Committed",22,0,0,0,22
1936119,1526125,2025-03-25,Senate,"Senate Floor: SB 130 PN 79, Final Passage",49,0,0,0,49
1936119,1584587,2025-06-04,House,"House Veterans Affairs And Emergency Preparedness: Report Bill As Committed",26,0,0,0,26
1936132,1475524,2025-01-28,Senate,"Senate Veterans Affairs And Emergency Preparedness: Reported as Committed",11,0,0,0,11
1936132,1476132,2025-01-29,Senate,"Senate Appropriations: Re-Reported as Committed",22,0,0,0,22
1936132,1480486,2025-02-05,Senate,"Senate Floor: SB 129 PN 78, Final Passage",49,0,0,0,49
1936132,1501006,2025-02-26,House,"House Veterans Affairs And Emergency Preparedness: Report Bill As Committed",26,0,0,0,26
1936132,1594985,2025-06-25,House,"House Floor: SB 129 PN 78, 2025 A267",203,0,0,0,203
1936132,1594986,2025-06-25,House,"House Appropriations: Re-report Bill As Committed",37,0,0,0,37
1936132,1595321,2025-06-26,House,"House Floor: SB 129 PN 1013, FINAL PASSAGE",202,0,0,1,203
1936132,1595396,2025-06-26,Senate,"Senate Floor: SB 129 PN 1013, Concur in House Amendments",50,0,0,0,50
1936132,1595397,2025-06-26,Senate,"Senate Rules And Executive Nominations: Re-Reported as Committed",17,0,0,0,17
1936180,1565607,2025-05-06,Senate,"Senate Education: Reported as Amended",7,4,0,0,11
1936180,1565608,2025-05-06,Senate,"Senate Education: Adopt Amendment A00552",11,0,0,0,11
1936180,1601217,2025-09-08,Senate,"Senate Appropriations: Re-Reported as Committed",17,2,3,0,22
1936180,1601432,2025-09-09,Senate,"Senate Floor: SB 114 PN 751, Final Passage",34,15,0,1,50
1936180,1601433,2025-09-09,Senate,"Senate Floor: SB 114 PN 751, Final Passage Reconsidered",31,18,0,1,50
1936204,1524613,2025-03-24,Senate,"Senate Environmental Resources And Energy: Reported as Committed",11,0,0,0,11
1936204,1588044,2025-06-10,Senate,"Senate Floor: SB 109 PN 62, Final Passage",50,0,0,0,50
1936204,1588045,2025-06-10,Senate,"Senate Appropriations: Re-Reported as Committed",22,0,0,0,22
1936204,1593889,2025-06-23,House,"House Environmental And Natural Resource Protection: Report Bill As Committed",26,0,0,0,26
1936204,1594960,2025-06-25,House,"House Appropriations: Re-report Bill As Committed",37,0,0,0,37
1936204,1595362,2025-06-26,House,"House Floor: SB 109 PN 62, FINAL PASSAGE",202,0,0,1,203
1936308,1569416,2025-05-12,Senate,"Senate Veterans Affairs And Emergency Preparedness: Reported as Committed",11,0,0,0,11
1936308,1583068,2025-06-02,Senate,"Senate Appropriations: Reported as Committed",22,0,0,0,22
1936308,1583916,2025-06-03,Senate,"Senate Floor: SB 89 PN 44, 2025 A712, MUTH Amendment No. A-0712 Tabled",27,22,0,1,50
1936308,1583917,2025-06-03,Senate,"Senate Floor: SB 89 PN 44, Final Passage",49,0,0,1,50
1936308,1590961,2025-06-16,House,"House Veterans Affairs And Emergency Preparedness: Adopt Amendment A01094",26,0,0,0,26
1936308,1590962,2025-06-16,House,"House Veterans Affairs And Emergency Preparedness: Report Bill As Amended",26,0,0,0,26
1936308,1595026,2025-06-25,House,"House Appropriations: Re-report Bill As Committed",37,0,0,0,37
1936308,1595323,2025-06-26,House,"House Floor: SB 89 PN 945, FINAL PASSAGE",202,0,0,1,203
1936308,1595404,2025-06-26,Senate,"Senate Floor: SB 89 PN 945, Concur in House Amendments",50,0,0,0,50
1936308,1595405,2025-06-26,Senate,"Senate Rules And Executive Nominations: Re-Reported as Committed",17,0,0,0,17
1936440,1587480,2025-06-10,Senate,"Senate Community, Economic And Recreational Development: Reported as Committed",14,0,0,0,14
1936916,1474838,2025-01-27,Senate,"Senate Consumer Protection And Professional Licensure: Reported as Committed",14,0,0,0,14
1936916,1476140,2025-01-29,Senate,"Senate Appropriations: Re-Reported as Committed",19,3,0,0,22
1936916,1478856,2025-02-03,Senate,"Senate Floor: SB 154 PN 104, Final Passage",41,7,0,1,49
1936939,1474757,2025-01-27,Senate,"Senate Health And Human Services: Reported as Committed",8,5,0,0,13
1936939,1476142,2025-01-29,Senate,"Senate Floor: SB 156 PN 106, Final Passage",30,19,0,0,49
1936939,1476143,2025-01-29,Senate,"Senate Appropriations: Re-Reported as Committed",14,8,0,0,22
1936964,1475541,2025-01-28,Senate,"Senate Veterans Affairs And Emergency Preparedness: Reported as Committed",11,0,0,0,11
1936964,1476481,2025-01-29,Senate,"Senate Appropriations: Re-Reported as Committed",22,0,0,0,22
1936964,1480504,2025-02-05,Senate,"Senate Floor: SB 173 PN 181, Final Passage",49,0,0,0,49
1936964,1520751,2025-03-19,House,"House Veterans Affairs And Emergency Preparedness: Adopt Amendment A00090",26,0,0,0,26
1936964,1520752,2025-03-19,House,"House Veterans Affairs And Emergency Preparedness: Report Bill As Amended",26,0,0,0,26
1936993,1474841,2025-01-27,House,"House Education: Report Bill As Committed",20,6,0,0,26
1936993,1478686,2025-02-03,House,"House Floor: HB 201 PN 255, FINAL PASSAGE",155,47,0,0,202
1936993,1478687,2025-02-03,House,"House Appropriations: Re-report Bill As Committed",37,0,0,0,37
1937013,1474743,2025-01-27,Senate,"Senate Health And Human Services: Reported as Committed",8,5,0,0,13
1937013,1476138,2025-01-29,Senate,"Senate Floor: SB 155 PN 105, Final Passage",30,19,0,0,49
1937013,1476139,2025-01-29,Senate,"Senate Appropriations: Re-Reported as Committed",14,8,0,0,22
1937040,1475780,2025-01-28,House,"House Veterans Affairs And Emergency Preparedness: Report Bill As Committed",26,0,0,0,26
1937040,1519504,2025-03-18,House,"House Floor: HB 304 PN 257, FINAL PASSAGE",201,1,0,0,202
1937040,1519505,2025-03-18,House,"House Appropriations: Re-report Bill As Committed",37,0,0,0,37
1937040,1594160,2025-06-24,Senate,"Senate Veterans Affairs And Emergency Preparedness: Reported as Committed",11,0,0,0,11
1937040,1595316,2025-06-26,Senate,"Senate Appropriations: Re-Reported as Committed",22,0,0,0,22
1937040,1595391,2025-06-26,Senate,"Senate Floor: HB 304 PN 257, Final Passage",50,0,0,0,50
1937089,1474754,2025-01-27,Senate,"Senate Health And Human Services: Reported as Committed",8,5,0,0,13
1937089,1476146,2025-01-29,Senate,"Senate Floor: SB 157 PN 107, Final Passage",29,20,0,0,49
1937089,1476147,2025-01-29,Senate,"Senate Appropriations: Re-Reported as Committed",14,8,0,0,22
1937347,1518651,2025-03-17,House,"House State Government: Re-refer Bill To Another Committee",26,0,0,0,26
1937347,1520782,2025-03-19,House,"House Tourism, Recreation And Economic Development: Report Bill As Committed",26,0,0,0,26
1937347,1553491,2025-04-22,House,"House Floor: HR 25 PN 280",142,61,0,0,203
1937347,1565909,2025-05-06,Senate,"Senate State Government: Reported as Committed",11,0,0,0,11
1937392,1538006,2025-04-07,House,"House Consumer Protection, Technology And Utilities: Report Bill As Committed",26,0,0,0,26
1937486,1479571,2025-02-04,House,"House State Government: Adopt Resolution",14,12,0,0,26
1937673,1567172,2025-05-07,Senate,"Senate Environmental Resources And Energy: Reported as Committed",7,4,0,0,11
1937766,1476107,2025-01-29,House,"House Professional Licensure: Adopt Amendment A00020",26,0,0,0,26
1937766,1476108,2025-01-29,House,"House Professional Licensure: Report Bill As Amended",26,0,0,0,26
1937766,1569428,2025-05-12,House,"House Floor: HB 309 PN 373, 2025 A140",203,0,0,0,203
1937766,1570139,2025-05-13,House,"House Floor: HB 309 PN 1686, FINAL PASSAGE",202,1,0,0,203
1937766,1570140,2025-05-13,House,"House Appropriations: Re-report Bill As Committed",37,0,0,0,37
1937766,1594248,2025-06-24,Senate,"Senate Consumer Protection And Professional Licensure: Adopt Amendment A01181",14,0,0,0,14
1937766,1594249,2025-06-24,Senate,"Senate Consumer Protection And Professional Licensure: Reported as Amended A01181",14,0,0,0,14
1937766,1594869,2025-06-25,Senate,"Senate Appropriations: Re-Reported as Committed",22,0,0,0,22
1937766,1595473,2025-06-26,Senate,"Senate Floor: HB 309 PN 2013, Final Passage",50,0,0,0,50
1937766,1596449,2025-06-30,House,"House Rules: Re-report Bill As Committed",33,0,0,0,33
1937766,1596548,2025-06-30,House,"House Floor: HB 309 PN 2013, CONCURRENCE",203,0,0,0,203
1937811,1525923,2025-03-25,Senate,"Senate Judiciary: Reported as Committed",14,0,0,0,14
1937908,1518471,2025-03-17,House,"House Housing And Community Development: Adopt Amendment A00089",26,0,0,0,26
1937908,1518472,2025-03-17,House,"House Housing And Community Development: Report Bill As Amended",19,7,0,0,26
1937908,1553637,2025-04-22,House,"House Floor: HB 316 PN 982, FINAL PASSAGE",114,89,0,0,203
1937908,1554307,2025-04-22,House,"House Appropriations: Re-report Bill As Committed",37,0,0,0,37
1937951,1480498,2025-02-05,House,"House Labor And Industry: Adopt Amendment A00033",12,14,0,0,26
1937951,1480499,2025-02-05,House,"House Labor And Industry: Report Bill As Committed",14,12,0,0,26
1937951,1540204,2025-04-08,House,"House Floor: HB 308 PN 261, 2025 A83",100,103,0,0,203
1937951,1540205,2025-04-08,House,"House Floor: HB 308 PN 261, 2025 A287",202,1,0,0,203
1937951,1541711,2025-04-09,House,"House Floor: HB 308 PN 1303, FINAL PASSAGE",111,92,0,0,203
1937951,1541712,2025-04-09,House,"House Appropriations: Re-report Bill As Committed",23,14,0,0,37
1938098,1475232,2025-01-28,House,"House Agriculture And Rural Affairs: Report Bill As Committed",20,6,0,0,26
1938098,1478694,2025-02-03,House,"House Floor: HB 324 PN 272, FINAL PASSAGE",161,41,0,0,202
1938098,1478695,2025-02-03,House,"House Appropriations: Re-report Bill As Committed",37,0,0,0,37
1938098,1478979,2025-02-03,Senate,"Senate Agriculture And Rural Affairs: Reported as Committed",9,2,0,0,11
1938098,1480485,2025-02-05,Senate,"Senate Appropriations: Re-Reported as Committed",21,1,0,0,22
1938098,1480772,2025-02-05,Senate,"Senate Floor: HB 324 PN 272, 2025 A46, Motion to Table COLEMAN Amendment No. A-0046",42,7,0,0,49
1938098,1480773,2025-02-05,Senate,"Senate Floor: HB 324 PN 272, 2025 A46, Final Passage",45,4,0,0,49
1939703,1583909,2025-06-03,Senate,"Senate State Government: Reported as Committed",11,0,0,0,11
1939737,1480488,2025-02-05,House,"House Finance: Report Bill As Amended",26,0,0,0,26
1939737,1480489,2025-02-05,House,"House Finance: Adopt Amendment",26,0,0,0,26
1939737,1538271,2025-04-07,House,"House Floor: HB 325 PN 507, 2025 A249",101,102,0,0,203
1939737,1539544,2025-04-08,House,"House Floor: HB 325 PN 507, FINAL PASSAGE",203,0,0,0,203
1939737,1539545,2025-04-08,House,"House Appropriations: Re-report Bill As Committed",37,0,0,0,37
1939876,1532455,2025-04-01,Senate,"Senate Labor And Industry: Reported as Amended",11,0,0,0,11
1939876,1532456,2025-04-01,Senate,"Senate Labor And Industry: Adopt Amendment A00130",11,0,0,0,11
1940123,1539621,2025-04-08,House,"House State Government: Report Bill As Committed",14,12,0,0,26
1940281,1478650,2025-02-03,House,"House Transportation: Adopt Amendment A00030",26,0,0,0,26
1940281,1478651,2025-02-03,House,"House Transportation: Report Bill As Amended",26,0,0,0,26
1940281,1519600,2025-03-18,House,"House Floor: HB 333 PN 432, FINAL PASSAGE",202,0,0,0,202
1940281,1519601,2025-03-18,House,"House Appropriations: Re-report Bill As Committed",37,0,0,0,37
1940332,1588253,2025-06-10,House,"House Human Services: Re-refer Bill To Another Committee",26,0,0,0,26
1940332,1594750,2025-06-25,House,"House Health: Report Bill As Committed",26,0,0,0,26
1940539,1475914,2025-01-28,House,"House Children And Youth: Report Bill As Committed",26,0,0,0,26
1940539,1476378,2025-01-29,House,"House Floor: HR 26 PN 273",197,5,0,0,202
1940590,1525973,2025-03-25,House,"House Judiciary: Adopt Amendment A00211",26,0,0,0,26
1940590,1525974,2025-03-25,House,"House Judiciary: Bring Up The Bill For Consideration",26,0,0,0,26
1940590,1565095,2025-05-05,House,"House Floor: HB 355 PN 1151, 2025 A415",203,0,0,0,203
1940590,1565471,2025-05-06,House,"House Appropriations: Re-report Bill As Committed",37,0,0,0,37
1940590,1566367,2025-05-06,House,"House Floor: HB 355 PN 1596, FINAL PASSAGE",203,0,0,0,203
1940590,1593986,2025-06-23,Senate,"Senate Judiciary: Reported as Committed",14,0,0,0,14
1940590,1594902,2025-06-25,Senate,"Senate Floor: HB 355 PN 1596, Final Passage",50,0,0,0,50
1941011,1518420,2025-03-17,House,"House Education: Report Bill As Committed",26,0,0,0,26
1941011,1538061,2025-04-07,House,"House Appropriations: Re-report Bill As Committed",37,0,0,0,37
1941011,1538416,2025-04-07,House,"House Floor: HB 354 PN 308, FINAL PASSAGE",190,13,0,0,203
1941011,1594181,2025-06-24,Senate,"Senate Education: Reported as Amended",11,0,0,0,11
1941011,1594182,2025-06-24,Senate,"Senate Education: Adopt Amendment A01269",11,0,0,0,11
1941011,1595388,2025-06-26,Senate,"Senate Floor: HB 354 PN 2000, Final Passage",50,0,0,0,50
1941011,1595389,2025-06-26,Senate,"Senate Appropriations: Re-Reported as Committed",22,0,0,0,22
1941011,1596080,2025-06-30,House,"House Rules: Re-report Bill As Committed",33,0,0,0,33
1941011,1596508,2025-06-30,House,"House Floor: HB 354 PN 2000, CONCURRENCE",199,4,0,0,203
1941270,1583040,2025-06-02,House,"House Judiciary: Report Bill As Committed",14,12,0,0,26
1941403,1527719,2025-03-26,Senate,"Senate Transportation: Reported as Amended",14,0,0,0,14
1941403,1527720,2025-03-26,Senate,"Senate Transportation: Adopt Amendment A00214",14,0,0,0,14
1941403,1533119,2025-04-01,Senate,"Senate Floor: SB 185 PN 487, Final Passage",48,1,0,0,49
1941403,1591479,2025-06-17,House,"House Transportation: Report Bill As Committed",26,0,0,0,26
1941471,1474883,2025-01-27,Senate,"Senate Environmental Resources And Energy: Reported as Committed",7,4,0,0,11
1941471,1476154,2025-01-29,Senate,"Senate Appropriations: Re-Reported as Committed",14,8,0,0,22
1941471,1479826,2025-02-04,Senate,"Senate Floor: SB 186 PN 125, Final Passage",31,18,0,0,49
1941674,1474822,2025-01-27,Senate,"Senate Consumer Protection And Professional Licensure: Reported as Amended A00019",14,0,0,0,14
1941674,1474823,2025-01-27,Senate,"Senate Consumer Protection And Professional Licensure: Adopt Amendment A00019",14,0,0,0,14
1941674,1475594,2025-01-28,Senate,"Senate Floor: SB 184 PN 128, motion to consider bill on second consideration",49,0,0,0,49
1941674,1476199,2025-01-29,Senate,"Senate Floor: SB 184 PN 128, Final Passage",49,0,0,0,49
1941674,1478656,2025-02-03,House,"House Professional Licensure: Report Bill As Committed",26,0,0,0,26
1941674,1480526,2025-02-05,House,"House Floor: SB 184 PN 128, FINAL PASSAGE",202,0,0,0,202
1941674,1480527,2025-02-05,House,"House Appropriations: Re-report Bill As Committed",37,0,0,0,37
1941748,1474834,2025-01-27,Senate,"Senate Environmental Resources And Energy: Reported as Committed",7,4,0,0,11
1941748,1476145,2025-01-29,Senate,"Senate Appropriations: Re-Reported as Committed",14,8,0,0,22
1941748,1478740,2025-02-03,Senate,"Senate Floor: SB 187 PN 126, Final Passage",27,21,0,1,49
1941909,1564983,2025-05-05,House,"House Housing And Community Development: Adopt Amendment A00354",14,12,0,0,26
1941909,1564984,2025-05-05,House,"House Housing And Community Development: Report Bill As Amended",14,12,0,0,26
1941909,1570984,2025-05-14,House,"House Appropriations: Re-report Bill As Committed",22,15,0,0,37
1941909,1571369,2025-05-14,House,"House Floor: HB 359 PN 1582, FINAL PASSAGE",102,101,0,0,203
1942084,1479832,2025-02-04,House,"House State Government: Adopt Resolution",19,7,0,0,26
1942084,1538476,2025-04-07,House,"House Floor: HR 28 PN 317",192,11,0,0,203
1942125,1593883,2025-06-23,House,"House Environmental And Natural Resource Protection: Report Bill As Committed",14,12,0,0,26
1942367,1567206,2025-05-07,House,"House Local Government: Report Bill As Committed",25,1,0,0,26
1942367,1588877,2025-06-11,House,"House Floor: HB 375 PN 331, FINAL PASSAGE",108,95,0,0,203
1942367,1588878,2025-06-11,House,"House Appropriations: Re-report Bill As Committed",37,0,0,0,37
1942590,1479513,2025-02-04,House,"House State Government: Adopt Resolution",14,12,0,0,26
1942637,1482181,2025-02-05,House,"House Health: Report Bill As Committed",26,0,0,0,26
1942637,1519948,2025-03-18,House,"House Floor: HR 31 PN 338",199,3,0,0,202
1942680,1480666,2025-02-05,House,"House Local Government: Report Bill As Committed",25,1,0,0,26
1942680,1526238,2025-03-25,House,"House Floor: HB 369 PN 325, FINAL PASSAGE",162,40,0,0,202
1942680,1526239,2025-03-25,House,"House Appropriations: Re-report Bill As Committed",37,0,0,0,37
1942991,1538136,2025-04-07,House,"House Consumer Protection, Technology And Utilities: Report Bill As Committed",26,0,0,0,26
1942991,1555501,2025-04-23,House,"House Floor: HR 34 PN 341",199,4,0,0,203
1943049,1598015,2025-07-09,House,"House Judiciary: Report Bill As Committed",14,12,0,0,26
1943103,1482215,2025-02-05,House,"House Health: Report Bill As Committed",26,0,0,0,26
1943103,1555090,2025-04-22,House,"House Floor: HR 33 PN 340",199,4,0,0,203
1943149,1478690,2025-02-03,House,"House Tourism, Recreation And Economic Development: Report Bill As Committed",26,0,0,0,26
1943149,1480767,2025-02-05,House,"House Floor: HR 35 PN 342",199,3,0,0,202
1943548,1480331,2025-02-04,House,"House Veterans Affairs And Emergency Preparedness: Report Bill As Committed",26,0,0,0,26
1943585,1596446,2025-06-30,House,"House Judiciary: Report Bill As Committed",26,0,0,0,26
1943664,1524614,2025-03-24,House,"House Aging And Older Adult Services: Adopt Amendment A00026",26,0,0,0,26
1943664,1524615,2025-03-24,House,"House Aging And Older Adult Services: Report Bill As Amended",26,0,0,0,26
1943707,1478875,2025-02-03,House,"House Judiciary: Report Bill As Committed",26,0,0,0,26
1943707,1519564,2025-03-18,House,"House Floor: HB 378 PN 334, 2025 A45",99,103,0,0,202
1943707,1564992,2025-05-05,House,"House Floor: HB 378 PN 334, 2025 A342",203,0,0,0,203
1943707,1564993,2025-05-05,House,"House Floor: HB 378 PN 334, 2025 A43, MOTION TO TABLE",102,101,0,0,203
1943707,1565977,2025-05-06,House,"House Floor: HB 378 PN 1599, FINAL PASSAGE",202,1,0,0,203
1943707,1565978,2025-05-06,House,"House Appropriations: Re-report Bill As Committed",37,0,0,0,37
1943707,1593877,2025-06-23,Senate,"Senate Judiciary: Reported as Committed",14,0,0,0,14
1943707,1595494,2025-06-26,Senate,"Senate Floor: HB 378 PN 1599, Final Passage",50,0,0,0,50
1943964,1541827,2025-04-09,House,"House Local Government: Report Bill As Committed",14,12,0,0,26
1943964,1571076,2025-05-14,House,"House Floor: HB 393 PN 358, FINAL PASSAGE",120,83,0,0,203
1943964,1571077,2025-05-14,House,"House Appropriations: Re-report Bill As Committed",22,15,0,0,37
1944275,1539511,2025-04-08,House,"House Game And Fisheries: Re-report Bill As Committed",26,0,0,0,26
1944406,1480817,2025-02-05,House,"House Health: Report Bill As Committed",26,0,0,0,26
1945457,1478896,2025-02-03,Senate,"Senate Transportation: Reported as Committed",13,1,0,0,14
1945457,1480589,2025-02-05,Senate,"Senate Floor: SB 210 PN 150, Final Passage",48,1,0,0,49
1945488,1515943,2025-03-12,House,"House Judiciary: Report Bill As Committed",26,0,0,0,26
1945488,1538186,2025-04-07,House,"House Floor: HB 407 PN 379, 2025 A181",203,0,0,0,203
1945488,1538187,2025-04-07,House,"House Floor: HB 407 PN 379, 2025 A241",203,0,0,0,203
1945488,1538188,2025-04-07,House,"House Floor: HB 407 PN 379, 2025 A236",203,0,0,0,203
1945488,1538189,2025-04-07,House,"House Floor: HB 407 PN 379, 2025 A230",203,0,0,0,203
1945488,1539384,2025-04-08,House,"House Appropriations: Re-report Bill As Committed",37,0,0,0,37
1945488,1540091,2025-04-08,House,"House Floor: HB 407 PN 1295, FINAL PASSAGE",201,2,0,0,203
1945506,1478931,2025-02-03,House,"House Tourism, Recreation And Economic Development: Report Bill As Committed",26,0,0,0,26
1945506,1518682,2025-03-17,House,"House Floor: HR 45 PN 389",199,3,0,0,202
1945522,1587382,2025-06-10,Senate,"Senate Local Government: Reported as Amended",10,1,0,0,11
1945522,1587383,2025-06-10,Senate,"Senate Local Government: Adopt Amendment A00949",10,1,0,0,11
1945633,1518602,2025-03-17,House,"House State Government: Adopt Amendment A00077",26,0,0,0,26
1945633,1518603,2025-03-17,House,"House State Government: Report Bill As Amended",14,12,0,0,26
1945668,1527241,2025-03-26,Senate,"Senate Finance: Reported as Committed",7,4,0,0,11
1945703,1584613,2025-06-04,Senate,"Senate Transportation: Reported as Amended",14,0,0,0,14
1945703,1584614,2025-06-04,Senate,"Senate Transportation: Adopt Amendment A00823",14,0,0,0,14
1945703,1593981,2025-06-23,Senate,"Senate Appropriations: Re-Reported as Committed",22,0,0,0,22
1945703,1594287,2025-06-24,Senate,"Senate Floor: SB 205 PN 892, Final Passage",50,0,0,0,50
1945774,1479407,2025-02-03,Senate,"Senate Banking And Insurance: Reported as Committed",14,0,0,0,14
1945774,1524772,2025-03-24,Senate,"Senate Appropriations: Re-Reported as Committed",22,0,0,0,22
1945774,1526087,2025-03-25,Senate,"Senate Floor: SB 202 PN 134, 2025 A222, GEBHARD Amendment No. A-0222",49,0,0,0,49
1945774,1527476,2025-03-26,Senate,"Senate Floor: SB 202 PN 474, Final Passage",49,0,0,0,49
1945774,1539304,2025-04-08,House,"House Commerce: Report Bill As Committed",16,10,0,0,26
1945774,1594816,2025-06-25,House,"House Appropriations: Re-report Bill As Committed",37,0,0,0,37
1945774,1594976,2025-06-25,House,"House Floor: SB 202 PN 474, FINAL PASSAGE",201,2,0,0,203
1945848,1478672,2025-02-03,House,"House Professional Licensure: Report Bill As Committed",26,0,0,0,26
1945848,1528522,2025-03-26,House,"House Floor: HR 44 PN 388",174,27,0,1,202
1945972,1518424,2025-03-17,House,"House Insurance: Report Bill As Committed",14,12,0,0,26
1945972,1525865,2025-03-25,House,"House Floor: HB 404 PN 376, FINAL PASSAGE",123,79,0,0,202
1945972,1525866,2025-03-25,House,"House Appropriations: Re-report Bill As Committed",23,14,0,0,37
1946008,1518479,2025-03-17,House,"House Energy: Report Bill As Committed",15,11,0,0,26
1946008,1521054,2025-03-19,House,"House Floor: HB 362 PN 375, 2025 A160",202,0,0,0,202
1946008,1521055,2025-03-19,House,"House Floor: HB 362 PN 375, 2025 A170",169,33,0,0,202
1946034,1519379,2025-03-18,House,"House Finance: Report Bill As Committed",26,0,0,0,26
1946034,1553383,2025-04-22,House,"House Appropriations: Re-report Bill As Committed",37,0,0,0,37
1946034,1553921,2025-04-22,House,"House Floor: HB 416 PN 392, FINAL PASSAGE",203,0,0,0,203
1946034,1587386,2025-06-10,Senate,"Senate Finance: Reported as Committed",11,0,0,0,11
1946077,1518384,2025-03-17,House,"House State Government: Adopt Amendment A00078",26,0,0,0,26
1946077,1518385,2025-03-17,House,"House State Government: Report Bill As Amended",14,12,0,0,26
1946077,1540266,2025-04-08,House,"House Floor: HB 411 PN 985, 2025 A172",101,102,0,0,203
1946077,1540267,2025-04-08,House,"House Floor: HB 411 PN 985, 2025 A188",101,102,0,0,203
1946077,1540268,2025-04-08,House,"House Floor: HB 411 PN 985, 2025 A212",101,102,0,0,203
1946077,1540269,2025-04-08,House,"House Floor: HB 411 PN 985, 2025 A221",101,102,0,0,203
1946077,1541768,2025-04-09,House,"House Floor: HB 411 PN 985, FINAL PASSAGE",131,72,0,0,203
1946077,1541769,2025-04-09,House,"House Appropriations: Re-report Bill As Committed",23,14,0,0,37
1946114,1480325,2025-02-04,House,"House Veterans Affairs And Emergency Preparedness: Report Bill As Committed",26,0,0,0,26
1946157,1584544,2025-06-04,House,"House Human Services: Adopt Amendment A00772",26,0,0,0,26
1946157,1584545,2025-06-04,House,"House Human Services: Report Bill As Amended",26,0,0,0,26
1946280,1478646,2025-02-03,House,"House Transportation: Report Bill As Amended",26,0,0,0,26
1946280,1478647,2025-02-03,House,"House Transportation: Adopt Amendment A00032",26,0,0,0,26
1946280,1520892,2025-03-19,House,"House Floor: HB 410 PN 433, 2025 A127",202,0,0,0,202
1946280,1524593,2025-03-24,House,"House Appropriations: Re-report Bill As Committed",37,0,0,0,37
1946280,1524967,2025-03-24,House,"House Floor: HB 410 PN 1053, FINAL PASSAGE",199,3,0,0,202
1946319,1480759,2025-02-05,House,"House Health: Report Bill As Amended A00031",26,0,0,0,26
1946319,1480760,2025-02-05,House,"House Health: Adopt Amendment A00031",26,0,0,0,26
1946319,1538286,2025-04-07,House,"House Floor: HB 409 PN 476, FINAL PASSAGE",202,1,0,0,203
1946319,1538287,2025-04-07,House,"House Appropriations: Re-report Bill As Committed",37,0,0,0,37
1946360,1516016,2025-03-12,House,"House Judiciary: Report Bill As Committed",26,0,0,0,26
1946360,1594963,2025-06-25,House,"House Appropriations: Re-report Bill As Committed",37,0,0,0,37
1946360,1595290,2025-06-26,House,"House Floor: HB 414 PN 390, FINAL PASSAGE",202,0,0,1,203
1946360,1601434,2025-09-09,Senate,"Senate Judiciary: Reported as Committed",13,0,1,0,14
1947717,1501004,2025-02-26,House,"House Veterans Affairs And Emergency Preparedness: Adopt Amendment A00038",26,0,0,0,26
1947717,1501005,2025-02-26,House,"House Veterans Affairs And Emergency Preparedness: Report Bill As Amended",26,0,0,0,26
1947751,1542379,2025-04-09,House,"House Health: Report Bill As Committed",26,0,0,0,26
1947751,1565434,2025-05-05,House,"House Floor: HR 46 PN 411",199,4,0,0,203
1948013,1480332,2025-02-04,House,"House Veterans Affairs And Emergency Preparedness: Report Bill As Committed",26,0,0,0,26
1948140,1480732,2025-02-05,House,"House Local Government: Report Bill As Committed",26,0,0,0,26
1948179,1515713,2025-03-12,House,"House Judiciary: Report Bill As Committed",26,0,0,0,26
1948179,1569421,2025-05-12,House,"House Floor: HR 48 PN 413",203,0,0,0,203
1948222,1583910,2025-06-03,House,"House Health: Report Bill As Amended",19,7,0,0,26
1948222,1583911,2025-06-03,House,"House Health: Adopt Amendment A00805",19,7,0,0,26
1948279,1522639,2025-03-19,House,"House Local Government: Report Bill As Committed",26,0,0,0,26
1948822,1519435,2025-03-18,House,"House Finance: Report Bill As Committed",25,1,0,0,26
1948905,1479698,2025-02-04,House,"House State Government: Report Bill As Committed",22,4,0,0,26
1948905,1480794,2025-02-05,House,"House Floor: HB 439 PN 397, 2025 A65, MOTION TO SUSPEND RULES",202,0,0,0,202
1948905,1480795,2025-02-05,House,"House Floor: HB 439 PN 397, 2025 A65",202,0,0,0,202
1948905,1518411,2025-03-17,House,"House Floor: HB 439 PN 508, 2025 A67",193,9,0,0,202
1948905,1518412,2025-03-17,House,"House Floor: HB 439 PN 996, FINAL PASSAGE",194,8,0,0,202
1948905,1518413,2025-03-17,House,"House Appropriations: Re-report Bill As Committed",37,0,0,0,37
1948985,1519597,2025-03-18,House,"House Environmental And Natural Resource Protection: Report Bill As Committed",14,12,0,0,26
1949066,1539386,2025-04-08,House,"House Insurance: Adopt Amendment A00204",26,0,0,0,26
1949066,1539387,2025-04-08,House,"House Insurance: Report Bill As Amended",26,0,0,0,26
1949066,1569373,2025-05-12,House,"House Appropriations: Re-report Bill As Committed",37,0,0,0,37
1949066,1569614,2025-05-12,House,"House Floor: HB 433 PN 1300, FINAL PASSAGE",198,5,0,0,203
1949066,1569615,2025-05-12,House,"House Appropriations: Re-report Bill As Committed",37,0,0,0,37
1950352,1541344,2025-04-09,House,"House Health: Report Bill As Committed",26,0,0,0,26
1950412,1519371,2025-03-18,House,"House Environmental And Natural Resource Protection: Report Bill As Committed",26,0,0,0,26
1950412,1538256,2025-04-07,House,"House Floor: HB 448 PN 426, FINAL PASSAGE",176,27,0,0,203
1950412,1538257,2025-04-07,House,"House Appropriations: Re-report Bill As Committed",37,0,0,0,37
1950655,1594746,2025-06-25,House,"House Health: Report Bill As Amended",26,0,0,0,26
1950655,1594747,2025-06-25,House,"House Health: Adopt Amendment A01274",26,0,0,0,26
1950846,1521461,2025-03-19,House,"House Tourism, Recreation And Economic Development: Report Bill As Committed",26,0,0,0,26
1950846,1539689,2025-04-08,House,"House Floor: HR 50 PN 431",197,6,0,0,203
1951634,1527261,2025-03-26,Senate,"Senate Education: Reported as Committed",7,4,0,0,11
1951634,1566021,2025-05-06,Senate,"Senate Floor: SB 9 PN 177, Final Passage",32,18,0,0,50
1951634,1597799,2025-07-08,House,"House Education: Re-refer Bill To Another Committee",14,12,0,0,26
1951676,1565947,2025-05-06,Senate,"Senate Education: Reported as Committed",9,2,0,0,11
1951676,1569470,2025-05-12,Senate,"Senate Floor: SB 227 PN 173, Final Passage",29,21,0,0,50
1951676,1569471,2025-05-12,Senate,"Senate Appropriations: Re-Reported as Committed",14,8,0,0,22
1951709,1501001,2025-02-27,House,"House Veterans Affairs And Emergency Preparedness: Report Bill As Committed",26,0,0,0,26
1951709,1501098,2025-02-26,House,"House Veterans Affairs And Emergency Preparedness: Report Bill As Committed",26,0,0,0,26
1951709,1539469,2025-04-08,House,"House Appropriations: Re-report Bill As Committed",37,0,0,0,37
1951709,1540248,2025-04-08,House,"House Floor: HB 453 PN 435, FINAL PASSAGE",203,0,0,0,203
1951723,1527348,2025-03-26,Senate,"Senate Finance: Reported as Committed",11,0,0,0,11
1951812,1565483,2025-05-06,House,"House Judiciary: Report Bill As Committed",15,11,0,0,26
1951812,1571199,2025-05-14,House,"House Floor: HB 464 PN 447, 2025 A737, MOTION TO APPEAL RULING OF THE CHAIR",102,101,0,0,203
1951812,1571200,2025-05-14,House,"House Floor: HB 464 PN 447, 2025 A731, MOTION TO APPEAL RULING OF THE CHAIR",102,101,0,0,203
1951812,1586687,2025-06-09,House,"House Floor: HB 464 PN 447, FINAL PASSAGE",138,64,0,1,203
1951812,1586688,2025-06-09,House,"House Appropriations: Re-report Bill As Committed",34,3,0,0,37
1951952,1519651,2025-03-18,House,"House Liquor Control: Adopt Amendment A00059",26,0,0,0,26
1951952,1519652,2025-03-18,House,"House Liquor Control: Report Bill As Amended",26,0,0,0,26
1951952,1538167,2025-04-07,House,"House Floor: HB 467 PN 1022, FINAL PASSAGE",200,3,0,0,203
1951952,1538168,2025-04-07,House,"House Appropriations: Re-report Bill As Committed",37,0,0,0,37
1951952,1565474,2025-05-06,Senate,"Senate Law And Justice: Reported as Committed",11,0,0,0,11
1951952,1587482,2025-06-10,Senate,"Senate Appropriations: Re-Reported as Committed",22,0,0,0,22
1951952,1598544,2025-07-16,Senate,"Senate Floor: HB 467 PN 1022, 2025 A1422, ARGALL Amendment No. A-1422",34,15,0,1,50
1951979,1565489,2025-05-06,House,"House Judiciary: Report Bill As Committed",15,11,0,0,26
1951979,1571234,2025-05-14,House,"House Floor: HB 462 PN 445, 2025 A723",91,112,0,0,203
1951979,1586484,2025-06-09,House,"House Appropriations: Re-report Bill As Committed",28,9,0,0,37
1951979,1586753,2025-06-09,House,"House Floor: HB 462 PN 445, FINAL PASSAGE",122,80,0,1,203
1952036,1519461,2025-03-18,House,"House Transportation: Report Bill As Amended",26,0,0,0,26
1952036,1519462,2025-03-18,House,"House Transportation: Adopt Amendment A00146",26,0,0,0,26
1952036,1541362,2025-04-09,House,"House Appropriations: Re-report Bill As Committed",37,0,0,0,37
1952036,1541990,2025-04-09,House,"House Floor: HB 472 PN 1023, FINAL PASSAGE",170,33,0,0,203
1952087,1566116,2025-05-06,House,"House Consumer Protection, Technology And Utilities: Report Bill As Committed",26,0,0,0,26
1952087,1584615,2025-06-04,House,"House Floor: HB 463 PN 446, FINAL PASSAGE",191,11,0,1,203
1952087,1584616,2025-06-04,House,"House Appropriations: Re-report Bill As Committed",37,0,0,0,37
1952200,1565780,2025-05-06,Senate,"Senate State Government: Reported as Committed",8,3,0,0,11
1952200,1569515,2025-05-12,Senate,"Senate Floor: SB 226 PN 179, Final Passage",29,21,0,0,50
1952200,1569516,2025-05-12,Senate,"Senate Appropriations: Re-Reported as Committed",14,8,0,0,22
1953400,1532279,2025-04-01,Senate,"Senate Game And Fisheries: Reported as Committed",11,0,0,0,11
1953400,1565015,2025-05-05,Senate,"Senate Appropriations: Re-Reported as Committed",22,0,0,0,22
1953400,1566997,2025-05-07,Senate,"Senate Floor: SB 232 PN 185, Final Passage",50,0,0,0,50
1953400,1594121,2025-06-24,House,"House Game And Fisheries: Bring Up The Bill For Consideration A01275",12,14,0,0,26
1953400,1594122,2025-06-24,House,"House Game And Fisheries: Report Bill As Committed",26,0,0,0,26
1953400,1595117,2025-06-25,House,"House Appropriations: Re-report Bill As Committed",37,0,0,0,37
1953400,1595350,2025-06-26,House,"House Floor: SB 232 PN 185, FINAL PASSAGE",202,0,0,1,203
1953915,1591398,2025-06-17,House,"House Professional Licensure: Report Bill As Amended",26,0,0,0,26
1953915,1591399,2025-06-17,House,"House Professional Licensure: Adopt Amendment A01067",26,0,0,0,26
1953915,1596439,2025-06-30,House,"House Rules: Re-report Bill As Committed",33,0,0,0,33
1953915,1597007,2025-07-01,House,"House Appropriations: Re-report Bill As Committed",37,0,0,0,37
1953915,1597089,2025-07-01,House,"House Floor: HB 482 PN 1942, FINAL PASSAGE",199,3,0,1,203
1954150,1568012,2025-05-07,House,"House Appropriations: Report Bill As Committed",22,15,0,0,37
1954327,1525063,2025-03-24,House,"House Gaming Oversight: Report Bill As Committed",26,0,0,0,26
1954327,1527904,2025-03-26,House,"House Floor: HR 52 PN 498",197,4,0,1,202
1954502,1519573,2025-03-18,House,"House Environmental And Natural Resource Protection: Report Bill As Committed",19,7,0,0,26
1954855,1515699,2025-03-12,House,"House Judiciary: Report Bill As Committed",26,0,0,0,26
1954855,1538303,2025-04-07,House,"House Floor: HB 491 PN 480, 2025 A289, MOTION TO SUSPEND RULES",203,0,0,0,203
1954855,1538304,2025-04-07,House,"House Floor: HB 491 PN 480, 2025 A289",203,0,0,0,203
1954855,1539612,2025-04-08,House,"House Floor: HB 491 PN 1294, FINAL PASSAGE",203,0,0,0,203
1954855,1539613,2025-04-08,House,"House Appropriations: Re-report Bill As Committed",37,0,0,0,37
1954855,1593882,2025-06-23,Senate,"Senate Judiciary: Reported as Committed",11,3,0,0,14
1954855,1594892,2025-06-25,Senate,"Senate Floor: HB 491 PN 1294, Final Passage",50,0,0,0,50
1954855,1594893,2025-06-25,Senate,"Senate Appropriations: Re-Reported as Committed",22,0,0,0,22
1955498,1598014,2025-07-09,House,"House Judiciary: Report Bill As Committed",14,12,0,0,26
1956248,1524632,2025-03-24,House,"House Gaming Oversight: Report Bill As Amended",26,0,0,0,26
1956248,1524633,2025-03-24,House,"House Gaming Oversight: Adopt Amendment A00198",26,0,0,0,26
1956248,1524634,2025-03-24,House,"House Gaming Oversight: Adopt Amendment A00195",9,17,0,0,26
1956248,1524635,2025-03-24,House,"House Gaming Oversight: Adopt Amendment A00145",26,0,0,0,26
1956248,1571352,2025-05-14,House,"House Floor: HR 60 PN 1115, 2025 A733",203,0,0,0,203
1956248,1571353,2025-05-14,House,"House Floor: HR 60 PN 1719",189,14,0,0,203
1957033,1571134,2025-05-14,House,"House Judiciary: Report Bill As Amended",14,12,0,0,26
1957033,1571135,2025-05-14,House,"House Judiciary: Adopt Amendment A00079",14,12,0,0,26
1957216,1521246,2025-03-19,House,"House Children And Youth: Report Bill As Committed",26,0,0,0,26
1957216,1542317,2025-04-09,House,"House Floor: HR 62 PN 533",197,6,0,0,203
1957395,1521417,2025-03-19,House,"House Tourism, Recreation And Economic Development: Report Bill As Committed",26,0,0,0,26
1957395,1541607,2025-04-09,House,"House Floor: HR 61 PN 532",199,4,0,0,203
1961683,1538043,2025-04-07,House,"House Transportation: Adopt Amendment A00125",26,0,0,0,26
1961683,1538044,2025-04-07,House,"House Transportation: Report Bill As Amended",26,0,0,0,26
1961720,1567306,2025-05-07,House,"House Education: Report Bill As Committed",26,0,0,0,26
1961720,1591497,2025-06-17,House,"House Floor: HB 538 PN 531, 2025 A1154",203,0,0,0,203
1961720,1593860,2025-06-23,House,"House Appropriations: Re-report Bill As Committed",37,0,0,0,37
1961720,1593948,2025-06-23,House,"House Floor: HB 538 PN 1946, FINAL PASSAGE",203,0,0,0,203
1961720,1598787,2025-07-16,Senate,"Senate Education: Reported as Amended",11,0,0,0,11
1961720,1598788,2025-07-16,Senate,"Senate Education: Adopt Amendment A01565",11,0,0,0,11
1961794,1518313,2025-03-17,House,"House Insurance: Report Bill As Committed",14,12,0,0,26
1961794,1518314,2025-03-17,House,"House Insurance: Bring Up The Bill For Consideration",14,12,0,0,26
1961794,1525888,2025-03-25,House,"House Floor: HB 535 PN 528, FINAL PASSAGE",121,81,0,0,202
1961794,1525889,2025-03-25,House,"House Appropriations: Report Bill As Committed",23,14,0,0,37
1962412,1564850,2025-05-05,House,"House Transportation: Report Bill As Committed",26,0,0,0,26
1962603,1518731,2025-03-17,House,"House Education: Adopt Amendment A00115",26,0,0,0,26
1962603,1518732,2025-03-17,House,"House Education: Report Bill As Amended",26,0,0,0,26
1962603,1557083,2025-04-24,House,"House Floor: HR 64 PN 990",199,4,0,0,203
1962803,1541371,2025-04-09,House,"House Health: Report Bill As Committed",25,1,0,0,26
1963476,1538051,2025-04-07,House,"House Consumer Protection, Technology And Utilities: Report Bill As Committed",26,0,0,0,26
1963476,1555349,2025-04-23,House,"House Floor: HB 543 PN 539, 2025 A327",101,102,0,0,203
1963476,1555350,2025-04-23,House,"House Floor: HB 543 PN 539, 2025 A346",101,102,0,0,203
1963476,1556715,2025-04-24,House,"House Floor: HB 543 PN 539, FINAL PASSAGE",195,8,0,0,203
1963476,1556716,2025-04-24,House,"House Appropriations: Re-report Bill As Committed",37,0,0,0,37
1963553,1518394,2025-03-17,House,"House State Government: Adopt Resolution",24,2,0,0,26
1963553,1526871,2025-03-25,House,"House Floor: HR 69 PN 559",197,5,0,0,202
1963671,1566166,2025-05-06,House,"House Professional Licensure: Report Bill As Amended",26,0,0,0,26
1963671,1566167,2025-05-06,House,"House Professional Licensure: Adopt Amendment A00239",26,0,0,0,26
1963671,1584589,2025-06-04,House,"House Floor: HB 554 PN 1619, FINAL PASSAGE",187,15,0,1,203
1963671,1584590,2025-06-04,House,"House Appropriations: Re-report Bill As Committed",37,0,0,0,37
1963736,1542491,2025-04-09,House,"House Health: Report Bill As Committed",26,0,0,0,26
1963857,1570461,2025-05-13,House,"House State Government: Adopt Amendment A00694",26,0,0,0,26
1963857,1570462,2025-05-13,House,"House State Government: Report Bill As Amended",26,0,0,0,26
1963857,1591244,2025-06-16,House,"House Floor: HB 553 PN 1698, 2025 A984",171,32,0,0,203
1963857,1591392,2025-06-17,House,"House Appropriations: Re-report Bill As Committed",37,0,0,0,37
1963857,1593892,2025-06-23,House,"House Floor: HB 553 PN 1938, FINAL PASSAGE",189,14,0,0,203
1963857,1594288,2025-06-24,Senate,"Senate State Government: Reported as Committed",11,0,0,0,11
1963857,1595627,2025-06-26,Senate,"Senate Floor: HB 553 PN 1938, Final Passage",49,1,0,0,50
1964284,1542511,2025-04-09,House,"House Health: Report Bill As Committed",26,0,0,0,26
1965045,1518357,2025-03-17,House,"House Education: Re-refer Bill To Another Committee",26,0,0,0,26
1965152,1539284,2025-04-08,House,"House Human Services: Adopt Amendment A00316",26,0,0,0,26
1965152,1539285,2025-04-08,House,"House Human Services: Report Bill As Amended",26,0,0,0,26
1965152,1570411,2025-05-13,House,"House Floor: HB 561 PN 1297, 2025 A649",203,0,0,0,203
1965152,1570412,2025-05-13,House,"House Floor: HB 561 PN 1297, 2025 A612",203,0,0,0,203
1965152,1570413,2025-05-13,House,"House Floor: HB 561 PN 1297, 2025 A628, MOTION TO APPEAL RULING OF THE CHAIR",102,101,0,0,203
1965152,1570414,2025-05-13,House,"House Floor: HB 561 PN 1297, 2025 A695, MOTION TO APPEAL RULING OF THE CHAIR",102,101,0,0,203
1965152,1571148,2025-05-14,House,"House Floor: HB 561 PN 1704, FINAL PASSAGE",192,11,0,0,203
1965152,1571149,2025-05-14,House,"House Appropriations: Re-report Bill As Committed",37,0,0,0,37
1965189,1584551,2025-06-04,House,"House Human Services: Adopt Amendment A00787",26,0,0,0,26
1965189,1584552,2025-06-04,House,"House Human Services: Report Bill As Amended",26,0,0,0,26
1965189,1594210,2025-06-24,House,"House Rules: Re-report Bill As Committed",33,0,0,0,33
1965189,1598321,2025-07-14,House,"House Floor: HB 564 PN 1831, FINAL PASSAGE",201,1,0,1,203
1965189,1598322,2025-07-14,House,"House Appropriations: Re-report Bill As Committed",37,0,0,0,37
1965230,1526060,2025-03-25,House,"House Labor And Industry: Report Bill As Committed",26,0,0,0,26
1965322,1570177,2025-05-13,House,"House Liquor Control: Adopt Amendment A00657",26,0,0,0,26
1965322,1570178,2025-05-13,House,"House Liquor Control: Report Bill As Amended",26,0,0,0,26
1965322,1591469,2025-06-17,House,"House Appropriations: Re-report Bill As Committed",37,0,0,0,37
1965322,1593901,2025-06-23,House,"House Floor: HB 559 PN 1697, FINAL PASSAGE",203,0,0,0,203
1965514,1519575,2025-03-18,House,"House Labor And Industry: Report Bill As Committed",14,12,0,0,26
1966072,1583898,2025-06-03,House,"House Health: Report Bill As Committed",22,4,0,0,26
1966072,1593862,2025-06-23,House,"House Rules: Re-report Bill As Committed",18,15,0,0,33
1966072,1593944,2025-06-23,House,"House Floor: HB 583 PN 593, 2025 A826",169,34,0,0,203
1966072,1593945,2025-06-23,House,"House Floor: HB 583 PN 593, 2025 A1169, MOTION TO TABLE",102,101,0,0,203
1966072,1593946,2025-06-23,House,"House Floor: HB 583 PN 593, 2025 A1201, MOTION TO TABLE",102,101,0,0,203
1966072,1594240,2025-06-24,House,"House Floor: HB 583 PN 1978, FINAL PASSAGE",154,49,0,0,203
1966072,1594241,2025-06-24,House,"House Appropriations: Re-report Bill As Committed",22,15,0,0,37
1966185,1518341,2025-03-17,House,"House Agriculture And Rural Affairs: To Table",26,0,0,0,26
1966185,1555085,2025-04-23,House,"House Agriculture And Rural Affairs: Adopt Amendment A00386",25,1,0,0,26
1966185,1555086,2025-04-23,House,"House Agriculture And Rural Affairs: Report Bill As Amended",25,1,0,0,26
1966304,1554989,2025-04-23,House,"House Environmental And Natural Resource Protection: Bring Up The Bill For Consideration",26,0,0,0,26
1966304,1554990,2025-04-23,House,"House Environmental And Natural Resource Protection: Report Bill As Committed",15,11,0,0,26
1967040,1586493,2025-06-09,House,"House Transportation: Report Bill As Committed",26,0,0,0,26
1967040,1594855,2025-06-25,House,"House Floor: HB 593 PN 601, 2025 A1280",203,0,0,0,203
1967040,1594856,2025-06-25,House,"House Rules: Re-report Bill As Committed",33,0,0,0,33
1967040,1595043,2025-06-25,House,"House Appropriations: Re-report Bill As Committed",37,0,0,0,37
1967040,1595330,2025-06-26,House,"House Floor: HB 593 PN 2028, FINAL PASSAGE",202,0,0,1,203
1967106,1518507,2025-03-17,House,"House Agriculture And Rural Affairs: Re-refer Bill To Another Committee",26,0,0,0,26
1967235,1525880,2025-03-25,House,"House Judiciary: Bring Up The Bill For Consideration",26,0,0,0,26
1968461,1522627,2025-03-19,House,"House Local Government: Report Bill As Committed",14,12,0,0,26
1968569,1518359,2025-03-17,House,"House Insurance: Report Bill As Committed",14,12,0,0,26
1968569,1518360,2025-03-17,House,"House Insurance: Bring Up The Bill For Consideration",14,12,0,0,26
1968569,1526102,2025-03-25,House,"House Floor: HB 618 PN 618, FINAL PASSAGE",125,77,0,0,202
1968569,1526103,2025-03-25,House,"House Appropriations: Re-report Bill As Committed",23,14,0,0,37
1968717,1526039,2025-03-25,House,"House Judiciary: Bring Up The Bill For Consideration",26,0,0,0,26
1968717,1555228,2025-04-23,House,"House Floor: HB 615 PN 628, FINAL PASSAGE",203,0,0,0,203
1968717,1555229,2025-04-23,House,"House Appropriations: Re-report Bill As Committed",37,0,0,0,37
1968717,1594163,2025-06-24,Senate,"Senate Agriculture And Rural Affairs: Reported as Committed",11,0,0,0,11
1968717,1594898,2025-06-25,Senate,"Senate Appropriations: Re-Reported as Committed",22,0,0,0,22
1968717,1595472,2025-06-26,Senate,"Senate Floor: HB 615 PN 628, Final Passage",50,0,0,0,50
1969204,1583702,2025-06-03,House,"House Communications And Technology: Report Bill As Committed",26,0,0,0,26
1969204,1591472,2025-06-17,House,"House Floor: HB 627 PN 638, 2025 A1104",203,0,0,0,203
1969204,1591473,2025-06-17,House,"House Rules: Re-report Bill As Committed",33,0,0,0,33
1969204,1593898,2025-06-23,House,"House Floor: HB 627 PN 1947, FINAL PASSAGE",197,6,0,0,203
1969204,1593899,2025-06-23,House,"House Appropriations: Re-report Bill As Committed",37,0,0,0,37
1970143,1584583,2025-06-04,Senate,"Senate Intergovernmental Operations: Reported as Amended",6,5,0,0,11
1970143,1584584,2025-06-04,Senate,"Senate Intergovernmental Operations: Adopt Amendment A00379",11,0,0,0,11
1970204,1565502,2025-05-06,Senate,"Senate Law And Justice: Reported as Committed",8,3,0,0,11
1970204,1601206,2025-09-08,Senate,"Senate Appropriations: Re-Reported as Committed",13,6,3,0,22
1970204,1601699,2025-09-10,Senate,"Senate Floor: SB 241 PN 194, Final Passage",28,22,0,0,50
1970266,1532299,2025-04-01,Senate,"Senate Finance: Reported as Committed",9,2,0,0,11
1970286,1566547,2025-05-06,Senate,"Senate Education: Reported as Amended",8,3,0,0,11
1970286,1566548,2025-05-06,Senate,"Senate Education: Adopt Amendment A00457",9,2,0,0,11
1970286,1569508,2025-05-12,Senate,"Senate Floor: SB 246 PN 752, 2025 A710, KIM Amendment No. A-0710",48,2,0,0,50
1970286,1569509,2025-05-12,Senate,"Senate Appropriations: Re-Reported as Committed",20,2,0,0,22
1970286,1570343,2025-05-13,Senate,"Senate Floor: SB 246 PN 764, Final Passage",45,4,0,1,50
1970286,1594758,2025-06-25,House,"House Education: Adopt Amendment A01322",26,0,0,0,26
1970286,1594759,2025-06-25,House,"House Education: Report Bill As Amended",26,0,0,0,26
1970286,1596538,2025-06-30,House,"House Floor: SB 246 PN 1009, 2025 A1363",203,0,0,0,203
1970286,1596539,2025-06-30,House,"House Floor: SB 246 PN 1009, 2025 A1363, MOTION TO RECONSIDER",102,101,0,0,203
1970286,1596540,2025-06-30,House,"House Floor: SB 246 PN 1009, 2025 A1383",101,102,0,0,203
1970286,1596541,2025-06-30,House,"House Floor: SB 246 PN 1009, 2025 A1363",164,39,0,0,203
1970286,1597009,2025-07-01,House,"House Appropriations: Re-report Bill As Committed",37,0,0,0,37
1971021,1553420,2025-04-22,House,"House Transportation: Report Bill As Committed",25,1,0,0,26
1971021,1570956,2025-05-14,House,"House Appropriations: Re-report Bill As Committed",37,0,0,0,37
1971021,1571334,2025-05-14,House,"House Floor: HB 646 PN 655, FINAL PASSAGE",193,10,0,0,203
1971021,1595348,2025-06-26,Senate,"Senate Transportation: Reported as Committed",13,1,0,0,14
1971113,1597783,2025-07-08,House,"House Transportation: Adopt Amendment A01394",26,0,0,0,26
1971113,1597784,2025-07-08,House,"House Transportation: Report Bill As Amended",26,0,0,0,26
1971186,1518531,2025-03-17,House,"House Housing And Community Development: Report Bill As Committed",17,9,0,0,26
1971186,1556401,2025-04-24,House,"House Appropriations: Re-report Bill As Committed",22,15,0,0,37
1971186,1556945,2025-04-24,House,"House Floor: HB 643 PN 619, FINAL PASSAGE",112,91,0,0,203
1971390,1519717,2025-03-18,House,"House Commerce: Report Bill As Committed",26,0,0,0,26
1971466,1505687,2025-03-05,House,"House Human Services: Report Bill As Committed",26,0,0,0,26
1971466,1541730,2025-04-09,House,"House Floor: HB 640 PN 650, FINAL PASSAGE",203,0,0,0,203
1971466,1541731,2025-04-09,House,"House Appropriations: Re-report Bill As Committed",37,0,0,0,37
1971466,1588435,2025-06-11,Senate,"Senate Health And Human Services: Reported as Committed",12,0,1,0,13
1971466,1593978,2025-06-23,Senate,"Senate Floor: HB 640 PN 650, Motion to consider bill on second consideration",50,0,0,0,50
1971466,1594266,2025-06-24,Senate,"Senate Floor: HB 640 PN 650, Re-referred to the Committee on Appropriations",50,0,0,0,50
1971466,1594896,2025-06-25,Senate,"Senate Appropriations: Re-Reported as Committed",22,0,0,0,22
1971466,1595464,2025-06-26,Senate,"Senate Floor: HB 640 PN 2037, Final Passage",50,0,0,0,50
1971466,1596460,2025-06-30,House,"House Floor: HB 640 PN 2052, CONCURRENCE",183,20,0,0,203
1971466,1596461,2025-06-30,House,"House Rules: Adopt Amendment A01428",33,0,0,0,33
1971466,1596462,2025-06-30,House,"House Rules: Re-report Bill As Amended",33,0,0,0,33
1971466,1596567,2025-06-30,Senate,"Senate Floor: HB 640 PN 2052, Concur in House Amendments to Senate Amendments",46,4,0,0,50
1971466,1596568,2025-06-30,Senate,"Senate Rules And Executive Nominations: Re-Reported as Committed",17,0,0,0,17
1973477,1566519,2025-05-06,Senate,"Senate Education: Reported as Amended",9,2,0,0,11
1973477,1566520,2025-05-06,Senate,"Senate Education: Adopt Amendment A00507",9,2,0,0,11
1973477,1566521,2025-05-06,Senate,"Senate Education: Adopt Amendment A00388",11,0,0,0,11
1973477,1569559,2025-05-12,Senate,"Senate Appropriations: Re-Reported as Committed",21,1,0,0,22
1973477,1570389,2025-05-13,Senate,"Senate Floor: SB 310 PN 765, Final Passage",47,2,0,1,50
1973523,1518443,2025-03-17,House,"House Energy: Adopt Amendment A00093",26,0,0,0,26
1973523,1518444,2025-03-17,House,"House Energy: Report Bill As Amended",14,1,11,0,26
1973665,1588874,2025-06-11,House,"House Local Government: Report Bill As Committed",26,0,0,0,26
1973751,1556563,2025-04-24,House,"House Communications And Technology: Report Bill As Committed",26,0,0,0,26
1975239,1565441,2025-05-06,House,"House Professional Licensure: Adopt Amendment A00240",26,0,0,0,26
1975239,1565442,2025-05-06,House,"House Professional Licensure: Report Bill As Amended",26,0,0,0,26
1975239,1584576,2025-06-04,House,"House Appropriations: Re-report Bill As Committed",37,0,0,0,37
1975239,1584818,2025-06-04,House,"House Floor: HB 668 PN 1620, FINAL PASSAGE",186,16,0,1,203
1975647,1519921,2025-03-17,House,"House Consumer Protection, Technology And Utilities: Report Bill As Committed",26,0,0,0,26
1975647,1521390,2025-03-19,House,"House Floor: HR 85 PN 698",199,3,0,0,202
1975803,1567244,2025-05-07,House,"House Health: Adopt Amendment A00503",25,1,0,0,26
1975803,1567245,2025-05-07,House,"House Health: Report Bill As Amended",25,1,0,0,26
1975803,1587687,2025-06-10,House,"House Floor: HB 681 PN 1648, 2025 A782",200,3,0,0,203
1975803,1587688,2025-06-10,House,"House Floor: HB 681 PN 1648, 2025 A783",203,0,0,0,203
1975803,1587689,2025-06-10,House,"House Floor: HB 681 PN 1648, 2025 A998",101,102,0,0,203
1975803,1588762,2025-06-11,House,"House Floor: HB 681 PN 1882, FINAL PASSAGE",158,45,0,0,203
1975803,1588763,2025-06-11,House,"House Appropriations: Re-report Bill As Committed",37,0,0,0,37
1977005,1519631,2025-03-18,House,"House Commerce: Adopt Amendment A00092",26,0,0,0,26
1977005,1519632,2025-03-18,House,"House Commerce: Report Bill As Amended",26,0,0,0,26
1977348,1595451,2025-06-26,House,"House Veterans Affairs And Emergency Preparedness: Report Bill As Committed",26,0,0,0,26
1977389,1519033,2025-03-17,House,"House State Government: Adopt Resolution",24,2,0,0,26
1977389,1520890,2025-03-19,House,"House Floor: HR 86 PN 716",178,24,0,0,202
1977559,1520827,2025-03-19,House,"House Veterans Affairs And Emergency Preparedness: Report Bill As Committed",26,0,0,0,26
1977604,1515740,2025-03-12,House,"House Judiciary: Report Bill As Amended",26,0,0,0,26
1977604,1515741,2025-03-12,House,"House Judiciary: Adopt Amendment A00099",26,0,0,0,26
1977794,1532201,2025-04-01,Senate,"Senate Judiciary: Reported as Committed",14,0,0,0,14
1977794,1565692,2025-05-05,Senate,"Senate Floor: SB 255 PN 207, Final Passage",50,0,0,0,50
1977794,1591501,2025-06-17,House,"House Judiciary: Report Bill As Committed",26,0,0,0,26
1977794,1594992,2025-06-25,House,"House Appropriations: Re-report Bill As Committed",37,0,0,0,37
1977794,1595313,2025-06-26,House,"House Floor: SB 255 PN 207, FINAL PASSAGE",202,0,0,1,203
1978048,1531969,2025-04-01,Senate,"Senate Health And Human Services: Reported as Committed",13,0,0,0,13
1979276,1539627,2025-04-08,House,"House State Government: Adopt Amendment A00308",26,0,0,0,26
1979276,1539628,2025-04-08,House,"House State Government: Report Bill As Amended",14,12,0,0,26
1979740,1518322,2025-03-17,House,"House Education: Report Bill As Committed",26,0,0,0,26
1981203,1541601,2025-04-09,House,"House Labor And Industry: Adopt Amendment A00298",12,14,0,0,26
1981203,1541602,2025-04-09,House,"House Labor And Industry: Adopt Amendment A00318",14,12,0,0,26
1981203,1541603,2025-04-09,House,"House Labor And Industry: Report Bill As Amended",14,12,0,0,26
1981203,1569440,2025-05-12,House,"House Floor: HB 721 PN 1330, 2025 A363",101,102,0,0,203
1981203,1570197,2025-05-13,House,"House Floor: HB 721 PN 1330, FINAL PASSAGE",113,90,0,0,203
1981203,1570198,2025-05-13,House,"House Appropriations: Re-report Bill As Committed",26,11,0,0,37
1981273,1539314,2025-04-08,House,"House Commerce: Report Bill As Committed",16,10,0,0,26
1983095,1569399,2025-05-12,Senate,"Senate Judiciary: Reported as Amended",14,0,0,0,14
1983095,1569400,2025-05-12,Senate,"Senate Judiciary: Adopt Amendment A00502",14,0,0,0,14
1983095,1583064,2025-06-02,Senate,"Senate Appropriations: Reported as Committed",22,0,0,0,22
1983095,1583245,2025-06-02,Senate,"Senate Floor: SB 302 PN 762, Final Passage",50,0,0,0,50
1983095,1591369,2025-06-17,House,"House Judiciary: Report Bill As Committed",26,0,0,0,26
1983095,1594966,2025-06-25,House,"House Appropriations: Re-report Bill As Committed",37,0,0,0,37
1983095,1595293,2025-06-26,House,"House Floor: SB 302 PN 762, FINAL PASSAGE",202,0,0,1,203
1983512,1518461,2025-03-17,House,"House Housing And Community Development: Adopt Amendment A00091",26,0,0,0,26
1983512,1518462,2025-03-17,House,"House Housing And Community Development: Report Bill As Amended",15,11,0,0,26
1983512,1564868,2025-05-05,House,"House Floor: HB 734 PN 983, FINAL PASSAGE",106,97,0,0,203
1983512,1564869,2025-05-05,House,"House Appropriations: Re-report Bill As Committed",37,0,0,0,37
1983512,1588595,2025-06-11,Senate,"Senate Urban Affairs And Housing: Reported as Committed",9,2,0,0,11
1984226,1518528,2025-03-17,House,"House Housing And Community Development: Report Bill As Committed",15,11,0,0,26
1984226,1555037,2025-04-23,House,"House Appropriations: Re-report Bill As Committed",37,0,0,0,37
1984226,1555383,2025-04-23,House,"House Floor: HB 743 PN 766, FINAL PASSAGE",115,88,0,0,203
1984586,1570375,2025-05-13,Senate,"Senate Banking And Insurance: Reported as Committed",14,0,0,0,14
1984586,1584926,2025-06-04,Senate,"Senate Floor: SR 27 PN 866",49,0,0,1,50
1984603,1583794,2025-06-03,Senate,"Senate Law And Justice: Reported as Committed",11,0,0,0,11
1984621,1505677,2025-03-05,House,"House Human Services: Report Bill As Committed",26,0,0,0,26
1984621,1541556,2025-04-09,House,"House Floor: HB 749 PN 765, 2025 A325",203,0,0,0,203
1984621,1553687,2025-04-22,House,"House Floor: HB 749 PN 1332, FINAL PASSAGE",203,0,0,0,203
1984621,1553688,2025-04-22,House,"House Appropriations: Re-report Bill As Committed",37,0,0,0,37
1984621,1595337,2025-06-26,Senate,"Senate Health And Human Services: Reported as Committed",13,0,0,0,13
1984673,1565933,2025-05-06,Senate,"Senate State Government: Reported as Committed",11,0,0,0,11
1984710,1526297,2025-03-25,Senate,"Senate Judiciary: Reported as Committed",10,4,0,0,14
1984710,1533024,2025-04-01,Senate,"Senate Floor: SB 347 PN 284, Final Passage",38,11,0,0,49
1984725,1588597,2025-06-11,Senate,"Senate Urban Affairs And Housing: Reported as Committed",8,3,0,0,11
1984960,1524847,2025-03-24,Senate,"Senate Environmental Resources And Energy: Reported as Committed",11,0,0,0,11
1984960,1564898,2025-05-05,Senate,"Senate Appropriations: Re-Reported as Committed",22,0,0,0,22
1984960,1566536,2025-05-06,Senate,"Senate Floor: SB 349 PN 286, Final Passage",49,1,0,0,50
1984960,1583045,2025-06-02,House,"House Environmental And Natural Resource Protection: Report Bill As Committed",26,0,0,0,26
1984989,1522579,2025-03-19,House,"House Local Government: Adopt Amendment A00148",12,14,0,0,26
1984989,1522580,2025-03-19,House,"House Local Government: Adopt Amendment A00158",12,14,0,0,26
1984989,1522581,2025-03-19,House,"House Local Government: Report Bill As Committed",15,11,0,0,26
1984989,1565740,2025-05-06,House,"House Floor: HB 754 PN 778, 2025 A147",101,102,0,0,203
1984989,1565741,2025-05-06,House,"House Floor: HB 754 PN 778, 2025 A148",101,102,0,0,203
1984989,1565742,2025-05-06,House,"House Floor: HB 754 PN 778, 2025 A158",101,102,0,0,203
1984989,1567375,2025-05-07,House,"House Floor: HB 754 PN 778, FINAL PASSAGE",120,83,0,0,203
1984989,1567376,2025-05-07,House,"House Appropriations: Re-report Bill As Committed",22,15,0,0,37
1985201,1565772,2025-05-06,Senate,"Senate State Government: Reported as Amended",11,0,0,0,11
1985201,1565773,2025-05-06,Senate,"Senate State Government: Adopt Amendment A00440",11,0,0,0,11
1985238,1526772,2025-03-25,Senate,"Senate Education: Reported as Committed",11,0,0,0,11
1985238,1532388,2025-04-01,Senate,"Senate Appropriations: Re-Reported as Committed",22,0,0,0,22
1985238,1533961,2025-04-02,Senate,"Senate Floor: SB 315 PN 249, Final Passage",49,0,0,0,49
1985238,1594119,2025-06-24,House,"House Education: Report Bill As Committed",26,0,0,0,26
1985253,1583781,2025-06-03,Senate,"Senate Law And Justice: Reported as Committed",11,0,0,0,11
1985395,1532264,2025-04-01,Senate,"Senate Finance: Reported as Committed",10,1,0,0,11
1986752,1518343,2025-03-17,House,"House Insurance: Bring Up The Bill For Consideration",14,12,0,0,26
1986752,1518344,2025-03-17,House,"House Insurance: Report Bill As Committed",14,12,0,0,26
1986752,1526055,2025-03-25,House,"House Floor: HB 755 PN 779, FINAL PASSAGE",133,69,0,0,202
1986752,1526056,2025-03-25,House,"House Appropriations: Re-report Bill As Committed",23,14,0,0,37
1987253,1518324,2025-03-17,House,"House Agriculture And Rural Affairs: Report Bill As Committed",23,3,0,0,26
1987253,1540247,2025-04-08,House,"House Floor: HB 764 PN 788, 2025 A141",101,102,0,0,203
1987253,1541749,2025-04-09,House,"House Floor: HB 764 PN 788, FINAL PASSAGE",112,91,0,0,203
1987253,1541750,2025-04-09,House,"House Appropriations: Re-report Bill As Committed",22,15,0,0,37
1987325,1526027,2025-03-25,House,"House Labor And Industry: Report Bill As Committed",14,12,0,0,26
1987325,1564857,2025-05-05,House,"House Floor: HB 630 PN 767, FINAL PASSAGE",102,101,0,0,203
1987325,1564858,2025-05-05,House,"House Appropriations: Re-report Bill As Committed",22,15,0,0,37
1987394,1570124,2025-05-13,House,"House Game And Fisheries: Report Bill As Committed",26,0,0,0,26
1988242,1584595,2025-06-04,Senate,"Senate Intergovernmental Operations: Reported as Amended",7,4,0,0,11
1988242,1584596,2025-06-04,Senate,"Senate Intergovernmental Operations: Adopt Amendment A00856",11,0,0,0,11
1988242,1587536,2025-06-10,Senate,"Senate Floor: SB 333 PN 895, Final Passage",27,23,0,0,50
1988242,1587537,2025-06-10,Senate,"Senate Appropriations: Re-Reported as Committed",14,8,0,0,22
1988435,1565743,2025-05-06,Senate,"Senate Law And Justice: Reported as Committed",11,0,0,0,11
1988435,1569526,2025-05-12,Senate,"Senate Floor: SB 327 PN 297, Final Passage",50,0,0,0,50
1988435,1569527,2025-05-12,Senate,"Senate Appropriations: Re-Reported as Committed",22,0,0,0,22
1988435,1591817,2025-06-17,House,"House Judiciary: Report Bill As Committed",26,0,0,0,26
1988460,1526520,2025-03-25,House,"House Veterans Affairs And Emergency Preparedness: Report Bill As Committed",26,0,0,0,26
1988695,1519650,2025-03-18,House,"House Environmental And Natural Resource Protection: Re-refer Bill To Another Committee",24,2,0,0,26
1988695,1591366,2025-06-17,House,"House Judiciary: Report Bill As Committed",14,12,0,0,26
1988971,1570466,2025-05-13,House,"House State Government: Report Bill As Committed",26,0,0,0,26
1989335,1553856,2025-04-22,House,"House Transportation: Report Bill As Committed",26,0,0,0,26
1989335,1556918,2025-04-24,House,"House Floor: HR 95 PN 825",199,4,0,0,203
1989364,1519423,2025-03-18,House,"House Environmental And Natural Resource Protection: Report Bill As Committed",14,12,0,0,26
1989364,1565106,2025-05-05,House,"House Floor: HB 789 PN 813, 2025 A408",101,102,0,0,203
1989364,1566343,2025-05-06,House,"House Floor: HB 789 PN 813, FINAL PASSAGE",107,96,0,0,203
1989364,1566344,2025-05-06,House,"House Appropriations: Re-report Bill As Committed",37,0,0,0,37
1989393,1556744,2025-04-24,House,"House Finance: Report Bill As Committed",17,9,0,0,26
1989393,1565576,2025-05-06,House,"House Appropriations: Re-report Bill As Committed",22,15,0,0,37
1989393,1566535,2025-05-06,House,"House Floor: HB 820 PN 824, FINAL PASSAGE",185,18,0,0,203
1989452,1594156,2025-06-24,Senate,"Senate Game And Fisheries: Reported as Amended",6,5,0,0,11
1989452,1594157,2025-06-24,Senate,"Senate Game And Fisheries: Amendment Defeated A01270",5,6,0,0,11
1989452,1594158,2025-06-24,Senate,"Senate Game And Fisheries: Adopt Amendment A01272",7,4,0,0,11
1989766,1541339,2025-04-09,House,"House Labor And Industry: Report Bill As Committed",24,2,0,0,26
1989766,1568003,2025-05-07,House,"House Floor: HR 97 PN 827",199,4,0,0,203
1989791,1522560,2025-03-19,House,"House Local Government: Report Bill As Committed",26,0,0,0,26
1989791,1553308,2025-04-22,House,"House Appropriations: Re-report Bill As Committed",37,0,0,0,37
1989791,1553808,2025-04-22,House,"House Floor: HB 797 PN 821, FINAL PASSAGE",203,0,0,0,203
1989791,1594273,2025-06-24,Senate,"Senate Veterans Affairs And Emergency Preparedness: Reported as Committed",11,0,0,0,11
1989901,1566129,2025-05-06,House,"House Consumer Protection, Technology And Utilities: Report Bill As Amended",14,12,0,0,26
1989901,1566130,2025-05-06,House,"House Consumer Protection, Technology And Utilities: Adopt Amendment A00431",26,0,0,0,26
1989901,1566131,2025-05-06,House,"House Consumer Protection, Technology And Utilities: Adopt Amendment A00490",26,0,0,0,26
1989986,1525994,2025-03-25,House,"House Veterans Affairs And Emergency Preparedness: Report Bill As Committed",26,0,0,0,26
1989986,1555176,2025-04-23,House,"House Floor: HB 799 PN 823, FINAL PASSAGE",134,69,0,0,203
1989986,1555177,2025-04-23,House,"House Appropriations: Re-report Bill As Committed",37,0,0,0,37
1989986,1594257,2025-06-24,Senate,"Senate Veterans Affairs And Emergency Preparedness: Reported as Committed",11,0,0,0,11
1989986,1594891,2025-06-25,Senate,"Senate Floor: HB 799 PN 823, 2025 A1327, MASTRIANO Amendment No. A-1327",48,2,0,0,50
1989986,1595326,2025-06-26,Senate,"Senate Appropriations: Re-Reported as Committed",22,0,0,0,22
1989986,1595415,2025-06-26,Senate,"Senate Floor: HB 799 PN 2027, Final Passage",46,4,0,0,50
1989986,1596159,2025-06-30,House,"House Rules: Re-report Bill As Committed",33,0,0,0,33
1989986,1596512,2025-06-30,House,"House Floor: HB 799 PN 2027, CONCURRENCE",181,22,0,0,203
1990070,1597038,2025-06-30,House,"House Judiciary: Report Bill As Committed",24,2,0,0,26
1990987,1570081,2025-05-12,House,"House Education: Re-refer Bill To Another Committee",26,0,0,0,26
1991152,1583024,2025-06-02,House,"House Judiciary: Report Bill As Committed",26,0,0,0,26
1991206,1583703,2025-06-03,House,"House Communications And Technology: Report Bill As Amended",26,0,0,0,26
1991206,1583704,2025-06-03,House,"House Communications And Technology: Adopt Amendment A00811",26,0,0,0,26
1991206,1591432,2025-06-17,House,"House Rules: Re-report Bill As Committed",33,0,0,0,33
1991206,1593916,2025-06-23,House,"House Floor: HB 811 PN 1819, FINAL PASSAGE",203,0,0,0,203
1991206,1593917,2025-06-23,House,"House Appropriations: Re-report Bill As Committed",37,0,0,0,37
1991664,1522542,2025-03-19,House,"House Local Government: Report Bill As Committed",15,11,0,0,26
1991861,1539375,2025-04-08,House,"House Housing And Community Development: Adopt Amendment A00279",26,0,0,0,26
1991861,1539376,2025-04-08,House,"House Housing And Community Development: Report Bill As Amended",24,2,0,0,26
1991861,1567055,2025-05-07,House,"House Floor: HB 818 PN 1296, 2025 A556",203,0,0,0,203
1991861,1567056,2025-05-07,House,"House Floor: HB 818 PN 1296, 2025 A588",203,0,0,0,203
1991861,1569521,2025-05-12,House,"House Floor: HB 818 PN 1656, FINAL PASSAGE",183,20,0,0,203
1991861,1569522,2025-05-12,House,"House Appropriations: Re-report Bill As Committed",37,0,0,0,37
1991926,1542473,2025-04-09,House,"House Health: Report Bill As Committed",26,0,0,0,26
1991926,1571423,2025-05-14,House,"House Floor: HR 101 PN 855",202,1,0,0,203
1991991,1519395,2025-03-17,House,"House Consumer Protection, Technology And Utilities: Report Bill As Committed",26,0,0,0,26
1991991,1594842,2025-06-25,House,"House Floor: HB 825 PN 852, FINAL PASSAGE",202,1,0,0,203
1991991,1594843,2025-06-25,House,"House Appropriations: Re-report Bill As Committed",37,0,0,0,37
1993184,1598010,2025-07-09,House,"House Liquor Control: Adopt Amendment A01488",26,0,0,0,26
1993184,1598011,2025-07-09,House,"House Liquor Control: Report Bill As Amended",26,0,0,0,26
1993192,1595406,2025-06-26,Senate,"Senate Judiciary: Reported as Committed",14,0,0,0,14
1993192,1599328,2025-08-12,Senate,"Senate Floor: SB 381 PN 328, 2025 A1633, PITTMAN Amendment No. A-1633",48,1,0,1,50
1993192,1601210,2025-09-08,Senate,"Senate Appropriations: Re-Reported as Committed",18,1,3,0,22
1993192,1601435,2025-09-09,Senate,"Senate Floor: SB 381 PN 1101, 2025 A1686, MASTRIANO Amendment No. A-1686",49,0,0,1,50
1993192,1601691,2025-09-10,Senate,"Senate Floor: SB 381 PN 1157, Final Passage",50,0,0,0,50
1993204,1564862,2025-05-05,Senate,"Senate Intergovernmental Operations: Reported as Amended",11,0,0,0,11
1993204,1564863,2025-05-05,Senate,"Senate Intergovernmental Operations: Adopt Amendment A00478",11,0,0,0,11
1993204,1569531,2025-05-12,Senate,"Senate Floor: SB 367 PN 748, Final Passage",50,0,0,0,50
1993204,1569532,2025-05-12,Senate,"Senate Appropriations: Re-Reported as Committed",22,0,0,0,22
1993247,1565694,2025-05-06,Senate,"Senate Communications And Technology: Reported as Committed",11,0,0,0,11
1993247,1583042,2025-06-02,Senate,"Senate Appropriations: Reported as Committed",22,0,0,0,22
1993247,1583875,2025-06-03,Senate,"Senate Floor: SB 377 PN 323, 2025 A761, PHILLIPS-HILL Amendment No. A-0761",28,21,0,1,50
1993247,1583876,2025-06-03,Senate,"Senate Floor: SB 377 PN 323, 2025 A761, PHILLIPS-HILL Amendment No. A-0761 Reconsideration",27,22,0,1,50
1993247,1584560,2025-06-04,Senate,"Senate Floor: SB 377 PN 323, Final Passage",49,0,0,1,50
1993269,1587903,2025-06-10,Senate,"Senate Community, Economic And Recreational Development: Reported as Committed",14,0,0,0,14
1993269,1594350,2025-06-24,Senate,"Senate Appropriations: Re-Reported as Committed",22,0,0,0,22
1993269,1598923,2025-07-16,Senate,"Senate Floor: SB 398 PN 345, Final Passage",49,0,0,1,50
1993290,1532089,2025-04-01,Senate,"Senate Finance: Reported as Amended",9,2,0,0,11
1993290,1532090,2025-04-01,Senate,"Senate Finance: Adopt Amendment A00266",10,1,0,0,11
1993303,1565693,2025-05-06,Senate,"Senate Communications And Technology: Reported as Committed",11,0,0,0,11
1993303,1583051,2025-06-02,Senate,"Senate Appropriations: Reported as Committed",22,0,0,0,22
1993303,1584562,2025-06-04,Senate,"Senate Floor: SB 376 PN 322, Final Passage",49,0,0,1,50
1993406,1531890,2025-04-01,Senate,"Senate Veterans Affairs And Emergency Preparedness: Reported as Committed",11,0,0,0,11
1993406,1565019,2025-05-05,Senate,"Senate Appropriations: Re-Reported as Committed",22,0,0,0,22
1993406,1566993,2025-05-07,Senate,"Senate Floor: SB 308 PN 324, Final Passage",50,0,0,0,50
1993406,1584558,2025-06-04,House,"House Veterans Affairs And Emergency Preparedness: Adopt Amendment A00777",26,0,0,0,26
1993406,1584559,2025-06-04,House,"House Veterans Affairs And Emergency Preparedness: Report Bill As Amended",26,0,0,0,26
1994783,1590926,2025-06-16,House,"House Agriculture And Rural Affairs: Report Bill As Committed",25,1,0,0,26
1995242,1565503,2025-05-06,House,"House Labor And Industry: Adopt Amendment A00456",12,14,0,0,26
1995242,1565504,2025-05-06,House,"House Labor And Industry: Report Bill As Committed",14,12,0,0,26
1995242,1584591,2025-06-04,House,"House Floor: HB 846 PN 876, 2025 A579",100,102,0,1,203
1995242,1584592,2025-06-04,House,"House Floor: HB 846 PN 876, 2025 A650",100,102,0,1,203
1995242,1586486,2025-06-09,House,"House Appropriations: Re-report Bill As Committed",25,12,0,0,37
1995242,1586755,2025-06-09,House,"House Floor: HB 846 PN 876, FINAL PASSAGE",126,76,0,1,203
1996040,1522717,2025-03-19,House,"House Local Government: Adopt Amendment A00137",26,0,0,0,26
1996040,1522718,2025-03-19,House,"House Local Government: Adopt Amendment A00149",26,0,0,0,26
1996040,1522719,2025-03-19,House,"House Local Government: Report Bill As Amended",26,0,0,0,26
1996040,1583080,2025-06-02,House,"House Floor: HB 858 PN 1046, 2025 A358",203,0,0,0,203
1996040,1583730,2025-06-03,House,"House Appropriations: Re-report Bill As Committed",37,0,0,0,37
1996040,1583943,2025-06-03,House,"House Floor: HB 858 PN 1806, FINAL PASSAGE",132,71,0,0,203
1996065,1556699,2025-04-24,House,"House Finance: Adopt Amendment A00396",23,3,0,0,26
1996065,1556700,2025-04-24,House,"House Finance: Report Bill As Amended",23,3,0,0,26
1996065,1583055,2025-06-02,House,"House Floor: HB 853 PN 1487, 2025 A743",203,0,0,0,203
1996065,1583056,2025-06-02,House,"House Floor: HB 853 PN 1487, 2025 A744",203,0,0,0,203
1996065,1583057,2025-06-02,House,"House Floor: HB 853 PN 1487, 2025 A746",203,0,0,0,203
1996065,1583885,2025-06-03,House,"House Floor: HB 853 PN 1805, FINAL PASSAGE",102,101,0,0,203
1996065,1583886,2025-06-03,House,"House Appropriations: Re-report Bill As Committed",37,0,0,0,37
1996091,1556763,2025-04-24,House,"House Finance: Adopt Amendment A00382",22,4,0,0,26
1996091,1556764,2025-04-24,House,"House Finance: Report Bill As Amended",21,5,0,0,26
1996091,1583129,2025-06-02,House,"House Floor: HB 852 PN 1486, 2025 A815",203,0,0,0,203
1996091,1583782,2025-06-03,House,"House Appropriations: Re-report Bill As Committed",37,0,0,0,37
1996091,1584025,2025-06-03,House,"House Floor: HB 852 PN 1804, FINAL PASSAGE",102,101,0,0,203
1996118,1518533,2025-03-17,House,"House Education: Report Bill As Committed",26,0,0,0,26
1996118,1520957,2025-03-19,House,"House Floor: HR 107 PN 891",200,2,0,0,202
1996191,1518329,2025-03-17,House,"House Agriculture And Rural Affairs: Report Bill As Amended",26,0,0,0,26
1996191,1518330,2025-03-17,House,"House Agriculture And Rural Affairs: Adopt Amendment A00102",26,0,0,0,26
1996336,1521778,2025-03-19,House,"House Veterans Affairs And Emergency Preparedness: Report Bill As Committed",26,0,0,0,26
1996336,1570306,2025-05-13,House,"House Floor: HB 865 PN 890, 2025 A215",203,0,0,0,203
1996336,1571218,2025-05-14,House,"House Floor: HB 865 PN 1705, FINAL PASSAGE",203,0,0,0,203
1996336,1571219,2025-05-14,House,"House Appropriations: Re-report Bill As Committed",37,0,0,0,37
1996336,1594297,2025-06-24,Senate,"Senate Veterans Affairs And Emergency Preparedness: Reported as Amended",11,0,0,0,11
1996336,1594298,2025-06-24,Senate,"Senate Veterans Affairs And Emergency Preparedness: Adopt Amendment A01284",11,0,0,0,11
1996336,1595318,2025-06-26,Senate,"Senate Appropriations: Re-Reported as Committed",22,0,0,0,22
1996336,1595394,2025-06-26,Senate,"Senate Floor: HB 865 PN 2010, Final Passage",50,0,0,0,50
1996336,1596491,2025-06-30,House,"House Floor: HB 865 PN 2010, CONCURRENCE",203,0,0,0,203
1996336,1596492,2025-06-30,House,"House Rules: Re-report Bill As Committed",33,0,0,0,33
1996472,1570487,2025-05-13,House,"House State Government: Report Bill As Committed",26,0,0,0,26
1996575,1531904,2025-04-01,Senate,"Senate Veterans Affairs And Emergency Preparedness: Reported as Committed",11,0,0,0,11
1996575,1564886,2025-05-05,Senate,"Senate Appropriations: Re-Reported as Committed",22,0,0,0,22
1996575,1584497,2025-06-03,Senate,"Senate Floor: SB 417 PN 351, Motion to Table",49,0,0,1,50
1996588,1531972,2025-04-01,Senate,"Senate Health And Human Services: Reported as Amended",13,0,0,0,13
1996588,1531973,2025-04-01,Senate,"Senate Health And Human Services: Adopt Amendment A00260",13,0,0,0,13
1996588,1583046,2025-06-02,Senate,"Senate Appropriations: Reported as Committed",22,0,0,0,22
1996588,1583867,2025-06-03,Senate,"Senate Floor: SB 411 PN 510, Final Passage",49,0,0,1,50
1996588,1590933,2025-06-16,House,"House Health: Report Bill As Amended",14,1,11,0,26
1996588,1590934,2025-06-16,House,"House Health: Adopt Amendment A01083",26,0,0,0,26
1996588,1595024,2025-06-25,House,"House Appropriations: Re-report Bill As Committed",37,0,0,0,37
1996588,1595320,2025-06-26,House,"House Floor: SB 411 PN 944, FINAL PASSAGE",199,3,0,1,203
1996588,1595400,2025-06-26,Senate,"Senate Floor: SB 411 PN 944, Concur in House Amendments",50,0,0,0,50
1996588,1595401,2025-06-26,Senate,"Senate Rules And Executive Nominations: Re-Reported as Committed",17,0,0,0,17
1999767,1520190,2025-03-18,House,"House Commerce: Adopt Amendment A00131",12,14,0,0,26
1999767,1520191,2025-03-18,House,"House Commerce: Report Bill As Committed",14,12,0,0,26
1999767,1553434,2025-04-22,House,"House Floor: HB 881 PN 913, 2025 A243",203,0,0,0,203
1999767,1555125,2025-04-23,House,"House Floor: HB 881 PN 1461, FINAL PASSAGE",164,39,0,0,203
1999767,1555126,2025-04-23,House,"House Appropriations: Re-report Bill As Committed",37,0,0,0,37
1999846,1518578,2025-03-17,House,"House Education: Report Bill As Committed",26,0,0,0,26
1999911,1526514,2025-03-25,House,"House Veterans Affairs And Emergency Preparedness: Adopt Amendment A00194",26,0,0,0,26
1999911,1526515,2025-03-25,House,"House Veterans Affairs And Emergency Preparedness: Report Bill As Amended",26,0,0,0,26
1999979,1540130,2025-04-08,House,"House State Government: Adopt Resolution",22,4,0,0,26
1999979,1556440,2025-04-24,House,"House Floor: HR 110 PN 914",199,4,0,0,203
2000039,1520843,2025-03-19,House,"House Children And Youth: Report Bill As Committed",14,12,0,0,26
2000039,1538428,2025-04-07,House,"House Floor: HR 113 PN 924",200,3,0,0,203
2002374,1542341,2025-04-09,House,"House Health: Report Bill As Committed",26,0,0,0,26
2004706,1522912,2025-03-19,House,"House Local Government: Report Bill As Committed",25,1,0,0,26
2004706,1543240,2025-04-09,House,"House Floor: HR 118 PN 956",198,5,0,0,203
2004815,1520756,2025-03-19,House,"House Children And Youth: Report Bill As Committed",14,12,0,0,26
2004815,1524654,2025-03-24,House,"House Rules: Adopt Amendment A00220",18,15,0,0,33
2004815,1524655,2025-03-24,House,"House Rules: Re-report Bill As Amended",18,15,0,0,33
2004815,1540064,2025-04-08,House,"House Floor: HR 117 PN 1116",109,94,0,0,203
2005137,1518539,2025-03-17,House,"House Education: Adopt Amendment A00117",21,5,0,0,26
2005137,1518540,2025-03-17,House,"House Education: Report Bill As Amended",19,7,0,0,26
2005137,1539810,2025-04-08,House,"House Floor: HB 819 PN 987, 2025 A159",101,102,0,0,203
2005137,1541406,2025-04-09,House,"House Appropriations: Re-report Bill As Committed",22,15,0,0,37
2005137,1542174,2025-04-09,House,"House Floor: HB 819 PN 987, FINAL PASSAGE",131,72,0,0,203
2006443,1565453,2025-05-06,House,"House Consumer Protection, Technology And Utilities: Report Bill As Committed",17,9,0,0,26
2006496,1519765,2025-03-18,House,"House Transportation: Report Bill As Amended",26,0,0,0,26
2006496,1522036,2025-03-19,House,"House Floor: HR 121 PN 957",199,3,0,0,202
2006547,1541332,2025-04-09,House,"House Finance: Re-report Bill As Committed",26,0,0,0,26
2006547,1555310,2025-04-23,House,"House Floor: HR 120 PN 978",198,5,0,0,203
2007235,1521500,2025-03-19,House,"House Veterans Affairs And Emergency Preparedness: Report Bill As Committed",26,0,0,0,26
2007395,1524665,2025-03-24,House,"House Aging And Older Adult Services: Report Bill As Committed",26,0,0,0,26
2007395,1554263,2025-04-22,House,"House Floor: HB 923 PN 958, FINAL PASSAGE",203,0,0,0,203
2007395,1554264,2025-04-22,House,"House Appropriations: Re-report Bill As Committed",37,0,0,0,37
2007507,1539555,2025-04-08,House,"House State Government: Adopt Resolution",22,4,0,0,26
2007507,1566139,2025-05-06,House,"House Floor: HR 123 PN 980",195,8,0,0,203
2007586,1526061,2025-03-25,House,"House Labor And Industry: Adopt Amendment A00210",12,14,0,0,26
2007586,1526062,2025-03-25,House,"House Labor And Industry: Report Bill As Committed",14,12,0,0,26
2007586,1564922,2025-05-05,House,"House Floor: HB 926 PN 974, 2025 A321",101,102,0,0,203
2007586,1564923,2025-05-05,House,"House Floor: HB 926 PN 974, 2025 A423",203,0,0,0,203
2007586,1565594,2025-05-06,House,"House Appropriations: Re-report Bill As Committed",22,15,0,0,37
2007586,1566376,2025-05-06,House,"House Floor: HB 926 PN 1597, FINAL PASSAGE",124,79,0,0,203
2007815,1584547,2025-06-04,House,"House Children And Youth: Adopt Amendment A00885",26,0,0,0,26
2007815,1584548,2025-06-04,House,"House Children And Youth: Report Bill As Amended A00885",26,0,0,0,26
2007815,1593906,2025-06-23,House,"House Floor: HB 928 PN 1833, 2025 A1056",154,49,0,0,203
2007815,1593907,2025-06-23,House,"House Rules: Re-report Bill As Committed",33,0,0,0,33
2007815,1594147,2025-06-24,House,"House Appropriations: Re-report Bill As Committed",37,0,0,0,37
2007815,1594409,2025-06-24,House,"House Floor: HB 928 PN 1979, FINAL PASSAGE",197,6,0,0,203
2008281,1526767,2025-03-25,Senate,"Senate State Government: Reported as Committed",11,0,0,0,11
2008281,1587538,2025-06-10,Senate,"Senate Floor: SB 225 PN 377, Final Passage",50,0,0,0,50
2008281,1587539,2025-06-10,Senate,"Senate Appropriations: Re-Reported as Committed",22,0,0,0,22
2008861,1565720,2025-05-06,House,"House State Government: Adopt Amendment A00445",26,0,0,0,26
2008861,1565721,2025-05-06,House,"House State Government: Report Bill As Amended A00445",14,12,0,0,26
2008998,1525256,2025-03-24,Senate,"Senate Appropriations: Re-Reported as Committed",15,7,0,0,22
2008998,1525257,2025-03-24,Senate,"Senate Environmental Resources And Energy: Reported as Committed",9,2,0,0,11
2008998,1528096,2025-03-26,Senate,"Senate Floor: SB 404 PN 383, Final Passage",35,14,0,0,49
2009010,1525513,2025-03-24,Senate,"Senate Appropriations: Re-Reported as Committed",15,7,0,0,22
2009010,1525514,2025-03-24,Senate,"Senate Environmental Resources And Energy: Reported as Committed",7,4,0,0,11
2009010,1528195,2025-03-26,Senate,"Senate Floor: SB 403 PN 382, Final Passage",29,20,0,0,49
2009060,1571129,2025-05-14,House,"House Judiciary: Report Bill As Committed",26,0,0,0,26
2009082,1594115,2025-06-24,House,"House Education: Report Bill As Committed",14,12,0,0,26
2009082,1597985,2025-07-09,House,"House Floor: HB 938 PN 1004, 2025 A1339",101,102,0,0,203
2009082,1597986,2025-07-09,House,"House Floor: HB 938 PN 1004, 2025 A1512",101,102,0,0,203
2009082,1597987,2025-07-09,House,"House Rules: Re-report Bill As Committed",18,15,0,0,33
2009082,1598184,2025-07-14,House,"House Appropriations: Re-report Bill As Committed",22,15,0,0,37
2009082,1598327,2025-07-14,House,"House Floor: HB 938 PN 1004, FINAL PASSAGE",106,96,0,1,203
2009145,1526296,2025-03-25,Senate,"Senate State Government: Reported as Committed",10,1,0,0,11
2009145,1527579,2025-03-26,Senate,"Senate Floor: SR 46 PN 378",47,2,0,0,49
2009206,1519604,2025-03-18,House,"House Appropriations: Report Bill As Committed",37,0,0,0,37
2009206,1520796,2025-03-19,House,"House Floor: HR 127 PN 997",199,3,0,0,202
2009235,1594191,2025-06-24,Senate,"Senate State Government: Reported as Committed",11,0,0,0,11
2009235,1598789,2025-07-16,Senate,"Senate Appropriations: Re-Reported as Committed",22,0,0,0,22
2009235,1601213,2025-09-08,Senate,"Senate Floor: SB 460 PN 394, 2025 A1667, ARGALL Amendment No. A-1667",37,9,0,4,50
2009235,1601442,2025-09-09,Senate,"Senate Floor: SB 460 PN 1150, Final Passage",35,14,0,1,50
2009247,1541806,2025-04-09,House,"House Local Government: Report Bill As Committed",14,12,0,0,26
2009247,1569560,2025-05-12,House,"House Floor: HB 937 PN 1003, 2025 A629, MOTION TO SUSPEND RULES",202,1,0,0,203
2009247,1569561,2025-05-12,House,"House Floor: HB 937 PN 1003, 2025 A629",203,0,0,0,203
2009247,1571290,2025-05-14,House,"House Floor: HB 937 PN 1687, FINAL PASSAGE",103,100,0,0,203
2009247,1571291,2025-05-14,House,"House Appropriations: Re-report Bill As Committed",22,15,0,0,37
2009317,1584581,2025-06-04,Senate,"Senate Intergovernmental Operations: Reported as Committed",7,4,0,0,11
2009317,1587527,2025-06-10,Senate,"Senate Floor: SB 444 PN 391, Final Passage",27,23,0,0,50
2009317,1587528,2025-06-10,Senate,"Senate Appropriations: Re-Reported as Committed",14,8,0,0,22
2009343,1527972,2025-03-26,Senate,"Senate Veterans Affairs And Emergency Preparedness: Reported as Committed",11,0,0,0,11
2009413,1587605,2025-06-10,Senate,"Senate Education: Reported as Amended",9,2,0,0,11
2009413,1587606,2025-06-10,Senate,"Senate Education: Adopt Amendment A00862",11,0,0,0,11
2009413,1594363,2025-06-24,Senate,"Senate Appropriations: Re-Reported as Committed",22,0,0,0,22
2009430,1587937,2025-06-10,Senate,"Senate Community, Economic And Recreational Development: Reported as Committed",14,0,0,0,14
2009430,1594351,2025-06-24,Senate,"Senate Appropriations: Re-Reported as Committed",22,0,0,0,22
2009430,1598790,2025-07-16,Senate,"Senate Floor: SB 416 PN 403, Final Passage",49,0,0,1,50
2009498,1588428,2025-06-11,Senate,"Senate Health And Human Services: Reported as Committed",12,0,1,0,13
2009567,1588706,2025-06-11,Senate,"Senate Health And Human Services: Reported as Committed",12,0,1,0,13
2009864,1525248,2025-03-24,House,"House Floor: UNCONTESTED CALENDAR",202,0,0,0,202
2009951,1526340,2025-03-25,House,"House Floor: HR 130 PN 1064",167,35,0,0,202
2009951,1526341,2025-03-25,House,"House Appropriations: Report Bill As Committed",37,0,0,0,37
2009967,1584746,2025-06-04,Senate,"Senate Transportation: Reported as Amended",14,0,0,0,14
2009967,1584747,2025-06-04,Senate,"Senate Transportation: Adopt Amendment A00835",14,0,0,0,14
2009967,1587513,2025-06-10,Senate,"Senate Appropriations: Re-Reported as Committed",22,0,0,0,22
2009967,1593973,2025-06-23,Senate,"Senate Floor: SB 468 PN 893, Final Passage",50,0,0,0,50
2010024,1526705,2025-03-25,Senate,"Senate Education: Reported as Committed",10,1,0,0,11
2010042,1553793,2025-04-22,House,"House Transportation: Adopt Amendment A00362",26,0,0,0,26
2010042,1553794,2025-04-22,House,"House Transportation: Report Bill As Amended",24,2,0,0,26
2010042,1571079,2025-05-14,House,"House Floor: HB 960 PN 1460, 2025 A395",201,2,0,0,203
2010042,1571080,2025-05-14,House,"House Floor: HB 960 PN 1460, 2025 A698, CONSTITUTIONALITY",101,102,0,0,203
2010042,1571081,2025-05-14,House,"House Floor: HB 960 PN 1460, 2025 A722",146,57,0,0,203
2010042,1583106,2025-06-02,House,"House Floor: HB 960 PN 1727, FINAL PASSAGE",115,88,0,0,203
2010042,1583107,2025-06-02,House,"House Appropriations: Re-report Bill As Committed",37,0,0,0,37
2010099,1527321,2025-03-26,Senate,"Senate Veterans Affairs And Emergency Preparedness: Reported as Amended",11,0,0,0,11
2010099,1527322,2025-03-26,Senate,"Senate Veterans Affairs And Emergency Preparedness: Adopt Amendment A00244",11,0,0,0,11
2010099,1564891,2025-05-05,Senate,"Senate Appropriations: Re-Reported as Committed",22,0,0,0,22
2010099,1565695,2025-05-05,Senate,"Senate Floor: SB 466 PN 485, Final Passage",50,0,0,0,50
2010099,1594139,2025-06-24,House,"House Veterans Affairs And Emergency Preparedness: Report Bill As Committed",26,0,0,0,26
2010099,1594977,2025-06-25,House,"House Appropriations: Re-report Bill As Committed",37,0,0,0,37
2010099,1595298,2025-06-26,House,"House Floor: SB 466 PN 485, FINAL PASSAGE",202,0,0,1,203
2010120,1571127,2025-05-14,House,"House Judiciary: Amendment Failed A00278",11,15,0,0,26
2010120,1593868,2025-06-23,House,"House Judiciary: Report Bill As Amended",22,4,0,0,26
2010120,1593869,2025-06-23,House,"House Judiciary: Adopt Amendment A00954",24,2,0,0,26
2010120,1596531,2025-06-30,House,"House Floor: HB 956 PN 1975, 2025 A1374, MOTION TO TABLE",102,101,0,0,203
2010120,1596532,2025-06-30,House,"House Rules: Re-report Bill As Committed",33,0,0,0,33
2010120,1597010,2025-07-01,House,"House Appropriations: Re-report Bill As Committed",37,0,0,0,37
2010120,1597090,2025-07-01,House,"House Floor: HB 956 PN 1975, FINAL PASSAGE",122,80,0,1,203
2010197,1595566,2025-06-26,Senate,"Senate State Government: Reported as Committed",11,0,0,0,11
2010197,1598820,2025-07-16,Senate,"Senate Floor: SB 467 PN 420, 2025 A1422, ARGALL Amendment No. A-1422",34,15,0,1,50
2010197,1598821,2025-07-17,Senate,"Senate Floor: SB 467 PN 1057, Final Passage",49,1,0,0,50
2010197,1598822,2025-07-17,Senate,"Senate Floor: SB 467 PN 1057, Reconsideration - Final Passage",48,2,0,0,50
2010432,1526697,2025-03-25,Senate,"Senate Judiciary: Reported as Committed",9,5,0,0,14
2010432,1531153,2025-03-31,Senate,"Senate Floor: SB 471 PN 425, Final Passage",31,18,0,0,49
2010734,1594254,2025-06-24,Senate,"Senate Finance: Reported as Amended",7,4,0,0,11
2010734,1594255,2025-06-24,Senate,"Senate Finance: Adopt Amendment A01233",7,4,0,0,11
2010778,1594205,2025-06-24,Senate,"Senate Game And Fisheries: Reported as Committed",11,0,0,0,11
2010791,1526320,2025-03-25,Senate,"Senate Judiciary: Reported as Committed",14,0,0,0,14
2010791,1532377,2025-04-01,Senate,"Senate Appropriations: Re-Reported as Committed",22,0,0,0,22
2010791,1533960,2025-04-02,Senate,"Senate Floor: SB 475 PN 430, Final Passage",49,0,0,0,49
2010791,1565034,2025-05-05,House,"House Judiciary: Report Bill As Committed",26,0,0,0,26
2010791,1597644,2025-07-07,House,"House Floor: SB 475 PN 430, 2025 A1448, MOTION TO TABLE",102,101,0,0,203
2010791,1597645,2025-07-07,House,"House Floor: SB 475 PN 430, 2025 A1449, MOTION TO TABLE",102,101,0,0,203
2010791,1597646,2025-07-07,House,"House Floor: SB 475 PN 430, 2025 A1453, MOTION TO TABLE",102,101,0,0,203
2010791,1597779,2025-07-08,House,"House Appropriations: Re-report Bill As Committed",37,0,0,0,37
2010791,1597798,2025-07-08,House,"House Floor: SB 475 PN 430, FINAL PASSAGE",203,0,0,0,203
2010812,1525908,2025-03-25,Senate,"Senate State Government: Reported as Committed",7,4,0,0,11
2010812,1532402,2025-04-01,Senate,"Senate Appropriations: Re-Reported as Committed",14,8,0,0,22
2010812,1533966,2025-04-02,Senate,"Senate Floor: SB 472 PN 427, Final Passage",27,22,0,0,49
2010867,1527346,2025-03-26,Senate,"Senate Finance: Reported as Committed",8,3,0,0,11
2010882,1570077,2025-05-13,House,"House Game And Fisheries: Report Bill As Committed",26,0,0,0,26
2010882,1593865,2025-06-23,House,"House Appropriations: Re-report Bill As Committed",37,0,0,0,37
2010882,1593970,2025-06-23,House,"House Floor: HB 968 PN 1049, FINAL PASSAGE",203,0,0,0,203
2010892,1565746,2025-05-06,House,"House Consumer Protection, Technology And Utilities: Report Bill As Committed",17,9,0,0,26
2010892,1588583,2025-06-11,House,"House Floor: HB 967 PN 1048, FINAL PASSAGE",108,95,0,0,203
2010892,1588584,2025-06-11,House,"House Appropriations: Re-report Bill As Committed",37,0,0,0,37
2010963,1594765,2025-06-25,House,"House Local Government: Adopt Amendment A01300",14,12,0,0,26
2010963,1594766,2025-06-25,House,"House Local Government: Report Bill As Amended",14,12,0,0,26
2010975,1567230,2025-05-07,House,"House Local Government: Adopt Amendment A00472",26,0,0,0,26
2010975,1567231,2025-05-07,House,"House Local Government: Report Bill As Amended",25,1,0,0,26
2011028,1583018,2025-06-02,House,"House Environmental And Natural Resource Protection: Re-refer Bill To Another Committee",26,0,0,0,26
2011028,1595346,2025-06-26,House,"House Veterans Affairs And Emergency Preparedness: Report Bill As Committed",25,1,0,0,26
2011028,1597775,2025-07-08,House,"House Rules: Re-report Bill As Committed",33,0,0,0,33
2011028,1597791,2025-07-08,House,"House Floor: HB 589 PN 1069, 2025 A1461",203,0,0,0,203
2011028,1597980,2025-07-09,House,"House Appropriations: Re-report Bill As Amended",37,0,0,0,37
2011028,1597981,2025-07-09,House,"House Appropriations: Adopt Amendment A01513",37,0,0,0,37
2011076,1541873,2025-04-09,House,"House Health: Report Bill As Committed",26,0,0,0,26
2011076,1570143,2025-05-13,House,"House Floor: HR 137 PN 1067",201,2,0,0,203
2011104,1566497,2025-05-06,House,"House State Government: Report Bill As Committed",25,1,0,0,26
2011426,1570215,2025-05-13,Senate,"Senate Local Government: Reported as Committed",8,3,0,0,11
2011426,1588640,2025-06-11,Senate,"Senate Floor: SB 311 PN 436, Final Passage",34,15,0,1,50
2011427,1597789,2025-07-08,House,"House Transportation: Report Bill As Committed",26,0,0,0,26
2011525,1539330,2025-04-08,House,"House Housing And Community Development: Re-report Bill As Committed",25,1,0,0,26
2011525,1567427,2025-05-07,House,"House Floor: HB 986 PN 1076, FINAL PASSAGE",153,50,0,0,203
2011525,1567428,2025-05-07,House,"House Appropriations: Re-report Bill As Committed",37,0,0,0,37
2011583,1541938,2025-04-09,House,"House Local Government: Adopt Amendment A00312",12,14,0,0,26
2011583,1541939,2025-04-09,House,"House Local Government: Adopt Amendment A00313",12,14,0,0,26
2011583,1541940,2025-04-09,House,"House Local Government: Report Bill As Amended",17,9,0,0,26
2011583,1541941,2025-04-09,House,"House Local Government: Adopt Amendment A00311",26,0,0,0,26
2011615,1541957,2025-04-09,House,"House Local Government: Adopt Amendment A00310",26,0,0,0,26
2011615,1541958,2025-04-09,House,"House Local Government: Adopt Amendment A00314",12,14,0,0,26
2011615,1541959,2025-04-09,House,"House Local Government: Adopt Amendment A00317",12,14,0,0,26
2011615,1541960,2025-04-09,House,"House Local Government: Report Bill As Amended",17,9,0,0,26
2011674,1527312,2025-03-26,Senate,"Senate Transportation: Reported as Committed",10,4,0,0,14
2011674,1565021,2025-05-05,Senate,"Senate Appropriations: Re-Reported as Committed",18,4,0,0,22
2011674,1567010,2025-05-07,Senate,"Senate Floor: SB 481 PN 439, Final Passage",36,14,0,0,50
2011731,1526774,2025-03-25,House,"House Veterans Affairs And Emergency Preparedness: Report Bill As Committed",26,0,0,0,26
2011785,1594478,2025-06-24,Senate,"Senate Community, Economic And Recreational Development: Reported as Amended",13,1,0,0,14
2011785,1594479,2025-06-24,Senate,"Senate Community, Economic And Recreational Development: Adopt Amendment A00768",14,0,0,0,14
2011808,1526749,2025-03-25,Senate,"Senate Judiciary: Reported as Committed",9,5,0,0,14
2011808,1531337,2025-03-31,Senate,"Senate Floor: SB 490 PN 444, Final Passage",32,17,0,0,49
2011887,1565449,2025-05-06,House,"House Commerce: Adopt Amendment A00487",26,0,0,0,26
2011887,1565450,2025-05-06,House,"House Commerce: Report Bill As Amended",14,12,0,0,26
2011922,1583069,2025-06-02,House,"House Judiciary: Report Bill As Committed",25,1,0,0,26
2011922,1594175,2025-06-24,House,"House Appropriations: Re-report Bill As Committed",37,0,0,0,37
2011922,1594439,2025-06-24,House,"House Floor: HB 994 PN 1078, FINAL PASSAGE",127,76,0,0,203
2011960,1539429,2025-04-08,House,"House Game And Fisheries: Re-report Bill As Committed",26,0,0,0,26
2011960,1566206,2025-05-06,House,"House Floor: HB 992 PN 1083, 2025 A483",101,102,0,0,203
2011960,1567606,2025-05-07,House,"House Floor: HB 992 PN 1083, FINAL PASSAGE",203,0,0,0,203
2011960,1567607,2025-05-07,House,"House Appropriations: Re-report Bill As Committed",37,0,0,0,37
2011960,1594183,2025-06-24,Senate,"Senate Game And Fisheries: Reported as Committed",11,0,0,0,11
2011960,1595328,2025-06-26,Senate,"Senate Appropriations: Re-Reported as Committed",22,0,0,0,22
2011960,1595414,2025-06-26,Senate,"Senate Floor: HB 992 PN 1083, Final Passage",50,0,0,0,50
2011993,1525989,2025-03-25,House,"House Veterans Affairs And Emergency Preparedness: Report Bill As Committed",26,0,0,0,26
2011993,1564865,2025-05-05,House,"House Floor: HB 993 PN 1077, 2025 A414",203,0,0,0,203
2011993,1565769,2025-05-06,House,"House Floor: HB 993 PN 1598, FINAL PASSAGE",203,0,0,0,203
2011993,1565770,2025-05-06,House,"House Appropriations: Re-report Bill As Committed",37,0,0,0,37
2012366,1539653,2025-04-08,House,"House Housing And Community Development: Report Bill As Committed",25,1,0,0,26
2012486,1591397,2025-06-17,House,"House Children And Youth: Report Bill As Committed",14,12,0,0,26
2012486,1596450,2025-06-30,House,"House Floor: HR 142 PN 1109",109,94,0,0,203
2012498,1601689,2025-09-10,Senate,"Senate Consumer Protection And Professional Licensure: Reported as Amended",13,1,0,0,14
2012498,1601690,2025-09-10,Senate,"Senate Consumer Protection And Professional Licensure: Adopt Amendment A01642",14,0,0,0,14
2012520,1570559,2025-05-13,House,"House State Government: Report Bill As Committed",26,0,0,0,26
2012520,1586666,2025-06-09,House,"House Floor: HB 1018 PN 1098, FINAL PASSAGE",200,2,0,1,203
2012520,1586667,2025-06-09,House,"House Appropriations: Re-report Bill As Committed",37,0,0,0,37
2012599,1555150,2025-04-23,House,"House Tourism, Recreation And Economic Development: Report Bill As Committed",26,0,0,0,26
2012599,1570681,2025-05-13,House,"House Floor: HB 1030 PN 1105, FINAL PASSAGE",150,53,0,0,203
2012599,1570682,2025-05-13,House,"House Appropriations: Re-report Bill As Committed",37,0,0,0,37
2013042,1526764,2025-03-25,House,"House Judiciary: Bring Up The Bill For Consideration",26,0,0,0,26
2013042,1526765,2025-03-25,House,"House Judiciary: Adopt Amendment A00229",23,3,0,0,26
2013365,1541566,2025-04-09,House,"House Floor: HR 144 PN 1124",199,4,0,0,203
2013365,1541567,2025-04-09,House,"House Health: Report Bill As Committed",26,0,0,0,26
2013528,1539648,2025-04-08,House,"House Housing And Community Development: Report Bill As Committed",26,0,0,0,26
2013822,1531932,2025-04-01,Senate,"Senate Veterans Affairs And Emergency Preparedness: Reported as Committed",11,0,0,0,11
2013822,1583137,2025-06-02,Senate,"Senate Appropriations: Reported as Committed",22,0,0,0,22
2013822,1586728,2025-06-09,Senate,"Senate Floor: SB 511 PN 471, Final Passage",50,0,0,0,50
2014013,1564864,2025-05-05,House,"House Judiciary: Report Bill As Committed",14,12,0,0,26
2014157,1567147,2025-05-07,House,"House Local Government: Adopt Amendment A00464",26,0,0,0,26
2014157,1567148,2025-05-07,House,"House Local Government: Adopt Amendment A00559",26,0,0,0,26
2014157,1567149,2025-05-07,House,"House Local Government: Report Bill As Amended",14,12,0,0,26
2014157,1591438,2025-06-17,House,"House Appropriations: Re-report Bill As Committed",33,4,0,0,37
2014157,1593967,2025-06-23,House,"House Floor: HB 1048 PN 1651, FINAL PASSAGE",113,90,0,0,203
2014252,1539528,2025-04-08,House,"House State Government: Report Bill As Committed",14,12,0,0,26
2014453,1532063,2025-04-01,Senate,"Senate Game And Fisheries: Reported as Committed",11,0,0,0,11
2014453,1565696,2025-05-05,Senate,"Senate Floor: SB 518 PN 481, Final Passage",50,0,0,0,50
2014453,1583755,2025-06-03,House,"House Game And Fisheries: Report Bill As Committed",26,0,0,0,26
2014453,1594852,2025-06-25,House,"House Floor: SB 518 PN 481, 2025 A1285, MOTION TO TABLE",9,194,0,0,203
2014453,1594853,2025-06-25,House,"House Floor: SB 518 PN 481, 2025 A1285",138,65,0,0,203
2014453,1595034,2025-06-25,House,"House Appropriations: Re-report Bill As Committed",37,0,0,0,37
2014453,1595329,2025-06-26,House,"House Floor: SB 518 PN 1014, FINAL PASSAGE",199,3,0,1,203
2014453,1595410,2025-06-26,Senate,"Senate Floor: SB 518 PN 1014, Concur in House Amendments",50,0,0,0,50
2014453,1595411,2025-06-26,Senate,"Senate Rules And Executive Nominations: Re-Reported as Committed",17,0,0,0,17
2014472,1567084,2025-05-07,House,"House Appropriations: Report Bill As Committed",22,15,0,0,37
2014472,1598197,2025-07-14,House,"House Floor: HB 1330 PN 2118, FINAL PASSAGE",105,97,0,1,203
2014472,1598198,2025-07-14,House,"House Appropriations: Adopt Amendment A01561",22,15,0,0,37
2014472,1598199,2025-07-14,House,"House Appropriations: Re-report Bill As Amended",22,15,0,0,37
2014472,1598784,2025-07-16,Senate,"Senate Appropriations: Reported as Amended",16,6,0,0,22
2014472,1598785,2025-07-16,Senate,"Senate Appropriations: Adopt Amendment A01564",14,8,0,0,22
2014646,1594184,2025-06-24,Senate,"Senate Game And Fisheries: Reported as Committed",10,1,0,0,11
2014813,1558002,2025-04-24,House,"House Finance: Adopt Amendment A00360",26,0,0,0,26
2014813,1558003,2025-04-24,House,"House Finance: Report Bill As Amended",25,1,0,0,26
2014813,1571085,2025-05-14,House,"House Floor: HB 1058 PN 1488, 2025 A594",203,0,0,0,203
2014813,1583135,2025-06-02,House,"House Floor: HB 1058 PN 1728, FINAL PASSAGE",188,15,0,0,203
2014813,1583136,2025-06-02,House,"House Appropriations: Re-report Bill As Committed",37,0,0,0,37
2014813,1595021,2025-06-25,Senate,"Senate Aging And Youth: Reported as Amended",11,0,0,0,11
2014813,1595022,2025-06-25,Senate,"Senate Aging And Youth: Adopt Amendment A01273",11,0,0,0,11
2014813,1595338,2025-06-26,Senate,"Senate Appropriations: Re-Reported as Committed",22,0,0,0,22
2014813,1596584,2025-06-30,Senate,"Senate Floor: HB 1058 PN 2025, Final Passage",49,1,0,0,50
2014813,1597068,2025-07-01,House,"House Floor: HB 1058 PN 2025, CONCURRENCE",201,1,0,1,203
2014813,1597069,2025-07-01,House,"House Rules: Re-report Bill As Committed",33,0,0,0,33
2014944,1539299,2025-04-08,House,"House Commerce: Report Bill As Committed",26,0,0,0,26
2014944,1566221,2025-05-06,House,"House Floor: HB 1057 PN 1148, FINAL PASSAGE",203,0,0,0,203
2014944,1566222,2025-05-06,House,"House Appropriations: Re-report Bill As Committed",37,0,0,0,37
2014944,1594258,2025-06-24,Senate,"Senate Consumer Protection And Professional Licensure: Reported as Amended A01042",14,0,0,0,14
2014944,1594259,2025-06-24,Senate,"Senate Consumer Protection And Professional Licensure: Adopt Amendment A01042",14,0,0,0,14
2014944,1594872,2025-06-25,Senate,"Senate Appropriations: Re-Reported as Committed",22,0,0,0,22
2015009,1539362,2025-04-08,House,"House Housing And Community Development: Report Bill As Committed",23,3,0,0,26
2015009,1567442,2025-05-07,House,"House Floor: HB 1062 PN 1157, 2025 A593",203,0,0,0,203
2015009,1569395,2025-05-12,House,"House Appropriations: Re-report Bill As Committed",37,0,0,0,37
2015009,1569645,2025-05-12,House,"House Floor: HB 1062 PN 1657, FINAL PASSAGE",125,78,0,0,203
2015009,1569646,2025-05-12,House,"House Appropriations: Re-report Bill As Committed",37,0,0,0,37
2015035,1566203,2025-05-06,House,"House Commerce: Adopt Amendment A00452",14,12,0,0,26
2015035,1566204,2025-05-06,House,"House Commerce: Report Bill As Amended",14,12,0,0,26
2015035,1566205,2025-05-06,House,"House Commerce: Adopt Amendment A00536",26,0,0,0,26
2015056,1532099,2025-04-01,Senate,"Senate Judiciary: Reported as Committed",13,1,0,0,14
2015056,1594903,2025-06-25,Senate,"Senate Appropriations: Adopt Amendment A01214",22,0,0,0,22
2015056,1594904,2025-06-25,Senate,"Senate Appropriations: Re-Reported as Amended",17,5,0,0,22
2015056,1595481,2025-06-26,Senate,"Senate Floor: SB 520 PN 1010, Final Passage",50,0,0,0,50
2015056,1598008,2025-07-09,House,"House Judiciary: Report Bill As Committed",22,4,0,0,26
2015214,1540203,2025-04-08,House,"House Children And Youth: Report Bill As Committed",15,11,0,0,26
2015214,1542190,2025-04-09,House,"House Floor: HR 149 PN 1179",163,40,0,0,203
2015228,1587522,2025-06-10,Senate,"Senate Finance: Reported as Committed",8,3,0,0,11
2015228,1593880,2025-06-23,Senate,"Senate Appropriations: Re-Reported as Committed",13,9,0,0,22
2015228,1593995,2025-06-23,Senate,"Senate Floor: SB 527 PN 500, 2025 A1248, Motion to table HAYWOOD Amendment No. A-1248",27,23,0,0,50
2015228,1593996,2025-06-23,Senate,"Senate Floor: SB 527 PN 500, 2025 A1248, Final Passage",29,21,0,0,50
2015246,1541564,2025-04-09,House,"House Health: Report Bill As Committed",25,1,0,0,26
2015246,1570117,2025-05-12,House,"House Floor: HR 151 PN 1181",178,25,0,0,203
2015344,1542606,2025-04-09,House,"House Finance: Report Bill As Committed",26,0,0,0,26
2015393,1587231,2025-06-10,House,"House Human Services: Report Bill As Committed",25,1,0,0,26
2015393,1594749,2025-06-25,House,"House Rules: Re-report Bill As Committed",33,0,0,0,33
2015393,1594883,2025-06-25,House,"House Floor: HB 1100 PN 1176, 2025 A1171, MOTION TO TABLE",102,101,0,0,203
2015393,1594884,2025-06-25,House,"House Floor: HB 1100 PN 1176, 2025 A1174, MOTION TO TABLE",102,101,0,0,203
2015393,1594885,2025-06-25,House,"House Floor: HB 1100 PN 1176, 2025 A1175, MOTION TO TABLE",102,101,0,0,203
2015393,1594886,2025-06-25,House,"House Floor: HB 1100 PN 1176, 2025 A1211, MOTION TO TABLE",102,101,0,0,203
2015393,1594887,2025-06-25,House,"House Floor: HB 1100 PN 1176, 2025 A1215, MOTION TO TABLE",102,101,0,0,203
2015393,1594888,2025-06-25,House,"House Floor: HB 1100 PN 1176, 2025 A1216, MOTION TO TABLE",102,101,0,0,203
2015393,1595064,2025-06-25,House,"House Appropriations: Re-report Bill As Committed",22,15,0,0,37
2015393,1595333,2025-06-26,House,"House Floor: HB 1100 PN 1176, FINAL PASSAGE",138,64,0,1,203
2015743,1542257,2025-04-09,House,"House Health: Report Bill As Committed",26,0,0,0,26
2015782,1542164,2025-04-09,House,"House Health: Report Bill As Committed",26,0,0,0,26
2015911,1541473,2025-04-09,House,"House Health: Report Bill As Committed",26,0,0,0,26
2015911,1557095,2025-04-24,House,"House Floor: HR 155 PN 1184",200,3,0,0,203
2016240,1541984,2025-04-09,House,"House Health: Report Bill As Committed",26,0,0,0,26
2016240,1555863,2025-04-23,House,"House Floor: HR 159 PN 1215",201,2,0,0,203
2016341,1570276,2025-05-13,House,"House State Government: Report Bill As Committed",26,0,0,0,26
2016341,1587619,2025-06-10,House,"House Floor: HB 1084 PN 1202, 2025 A989",186,17,0,0,203
2016341,1588713,2025-06-11,House,"House Appropriations: Re-report Bill As Committed",37,0,0,0,37
2016341,1590969,2025-06-16,House,"House Floor: HB 1084 PN 1883, FINAL PASSAGE",203,0,0,0,203
2016523,1533357,2025-04-01,Senate,"Senate Veterans Affairs And Emergency Preparedness: Reported as Committed",11,0,0,0,11
2016549,1555129,2025-04-23,House,"House Tourism, Recreation And Economic Development: Report Bill As Committed",18,8,0,0,26
2016549,1571303,2025-05-14,House,"House Floor: HR 161 PN 1217",198,5,0,0,203
2016835,1566898,2025-05-07,House,"House Insurance: Report Bill As Committed",14,12,0,0,26
2016835,1587838,2025-06-10,House,"House Floor: HB 1088 PN 1205, FINAL PASSAGE",143,60,0,0,203
2016835,1587839,2025-06-10,House,"House Appropriations: Re-report Bill As Committed",37,0,0,0,37
2016930,1538092,2025-04-07,House,"House Environmental And Natural Resource Protection: Report Bill As Committed",14,12,0,0,26
2016930,1584565,2025-06-04,House,"House Appropriations: Re-report Bill As Committed",22,15,0,0,37
2016930,1584783,2025-06-04,House,"House Floor: HB 1089 PN 1206, FINAL PASSAGE",102,100,0,1,203
2016995,1538155,2025-04-07,House,"House Transportation: Report Bill As Committed",26,0,0,0,26
2017065,1569675,2025-05-12,House,"House Intergovernmental Affairs And Operations: Report Bill As Committed",24,2,0,0,26
2017065,1584505,2025-06-03,House,"House Floor: HR 166 PN 1222",203,0,0,0,203
2017130,1542641,2025-04-09,House,"House Health: Report Bill As Committed",26,0,0,0,26
2017130,1583931,2025-06-03,House,"House Floor: HR 164 PN 1220",202,1,0,0,203
2017162,1541329,2025-04-09,House,"House Health: Report Bill As Committed",26,0,0,0,26
2017231,1591365,2025-06-17,House,"House Judiciary: Report Bill As Committed",26,0,0,0,26
2017265,1593857,2025-06-23,House,"House Tourism, Recreation And Economic Development: Report Bill As Committed",26,0,0,0,26
2017302,1594113,2025-06-24,House,"House Transportation: Report Bill As Committed",16,10,0,0,26
2017302,1597634,2025-07-07,House,"House Floor: HB 1093 PN 1210, 2025 A1345",182,21,0,0,203
2017302,1597635,2025-07-07,House,"House Rules: Re-report Bill As Committed",18,15,0,0,33
2017302,1597787,2025-07-08,House,"House Floor: HB 1093 PN 2090, FINAL PASSAGE",151,52,0,0,203
2017302,1597788,2025-07-08,House,"House Appropriations: Re-report Bill As Committed",37,0,0,0,37
2017335,1564963,2025-05-05,House,"House Housing And Community Development: Report Bill As Committed",23,3,0,0,26
2017335,1591628,2025-06-17,House,"House Floor: HB 1095 PN 1190, 2025 A1010",200,3,0,0,203
2017335,1591629,2025-06-17,House,"House Floor: HB 1095 PN 1190, 2025 A1126",101,102,0,0,203
2017335,1591630,2025-06-17,House,"House Floor: HB 1095 PN 1190, 2025 A1127",101,102,0,0,203
2017335,1591631,2025-06-17,House,"House Floor: HB 1095 PN 1190, 2025 A1157, MOTION TO TABLE",102,101,0,0,203
2017335,1591632,2025-06-17,House,"House Floor: HB 1095 PN 1190, 2025 A1158, MOTION TO TABLE",102,101,0,0,203
2017335,1593910,2025-06-23,House,"House Floor: HB 1095 PN 1948, FINAL PASSAGE",105,98,0,0,203
2017335,1593911,2025-06-23,House,"House Appropriations: Re-report Bill As Committed",35,2,0,0,37
2017371,1555073,2025-04-23,House,"House Agriculture And Rural Affairs: Report Bill As Committed",23,3,0,0,26
2017371,1583109,2025-06-02,House,"House Floor: HB 1096 PN 1191, 2025 A662, MOTION TO TABLE",102,101,0,0,203
2017371,1583749,2025-06-03,House,"House Appropriations: Re-report Bill As Committed",22,15,0,0,37
2017371,1583985,2025-06-03,House,"House Floor: HB 1096 PN 1191, FINAL PASSAGE",164,39,0,0,203
2017509,1565004,2025-05-05,House,"House Judiciary: Report Bill As Amended",26,0,0,0,26
2017509,1565005,2025-05-05,House,"House Judiciary: Adopt Amendment A00409",26,0,0,0,26
2017741,1540049,2025-04-08,House,"House Veterans Affairs And Emergency Preparedness: Report Bill As Committed",26,0,0,0,26
2017741,1556490,2025-04-24,House,"House Floor: HB 1102 PN 1214, 2025 A404",203,0,0,0,203
2017741,1564879,2025-05-05,House,"House Floor: HB 1102 PN 1489, FINAL PASSAGE",203,0,0,0,203
2017741,1564880,2025-05-05,House,"House Appropriations: Re-report Bill As Committed",37,0,0,0,37
2017811,1542638,2025-04-09,House,"House Health: Report Bill As Committed",26,0,0,0,26
2017886,1555161,2025-04-23,House,"House Environmental And Natural Resource Protection: Bring Up The Bill For Consideration",26,0,0,0,26
2017886,1555162,2025-04-23,House,"House Environmental And Natural Resource Protection: Report Bill As Committed",26,0,0,0,26
2017886,1567567,2025-05-07,House,"House Floor: HR 167 PN 1223",198,5,0,0,203
2018173,1540524,2025-04-08,House,"House State Government: Adopt Resolution",23,3,0,0,26
2018173,1556635,2025-04-24,House,"House Floor: HR 171 PN 1230",203,0,0,0,203
2018245,1541404,2025-04-09,House,"House Health: Re-refer Bill To Another Committee",26,0,0,0,26
2018310,1539308,2025-04-08,House,"House Commerce: Report Bill As Committed",26,0,0,0,26
2018310,1567409,2025-05-07,House,"House Floor: HB 1103 PN 1224, 2025 A482",203,0,0,0,203
2018310,1569434,2025-05-12,House,"House Floor: HB 1103 PN 1658, FINAL PASSAGE",203,0,0,0,203
2018310,1569435,2025-05-12,House,"House Appropriations: Re-report Bill As Committed",37,0,0,0,37
2018310,1569436,2025-05-12,House,"House Appropriations: Re-report Bill As Committed",37,0,0,0,37
2018310,1594125,2025-06-24,Senate,"Senate Banking And Insurance: Reported as Committed",14,0,0,0,14
2018310,1594858,2025-06-25,Senate,"Senate Appropriations: Re-Reported as Committed",22,0,0,0,22
2018310,1595424,2025-06-26,Senate,"Senate Floor: HB 1103 PN 1658, Final Passage",50,0,0,0,50
2018375,1583038,2025-06-02,House,"House Education: Report Bill As Committed",26,0,0,0,26
2018604,1554997,2025-04-23,House,"House Tourism, Recreation And Economic Development: Report Bill As Committed",25,1,0,0,26
2018604,1564854,2025-05-05,House,"House Floor: HR 172 PN 1244",199,4,0,0,203
2018872,1591371,2025-06-17,House,"House Human Services: Adopt Amendment A01167",26,0,0,0,26
2018872,1591372,2025-06-17,House,"House Human Services: Report Bill As Amended",26,0,0,0,26
2018872,1598190,2025-07-14,House,"House Rules: Re-report Bill As Committed",33,0,0,0,33
2018898,1541411,2025-04-09,House,"House Health: Report Bill As Committed",26,0,0,0,26
2018990,1539279,2025-04-08,House,"House Human Services: Adopt Amendment A00307",26,0,0,0,26
2018990,1539280,2025-04-08,House,"House Human Services: Adopt Amendment A00305",26,0,0,0,26
2018990,1539281,2025-04-08,House,"House Human Services: Report Bill As Amended",26,0,0,0,26
2018990,1565670,2025-05-06,House,"House Floor: HB 1117 PN 1298, FINAL PASSAGE",201,2,0,0,203
2018990,1565671,2025-05-06,House,"House Appropriations: Re-report Bill As Committed",37,0,0,0,37
2019007,1571125,2025-05-14,House,"House Local Government: Report Bill As Committed",14,12,0,0,26
2019098,1594180,2025-06-24,Senate,"Senate Game And Fisheries: Reported as Committed",11,0,0,0,11
2019098,1601218,2025-09-08,Senate,"Senate Floor: SB 533 PN 519, Final Passage",46,0,0,4,50
2019098,1601219,2025-09-08,Senate,"Senate Appropriations: Re-Reported as Committed",19,0,3,0,22
2019223,1588868,2025-06-11,House,"House Local Government: Re-refer Bill To Another Committee",26,0,0,0,26
2019241,1588675,2025-06-11,Senate,"Senate Consumer Protection And Professional Licensure: Reported as Committed",13,0,1,0,14
2019288,1555620,2025-04-23,House,"House Tourism, Recreation And Economic Development: Report Bill As Committed",25,1,0,0,26
2019288,1571237,2025-05-14,House,"House Floor: HR 175 PN 1247",200,3,0,0,203
2019334,1589260,2025-06-11,Senate,"Senate Consumer Protection And Professional Licensure: Reported as Committed",13,0,1,0,14
2019626,1542531,2025-04-09,House,"House Finance: Adopt Amendment",26,0,0,0,26
2019626,1542532,2025-04-09,House,"House Finance: Report Bill As Amended",26,0,0,0,26
2019626,1571506,2025-05-14,House,"House Floor: HB 1072 PN 1327, 2025 A718",101,102,0,0,203
2019626,1583262,2025-06-02,House,"House Floor: HB 1072 PN 1327, FINAL PASSAGE",203,0,0,0,203
2019626,1583263,2025-06-02,House,"House Appropriations: Re-report Bill As Committed",37,0,0,0,37
2019658,1555064,2025-04-23,House,"House Tourism, Recreation And Economic Development: Report Bill As Committed",25,1,0,0,26
2019658,1569405,2025-05-12,House,"House Floor: HR 178 PN 1264",201,2,0,0,203
2019694,1539887,2025-04-08,House,"House Veterans Affairs And Emergency Preparedness: Report Bill As Committed",26,0,0,0,26
2019835,1555224,2025-04-23,House,"House Environmental And Natural Resource Protection: Bring Up The Bill For Consideration",26,0,0,0,26
2019835,1555225,2025-04-23,House,"House Environmental And Natural Resource Protection: Report Bill As Committed",26,0,0,0,26
2019927,1597093,2025-07-01,House,"House Finance: Adopt Amendment A01437",26,0,0,0,26
2019927,1597094,2025-07-01,House,"House Finance: Report Bill As Amended",24,2,0,0,26
2019976,1558939,2025-04-23,House,"House Floor: UNCONTESTED CALENDAR",203,0,0,0,203
2020034,1569545,2025-05-12,Senate,"Senate Appropriations: Reported as Committed",22,0,0,0,22
2020034,1599282,2025-08-12,Senate,"Senate Appropriations: Motion to Table Amendment A01634 to SB 160 A01634",14,8,0,0,22
2020034,1599283,2025-08-12,Senate,"Senate Appropriations: Re-Reported as Committed",14,8,0,0,22
2020034,1599326,2025-08-12,Senate,"Senate Floor: SB 160 PN 529, Final Passage",27,22,0,1,50
2020034,1599335,2025-08-13,House,"House Appropriations: Report Bill As Committed",15,22,0,0,37
2020034,1601698,2025-09-10,House,"House Appropriations: Report Bill As Committed",37,0,0,0,37
2020040,1569996,2025-05-12,Senate,"Senate Appropriations: Reported as Committed",22,0,0,0,22
2020049,1570161,2025-05-12,Senate,"Senate Appropriations: Reported as Committed",22,0,0,0,22
2020072,1569410,2025-05-12,Senate,"Senate Appropriations: Reported as Committed",22,0,0,0,22
2020080,1569411,2025-05-12,Senate,"Senate Appropriations: Reported as Committed",22,0,0,0,22
2020086,1569994,2025-05-12,Senate,"Senate Appropriations: Reported as Committed",22,0,0,0,22
2020099,1569415,2025-05-12,Senate,"Senate Appropriations: Reported as Committed",22,0,0,0,22
2020112,1569993,2025-05-12,Senate,"Senate Appropriations: Reported as Committed",22,0,0,0,22
2020120,1569992,2025-05-12,Senate,"Senate Appropriations: Reported as Committed",22,0,0,0,22
2020129,1569987,2025-05-12,Senate,"Senate Appropriations: Reported as Committed",22,0,0,0,22
2020134,1569995,2025-05-12,Senate,"Senate Appropriations: Reported as Committed",22,0,0,0,22
2020144,1569991,2025-05-12,Senate,"Senate Appropriations: Reported as Committed",22,0,0,0,22
2020150,1569989,2025-05-12,Senate,"Senate Appropriations: Reported as Committed",22,0,0,0,22
2020156,1569990,2025-05-12,Senate,"Senate Appropriations: Reported as Committed",22,0,0,0,22
2020221,1539378,2025-04-08,House,"House Veterans Affairs And Emergency Preparedness: Adopt Amendment A00319",26,0,0,0,26
2020221,1539379,2025-04-08,House,"House Veterans Affairs And Emergency Preparedness: Report Bill As Amended",26,0,0,0,26
2020221,1567313,2025-05-07,House,"House Floor: HB 1144 PN 1301, 2025 A609, MOTION TO SUSPEND RULES",202,1,0,0,203
2020221,1567314,2025-05-07,House,"House Floor: HB 1144 PN 1301, 2025 A609",203,0,0,0,203
2020221,1569948,2025-05-12,House,"House Floor: HB 1144 PN 1659, FINAL PASSAGE",203,0,0,0,203
2020221,1569949,2025-05-12,House,"House Appropriations: Re-report Bill As Committed",37,0,0,0,37
2020296,1591461,2025-06-17,House,"House Judiciary: Report Bill As Committed",14,12,0,0,26
2020517,1540750,2025-04-08,House,"House Veterans Affairs And Emergency Preparedness: Report Bill As Committed",26,0,0,0,26
2020517,1542780,2025-04-09,House,"House Floor: HR 180 PN 1274",199,4,0,0,203
2020701,1539884,2025-04-08,House,"House Children And Youth: Report Bill As Committed",16,10,0,0,26
2020701,1543017,2025-04-09,House,"House Floor: HR 181 PN 1275",175,28,0,0,203
2020957,1555068,2025-04-23,House,"House Agriculture And Rural Affairs: Report Bill As Committed",23,3,0,0,26
2020995,1543041,2025-04-09,House,"House Health: Report Bill As Committed",26,0,0,0,26
2020995,1595265,2025-06-25,House,"House Floor: HR 182 PN 1280",199,4,0,0,203
2021025,1587437,2025-06-10,House,"House Children And Youth: Adopt Amendment A01015",25,0,1,0,26
2021025,1587438,2025-06-10,House,"House Children And Youth: Report Bill As Amended A01015",18,7,1,0,26
2021025,1590943,2025-06-16,House,"House Floor: HB 350 PN 1880, 2025 A1063",182,21,0,0,203
2021025,1590944,2025-06-16,House,"House Floor: HB 350 PN 1880, 2025 A1075, MOTION TO TABLE",102,101,0,0,203
2021025,1590945,2025-06-16,House,"House Floor: HB 350 PN 1880, 2025 A1076, MOTION TO TABLE",102,101,0,0,203
2021025,1590946,2025-06-16,House,"House Floor: HB 350 PN 1880, 2025 A1077, MOTION TO TABLE",102,101,0,0,203
2021025,1590947,2025-06-16,House,"House Rules: Re-report Bill As Committed",18,15,0,0,33
2021025,1591638,2025-06-17,House,"House Appropriations: Re-report Bill As Committed",22,15,0,0,37
2021025,1593902,2025-06-23,House,"House Floor: HB 350 PN 1937, FINAL PASSAGE",112,91,0,0,203
2021266,1570247,2025-05-13,House,"House Liquor Control: Report Bill As Committed",26,0,0,0,26
2021359,1596914,2025-06-30,House,"House Finance: Re-refer Bill To Another Committee",26,0,0,0,26
2021359,1598013,2025-07-09,House,"House Judiciary: Report Bill As Committed",26,0,0,0,26
2022160,1586624,2025-06-09,Senate,"Senate Labor And Industry: Reported as Committed",11,0,0,0,11
2022160,1601207,2025-09-08,Senate,"Senate Appropriations: Re-Reported as Committed",17,2,3,0,22
2022182,1583736,2025-06-03,Senate,"Senate Consumer Protection And Professional Licensure: Reported as Committed",14,0,0,0,14
2022182,1594338,2025-06-24,Senate,"Senate Appropriations: Re-Reported as Committed",22,0,0,0,22
2022196,1567005,2025-05-07,House,"House Finance: Report Bill As Committed",26,0,0,0,26
2022196,1586549,2025-06-09,House,"House Appropriations: Adopt Amendment A00982",22,15,0,0,37
2022196,1586550,2025-06-09,House,"House Appropriations: Re-report Bill As Amended",22,15,0,0,37
2022196,1587567,2025-06-10,House,"House Floor: HB 1189 PN 1870, FINAL PASSAGE",102,101,0,0,203
2022196,1594206,2025-06-24,Senate,"Senate Finance: Reported as Amended",10,1,0,0,11
2022196,1594207,2025-06-24,Senate,"Senate Finance: Motion to Revert to Prior Printer's Number",7,4,0,0,11
2022239,1567718,2025-05-07,House,"House Local Government: Report Bill As Committed",26,0,0,0,26
2022269,1583774,2025-06-03,Senate,"Senate Consumer Protection And Professional Licensure: Reported as Committed",14,0,0,0,14
2022269,1598540,2025-07-16,Senate,"Senate Appropriations: Re-Reported as Committed",22,0,0,0,22
2022269,1598825,2025-07-17,Senate,"Senate Floor: SB 604 PN 612, Final Passage",45,5,0,0,50
2022690,1570975,2025-05-14,House,"House Local Government: Report Bill As Committed",26,0,0,0,26
2022743,1567020,2025-05-07,House,"House Health: Report Bill As Committed",26,0,0,0,26
2022837,1554700,2025-04-22,House,"House Transportation: Report Bill As Committed",26,0,0,0,26
2022837,1569392,2025-05-07,House,"House Floor: HR 187 PN 1372",198,5,0,0,203
2022880,1567707,2025-05-07,House,"House Local Government: Report Bill As Committed",26,0,0,0,26
2023372,1554986,2025-04-23,House,"House Environmental And Natural Resource Protection: Bring Up The Bill For Consideration",26,0,0,0,26
2023372,1554987,2025-04-23,House,"House Environmental And Natural Resource Protection: Report Bill As Committed",14,12,0,0,26
2023590,1591139,2025-06-16,House,"House Health: Report Bill As Amended",24,2,0,0,26
2023590,1591140,2025-06-16,House,"House Health: Adopt Amendment A01100",24,2,0,0,26
2023590,1597976,2025-07-09,House,"House Rules: Re-report Bill As Committed",33,0,0,0,33
2023590,1598319,2025-07-14,House,"House Appropriations: Re-report Bill As Committed",37,0,0,0,37
2023604,1565443,2025-05-06,House,"House Consumer Protection, Technology And Utilities: Report Bill As Committed",26,0,0,0,26
2023604,1591546,2025-06-17,House,"House Floor: HB 1216 PN 1364, 2025 A1059",199,4,0,0,203
2023604,1591547,2025-06-17,House,"House Floor: HB 1216 PN 1364, 2025 A1110",200,3,0,0,203
2023604,1593914,2025-06-23,House,"House Floor: HB 1216 PN 1949, FINAL PASSAGE",108,95,0,0,203
2023604,1593915,2025-06-23,House,"House Appropriations: Re-report Bill As Committed",37,0,0,0,37
2023714,1598012,2025-07-09,House,"House Judiciary: Report Bill As Committed",14,12,0,0,26
2023769,1569513,2025-05-12,Senate,"Senate Rules And Executive Nominations: Reported as Committed",17,0,0,0,17
2023769,1570391,2025-05-13,Senate,"Senate Floor: SR 82 PN 651",47,2,0,1,50
2023822,1583798,2025-06-03,Senate,"Senate Judiciary: Reported as Amended",9,4,1,0,14
2023822,1583799,2025-06-03,Senate,"Senate Judiciary: Adopt Amendment A00798",13,0,1,0,14
2023822,1594834,2025-06-25,Senate,"Senate Floor: SB 635 PN 1007, Final Passage",43,7,0,0,50
2023943,1564994,2025-05-05,House,"House Environmental And Natural Resource Protection: Report Bill As Committed",16,10,0,0,26
2023967,1564871,2025-05-05,House,"House Environmental And Natural Resource Protection: Report Bill As Committed",26,0,0,0,26
2023967,1585242,2025-06-04,House,"House Floor: HR 192 PN 1377",189,13,0,1,203
2023985,1571107,2025-05-14,House,"House Judiciary: Report Bill As Committed",15,11,0,0,26
2023985,1597060,2025-07-01,House,"House Floor: HB 150 PN 1386, 2025 A1144, MOTION TO APPEAL RULING OF THE CHAIR",102,100,0,1,203
2023985,1597061,2025-07-01,House,"House Floor: HB 150 PN 1386, 2025 A1429",202,0,0,1,203
2024021,1567012,2025-05-07,House,"House Health: Report Bill As Committed",26,0,0,0,26
2024087,1555477,2025-04-23,House,"House Children And Youth: Report Bill As Committed",26,0,0,0,26
2024153,1594752,2025-06-25,House,"House Energy: Adopt Amendment A01111",14,12,0,0,26
2024153,1594753,2025-06-25,House,"House Energy: Report Bill As Amended",14,12,0,0,26
2024310,1554974,2025-04-23,House,"House Housing And Community Development: Report Bill As Committed",15,11,0,0,26
2024310,1586613,2025-06-09,House,"House Floor: HB 1250 PN 1379, 2025 A420",99,103,0,1,203
2024310,1586614,2025-06-09,House,"House Floor: HB 1250 PN 1379, 2025 A422",100,102,0,1,203
2024310,1586615,2025-06-09,House,"House Floor: HB 1250 PN 1379, 2025 A491",92,110,0,1,203
2024310,1587280,2025-06-10,House,"House Appropriations: Re-report Bill As Committed",37,0,0,0,37
2024310,1587693,2025-06-10,House,"House Floor: HB 1250 PN 1379, FINAL PASSAGE",144,59,0,0,203
2024411,1555649,2025-04-23,House,"House Tourism, Recreation And Economic Development: Report Bill As Committed",25,1,0,0,26
2024411,1565187,2025-05-05,House,"House Floor: HR 197 PN 1380",192,11,0,0,203
2024445,1556383,2025-04-24,House,"House Veterans Affairs And Emergency Preparedness: Adopt Amendment A00359",15,11,0,0,26
2024445,1556384,2025-04-24,House,"House Veterans Affairs And Emergency Preparedness: Report Bill As Amended",26,0,0,0,26
2024445,1596530,2025-06-30,House,"House Floor: HB 1261 PN 1484, 2025 A1259",203,0,0,0,203
2024445,1597008,2025-07-01,House,"House Appropriations: Re-report Bill As Committed",37,0,0,0,37
2024445,1597088,2025-07-01,House,"House Floor: HB 1261 PN 2053, FINAL PASSAGE",202,0,0,1,203
2024474,1590935,2025-06-16,House,"House Veterans Affairs And Emergency Preparedness: Adopt Amendment A01082",26,0,0,0,26
2024474,1590936,2025-06-16,House,"House Veterans Affairs And Emergency Preparedness: Report Bill As Amended",26,0,0,0,26
2024603,1554668,2025-04-22,House,"House Transportation: Report Bill As Committed",26,0,0,0,26
2024603,1556408,2025-04-24,House,"House Floor: HR 196 PN 1413",199,4,0,0,203
2024803,1564941,2025-05-05,House,"House Appropriations: Report Bill As Committed",37,0,0,0,37
2024803,1565836,2025-05-06,House,"House Floor: HR 198 PN 1382",197,6,0,0,203
2024818,1565484,2025-05-06,House,"House Commerce: Report Bill As Amended",14,12,0,0,26
2024818,1565485,2025-05-06,House,"House Commerce: Adopt Amendment A00519",26,0,0,0,26
2024818,1569600,2025-05-12,House,"House Floor: HB 1263 PN 1623, 2025 A621",101,102,0,0,203
2024818,1569601,2025-05-12,House,"House Floor: HB 1263 PN 1623, 2025 A622",101,102,0,0,203
2024818,1570094,2025-05-13,House,"House Appropriations: Re-report Bill As Committed",22,15,0,0,37
2024818,1570505,2025-05-13,House,"House Floor: HB 1263 PN 1623, FINAL PASSAGE",102,101,0,0,203
2024854,1567597,2025-05-07,House,"House Health: Report Bill As Amended",26,0,0,0,26
2024854,1567598,2025-05-07,House,"House Health: Adopt Amendment A00488",26,0,0,0,26
2024943,1567013,2025-05-07,House,"House Health: Report Bill As Committed",26,0,0,0,26
2025187,1571150,2025-05-14,House,"House Health: Report Bill As Amended",26,0,0,0,26
2025187,1571151,2025-05-14,House,"House Health: Adopt Amendment A00684",26,0,0,0,26
2025187,1584554,2025-06-04,House,"House Appropriations: Re-report Bill As Committed",37,0,0,0,37
2025187,1584726,2025-06-04,House,"House Floor: HB 704 PN 1713, FINAL PASSAGE",197,5,0,1,203
2025434,1570959,2025-05-14,House,"House Local Government: Adopt Amendment A00711",25,1,0,0,26
2025434,1570960,2025-05-14,House,"House Local Government: Report Bill As Amended",25,1,0,0,26
2025434,1591481,2025-06-17,House,"House Appropriations: Re-report Bill As Committed",37,0,0,0,37
2025434,1593905,2025-06-23,House,"House Floor: HB 1282 PN 1715, FINAL PASSAGE",132,71,0,0,203
2025559,1567219,2025-05-07,House,"House Insurance: Report Bill As Committed",14,12,0,0,26
2025559,1583079,2025-06-02,House,"House Floor: HB 1140 PN 1449, 2025 A749",92,111,0,0,203
2025559,1583926,2025-06-03,House,"House Floor: HB 1140 PN 1449, FINAL PASSAGE",116,87,0,0,203
2025559,1583927,2025-06-03,House,"House Appropriations: Re-report Bill As Committed",23,14,0,0,37
2025572,1567579,2025-05-07,House,"House Local Government: Adopt Amendment A00509",12,14,0,0,26
2025572,1567580,2025-05-07,House,"House Local Government: Report Bill As Committed",16,10,0,0,26
2025585,1584627,2025-06-04,House,"House Veterans Affairs And Emergency Preparedness: Report Bill As Committed",26,0,0,0,26
2025585,1586949,2025-06-09,House,"House Floor: HR 206 PN 1465",202,0,0,1,203
2025602,1593867,2025-06-23,House,"House Tourism, Recreation And Economic Development: Report Bill As Committed",16,10,0,0,26
2025624,1555030,2025-04-23,House,"House Tourism, Recreation And Economic Development: Report Bill As Committed",16,10,0,0,26
2025624,1557191,2025-04-24,House,"House Floor: HR 204 PN 1459",203,0,0,0,203
2025963,1590949,2025-06-16,House,"House Health: Report Bill As Committed",22,4,0,0,26
2025963,1594748,2025-06-25,House,"House Rules: Re-report Bill As Committed",33,0,0,0,33
2025963,1596544,2025-06-30,House,"House Floor: HB 1234 PN 1468, 2025 A1182",203,0,0,0,203
2025963,1597017,2025-07-01,House,"House Floor: HB 1234 PN 2054, FINAL PASSAGE",147,55,0,1,203
2025963,1597018,2025-07-01,House,"House Appropriations: Re-report Bill As Committed",37,0,0,0,37
2026029,1587655,2025-06-10,House,"House Communications And Technology: Report Bill As Amended",26,0,0,0,26
2026029,1587656,2025-06-10,House,"House Communications And Technology: Adopt Amendment A00981",26,0,0,0,26
2026029,1594821,2025-06-25,House,"House Rules: Re-report Bill As Committed",33,0,0,0,33
2026029,1597631,2025-07-07,House,"House Floor: HB 1299 PN 1876, 2025 A1079",101,102,0,0,203
2026029,1597785,2025-07-08,House,"House Floor: HB 1299 PN 1876, FINAL PASSAGE",181,22,0,0,203
2026029,1597786,2025-07-08,House,"House Appropriations: Re-report Bill As Committed",37,0,0,0,37
2026163,1566988,2025-05-07,House,"House Finance: Adopt Amendment A00554",25,1,0,0,26
2026163,1566989,2025-05-07,House,"House Finance: Adopt Amendment A00555",26,0,0,0,26
2026163,1566990,2025-05-07,House,"House Finance: Adopt Amendment A00567",26,0,0,0,26
2026163,1566991,2025-05-07,House,"House Finance: Report Bill As Amended",14,12,0,0,26
2026163,1566992,2025-05-07,House,"House Finance: Adopt Amendment A00582",24,2,0,0,26
2026163,1570146,2025-05-13,House,"House Floor: HB 500 PN 1652, 2025 A691",203,0,0,0,203
2026163,1570147,2025-05-13,House,"House Floor: HB 500 PN 1652, 2025 A706",203,0,0,0,203
2026163,1570148,2025-05-13,House,"House Floor: HB 500 PN 1652, 2025 A708",102,101,0,0,203
2026163,1570149,2025-05-13,House,"House Floor: HB 500 PN 1652, 2025 A709",203,0,0,0,203
2026163,1570150,2025-05-13,House,"House Floor: HB 500 PN 1652, 2025 A636",101,102,0,0,203
2026163,1570685,2025-05-13,House,"House Floor: HB 500 PN 1652, 2025 A654",101,102,0,0,203
2026163,1570686,2025-05-13,House,"House Floor: HB 500 PN 1652, 2025 A680",101,102,0,0,203
2026163,1570687,2025-05-13,House,"House Floor: HB 500 PN 1652, 2025 A683",101,102,0,0,203
2026163,1570688,2025-05-13,House,"House Floor: HB 500 PN 1652, 2025 A693",101,102,0,0,203
2026163,1570689,2025-05-13,House,"House Floor: HB 500 PN 1652, 2025 A716",101,102,0,0,203
2026163,1571087,2025-05-14,House,"House Floor: HB 500 PN 1716, FINAL PASSAGE",108,95,0,0,203
2026163,1571088,2025-05-14,House,"House Appropriations: Re-report Bill As Amended",22,15,0,0,37
2026163,1571089,2025-05-14,House,"House Appropriations: Adopt Amendment A00741",22,15,0,0,37
2026185,1556904,2025-04-24,House,"House Consumer Protection, Technology And Utilities: Report Bill As Committed",22,4,0,0,26
2026185,1566049,2025-05-06,House,"House Floor: HB 504 PN 1481, 2025 A454",101,102,0,0,203
2026185,1566050,2025-05-06,House,"House Floor: HB 504 PN 1481, 2025 A470, MOTION TO TABLE",102,101,0,0,203
2026185,1566051,2025-05-06,House,"House Floor: HB 504 PN 1481, 2025 A473",101,102,0,0,203
2026185,1566052,2025-05-06,House,"House Floor: HB 504 PN 1481, 2025 A474",101,102,0,0,203
2026185,1566053,2025-05-06,House,"House Floor: HB 504 PN 1481, 2025 A476",101,102,0,0,203
2026185,1566054,2025-05-06,House,"House Floor: HB 504 PN 1481, 2025 A481",101,102,0,0,203
2026185,1566055,2025-05-06,House,"House Floor: HB 504 PN 1481, 2025 A485",101,102,0,0,203
2026185,1566056,2025-05-06,House,"House Floor: HB 504 PN 1481, 2025 A489",101,102,0,0,203
2026185,1566057,2025-05-06,House,"House Floor: HB 504 PN 1481, 2025 A511",166,37,0,0,203
2026185,1566058,2025-05-06,House,"House Floor: HB 504 PN 1481, 2025 A542",102,101,0,0,203
2026185,1567516,2025-05-07,House,"House Floor: HB 504 PN 1628, FINAL PASSAGE",114,89,0,0,203
2026185,1567517,2025-05-07,House,"House Appropriations: Re-report Bill As Committed",22,15,0,0,37
2026232,1583035,2025-06-02,House,"House Environmental And Natural Resource Protection: Adopt Amendment A00794",12,14,0,0,26
2026232,1583036,2025-06-02,House,"House Environmental And Natural Resource Protection: Report Bill As Committed",14,12,0,0,26
2026255,1588885,2025-06-11,House,"House Local Government: Adopt Amendment A01021",26,0,0,0,26
2026255,1588886,2025-06-11,House,"House Local Government: Report Bill As Amended",18,8,0,0,26
2026261,1569352,2025-05-12,House,"House Aging And Older Adult Services: Report Bill As Committed",26,0,0,0,26
2026261,1571489,2025-05-14,House,"House Floor: HR 209 PN 1521",200,3,0,0,203
2026269,1571204,2025-05-14,House,"House Finance: Adopt Amendment A00738",26,0,0,0,26
2026269,1571205,2025-05-14,House,"House Finance: Report Bill As Amended",26,0,0,0,26
2026269,1591023,2025-06-16,House,"House Appropriations: Re-report Bill As Committed",37,0,0,0,37
2026269,1593952,2025-06-23,House,"House Floor: HB 1306 PN 1714, FINAL PASSAGE",203,0,0,0,203
2026303,1570966,2025-05-14,House,"House Local Government: Report Bill As Committed",26,0,0,0,26
2026303,1593897,2025-06-23,House,"House Floor: HB 1318 PN 1511, 2025 A1101",95,108,0,0,203
2026303,1594140,2025-06-24,House,"House Appropriations: Re-report Bill As Committed",37,0,0,0,37
2026303,1594405,2025-06-24,House,"House Floor: HB 1318 PN 1511, FINAL PASSAGE",185,18,0,0,203
2026363,1567811,2025-05-07,House,"House Education: Adopt Amendment A00544",26,0,0,0,26
2026363,1567812,2025-05-07,House,"House Education: Report Bill As Amended",26,0,0,0,26
2026363,1587597,2025-06-10,House,"House Floor: HB 1326 PN 1647, FINAL PASSAGE",201,2,0,0,203
2026363,1587598,2025-06-10,House,"House Appropriations: Re-report Bill As Committed",37,0,0,0,37
2026385,1591735,2025-06-17,House,"House Judiciary: Report Bill As Committed",25,1,0,0,26
2026385,1597020,2025-07-01,House,"House Rules: Re-report Bill As Committed",33,0,0,0,33
2026385,1597627,2025-07-07,House,"House Appropriations: Re-report Bill As Committed",37,0,0,0,37
2026385,1597643,2025-07-07,House,"House Floor: HB 1319 PN 1490, FINAL PASSAGE",116,87,0,0,203
2026555,1567830,2025-05-07,House,"House Local Government: Report Bill As Committed",25,1,0,0,26
2026555,1570839,2025-05-13,House,"House Floor: HR 212 PN 1524",200,3,0,0,203
2026661,1564961,2025-05-05,House,"House Judiciary: Report Bill As Committed",26,0,0,0,26
2026775,1583061,2025-06-02,House,"House Judiciary: Report Bill As Committed",26,0,0,0,26
2026789,1583820,2025-06-03,House,"House Tourism, Recreation And Economic Development: Re-refer Bill To Another Committee",26,0,0,0,26
2026789,1595443,2025-06-26,House,"House Veterans Affairs And Emergency Preparedness: Adopt Amendment A01336",26,0,0,0,26
2026789,1595444,2025-06-26,House,"House Veterans Affairs And Emergency Preparedness: Report Bill As Amended",26,0,0,0,26
2026801,1565724,2025-05-06,House,"House Commerce: Re-refer Bill To Another Committee",26,0,0,0,26
2026810,1565596,2025-05-06,Senate,"Senate Law And Justice: Reported as Committed",11,0,0,0,11
2026810,1569743,2025-05-12,Senate,"Senate Floor: SR 94 PN 702",50,0,0,0,50
2026813,1583821,2025-06-03,House,"House Tourism, Recreation And Economic Development: Report Bill As Committed",26,0,0,0,26
2026813,1594112,2025-06-23,House,"House Rules: Re-report Bill As Committed",33,0,0,0,33
2026813,1594129,2025-06-24,House,"House Appropriations: Re-report Bill As Committed",37,0,0,0,37
2026813,1594711,2025-06-24,House,"House Floor: HB 1347 PN 1535, FINAL PASSAGE",149,54,0,0,203
2026824,1567436,2025-05-07,Senate,"Senate Community, Economic And Recreational Development: Reported as Committed",9,5,0,0,14
2026830,1565697,2025-05-06,Senate,"Senate Agriculture And Rural Affairs: Reported as Committed",11,0,0,0,11
2026831,1566246,2025-05-06,Senate,"Senate Education: Reported as Committed",8,3,0,0,11
2026853,1565781,2025-05-06,Senate,"Senate State Government: Reported as Amended",8,3,0,0,11
2026853,1565782,2025-05-06,Senate,"Senate State Government: Adopt Amendment A00448",11,0,0,0,11
2026853,1584619,2025-06-04,Senate,"Senate Floor: SB 686 PN 755, Final Passage",31,18,0,1,50
2026859,1570484,2025-05-13,House,"House State Government: Report Bill As Committed",15,11,0,0,26
2026878,1595461,2025-06-26,Senate,"Senate Transportation: Reported as Committed",9,5,0,0,14
2026881,1566925,2025-05-07,Senate,"Senate Environmental Resources And Energy: Reported as Committed",7,4,0,0,11
2026881,1583059,2025-06-02,Senate,"Senate Appropriations: Reported as Committed",14,8,0,0,22
2026881,1583900,2025-06-03,Senate,"Senate Floor: SB 682 PN 671, Final Passage",27,22,0,1,50
2026899,1587381,2025-06-10,Senate,"Senate Community, Economic And Recreational Development: Reported as Committed",14,0,0,0,14
2027009,1591400,2025-06-17,House,"House Labor And Industry: Report Bill As Committed",14,12,0,0,26
2027009,1597001,2025-07-01,House,"House Rules: Re-report Bill As Committed",18,15,0,0,33
2027009,1597084,2025-07-01,House,"House Floor: HB 1358 PN 1546, 2025 A1410",202,0,0,1,203
2027009,1597085,2025-07-01,House,"House Floor: HB 1358 PN 1546, 2025 A1414",202,0,0,1,203
2027009,1597638,2025-07-07,House,"House Floor: HB 1358 PN 2067, FINAL PASSAGE",109,94,0,0,203
2027009,1597639,2025-07-07,House,"House Appropriations: Re-report Bill As Committed",22,15,0,0,37
2027055,1593858,2025-06-23,House,"House Environmental And Natural Resource Protection: Report Bill As Committed",26,0,0,0,26
2027103,1564852,2025-05-05,House,"House Appropriations: Report Bill As Committed",37,0,0,0,37
2027103,1567161,2025-05-07,House,"House Floor: HR 217 PN 1526",201,2,0,0,203
2027127,1583754,2025-06-03,Senate,"Senate Judiciary: Reported as Committed",13,0,1,0,14
2027127,1586783,2025-06-09,Senate,"Senate Floor: SB 649 PN 705, 2025 A963, PENNYCUICK Amendment No. A-0963",47,3,0,0,50
2027127,1587570,2025-06-10,Senate,"Senate Floor: SB 649 PN 920, Final Passage",50,0,0,0,50
2027127,1593861,2025-06-23,House,"House Judiciary: Report Bill As Committed",25,1,0,0,26
2027127,1595054,2025-06-25,House,"House Appropriations: Re-report Bill As Committed",37,0,0,0,37
2027127,1595332,2025-06-26,House,"House Floor: SB 649 PN 920, FINAL PASSAGE",199,3,0,1,203
2027154,1565965,2025-05-06,House,"House Commerce: Report Bill As Committed",26,0,0,0,26
2027154,1583912,2025-06-03,House,"House Floor: HB 1359 PN 1527, FINAL PASSAGE",194,9,0,0,203
2027154,1583913,2025-06-03,House,"House Appropriations: Re-report Bill As Committed",37,0,0,0,37
2027268,1596526,2025-06-30,House,"House Intergovernmental Affairs And Operations: Report Bill As Committed",25,1,0,0,26
2027268,1597809,2025-07-08,House,"House Floor: HR 219 PN 1555",200,3,0,0,203
2027402,1565018,2025-05-05,House,"House Transportation: Report Bill As Committed",16,10,0,0,26
2027402,1588780,2025-06-11,House,"House Floor: HB 1364 PN 1556, 2025 A468",101,102,0,0,203
2027402,1588781,2025-06-11,House,"House Floor: HB 1364 PN 1556, 2025 A1032",111,92,0,0,203
2027402,1588782,2025-06-11,House,"House Floor: HB 1364 PN 1556, 2025 A1038",94,109,0,0,203
2027402,1588783,2025-06-11,House,"House Floor: HB 1364 PN 1556, 2025 A1046",144,59,0,0,203
2027402,1590924,2025-06-16,House,"House Appropriations: Re-report Bill As Committed",22,15,0,0,37
2027402,1591460,2025-06-17,House,"House Floor: HB 1364 PN 1912, FINAL PASSAGE",107,96,0,0,203
2027433,1566254,2025-05-06,Senate,"Senate Education: Reported as Committed",10,1,0,0,11
2027572,1591009,2025-06-16,House,"House Agriculture And Rural Affairs: Report Bill As Committed",26,0,0,0,26
2027572,1593831,2025-06-17,House,"House Floor: HR 221 PN 1565",199,4,0,0,203
2028207,1588589,2025-06-11,Senate,"Senate Health And Human Services: Reported as Committed",12,0,1,0,13
2028207,1594861,2025-06-25,Senate,"Senate Floor: SB 715 PN 727, Final Passage",50,0,0,0,50
2028207,1594862,2025-06-25,Senate,"Senate Appropriations: Re-Reported as Committed",22,0,0,0,22
2028207,1597019,2025-07-01,House,"House Health: Report Bill As Committed",26,0,0,0,26
2028220,1567006,2025-05-07,House,"House Health: Report Bill As Committed",25,1,0,0,26
2028220,1570137,2025-05-13,House,"House Floor: HR 225 PN 1572",166,37,0,0,203
2028234,1567532,2025-05-07,Senate,"Senate Environmental Resources And Energy: Reported as Committed",7,4,0,0,11
2028302,1567065,2025-05-07,Senate,"Senate Environmental Resources And Energy: Reported as Committed",9,2,0,0,11
2028309,1567007,2025-05-07,House,"House Health: Report Bill As Committed",26,0,0,0,26
2028366,1564912,2025-05-05,House,"House Health: Report Bill As Committed",14,12,0,0,26
2028366,1564913,2025-05-05,House,"House Health: To Table",12,14,0,0,26
2028366,1566280,2025-05-06,House,"House Floor: HB 1200 PN 1578, 2025 A523",102,101,0,0,203
2028366,1566281,2025-05-06,House,"House Floor: HB 1200 PN 1578, 2025 A527",101,102,0,0,203
2028366,1566282,2025-05-06,House,"House Floor: HB 1200 PN 1578, SECOND CONSIDERATION",102,101,0,0,203
2028366,1567633,2025-05-07,House,"House Floor: HB 1200 PN 1641, CONSTITUTIONALITY",102,101,0,0,203
2028366,1567634,2025-05-07,House,"House Floor: HB 1200 PN 1641, FINAL PASSAGE",102,101,0,0,203
2028366,1567635,2025-05-07,House,"House Appropriations: Re-report Bill As Committed",22,15,0,0,37
2028366,1570130,2025-05-13,Senate,"Senate Law And Justice: Motion to Report Defeated",3,7,1,0,11
2028441,1583873,2025-06-03,House,"House Tourism, Recreation And Economic Development: Report Bill As Committed",26,0,0,0,26
2028441,1586463,2025-06-09,House,"House Floor: HR 227 PN 1592, MOTION TO SUSPEND RULES",202,0,0,1,203
2028441,1586464,2025-06-09,House,"House Floor: HR 227 PN 1592",201,1,0,1,203
2028445,1565847,2025-05-06,House,"House State Government: Report Bill As Committed",14,12,0,0,26
2028445,1569633,2025-05-12,House,"House Floor: HB 1396 PN 1584, 2025 A599",101,102,0,0,203
2028445,1569634,2025-05-12,House,"House Floor: HB 1396 PN 1584, 2025 A600",101,102,0,0,203
2028445,1569635,2025-05-12,House,"House Floor: HB 1396 PN 1584, 2025 A614",101,102,0,0,203
2028445,1569636,2025-05-12,House,"House Floor: HB 1396 PN 1584, 2025 A616",101,102,0,0,203
2028445,1569637,2025-05-12,House,"House Floor: HB 1396 PN 1584, 2025 A617",101,102,0,0,203
2028445,1569638,2025-05-12,House,"House Floor: HB 1396 PN 1584, 2025 A627",148,55,0,0,203
2028445,1569639,2025-05-12,House,"House Floor: HB 1396 PN 1584, 2025 A620",119,84,0,0,203
2028445,1570100,2025-05-13,House,"House Appropriations: Re-report Bill As Committed",22,15,0,0,37
2028445,1570575,2025-05-13,House,"House Floor: HB 1396 PN 1688, FINAL PASSAGE",102,101,0,0,203
2028453,1571227,2025-05-14,House,"House Health: Report Bill As Committed",26,0,0,0,26
2028465,1569361,2025-05-07,House,"House Floor: UNCONTESTED CALENDAR",203,0,0,0,203
2028474,1569386,2025-05-12,House,"House Education: Report Bill As Committed",26,0,0,0,26
2028474,1597983,2025-07-09,House,"House Floor: HB 1407 PN 1605, 2025 A1440",203,0,0,0,203
2028474,1598200,2025-07-14,House,"House Floor: HB 1407 PN 2106, FINAL PASSAGE",202,0,0,1,203
2028474,1598201,2025-07-14,House,"House Appropriations: Re-report Bill As Committed",37,0,0,0,37
2028490,1569686,2025-05-12,House,"House Education: Adopt Amendment A00660",26,0,0,0,26
2028490,1569687,2025-05-12,House,"House Education: Report Bill As Amended",26,0,0,0,26
2028490,1593886,2025-06-23,House,"House Appropriations: Re-report Bill As Committed",37,0,0,0,37
2028490,1594103,2025-06-23,House,"House Floor: HB 1403 PN 1685, FINAL PASSAGE",203,0,0,0,203
2028495,1569362,2025-05-12,House,"House Education: Report Bill As Committed",26,0,0,0,26
2028495,1591386,2025-06-17,House,"House Appropriations: Re-report Bill As Committed",37,0,0,0,37
2028495,1594010,2025-06-23,House,"House Floor: HB 1404 PN 1603, FINAL PASSAGE",203,0,0,0,203
2028502,1569402,2025-05-12,House,"House Education: Adopt Amendment A00661",16,10,0,0,26
2028502,1569403,2025-05-12,House,"House Education: Report Bill As Amended",17,9,0,0,26
2028509,1584573,2025-06-04,House,"House Housing And Community Development: Report Bill As Committed",26,0,0,0,26
2028509,1588467,2025-06-11,House,"House Rules: Re-report Bill As Committed",33,0,0,0,33
2028509,1593904,2025-06-23,House,"House Floor: HB 1406 PN 1609, 2025 A1173",203,0,0,0,203
2028509,1594165,2025-06-24,House,"House Appropriations: Re-report Bill As Committed",37,0,0,0,37
2028509,1594416,2025-06-24,House,"House Floor: HB 1406 PN 1980, FINAL PASSAGE",203,0,0,0,203
2028509,1601437,2025-09-09,Senate,"Senate Judiciary: Reported as Committed",13,0,1,0,14
2028524,1569662,2025-05-12,House,"House Education: Report Bill As Committed",26,0,0,0,26
2028524,1586523,2025-06-09,House,"House Appropriations: Re-report Bill As Committed",37,0,0,0,37
2028524,1586935,2025-06-09,House,"House Floor: HB 1405 PN 1604, FINAL PASSAGE",202,0,0,1,203
2028524,1594277,2025-06-24,Senate,"Senate Education: Reported as Committed",11,0,0,0,11
2028524,1595325,2025-06-26,Senate,"Senate Appropriations: Re-Reported as Committed",22,0,0,0,22
2028549,1597077,2025-07-01,House,"House Labor And Industry: Report Bill As Committed",25,1,0,0,26
2028557,1569538,2025-05-12,House,"House Education: Adopt Amendment A00658",15,11,0,0,26
2028557,1569539,2025-05-12,House,"House Education: Report Bill As Amended",26,0,0,0,26
2028557,1587612,2025-06-10,House,"House Floor: HB 1402 PN 1684, 2025 A1000",101,102,0,0,203
2028557,1587613,2025-06-10,House,"House Floor: HB 1402 PN 1684, 2025 A1001",203,0,0,0,203
2028557,1587614,2025-06-10,House,"House Floor: HB 1402 PN 1684, 2025 A1002",101,102,0,0,203
2028557,1588699,2025-06-11,House,"House Floor: HB 1402 PN 1884, FINAL PASSAGE",203,0,0,0,203
2028557,1588700,2025-06-11,House,"House Appropriations: Re-report Bill As Committed",37,0,0,0,37
2028616,1567838,2025-05-07,Senate,"Senate Aging And Youth: Reported as Committed",11,0,0,0,11
2028616,1569680,2025-05-12,Senate,"Senate Floor: SB 731 PN 749, Motion to consider bill on second consideration",49,0,0,1,50
2028616,1569681,2025-05-12,Senate,"Senate Appropriations: Re-Reported as Committed",22,0,0,0,22
2028616,1583807,2025-06-02,Senate,"Senate Floor: SB 731 PN 749, Final Passage",50,0,0,0,50
2028655,1583031,2025-06-02,House,"House Judiciary: Report Bill As Committed",25,1,0,0,26
2028655,1597074,2025-07-01,House,"House Floor: HB 1412 PN 1613, 2025 A1074",100,102,0,1,203
2028655,1597075,2025-07-01,House,"House Floor: HB 1412 PN 1613, 2025 A1326",102,100,0,1,203
2028655,1597640,2025-07-07,House,"House Floor: HB 1412 PN 2068, FINAL PASSAGE",102,101,0,0,203
2028655,1597641,2025-07-07,House,"House Appropriations: Re-report Bill As Committed",37,0,0,0,37
2028683,1584564,2025-06-04,House,"House Veterans Affairs And Emergency Preparedness: Re-refer Bill To Environmental and Natural Resource Protection Committee",26,0,0,0,26
2028852,1583737,2025-06-03,Senate,"Senate Consumer Protection And Professional Licensure: Reported as Amended",14,0,0,0,14
2028852,1583738,2025-06-03,Senate,"Senate Consumer Protection And Professional Licensure: Adopt Amendment A00760",14,0,0,0,14
2028852,1587523,2025-06-10,Senate,"Senate Appropriations: Re-Reported as Committed",22,0,0,0,22
2028852,1588614,2025-06-11,Senate,"Senate Floor: SB 719 PN 862, Final Passage",49,0,0,1,50
2028852,1594123,2025-06-24,House,"House Professional Licensure: Report Bill As Committed",26,0,0,0,26
2028852,1594946,2025-06-25,House,"House Appropriations: Re-report Bill As Committed",37,0,0,0,37
2028852,1595351,2025-06-26,House,"House Floor: SB 719 PN 862, FINAL PASSAGE",202,0,0,1,203
2028861,1567706,2025-05-07,House,"House Appropriations: Report Bill As Committed",37,0,0,0,37
2028861,1584714,2025-06-04,House,"House Floor: HB 1335 PN 1633, FINAL PASSAGE",168,34,0,1,203
2028861,1584715,2025-06-04,House,"House Appropriations: Re-report Bill As Committed",37,0,0,0,37
2028861,1593931,2025-06-23,Senate,"Senate Appropriations: Reported as Committed",22,0,0,0,22
2028861,1594926,2025-06-25,Senate,"Senate Floor: HB 1335 PN 1633, Final Passage",50,0,0,0,50
2028867,1567190,2025-05-07,House,"House Appropriations: Report Bill As Committed",37,0,0,0,37
2028867,1584650,2025-06-04,House,"House Floor: HB 1337 PN 1635, FINAL PASSAGE",157,45,0,1,203
2028867,1584651,2025-06-04,House,"House Appropriations: Re-report Bill As Committed",37,0,0,0,37
2028867,1593918,2025-06-23,Senate,"Senate Appropriations: Reported as Committed",22,0,0,0,22
2028867,1594925,2025-06-25,Senate,"Senate Floor: HB 1337 PN 1635, Final Passage",47,3,0,0,50
2028886,1567198,2025-05-07,House,"House Appropriations: Report Bill As Committed",37,0,0,0,37
2028886,1584720,2025-06-04,House,"House Floor: HB 1334 PN 1632, FINAL PASSAGE",160,42,0,1,203
2028886,1584721,2025-06-04,House,"House Appropriations: Re-report Bill As Committed",37,0,0,0,37
2028886,1593928,2025-06-23,Senate,"Senate Appropriations: Reported as Committed",22,0,0,0,22
2028886,1594916,2025-06-25,Senate,"Senate Floor: HB 1334 PN 1632, Final Passage",50,0,0,0,50
2028897,1591488,2025-06-17,House,"House Transportation: Report Bill As Committed",26,0,0,0,26
2028910,1567819,2025-05-07,House,"House Appropriations: Report Bill As Committed",37,0,0,0,37
2028910,1584625,2025-06-04,House,"House Floor: HB 1333 PN 1631, FINAL PASSAGE",155,47,0,1,203
2028910,1584626,2025-06-04,House,"House Appropriations: Re-report Bill As Committed",37,0,0,0,37
2028910,1593932,2025-06-23,Senate,"Senate Appropriations: Reported as Committed",22,0,0,0,22
2028910,1594929,2025-06-25,Senate,"Senate Floor: HB 1333 PN 1631, Final Passage",50,0,0,0,50
2028923,1570175,2025-05-13,House,"House State Government: Report Bill As Committed",23,3,0,0,26
2028934,1567199,2025-05-07,House,"House Appropriations: Report Bill As Committed",22,15,0,0,37
2028934,1583894,2025-06-03,House,"House Floor: HB 1340 PN 1638, 2025 A825",101,102,0,0,203
2028934,1584553,2025-06-04,House,"House Appropriations: Re-report Bill As Committed",22,15,0,0,37
2028934,1584985,2025-06-04,House,"House Floor: HB 1340 PN 1638, FINAL PASSAGE",102,100,0,1,203
2028934,1593925,2025-06-23,Senate,"Senate Appropriations: Reported as Amended",22,0,0,0,22
2028934,1593926,2025-06-23,Senate,"Senate Appropriations: Adopt Amendment A01137",22,0,0,0,22
2028934,1594927,2025-06-25,Senate,"Senate Floor: HB 1340 PN 1977, Final Passage",48,2,0,0,50
2028934,1594928,2025-06-25,House,"House Rules: Re-report Bill As Committed",33,0,0,0,33
2028934,1595340,2025-06-26,House,"House Floor: HB 1340 PN 1977, CONCURRENCE",178,24,0,1,203
2028941,1567803,2025-05-07,House,"House Appropriations: Report Bill As Committed",37,0,0,0,37
2028941,1584579,2025-06-04,House,"House Appropriations: Re-report Bill As Committed",37,0,0,0,37
2028941,1585259,2025-06-04,House,"House Floor: HB 1336 PN 1634, FINAL PASSAGE",157,45,0,1,203
2028941,1593955,2025-06-23,Senate,"Senate Appropriations: Reported as Committed",22,0,0,0,22
2028941,1594924,2025-06-25,Senate,"Senate Floor: HB 1336 PN 1634, Final Passage",48,2,0,0,50
2028954,1567936,2025-05-07,House,"House Appropriations: Report Bill As Committed",37,0,0,0,37
2028954,1583887,2025-06-03,House,"House Appropriations: Re-report Bill As Amended",37,0,0,0,37
2028954,1583888,2025-06-03,House,"House Appropriations: Adopt Amendment A00792",37,0,0,0,37
2028954,1586705,2025-06-09,House,"House Floor: HB 1339 PN 1869, FINAL PASSAGE",148,54,0,1,203
2028954,1586706,2025-06-09,House,"House Appropriations: Re-report Bill As Amended",37,0,0,0,37
2028954,1586707,2025-06-09,House,"House Appropriations: Adopt Amendment A00925",37,0,0,0,37
2028954,1593891,2025-06-23,Senate,"Senate Appropriations: Reported as Committed",22,0,0,0,22
2028954,1594917,2025-06-25,Senate,"Senate Floor: HB 1339 PN 1869, Final Passage",48,2,0,0,50
2028976,1591442,2025-06-17,House,"House Appropriations: Report Bill As Amended",37,0,0,0,37
2028976,1595730,2025-06-17,House,"House Appropriations: Adopt Amendment A01092",37,0,0,0,37
2028985,1567374,2025-05-07,House,"House Appropriations: Report Bill As Committed",37,0,0,0,37
2028985,1584481,2025-06-03,House,"House Appropriations: Adopt Amendment A00882",22,15,0,0,37
2028985,1584482,2025-06-03,House,"House Appropriations: Re-report Bill As Amended",22,15,0,0,37
2028985,1584634,2025-06-04,House,"House Floor: HB 1332 PN 1827, FINAL PASSAGE",184,18,0,1,203
2029011,1567681,2025-05-07,House,"House Appropriations: Report Bill As Committed",37,0,0,0,37
2029011,1584697,2025-06-04,House,"House Floor: HB 1338 PN 1636, FINAL PASSAGE",154,48,0,1,203
2029011,1584698,2025-06-04,House,"House Appropriations: Re-report Bill As Committed",37,0,0,0,37
2029011,1593913,2025-06-23,Senate,"Senate Appropriations: Reported as Committed",22,0,0,0,22
2029011,1595266,2025-06-25,Senate,"Senate Floor: HB 1338 PN 1636, Final Passage",48,2,0,0,50
2029011,1595267,2025-06-25,Senate,"Senate Floor: HB 1338 PN 1636, Final Passage - Reconsideration",49,1,0,0,50
2029090,1583690,2025-06-02,House,"House Appropriations: Report Bill As Committed",22,15,0,0,37
2029145,1583103,2025-06-02,House,"House Appropriations: Report Bill As Committed",37,0,0,0,37
2029145,1584712,2025-06-04,House,"House Floor: HB 1420 PN 1644, FINAL PASSAGE",157,45,0,1,203
2029145,1584713,2025-06-04,House,"House Appropriations: Re-report Bill As Committed",37,0,0,0,37
2029145,1593924,2025-06-23,Senate,"Senate Appropriations: Reported as Committed",22,0,0,0,22
2029145,1594911,2025-06-25,Senate,"Senate Floor: HB 1420 PN 1644, Final Passage",48,2,0,0,50
2029240,1593871,2025-06-23,House,"House Judiciary: Report Bill As Committed",26,0,0,0,26
2029353,1571099,2025-05-14,House,"House Judiciary: Report Bill As Committed",25,1,0,0,26
2029353,1591525,2025-06-17,House,"House Floor: HB 1425 PN 1660, 2025 A1148",199,4,0,0,203
2029353,1593919,2025-06-23,House,"House Floor: HB 1425 PN 1950, FINAL PASSAGE",180,23,0,0,203
2029353,1593920,2025-06-23,House,"House Appropriations: Re-report Bill As Committed",36,1,0,0,37
2029367,1593859,2025-06-23,House,"House Tourism, Recreation And Economic Development: Report Bill As Committed",26,0,0,0,26
2029367,1597626,2025-07-07,House,"House Rules: Re-report Bill As Committed",33,0,0,0,33
2029367,1597774,2025-07-08,House,"House Appropriations: Re-report Bill As Committed",37,0,0,0,37
2029367,1597792,2025-07-08,House,"House Floor: HB 1424 PN 1653, FINAL PASSAGE",203,0,0,0,203
2029399,1570560,2025-05-13,House,"House State Government: Report Bill As Committed",14,12,0,0,26
2029399,1586623,2025-06-09,House,"House Floor: HB 1428 PN 1663, 2025 A666",100,102,0,1,203
2029399,1587283,2025-06-10,House,"House Appropriations: Re-report Bill As Committed",22,15,0,0,37
2029399,1587694,2025-06-10,House,"House Floor: HB 1428 PN 1663, FINAL PASSAGE",143,60,0,0,203
2029424,1596984,2025-06-30,House,"House Judiciary: Report Bill As Committed",26,0,0,0,26
2029431,1570947,2025-05-13,House,"House Human Services: Report Bill As Committed",26,0,0,0,26
2029431,1586572,2025-06-09,House,"House Appropriations: Re-report Bill As Committed",37,0,0,0,37
2029431,1586805,2025-06-09,House,"House Floor: HB 1429 PN 1664, FINAL PASSAGE",198,4,0,1,203
2029431,1598791,2025-07-16,Senate,"Senate Health And Human Services: Reported as Committed",12,0,1,0,13
2029611,1583769,2025-06-03,House,"House Game And Fisheries: Report Bill As Committed",18,8,0,0,26
2029611,1587495,2025-06-10,House,"House Floor: HB 1431 PN 1667, 2025 A928",101,102,0,0,203
2029611,1587496,2025-06-10,House,"House Floor: HB 1431 PN 1667, 2025 A929, MOTION TO TABLE",102,101,0,0,203
2029611,1587497,2025-06-10,House,"House Floor: HB 1431 PN 1667, 2025 A932",101,102,0,0,203
2029611,1587498,2025-06-10,House,"House Floor: HB 1431 PN 1667, 2025 A958",101,102,0,0,203
2029611,1587499,2025-06-10,House,"House Floor: HB 1431 PN 1667, 2025 A935",203,0,0,0,203
2029611,1587500,2025-06-10,House,"House Rules: Re-report Bill As Committed",18,15,0,0,33
2029611,1588605,2025-06-11,House,"House Appropriations: Re-report Bill As Committed",37,0,0,0,37
2029611,1588939,2025-06-11,House,"House Floor: HB 1431 PN 1896, FINAL PASSAGE",131,72,0,0,203
2029611,1594172,2025-06-24,Senate,"Senate Game And Fisheries: Reported as Amended",6,5,0,0,11
2029611,1594173,2025-06-24,Senate,"Senate Game And Fisheries: Amendment Defeated A01256",5,6,0,0,11
2029611,1594174,2025-06-24,Senate,"Senate Game And Fisheries: Adopt Amendment A01288",7,4,0,0,11
2029611,1594889,2025-06-25,Senate,"Senate Appropriations: Re-Reported as Committed",16,6,0,0,22
2029611,1595474,2025-06-26,Senate,"Senate Floor: HB 1431 PN 1998, 2025 A1349, DUSH Amendment No. A-1349",9,41,0,0,50
2029611,1595475,2025-06-26,Senate,"Senate Floor: HB 1431 PN 1998, Final Passage",34,16,0,0,50
2029611,1596454,2025-06-30,House,"House Rules: Re-report Bill As Committed",18,15,0,0,33
2029611,1596553,2025-06-30,House,"House Floor: HB 1431 PN 1998, CONCURRENCE",142,61,0,0,203
2029621,1594126,2025-06-24,House,"House Professional Licensure: Report Bill As Committed",26,0,0,0,26
2029621,1597629,2025-07-07,House,"House Rules: Re-report Bill As Committed",33,0,0,0,33
2029621,1597778,2025-07-08,House,"House Appropriations: Re-report Bill As Committed",37,0,0,0,37
2029621,1597797,2025-07-08,House,"House Floor: HB 1433 PN 1669, FINAL PASSAGE",203,0,0,0,203
2029676,1571103,2025-05-14,House,"House Health: Report Bill As Committed",26,0,0,0,26
2029676,1583028,2025-06-02,House,"House Floor: HR 232 PN 1672",199,4,0,0,203
2029688,1570771,2025-05-13,House,"House State Government: Report Bill As Committed",16,10,0,0,26
2029688,1589364,2025-06-11,House,"House Floor: HR 231 PN 1666",120,83,0,0,203
2029948,1584566,2025-06-04,House,"House Veterans Affairs And Emergency Preparedness: Report Bill As Committed",26,0,0,0,26
2030061,1583768,2025-06-03,Senate,"Senate Consumer Protection And Professional Licensure: Reported as Committed",14,0,0,0,14
2030061,1584644,2025-06-04,Senate,"Senate Floor: SB 748 PN 760, Motion to consider bill on second consideration",49,0,0,1,50
2030061,1587515,2025-06-10,Senate,"Senate Appropriations: Re-Reported as Committed",22,0,0,0,22
2030061,1588610,2025-06-11,Senate,"Senate Floor: SB 748 PN 919, Final Passage",48,1,0,1,50
2030228,1587396,2025-06-10,House,"House Health: Report Bill As Amended",26,0,0,0,26
2030228,1587397,2025-06-10,House,"House Health: Adopt Amendment A00781",26,0,0,0,26
2030228,1593870,2025-06-23,House,"House Rules: Re-report Bill As Committed",33,0,0,0,33
2030228,1594117,2025-06-24,House,"House Appropriations: Re-report Bill As Committed",37,0,0,0,37
2030228,1594274,2025-06-24,House,"House Floor: HB 1442 PN 1877, FINAL PASSAGE",203,0,0,0,203
2030292,1591223,2025-06-16,House,"House Health: Report Bill As Committed",26,0,0,0,26
2030292,1594417,2025-06-24,House,"House Floor: HR 235 PN 1695",192,11,0,0,203
2030451,1601208,2025-09-08,Senate,"Senate Transportation: Reported as Amended",10,2,2,0,14
2030451,1601209,2025-09-08,Senate,"Senate Transportation: Adopt Amendment A01679",11,1,2,0,14
2030451,1601430,2025-09-09,Senate,"Senate Appropriations: Re-Reported as Committed",17,4,1,0,22
2030451,1601688,2025-09-10,Senate,"Senate Floor: SB 713 PN 1152, Final Passage",28,22,0,0,50
2030506,1587423,2025-06-10,Senate,"Senate Education: Reported as Committed",11,0,0,0,11
2030545,1594822,2025-06-25,House,"House Local Government: Adopt Amendment A01184",15,11,0,0,26
2030545,1594823,2025-06-25,House,"House Local Government: Report Bill As Amended",15,11,0,0,26
2030545,1598188,2025-07-14,House,"House Rules: Re-report Bill As Committed",18,15,0,0,33
2030599,1583753,2025-06-03,Senate,"Senate Judiciary: Reported as Committed",10,3,1,0,14
2030599,1594899,2025-06-25,Senate,"Senate Floor: SB 739 PN 1006, Final Passage",49,1,0,0,50
2030599,1596435,2025-06-30,House,"House Judiciary: Report Bill As Committed",25,1,0,0,26
2030646,1583944,2025-06-03,House,"House Health: Report Bill As Amended",20,6,0,0,26
2030646,1583945,2025-06-03,House,"House Health: Adopt Amendment A00836",26,0,0,0,26
2030646,1586483,2025-06-09,House,"House Rules: Re-report Bill As Committed",18,15,0,0,33
2030646,1586746,2025-06-09,House,"House Floor: HB 1460 PN 1821, 2025 A914",133,69,0,1,203
2030646,1586747,2025-06-09,House,"House Floor: HB 1460 PN 1821, 2025 A907",130,72,0,1,203
2030646,1586748,2025-06-09,House,"House Floor: HB 1460 PN 1821, 2025 A892, MOTION TO TABLE",102,100,0,1,203
2030646,1586749,2025-06-09,House,"House Floor: HB 1460 PN 1821, 2025 A896",99,103,0,1,203
2030646,1587487,2025-06-10,House,"House Appropriations: Re-report Bill As Committed",22,15,0,0,37
2030646,1587899,2025-06-10,House,"House Floor: HB 1460 PN 1871, FINAL PASSAGE",121,82,0,0,203
2031235,1593872,2025-06-23,House,"House Aging And Older Adult Services: Adopt Amendment A01102",26,0,0,0,26
2031235,1593873,2025-06-23,House,"House Aging And Older Adult Services: Report Bill As Amended A01102",26,0,0,0,26
2031235,1597982,2025-07-09,House,"House Rules: Re-report Bill As Committed",33,0,0,0,33
2031235,1598183,2025-07-14,House,"House Appropriations: Re-report Bill As Committed",37,0,0,0,37
2031235,1598193,2025-07-14,House,"House Floor: HB 1466 PN 1973, FINAL PASSAGE",167,35,0,1,203
2033115,1584549,2025-06-04,House,"House Housing And Community Development: Adopt Amendment A00780",23,3,0,0,26
2033115,1584550,2025-06-04,House,"House Housing And Community Development: Report Bill As Amended",23,3,0,0,26
2033115,1588715,2025-06-11,House,"House Rules: Re-report Bill As Committed",33,0,0,0,33
2033115,1590974,2025-06-16,House,"House Appropriations: Re-report Bill As Committed",37,0,0,0,37
2033115,1593959,2025-06-23,House,"House Floor: HB 1498 PN 1832, FINAL PASSAGE",181,22,0,0,203
2033126,1593305,2025-06-10,Senate,"Senate Community, Economic And Recreational Development: Reported as Committed",14,0,0,0,14
2033126,1594473,2025-06-24,Senate,"Senate Appropriations: Adopt Amendment A01172",22,0,0,0,22
2033126,1594474,2025-06-24,Senate,"Senate Appropriations: Re-Reported as Amended",22,0,0,0,22
2033126,1596500,2025-06-30,Senate,"Senate Floor: SB 766 PN 987, Final Passage",46,4,0,0,50
2033128,1594161,2025-06-24,Senate,"Senate State Government: Reported as Committed",11,0,0,0,11
2033128,1598541,2025-07-16,Senate,"Senate Appropriations: Re-Reported as Committed",22,0,0,0,22
2033144,1587245,2025-06-10,Senate,"Senate Local Government: Reported as Committed",11,0,0,0,11
2033144,1593984,2025-06-23,Senate,"Senate Floor: SB 764 PN 820, Final Passage",50,0,0,0,50
2033144,1593985,2025-06-23,Senate,"Senate Appropriations: Re-Reported as Committed",22,0,0,0,22
2033151,1586627,2025-06-09,Senate,"Senate Labor And Industry: Reported as Committed",11,0,0,0,11
2033836,1588593,2025-06-11,House,"House Finance: Report Bill As Committed",26,0,0,0,26
2033898,1593974,2025-06-23,Senate,"Senate Judiciary: Reported as Committed",14,0,0,0,14
2033898,1595319,2025-06-26,Senate,"Senate Appropriations: Re-Reported as Committed",22,0,0,0,22
2033898,1595392,2025-06-26,Senate,"Senate Floor: SB 779 PN 843, Final Passage",49,1,0,0,50
2033909,1587370,2025-06-10,Senate,"Senate Local Government: Reported as Committed",7,4,0,0,11
2033909,1594321,2025-06-24,Senate,"Senate Appropriations: Re-Reported as Committed",14,8,0,0,22
2033909,1594912,2025-06-25,Senate,"Senate Floor: SB 780 PN 837, 2025 A1351, Motion to Table BOSCOLA Amendment No. A-1351",27,23,0,0,50
2033909,1594913,2025-06-25,Senate,"Senate Floor: SB 780 PN 837, Final Passage",34,16,0,0,50
2033920,1591431,2025-06-17,House,"House Children And Youth: Report Bill As Committed",25,1,0,0,26
2033920,1597015,2025-07-01,House,"House Rules: Re-report Bill As Committed",33,0,0,0,33
2033920,1597628,2025-07-07,House,"House Appropriations: Re-report Bill As Committed",37,0,0,0,37
2033920,1597647,2025-07-07,House,"House Floor: HB 1505 PN 1760, FINAL PASSAGE",202,1,0,0,203
2033974,1594162,2025-06-24,Senate,"Senate State Government: Reported as Committed",11,0,0,0,11
2034077,1583718,2025-06-03,House,"House Game And Fisheries: Report Bill As Committed",26,0,0,0,26
2034077,1594840,2025-06-25,House,"House Rules: Re-report Bill As Committed",33,0,0,0,33
2034077,1596438,2025-06-30,House,"House Appropriations: Re-report Bill As Committed",37,0,0,0,37
2034077,1596535,2025-06-30,House,"House Floor: HB 1507 PN 1762, FINAL PASSAGE",198,5,0,0,203
2034083,1583021,2025-06-02,House,"House Judiciary: Report Bill As Committed",24,2,0,0,26
2034083,1586797,2025-06-09,House,"House Floor: HB 1511 PN 1767, 2025 A916",100,102,0,1,203
2034083,1586798,2025-06-09,House,"House Floor: HB 1511 PN 1767, 2025 A974, MOTION TO SUSPEND RULES",201,1,0,1,203
2034083,1586799,2025-06-09,House,"House Floor: HB 1511 PN 1767, 2025 A974",202,0,0,1,203
2034083,1587616,2025-06-10,House,"House Floor: HB 1511 PN 1872, FINAL PASSAGE",169,34,0,0,203
2034083,1587617,2025-06-10,House,"House Appropriations: Re-report Bill As Committed",37,0,0,0,37
2034214,1583750,2025-06-03,Senate,"Senate State Government: Reported as Committed",9,2,0,0,11
2034238,1588456,2025-06-11,House,"House Commerce: Report Bill As Committed",15,11,0,0,26
2034238,1594778,2025-06-25,House,"House Rules: Re-report Bill As Committed",18,15,0,0,33
2034366,1584216,2025-06-03,House,"House Tourism, Recreation And Economic Development: Report Bill As Committed",26,0,0,0,26
2034366,1595360,2025-06-25,House,"House Floor: HR 238 PN 1763",198,5,0,0,203
2034451,1587432,2025-06-10,House,"House Health: Report Bill As Committed",26,0,0,0,26
2034451,1594153,2025-06-24,House,"House Floor: HB 1527 PN 1784, 2025 A1251",203,0,0,0,203
2034451,1594154,2025-06-24,House,"House Rules: Re-report Bill As Committed",33,0,0,0,33
2034451,1594811,2025-06-25,House,"House Appropriations: Re-report Bill As Committed",37,0,0,0,37
2034451,1594984,2025-06-25,House,"House Floor: HB 1527 PN 2011, FINAL PASSAGE",203,0,0,0,203
2034451,1598537,2025-07-16,Senate,"Senate Health And Human Services: Reported as Amended",12,0,1,0,13
2034451,1598538,2025-07-16,Senate,"Senate Health And Human Services: Adopt Amendment A01566",12,0,1,0,13
2034476,1584600,2025-06-04,House,"House Labor And Industry: Report Bill As Committed",15,10,1,0,26
2034476,1584601,2025-06-04,House,"House Labor And Industry: Appeal Ruling of the Chair",11,14,1,0,26
2034476,1588601,2025-06-11,House,"House Floor: HR 245 PN 1772",177,26,0,0,203
2034639,1588668,2025-06-11,House,"House Local Government: Adopt Amendment A00968",26,0,0,0,26
2034639,1588669,2025-06-11,House,"House Local Government: Adopt Amendment A01043",14,12,0,0,26
2034639,1588670,2025-06-11,House,"House Local Government: Report Bill As Amended",15,11,0,0,26
2034639,1596079,2025-06-30,House,"House Rules: Re-report Bill As Committed",18,15,0,0,33
2034639,1596506,2025-06-30,House,"House Floor: HB 1532 PN 1904, 2025 A1085, MOTION TO TABLE",102,101,0,0,203
2034639,1597080,2025-07-01,House,"House Floor: HB 1532 PN 1904, FINAL PASSAGE",102,100,0,1,203
2034639,1597081,2025-07-01,House,"House Appropriations: Re-report Bill As Committed",22,15,0,0,37
2034647,1584111,2025-06-03,House,"House Tourism, Recreation And Economic Development: Report Bill As Committed",26,0,0,0,26
2034647,1586566,2025-06-09,House,"House Floor: HR 243 PN 1778",193,9,0,1,203
2034717,1583829,2025-06-03,Senate,"Senate State Government: Reported as Amended",11,0,0,0,11
2034717,1583830,2025-06-03,Senate,"Senate State Government: Adopt Amendment A00820",11,0,0,0,11
2034745,1583027,2025-06-02,House,"House Education: Report Bill As Committed",14,12,0,0,26
2034745,1584068,2025-06-03,House,"House Appropriations: Adopt Amendment A00865",22,15,0,0,37
2034745,1584069,2025-06-03,House,"House Appropriations: Re-report Bill As Amended",22,15,0,0,37
2034745,1584699,2025-06-04,House,"House Floor: HB 1500 PN 1829, FINAL PASSAGE",104,98,0,1,203
2035099,1593881,2025-06-23,House,"House Tourism, Recreation And Economic Development: Report Bill As Committed",18,8,0,0,26
2035110,1593878,2025-06-23,House,"House Tourism, Recreation And Economic Development: Report Bill As Committed",26,0,0,0,26
2035145,1591766,2025-06-17,House,"House Labor And Industry: Adopt Amendment A01095",12,14,0,0,26
2035145,1591767,2025-06-17,House,"House Labor And Industry: Constitutionality of A01113 A01113",12,14,0,0,26
2035145,1591768,2025-06-17,House,"House Labor And Industry: Report Bill As Committed",14,12,0,0,26
2035145,1596437,2025-06-30,House,"House Rules: Re-report Bill As Committed",18,15,0,0,33
2035168,1594146,2025-06-24,Senate,"Senate Game And Fisheries: Reported as Committed",11,0,0,0,11
2035168,1594876,2025-06-25,Senate,"Senate Appropriations: Re-Reported as Committed",22,0,0,0,22
2035168,1595471,2025-06-26,Senate,"Senate Floor: SB 800 PN 861, Final Passage",50,0,0,0,50
2035168,1598195,2025-07-14,House,"House Game And Fisheries: Adopt Amendment A01545",12,14,0,0,26
2035168,1598196,2025-07-14,House,"House Game And Fisheries: Report Bill As Committed",26,0,0,0,26
2035185,1594149,2025-06-24,House,"House Education: Re-refer Bill To Another Committee",26,0,0,0,26
2035213,1591368,2025-06-17,House,"House Transportation: Report Bill As Committed",25,1,0,0,26
2035213,1597776,2025-07-08,House,"House Rules: Re-report Bill As Committed",33,0,0,0,33
2035213,1597793,2025-07-08,House,"House Floor: HB 1545 PN 1822, 2025 A1498",203,0,0,0,203
2035213,1597984,2025-07-09,House,"House Appropriations: Re-report Bill As Committed",37,0,0,0,37
2035224,1587425,2025-06-10,House,"House Finance: Adopt Amendment A01007",26,0,0,0,26
2035224,1587426,2025-06-10,House,"House Finance: Report Bill As Amended",14,12,0,0,26
2035224,1594145,2025-06-24,House,"House Rules: Re-report Bill As Committed",33,0,0,0,33
2035224,1594810,2025-06-25,House,"House Appropriations: Re-report Bill As Committed",37,0,0,0,37
2035224,1594981,2025-06-25,House,"House Floor: HB 1534 PN 1879, FINAL PASSAGE",128,75,0,0,203
2035234,1588194,2025-06-10,House,"House Health: Report Bill As Committed",26,0,0,0,26
2035259,1584658,2025-06-04,House,"House Labor And Industry: To Table",15,8,3,0,26
2035259,1584659,2025-06-04,House,"House Labor And Industry: To Table",11,14,1,0,26
2035259,1584660,2025-06-04,House,"House Labor And Industry: Report Bill As Committed",14,11,1,0,26
2035259,1586466,2025-06-09,House,"House Rules: Re-report Bill As Committed",18,15,0,0,33
2035259,1587451,2025-06-10,House,"House Floor: HB 1549 PN 1826, 2025 A1006",102,101,0,0,203
2035259,1588594,2025-06-11,House,"House Appropriations: Re-report Bill As Committed",22,15,0,0,37
2035259,1588926,2025-06-11,House,"House Floor: HB 1549 PN 1881, FINAL PASSAGE",102,101,0,0,203
2035309,1587680,2025-06-10,House,"House Health: Report Bill As Committed",26,0,0,0,26
2035316,1594204,2025-06-24,Senate,"Senate Veterans Affairs And Emergency Preparedness: Reported as Committed",11,0,0,0,11
2035317,1588618,2025-06-11,Senate,"Senate Urban Affairs And Housing: Reported as Committed",10,1,0,0,11
2035433,1588459,2025-06-11,House,"House Commerce: Report Bill As Committed",14,12,0,0,26
2035433,1594815,2025-06-25,House,"House Rules: Re-report Bill As Committed",18,15,0,0,33
2035433,1596503,2025-06-30,House,"House Floor: HB 1553 PN 1835, FINAL PASSAGE",102,101,0,0,203
2035433,1596504,2025-06-30,House,"House Appropriations: Re-report Bill As Committed",22,15,0,0,37
2035470,1588032,2025-06-10,Senate,"Senate Institutional Sustainability And Innovation: Adopt Amendment A00988",11,0,0,0,11
2035470,1588033,2025-06-10,Senate,"Senate Institutional Sustainability And Innovation: Reported as Amended A00988",11,0,0,0,11
2035495,1587845,2025-06-10,Senate,"Senate Education: Reported as Committed",11,0,0,0,11
2035495,1588974,2025-06-11,Senate,"Senate Floor: SR 119 PN 897",47,2,0,1,50
2035549,1588676,2025-06-11,House,"House Local Government: Report Bill As Committed",15,11,0,0,26
2035614,1596330,2025-06-30,House,"House Judiciary: Report Bill As Committed",14,12,0,0,26
2035614,1596331,2025-06-30,House,"House Judiciary: Vote To Table",12,14,0,0,26
2035676,1595335,2025-06-26,House,"House Veterans Affairs And Emergency Preparedness: Re-refer Bill To Human Services Committee",26,0,0,0,26
2035908,1587272,2025-06-10,Senate,"Senate Education: Reported as Committed",11,0,0,0,11
2035908,1594436,2025-06-24,Senate,"Senate Floor: SB 838 PN 904, Final Passage",48,2,0,0,50
2035908,1594437,2025-06-24,Senate,"Senate Floor: SB 838 PN 904, Final Passage - Reconsideration",50,0,0,0,50
2035908,1594438,2025-06-24,Senate,"Senate Appropriations: Re-Reported as Committed",22,0,0,0,22
2035908,1596163,2025-06-30,House,"House Professional Licensure: Report Bill As Committed",26,0,0,0,26
2035957,1591443,2025-06-17,House,"House Children And Youth: Report Bill As Committed",16,10,0,0,26
2035957,1594176,2025-06-24,House,"House Rules: Re-report Bill As Committed",18,15,0,0,33
2035957,1594828,2025-06-25,House,"House Appropriations: Re-report Bill As Committed",22,15,0,0,37
2035957,1595001,2025-06-25,House,"House Floor: HB 506 PN 1854, FINAL PASSAGE",113,90,0,0,203
2035988,1591415,2025-06-17,House,"House Children And Youth: Report Bill As Committed",14,12,0,0,26
2035988,1597979,2025-07-09,House,"House Rules: Re-report Bill As Committed",18,15,0,0,33
2035988,1598324,2025-07-14,House,"House Floor: HB 1573 PN 1861, FINAL PASSAGE",102,100,0,1,203
2035988,1598325,2025-07-14,House,"House Appropriations: Re-report Bill As Committed",22,15,0,0,37
2036000,1591384,2025-06-17,House,"House Children And Youth: Report Bill As Committed",14,12,0,0,26
2036000,1597790,2025-07-08,House,"House Rules: Re-report Bill As Committed",18,15,0,0,33
2036000,1597977,2025-07-09,House,"House Floor: HB 1576 PN 1863, FINAL PASSAGE",106,97,0,0,203
2036000,1597978,2025-07-09,House,"House Appropriations: Re-report Bill As Committed",22,15,0,0,37
2036014,1587356,2025-06-10,House,"House Human Services: Adopt Amendment A01011",26,0,0,0,26
2036014,1587357,2025-06-10,House,"House Human Services: Report Bill As Amended",26,0,0,0,26
2036019,1587251,2025-06-10,House,"House Human Services: Report Bill As Committed",26,0,0,0,26
2036019,1593903,2025-06-23,House,"House Rules: Re-report Bill As Committed",33,0,0,0,33
2036019,1594167,2025-06-24,House,"House Appropriations: Re-report Bill As Committed",37,0,0,0,37
2036019,1594423,2025-06-24,House,"House Floor: HB 1590 PN 1852, FINAL PASSAGE",202,1,0,0,203
2036026,1591393,2025-06-17,House,"House Children And Youth: Report Bill As Committed",15,11,0,0,26
2036026,1597780,2025-07-08,House,"House Floor: HB 1577 PN 1864, 2025 A1395",203,0,0,0,203
2036026,1597781,2025-07-08,House,"House Rules: Re-report Bill As Committed",18,15,0,0,33
2036026,1597990,2025-07-09,House,"House Floor: HB 1577 PN 2098, FINAL PASSAGE",108,95,0,0,203
2036026,1597991,2025-07-09,House,"House Appropriations: Re-report Bill As Committed",22,15,0,0,37
2036031,1593942,2025-06-23,House,"House Housing And Community Development: Report Bill As Committed",25,1,0,0,26
2036031,1596452,2025-06-30,House,"House Rules: Re-report Bill As Committed",33,0,0,0,33
2036031,1597021,2025-07-01,House,"House Floor: HB 1574 PN 1862, FINAL PASSAGE",160,42,0,1,203
2036031,1597022,2025-07-01,House,"House Appropriations: Re-report Bill As Committed",37,0,0,0,37
2036048,1591699,2025-06-17,House,"House Consumer Protection, Technology And Utilities: Report Bill As Committed",26,0,0,0,26
2036048,1594155,2025-06-24,House,"House Floor: HR 254 PN 1866",120,83,0,0,203
2036053,1587585,2025-06-10,Senate,"Senate Education: Reported as Amended",10,1,0,0,11
2036053,1587586,2025-06-10,Senate,"Senate Education: Adopt Amendment A01013",11,0,0,0,11
2036053,1594306,2025-06-24,Senate,"Senate Floor: SB 375 PN 934, Final Passage",47,3,0,0,50
2036053,1594307,2025-06-24,Senate,"Senate Appropriations: Re-Reported as Committed",22,0,0,0,22
2036057,1587544,2025-06-10,Senate,"Senate Banking And Insurance: Reported as Committed",14,0,0,0,14
2036057,1593963,2025-06-23,Senate,"Senate Appropriations: Re-Reported as Committed",22,0,0,0,22
2036057,1594256,2025-06-24,Senate,"Senate Floor: SB 88 PN 981, Final Passage",50,0,0,0,50
2036057,1594769,2025-06-25,House,"House Insurance: Bring Up The Bill For Consideration",26,0,0,0,26
2036059,1588465,2025-06-11,Senate,"Senate Consumer Protection And Professional Licensure: Reported as Committed",12,1,1,0,14
2036059,1594311,2025-06-24,Senate,"Senate Floor: SB 842 PN 914, Final Passage",47,3,0,0,50
2036059,1594312,2025-06-24,Senate,"Senate Appropriations: Re-Reported as Committed",22,0,0,0,22
2036059,1596423,2025-06-30,House,"House Professional Licensure: Report Bill As Committed",26,0,0,0,26
2036067,1588734,2025-06-11,House,"House Finance: Report Bill As Committed",14,12,0,0,26
2036079,1588600,2025-06-11,House,"House Finance: Report Bill As Committed",14,12,0,0,26
2036240,1587526,2025-06-10,Senate,"Senate Community, Economic And Recreational Development: Reported as Committed",9,5,0,0,14
2036240,1588689,2025-06-11,Senate,"Senate Appropriations: Re-Reported as Committed",13,8,1,0,22
2036240,1594938,2025-06-25,Senate,"Senate Floor: SB 840 PN 931, Reconsideration of request to go over",26,24,0,0,50
2036240,1594939,2025-06-25,Senate,"Senate Floor: SB 840 PN 931, Final Passage",26,24,0,0,50
2036240,1595353,2025-06-26,House,"House Gaming Oversight: Report Bill As Committed",18,8,0,0,26
2036257,1591396,2025-06-17,House,"House Finance: Report Bill As Committed",15,11,0,0,26
2036257,1597064,2025-07-01,House,"House Rules: Re-report Bill As Committed",18,15,0,0,33
2036257,1597632,2025-07-07,House,"House Floor: HB 1575 PN 1873, FINAL PASSAGE",114,89,0,0,203
2036257,1597633,2025-07-07,House,"House Appropriations: Re-report Bill As Committed",22,15,0,0,37
2036278,1594250,2025-06-24,Senate,"Senate Finance: Reported as Committed",11,0,0,0,11
2036498,1594767,2025-06-25,House,"House Local Government: Report Bill As Committed",26,0,0,0,26
2036594,1591022,2025-06-16,House,"House Health: Report Bill As Committed",26,0,0,0,26
2036618,1591737,2025-06-17,House,"House Finance: Report Bill As Committed",25,1,0,0,26
2036618,1594813,2025-06-25,House,"House Rules: Re-report Bill As Committed",33,0,0,0,33
2036618,1595292,2025-06-26,House,"House Floor: HB 1572 PN 1885, 2025 A1333",101,101,0,1,203
2036618,1596478,2025-06-30,House,"House Floor: HB 1572 PN 1885, FINAL PASSAGE",141,62,0,0,203
2036618,1596479,2025-06-30,House,"House Appropriations: Re-report Bill As Committed",37,0,0,0,37
2036653,1591535,2025-06-17,House,"House Insurance: Report Bill As Committed",14,12,0,0,26
2036653,1594187,2025-06-24,House,"House Rules: Re-report Bill As Committed",18,15,0,0,33
2036653,1594818,2025-06-25,House,"House Appropriations: Re-report Bill As Committed",22,15,0,0,37
2036653,1594990,2025-06-25,House,"House Floor: HB 1445 PN 1897, FINAL PASSAGE",102,101,0,0,203
2036661,1591474,2025-06-17,House,"House Transportation: Adopt Amendment A01168",26,0,0,0,26
2036661,1591475,2025-06-17,House,"House Transportation: Report Bill As Amended",26,0,0,0,26
2036661,1597777,2025-07-08,House,"House Rules: Re-report Bill As Committed",33,0,0,0,33
2036661,1597988,2025-07-09,House,"House Floor: HB 1591 PN 1939, FINAL PASSAGE",193,10,0,0,203
2036661,1597989,2025-07-09,House,"House Appropriations: Re-report Bill As Committed",37,0,0,0,37
2036668,1594159,2025-06-24,Senate,"Senate State Government: Reported as Committed",7,4,0,0,11
2036668,1595324,2025-06-26,Senate,"Senate Appropriations: Re-Reported as Committed",14,8,0,0,22
2036778,1591390,2025-06-17,House,"House Children And Youth: Adopt Amendment A01155",26,0,0,0,26
2036778,1591391,2025-06-17,House,"House Children And Youth: Report Bill As Amended A01155",26,0,0,0,26
2036778,1597796,2025-07-08,House,"House Rules: Re-report Bill As Committed",33,0,0,0,33
2036778,1598016,2025-07-09,House,"House Floor: HB 1600 PN 1944, FINAL PASSAGE",176,27,0,0,203
2036778,1598017,2025-07-09,House,"House Appropriations: Re-report Bill As Committed",37,0,0,0,37
2036962,1591353,2025-06-17,House,"House Consumer Protection, Technology And Utilities: Report Bill As Committed",26,0,0,0,26
2036962,1594805,2025-06-25,House,"House Rules: Re-report Bill As Committed",33,0,0,0,33
2036962,1596476,2025-06-30,House,"House Floor: HB 1599 PN 1913, 2025 A1329",101,102,0,0,203
2036962,1596477,2025-06-30,House,"House Floor: HB 1599 PN 1913, 2025 A1331, MOTION TO TABLE",102,101,0,0,203
2036962,1597057,2025-07-01,House,"House Floor: HB 1599 PN 1913, FINAL PASSAGE",159,43,0,1,203
2036962,1597058,2025-07-01,House,"House Appropriations: Re-report Bill As Committed",37,0,0,0,37
2037019,1594754,2025-06-25,House,"House Health: Report Bill As Committed",25,0,1,0,26
2037132,1591447,2025-06-17,House,"House Finance: Report Bill As Committed",14,12,0,0,26
2037132,1594179,2025-06-24,House,"House Rules: Re-report Bill As Committed",18,15,0,0,33
2037132,1594420,2025-06-24,House,"House Floor: HB 1610 PN 1914, 2025 A1267, MOTION TO APPEAL RULING OF THE CHAIR",102,101,0,0,203
2037132,1594421,2025-06-24,House,"House Floor: HB 1610 PN 1914, 2025 A1267",104,99,0,0,203
2037132,1594819,2025-06-25,House,"House Appropriations: Re-report Bill As Committed",22,15,0,0,37
2037132,1594987,2025-06-25,House,"House Floor: HB 1610 PN 2012, FINAL PASSAGE",104,99,0,0,203
2037322,1593856,2025-06-23,House,"House Aging And Older Adult Services: Report Bill As Committed",26,0,0,0,26
2037323,1597782,2025-07-08,House,"House Transportation: Report Bill As Committed",26,0,0,0,26
2037354,1594023,2025-06-23,House,"House Tourism, Recreation And Economic Development: Report Bill As Committed",16,10,0,0,26
2037367,1593921,2025-06-23,House,"House Judiciary: Report Bill As Amended",25,1,0,0,26
2037367,1593922,2025-06-23,House,"House Judiciary: Adopt Amendment A01243",26,0,0,0,26
2037446,1594768,2025-06-25,House,"House Health: Report Bill As Committed",25,1,0,0,26
2037485,1594756,2025-06-25,House,"House Health: Report Bill As Committed",23,3,0,0,26
2037631,1594015,2025-06-23,House,"House Tourism, Recreation And Economic Development: Report Bill As Committed",17,9,0,0,26
2037666,1594740,2025-06-25,House,"House Health: Report Bill As Committed",25,1,0,0,26
2037666,1596739,2025-06-30,House,"House Floor: HR 264 PN 1962",200,3,0,0,203
2037669,1594116,2025-06-24,House,"House Consumer Protection, Technology And Utilities: Report Bill As Committed",26,0,0,0,26
2037801,1594222,2025-06-24,House,"House Education: Report Bill As Committed",26,0,0,0,26
2037801,1594830,2025-06-25,House,"House Rules: Re-report Bill As Committed",33,0,0,0,33
2037801,1595260,2025-06-25,House,"House Appropriations: Re-report Bill As Committed",37,0,0,0,37
2037801,1595327,2025-06-26,House,"House Floor: HB 1627 PN 1969, FINAL PASSAGE",195,7,0,1,203
2037801,1598819,2025-07-16,Senate,"Senate Education: Reported as Committed",10,1,0,0,11
2037803,1593866,2025-06-23,House,"House Veterans Affairs And Emergency Preparedness: Report Bill As Committed",26,0,0,0,26
2037803,1595262,2025-06-25,House,"House Floor: HR 267 PN 1967",203,0,0,0,203
2037805,1594221,2025-06-24,House,"House Education: Report Bill As Committed",26,0,0,0,26
2037805,1594751,2025-06-25,House,"House Rules: Re-report Bill As Committed",33,0,0,0,33
2037805,1594954,2025-06-25,House,"House Appropriations: Re-report Bill As Committed",37,0,0,0,37
2037805,1595361,2025-06-26,House,"House Floor: HB 1626 PN 1968, FINAL PASSAGE",197,5,0,1,203
2037805,1598783,2025-07-16,Senate,"Senate Education: Reported as Committed",10,1,0,0,11
2037808,1594019,2025-06-23,House,"House Floor: UNCONTESTED CALENDAR SUP A",203,0,0,0,203
2037812,1593885,2025-06-23,House,"House Judiciary: Bill failed",13,13,0,0,26
2037812,1596076,2025-06-30,House,"House Judiciary: Report Bill As Committed",14,12,0,0,26
2037819,1593879,2025-06-23,House,"House Housing And Community Development: Report Bill As Committed",23,3,0,0,26
2037819,1594755,2025-06-25,House,"House Rules: Re-report Bill As Committed",18,15,0,0,33
2037819,1595089,2025-06-25,House,"House Appropriations: Re-report Bill As Committed",22,15,0,0,37
2037819,1595347,2025-06-26,House,"House Floor: HB 1650 PN 1972, FINAL PASSAGE",122,80,0,1,203
2037857,1595341,2025-06-26,Senate,"Senate Judiciary: Reported as Committed",10,4,0,0,14
2037860,1594290,2025-06-24,Senate,"Senate Education: Reported as Committed",11,0,0,0,11
2037860,1598542,2025-07-16,Senate,"Senate Appropriations: Re-Reported as Committed",22,0,0,0,22
2037860,1598796,2025-07-17,Senate,"Senate Floor: SB 877 PN 977, Final Passage",49,1,0,0,50
2037870,1594289,2025-06-24,Senate,"Senate Education: Reported as Committed",11,0,0,0,11
2037870,1598543,2025-07-16,Senate,"Senate Appropriations: Re-Reported as Committed",22,0,0,0,22
2037870,1598826,2025-07-17,Senate,"Senate Floor: SB 878 PN 978, Final Passage",49,1,0,0,50
2037880,1596459,2025-06-30,House,"House Professional Licensure: Report Bill As Committed",26,0,0,0,26
2037880,1597800,2025-07-08,House,"House Floor: HB 1646 PN 1996, 2025 A1480",91,112,0,0,203
2037880,1597801,2025-07-08,House,"House Floor: HB 1646 PN 1996, 2025 A1494",101,102,0,0,203
2037880,1597802,2025-07-08,House,"House Rules: Re-report Bill As Committed",33,0,0,0,33
2037880,1598144,2025-07-09,House,"House Floor: HB 1646 PN 1996, FINAL PASSAGE",115,88,0,0,203
2037880,1598145,2025-07-09,House,"House Appropriations: Re-report Bill As Committed",37,0,0,0,37
2037895,1597066,2025-07-01,House,"House Tourism, Recreation And Economic Development: Report Bill As Committed",26,0,0,0,26
2037938,1594877,2025-06-25,House,"House Local Government: Report Bill As Committed",26,0,0,0,26
2038003,1595364,2025-06-26,House,"House Gaming Oversight: Report Bill As Committed",18,8,0,0,26
2038157,1597299,2025-07-01,House,"House Tourism, Recreation And Economic Development: Report Bill As Committed",26,0,0,0,26
2038188,1595421,2025-06-26,Senate,"Senate Floor: SR 131 PN 1015",26,24,0,0,50
2038188,1595422,2025-06-26,Senate,"Senate State Government: Reported as Committed",7,4,0,0,11
2038380,1596486,2025-06-30,House,"House Finance: Report Bill As Committed",24,2,0,0,26
2038380,1598194,2025-07-14,House,"House Rules: Re-report Bill As Committed",33,0,0,0,33
2038511,1597002,2025-07-01,House,"House Labor And Industry: Report Bill As Committed",14,12,0,0,26
2038511,1597642,2025-07-07,House,"House Rules: Re-report Bill As Committed",18,15,0,0,33
2038537,1596807,2025-06-30,House,"House Finance: Report Bill As Committed",15,11,0,0,26
2038537,1597648,2025-07-07,House,"House Floor: HB 1668 PN 2044, 2025 A1467, MOTION TO TABLE",102,101,0,0,203
2038537,1597649,2025-07-07,House,"House Rules: Re-report Bill As Committed",18,15,0,0,33
2038537,1597794,2025-07-08,House,"House Floor: HB 1668 PN 2044, FINAL PASSAGE",107,96,0,0,203
2038537,1597795,2025-07-08,House,"House Appropriations: Re-report Bill As Committed",22,15,0,0,37
2038560,1597011,2025-07-01,House,"House Tourism, Recreation And Economic Development: Report Bill As Committed",26,0,0,0,26
2038560,1597650,2025-07-07,House,"House Floor: HR 275 PN 2051",199,4,0,0,203
2038681,1597110,2025-07-01,House,"House Appropriations: Report Bill As Committed",37,0,0,0,37
2038882,1597630,2025-07-07,House,"House Judiciary: Report Bill As Committed",14,12,0,0,26
2038882,1597803,2025-07-08,House,"House Floor: HB 1697 PN 2081, 2025 A1483, MOTION TO TABLE",102,101,0,0,203
2038882,1597804,2025-07-08,House,"House Floor: HB 1697 PN 2081, 2025 A1484, MOTION TO TABLE",102,101,0,0,203
2038882,1597805,2025-07-08,House,"House Floor: HB 1697 PN 2081, 2025 A1486, MOTION TO TABLE",102,101,0,0,203
2038882,1597806,2025-07-08,House,"House Floor: HB 1697 PN 2081, 2025 A1489, MOTION TO TABLE",102,101,0,0,203
2038882,1597807,2025-07-08,House,"House Floor: HB 1697 PN 2081, MOTION TO POSTPONE",95,102,6,0,203
2038882,1597808,2025-07-08,House,"House Rules: Re-report Bill As Committed",18,15,0,0,33
2038882,1598006,2025-07-09,House,"House Floor: HB 1697 PN 2081, FINAL PASSAGE",136,67,0,0,203
2038882,1598007,2025-07-09,House,"House Appropriations: Re-report Bill As Committed",22,15,0,0,37
2038928,1598018,2025-07-09,House,"House Judiciary: Report Bill As Committed",14,12,0,0,26
2038949,1598009,2025-07-09,House,"House Liquor Control: Report Bill As Committed",26,0,0,0,26
2038961,1598366,2025-07-14,House,"House Insurance: Report Bill As Committed",26,0,0,0,26
2038971,1598794,2025-07-16,Senate,"Senate Education: Reported as Committed",10,1,0,0,11
2038982,1598797,2025-07-16,Senate,"Senate Education: Reported as Amended",10,1,0,0,11
2038982,1598798,2025-07-16,Senate,"Senate Education: Adopt Amendment A01568",6,5,0,0,11
2039394,1598795,2025-07-16,Senate,"Senate Education: Reported as Committed",7,4,0,0,11
2039394,1601216,2025-09-08,Senate,"Senate Floor: SB 922 PN 1053, 2025 A1570, MARTIN Amendment No. A-1570",44,2,0,4,50
2039394,1601440,2025-09-09,Senate,"Senate Floor: SB 922 PN 1151, Final Passage",31,18,0,1,50
2039394,1601441,2025-09-09,Senate,"Senate Appropriations: Re-Reported as Committed",15,6,1,0,22
2040179,1601421,2025-09-08,Senate,"Senate Transportation: Reported as Amended",10,2,2,0,14
2040179,1601422,2025-09-08,Senate,"Senate Transportation: Adopt Amendment A01684",10,2,2,0,14
2040179,1601614,2025-09-09,Senate,"Senate Appropriations: Re-Reported as Committed",15,6,1,0,22
2040179,1601812,2025-09-10,Senate,"Senate Floor: SB 952 PN 1153, 2025 A1691, Motion to move the previous question to SAVAL Amendment No. A-1691",23,27,0,0,50
2040179,1601813,2025-09-10,Senate,"Senate Floor: SB 952 PN 1153, 2025 A1691, Motion to Table SAVAL Amendment No. A-1691",26,24,0,0,50
2040179,1601814,2025-09-10,Senate,"Senate Floor: SB 952 PN 1153, Motion for the Previous Question",27,23,0,0,50
2040179,1601815,2025-09-10,Senate,"Senate Floor: SB 952 PN 1153, Final Passage",26,24,0,0,50
2041043,1601450,2025-09-09,Senate,"Senate Judiciary: Reported as Committed",13,0,1,0,14
2041058,1601212,2025-09-08,Senate,"Senate Transportation: Reported as Committed",12,0,2,0,14
2041472,1599261,2025-08-06,House,"House Transportation: Report Bill As Committed",16,10,0,0,26
2041472,1599275,2025-08-10,House,"House Rules: Re-Reported As Committed",19,14,0,0,33
2041472,1599276,2025-08-10,House,"House Appropriations: Re-report Bill As Committed",22,15,0,0,37
2041472,1599278,2025-08-11,House,"House Floor: HB 1788 PN 2194, 2025 A1614",106,97,0,0,203
2041472,1599279,2025-08-11,House,"House Floor: HB 1788 PN 2206, FINAL PASSAGE",108,95,0,0,203
2043440,1601818,2025-09-10,Senate,"Senate Consumer Protection And Professional Licensure: Reported as Amended",14,0,0,0,14
2043440,1601819,2025-09-10,Senate,"Senate Consumer Protection And Professional Licensure: Adopt Amendment A01687",14,0,0,0,14
