bill_id,roll_call_id,date,chamber,description,yea,nay,nv,absent,total
1892290,1483197,2025-02-06,House,"House: Civil Judiciary Committee: DO PASS",6,1,0,0,7
1892290,1501127,2025-02-27,House,"House: Judiciary and Public Safety Oversight Committee: DO PASS",11,2,0,0,13
1892290,1515807,2025-03-12,House,"House: THIRD READING",76,11,0,12,99
1892290,1539676,2025-04-08,Senate,"Senate: Judiciary Committee: DO PASS",7,1,0,0,8
1892290,1561666,2025-04-30,Senate,"Senate: THIRD READING",38,5,0,4,47
1892292,1507080,2025-03-06,Senate,"Senate: Energy Committee: DO PASS AMENDED CS",10,0,0,0,10
1892292,1527258,2025-03-26,Senate,"Senate: THIRD READING",42,4,0,1,47
1892293,1489059,2025-02-13,Senate,"Senate: Energy Committee: DO PASS",6,5,0,0,11
1892293,1528771,2025-03-27,Senate,"Senate: THIRD READING",28,19,0,0,47
1892293,1542163,2025-04-09,House,"House: Energy Committee: DO PASS",8,4,0,0,12
1892293,1555087,2025-04-23,House,"House: Energy and Natural Resources Oversight Committee: DO PASS AS AMENDED, STRIKE THE TITLE",9,6,0,0,15
1892293,1566146,2025-05-06,House,"House: THIRD READING",44,49,0,5,98
1892293,1567150,2025-05-07,House,"House: RECONSIDER MEASURE",61,29,0,8,98
1892293,1567151,2025-05-07,House,"House: APPEAL OF THE DECISION OF THE CHAIR",76,16,0,6,98
1892691,1503106,2025-03-03,Senate,"Senate: Agriculture & Wildlife Committee: DO PASS AMENDED CS",10,1,1,0,12
1893053,1494161,2025-02-19,House,"House: Criminal Judiciary Committee: DO PASS AS AMENDED BY CS",4,1,0,0,5
1893053,1507640,2025-03-06,House,"House: Judiciary and Public Safety Oversight Committee: DO PASS AS AMENDED BY CS",11,0,0,0,11
1893338,1491228,2025-02-17,House,"House: Appropriations and Budget General Government Subcommittee: DO PASS",5,0,0,0,5
1893338,1500879,2025-02-26,House,"House: Appropriations and Budget Committee: DO PASS AS AMENDED, STRIKE THE TITLE",25,6,0,0,31
1893338,1529290,2025-03-27,House,"House: THIRD READING",75,18,0,6,99
1893338,1548565,2025-04-15,Senate,"Senate: Judiciary Committee: DO PASS AMENDED",5,2,0,0,7
1893339,1485630,2025-02-10,House,"House: Elections and Ethics Committee: DO PASS",5,1,0,0,6
1893339,1504787,2025-03-04,House,"House: Government Oversight Committee: DO PASS",13,3,0,0,16
1893341,1497649,2025-02-24,House,"House: Public Health Committee: DO PASS",5,1,0,0,6
1893341,1500604,2025-02-26,House,"House: Health and Human Services Oversight Committee: DO PASS",9,3,0,0,12
1893342,1494081,2025-02-19,House,"House: Criminal Judiciary Committee: DO PASS",4,1,0,0,5
1893342,1501156,2025-02-27,House,"House: Judiciary and Public Safety Oversight Committee: DO PASS",7,6,0,0,13
1893342,1528867,2025-03-26,House,"House: TABLE AMENDMENT",26,65,0,8,99
1893342,1528868,2025-03-26,House,"House: ADOPT AMENDMENT",47,39,0,13,99
1893342,1528869,2025-03-26,House,"House: THIRD READING",89,0,0,10,99
1893342,1554404,2025-04-22,Senate,"Senate: Judiciary Committee: DO PASS AMENDED CS",8,0,0,0,8
1893342,1565649,2025-05-06,Senate,"Senate: THIRD READING",41,0,0,6,47
1893342,1572045,2025-05-15,House,"House: FOURTH READING",60,21,0,17,98
1893342,1572046,2025-05-15,House,"House: EMERGENCY",54,26,0,18,98
1894746,1486180,2025-02-11,Senate,"Senate: Education Committee: DO PASS",7,5,0,0,12
1894746,1515762,2025-03-12,Senate,"Senate: THIRD READING",33,10,0,4,47
1894746,1539143,2025-04-07,House,"House: Elections and Ethics Committee: DO PASS AS AMENDED BY CS",5,1,0,0,6
1894746,1596312,2025-04-15,House,"House: Government Oversight Committee: DO PASS AS AMENDED BY CS",11,6,0,0,17
1895091,1501186,2025-02-27,Senate,"Senate: Business & Insurance Committee: DO PASS",8,2,0,0,10
1895762,1484742,2025-02-10,House,"House: Elections and Ethics Committee: DO PASS AS AMENDED BY CS",5,1,0,0,6
1896397,1485398,2025-02-10,Senate,"Senate: Aeronautics & Transportation Committee: DO PASS",12,0,0,0,12
1896397,1500259,2025-02-26,Senate,"Senate: THIRD READING",46,0,0,1,47
1896397,1543455,2025-04-10,House,"House: Transportation Committee: DO PASS AS AMENDED BY CS",9,0,0,0,9
1896397,1568153,2025-05-08,House,"House: THIRD READING",74,15,0,9,98
1896397,1575809,2025-05-22,House,"House: FOURTH READING",71,13,0,14,98
1896397,1591718,2025-05-21,Senate,"Senate: FOURTH READING",36,10,0,2,48
1896397,1596195,2025-04-24,House,"House: Commerce and Economic Development Oversight Committee: DO PASS AS AMENDED BY CS",14,3,0,0,17
1896747,1488661,2025-02-13,Senate,"Senate: Business & Insurance Committee: DO PASS",10,0,0,0,10
1896759,1482144,2025-02-05,House,"House: Government Modernization and Technology Committee: DO PASS",7,1,0,0,8
1896782,1486093,2025-02-11,Senate,"Senate: Public Safety Committee: DO PASS",5,3,0,0,8
1896994,1486166,2025-02-11,House,"House: Postsecondary Education Committee: DO PASS",8,0,0,0,8
1896994,1499884,2025-02-26,House,"House: Education Oversight Committee: DO PASS",10,0,0,0,10
1896994,1504239,2025-03-04,House,"House: THIRD READING",78,13,0,8,99
1896994,1539929,2025-04-08,Senate,"Senate: Education Committee: DO PASS AMENDED",9,2,0,0,11
1896994,1560393,2025-04-29,Senate,"Senate: THIRD READING",32,13,0,2,47
1897024,1486443,2025-02-11,Senate,"Senate: Education Committee: DO PASS",11,0,0,0,11
1897024,1498037,2025-02-24,Senate,"Senate: THIRD READING",47,0,0,0,47
1897024,1543485,2025-04-10,House,"House: Veterans and Military Affairs Committee: DO PASS",6,0,0,0,6
1897024,1568354,2025-05-08,House,"House: THIRD READING",87,4,0,7,98
1897024,1596229,2025-04-16,House,"House: Health and Human Services Oversight Committee: DO PASS",13,0,0,0,13
1897051,1499425,2025-02-25,Senate,"Senate: Education Committee: DO PASS AMENDED",11,0,0,0,11
1897051,1525227,2025-03-24,Senate,"Senate: THIRD READING",47,0,0,0,47
1897051,1538716,2025-04-07,House,"House: Appropriations and Budget General Government Subcommittee: DO PASS",7,0,0,0,7
1897051,1548532,2025-04-15,House,"House: Appropriations and Budget Committee: DO PASS AS AMENDED, STRIKE THE ENACTING CLAUSE",28,0,0,0,28
1897051,1556396,2025-04-24,House,"House: THIRD READING",76,5,0,17,98
1897051,1576600,2025-05-22,House,"House: FOURTH READING",78,5,0,15,98
1897051,1591623,2025-05-22,Senate,"Senate: FOURTH READING",46,0,0,2,48
1897051,1596227,2025-03-05,Senate,"Senate: Appropriations Committee: DO PASS AMENDED",22,0,1,0,23
1897159,1493965,2025-02-19,Senate,"Senate: Retirement & Government Resources Committee: DO PASS",8,0,0,0,8
1897159,1527987,2025-03-26,Senate,"Senate: THIRD READING",45,0,0,2,47
1897159,1540538,2025-04-08,House,"House: General Government Committee: DO PASS",8,0,0,0,8
1897159,1566877,2025-05-06,House,"House: THIRD READING",82,5,0,11,98
1897159,1566878,2025-05-06,House,"House: EMERGENCY",68,12,0,18,98
1897159,1596237,2025-04-17,House,"House: Government Oversight Committee: DO PASS",9,1,0,0,10
1897234,1491318,2025-02-17,Senate,"Senate: Revenue & Taxation Committee: DO PASS AMENDED",6,5,0,0,11
1897269,1504428,2025-03-04,Senate,"Senate: Public Safety Committee: DO PASS AMENDED",4,3,0,0,7
1897284,1493133,2025-02-19,Senate,"Senate: Public Safety Committee: DO PASS",6,0,0,0,6
1897284,1520108,2025-03-18,Senate,"Senate: THIRD READING",45,0,0,2,47
1897301,1485251,2025-02-10,Senate,"Senate: Aeronautics & Transportation Committee: DO PASS",12,0,0,0,12
1897301,1497465,2025-02-24,Senate,"Senate: THIRD READING",47,0,0,0,47
1897315,1486198,2025-02-11,Senate,"Senate: Public Safety Committee: DO PASS",8,0,0,0,8
1897315,1527598,2025-03-25,Senate,"Senate: THIRD READING",46,0,0,1,47
1897315,1542244,2025-04-09,House,"House: Appropriations and Budget Public Safety Subcommittee: DO PASS",10,1,0,0,11
1897315,1559535,2025-04-28,House,"House: THIRD READING",82,5,0,11,98
1897315,1596242,2025-04-15,House,"House: Appropriations and Budget Committee: DO PASS",29,1,0,0,30
1897328,1504198,2025-03-03,Senate,"Senate: Revenue & Taxation Committee: DO PASS",6,3,0,0,9
1897342,1484889,2025-02-10,Senate,"Senate: Finance Committee: DO PASS",6,4,0,0,10
1897342,1526734,2025-03-25,Senate,"Senate: THIRD READING",21,25,0,1,47
1897342,1596264,2025-03-27,Senate,"Senate: RECONSIDER",30,12,0,5,47
1897346,1484887,2025-02-10,Senate,"Senate: Finance Committee: DO PASS AMENDED CS",11,0,0,0,11
1897350,1484883,2025-02-10,Senate,"Senate: Finance Committee: DO PASS AMENDED",7,4,0,0,11
1897350,1516933,2025-03-13,Senate,"Senate: THIRD READING",43,1,0,3,47
1897350,1544097,2025-04-10,House,"House: Appropriations and Budget Finance Subcommittee: DO PASS",6,1,0,0,7
1897350,1550331,2025-04-16,House,"House: Appropriations and Budget Committee: DO PASS AS AMENDED, STRIKE THE ENACTING CLAUSE",25,2,0,0,27
1897350,1561208,2025-04-29,House,"House: THIRD READING",88,0,0,10,98
1897350,1576148,2025-05-22,House,"House: FOURTH READING",88,0,0,10,98
1897350,1591823,2025-05-22,Senate,"Senate: FOURTH READING",38,6,0,4,48
1897350,1596271,2025-02-26,Senate,"Senate: Appropriations Committee: DO PASS",19,3,0,0,22
1897361,1498768,2025-02-25,Senate,"Senate: Public Safety Committee: DO PASS",7,0,0,0,7
1897361,1511615,2025-03-10,Senate,"Senate: THIRD READING",45,0,0,2,47
1897361,1540510,2025-04-08,House,"House: Criminal Judiciary Committee: DO PASS",3,0,0,0,3
1897361,1559840,2025-04-29,House,"House: THIRD READING",83,0,0,15,98
1897361,1596281,2025-04-17,House,"House: Judiciary and Public Safety Oversight Committee: DO PASS",9,0,0,0,9
1897369,1484876,2025-02-10,Senate,"Senate: Finance Committee: DO PASS",11,0,0,0,11
1897369,1596266,2025-02-26,Senate,"Senate: Appropriations Committee: DO PASS AMENDED",22,0,0,0,22
1897379,1493127,2025-02-19,Senate,"Senate: Public Safety Committee: DO PASS AMENDED CS",6,2,0,0,8
1897379,1529116,2025-03-27,Senate,"Senate: THIRD READING",41,4,0,2,47
1897379,1539651,2025-04-08,House,"House: Criminal Judiciary Committee: DO PASS",4,0,0,0,4
1897379,1559188,2025-04-28,House,"House: THIRD READING",81,6,0,11,98
1897379,1581099,2025-05-29,Senate,"Senate: VETO OVERRIDE NO EMERGENCY",33,14,0,1,48
1897379,1581616,2025-05-29,House,"House: VETO OVERRIDE WITHOUT EMERGENCY",81,0,0,17,98
1897379,1596285,2025-04-17,House,"House: Judiciary and Public Safety Oversight Committee: DO PASS",11,1,0,0,12
1897385,1491338,2025-02-17,Senate,"Senate: Health & Human Services Committee: DO PASS",10,0,0,0,10
1897385,1514148,2025-03-11,Senate,"Senate: THIRD READING",43,0,0,4,47
1897385,1539123,2025-04-07,House,"House: Appropriations and Budget Health Subcommittee: DO PASS",4,0,0,0,4
1897385,1564410,2025-05-01,House,"House: THIRD READING",71,5,0,22,98
1897385,1596293,2025-02-20,Senate,"Senate: Appropriations Committee: DO PASS AMENDED",24,0,0,0,24
1897385,1596294,2025-04-15,House,"House: Appropriations and Budget Committee: DO PASS",28,0,0,0,28
1897393,1503894,2025-03-03,Senate,"Senate: Revenue & Taxation Committee: DO PASS",9,0,0,0,9
1897393,1596313,2025-03-05,Senate,"Senate: Appropriations Committee: DO PASS AMENDED",20,3,0,0,23
1897397,1493685,2025-02-19,Senate,"Senate: Education Committee: DO PASS AMENDED",12,0,0,0,12
1897405,1504311,2025-03-04,Senate,"Senate: Education Committee: DO PASS AMENDED",3,8,0,0,11
1897420,1484888,2025-02-10,Senate,"Senate: Finance Committee: DO PASS",11,0,0,0,11
1897420,1526427,2025-03-25,Senate,"Senate: THIRD READING",46,0,0,1,47
1897420,1545859,2025-04-10,House,"House: Appropriations and Budget Finance Subcommittee: DO PASS",6,1,0,0,7
1897420,1550543,2025-04-16,House,"House: Appropriations and Budget Committee: DO PASS AS AMENDED, STRIKE THE ENACTING CLAUSE",24,3,0,0,27
1897420,1562717,2025-04-30,House,"House: THIRD READING",54,34,0,10,98
1897420,1576323,2025-05-22,House,"House: FOURTH READING",51,34,0,13,98
1897420,1591414,2025-05-22,Senate,"Senate: FOURTH READING",38,6,0,4,48
1897420,1596307,2025-03-05,Senate,"Senate: Appropriations Committee: DO PASS AMENDED",20,0,0,0,20
1897427,1484543,2025-02-10,Senate,"Senate: Aeronautics & Transportation Committee: DO PASS",12,0,0,0,12
1897427,1527924,2025-03-26,Senate,"Senate: THIRD READING",44,0,0,3,47
1897427,1544067,2025-04-10,House,"House: Transportation Committee: DO PASS AS AMENDED BY CS",11,0,0,0,11
1897427,1560274,2025-04-29,House,"House: THIRD READING",87,0,0,11,98
1897427,1591530,2025-05-13,Senate,"Senate: FOURTH READING",43,0,0,4,47
1897427,1596318,2025-04-22,House,"House: Commerce and Economic Development Oversight Committee: DO PASS AS AMENDED BY CS",17,0,0,0,17
1897495,1493424,2025-02-19,Senate,"Senate: Public Safety Committee: DO PASS",8,0,0,0,8
1897556,1504032,2025-03-03,Senate,"Senate: Revenue & Taxation Committee: DO PASS AMENDED CS",5,5,0,0,10
1897568,1485241,2025-02-10,Senate,"Senate: Aeronautics & Transportation Committee: DO PASS",12,0,0,0,12
1897568,1498111,2025-02-24,Senate,"Senate: THIRD READING",47,0,0,0,47
1897582,1488085,2025-02-12,House,"House: Public Safety Committee: DO PASS",4,0,0,0,4
1897582,1501479,2025-02-27,House,"House: Judiciary and Public Safety Oversight Committee: DO PASS",12,1,0,0,13
1897582,1509767,2025-03-10,House,"House: THIRD READING",89,4,0,6,99
1897582,1547031,2025-04-14,Senate,"Senate: Aeronautics & Transportation Committee: DO PASS",10,1,0,0,11
1897582,1565615,2025-05-06,Senate,"Senate: THIRD READING",39,4,0,4,47
1897591,1499421,2025-02-25,Senate,"Senate: Retirement & Government Resources Committee: DO PASS AMENDED",8,0,0,0,8
1897591,1526748,2025-03-25,Senate,"Senate: THIRD READING",46,0,0,1,47
1897591,1541496,2025-04-09,House,"House: Government Modernization and Technology Committee: DO PASS",8,0,0,0,8
1897591,1551569,2025-04-17,House,"House: Commerce and Economic Development Oversight Committee: DO PASS AS AMENDED BY CS",15,1,0,0,16
1897591,1565203,2025-05-05,House,"House: THIRD READING",87,3,0,8,98
1897591,1591344,2025-05-15,Senate,"Senate: FOURTH READING",37,0,0,10,47
1897600,1487834,2025-02-12,House,"House: Public Safety Committee: DO PASS",4,0,0,0,4
1897600,1501480,2025-02-27,House,"House: Judiciary and Public Safety Oversight Committee: DO PASS",11,2,0,0,13
1897600,1516994,2025-03-13,House,"House: THIRD READING",80,4,0,15,99
1897600,1539307,2025-04-08,Senate,"Senate: Public Safety Committee: DO PASS",6,1,0,0,7
1897600,1567392,2025-05-07,Senate,"Senate: THIRD READING",38,0,0,9,47
1897600,1571262,2025-05-14,House,"House: FOURTH READING",77,8,0,13,98
1897626,1491071,2025-02-17,Senate,"Senate: Aeronautics & Transportation Committee: DO PASS AMENDED",12,0,0,0,12
1897717,1494364,2025-02-19,Senate,"Senate: Judiciary Committee: DO PASS",8,0,0,0,8
1897765,1499538,2025-02-25,Senate,"Senate: Public Safety Committee: DO PASS",8,0,0,0,8
1897765,1530076,2025-03-27,Senate,"Senate: THIRD READING",36,7,0,4,47
1897765,1540241,2025-04-08,House,"House: Criminal Judiciary Committee: DO PASS",4,0,0,0,4
1897765,1561244,2025-04-29,House,"House: THIRD READING",73,11,0,14,98
1897765,1596370,2025-04-22,House,"House: Judiciary and Public Safety Oversight Committee: DO PASS",8,2,0,0,10
1898146,1485167,2025-02-10,Senate,"Senate: Aeronautics & Transportation Committee: DO PASS AMENDED",12,0,0,0,12
1898168,1497742,2025-02-24,House,"House: Business Committee: DO PASS AS AMENDED BY CS",8,0,0,0,8
1898168,1504304,2025-03-04,House,"House: Commerce and Economic Development Oversight Committee: DO PASS AS AMENDED BY CS",16,0,0,0,16
1898168,1509502,2025-03-10,House,"House: THIRD READING",89,3,0,7,99
1898260,1501512,2025-02-27,Senate,"Senate: Energy Committee: DO PASS AMENDED CS",9,0,0,0,9
1898270,1498581,2025-02-25,Senate,"Senate: Public Safety Committee: DO PASS",8,0,0,0,8
1898270,1503408,2025-03-03,Senate,"Senate: THIRD READING",46,0,0,1,47
1898270,1541443,2025-04-09,House,"House: Public Safety Committee: DO PASS",7,0,0,0,7
1898270,1566805,2025-05-06,House,"House: THIRD READING",90,0,0,8,98
1898270,1596384,2025-04-17,House,"House: Judiciary and Public Safety Oversight Committee: DO PASS",12,0,0,0,12
1898275,1488926,2025-02-13,Senate,"Senate: Energy Committee: DO PASS AMENDED",11,0,0,0,11
1898275,1596406,2025-02-20,Senate,"Senate: Appropriations Committee: DO PASS AMENDED CS",19,5,0,0,24
1898281,1493446,2025-02-19,Senate,"Senate: Public Safety Committee: DO PASS AMENDED",5,2,0,0,7
1898284,1486129,2025-02-11,Senate,"Senate: Public Safety Committee: DO PASS",8,0,0,0,8
1898284,1519344,2025-03-17,Senate,"Senate: THIRD READING",44,0,0,3,47
1898284,1538625,2025-04-07,House,"House: Appropriations and Budget General Government Subcommittee: DO PASS",8,0,0,0,8
1898284,1549097,2025-04-15,House,"House: Appropriations and Budget Committee: DO PASS AS AMENDED, STRIKE THE ENACTING CLAUSE",27,0,0,0,27
1898284,1559011,2025-04-28,House,"House: THIRD READING",85,0,0,13,98
1898284,1576415,2025-05-22,House,"House: FOURTH READING",89,0,0,9,98
1898284,1591434,2025-05-22,Senate,"Senate: FOURTH READING",44,0,0,4,48
1898284,1596389,2025-02-20,Senate,"Senate: Appropriations Committee: DO PASS AMENDED",24,0,0,0,24
1898293,1488956,2025-02-13,Senate,"Senate: Energy Committee: DO PASS AMENDED",10,1,0,0,11
1898293,1527249,2025-03-26,Senate,"Senate: THIRD READING",45,0,0,2,47
1898293,1538606,2025-04-07,House,"House: Appropriations and Budget Natural Resources Subcommittee: DO PASS",10,0,0,0,10
1898293,1550263,2025-04-16,House,"House: Appropriations and Budget Committee: DO PASS AS AMENDED BY CS",24,1,0,0,25
1898293,1566662,2025-05-06,House,"House: THIRD READING",87,1,0,10,98
1898293,1591339,2025-05-19,Senate,"Senate: FOURTH READING",20,24,0,3,47
1898293,1596404,2025-03-05,Senate,"Senate: Appropriations Committee: DO PASS",23,0,0,0,23
1898329,1497586,2025-02-24,Senate,"Senate: Agriculture & Wildlife Committee: DO PASS AMENDED CS",12,0,0,0,12
1898329,1516060,2025-03-12,Senate,"Senate: THIRD READING",44,0,0,3,47
1898329,1541265,2025-04-08,House,"House: Agriculture Committee: DO PASS",7,1,0,0,8
1898329,1550025,2025-04-16,House,"House: Energy and Natural Resources Oversight Committee: DO PASS AS AMENDED BY CS",12,0,0,0,12
1898329,1564849,2025-05-05,House,"House: THIRD READING",76,16,1,5,98
1898346,1507093,2025-03-06,Senate,"Senate: Business & Insurance Committee: DO PASS",10,0,0,0,10
1898346,1527561,2025-03-26,Senate,"Senate: THIRD READING",44,0,0,3,47
1898346,1538340,2025-04-03,House,"House: Civil Judiciary Committee: DO PASS",8,2,0,0,10
1898346,1562368,2025-04-30,House,"House: THIRD READING",88,0,0,10,98
1898346,1596418,2025-04-22,House,"House: Judiciary and Public Safety Oversight Committee: DO PASS",8,0,0,0,8
1898351,1486006,2025-02-11,Senate,"Senate: Retirement & Insurance Committee: DO PASS AMENDED",7,1,0,0,8
1899724,1488843,2025-02-13,Senate,"Senate: Energy Committee: DO PASS AMENDED CS",11,0,0,0,11
1899724,1509178,2025-03-10,Senate,"Senate: THIRD READING",39,7,0,1,47
1899724,1533911,2025-04-02,House,"House: Energy Committee: DO PASS AS AMENDED BY CS",11,0,0,0,11
1899724,1566305,2025-05-06,House,"House: THIRD READING",82,1,0,15,98
1899724,1578906,2025-05-27,House,"House: FOURTH READING",81,4,0,13,98
1899724,1591564,2025-05-22,Senate,"Senate: FOURTH READING",36,8,0,4,48
1899724,1596183,2025-04-16,House,"House: Energy and Natural Resources Oversight Committee: DO PASS AS AMENDED BY CS",13,1,0,0,14
1899725,1497890,2025-02-24,Senate,"Senate: Agriculture & Wildlife Committee: DO PASS AMENDED CS",3,9,0,0,12
1899727,1497827,2025-02-24,Senate,"Senate: Agriculture & Wildlife Committee: DO PASS AMENDED CS",5,7,0,0,12
1899730,1501432,2025-02-27,Senate,"Senate: Business & Insurance Committee: DO PASS",11,0,0,0,11
1899730,1515780,2025-03-12,Senate,"Senate: THIRD READING",33,12,0,2,47
1899730,1539735,2025-04-08,House,"House: Business Committee: DO PASS",9,0,0,0,9
1899730,1560207,2025-04-29,House,"House: THIRD READING",45,42,0,11,98
1899730,1562710,2025-04-30,House,"House: RECONSIDER MEASURE",54,23,0,21,98
1899730,1596178,2025-04-17,House,"House: Commerce and Economic Development Oversight Committee: DO PASS",12,4,0,0,16
1899733,1494750,2025-02-20,Senate,"Senate: Business & Insurance Committee: DO PASS",8,2,0,0,10
1899733,1520171,2025-03-18,Senate,"Senate: THIRD READING",35,8,0,4,47
1899733,1539114,2025-04-07,House,"House: Appropriations and Budget Health Subcommittee: DO PASS",4,0,0,0,4
1899733,1548891,2025-04-15,House,"House: Oklahoma House of Representatives: DO PASS AS AMENDED, STRIKE THE E NACTING CLAUSE",28,0,0,0,28
1899733,1548892,2025-04-15,House,"House: Oklahoma House of Representatives: DO PASS AS AMENDED, STRIKE THE T ITLE AND ENACTING",28,0,0,0,28
1899733,1562052,2025-04-30,House,"House: THIRD READING",63,27,0,8,98
1899733,1575831,2025-05-22,House,"House: FOURTH READING",68,20,0,10,98
1899733,1591544,2025-05-21,Senate,"Senate: FOURTH READING",35,11,0,2,48
1899736,1505381,2025-03-04,Senate,"Senate: Judiciary Committee: DO PASS",8,0,0,0,8
1899736,1527791,2025-03-26,Senate,"Senate: THIRD READING",26,19,0,2,47
1899736,1543571,2025-04-10,House,"House: Civil Judiciary Committee: DO PASS",8,0,0,0,8
1899736,1559528,2025-04-28,House,"House: THIRD READING",51,35,1,11,98
1899736,1596182,2025-04-17,House,"House: Judiciary and Public Safety Oversight Committee: DO PASS",10,2,0,0,12
1899739,1504638,2025-03-04,Senate,"Senate: Public Safety Committee: DO PASS",5,1,0,0,6
1899754,1507562,2025-03-06,Senate,"Senate: Energy Committee: DO PASS AMENDED CS",10,1,0,0,11
1899754,1527888,2025-03-26,Senate,"Senate: THIRD READING",43,3,0,1,47
1899754,1539690,2025-04-08,House,"House: Agriculture Committee: DO PASS",5,3,0,0,8
1899754,1550046,2025-04-16,House,"House: Energy and Natural Resources Oversight Committee: DO PASS AS AMENDED BY CS",11,1,0,0,12
1899762,1499753,2025-02-25,Senate,"Senate: Economic Development, Workforce & Tourism Committee: DO PASS AMENDED",8,0,0,0,8
1899765,1484954,2025-02-10,Senate,"Senate: Aeronautics & Transportation Committee: DO PASS",11,1,0,0,12
1899765,1525341,2025-03-24,Senate,"Senate: THIRD READING",33,13,0,1,47
1899765,1596180,2025-02-26,Senate,"Senate: Appropriations Committee: DO PASS AMENDED",21,2,0,0,23
1899771,1485208,2025-02-10,Senate,"Senate: Aeronautics & Transportation Committee: DO PASS AMENDED",12,0,0,0,12
1899771,1490826,2025-02-17,Senate,"Senate: THIRD READING",42,3,0,2,47
1899771,1538385,2025-04-07,House,"House: Appropriations and Budget Transportation Subcommittee: DO PASS",8,0,0,0,8
1899771,1563588,2025-05-01,House,"House: ADVANCE FROM GENERAL ORDER",68,14,0,16,98
1899771,1596185,2025-04-16,House,"House: Appropriations and Budget Committee: DO PASS",25,1,0,0,26
1899773,1488669,2025-02-13,Senate,"Senate: Business & Insurance Committee: DO PASS",9,2,0,0,11
1899773,1596181,2025-02-20,Senate,"Senate: Appropriations Committee: DO PASS AMENDED",14,9,0,0,23
1899775,1488877,2025-02-13,Senate,"Senate: Energy Committee: DO PASS AMENDED CS",11,0,0,0,11
1899782,1507285,2025-03-06,Senate,"Senate: Energy Committee: DO PASS AMENDED CS",9,1,0,0,10
1899782,1526922,2025-03-25,Senate,"Senate: THIRD READING",45,0,0,2,47
1899782,1541368,2025-04-09,House,"House: Energy Committee: DO PASS AS AMENDED BY CS",12,0,0,0,12
1899782,1565121,2025-05-05,House,"House: THIRD READING",95,0,0,3,98
1899782,1576158,2025-05-22,House,"House: FOURTH READING",81,0,0,17,98
1899782,1591357,2025-05-21,Senate,"Senate: FOURTH READING",45,0,1,2,48
1899782,1596184,2025-04-23,House,"House: Energy and Natural Resources Oversight Committee: DO PASS AS AMENDED BY CS",14,0,0,0,14
1899788,1487007,2025-02-11,Senate,"Senate: Economic Development, Workforce & Tourism Committee: DO PASS",2,7,0,0,9
1899790,1483546,2025-02-06,House,"House: Civil Judiciary Committee: DO PASS",8,0,0,0,8
1899790,1504243,2025-03-04,House,"House: Judiciary and Public Safety Oversight Committee: DO PASS",12,0,0,0,12
1899790,1517015,2025-03-13,House,"House: THIRD READING",85,1,0,13,99
1899790,1539708,2025-04-08,Senate,"Senate: Retirement & Government Resources Committee: DO PASS",6,0,0,0,6
1899790,1559275,2025-04-28,Senate,"Senate: THIRD READING",41,2,0,4,47
1899795,1485242,2025-02-10,Senate,"Senate: Health & Human Services Committee: DO PASS",10,1,0,0,11
1899796,1488651,2025-02-13,Senate,"Senate: Business & Insurance Committee: DO PASS AMENDED CS",9,2,0,0,11
1899796,1525264,2025-03-24,Senate,"Senate: THIRD READING",29,18,0,0,47
1899796,1540095,2025-04-08,House,"House: Business Committee: DO PASS",1,8,0,0,9
1899799,1493656,2025-02-19,Senate,"Senate: Education Committee: DO PASS AMENDED",9,3,0,0,12
1899799,1514176,2025-03-11,Senate,"Senate: THIRD READING",35,10,0,2,47
1899799,1535324,2025-04-02,House,"House: Common Education Committee: DO PASS",6,5,0,0,11
1899799,1549902,2025-04-16,House,"House: Education Oversight Committee: DO PASS AS AMENDED BY CS",6,3,0,0,9
1899799,1559823,2025-04-29,House,"House: SUSPEND HOUSE RULES",73,13,0,12,98
1899799,1559824,2025-04-29,House,"House: THIRD READING",70,23,0,5,98
1899799,1591309,2025-05-13,Senate,"Senate: FOURTH READING",32,9,0,6,47
1899799,1596166,2025-03-05,Senate,"Senate: Appropriations Committee: DO PASS",18,6,0,0,24
1899799,1596167,2025-05-13,Senate,"Senate: AMENDMENT",32,9,0,6,47
1899805,1503313,2025-03-03,Senate,"Senate: Revenue & Taxation Committee: DO PASS AMENDED",8,2,0,0,10
1899806,1493425,2025-02-19,Senate,"Senate: Public Safety Committee: DO PASS",4,3,0,0,7
1899859,1486240,2025-02-11,Senate,"Senate: Public Safety Committee: DO PASS",8,0,0,0,8
1899859,1518404,2025-03-17,Senate,"Senate: THIRD READING",44,0,0,3,47
1899859,1541823,2025-04-09,House,"House: Appropriations and Budget Public Safety Subcommittee: DO PASS",11,0,0,0,11
1899859,1550176,2025-04-16,House,"House: Appropriations and Budget Committee: DO PASS AS AMENDED, STRIKE THE TITLE",27,0,0,0,27
1899859,1560774,2025-04-29,House,"House: THIRD READING",83,0,0,15,98
1899859,1576528,2025-05-22,House,"House: FOURTH READING",81,0,0,17,98
1899859,1591667,2025-05-22,Senate,"Senate: FOURTH READING",44,0,0,4,48
1899864,1499533,2025-02-25,Senate,"Senate: Judiciary Committee: DO PASS AMENDED CS",8,0,0,0,8
1899864,1518570,2025-03-17,Senate,"Senate: THIRD READING",42,3,0,2,47
1899864,1539661,2025-04-07,House,"House: Oklahoma House of Representatives: DO PASS",8,0,0,0,8
1899864,1539662,2025-04-07,House,"House: Oklahoma House of Representatives: DO PASS AS AMENDED BY CS",8,0,0,0,8
1899864,1565120,2025-05-05,House,"House: THIRD READING",90,0,0,8,98
1899864,1591383,2025-05-14,Senate,"Senate: FOURTH READING",36,3,0,8,47
1899864,1596188,2025-04-07,House,"House: Appropriations and Budget General Government Subcommittee: DO PASS",8,0,0,0,8
1899864,1596189,2025-04-07,House,"House: Appropriations and Budget General Government Subcommittee: DO PASS AS AMENDED BY CS",8,0,0,0,8
1899864,1596190,2025-04-16,House,"House: Appropriations and Budget Committee: DO PASS AS AMENDED BY CS",22,5,0,0,27
1899882,1485900,2025-02-11,Senate,"Senate: Education Committee: DO PASS AMENDED CS",7,5,0,0,12
1899882,1517199,2025-03-13,Senate,"Senate: THIRD READING",30,15,0,2,47
1899882,1542058,2025-04-09,House,"House: Common Education Committee: DO PASS",8,3,0,0,11
1899882,1560537,2025-04-29,House,"House: THIRD READING",51,39,0,8,98
1899882,1560538,2025-04-29,House,"House: EMERGENCY",47,35,0,16,98
1899882,1596186,2025-04-16,House,"House: Education Oversight Committee: DO PASS",9,0,0,0,9
1899887,1486417,2025-02-11,Senate,"Senate: Education Committee: DO PASS AMENDED",10,0,0,0,10
1899887,1518700,2025-03-17,Senate,"Senate: THIRD READING",45,0,0,2,47
1899887,1538014,2025-04-07,House,"House: Appropriations and Budget Education Subcommittee: DO PASS",10,0,0,0,10
1899887,1548478,2025-04-15,House,"House: Appropriations and Budget Committee: DO PASS AS AMENDED, STRIKE THE ENACTING CLAUSE",29,0,0,0,29
1899887,1565775,2025-05-06,House,"House: THIRD READING",89,1,0,8,98
1899887,1579952,2025-05-28,House,"House: FOURTH READING",69,17,0,12,98
1899887,1591485,2025-05-28,Senate,"Senate: FOURTH READING",35,12,0,1,48
1899887,1596187,2025-02-20,Senate,"Senate: Appropriations Committee: DO PASS",23,0,0,0,23
1899899,1498919,2025-02-25,Senate,"Senate: Education Committee: DO PASS AMENDED",8,2,0,0,10
1899983,1490762,2025-02-17,Senate,"Senate: Aeronautics & Transportation Committee: DO PASS AMENDED",11,1,0,0,12
1899990,1486474,2025-02-11,Senate,"Senate: Retirement & Insurance Committee: DO PASS AMENDED",8,0,0,0,8
1900002,1485265,2025-02-10,Senate,"Senate: Health & Human Services Committee: DO PASS",7,3,0,0,10
1900009,1486094,2025-02-11,Senate,"Senate: Retirement & Insurance Committee: DO PASS AMENDED CS",8,0,0,0,8
1900016,1489108,2025-02-13,Senate,"Senate: Veterans & Military Affairs Committee: DO PASS AMENDED CS",7,2,0,0,9
1900019,1499141,2025-02-25,Senate,"Senate: Education Committee: DO PASS AMENDED",8,1,0,0,9
1900019,1525585,2025-03-24,Senate,"Senate: THIRD READING",34,12,0,1,47
1900019,1596192,2025-03-05,Senate,"Senate: Appropriations Committee: DO PASS",20,1,0,0,21
1900025,1489026,2025-02-13,Senate,"Senate: Energy Committee: DO PASS",5,4,0,0,9
1900026,1501436,2025-02-27,Senate,"Senate: Business & Insurance Committee: DO PASS AMENDED",11,0,0,0,11
1900026,1527860,2025-03-26,Senate,"Senate: THIRD READING",33,13,0,1,47
1900026,1540779,2025-04-08,House,"House: Insurance Committee: DO PASS",5,0,0,0,5
1900026,1565373,2025-05-05,House,"House: THIRD READING",74,15,0,9,98
1900026,1576261,2025-05-22,House,"House: FOURTH READING",65,25,0,8,98
1900026,1591341,2025-05-21,Senate,"Senate: FOURTH READING",30,16,0,2,48
1900026,1596191,2025-04-22,House,"House: Commerce and Economic Development Oversight Committee: DO PASS",17,0,0,0,17
1900037,1489186,2025-02-13,Senate,"Senate: Business & Insurance Committee: DO PASS AMENDED CS",4,6,0,0,10
1900049,1504716,2025-03-04,Senate,"Senate: Judiciary Committee: DO PASS AMENDED CS",8,0,0,0,8
1900049,1515237,2025-03-11,Senate,"Senate: THIRD READING",45,0,0,2,47
1900049,1539119,2025-04-03,House,"House: Civil Judiciary Committee: DO PASS",10,0,0,0,10
1900049,1567179,2025-05-07,House,"House: THIRD READING",89,0,0,9,98
1900049,1596194,2025-04-17,House,"House: Judiciary and Public Safety Oversight Committee: DO PASS",12,0,0,0,12
1900051,1494649,2025-02-20,Senate,"Senate: Business & Insurance Committee: DO PASS AMENDED",10,0,0,0,10
1900054,1486728,2025-02-11,Senate,"Senate: Retirement & Insurance Committee: DO PASS AMENDED",8,0,0,0,8
1900067,1488671,2025-02-13,Senate,"Senate: Business & Insurance Committee: DO PASS",6,5,0,0,11
1900068,1493492,2025-02-19,Senate,"Senate: Retirement & Government Resources Committee: DO PASS AMENDED",7,1,0,0,8
1900068,1530115,2025-03-27,Senate,"Senate: THIRD READING",36,8,0,3,47
1900075,1493131,2025-02-19,Senate,"Senate: Retirement & Government Resources Committee: DO PASS AMENDED CS",8,0,0,0,8
1900084,1507132,2025-03-06,Senate,"Senate: Business & Insurance Committee: DO PASS",10,0,0,0,10
1900097,1503325,2025-03-03,Senate,"Senate: Revenue & Taxation Committee: DO PASS AMENDED CS",9,0,0,0,9
1900097,1527680,2025-03-26,Senate,"Senate: THIRD READING",45,0,0,2,47
1900097,1544024,2025-04-10,House,"House: Appropriations and Budget Finance Subcommittee: DO PASS",7,0,0,0,7
1900097,1565218,2025-05-05,House,"House: THIRD READING",79,12,0,7,98
1900097,1596193,2025-04-16,House,"House: Appropriations and Budget Committee: DO PASS",27,0,0,0,27
1900106,1506395,2025-03-05,Senate,"Senate: Appropriations Committee: DO PASS AMENDED",22,1,0,0,23
1900106,1513184,2025-03-11,Senate,"Senate: THIRD READING",29,13,0,5,47
1900106,1539197,2025-04-07,House,"House: Appropriations and Budget General Government Subcommittee: DO PASS AS AMENDED BY CS",4,1,0,0,5
1900106,1549216,2025-04-15,House,"House: Appropriations and Budget Committee: DO PASS AS AMENDED, STRIKE THE ENACTING CLAUSE",26,2,0,0,28
1900106,1567373,2025-05-07,House,"House: THIRD READING",84,6,0,8,98
1900106,1591332,2025-05-13,Senate,"Senate: FOURTH READING",41,2,0,4,47
1900189,1487127,2025-02-11,House,"House: Administrative Rules Committee: DO PASS AS AMENDED BY CS",11,0,0,0,11
1900189,1498829,2025-02-25,House,"House: THIRD READING",87,0,0,12,99
1900189,1536414,2025-04-03,Senate,"Senate: Administrative Rules Committee: DO PASS",6,0,0,0,6
1900189,1568001,2025-05-07,Senate,"Senate: THIRD READING",32,8,0,7,47
1900190,1486409,2025-02-11,House,"House: Administrative Rules Committee: DO PASS AS AMENDED BY CS",11,0,0,0,11
1900190,1498571,2025-02-25,House,"House: THIRD READING",88,0,0,11,99
1900190,1536431,2025-04-03,Senate,"Senate: Administrative Rules Committee: DO PASS",6,0,0,0,6
1900190,1552810,2025-04-21,Senate,"Senate: THIRD READING",41,5,0,1,47
1900194,1493318,2025-02-19,Senate,"Senate: Education Committee: DO PASS",9,1,0,0,10
1900201,1505307,2025-03-04,Senate,"Senate: Judiciary Committee: DO PASS",3,5,0,0,8
1900202,1503089,2025-03-03,Senate,"Senate: Agriculture & Wildlife Committee: DO PASS AMENDED CS",12,0,0,0,12
1900202,1527771,2025-03-26,Senate,"Senate: THIRD READING",45,0,0,2,47
1900202,1538389,2025-04-07,House,"House: Wildlife Committee: DO PASS",6,0,0,0,6
1900202,1568042,2025-05-08,House,"House: THIRD READING",53,35,0,10,98
1900202,1596199,2025-04-23,House,"House: Energy and Natural Resources Oversight Committee: DO PASS",11,3,0,0,14
1900212,1503292,2025-03-03,Senate,"Senate: Revenue & Taxation Committee: DO PASS",10,0,0,0,10
1900217,1503553,2025-03-03,Senate,"Senate: Health & Human Services Committee: DO PASS",11,0,0,0,11
1900217,1509041,2025-03-10,Senate,"Senate: THIRD READING",46,0,0,1,47
1900217,1538835,2025-04-07,House,"House: Appropriations and Budget Health Subcommittee: DO PASS",4,0,0,0,4
1900217,1567560,2025-05-07,House,"House: THIRD READING",79,0,0,19,98
1900217,1596214,2025-04-15,House,"House: Appropriations and Budget Committee: DO PASS",28,0,0,0,28
1900219,1486028,2025-02-11,House,"House: Administrative Rules Committee: DO PASS AS AMENDED BY CS",10,0,0,0,10
1900219,1498094,2025-02-24,House,"House: THIRD READING",96,0,0,3,99
1900219,1537091,2025-04-03,Senate,"Senate: Administrative Rules Committee: DO PASS",6,0,0,0,6
1900219,1567404,2025-05-07,Senate,"Senate: THIRD READING",33,4,0,10,47
1900224,1499516,2025-02-25,Senate,"Senate: Economic Development, Workforce & Tourism Committee: DO PASS",9,0,0,0,9
1900224,1515771,2025-03-12,Senate,"Senate: THIRD READING",26,17,0,4,47
1900224,1540215,2025-04-08,House,"House: Business Committee: DO PASS AS AMENDED BY CS",7,2,0,0,9
1900224,1565000,2025-05-05,House,"House: THIRD READING",74,19,0,5,98
1900224,1591373,2025-05-15,Senate,"Senate: FOURTH READING",33,6,0,8,47
1900224,1596212,2025-04-22,House,"House: Commerce and Economic Development Oversight Committee: DO PASS AS AMENDED BY CS",14,3,0,0,17
1900228,1486395,2025-02-11,House,"House: Administrative Rules Committee: DO PASS AS AMENDED BY CS",11,0,0,0,11
1900228,1497441,2025-02-24,House,"House: THIRD READING",96,0,0,3,99
1900228,1536383,2025-04-03,Senate,"Senate: Administrative Rules Committee: DO PASS",6,0,0,0,6
1900228,1568011,2025-05-07,Senate,"Senate: THIRD READING",31,9,0,7,47
1900231,1498830,2025-02-25,Senate,"Senate: Economic Development, Workforce & Tourism Committee: DO PASS AMENDED",8,1,0,0,9
1900231,1516948,2025-03-13,Senate,"Senate: THIRD READING",38,6,0,3,47
1900231,1538281,2025-04-07,House,"House: Appropriations and Budget General Government Subcommittee: DO PASS",5,2,0,0,7
1900231,1550378,2025-04-16,House,"House: Appropriations and Budget Committee: DO PASS AS AMENDED, STRIKE THE ENACTING CLAUSE",27,0,0,0,27
1900231,1566014,2025-05-06,House,"House: THIRD READING",45,42,0,11,98
1900231,1567840,2025-05-07,House,"House: RECONSIDER MEASURE",54,27,0,17,98
1900231,1576220,2025-05-22,House,"House: FOURTH READING",51,30,0,17,98
1900231,1591378,2025-05-22,Senate,"Senate: FOURTH READING",36,8,0,4,48
1900231,1596200,2025-03-05,Senate,"Senate: Appropriations Committee: DO PASS AMENDED CS",19,2,0,0,21
1900236,1499549,2025-02-25,Senate,"Senate: Judiciary Committee: DO PASS AMENDED CS",7,0,0,0,7
1900244,1486634,2025-02-11,Senate,"Senate: Economic Development, Workforce & Tourism Committee: DO PASS",9,0,0,0,9
1900244,1527785,2025-03-26,Senate,"Senate: THIRD READING",43,3,0,1,47
1900244,1538849,2025-04-07,House,"House: Tourism Committee: DO PASS",5,0,0,0,5
1900244,1561257,2025-04-29,House,"House: THIRD READING",59,26,0,13,98
1900244,1596210,2025-03-03,Senate,"Senate: Revenue & Taxation Committee: DO PASS",6,4,0,0,10
1900244,1596211,2025-04-15,House,"House: Commerce and Economic Development Oversight Committee: DO PASS",14,3,0,0,17
1900248,1493557,2025-02-19,Senate,"Senate: Education Committee: DO PASS AMENDED CS",10,0,0,0,10
1900248,1517098,2025-03-13,Senate,"Senate: THIRD READING",34,10,0,3,47
1900248,1538163,2025-04-07,House,"House: Appropriations and Budget Education Subcommittee: DO PASS",8,2,0,0,10
1900248,1550341,2025-04-16,House,"House: Appropriations and Budget Committee: DO PASS AS AMENDED, STRIKE THE ENACTING CLAUSE",26,2,0,0,28
1900248,1566300,2025-05-06,House,"House: THIRD READING",59,28,0,11,98
1900248,1576398,2025-05-22,House,"House: FOURTH READING",51,29,0,18,98
1900248,1591696,2025-05-22,Senate,"Senate: FOURTH READING",34,10,0,4,48
1900248,1596201,2025-02-26,Senate,"Senate: Appropriations Committee: DO PASS",22,0,0,0,22
1900250,1490922,2025-02-17,Senate,"Senate: Health & Human Services Committee: DO PASS AMENDED",11,0,0,0,11
1900250,1515791,2025-03-12,Senate,"Senate: THIRD READING",42,1,0,4,47
1900250,1540451,2025-04-08,House,"House: Insurance Committee: DO PASS",7,0,0,0,7
1900250,1563385,2025-05-01,House,"House: THIRD READING",78,6,0,14,98
1900250,1596197,2025-04-17,House,"House: Commerce and Economic Development Oversight Committee: DO PASS",16,0,0,0,16
1900252,1493660,2025-02-19,Senate,"Senate: Economic Development, Workforce & Tourism Committee: DO PASS",8,1,0,0,9
1900252,1526891,2025-03-25,Senate,"Senate: THIRD READING",33,13,0,1,47
1900252,1538057,2025-04-07,House,"House: Appropriations and Budget Education Subcommittee: DO PASS",7,3,0,0,10
1900252,1550369,2025-04-16,House,"House: Appropriations and Budget Committee: DO PASS AS AMENDED, STRIKE THE ENACTING CLAUSE",24,4,0,0,28
1900252,1560752,2025-04-29,House,"House: THIRD READING",35,56,0,7,98
1900252,1563799,2025-05-01,House,"House: RECONSIDER MEASURE",51,34,0,13,98
1900252,1563800,2025-05-01,House,"House: ADOPT MOTION",51,32,0,15,98
1900252,1591719,2025-05-21,Senate,"Senate: FOURTH READING",23,21,0,4,48
1900252,1596204,2025-03-05,Senate,"Senate: Appropriations Committee: DO PASS AMENDED",21,2,0,0,23
1900256,1506556,2025-03-05,Senate,"Senate: Appropriations Committee: DO PASS AMENDED",23,0,0,0,23
1900256,1526158,2025-03-25,Senate,"Senate: THIRD READING",45,0,0,2,47
1900256,1538450,2025-04-07,House,"House: Appropriations and Budget Transportation Subcommittee: DO PASS AS AMENDED BY CS",8,0,0,0,8
1900256,1548637,2025-04-15,House,"House: Appropriations and Budget Committee: DO PASS AS AMENDED, STRIKE THE ENACTING CLAUSE",28,0,0,0,28
1900256,1561320,2025-04-29,House,"House: THIRD READING",88,0,0,10,98
1900259,1487049,2025-02-11,House,"House: Administrative Rules Committee: DO PASS AS AMENDED BY CS",11,0,0,0,11
1900259,1497957,2025-02-24,House,"House: THIRD READING",97,0,0,2,99
1900259,1537034,2025-04-03,Senate,"Senate: Administrative Rules Committee: DO PASS",6,0,0,0,6
1900259,1552814,2025-04-21,Senate,"Senate: THIRD READING",45,0,0,2,47
1900262,1491333,2025-02-17,Senate,"Senate: Revenue & Taxation Committee: DO PASS AMENDED CS",11,0,0,0,11
1900262,1519186,2025-03-17,Senate,"Senate: THIRD READING",36,9,0,2,47
1900262,1538791,2025-04-07,House,"House: Appropriations and Budget Education Subcommittee: DO PASS",10,0,0,0,10
1900262,1596207,2025-02-20,Senate,"Senate: Appropriations Committee: DO PASS AMENDED",23,0,0,0,23
1900264,1486397,2025-02-11,Senate,"Senate: Economic Development, Workforce & Tourism Committee: DO PASS",9,0,0,0,9
1900264,1596209,2025-02-26,Senate,"Senate: Appropriations Committee: DO PASS AMENDED",20,0,0,0,20
1900273,1486517,2025-02-11,Senate,"Senate: Education Committee: DO PASS AMENDED",10,0,0,0,10
1900275,1493520,2025-02-19,Senate,"Senate: Education Committee: DO PASS AMENDED",9,2,0,0,11
1900275,1527573,2025-03-26,Senate,"Senate: THIRD READING",46,0,0,1,47
1900275,1538127,2025-04-07,House,"House: Appropriations and Budget Education Subcommittee: DO PASS",8,2,0,0,10
1900275,1549946,2025-04-16,House,"House: Appropriations and Budget Committee: DO PASS AS AMENDED BY CS",27,0,0,0,27
1900275,1560319,2025-04-29,House,"House: THIRD READING",75,12,0,11,98
1900275,1596208,2025-03-05,Senate,"Senate: Appropriations Committee: DO PASS",24,0,0,0,24
1900278,1485322,2025-02-10,Senate,"Senate: Health & Human Services Committee: DO PASS AMENDED",11,0,0,0,11
1900278,1528962,2025-03-27,Senate,"Senate: THIRD READING",30,17,0,0,47
1900278,1542338,2025-04-09,House,"House: Children, Youth and Family Services Committee: DO PASS",5,0,0,0,5
1900278,1552781,2025-04-21,House,"House: Health and Human Services Oversight Committee: DO PASS AS AMENDED, STRIKE THE ENACTING CLAUSE",13,0,0,0,13
1900278,1567327,2025-05-07,House,"House: THIRD READING",78,11,0,9,98
1900278,1580040,2025-05-28,House,"House: FOURTH READING",79,13,0,6,98
1900278,1591577,2025-05-28,Senate,"Senate: FOURTH READING",31,14,0,3,48
1900278,1596198,2025-02-20,Senate,"Senate: Appropriations Committee: DO PASS AMENDED",20,2,0,0,22
1900279,1505789,2025-03-05,House,"House: Administrative Rules Committee: DO PASS AS AMENDED BY CS",15,0,0,0,15
1900279,1516087,2025-03-12,House,"House: THIRD READING",88,0,0,11,99
1900279,1544295,2025-04-10,Senate,"Senate: Energy Committee: DO PASS",8,1,0,0,9
1900279,1552582,2025-04-21,Senate,"Senate: THIRD READING",45,0,0,2,47
1900286,1486401,2025-02-11,Senate,"Senate: Judiciary Committee: DO PASS",8,0,0,0,8
1900286,1503900,2025-03-03,Senate,"Senate: THIRD READING",46,0,0,1,47
1900286,1538963,2025-04-03,House,"House: Civil Judiciary Committee: DO PASS",10,0,0,0,10
1900286,1560931,2025-04-29,House,"House: THIRD READING",87,0,0,11,98
1900286,1596196,2025-04-17,House,"House: Judiciary and Public Safety Oversight Committee: DO PASS",12,0,0,0,12
1900289,1505137,2025-03-04,Senate,"Senate: Economic Development, Workforce & Tourism Committee: DO PASS AMENDED",7,0,0,0,7
1900293,1486670,2025-02-11,House,"House: Administrative Rules Committee: DO PASS AS AMENDED BY CS",11,0,0,0,11
1900293,1497442,2025-02-24,House,"House: THIRD READING",97,0,0,2,99
1900293,1536420,2025-04-03,Senate,"Senate: Administrative Rules Committee: DO PASS",6,0,0,0,6
1900293,1552586,2025-04-21,Senate,"Senate: THIRD READING",42,4,0,1,47
1900298,1493792,2025-02-19,Senate,"Senate: Judiciary Committee: DO PASS AMENDED",2,6,0,0,8
1900301,1493257,2025-02-19,Senate,"Senate: Education Committee: DO PASS AMENDED",10,0,0,0,10
1900301,1527646,2025-03-26,Senate,"Senate: THIRD READING",40,6,0,1,47
1900301,1538142,2025-04-07,House,"House: Appropriations and Budget Education Subcommittee: DO PASS",8,2,0,0,10
1900301,1549293,2025-04-15,House,"House: Appropriations and Budget Committee: DO PASS AS AMENDED, STRIKE THE ENACTING CLAUSE",28,2,0,0,30
1900301,1560240,2025-04-29,House,"House: THIRD READING",62,19,0,17,98
1900301,1596202,2025-02-26,Senate,"Senate: Appropriations Committee: DO PASS AMENDED CS",21,1,0,0,22
1900306,1493618,2025-02-19,Senate,"Senate: Education Committee: DO PASS AMENDED",10,0,0,0,10
1900306,1526496,2025-03-25,Senate,"Senate: THIRD READING",41,6,0,0,47
1900306,1538559,2025-04-07,House,"House: Appropriations and Budget Education Subcommittee: DO PASS",10,0,0,0,10
1900306,1550270,2025-04-16,House,"House: Appropriations and Budget Committee: DO PASS AS AMENDED, STRIKE THE ENACTING CLAUSE",27,0,0,0,27
1900306,1559966,2025-04-29,House,"House: THIRD READING",77,10,0,11,98
1900306,1580056,2025-05-28,House,"House: FOURTH READING",79,13,0,6,98
1900306,1591375,2025-05-28,Senate,"Senate: FOURTH READING",36,10,0,2,48
1900306,1596206,2025-03-05,Senate,"Senate: Appropriations Committee: DO PASS",21,0,0,0,21
1900309,1485532,2025-02-10,Senate,"Senate: Health & Human Services Committee: DO PASS",11,1,0,0,12
1900309,1519176,2025-03-17,Senate,"Senate: THIRD READING",45,0,0,2,47
1900309,1539087,2025-04-07,House,"House: Appropriations and Budget Health Subcommittee: DO PASS",4,0,0,0,4
1900309,1567680,2025-05-07,House,"House: THIRD READING",87,6,0,5,98
1900309,1596213,2025-04-15,House,"House: Appropriations and Budget Committee: DO PASS",29,0,0,0,29
1900312,1493422,2025-02-19,Senate,"Senate: Public Safety Committee: DO PASS AMENDED CS",6,0,0,0,6
1900312,1505174,2025-03-04,Senate,"Senate: THIRD READING",44,0,0,3,47
1900312,1541640,2025-04-09,House,"House: Public Safety Committee: DO PASS",7,0,0,0,7
1900312,1566465,2025-05-06,House,"House: THIRD READING",92,0,0,6,98
1900312,1596203,2025-04-17,House,"House: Judiciary and Public Safety Oversight Committee: DO PASS",12,0,0,0,12
1900315,1503311,2025-03-03,Senate,"Senate: Revenue & Taxation Committee: DO PASS",5,5,0,0,10
1900317,1498994,2025-02-25,Senate,"Senate: Education Committee: DO PASS AMENDED",6,3,0,0,9
1900317,1528981,2025-03-27,Senate,"Senate: THIRD READING",34,13,0,0,47
1900317,1538339,2025-04-07,House,"House: Appropriations and Budget Education Subcommittee: DO PASS AS AMENDED BY CS",8,3,0,0,11
1900317,1549247,2025-04-15,House,"House: Appropriations and Budget Committee: DO PASS AS AMENDED, STRIKE THE ENACTING CLAUSE",25,5,0,0,30
1900318,1497688,2025-02-24,Senate,"Senate: Revenue & Taxation Committee: DO PASS",7,4,0,0,11
1900318,1596205,2025-03-05,Senate,"Senate: Appropriations Committee: DO PASS AMENDED",22,1,0,0,23
1900323,1501361,2025-02-27,Senate,"Senate: Energy Committee: DO PASS AMENDED CS",10,0,0,0,10
1900323,1519201,2025-03-17,Senate,"Senate: THIRD READING",27,18,0,2,47
1900323,1534115,2025-04-02,House,"House: Energy Committee: DO PASS",12,0,0,0,12
1900323,1549744,2025-04-16,House,"House: Energy and Natural Resources Oversight Committee: DO PASS AS AMENDED BY CS",13,1,0,0,14
1900323,1563807,2025-05-01,House,"House: THIRD READING",73,12,1,12,98
1900323,1591445,2025-05-13,Senate,"Senate: FOURTH READING",27,15,0,5,47
1900323,1596218,2025-03-05,Senate,"Senate: Appropriations Committee: DO PASS AMENDED",21,2,0,0,23
1900325,1484613,2025-02-10,Senate,"Senate: Agriculture & Rural Affairs Committee: DO PASS",7,2,0,0,9
1900327,1486993,2025-02-11,Senate,"Senate: Judiciary Committee: DO PASS AMENDED CS",6,2,0,0,8
1900334,1489173,2025-02-13,Senate,"Senate: Business & Insurance Committee: DO PASS",6,4,0,0,10
1900338,1484900,2025-02-10,Senate,"Senate: Agriculture & Rural Affairs Committee: DO PASS",11,0,0,0,11
1900338,1526635,2025-03-25,Senate,"Senate: THIRD READING",43,0,0,4,47
1900338,1540129,2025-04-08,House,"House: Agriculture Committee: DO PASS",8,0,0,0,8
1900338,1566396,2025-05-06,House,"House: THIRD READING",87,1,0,10,98
1900338,1596215,2025-03-05,Senate,"Senate: Appropriations Committee: DO PASS AMENDED",21,0,0,0,21
1900338,1596216,2025-04-16,House,"House: Energy and Natural Resources Oversight Committee: DO PASS",11,1,0,0,12
1900339,1495085,2025-02-20,Senate,"Senate: Energy Committee: DO PASS",10,1,0,0,11
1900339,1520563,2025-03-18,Senate,"Senate: THIRD READING",42,0,0,5,47
1900351,1495261,2025-02-20,Senate,"Senate: Energy Committee: DO PASS",10,1,0,0,11
1900351,1596217,2025-02-26,Senate,"Senate: Appropriations Committee: DO PASS AMENDED",19,2,0,0,21
1900352,1484885,2025-02-10,Senate,"Senate: Finance Committee: DO PASS",11,0,0,0,11
1900352,1513254,2025-03-11,Senate,"Senate: THIRD READING",43,0,0,4,47
1900352,1538634,2025-04-07,House,"House: Appropriations and Budget General Government Subcommittee: DO PASS",7,1,0,0,8
1900352,1562355,2025-04-30,House,"House: THIRD READING",88,0,0,10,98
1900352,1596225,2025-04-15,House,"House: Appropriations and Budget Committee: DO PASS",27,0,0,0,27
1900357,1497654,2025-02-24,Senate,"Senate: Revenue & Taxation Committee: DO PASS AMENDED CS",8,3,0,0,11
1900357,1526418,2025-03-25,Senate,"Senate: THIRD READING",44,1,0,2,47
1900357,1544041,2025-04-10,House,"House: Appropriations and Budget Finance Subcommittee: DO PASS",7,0,0,0,7
1900357,1550257,2025-04-16,House,"House: Appropriations and Budget Committee: DO PASS AS AMENDED, STRIKE THE ENACTING CLAUSE",23,3,0,0,26
1900357,1596226,2025-03-05,Senate,"Senate: Appropriations Committee: DO PASS AMENDED",22,0,0,0,22
1900358,1498265,2025-02-24,Senate,"Senate: Revenue & Taxation Committee: DO PASS",9,2,0,0,11
1900358,1526537,2025-03-25,Senate,"Senate: THIRD READING",37,8,0,2,47
1900358,1544099,2025-04-10,House,"House: Appropriations and Budget Finance Subcommittee: DO PASS",5,2,0,0,7
1900358,1596222,2025-03-05,Senate,"Senate: Appropriations Committee: DO PASS AMENDED",18,4,0,0,22
1900361,1505167,2025-03-04,Senate,"Senate: Economic Development, Workforce & Tourism Committee: DO PASS AMENDED CS",8,1,0,0,9
1900363,1497619,2025-02-24,Senate,"Senate: Revenue & Taxation Committee: DO PASS AMENDED",11,0,0,0,11
1900371,1484869,2025-02-10,Senate,"Senate: Finance Committee: DO PASS",8,3,0,0,11
1900371,1497624,2025-02-24,Senate,"Senate: THIRD READING",33,13,0,1,47
1900371,1544776,2025-04-10,House,"House: Appropriations and Budget Finance Subcommittee: DO PASS AS AMENDED BY CS",5,2,0,0,7
1900371,1565372,2025-05-05,House,"House: THIRD READING",69,22,0,7,98
1900371,1576419,2025-05-22,House,"House: FOURTH READING",60,17,0,21,98
1900371,1591604,2025-05-22,Senate,"Senate: FOURTH READING",32,13,0,3,48
1900371,1596220,2025-04-16,House,"House: Appropriations and Budget Committee: DO PASS AS AMENDED BY CS",26,2,0,0,28
1900373,1503887,2025-03-03,Senate,"Senate: Revenue & Taxation Committee: DO PASS",9,0,0,0,9
1900373,1526802,2025-03-25,Senate,"Senate: THIRD READING",37,7,0,3,47
1900373,1543573,2025-04-10,House,"House: Appropriations and Budget Finance Subcommittee: DO PASS",6,1,0,0,7
1900373,1550224,2025-04-16,House,"House: Appropriations and Budget Committee: DO PASS AS AMENDED, STRIKE THE ENACTING CLAUSE",23,5,0,0,28
1900373,1567492,2025-05-07,House,"House: THIRD READING",80,13,0,5,98
1900373,1596223,2025-03-05,Senate,"Senate: Appropriations Committee: DO PASS AMENDED",21,3,0,0,24
1900375,1484877,2025-02-10,Senate,"Senate: Finance Committee: DO PASS AMENDED",10,1,0,0,11
1900375,1509258,2025-03-10,Senate,"Senate: THIRD READING",46,0,0,1,47
1900375,1539642,2025-04-08,House,"House: General Government Committee: DO PASS",7,0,0,0,7
1900375,1564106,2025-05-01,House,"House: THIRD READING",82,1,0,15,98
1900375,1596224,2025-04-15,House,"House: Government Oversight Committee: DO PASS",15,0,0,0,15
1900378,1486548,2025-02-11,Senate,"Senate: Economic Development, Workforce & Tourism Committee: DO PASS",6,3,0,0,9
1900381,1484874,2025-02-10,Senate,"Senate: Finance Committee: DO PASS AMENDED",11,0,0,0,11
1900381,1526869,2025-03-25,Senate,"Senate: THIRD READING",45,0,0,2,47
1900381,1543799,2025-04-10,House,"House: Appropriations and Budget Finance Subcommittee: DO PASS",6,1,0,0,7
1900381,1596221,2025-02-20,Senate,"Senate: Appropriations Committee: DO PASS",22,1,0,0,23
1900385,1491397,2025-02-17,Senate,"Senate: Revenue & Taxation Committee: DO PASS",7,4,0,0,11
1900385,1518662,2025-03-17,Senate,"Senate: THIRD READING",45,0,0,2,47
1900385,1538199,2025-04-07,House,"House: Appropriations and Budget Education Subcommittee: DO PASS",10,0,0,0,10
1900385,1561261,2025-04-29,House,"House: THIRD READING",84,3,0,11,98
1900385,1596219,2025-04-16,House,"House: Appropriations and Budget Committee: DO PASS",28,0,0,0,28
1900388,1487806,2025-02-12,House,"House: Public Safety Committee: DO PASS",4,0,0,0,4
1900481,1503308,2025-03-03,Senate,"Senate: Revenue & Taxation Committee: DO PASS AMENDED",6,4,0,0,10
1900481,1527197,2025-03-25,Senate,"Senate: THIRD READING",33,11,0,3,47
1900481,1543572,2025-04-10,House,"House: Appropriations and Budget Finance Subcommittee: DO PASS",5,2,0,0,7
1900481,1550231,2025-04-16,House,"House: Appropriations and Budget Committee: DO PASS AS AMENDED, STRIKE THE ENACTING CLAUSE",22,4,0,0,26
1900481,1566416,2025-05-06,House,"House: THIRD READING",65,23,0,10,98
1900481,1576559,2025-05-22,House,"House: FOURTH READING",59,24,0,15,98
1900481,1581193,2025-05-29,Senate,"Senate: VETO OVERRIDE NO EMERGENCY",33,14,0,1,48
1900481,1582562,2025-05-29,House,"House: VETO OVERRIDE WITHOUT EMERGENCY",69,13,0,16,98
1900481,1591545,2025-05-22,Senate,"Senate: FOURTH READING",31,14,0,3,48
1900612,1489325,2025-02-13,Senate,"Senate: Administrative Rules Committee: DO PASS AMENDED CS",7,2,0,0,9
1900612,1596228,2025-03-05,Senate,"Senate: Appropriations Committee: DO PASS AMENDED",21,3,0,0,24
1900626,1490760,2025-02-17,House,"House: Appropriations and Budget Natural Resources Subcommittee: DO PASS",6,4,0,0,10
1900819,1484886,2025-02-10,House,"House: Appropriations and Budget Select Agencies Subcommittee: DO PASS AS AMENDED BY CS",5,0,0,0,5
1900819,1506398,2025-03-05,House,"House: Appropriations and Budget Committee: DO PASS AS AMENDED BY CS",26,5,0,0,31
1900819,1527880,2025-03-26,House,"House: THIRD READING",62,31,0,6,99
1900819,1556452,2025-04-24,Senate,"Senate: Business & Insurance Committee: DO PASS AMENDED",8,1,0,0,9
1900880,1486210,2025-02-11,Senate,"Senate: Education Committee: DO PASS",11,0,0,0,11
1900880,1505051,2025-03-04,Senate,"Senate: THIRD READING",45,0,0,2,47
1900880,1534379,2025-04-02,House,"House: Common Education Committee: DO PASS",12,0,0,0,12
1900880,1568038,2025-05-08,House,"House: THIRD READING",90,0,0,8,98
1900880,1596230,2025-04-16,House,"House: Education Oversight Committee: DO PASS",8,0,0,0,8
1900900,1499547,2025-02-25,Senate,"Senate: Economic Development, Workforce & Tourism Committee: DO PASS AMENDED CS",8,0,0,0,8
1900900,1514418,2025-03-11,Senate,"Senate: THIRD READING",25,19,0,3,47
1900900,1532031,2025-04-01,House,"House: General Government Committee: DO PASS",5,3,0,0,8
1900900,1567070,2025-05-06,House,"House: THIRD READING",78,16,0,4,98
1900900,1596231,2025-02-25,Senate,"Senate: ADOPT",8,0,0,0,8
1900900,1596232,2025-04-22,House,"House: Government Oversight Committee: DO PASS",9,7,0,0,16
1901066,1493403,2025-02-19,Senate,"Senate: Education Committee: DO PASS",3,7,0,0,10
1901104,1488664,2025-02-13,Senate,"Senate: Business & Insurance Committee: DO PASS",10,0,0,0,10
1901104,1527695,2025-03-26,Senate,"Senate: THIRD READING",45,0,0,2,47
1901104,1540573,2025-04-08,House,"House: Utilities Committee: DO PASS AS AMENDED BY CS",7,2,0,0,9
1901104,1561292,2025-04-29,House,"House: THIRD READING",73,13,0,12,98
1901104,1591557,2025-05-15,Senate,"Senate: FOURTH READING",41,0,0,6,47
1901104,1596233,2025-04-16,House,"House: Energy and Natural Resources Oversight Committee: DO PASS AS AMENDED BY CS",12,2,0,0,14
1901109,1497226,2025-02-24,Senate,"Senate: Aeronautics & Transportation Committee: DO PASS",12,0,0,0,12
1901109,1525743,2025-03-24,Senate,"Senate: THIRD READING",46,0,0,1,47
1901109,1541934,2025-04-09,House,"House: Public Safety Committee: DO PASS",7,0,0,0,7
1901109,1563857,2025-05-01,House,"House: THIRD READING",81,0,0,17,98
1901109,1596234,2025-04-17,House,"House: Judiciary and Public Safety Oversight Committee: DO PASS",12,0,0,0,12
1901118,1491412,2025-02-17,Senate,"Senate: Aeronautics & Transportation Committee: DO PASS AMENDED",11,0,0,0,11
1901118,1499269,2025-02-25,Senate,"Senate: THIRD READING",47,0,0,0,47
1901118,1544103,2025-04-10,House,"House: Transportation Committee: DO PASS",11,0,0,0,11
1901118,1559039,2025-04-28,House,"House: THIRD READING",81,8,0,9,98
1901118,1596235,2025-04-17,House,"House: Commerce and Economic Development Oversight Committee: DO PASS",16,0,0,0,16
1901159,1487048,2025-02-11,Senate,"Senate: General Government Committee: DO PASS AMENDED",6,3,0,0,9
1901247,1488887,2025-02-13,Senate,"Senate: Business & Insurance Committee: DO PASS",10,0,0,0,10
1901348,1487575,2025-02-12,House,"House: County and Municipal Government Committee: DO PASS",6,0,0,0,6
1901348,1505034,2025-03-04,House,"House: Government Oversight Committee: DO PASS",17,0,0,0,17
1901348,1509038,2025-03-10,House,"House: THIRD READING",92,2,0,5,99
1901348,1554858,2025-04-22,Senate,"Senate: Local & County Government Committee: DO PASS",8,0,0,0,8
1901348,1559957,2025-04-29,Senate,"Senate: THIRD READING",44,0,0,3,47
1901412,1487596,2025-02-12,House,"House: County and Municipal Government Committee: DO PASS",2,4,0,0,6
1901471,1494721,2025-02-20,Senate,"Senate: Business & Insurance Committee: DO PASS AMENDED CS",10,0,0,0,10
1901471,1516831,2025-03-13,Senate,"Senate: THIRD READING",43,0,0,4,47
1901471,1539391,2025-04-08,House,"House: Business Committee: DO PASS",5,4,0,0,9
1901471,1596236,2025-04-24,House,"House: Commerce and Economic Development Oversight Committee: DO PASS",14,3,0,0,17
1901506,1497459,2025-02-24,Senate,"Senate: Aeronautics & Transportation Committee: DO PASS AMENDED",1,11,0,0,12
1901511,1471208,2025-01-07,House,"House: ADOPT RESOLUTION",66,25,0,9,100
1901520,1486697,2025-02-11,Senate,"Senate: Judiciary Committee: DO PASS",5,3,0,0,8
1901520,1512536,2025-03-11,Senate,"Senate: THIRD READING",46,0,0,1,47
1901568,1484545,2025-02-10,Senate,"Senate: Aeronautics & Transportation Committee: DO PASS AMENDED",12,0,0,0,12
1901590,1483259,2025-02-06,House,"House: Civil Judiciary Committee: DO PASS",9,0,0,0,9
1901590,1504809,2025-03-04,House,"House: Judiciary and Public Safety Oversight Committee: DO PASS",13,0,0,0,13
1901590,1514439,2025-03-11,House,"House: THIRD READING",89,0,0,10,99
1901590,1540304,2025-04-08,Senate,"Senate: Judiciary Committee: DO PASS",6,0,0,0,6
1901590,1567181,2025-05-07,Senate,"Senate: THIRD READING",44,0,0,3,47
1901603,1499760,2025-02-25,Senate,"Senate: Local & County Government Committee: DO PASS",9,0,0,0,9
1902005,1504651,2025-03-04,Senate,"Senate: Education Committee: DO PASS AMENDED",9,0,0,0,9
1902069,1486239,2025-02-11,Senate,"Senate: Public Safety Committee: DO PASS",6,2,0,0,8
1902091,1486454,2025-02-11,Senate,"Senate: Education Committee: DO PASS",11,0,0,0,11
1902091,1499436,2025-02-25,Senate,"Senate: THIRD READING",31,16,0,0,47
1902091,1548294,2025-04-15,House,"House: Rules Committee: DO PASS",11,0,0,0,11
1902091,1562123,2025-04-30,House,"House: THIRD READING",63,25,0,10,98
1902091,1562124,2025-04-30,House,"House: EMERGENCY",61,23,0,14,98
1902113,1497603,2025-02-24,Senate,"Senate: Revenue & Taxation Committee: DO PASS AMENDED CS",11,0,0,0,11
1902113,1596239,2025-03-05,Senate,"Senate: Appropriations Committee: DO PASS AMENDED",21,0,0,0,21
1902136,1491461,2025-02-17,Senate,"Senate: Aeronautics & Transportation Committee: DO PASS",12,0,0,0,12
1902136,1497462,2025-02-24,Senate,"Senate: THIRD READING",47,0,0,0,47
1902136,1541961,2025-04-09,House,"House: Public Safety Committee: DO PASS",7,0,0,0,7
1902136,1568508,2025-05-08,House,"House: THIRD READING",86,1,0,11,98
1902136,1596240,2025-04-17,House,"House: Judiciary and Public Safety Oversight Committee: DO PASS",12,0,0,0,12
1902209,1493886,2025-02-19,Senate,"Senate: Education Committee: DO PASS",8,2,0,0,10
1902209,1524898,2025-03-24,Senate,"Senate: THIRD READING",46,0,0,1,47
1902209,1539503,2025-04-08,House,"House: Postsecondary Education Committee: DO PASS",7,0,0,0,7
1902209,1560827,2025-04-29,House,"House: THIRD READING",83,0,0,15,98
1902209,1596238,2025-04-16,House,"House: Education Oversight Committee: DO PASS",9,0,0,0,9
1902231,1486275,2025-02-11,Senate,"Senate: Public Safety Committee: DO PASS",6,2,0,0,8
1902231,1527087,2025-03-25,Senate,"Senate: THIRD READING",40,7,0,0,47
1902231,1539753,2025-04-08,House,"House: Criminal Judiciary Committee: DO PASS",4,0,0,0,4
1902231,1558867,2025-04-28,House,"House: THIRD READING",79,7,0,12,98
1902231,1596241,2025-04-17,House,"House: Judiciary and Public Safety Oversight Committee: DO PASS",12,0,0,0,12
1902299,1493594,2025-02-19,Senate,"Senate: Judiciary Committee: DO PASS",3,5,0,0,8
1902346,1507121,2025-03-06,Senate,"Senate: Business & Insurance Committee: DO PASS",10,0,0,0,10
1902389,1490879,2025-02-17,Senate,"Senate: Aeronautics & Transportation Committee: DO PASS AMENDED CS",12,0,0,0,12
1902389,1528014,2025-03-26,Senate,"Senate: THIRD READING",47,0,0,0,47
1902389,1544075,2025-04-10,House,"House: Transportation Committee: DO PASS",11,0,0,0,11
1902389,1566699,2025-05-06,House,"House: THIRD READING",85,2,0,11,98
1902389,1596243,2025-04-22,House,"House: Commerce and Economic Development Oversight Committee: DO PASS",16,1,0,0,17
1902474,1494735,2025-02-20,Senate,"Senate: Business & Insurance Committee: DO PASS AMENDED CS",10,0,0,0,10
1902474,1525355,2025-03-24,Senate,"Senate: THIRD READING",46,0,0,1,47
1902474,1540317,2025-04-08,House,"House: Business Committee: DO PASS",7,0,0,0,7
1902474,1555849,2025-04-23,House,"House: THIRD READING",76,8,0,14,98
1902474,1596245,2025-02-20,Senate,"Senate: ADOPT",10,0,0,0,10
1902474,1596246,2025-04-17,House,"House: Commerce and Economic Development Oversight Committee: DO PASS",16,0,0,0,16
1902512,1498866,2025-02-25,Senate,"Senate: Judiciary Committee: DO PASS",5,3,0,0,8
1902653,1482685,2025-02-05,House,"House: Alcohol, Tobacco and Controlled Substances Committee: DO PASS AS AMENDED BY CS",6,1,0,0,7
1902653,1503649,2025-03-03,House,"House: Health and Human Services Oversight Committee: DO PASS AS AMENDED BY CS",10,2,0,0,12
1902653,1509773,2025-03-10,House,"House: THIRD READING",60,33,0,6,99
1902653,1543570,2025-04-10,Senate,"Senate: Business & Insurance Committee: DO PASS",8,0,0,0,8
1902653,1559134,2025-04-28,Senate,"Senate: THIRD READING",25,17,1,4,47
1902744,1486404,2025-02-11,House,"House: Banking, Financial Services and Pensions Committee: DO PASS",2,6,0,0,8
1902791,1480639,2025-02-05,House,"House: Public Health Committee: DO PASS",6,0,0,0,6
1902791,1503580,2025-03-03,House,"House: Health and Human Services Oversight Committee: DO PASS AS AMENDED BY CS",12,0,0,0,12
1902837,1495951,2025-02-20,House,"House: Appropriations and Budget Finance Subcommittee: DO PASS",8,1,0,0,9
1902837,1505078,2025-03-04,House,"House: Appropriations and Budget Committee: DO PASS",27,2,0,0,29
1902837,1509270,2025-03-10,House,"House: THIRD READING",72,22,0,5,99
1902886,1480167,2025-02-04,House,"House: Criminal Judiciary Committee: DO PASS",5,0,0,0,5
1902886,1499514,2025-02-25,House,"House: Judiciary and Public Safety Oversight Committee: DO PASS",11,0,0,0,11
1902886,1501284,2025-02-27,House,"House: THIRD READING",75,14,0,10,99
1902886,1553536,2025-04-22,Senate,"Senate: Judiciary Committee: DO PASS AMENDED CS",8,0,0,0,8
1902886,1559750,2025-04-29,Senate,"Senate: THIRD READING",45,0,0,2,47
1902886,1571289,2025-05-14,House,"House: FOURTH READING",86,0,0,12,98
1902952,1489357,2025-02-13,Senate,"Senate: Administrative Rules Committee: DO PASS AMENDED CS",8,0,0,0,8
1902952,1526870,2025-03-25,Senate,"Senate: THIRD READING",40,7,0,0,47
1902952,1540671,2025-04-08,House,"House: Administrative Rules Committee: DO PASS",13,0,0,0,13
1902952,1566499,2025-05-06,House,"House: THIRD READING",89,0,0,9,98
1902976,1493598,2025-02-19,Senate,"Senate: Education Committee: DO PASS",11,1,0,0,12
1902976,1528638,2025-03-27,Senate,"Senate: THIRD READING",43,1,0,3,47
1902976,1542334,2025-04-09,House,"House: Common Education Committee: DO PASS AS AMENDED BY CS",3,8,0,0,11
1903014,1491171,2025-02-17,Senate,"Senate: Aeronautics & Transportation Committee: DO PASS AMENDED",9,3,0,0,12
1903026,1491090,2025-02-17,Senate,"Senate: Aeronautics & Transportation Committee: DO PASS",10,2,0,0,12
1903026,1527385,2025-03-26,Senate,"Senate: THIRD READING",36,8,0,3,47
1903038,1486105,2025-02-11,House,"House: General Government Committee: DO PASS",2,5,0,0,7
1903082,1486916,2025-02-11,Senate,"Senate: General Government Committee: DO PASS AMENDED",9,0,0,0,9
1903082,1524951,2025-03-24,Senate,"Senate: THIRD READING",45,1,0,1,47
1903082,1542078,2025-04-09,House,"House: County and Municipal Government Committee: DO PASS",5,0,0,0,5
1903082,1560205,2025-04-29,House,"House: THIRD READING",77,0,0,21,98
1903082,1596249,2025-04-22,House,"House: Government Oversight Committee: DO PASS",14,2,0,0,16
1903090,1504250,2025-03-04,Senate,"Senate: Education Committee: DO PASS",9,0,0,0,9
1903090,1511696,2025-03-10,Senate,"Senate: THIRD READING",47,0,0,0,47
1903090,1538622,2025-04-07,House,"House: Appropriations and Budget Education Subcommittee: DO PASS",10,0,0,0,10
1903090,1559008,2025-04-28,House,"House: THIRD READING",87,1,0,10,98
1903090,1596247,2025-04-16,House,"House: Appropriations and Budget Committee: DO PASS",28,0,0,0,28
1903145,1493383,2025-02-19,Senate,"Senate: Local & County Government Committee: DO PASS",8,0,0,0,8
1903157,1489345,2025-02-13,Senate,"Senate: Administrative Rules Committee: DO PASS AMENDED CS",8,0,0,0,8
1903157,1526938,2025-03-25,Senate,"Senate: THIRD READING",41,6,0,0,47
1903157,1540729,2025-04-08,House,"House: Administrative Rules Committee: DO PASS",13,0,0,0,13
1903172,1505104,2025-03-04,Senate,"Senate: Local & County Government Committee: DO PASS AMENDED",9,0,0,0,9
1903198,1486648,2025-02-11,Senate,"Senate: Judiciary Committee: DO PASS AMENDED",8,0,0,0,8
1903198,1527877,2025-03-26,Senate,"Senate: THIRD READING",45,0,0,2,47
1903198,1541333,2025-04-09,House,"House: Alcohol, Tobacco and Controlled Substances Committee: DO PASS",8,0,0,0,8
1903198,1562483,2025-04-30,House,"House: THIRD READING",88,0,0,10,98
1903198,1596248,2025-04-21,House,"House: Health and Human Services Oversight Committee: DO PASS",9,3,0,0,12
1903225,1489172,2025-02-13,Senate,"Senate: Administrative Rules Committee: DO PASS AMENDED CS",9,0,0,0,9
1903225,1518446,2025-03-17,Senate,"Senate: THIRD READING",45,0,0,2,47
1903225,1539482,2025-04-08,House,"House: Administrative Rules Committee: DO PASS",13,0,0,0,13
1903225,1566895,2025-05-06,House,"House: THIRD READING",91,0,0,7,98
1903246,1489352,2025-02-13,Senate,"Senate: Administrative Rules Committee: DO PASS AMENDED CS",7,2,0,0,9
1903246,1519025,2025-03-17,Senate,"Senate: THIRD READING",37,8,0,2,47
1903246,1540845,2025-04-08,House,"House: Administrative Rules Committee: DO PASS",13,0,0,0,13
1903246,1566449,2025-05-06,House,"House: THIRD READING",92,0,0,6,98
1903263,1489273,2025-02-13,Senate,"Senate: Administrative Rules Committee: DO PASS",9,0,0,0,9
1903272,1489524,2025-02-13,Senate,"Senate: Administrative Rules Committee: DO PASS AMENDED CS",8,0,0,0,8
1903272,1527027,2025-03-25,Senate,"Senate: THIRD READING",39,8,0,0,47
1903272,1539460,2025-04-08,House,"House: Administrative Rules Committee: DO PASS",13,0,0,0,13
1903272,1566924,2025-05-06,House,"House: THIRD READING",89,0,0,9,98
1903298,1504871,2025-03-04,Senate,"Senate: Education Committee: DO PASS AMENDED",5,4,0,0,9
1903313,1489547,2025-02-13,Senate,"Senate: Administrative Rules Committee: DO PASS AMENDED CS",9,0,0,0,9
1903313,1497650,2025-02-24,Senate,"Senate: THIRD READING",46,1,0,0,47
1903313,1539492,2025-04-08,House,"House: Administrative Rules Committee: DO PASS",12,0,0,0,12
1903313,1566887,2025-05-06,House,"House: THIRD READING",92,0,0,6,98
1903378,1499045,2025-02-25,Senate,"Senate: Education Committee: DO PASS AMENDED CS",9,1,0,0,10
1903378,1526832,2025-03-25,Senate,"Senate: THIRD READING",44,2,0,1,47
1903378,1542639,2025-04-09,House,"House: Common Education Committee: DO PASS",9,2,0,0,11
1903438,1485558,2025-02-10,Senate,"Senate: Health & Human Services Committee: DO PASS",11,0,0,0,11
1903438,1490830,2025-02-17,Senate,"Senate: THIRD READING",45,0,0,2,47
1903438,1542191,2025-04-09,House,"House: County and Municipal Government Committee: DO PASS",5,0,0,0,5
1903438,1563545,2025-05-01,House,"House: THIRD READING",82,0,0,16,98
1903438,1596250,2025-04-22,House,"House: Government Oversight Committee: DO PASS",16,0,0,0,16
1903501,1504862,2025-03-04,Senate,"Senate: Judiciary Committee: DO PASS AMENDED CS",8,0,0,0,8
1903501,1518459,2025-03-17,Senate,"Senate: THIRD READING",44,0,0,3,47
1903547,1485895,2025-02-11,Senate,"Senate: Public Safety Committee: DO PASS AMENDED CS",7,2,0,0,9
1903547,1511350,2025-03-10,Senate,"Senate: THIRD READING",39,8,0,0,47
1903547,1541673,2025-04-09,House,"House: Public Safety Committee: DO PASS",7,0,0,0,7
1903547,1567477,2025-05-07,House,"House: THIRD READING",77,15,0,6,98
1903547,1596252,2025-04-17,House,"House: Judiciary and Public Safety Oversight Committee: DO PASS",9,0,0,0,9
1903654,1491416,2025-02-17,Senate,"Senate: Aeronautics & Transportation Committee: DO PASS",12,0,0,0,12
1903670,1486430,2025-02-11,Senate,"Senate: Education Committee: DO PASS AMENDED",6,3,0,0,9
1903670,1518717,2025-03-17,Senate,"Senate: THIRD READING",37,8,0,2,47
1903670,1538085,2025-04-07,House,"House: Appropriations and Budget Education Subcommittee: DO PASS",7,3,0,0,10
1903670,1549978,2025-04-16,House,"House: Appropriations and Budget Committee: DO PASS AS AMENDED, STRIKE THE ENACTING CLAUSE",21,7,0,0,28
1903670,1560566,2025-04-29,House,"House: THIRD READING",22,63,0,13,98
1903670,1596251,2025-02-20,Senate,"Senate: Appropriations Committee: DO PASS",18,5,0,0,23
1903940,1488615,2025-02-13,Senate,"Senate: Energy Committee: DO PASS",9,0,0,0,9
1903976,1485204,2025-02-10,Senate,"Senate: Health & Human Services Committee: DO PASS AMENDED",12,0,0,0,12
1903976,1527655,2025-03-26,Senate,"Senate: THIRD READING",44,0,0,3,47
1903976,1541336,2025-04-09,House,"House: Public Health Committee: DO PASS AS AMENDED BY CS",6,0,0,0,6
1903976,1596253,2025-04-14,House,"House: Health and Human Services Oversight Committee: DO PASS AS AMENDED BY CS",11,0,0,0,11
1904088,1503254,2025-03-03,Senate,"Senate: Health & Human Services Committee: DO PASS AMENDED CS",11,0,0,0,11
1904088,1527384,2025-03-26,Senate,"Senate: THIRD READING",33,11,0,3,47
1904088,1541340,2025-04-09,House,"House: Public Health Committee: DO PASS",5,0,0,0,5
1904088,1563702,2025-05-01,House,"House: THIRD READING",53,28,0,17,98
1904088,1581389,2025-05-29,Senate,"Senate: VETO OVERRIDE NO EMERGENCY",42,4,0,2,48
1904088,1581949,2025-05-29,House,"House: VETO OVERRIDE WITHOUT EMERGENCY",68,15,0,15,98
1904088,1596254,2025-04-16,House,"House: Health and Human Services Oversight Committee: DO PASS",13,0,0,0,13
1904118,1499175,2025-02-25,Senate,"Senate: Retirement & Government Resources Committee: DO PASS AMENDED",5,2,0,0,7
1904118,1528148,2025-03-26,Senate,"Senate: THIRD READING",40,5,0,2,47
1904118,1540678,2025-04-08,House,"House: Banking, Financial Services and Pensions Committee: DO PASS",9,0,0,0,9
1904118,1548303,2025-04-15,House,"House: Government Oversight Committee: DO PASS AS AMENDED BY CS",15,0,0,0,15
1904118,1566310,2025-05-06,House,"House: THIRD READING",88,0,0,10,98
1904118,1591456,2025-05-13,Senate,"Senate: FOURTH READING",39,4,0,4,47
1904308,1488344,2025-02-12,House,"House: Common Education Committee: DO PASS AS AMENDED BY CS",9,2,0,0,11
1904308,1505963,2025-03-05,House,"House: Education Oversight Committee: DO PASS AS AMENDED BY CS",9,0,0,0,9
1904308,1518706,2025-03-17,House,"House: THIRD READING",84,1,0,14,99
1904308,1553651,2025-04-22,Senate,"Senate: Education Committee: DO PASS AMENDED CS",10,0,0,0,10
1904308,1568399,2025-05-08,Senate,"Senate: THIRD READING",44,0,0,3,47
1904308,1571983,2025-05-15,House,"House: FOURTH READING",80,0,0,18,98
1904363,1498208,2025-02-24,House,"House: Public Health Committee: DO PASS AS AMENDED BY CS",6,0,0,0,6
1904363,1503381,2025-03-03,House,"House: Health and Human Services Oversight Committee: DO PASS AS AMENDED BY CS",12,0,0,0,12
1904363,1517233,2025-03-13,House,"House: THIRD READING",85,3,0,11,99
1904363,1547300,2025-04-14,Senate,"Senate: Health & Human Services Committee: DO PASS",9,3,0,0,12
1904363,1560272,2025-04-29,Senate,"Senate: THIRD READING",41,4,0,2,47
1904423,1494756,2025-02-20,Senate,"Senate: Business & Insurance Committee: DO PASS",10,0,0,0,10
1904611,1501195,2025-02-27,Senate,"Senate: Business & Insurance Committee: DO PASS AMENDED CS",10,0,0,0,10
1904611,1515763,2025-03-12,Senate,"Senate: THIRD READING",41,0,0,6,47
1904611,1539606,2025-04-08,House,"House: Insurance Committee: DO PASS",7,0,0,0,7
1904611,1559320,2025-04-28,House,"House: THIRD READING",88,0,0,10,98
1904611,1596255,2025-04-17,House,"House: Commerce and Economic Development Oversight Committee: DO PASS",16,0,0,0,16
1905587,1485421,2025-02-10,Senate,"Senate: Health & Human Services Committee: DO PASS",12,0,0,0,12
1905587,1491425,2025-02-17,Senate,"Senate: THIRD READING",39,4,0,4,47
1905587,1542018,2025-04-09,House,"House: Public Health Committee: DO PASS",5,0,0,0,5
1905587,1547610,2025-04-14,House,"House: Health and Human Services Oversight Committee: DO PASS AS AMENDED BY CS",10,0,0,0,10
1905587,1562318,2025-04-30,House,"House: THIRD READING",86,4,0,8,98
1905587,1581041,2025-05-29,Senate,"Senate: VETO OVERRIDE WITH EMERGENCY",46,1,0,1,48
1905587,1581628,2025-05-29,House,"House: VETO OVERRIDE WITH EMERGENCY",76,5,0,17,98
1905587,1591810,2025-05-14,Senate,"Senate: FOURTH READING",41,0,0,6,47
1905799,1484580,2025-02-10,Senate,"Senate: Agriculture & Rural Affairs Committee: DO PASS AMENDED CS",11,0,0,0,11
1905799,1528544,2025-03-27,Senate,"Senate: THIRD READING",44,0,0,3,47
1905799,1539036,2025-04-07,House,"House: Wildlife Committee: DO PASS",6,0,0,0,6
1905799,1553110,2025-04-21,House,"House: THIRD READING",78,1,0,19,98
1905799,1596256,2025-04-16,House,"House: Energy and Natural Resources Oversight Committee: DO PASS",14,0,0,0,14
1905853,1493908,2025-02-19,Senate,"Senate: Judiciary Committee: DO PASS AMENDED CS",8,0,0,0,8
1905853,1526066,2025-03-25,Senate,"Senate: THIRD READING",46,0,0,1,47
1905903,1503415,2025-03-03,Senate,"Senate: Agriculture & Wildlife Committee: DO PASS AMENDED CS",12,0,0,0,12
1905903,1529390,2025-03-27,Senate,"Senate: THIRD READING",47,0,0,0,47
1905903,1541460,2025-04-09,House,"House: State Powers Committee: DO PASS",4,1,0,0,5
1905903,1551278,2025-04-17,House,"House: Government Oversight Committee: DO PASS AS AMENDED BY CS",13,0,0,0,13
1905903,1566493,2025-05-06,House,"House: THIRD READING",82,2,0,14,98
1905903,1591406,2025-05-13,Senate,"Senate: FOURTH READING",43,0,0,4,47
1905958,1493580,2025-02-19,Senate,"Senate: Public Safety Committee: DO PASS",6,0,0,0,6
1907237,1484815,2025-02-10,House,"House: Appropriations and Budget Education Subcommittee: DO PASS",10,0,0,0,10
1907237,1506707,2025-03-05,House,"House: Appropriations and Budget Committee: DO PASS AS AMENDED BY CS",33,0,0,0,33
1907237,1516901,2025-03-13,House,"House: THIRD READING",86,2,0,11,99
1907237,1539426,2025-04-08,Senate,"Senate: Education Committee: DO PASS AMENDED",11,0,0,0,11
1907237,1568098,2025-05-08,Senate,"Senate: THIRD READING",37,9,0,1,47
1907237,1579545,2025-05-28,House,"House: FOURTH READING",81,6,1,10,98
1907237,1591701,2025-05-28,Senate,"Senate: FOURTH READING",35,12,0,1,48
1907237,1596081,2025-04-23,Senate,"Senate: Appropriations Committee: DO PASS",24,0,0,0,24
1907277,1497889,2025-02-24,House,"House: Business Committee: DO PASS",8,0,0,0,8
1907277,1501048,2025-02-27,House,"House: Commerce and Economic Development Oversight Committee: DO PASS",16,0,0,0,16
1907277,1517281,2025-03-13,House,"House: THIRD READING",84,0,0,15,99
1907277,1556880,2025-04-24,Senate,"Senate: Business & Insurance Committee: DO PASS AMENDED",6,3,0,0,9
1907294,1493725,2025-02-19,Senate,"Senate: Judiciary Committee: DO PASS",2,6,0,0,8
1907312,1483004,2025-02-05,House,"House: Common Education Committee: DO PASS",11,0,0,0,11
1907312,1499788,2025-02-26,House,"House: Education Oversight Committee: DO PASS",9,0,0,0,9
1907312,1509153,2025-03-10,House,"House: THIRD READING",80,7,0,12,99
1907312,1554075,2025-04-22,Senate,"Senate: Education Committee: DO PASS",8,2,0,0,10
1907347,1487652,2025-02-11,House,"House: Insurance Committee: DO PASS",7,0,0,0,7
1907347,1505414,2025-03-04,House,"House: Commerce and Economic Development Oversight Committee: DO PASS AS AMENDED BY CS",15,1,0,0,16
1907347,1509749,2025-03-10,House,"House: THIRD READING",85,6,0,8,99
1907347,1543895,2025-04-10,Senate,"Senate: Business & Insurance Committee: DO PASS AMENDED",8,0,0,0,8
1907368,1486406,2025-02-11,House,"House: Insurance Committee: DO PASS AS AMENDED BY CS",7,0,0,0,7
1907368,1501153,2025-02-27,House,"House: Commerce and Economic Development Oversight Committee: DO PASS AS AMENDED BY CS",16,0,0,0,16
1907368,1511953,2025-03-10,House,"House: THIRD READING",92,1,0,6,99
1907368,1556917,2025-04-24,Senate,"Senate: Business & Insurance Committee: DO PASS AMENDED",8,1,0,0,9
1907368,1567498,2025-05-07,Senate,"Senate: THIRD READING",42,0,0,5,47
1907368,1575269,2025-05-21,House,"House: FOURTH READING",91,0,0,7,98
1907388,1480295,2025-02-04,House,"House: Agriculture Committee: DO PASS",7,0,0,0,7
1907388,1499751,2025-02-26,House,"House: Energy and Natural Resources Oversight Committee: DO PASS",11,1,0,0,12
1907388,1503138,2025-03-03,House,"House: THIRD READING",86,2,0,11,99
1907388,1543524,2025-04-10,Senate,"Senate: Business & Insurance Committee: DO PASS",9,0,0,0,9
1907388,1559300,2025-04-28,Senate,"Senate: THIRD READING",44,0,0,3,47
1907400,1493937,2025-02-19,House,"House: Appropriations and Budget Education Subcommittee: DO PASS AS AMENDED BY CS",9,0,0,0,9
1907400,1506216,2025-03-05,House,"House: Appropriations and Budget Committee: DO PASS AS AMENDED BY CS",33,0,0,0,33
1907400,1515876,2025-03-12,House,"House: THIRD READING",82,0,0,17,99
1907400,1548135,2025-04-15,Senate,"Senate: Education Committee: DO PASS AMENDED",11,0,0,0,11
1907400,1565569,2025-05-06,Senate,"Senate: THIRD READING",46,0,0,1,47
1907400,1570996,2025-05-14,House,"House: FOURTH READING",78,7,0,13,98
1907473,1486258,2025-02-11,Senate,"Senate: Judiciary Committee: DO PASS",7,1,0,0,8
1907473,1513486,2025-03-11,Senate,"Senate: THIRD READING",30,15,0,2,47
1907473,1556446,2025-04-24,House,"House: Rules Committee: DO PASS AS AMENDED, STRIKE THE TITLE",8,1,0,0,9
1907473,1568330,2025-05-08,House,"House: THIRD READING",78,10,0,10,98
1907473,1576370,2025-05-22,House,"House: FOURTH READING",61,19,0,18,98
1907473,1591348,2025-05-22,Senate,"Senate: FOURTH READING",37,8,0,3,48
1907490,1490026,2025-02-13,Senate,"Senate: Veterans & Military Affairs Committee: DO PASS",9,0,0,0,9
1907490,1506291,2025-03-05,Senate,"Senate: THIRD READING",45,0,0,2,47
1907490,1532015,2025-04-01,House,"House: General Government Committee: DO PASS",8,0,0,0,8
1907490,1560859,2025-04-29,House,"House: THIRD READING",87,0,0,11,98
1907490,1596257,2025-04-22,House,"House: Government Oversight Committee: DO PASS",16,0,0,0,16
1907507,1485565,2025-02-10,Senate,"Senate: Health & Human Services Committee: DO PASS",10,0,0,0,10
1907507,1524631,2025-03-24,Senate,"Senate: THIRD READING",46,0,0,1,47
1907507,1542020,2025-04-09,House,"House: Public Health Committee: DO PASS",5,0,0,0,5
1907507,1563861,2025-05-01,House,"House: THIRD READING",77,0,0,21,98
1907507,1596258,2025-04-21,House,"House: Health and Human Services Oversight Committee: DO PASS",13,0,0,0,13
1907521,1495659,2025-02-20,House,"House: Civil Judiciary Committee: DO PASS AS AMENDED BY CS",7,1,0,0,8
1907521,1507301,2025-03-06,House,"House: Judiciary and Public Safety Oversight Committee: DO PASS AS AMENDED BY CS",11,0,0,0,11
1907521,1525193,2025-03-24,House,"House: THIRD READING",92,1,0,6,99
1907567,1489243,2025-02-13,Senate,"Senate: Business & Insurance Committee: DO PASS",9,1,0,0,10
1907567,1511498,2025-03-10,Senate,"Senate: THIRD READING",32,15,0,0,47
1907567,1541374,2025-04-09,House,"House: Alcohol, Tobacco and Controlled Substances Committee: DO PASS",6,1,0,0,7
1907567,1562397,2025-04-30,House,"House: THIRD READING",52,27,0,19,98
1907567,1562398,2025-04-30,House,"House: EMERGENCY",48,24,0,26,98
1907567,1596261,2025-04-16,House,"House: Health and Human Services Oversight Committee: DO PASS",11,2,0,0,13
1907665,1485233,2025-02-10,Senate,"Senate: Aeronautics & Transportation Committee: DO PASS",12,0,0,0,12
1907690,1484680,2025-02-10,House,"House: Appropriations and Budget Education Subcommittee: DO PASS",7,3,0,0,10
1907690,1505954,2025-03-04,House,"House: Appropriations and Budget Committee: DO PASS AS AMENDED BY CS",21,6,0,0,27
1907690,1515001,2025-03-11,House,"House: THIRD READING",78,17,0,4,99
1907690,1554972,2025-04-22,Senate,"Senate: Education Committee: DO PASS AMENDED CS",7,3,0,0,10
1907690,1568310,2025-05-08,Senate,"Senate: THIRD READING",40,7,0,0,47
1907690,1571872,2025-05-15,House,"House: FOURTH READING",66,15,0,17,98
1907690,1571873,2025-05-15,House,"House: EMERGENCY",68,13,0,17,98
1907717,1504333,2025-03-04,Senate,"Senate: Public Safety Committee: DO PASS AMENDED CS",5,0,0,0,5
1907741,1487609,2025-02-12,House,"House: Public Safety Committee: DO PASS AS AMENDED BY CS",4,0,0,0,4
1907741,1498771,2025-02-25,House,"House: Judiciary and Public Safety Oversight Committee: DO PASS AS AMENDED BY CS",6,3,0,0,9
1907741,1518421,2025-03-17,House,"House: THIRD READING",70,15,0,14,99
1907741,1519465,2025-03-18,House,"House: RECONSIDER MEASURE",61,12,0,26,99
1907741,1554131,2025-04-22,Senate,"Senate: Public Safety Committee: DO PASS AMENDED CS",6,2,0,0,8
1907741,1566040,2025-05-06,Senate,"Senate: THIRD READING",39,8,0,0,47
1907741,1571279,2025-05-14,House,"House: FOURTH READING",70,15,0,13,98
1907792,1494759,2025-02-20,Senate,"Senate: Energy Committee: DO PASS",10,1,0,0,11
1907792,1509761,2025-03-10,Senate,"Senate: THIRD READING",39,8,0,0,47
1907792,1541341,2025-04-09,House,"House: Energy Committee: DO PASS",8,3,0,0,11
1907792,1555151,2025-04-23,House,"House: THIRD READING",70,19,0,9,98
1907792,1555152,2025-04-23,House,"House: EMERGENCY",68,18,0,12,98
1907792,1596259,2025-04-16,House,"House: Energy and Natural Resources Oversight Committee: DO PASS",11,3,0,0,14
1907820,1493401,2025-02-19,Senate,"Senate: Public Safety Committee: DO PASS AMENDED CS",7,1,0,0,8
1907820,1505058,2025-03-04,Senate,"Senate: THIRD READING",44,1,0,2,47
1907820,1541530,2025-04-09,House,"House: Public Safety Committee: DO PASS",7,0,0,0,7
1907820,1562743,2025-04-30,House,"House: THIRD READING",84,1,0,13,98
1907820,1591361,2025-05-15,Senate,"Senate: FOURTH READING",38,3,0,6,47
1907820,1596260,2025-04-17,House,"House: Judiciary and Public Safety Oversight Committee: DO PASS",12,0,0,0,12
1907843,1484835,2025-02-10,House,"House: Appropriations and Budget Education Subcommittee: DO PASS",4,6,0,0,10
1907870,1494797,2025-02-19,House,"House: Banking, Financial Services and Pensions Committee: DO PASS AS AMENDED BY CS",7,0,0,0,7
1907870,1505173,2025-03-04,House,"House: Government Oversight Committee: DO PASS AS AMENDED BY CS",17,0,0,0,17
1907870,1517223,2025-03-13,House,"House: THIRD READING",88,0,0,11,99
1907870,1556909,2025-04-24,Senate,"Senate: Business & Insurance Committee: DO PASS",9,0,0,0,9
1907870,1563733,2025-05-01,Senate,"Senate: THIRD READING",45,0,0,2,47
1907943,1483539,2025-02-06,House,"House: Appropriations and Budget Finance Subcommittee: DO PASS AS AMENDED BY CS",6,2,0,0,8
1907943,1505207,2025-03-04,House,"House: Appropriations and Budget Committee: DO PASS AS AMENDED BY CS",27,3,0,0,30
1907943,1516175,2025-03-12,House,"House: THIRD READING",59,28,0,12,99
1907943,1540611,2025-04-08,Senate,"Senate: Economic Development, Workforce & Tourism Committee: DO PASS AMENDED",8,1,0,0,9
1907943,1596082,2025-04-16,Senate,"Senate: Appropriations Committee: DO PASS",19,4,0,0,23
1907971,1505100,2025-03-04,Senate,"Senate: Local & County Government Committee: DO PASS AMENDED",8,1,0,0,9
1908021,1488850,2025-02-13,Senate,"Senate: Energy Committee: DO PASS",9,2,0,0,11
1908021,1526456,2025-03-25,Senate,"Senate: THIRD READING",40,5,0,2,47
1908021,1534208,2025-04-02,House,"House: Energy Committee: DO PASS",10,0,0,0,10
1908021,1555685,2025-04-23,House,"House: THIRD READING",82,2,1,13,98
1908021,1555686,2025-04-23,House,"House: EMERGENCY",68,12,1,17,98
1908021,1596262,2025-04-16,House,"House: Energy and Natural Resources Oversight Committee: DO PASS",13,0,0,0,13
1908263,1494883,2025-02-20,Senate,"Senate: Energy Committee: DO PASS AMENDED CS",10,0,0,0,10
1908263,1526747,2025-03-25,Senate,"Senate: THIRD READING",46,0,0,1,47
1908263,1542328,2025-04-08,House,"House: Utilities Committee: DO PASS",7,0,0,0,7
1908263,1568551,2025-05-08,House,"House: THIRD READING",90,0,0,8,98
1908263,1596265,2025-04-16,House,"House: Energy and Natural Resources Oversight Committee: DO PASS",14,0,0,0,14
1908356,1491462,2025-02-17,Senate,"Senate: Revenue & Taxation Committee: DO PASS",10,0,0,0,10
1908418,1498819,2025-02-25,Senate,"Senate: Retirement & Government Resources Committee: DO PASS AMENDED CS",6,2,0,0,8
1908451,1486226,2025-02-11,Senate,"Senate: Education Committee: DO PASS AMENDED",8,3,0,0,11
1908477,1493651,2025-02-19,Senate,"Senate: Economic Development, Workforce & Tourism Committee: DO PASS",9,0,0,0,9
1908477,1511660,2025-03-10,Senate,"Senate: THIRD READING",46,0,0,1,47
1908477,1542359,2025-04-09,House,"House: County and Municipal Government Committee: DO PASS",5,0,0,0,5
1908477,1567720,2025-05-07,House,"House: THIRD READING",80,7,0,11,98
1908477,1596263,2025-04-22,House,"House: Government Oversight Committee: DO PASS",16,0,0,0,16
1908539,1486174,2025-02-11,House,"House: Agriculture Committee: DO PASS AS AMENDED BY CS",8,0,0,0,8
1908539,1503680,2025-03-03,House,"House: Energy and Natural Resources Oversight Committee: DO PASS AS AMENDED BY CS",13,0,0,0,13
1908539,1513113,2025-03-11,House,"House: THIRD READING",83,4,0,12,99
1908570,1484879,2025-02-10,Senate,"Senate: Finance Committee: DO PASS",11,0,0,0,11
1908656,1503459,2025-03-03,Senate,"Senate: Agriculture & Wildlife Committee: DO PASS AMENDED CS",12,0,0,0,12
1908686,1486366,2025-02-11,Senate,"Senate: Retirement & Insurance Committee: DO PASS",8,0,0,0,8
1910241,1499459,2025-02-25,Senate,"Senate: Local & County Government Committee: DO PASS AMENDED CS",6,3,0,0,9
1910241,1526751,2025-03-25,Senate,"Senate: THIRD READING",26,20,0,1,47
1910408,1490932,2025-02-17,Senate,"Senate: Aeronautics & Transportation Committee: DO PASS",12,0,0,0,12
1910583,1493278,2025-02-19,Senate,"Senate: Local & County Government Committee: DO PASS",7,2,0,0,9
1911261,1499236,2025-02-25,Senate,"Senate: Judiciary Committee: DO PASS AMENDED CS",7,1,0,0,8
1911261,1519341,2025-03-17,Senate,"Senate: THIRD READING",42,3,0,2,47
1911261,1538335,2025-04-07,House,"House: Appropriations and Budget Education Subcommittee: DO PASS",10,1,0,0,11
1911261,1559532,2025-04-28,House,"House: THIRD READING",69,19,0,10,98
1911261,1596267,2025-04-16,House,"House: Appropriations and Budget Committee: DO PASS",26,2,0,0,28
1911655,1499224,2025-02-25,Senate,"Senate: Judiciary Committee: DO PASS",8,0,0,0,8
1911655,1529090,2025-03-27,Senate,"Senate: THIRD READING",36,7,0,4,47
1911655,1538858,2025-04-03,House,"House: Civil Judiciary Committee: DO PASS",10,0,0,0,10
1911655,1568274,2025-05-08,House,"House: THIRD READING",89,2,0,7,98
1911655,1596268,2025-04-17,House,"House: Judiciary and Public Safety Oversight Committee: DO PASS",12,0,0,0,12
1911907,1507094,2025-03-06,Senate,"Senate: Business & Insurance Committee: DO PASS AMENDED CS",11,0,0,0,11
1911907,1516080,2025-03-12,Senate,"Senate: THIRD READING",42,0,0,5,47
1911907,1544117,2025-04-10,House,"House: Civil Judiciary Committee: DO PASS",8,0,0,0,8
1911907,1565077,2025-05-05,House,"House: THIRD READING",90,0,0,8,98
1911907,1596269,2025-04-17,House,"House: Judiciary and Public Safety Oversight Committee: DO PASS",12,0,0,0,12
1914804,1493543,2025-02-19,Senate,"Senate: Public Safety Committee: DO PASS",5,2,0,0,7
1914804,1527410,2025-03-26,Senate,"Senate: THIRD READING",38,8,0,1,47
1914804,1542044,2025-04-09,House,"House: State Powers Committee: DO PASS",4,1,0,0,5
1914804,1558876,2025-04-28,House,"House: THIRD READING",73,16,0,9,98
1914804,1596272,2025-04-17,House,"House: Government Oversight Committee: DO PASS",13,3,0,0,16
1914810,1493135,2025-02-19,Senate,"Senate: Education Committee: DO PASS",8,1,0,0,9
1914811,1504564,2025-03-04,Senate,"Senate: Education Committee: DO PASS",11,0,0,0,11
1914817,1493541,2025-02-19,Senate,"Senate: Public Safety Committee: DO PASS",5,2,0,0,7
1914831,1507105,2025-03-06,Senate,"Senate: Business & Insurance Committee: DO PASS",10,0,0,0,10
1914831,1525549,2025-03-24,Senate,"Senate: THIRD READING",46,0,0,1,47
1914831,1539381,2025-04-08,House,"House: Business Committee: DO PASS",9,0,0,0,9
1914831,1596276,2025-04-24,House,"House: Commerce and Economic Development Oversight Committee: DO PASS",16,0,0,0,16
1914845,1494667,2025-02-20,Senate,"Senate: Business & Insurance Committee: DO PASS",10,0,0,0,10
1914845,1525385,2025-03-24,Senate,"Senate: THIRD READING",46,0,0,1,47
1914845,1539998,2025-04-08,House,"House: Business Committee: DO PASS",9,0,0,0,9
1914845,1566788,2025-05-06,House,"House: THIRD READING",91,1,0,6,98
1914845,1596274,2025-04-17,House,"House: Commerce and Economic Development Oversight Committee: DO PASS",16,0,0,0,16
1914924,1493289,2025-02-19,Senate,"Senate: Public Safety Committee: DO PASS AMENDED CS",6,2,0,0,8
1914944,1489265,2025-02-13,Senate,"Senate: Business & Insurance Committee: DO PASS",10,0,0,0,10
1914944,1528567,2025-03-27,Senate,"Senate: THIRD READING",36,7,0,4,47
1914944,1541315,2025-04-09,House,"House: Alcohol, Tobacco and Controlled Substances Committee: DO PASS AS AMENDED BY CS",7,2,0,0,9
1914944,1560705,2025-04-29,House,"House: THIRD READING",81,2,0,15,98
1914944,1591367,2025-05-13,Senate,"Senate: FOURTH READING",38,6,0,3,47
1914944,1596275,2025-04-14,House,"House: Health and Human Services Oversight Committee: DO PASS AS AMENDED BY CS",13,0,0,0,13
1914967,1503434,2025-03-03,Senate,"Senate: Aeronautics & Transportation Committee: DO PASS AMENDED CS",11,0,0,0,11
1914967,1507771,2025-03-06,Senate,"Senate: THIRD READING",46,0,0,1,47
1914967,1539758,2025-04-08,House,"House: Banking, Financial Services and Pensions Committee: DO PASS AS AMENDED BY CS",9,0,0,0,9
1914967,1555187,2025-04-23,House,"House: THIRD READING",86,0,0,12,98
1914967,1555188,2025-04-23,House,"House: EMERGENCY",68,5,0,25,98
1914967,1591495,2025-05-21,Senate,"Senate: FOURTH READING",40,0,0,8,48
1914967,1596279,2025-04-17,House,"House: Government Oversight Committee: DO PASS AS AMENDED BY CS",11,0,0,0,11
1914985,1490866,2025-02-17,Senate,"Senate: Health & Human Services Committee: DO PASS",10,0,0,0,10
1914985,1507253,2025-03-06,Senate,"Senate: THIRD READING",46,0,0,1,47
1914985,1542147,2025-04-09,House,"House: Alcohol, Tobacco and Controlled Substances Committee: DO PASS",6,1,0,0,7
1914985,1565062,2025-05-05,House,"House: THIRD READING",81,9,0,8,98
1914985,1596277,2025-04-14,House,"House: Health and Human Services Oversight Committee: DO PASS",13,0,0,0,13
1915024,1486389,2025-02-11,Senate,"Senate: Public Safety Committee: DO PASS",8,0,0,0,8
1915024,1509095,2025-03-10,Senate,"Senate: THIRD READING",43,3,0,1,47
1915024,1541965,2025-04-09,House,"House: Public Safety Committee: DO PASS",7,0,0,0,7
1915024,1563477,2025-05-01,House,"House: THIRD READING",81,0,0,17,98
1915024,1596278,2025-04-17,House,"House: Judiciary and Public Safety Oversight Committee: DO PASS",12,0,0,0,12
1915045,1507096,2025-03-06,Senate,"Senate: Business & Insurance Committee: DO PASS AMENDED",10,0,0,0,10
1915045,1526815,2025-03-25,Senate,"Senate: THIRD READING",46,0,0,1,47
1915045,1542994,2025-04-08,House,"House: Insurance Committee: DO PASS",6,0,0,0,6
1915045,1565197,2025-05-05,House,"House: THIRD READING",90,0,0,8,98
1915045,1596273,2025-04-24,House,"House: Commerce and Economic Development Oversight Committee: DO PASS",16,0,0,0,16
1915088,1485261,2025-02-10,House,"House: Appropriations and Budget Select Agencies Subcommittee: DO PASS",5,0,0,0,5
1915088,1506701,2025-03-05,House,"House: Appropriations and Budget Committee: DO PASS AS AMENDED BY CS",26,5,0,0,31
1915088,1528460,2025-03-26,House,"House: THIRD READING",66,29,0,4,99
1915088,1556449,2025-04-24,Senate,"Senate: Business & Insurance Committee: DO PASS AMENDED",6,3,0,0,9
1915147,1507079,2025-03-06,Senate,"Senate: Business & Insurance Committee: DO PASS AMENDED",10,0,0,0,10
1915303,1489254,2025-02-13,Senate,"Senate: Technology & Telecommunications Committee: DO PASS AMENDED",7,0,0,0,7
1915303,1527473,2025-03-26,Senate,"Senate: THIRD READING",46,0,0,1,47
1915303,1541396,2025-04-09,House,"House: Government Modernization and Technology Committee: DO PASS",8,0,0,0,8
1915303,1596288,2025-04-24,House,"House: Commerce and Economic Development Oversight Committee: DO PASS",15,2,0,0,17
1915321,1485867,2025-02-11,Senate,"Senate: Public Safety Committee: DO PASS",6,2,0,0,8
1915340,1489201,2025-02-13,Senate,"Senate: Veterans & Military Affairs Committee: DO PASS AMENDED CS",9,0,0,0,9
1915340,1509506,2025-03-10,Senate,"Senate: THIRD READING",47,0,0,0,47
1915340,1544524,2025-04-10,House,"House: Veterans and Military Affairs Committee: DO PASS",6,0,0,0,6
1915340,1553500,2025-04-22,House,"House: THIRD READING",84,2,0,12,98
1915340,1596282,2025-04-16,House,"House: Health and Human Services Oversight Committee: DO PASS",12,0,0,0,12
1915366,1487054,2025-02-11,Senate,"Senate: General Government Committee: DO PASS",7,2,0,0,9
1915424,1486205,2025-02-11,Senate,"Senate: Public Safety Committee: DO PASS",6,2,0,0,8
1915424,1507134,2025-03-06,Senate,"Senate: THIRD READING",46,0,0,1,47
1915424,1540639,2025-04-08,House,"House: Criminal Judiciary Committee: DO PASS",4,0,0,0,4
1915424,1563547,2025-05-01,House,"House: THIRD READING",79,0,0,19,98
1915424,1596286,2025-04-17,House,"House: Judiciary and Public Safety Oversight Committee: DO PASS",12,0,0,0,12
1915445,1491292,2025-02-17,Senate,"Senate: Health & Human Services Committee: DO PASS AMENDED CS",7,3,0,0,10
1915469,1487058,2025-02-11,Senate,"Senate: Judiciary Committee: DO PASS",8,0,0,0,8
1915469,1506067,2025-03-05,Senate,"Senate: THIRD READING",46,1,0,0,47
1915469,1538150,2025-04-07,House,"House: Elections and Ethics Committee: DO PASS",5,0,0,0,5
1915469,1566399,2025-05-06,House,"House: THIRD READING",90,0,0,8,98
1915469,1596284,2025-04-15,House,"House: Government Oversight Committee: DO PASS",15,0,0,0,15
1915529,1499480,2025-02-25,Senate,"Senate: Judiciary Committee: DO PASS AMENDED CS",8,1,0,0,9
1915529,1509687,2025-03-10,Senate,"Senate: THIRD READING",45,2,0,0,47
1915529,1544180,2025-04-10,House,"House: Civil Judiciary Committee: DO PASS AS AMENDED BY CS",8,0,0,0,8
1915529,1567775,2025-05-07,House,"House: THIRD READING",83,5,0,10,98
1915529,1591439,2025-05-15,Senate,"Senate: FOURTH READING",38,4,0,5,47
1915529,1596283,2025-04-17,House,"House: Judiciary and Public Safety Oversight Committee: DO PASS AS AMENDED BY CS",12,0,0,0,12
1915548,1491372,2025-02-17,Senate,"Senate: Health & Human Services Committee: DO PASS",5,5,0,0,10
1915570,1489388,2025-02-13,Senate,"Senate: Technology & Telecommunications Committee: DO PASS",7,0,0,0,7
1915570,1517288,2025-03-13,Senate,"Senate: THIRD READING",46,0,0,1,47
1915570,1541429,2025-04-09,House,"House: Public Safety Committee: DO PASS",7,0,0,0,7
1915570,1560938,2025-04-29,House,"House: THIRD READING",86,0,0,12,98
1915570,1596289,2025-04-17,House,"House: Judiciary and Public Safety Oversight Committee: DO PASS",12,0,0,0,12
1915615,1498352,2025-02-24,Senate,"Senate: Health & Human Services Committee: DO PASS",7,4,0,0,11
1915671,1487579,2025-02-12,House,"House: County and Municipal Government Committee: DO PASS AS AMENDED BY CS",6,0,0,0,6
1915671,1507619,2025-03-06,House,"House: Government Oversight Committee: DO PASS AS AMENDED BY CS",10,5,0,0,15
1915671,1524728,2025-03-24,House,"House: THIRD READING",48,47,0,4,99
1915691,1504407,2025-03-04,Senate,"Senate: Public Safety Committee: DO PASS AMENDED",6,1,0,0,7
1915734,1507106,2025-03-06,Senate,"Senate: Business & Insurance Committee: DO PASS AMENDED CS",10,0,0,0,10
1915734,1529031,2025-03-27,Senate,"Senate: THIRD READING",45,0,0,2,47
1915734,1541414,2025-04-09,House,"House: Alcohol, Tobacco and Controlled Substances Committee: DO PASS",8,0,0,0,8
1915754,1493947,2025-02-19,Senate,"Senate: Public Safety Committee: DO PASS",8,0,0,0,8
1915754,1528685,2025-03-26,Senate,"Senate: THIRD READING",46,0,0,1,47
1915754,1541932,2025-04-09,House,"House: Public Safety Committee: DO PASS",7,0,0,0,7
1915754,1558964,2025-04-28,House,"House: THIRD READING",83,3,0,12,98
1915754,1596287,2025-04-17,House,"House: Judiciary and Public Safety Oversight Committee: DO PASS",12,0,0,0,12
1915795,1493658,2025-02-19,Senate,"Senate: Local & County Government Committee: DO PASS",7,2,0,0,9
1915816,1482631,2025-02-04,House,"House: General Government Committee: DO PASS AS AMENDED BY CS",7,0,0,0,7
1915816,1489324,2025-02-13,House,"House: Government Oversight Committee: DO PASS AS AMENDED BY CS",14,2,0,0,16
1915816,1526231,2025-03-25,House,"House: THIRD READING",84,9,0,6,99
1915816,1547239,2025-04-14,Senate,"Senate: Aeronautics & Transportation Committee: DO PASS",8,0,0,0,8
1915816,1553895,2025-04-22,Senate,"Senate: THIRD READING",40,3,0,4,47
1915836,1501617,2025-02-27,Senate,"Senate: Business & Insurance Committee: DO PASS AMENDED CS",8,0,0,0,8
1915852,1494744,2025-02-20,Senate,"Senate: Business & Insurance Committee: DO PASS",10,0,0,0,10
1915852,1596280,2025-03-27,Senate,"Senate: SUSPEND RULE",17,30,0,0,47
1915908,1487112,2025-02-11,Senate,"Senate: General Government Committee: DO PASS",9,0,0,0,9
1915908,1514357,2025-03-11,Senate,"Senate: THIRD READING",42,0,0,5,47
1915908,1542156,2025-04-09,House,"House: County and Municipal Government Committee: DO PASS",5,0,0,0,5
1915908,1596296,2025-04-22,House,"House: Government Oversight Committee: DO PASS",10,6,0,0,16
1915981,1493943,2025-02-19,Senate,"Senate: Judiciary Committee: DO PASS AMENDED",6,2,0,0,8
1915981,1525571,2025-03-24,Senate,"Senate: THIRD READING",39,7,0,1,47
1915981,1541818,2025-04-09,House,"House: Alcohol, Tobacco and Controlled Substances Committee: DO PASS",8,0,0,0,8
1915981,1566849,2025-05-06,House,"House: THIRD READING",66,17,0,15,98
1915981,1581114,2025-05-29,Senate,"Senate: VETO OVERRIDE NO EMERGENCY",33,14,0,1,48
1915981,1581666,2025-05-29,House,"House: VETO OVERRIDE WITHOUT EMERGENCY",72,10,0,16,98
1915981,1596298,2025-02-26,Senate,"Senate: Appropriations Committee: DO PASS AMENDED",21,1,0,0,22
1915981,1596299,2025-04-16,House,"House: Health and Human Services Oversight Committee: DO PASS",13,0,0,0,13
1916005,1493400,2025-02-19,Senate,"Senate: Economic Development, Workforce & Tourism Committee: DO PASS",9,0,0,0,9
1916005,1516171,2025-03-12,Senate,"Senate: THIRD READING",44,0,0,3,47
1916005,1538131,2025-04-07,House,"House: Appropriations and Budget Natural Resources Subcommittee: DO PASS",10,0,0,0,10
1916005,1566268,2025-05-06,House,"House: THIRD READING",73,18,0,7,98
1916005,1596297,2025-04-16,House,"House: Appropriations and Budget Committee: DO PASS",27,0,0,0,27
1916055,1487483,2025-02-12,House,"House: County and Municipal Government Committee: DO PASS AS AMENDED BY CS",2,4,0,0,6
1916055,1507641,2025-03-06,House,"House: Government Oversight Committee: DO PASS AS AMENDED BY CS",6,9,0,0,15
1916142,1493485,2025-02-19,Senate,"Senate: Economic Development, Workforce & Tourism Committee: DO PASS",9,0,0,0,9
1916142,1509708,2025-03-10,Senate,"Senate: THIRD READING",46,0,0,1,47
1916142,1538649,2025-04-07,House,"House: Appropriations and Budget Education Subcommittee: DO PASS",10,0,0,0,10
1916173,1484875,2025-02-10,Senate,"Senate: Finance Committee: DO PASS",10,0,0,0,10
1916173,1514723,2025-03-11,Senate,"Senate: THIRD READING",45,0,0,2,47
1916173,1543999,2025-04-10,House,"House: Appropriations and Budget Finance Subcommittee: DO PASS",7,0,0,0,7
1916173,1566011,2025-05-06,House,"House: THIRD READING",89,2,0,7,98
1916173,1596301,2025-04-16,House,"House: Appropriations and Budget Committee: DO PASS",27,0,0,0,27
1916192,1504266,2025-03-04,Senate,"Senate: Education Committee: DO PASS",9,1,0,0,10
1916211,1504217,2025-03-04,Senate,"Senate: Education Committee: DO PASS AMENDED",9,0,0,0,9
1916211,1596291,2025-03-04,Senate,"Senate: ADOPT",9,0,0,0,9
1916211,1596292,2025-03-05,Senate,"Senate: Appropriations Committee: DO PASS",22,0,0,0,22
1916225,1486950,2025-02-11,Senate,"Senate: Economic Development, Workforce & Tourism Committee: DO PASS",9,0,0,0,9
1916225,1519151,2025-03-17,Senate,"Senate: THIRD READING",34,11,0,2,47
1916225,1538421,2025-04-07,House,"House: Appropriations and Budget Natural Resources Subcommittee: DO PASS",8,2,0,0,10
1916225,1559511,2025-04-28,House,"House: THIRD READING",56,34,0,8,98
1916225,1559512,2025-04-28,House,"House: EMERGENCY",62,27,0,9,98
1916225,1596302,2025-04-16,House,"House: Appropriations and Budget Committee: DO PASS",25,2,0,0,27
1916241,1484760,2025-02-10,House,"House: Appropriations and Budget Human Services Subcommittee: DO PASS AS AMENDED BY CS",5,0,0,0,5
1916241,1505241,2025-03-04,House,"House: Appropriations and Budget Committee: DO PASS AS AMENDED BY CS",29,2,0,0,31
1916241,1524822,2025-03-24,House,"House: THIRD READING",55,34,0,10,99
1916263,1486375,2025-02-11,Senate,"Senate: Public Safety Committee: DO PASS",6,2,0,0,8
1916347,1498368,2025-02-24,Senate,"Senate: Revenue & Taxation Committee: DO PASS",11,0,0,0,11
1916347,1524929,2025-03-24,Senate,"Senate: THIRD READING",46,0,0,1,47
1916398,1479934,2025-02-04,House,"House: General Government Committee: DO PASS",5,2,0,0,7
1916398,1504721,2025-03-04,House,"House: Government Oversight Committee: DO PASS",13,5,0,0,18
1916416,1484587,2025-02-10,Senate,"Senate: Agriculture & Rural Affairs Committee: DO PASS",10,2,0,0,12
1916468,1488964,2025-02-13,Senate,"Senate: Business & Insurance Committee: DO PASS",7,3,0,0,10
1916468,1525245,2025-03-24,Senate,"Senate: THIRD READING",28,18,0,1,47
1916468,1539403,2025-04-08,House,"House: Business Committee: DO PASS",5,4,0,0,9
1916484,1493633,2025-02-19,Senate,"Senate: Economic Development, Workforce & Tourism Committee: DO PASS",9,0,0,0,9
1916484,1517474,2025-03-13,Senate,"Senate: THIRD READING",42,2,0,3,47
1916484,1540167,2025-04-08,House,"House: Business Committee: DO PASS",8,0,0,0,8
1916484,1566787,2025-05-06,House,"House: THIRD READING",66,24,0,8,98
1916484,1596300,2025-04-17,House,"House: Commerce and Economic Development Oversight Committee: DO PASS",14,2,0,0,16
1916499,1504902,2025-03-04,Senate,"Senate: Education Committee: DO PASS AMENDED CS",10,0,0,0,10
1916499,1525028,2025-03-24,Senate,"Senate: THIRD READING",47,0,0,0,47
1916499,1534334,2025-04-02,House,"House: Common Education Committee: DO PASS",11,0,0,0,11
1916499,1563526,2025-05-01,House,"House: THIRD READING",78,0,0,20,98
1916499,1596290,2025-04-23,House,"House: Education Oversight Committee: DO PASS",9,0,0,0,9
1916523,1493180,2025-02-19,Senate,"Senate: Judiciary Committee: DO PASS",8,0,0,0,8
1916523,1509658,2025-03-10,Senate,"Senate: THIRD READING",46,0,0,1,47
1916523,1539712,2025-04-08,House,"House: Criminal Judiciary Committee: DO PASS",4,0,0,0,4
1916523,1562072,2025-04-30,House,"House: THIRD READING",89,0,0,9,98
1916523,1596270,2025-04-17,House,"House: Judiciary and Public Safety Oversight Committee: DO PASS",11,0,0,0,11
1916550,1486217,2025-02-11,Senate,"Senate: Public Safety Committee: DO PASS",6,2,0,0,8
1916550,1529249,2025-03-27,Senate,"Senate: THIRD READING",40,7,0,0,47
1916550,1539620,2025-04-08,House,"House: Criminal Judiciary Committee: DO PASS AS AMENDED BY CS",4,0,0,0,4
1916550,1566804,2025-05-06,House,"House: THIRD READING",93,0,0,5,98
1916550,1591659,2025-05-15,Senate,"Senate: FOURTH READING",35,6,0,6,47
1916550,1596295,2025-04-17,House,"House: Judiciary and Public Safety Oversight Committee: DO PASS AS AMENDED BY CS",12,0,0,0,12
1917033,1499050,2025-02-24,House,"House: Business Committee: DO PASS AS AMENDED BY CS",7,0,0,0,7
1917033,1504244,2025-03-04,House,"House: Commerce and Economic Development Oversight Committee: DO PASS AS AMENDED BY CS",14,0,0,0,14
1917033,1520354,2025-03-18,House,"House: THIRD READING",73,6,0,20,99
1917033,1544628,2025-04-10,Senate,"Senate: Business & Insurance Committee: DO PASS",8,0,0,0,8
1917033,1558810,2025-04-28,Senate,"Senate: THIRD READING",35,8,0,4,47
1917139,1504257,2025-03-04,Senate,"Senate: Public Safety Committee: DO PASS",5,1,0,0,6
1917139,1529151,2025-03-27,Senate,"Senate: THIRD READING",39,5,0,3,47
1917139,1540388,2025-04-08,House,"House: Criminal Judiciary Committee: DO PASS AS AMENDED BY CS",4,0,0,0,4
1917139,1559202,2025-04-28,House,"House: THIRD READING",80,8,0,10,98
1917139,1591774,2025-05-15,Senate,"Senate: FOURTH READING",36,6,0,5,47
1917139,1596311,2025-04-17,House,"House: Judiciary and Public Safety Oversight Committee: DO PASS AS AMENDED BY CS",8,2,0,0,10
1917164,1505216,2025-03-04,Senate,"Senate: Judiciary Committee: DO PASS AMENDED CS",5,3,0,0,8
1917183,1491569,2025-02-17,Senate,"Senate: Revenue & Taxation Committee: DO PASS",11,0,0,0,11
1917183,1516395,2025-03-12,Senate,"Senate: THIRD READING",34,11,0,2,47
1917183,1538289,2025-04-07,House,"House: Appropriations and Budget General Government Subcommittee: DO PASS",7,0,0,0,7
1917183,1560371,2025-04-29,House,"House: THIRD READING",70,15,0,13,98
1917183,1596303,2025-04-16,House,"House: Appropriations and Budget Committee: DO PASS",28,0,0,0,28
1917224,1491740,2025-02-17,Senate,"Senate: Revenue & Taxation Committee: DO PASS",11,0,0,0,11
1917224,1515727,2025-03-12,Senate,"Senate: THIRD READING",45,0,0,2,47
1917224,1544095,2025-04-10,House,"House: Appropriations and Budget Finance Subcommittee: DO PASS",7,0,0,0,7
1917224,1560219,2025-04-29,House,"House: THIRD READING",85,0,0,13,98
1917224,1596304,2025-04-16,House,"House: Appropriations and Budget Committee: DO PASS",27,0,0,0,27
1917261,1505429,2025-03-04,Senate,"Senate: Judiciary Committee: DO PASS",8,0,0,0,8
1917284,1499588,2025-02-25,Senate,"Senate: Public Safety Committee: DO PASS",8,0,0,0,8
1917284,1525213,2025-03-24,Senate,"Senate: THIRD READING",46,0,0,1,47
1917284,1541483,2025-04-09,House,"House: Oklahoma House of Representatives: DO PASS AS AMENDED BY CS",7,0,0,0,7
1917284,1541484,2025-04-09,House,"House: Oklahoma House of Representatives: DO PASS",7,0,0,0,7
1917284,1556235,2025-04-23,House,"House: EMERGENCY",68,17,0,13,98
1917284,1556236,2025-04-23,House,"House: THIRD READING",74,12,0,12,98
1917284,1596308,2025-04-09,House,"House: Public Safety Committee: DO PASS",7,0,0,0,7
1917284,1596309,2025-04-09,House,"House: Public Safety Committee: DO PASS AS AMENDED BY CS",7,0,0,0,7
1917284,1596310,2025-04-17,House,"House: Judiciary and Public Safety Oversight Committee: DO PASS",12,0,0,0,12
1917331,1484764,2025-02-10,House,"House: Appropriations and Budget Transportation Subcommittee: DO PASS AS AMENDED BY CS",7,0,0,0,7
1917331,1506172,2025-03-05,House,"House: Appropriations and Budget Committee: DO PASS AS AMENDED BY CS",31,0,0,0,31
1917331,1516522,2025-03-12,House,"House: THIRD READING",88,1,0,10,99
1917331,1547233,2025-04-14,Senate,"Senate: Aeronautics & Transportation Committee: DO PASS AMENDED",6,5,0,0,11
1917365,1484734,2025-02-10,House,"House: Elections and Ethics Committee: DO PASS AS AMENDED BY CS",5,1,0,0,6
1917365,1507648,2025-03-06,House,"House: Government Oversight Committee: DO PASS AS AMENDED BY CS",12,3,0,0,15
1917365,1518552,2025-03-17,House,"House: THIRD READING",65,18,0,16,99
1917365,1554156,2025-04-22,Senate,"Senate: Judiciary Committee: DO PASS AMENDED",6,2,0,0,8
1917387,1507150,2025-03-06,Senate,"Senate: Technology & Telecommunications Committee: DO PASS AMENDED CS",8,0,0,0,8
1917387,1527885,2025-03-26,Senate,"Senate: THIRD READING",42,2,0,3,47
1917387,1541569,2025-04-09,House,"House: Public Safety Committee: DO PASS",7,0,0,0,7
1917387,1596316,2025-04-17,House,"House: Judiciary and Public Safety Oversight Committee: DO PASS",10,0,0,0,10
1917405,1493573,2025-02-19,Senate,"Senate: Economic Development, Workforce & Tourism Committee: DO PASS",5,2,0,0,7
1917405,1512543,2025-03-11,Senate,"Senate: THIRD READING",27,17,0,3,47
1917405,1538081,2025-04-07,House,"House: Appropriations and Budget Natural Resources Subcommittee: DO PASS",6,4,0,0,10
1917405,1563410,2025-04-30,House,"House: THIRD READING",51,40,1,6,98
1917405,1596306,2025-04-15,House,"House: Appropriations and Budget Committee: DO PASS",19,8,0,0,27
1917424,1499342,2025-02-25,Senate,"Senate: Judiciary Committee: DO PASS",6,1,0,0,7
1917424,1519199,2025-03-17,Senate,"Senate: THIRD READING",45,0,0,2,47
1917424,1539018,2025-04-03,House,"House: Civil Judiciary Committee: DO PASS",10,0,0,0,10
1917424,1560345,2025-04-29,House,"House: THIRD READING",72,14,0,12,98
1917424,1596314,2025-04-17,House,"House: Judiciary and Public Safety Oversight Committee: DO PASS",10,0,0,0,10
1917490,1488673,2025-02-13,Senate,"Senate: Business & Insurance Committee: DO PASS AMENDED CS",8,2,0,0,10
1917490,1526806,2025-03-25,Senate,"Senate: THIRD READING",25,15,0,7,47
1917490,1596305,2025-03-25,Senate,"Senate: RECONSIDER",30,16,0,1,47
1917549,1490753,2025-02-17,Senate,"Senate: Aeronautics & Transportation Committee: DO PASS",10,2,0,0,12
1917581,1486117,2025-02-11,Senate,"Senate: Judiciary Committee: DO PASS",8,0,0,0,8
1917581,1515790,2025-03-12,Senate,"Senate: THIRD READING",44,0,0,3,47
1917581,1544721,2025-04-10,House,"House: Civil Judiciary Committee: DO PASS",8,0,0,0,8
1917581,1596315,2025-04-17,House,"House: Judiciary and Public Safety Oversight Committee: DO PASS",12,0,0,0,12
1917635,1493024,2025-02-19,House,"House: Government Modernization and Technology Committee: DO PASS",7,0,0,0,7
1917635,1504242,2025-03-04,House,"House: Commerce and Economic Development Oversight Committee: DO PASS",14,0,0,0,14
1917635,1519846,2025-03-18,House,"House: THIRD READING",79,0,0,20,99
1917635,1555505,2025-04-23,Senate,"Senate: Appropriations Committee: DO PASS",23,0,0,0,23
1917635,1563325,2025-05-01,Senate,"Senate: THIRD READING",46,0,0,1,47
1917664,1489094,2025-02-13,Senate,"Senate: Technology & Telecommunications Committee: DO PASS",5,2,0,0,7
1917664,1528818,2025-03-27,Senate,"Senate: THIRD READING",38,6,0,3,47
1917664,1538270,2025-04-07,House,"House: Appropriations and Budget Judiciary Subcommittee: DO PASS",6,1,0,0,7
1917664,1567334,2025-05-07,House,"House: THIRD READING",85,2,0,11,98
1917664,1591728,2025-05-20,Senate,"Senate: FOURTH READING",36,6,0,5,47
1917664,1596320,2025-04-16,House,"House: Appropriations and Budget Committee: DO PASS",27,0,0,0,27
1917719,1486230,2025-02-11,Senate,"Senate: Judiciary Committee: DO PASS",7,0,0,0,7
1917719,1526770,2025-03-25,Senate,"Senate: THIRD READING",46,0,0,1,47
1917719,1539854,2025-04-08,House,"House: Criminal Judiciary Committee: DO PASS",3,0,0,0,3
1917719,1559055,2025-04-28,House,"House: THIRD READING",89,0,0,9,98
1917719,1596319,2025-04-17,House,"House: Judiciary and Public Safety Oversight Committee: DO PASS",12,0,0,0,12
1917744,1507089,2025-03-06,Senate,"Senate: Business & Insurance Committee: DO PASS",10,0,0,0,10
1917744,1527036,2025-03-25,Senate,"Senate: THIRD READING",43,3,0,1,47
1917744,1541337,2025-04-09,House,"House: Public Health Committee: DO PASS",6,0,0,0,6
1917744,1566850,2025-05-06,House,"House: THIRD READING",68,15,0,15,98
1917744,1596328,2025-04-21,House,"House: Health and Human Services Oversight Committee: DO PASS",13,0,0,0,13
1917771,1499231,2025-02-25,Senate,"Senate: Public Safety Committee: DO PASS",7,0,0,0,7
1917771,1509629,2025-03-10,Senate,"Senate: THIRD READING",47,0,0,0,47
1917771,1539592,2025-04-08,House,"House: Criminal Judiciary Committee: DO PASS",4,0,0,0,4
1917771,1564070,2025-05-01,House,"House: THIRD READING",84,0,0,14,98
1917771,1596322,2025-04-17,House,"House: Judiciary and Public Safety Oversight Committee: DO PASS",12,0,0,0,12
1917780,1492945,2025-02-17,House,"House: Appropriations and Budget General Government Subcommittee: DO PASS",6,0,0,0,6
1917780,1506728,2025-03-05,House,"House: Appropriations and Budget Committee: DO PASS",29,1,0,0,30
1917780,1524942,2025-03-24,House,"House: THIRD READING",85,0,0,14,99
1917780,1539825,2025-04-08,Senate,"Senate: Retirement & Government Resources Committee: DO PASS AMENDED",8,0,0,0,8
1917780,1568317,2025-05-08,Senate,"Senate: THIRD READING",45,0,0,2,47
1917780,1571882,2025-05-15,House,"House: FOURTH READING",79,0,0,19,98
1917780,1581068,2025-05-29,House,"House: VETO OVERRIDE WITHOUT EMERGENCY",93,0,0,5,98
1917780,1581632,2025-05-29,Senate,"Senate: VETO OVERRIDE NO EMERGENCY",42,2,0,4,48
1917792,1486269,2025-02-11,Senate,"Senate: Public Safety Committee: DO PASS",7,2,0,0,9
1917792,1516287,2025-03-12,Senate,"Senate: THIRD READING",37,7,0,3,47
1917792,1541028,2025-04-08,House,"House: Criminal Judiciary Committee: DO PASS",4,0,0,0,4
1917792,1563768,2025-05-01,House,"House: THIRD READING",71,17,0,10,98
1917792,1581984,2025-05-29,Senate,"Senate: VETO OVERRIDE NO EMERGENCY",38,7,0,3,48
1917792,1581985,2025-05-29,House,"House: VETO OVERRIDE WITHOUT EMERGENCY",68,17,0,13,98
1917792,1596323,2025-04-17,House,"House: Judiciary and Public Safety Oversight Committee: DO PASS",9,3,0,0,12
1917875,1488618,2025-02-13,House,"House: Civil Judiciary Committee: DO PASS AS AMENDED BY CS",8,0,0,0,8
1917875,1501216,2025-02-27,House,"House: Judiciary and Public Safety Oversight Committee: DO PASS AS AMENDED BY CS",8,3,0,0,11
1917875,1516560,2025-03-12,House,"House: THIRD READING",39,50,0,10,99
1917892,1486922,2025-02-11,House,"House: Agriculture Committee: DO PASS AS AMENDED BY CS",6,1,0,0,7
1917892,1499869,2025-02-26,House,"House: Energy and Natural Resources Oversight Committee: DO PASS AS AMENDED BY CS",12,3,0,0,15
1917892,1525143,2025-03-24,House,"House: ,                    THIRD READING",86,7,0,6,99
1917892,1552445,2025-04-14,Senate,"Senate: Agriculture & Wildlife Committee: DO PASS",10,2,0,0,12
1917892,1563679,2025-05-01,Senate,"Senate: THIRD READING",40,7,0,0,47
1917913,1493478,2025-02-19,Senate,"Senate: Public Safety Committee: DO PASS",5,2,0,0,7
1917937,1486224,2025-02-11,Senate,"Senate: Judiciary Committee: DO PASS",7,1,0,0,8
1917937,1525258,2025-03-24,Senate,"Senate: THIRD READING",39,8,0,0,47
1917947,1486518,2025-02-11,Senate,"Senate: Retirement & Insurance Committee: DO PASS",7,0,0,0,7
1918012,1501365,2025-02-27,Senate,"Senate: Business & Insurance Committee: DO PASS AMENDED",11,0,0,0,11
1918012,1520488,2025-03-18,Senate,"Senate: THIRD READING",38,5,0,4,47
1918033,1489230,2025-02-13,Senate,"Senate: Energy Committee: DO PASS",9,1,0,0,10
1918048,1493553,2025-02-19,House,"House: Criminal Judiciary Committee: DO PASS",5,1,0,0,6
1918048,1501089,2025-02-27,House,"House: Judiciary and Public Safety Oversight Committee: DO PASS",8,2,0,0,10
1918048,1525398,2025-03-24,House,"House: THIRD READING",77,14,0,8,99
1918048,1548292,2025-04-15,Senate,"Senate: Public Safety Committee: DO PASS",6,2,0,0,8
1918058,1491517,2025-02-17,Senate,"Senate: Health & Human Services Committee: DO PASS",7,2,0,0,9
1918058,1517197,2025-03-13,Senate,"Senate: THIRD READING",38,6,0,3,47
1918081,1499181,2025-02-25,Senate,"Senate: Judiciary Committee: DO PASS AMENDED",5,2,0,0,7
1918081,1524959,2025-03-24,Senate,"Senate: THIRD READING",40,6,0,1,47
1918081,1544101,2025-04-10,House,"House: Civil Judiciary Committee: DO PASS",7,1,0,0,8
1918081,1568521,2025-05-08,House,"House: THIRD READING",71,19,1,7,98
1918081,1579737,2025-05-28,House,"House: FOURTH READING",77,12,2,7,98
1918081,1591459,2025-05-28,Senate,"Senate: FOURTH READING",39,7,0,2,48
1918081,1596324,2025-03-05,Senate,"Senate: Appropriations Committee: DO PASS",21,3,0,0,24
1918081,1596325,2025-04-22,House,"House: Judiciary and Public Safety Oversight Committee: DO PASS",10,0,0,0,10
1918140,1493990,2025-02-19,Senate,"Senate: Public Safety Committee: DO PASS AMENDED CS",8,0,0,0,8
1918140,1516263,2025-03-12,Senate,"Senate: THIRD READING",43,0,0,4,47
1918140,1541287,2025-04-09,House,"House: Public Safety Committee: DO PASS",7,0,0,0,7
1918140,1562503,2025-04-30,House,"House: THIRD READING",80,8,0,10,98
1918140,1596326,2025-04-22,House,"House: Judiciary and Public Safety Oversight Committee: DO PASS",10,0,0,0,10
1918170,1485029,2025-02-10,House,"House: Appropriations and Budget Human Services Subcommittee: DO PASS",5,0,0,0,5
1918170,1507621,2025-03-05,House,"House: Appropriations and Budget Committee: DO PASS",32,0,0,0,32
1918170,1517369,2025-03-13,House,"House: THIRD READING",83,0,0,16,99
1918170,1555041,2025-04-22,Senate,"Senate: Public Safety Committee: DO PASS",8,0,0,0,8
1918170,1559294,2025-04-28,Senate,"Senate: THIRD READING",42,1,0,4,47
1918170,1581626,2025-05-29,Senate,"Senate: VETO OVERRIDE NO EMERGENCY",40,4,0,4,48
1918170,1581627,2025-05-29,House,"House: VETO OVERRIDE WITHOUT EMERGENCY",91,1,0,6,98
1918191,1505266,2025-03-04,Senate,"Senate: Judiciary Committee: DO PASS AMENDED CS",8,1,0,0,9
1918191,1520316,2025-03-18,Senate,"Senate: THIRD READING",44,0,0,3,47
1918191,1540044,2025-04-08,House,"House: General Government Committee: DO PASS",8,0,0,0,8
1918191,1596329,2025-04-22,House,"House: Government Oversight Committee: DO PASS",15,0,0,0,15
1918263,1507102,2025-03-06,Senate,"Senate: Business & Insurance Committee: DO PASS",10,0,0,0,10
1918263,1528950,2025-03-27,Senate,"Senate: THIRD READING",32,7,0,8,47
1918263,1539549,2025-04-08,House,"House: Business Committee: DO PASS",6,0,0,0,6
1918263,1549038,2025-04-15,House,"House: Commerce and Economic Development Oversight Committee: DO PASS AS AMENDED BY CS",13,4,0,0,17
1918263,1568152,2025-05-08,House,"House: THIRD READING",58,32,1,7,98
1918263,1591350,2025-05-19,Senate,"Senate: FOURTH READING",33,13,0,1,47
1918283,1499545,2025-02-25,Senate,"Senate: Local & County Government Committee: DO PASS AMENDED CS",7,2,0,0,9
1918283,1527158,2025-03-25,Senate,"Senate: THIRD READING",30,14,0,3,47
1918283,1543014,2025-04-09,House,"House: County and Municipal Government Committee: DO PASS",5,0,0,0,5
1918283,1556864,2025-04-24,House,"House: Government Oversight Committee: DO PASS AS AMENDED, STRIKE THE TITLE",13,0,0,0,13
1918283,1567480,2025-05-07,House,"House: THIRD READING",52,39,0,7,98
1918298,1487114,2025-02-11,Senate,"Senate: Judiciary Committee: DO PASS",7,1,0,0,8
1918298,1509160,2025-03-10,Senate,"Senate: THIRD READING",43,4,0,0,47
1918298,1539804,2025-04-08,House,"House: Criminal Judiciary Committee: DO PASS",4,0,0,0,4
1918298,1567421,2025-05-07,House,"House: THIRD READING",87,1,0,10,98
1918298,1596317,2025-04-17,House,"House: Judiciary and Public Safety Oversight Committee: DO PASS",12,0,0,0,12
1918358,1491306,2025-02-17,House,"House: Appropriations and Budget Transportation Subcommittee: DO PASS AS AMENDED BY CS",9,0,0,0,9
1918374,1489330,2025-02-13,Senate,"Senate: Business & Insurance Committee: DO PASS",7,2,0,0,9
1918374,1526698,2025-03-25,Senate,"Senate: THIRD READING",43,3,0,1,47
1918374,1539665,2025-04-08,House,"House: Business Committee: DO PASS",8,0,0,0,8
1918374,1554079,2025-04-22,House,"House: Commerce and Economic Development Oversight Committee: DO PASS AS AMENDED BY CS",17,0,0,0,17
1918374,1560037,2025-04-29,House,"House: THIRD READING",84,0,0,14,98
1918374,1591334,2025-05-15,Senate,"Senate: FOURTH READING",40,2,0,5,47
1918427,1501461,2025-02-27,Senate,"Senate: Business & Insurance Committee: DO PASS AMENDED CS",9,2,0,0,11
1918427,1520174,2025-03-18,Senate,"Senate: THIRD READING",37,7,0,3,47
1918427,1544158,2025-04-10,House,"House: Civil Judiciary Committee: DO PASS",8,0,0,0,8
1918427,1568158,2025-05-08,House,"House: THIRD READING",74,18,0,6,98
1918427,1575180,2025-05-21,House,"House: FOURTH READING",81,12,0,5,98
1918427,1591310,2025-05-21,Senate,"Senate: FOURTH READING",40,6,0,2,48
1918427,1596327,2025-04-22,House,"House: Judiciary and Public Safety Oversight Committee: DO PASS",10,0,0,0,10
1918477,1493496,2025-02-19,Senate,"Senate: Public Safety Committee: DO PASS AMENDED CS",5,2,0,0,7
1918477,1529658,2025-03-27,Senate,"Senate: THIRD READING",37,8,0,2,47
1918477,1541391,2025-04-09,House,"House: Public Safety Committee: DO PASS",6,1,0,0,7
1918477,1596321,2025-04-22,House,"House: Judiciary and Public Safety Oversight Committee: DO PASS",8,2,0,0,10
1918501,1486949,2025-02-11,Senate,"Senate: General Government Committee: DO PASS AMENDED",3,6,0,0,9
1918513,1498211,2025-02-24,House,"House: Agriculture Committee: DO PASS AS AMENDED BY CS",4,2,0,0,6
1918513,1505992,2025-03-05,House,"House: Energy and Natural Resources Oversight Committee: DO PASS AS AMENDED BY CS",11,2,0,0,13
1918520,1505982,2025-03-05,Senate,"Senate: Rules Committee: DO PASS AMENDED CS",16,3,0,0,19
1918533,1493452,2025-02-19,House,"House: Criminal Judiciary Committee: DO PASS",5,1,0,0,6
1918533,1507636,2025-03-06,House,"House: Judiciary and Public Safety Oversight Committee: DO PASS",12,0,0,0,12
1918533,1519912,2025-03-18,House,"House: THIRD READING",52,28,0,19,99
1918533,1548259,2025-04-15,Senate,"Senate: Public Safety Committee: DO PASS",5,2,0,0,7
1918533,1565479,2025-05-06,Senate,"Senate: THIRD READING",36,9,0,2,47
1918533,1581062,2025-05-29,House,"House: VETO OVERRIDE WITHOUT EMERGENCY",71,17,0,10,98
1918533,1581980,2025-05-29,Senate,"Senate: VETO OVERRIDE NO EMERGENCY",35,9,0,4,48
1918553,1504571,2025-03-04,Senate,"Senate: Public Safety Committee: DO PASS AMENDED",5,1,0,0,6
1918553,1527074,2025-03-25,Senate,"Senate: THIRD READING",39,6,0,2,47
1918553,1541903,2025-04-09,House,"House: Public Safety Committee: DO NOT PASS",7,0,0,0,7
1918564,1507457,2025-03-06,Senate,"Senate: Energy Committee: DO PASS AMENDED CS",11,0,0,0,11
1918564,1526290,2025-03-25,Senate,"Senate: THIRD READING",47,0,0,0,47
1918564,1543688,2025-04-10,House,"House: Civil Judiciary Committee: DO PASS",8,0,0,0,8
1918570,1494982,2025-02-20,House,"House: Appropriations and Budget Finance Subcommittee: DO PASS AS AMENDED BY CS",9,0,0,0,9
1918570,1506784,2025-03-05,House,"House: Appropriations and Budget Committee: DO PASS AS AMENDED BY CS",30,0,0,0,30
1918570,1517162,2025-03-13,House,"House: THIRD READING",86,0,0,13,99
1918570,1547740,2025-04-14,Senate,"Senate: Revenue & Taxation Committee: DO PASS AMENDED",11,0,0,0,11
1918570,1565447,2025-05-06,Senate,"Senate: THIRD READING",44,0,0,3,47
1918570,1571013,2025-05-14,House,"House: FOURTH READING",79,0,0,19,98
1918570,1596083,2025-04-23,Senate,"Senate: Appropriations Committee: DO PASS",23,0,0,0,23
1918584,1486237,2025-02-11,Senate,"Senate: Retirement & Insurance Committee: DO PASS",6,2,0,0,8
1918612,1491464,2025-02-17,Senate,"Senate: Health & Human Services Committee: DO PASS",10,0,0,0,10
1918612,1527014,2025-03-25,Senate,"Senate: THIRD READING",47,0,0,0,47
1918612,1541436,2025-04-09,House,"House: Public Health Committee: DO PASS AS AMENDED BY CS",6,0,0,0,6
1918612,1563843,2025-05-01,House,"House: THIRD READING",82,0,0,16,98
1918612,1591387,2025-05-13,Senate,"Senate: FOURTH READING",43,0,0,4,47
1918612,1596337,2025-04-16,House,"House: Health and Human Services Oversight Committee: DO PASS AS AMENDED BY CS",12,1,0,0,13
1918618,1482433,2025-02-05,House,"House: Common Education Committee: DO PASS AS AMENDED BY CS",11,0,0,0,11
1918629,1482426,2025-02-05,House,"House: Energy Committee: DO PASS",9,0,0,0,9
1918629,1503469,2025-03-03,House,"House: Energy and Natural Resources Oversight Committee: DO PASS AS AMENDED BY CS",13,0,0,0,13
1918629,1518628,2025-03-17,House,"House: THIRD READING",76,9,0,14,99
1918629,1543564,2025-04-10,Senate,"Senate: Energy Committee: DO PASS",9,1,0,0,10
1918629,1560987,2025-04-29,Senate,"Senate: THIRD READING",43,3,0,1,47
1918637,1486626,2025-02-11,Senate,"Senate: Economic Development, Workforce & Tourism Committee: DO PASS",7,2,0,0,9
1918637,1509744,2025-03-10,Senate,"Senate: THIRD READING",32,15,0,0,47
1918637,1544068,2025-04-10,House,"House: Appropriations and Budget Finance Subcommittee: DO PASS",7,0,0,0,7
1918637,1565924,2025-05-06,House,"House: THIRD READING",63,23,0,12,98
1918637,1565925,2025-05-06,House,"House: EMERGENCY",69,17,0,12,98
1918637,1591416,2025-05-20,Senate,"Senate: FOURTH READING",25,17,0,5,47
1918637,1596336,2025-04-16,House,"House: Appropriations and Budget Committee: DO PASS",28,0,0,0,28
1918686,1486503,2025-02-11,House,"House: Insurance Committee: DO PASS",7,0,0,0,7
1918686,1498580,2025-02-25,House,"House: Commerce and Economic Development Oversight Committee: DO PASS",15,0,0,0,15
1918686,1503319,2025-03-03,House,"House: THIRD READING",93,2,0,4,99
1918686,1543604,2025-04-10,Senate,"Senate: Business & Insurance Committee: DO PASS AMENDED",8,0,0,0,8
1918686,1559527,2025-04-28,Senate,"Senate: THIRD READING",44,0,0,3,47
1918686,1574853,2025-05-21,House,"House: FOURTH READING",89,0,0,9,98
1918690,1482480,2025-02-05,House,"House: Public Health Committee: DO PASS",4,2,0,0,6
1918706,1485593,2025-02-10,House,"House: Elections and Ethics Committee: DO PASS",5,1,0,0,6
1918706,1498788,2025-02-25,House,"House: Government Oversight Committee: DO PASS",10,7,0,0,17
1918717,1493228,2025-02-19,House,"House: Banking, Financial Services and Pensions Committee: DO PASS AS AMENDED BY CS",7,1,0,0,8
1918717,1504562,2025-03-04,House,"House: Government Oversight Committee: DO PASS AS AMENDED BY CS",12,3,0,0,15
1918731,1494101,2025-02-19,Senate,"Senate: Economic Development, Workforce & Tourism Committee: DO PASS",7,2,0,0,9
1918762,1486553,2025-02-11,Senate,"Senate: Economic Development, Workforce & Tourism Committee: DO PASS",9,0,0,0,9
1918762,1509098,2025-03-10,Senate,"Senate: THIRD READING",32,14,0,1,47
1918762,1539337,2025-04-08,House,"House: Business Committee: DO PASS",6,0,0,0,6
1918762,1556964,2025-04-24,House,"House: Commerce and Economic Development Oversight Committee: DO PASS AS AMENDED BY CS",14,3,0,0,17
1918762,1566060,2025-05-06,House,"House: THIRD READING",67,20,0,11,98
1918762,1591335,2025-05-19,Senate,"Senate: FOURTH READING",28,18,0,1,47
1918785,1486259,2025-02-11,Senate,"Senate: Public Safety Committee: DO PASS",6,2,0,0,8
1918785,1527436,2025-03-26,Senate,"Senate: THIRD READING",38,8,0,1,47
1918785,1539327,2025-04-08,House,"House: Business Committee: DO PASS",7,2,0,0,9
1918785,1552723,2025-04-21,House,"House: THIRD READING",74,15,0,9,98
1918785,1596339,2025-04-15,House,"House: Commerce and Economic Development Oversight Committee: DO PASS",14,3,0,0,17
1918800,1503618,2025-03-03,Senate,"Senate: Health & Human Services Committee: DO PASS AMENDED",8,2,0,0,10
1918823,1483307,2025-02-06,House,"House: Civil Judiciary Committee: DO PASS",8,0,0,0,8
1918823,1507614,2025-03-06,House,"House: Judiciary and Public Safety Oversight Committee: DO PASS",12,0,0,0,12
1918823,1525047,2025-03-24,House,"House: THIRD READING",92,0,0,7,99
1918837,1482232,2025-02-04,House,"House: General Government Committee: DO PASS",6,1,0,0,7
1918837,1501451,2025-02-27,House,"House: Government Oversight Committee: DO PASS AS AMENDED BY CS",10,4,0,0,14
1918884,1493876,2025-02-19,House,"House: County and Municipal Government Committee: DO PASS AS AMENDED BY CS",6,0,0,0,6
1918884,1505141,2025-03-04,House,"House: Government Oversight Committee: DO PASS AS AMENDED BY CS",17,0,0,0,17
1918884,1525512,2025-03-24,House,"House: THIRD READING",76,18,0,5,99
1918884,1549054,2025-04-15,Senate,"Senate: Judiciary Committee: DO PASS",6,2,0,0,8
1918884,1567060,2025-05-07,Senate,"Senate: THIRD READING",44,1,0,2,47
1918884,1579913,2025-05-28,House,"House: FOURTH READING",87,2,0,9,98
1918884,1591379,2025-05-28,Senate,"Senate: FOURTH READING",44,2,0,2,48
1918893,1485361,2025-02-10,Senate,"Senate: Health & Human Services Committee: DO PASS",11,2,0,0,13
1918893,1500417,2025-02-26,Senate,"Senate: THIRD READING",38,7,0,2,47
1918893,1542584,2025-04-09,House,"House: Children, Youth and Family Services Committee: DO PASS",5,1,0,0,6
1918893,1566621,2025-05-06,House,"House: THIRD READING",68,19,0,11,98
1918893,1596335,2025-04-21,House,"House: Health and Human Services Oversight Committee: DO PASS",10,3,0,0,13
1918912,1493147,2025-02-19,Senate,"Senate: Judiciary Committee: DO PASS AMENDED CS",8,1,0,0,9
1918912,1526117,2025-03-25,Senate,"Senate: THIRD READING",47,0,0,0,47
1918912,1539088,2025-04-07,House,"House: Elections and Ethics Committee: DO PASS AS AMENDED BY CS",5,0,0,0,5
1918912,1567825,2025-05-07,House,"House: THIRD READING",93,0,0,5,98
1918912,1591311,2025-05-15,Senate,"Senate: FOURTH READING",36,7,0,4,47
1918912,1596332,2025-02-26,Senate,"Senate: Appropriations Committee: DO PASS",23,0,0,0,23
1918912,1596333,2025-04-17,House,"House: Government Oversight Committee: DO PASS AS AMENDED BY CS",16,0,0,0,16
1918919,1494117,2025-02-19,House,"House: Appropriations and Budget Public Safety Subcommittee: DO PASS",7,2,0,0,9
1918923,1487433,2025-02-12,House,"House: Public Health Committee: DO PASS",5,1,0,0,6
1918923,1505780,2025-03-05,House,"House: Health and Human Services Oversight Committee: DO PASS",10,1,0,0,11
1918936,1486344,2025-02-11,House,"House: Criminal Judiciary Committee: DO PASS",4,1,0,0,5
1918936,1507649,2025-03-06,House,"House: Judiciary and Public Safety Oversight Committee: DO PASS",8,2,0,0,10
1918936,1526655,2025-03-25,House,"House: THIRD READING",77,19,0,3,99
1918936,1552772,2025-04-21,Senate,"Senate: Health & Human Services Committee: DO PASS",7,3,0,0,10
1918953,1480201,2025-02-04,House,"House: Criminal Judiciary Committee: DO PASS",4,1,0,0,5
1918953,1501492,2025-02-27,House,"House: Judiciary and Public Safety Oversight Committee: DO PASS AS AMENDED BY CS",7,3,0,0,10
1918953,1527954,2025-03-26,House,"House: THIRD READING",66,17,0,16,99
1918953,1553223,2025-04-22,Senate,"Senate: Public Safety Committee: DO PASS",6,2,0,0,8
1918972,1493720,2025-02-19,Senate,"Senate: Local & County Government Committee: DO PASS",7,1,0,0,8
1918972,1514815,2025-03-11,Senate,"Senate: THIRD READING",40,6,0,1,47
1918972,1541686,2025-04-09,House,"House: County and Municipal Government Committee: DO PASS",5,0,0,0,5
1918972,1556634,2025-04-24,House,"House: Government Oversight Committee: DO PASS AS AMENDED BY CS",12,3,0,0,15
1918972,1566867,2025-05-06,House,"House: THIRD READING",61,20,0,17,98
1918972,1566868,2025-05-06,House,"House: EMERGENCY",60,18,0,20,98
1918972,1591708,2025-05-21,Senate,"Senate: FOURTH READING",39,4,0,5,48
1918984,1498778,2025-02-25,Senate,"Senate: Judiciary Committee: DO PASS AMENDED CS",9,0,0,0,9
1919001,1485496,2025-02-10,House,"House: Elections and Ethics Committee: DO PASS AS AMENDED BY CS",6,0,0,0,6
1919028,1505430,2025-03-04,Senate,"Senate: Judiciary Committee: DO PASS",6,1,0,0,7
1919028,1528467,2025-03-26,Senate,"Senate: THIRD READING",38,7,0,2,47
1919028,1540769,2025-04-08,House,"House: Criminal Judiciary Committee: DO PASS",3,0,0,0,3
1919028,1568022,2025-05-07,House,"House: THIRD READING",80,10,0,8,98
1919028,1596334,2025-04-17,House,"House: Judiciary and Public Safety Oversight Committee: DO PASS",12,0,0,0,12
1919035,1491476,2025-02-17,Senate,"Senate: Health & Human Services Committee: DO PASS",10,0,0,0,10
1919344,1480171,2025-02-04,House,"House: Agriculture Committee: DO PASS",5,2,0,0,7
1919344,1505990,2025-03-05,House,"House: Energy and Natural Resources Oversight Committee: DO PASS",12,3,0,0,15
1919347,1489585,2025-02-13,Senate,"Senate: Energy Committee: DO PASS",10,1,0,0,11
1919360,1491097,2025-02-17,House,"House: Appropriations and Budget Transportation Subcommittee: DO PASS AS AMENDED BY CS",9,0,0,0,9
1919365,1483222,2025-02-06,House,"House: Appropriations and Budget Finance Subcommittee: DO PASS AS AMENDED BY CS",8,0,0,0,8
1919370,1498763,2025-02-25,Senate,"Senate: Education Committee: DO PASS",11,0,0,0,11
1919370,1513783,2025-03-11,Senate,"Senate: THIRD READING",43,1,0,3,47
1919370,1539658,2025-04-08,House,"House: Postsecondary Education Committee: DO PASS AS AMENDED BY CS",5,2,0,0,7
1919370,1566437,2025-05-06,House,"House: THIRD READING",51,43,0,4,98
1919370,1591313,2025-05-21,Senate,"Senate: FOURTH READING",29,15,0,4,48
1919370,1596354,2025-04-16,House,"House: Education Oversight Committee: DO PASS AS AMENDED BY CS",7,2,0,0,9
1919374,1493988,2025-02-19,Senate,"Senate: Retirement & Government Resources Committee: DO PASS AMENDED",8,0,0,0,8
1919374,1526634,2025-03-25,Senate,"Senate: THIRD READING",46,0,0,1,47
1919421,1483330,2025-02-06,House,"House: Appropriations and Budget Finance Subcommittee: DO PASS",8,0,0,0,8
1919421,1500793,2025-02-26,House,"House: Appropriations and Budget Committee: DO PASS AS AMENDED, STRIKE THE TITLE",24,5,0,0,29
1919421,1506044,2025-03-05,House,"House: THIRD READING",89,6,0,4,99
1919421,1548128,2025-04-14,Senate,"Senate: Revenue & Taxation Committee: DO PASS AMENDED CS",10,0,0,0,10
1919421,1596084,2025-04-23,Senate,"Senate: Appropriations Committee: DO PASS AMENDED CS",14,5,0,0,19
1919424,1493376,2025-02-19,Senate,"Senate: Economic Development, Workforce & Tourism Committee: DO PASS AMENDED",7,0,0,0,7
1919449,1498162,2025-02-24,House,"House: Public Health Committee: DO PASS",6,1,0,0,7
1919449,1503936,2025-03-03,House,"House: Health and Human Services Oversight Committee: DO PASS",7,6,0,0,13
1919449,1527891,2025-03-26,House,"House: THIRD READING",70,28,0,1,99
1919449,1547424,2025-04-14,Senate,"Senate: Health & Human Services Committee: DO PASS AMENDED CS",9,3,0,0,12
1919449,1566061,2025-05-06,Senate,"Senate: THIRD READING",38,7,0,2,47
1919471,1497701,2025-02-24,Senate,"Senate: Agriculture & Wildlife Committee: DO PASS AMENDED",12,0,0,0,12
1919471,1516981,2025-03-13,Senate,"Senate: THIRD READING",45,0,0,2,47
1919471,1540297,2025-04-08,House,"House: Agriculture Committee: DO PASS",8,0,0,0,8
1919475,1486376,2025-02-11,Senate,"Senate: Education Committee: DO PASS",11,0,0,0,11
1919475,1516280,2025-03-12,Senate,"Senate: THIRD READING",44,0,0,3,47
1919492,1497487,2025-02-24,House,"House: General Government Committee: DO PASS AS AMENDED BY CS",5,1,0,0,6
1919492,1507260,2025-03-06,House,"House: Government Oversight Committee: DO PASS AS AMENDED BY CS",10,4,0,0,14
1919492,1526836,2025-03-25,House,"House: THIRD READING",40,54,0,5,99
1919499,1484878,2025-02-10,Senate,"Senate: Finance Committee: DO PASS",11,0,0,0,11
1919499,1528232,2025-03-26,Senate,"Senate: THIRD READING",45,0,0,2,47
1919499,1544074,2025-04-10,House,"House: Appropriations and Budget Finance Subcommittee: DO PASS",7,0,0,0,7
1919499,1563373,2025-05-01,House,"House: THIRD READING",81,0,0,17,98
1919499,1596343,2025-04-16,House,"House: Appropriations and Budget Committee: DO PASS",27,0,0,0,27
1919523,1483441,2025-02-06,House,"House: Appropriations and Budget Finance Subcommittee: DO PASS AS AMENDED BY CS",8,0,0,0,8
1919523,1487690,2025-02-12,House,"House: Appropriations and Budget Committee: DO PASS AS AMENDED, STRIKE THE T ITLE",23,5,0,0,28
1919523,1490580,2025-02-12,House,"House: Appropriations and Budget Committee: DO PASS AS AMENDED BY CS",23,5,0,0,28
1919523,1501164,2025-02-27,House,"House: THIRD READING",78,13,0,8,99
1919523,1548091,2025-04-14,Senate,"Senate: Revenue & Taxation Committee: DO PASS AMENDED",9,2,0,0,11
1919523,1596085,2025-02-12,House,"House: Appropriations and Budget Committee: DO PASS AS AMENDED, STRIKE THE TITLE",23,5,0,0,28
1919523,1596086,2025-04-23,Senate,"Senate: Appropriations Committee: DO PASS",17,5,1,0,23
1919528,1504545,2025-03-04,Senate,"Senate: Public Safety Committee: DO PASS AMENDED",7,0,0,0,7
1919528,1525275,2025-03-24,Senate,"Senate: THIRD READING",46,0,0,1,47
1919528,1541786,2025-04-09,House,"House: Public Safety Committee: DO PASS",7,0,0,0,7
1919528,1565234,2025-05-05,House,"House: THIRD READING",89,0,0,9,98
1919528,1596351,2025-04-17,House,"House: Judiciary and Public Safety Oversight Committee: DO PASS",9,0,0,0,9
1919544,1492949,2025-02-17,House,"House: Appropriations and Budget General Government Subcommittee: DO PASS",4,1,0,0,5
1919550,1499291,2025-02-25,Senate,"Senate: Local & County Government Committee: DO PASS AMENDED CS",8,0,0,0,8
1919550,1514730,2025-03-11,Senate,"Senate: THIRD READING",40,0,0,7,47
1919550,1542282,2025-04-09,House,"House: County and Municipal Government Committee: DO PASS",5,0,0,0,5
1919550,1565042,2025-05-05,House,"House: THIRD READING",86,4,0,8,98
1919550,1581387,2025-05-29,Senate,"Senate: VETO OVERRIDE NO EMERGENCY",47,0,0,1,48
1919550,1581948,2025-05-29,House,"House: VETO OVERRIDE WITHOUT EMERGENCY",77,4,0,17,98
1919550,1596352,2025-04-22,House,"House: Government Oversight Committee: DO PASS",16,0,0,0,16
1919573,1486627,2025-02-11,House,"House: Banking, Financial Services and Pensions Committee: DO PASS",8,0,0,0,8
1919573,1498784,2025-02-25,House,"House: Government Oversight Committee: DO PASS",12,4,0,0,16
1919573,1524956,2025-03-24,House,"House: THIRD READING",73,15,0,11,99
1919573,1548613,2025-04-15,Senate,"Senate: Retirement & Government Resources Committee: DO PASS AMENDED",7,1,0,0,8
1919575,1494651,2025-02-20,Senate,"Senate: Business & Insurance Committee: DO PASS AMENDED CS",10,0,0,0,10
1919575,1512489,2025-03-11,Senate,"Senate: THIRD READING",42,0,0,5,47
1919575,1539380,2025-04-08,House,"House: Business Committee: DO PASS",8,1,0,0,9
1919575,1556973,2025-04-24,House,"House: Commerce and Economic Development Oversight Committee: DO PASS AS AMENDED BY CS",16,1,0,0,17
1919575,1566406,2025-05-06,House,"House: THIRD READING",84,1,0,13,98
1919575,1591450,2025-05-20,Senate,"Senate: FOURTH READING",41,2,0,4,47
1919581,1495353,2025-02-20,House,"House: Appropriations and Budget Finance Subcommittee: DO PASS",9,0,0,0,9
1919581,1504756,2025-03-04,House,"House: Appropriations and Budget Committee: DO PASS",30,0,0,0,30
1919581,1516967,2025-03-12,House,"House: TABLE",68,14,0,17,99
1919581,1516968,2025-03-12,House,"House: THIRD READING",83,0,0,16,99
1919581,1563460,2025-04-07,Senate,"Senate: Revenue & Taxation Committee: DO PASS",10,0,0,0,10
1919581,1563461,2025-05-01,Senate,"Senate: THIRD READING",46,0,0,1,47
1919592,1485397,2025-02-10,House,"House: Appropriations and Budget Education Subcommittee: DO PASS AS AMENDED BY CS",7,2,0,0,9
1919598,1497718,2025-02-24,House,"House: Agriculture Committee: DO PASS AS AMENDED BY CS",4,3,0,0,7
1919598,1505901,2025-03-05,House,"House: Energy and Natural Resources Oversight Committee: DO PASS AS AMENDED BY CS",12,3,0,0,15
1919612,1484868,2025-02-10,Senate,"Senate: Finance Committee: DO PASS",5,6,0,0,11
1919619,1479479,2025-02-04,House,"House: General Government Committee: DO PASS",5,2,0,0,7
1919619,1507204,2025-03-06,House,"House: Government Oversight Committee: DO PASS AS AMENDED BY CS",12,3,0,0,15
1919624,1498599,2025-02-25,Senate,"Senate: Education Committee: DO PASS",9,0,0,0,9
1919639,1504331,2025-03-04,Senate,"Senate: Education Committee: DO PASS AMENDED CS",11,0,0,0,11
1919648,1493721,2025-02-19,Senate,"Senate: Retirement & Government Resources Committee: DO PASS AMENDED CS",9,0,0,0,9
1919648,1516931,2025-03-13,Senate,"Senate: THIRD READING",46,0,0,1,47
1919648,1531928,2025-04-01,House,"House: General Government Committee: DO PASS",8,0,0,0,8
1919648,1568594,2025-05-08,House,"House: THIRD READING",76,14,0,8,98
1919648,1580224,2025-05-28,House,"House: FOURTH READING",88,2,0,8,98
1919648,1591370,2025-05-28,Senate,"Senate: FOURTH READING",46,0,0,2,48
1919648,1596340,2025-04-17,House,"House: Government Oversight Committee: DO PASS",9,0,0,0,9
1919652,1487577,2025-02-12,House,"House: County and Municipal Government Committee: DO PASS AS AMENDED BY CS",6,0,0,0,6
1919652,1499200,2025-02-25,House,"House: Government Oversight Committee: DO PASS AS AMENDED BY CS",15,0,0,0,15
1919652,1503487,2025-03-03,House,"House: THIRD READING",97,0,0,2,99
1919652,1550921,2025-04-17,Senate,"Senate: Energy Committee: DO PASS AMENDED CS",6,2,0,0,8
1919660,1493925,2025-02-19,House,"House: Criminal Judiciary Committee: DO PASS",5,1,0,0,6
1919660,1501358,2025-02-27,House,"House: Judiciary and Public Safety Oversight Committee: DO PASS",10,3,0,0,13
1919660,1526322,2025-03-25,House,"House: THIRD READING",79,17,0,3,99
1919660,1553692,2025-04-22,Senate,"Senate: Judiciary Committee: DO PASS",6,2,0,0,8
1919660,1563576,2025-05-01,Senate,"Senate: THIRD READING",39,8,0,0,47
1919689,1507103,2025-03-06,Senate,"Senate: Technology & Telecommunications Committee: DO PASS",8,0,0,0,8
1919694,1494031,2025-02-19,House,"House: Criminal Judiciary Committee: DO PASS AS AMENDED BY CS",6,0,0,0,6
1919694,1501245,2025-02-27,House,"House: Judiciary and Public Safety Oversight Committee: DO PASS AS AMENDED BY CS",13,0,0,0,13
1919694,1516240,2025-03-12,House,"House: THIRD READING",88,0,0,11,99
1919694,1548914,2025-04-15,Senate,"Senate: Judiciary Committee: DO PASS AMENDED",6,0,0,0,6
1919696,1497639,2025-02-24,Senate,"Senate: Revenue & Taxation Committee: DO PASS",7,5,0,0,12
1919696,1527548,2025-03-26,Senate,"Senate: THIRD READING",31,14,1,1,47
1919696,1538890,2025-04-07,House,"House: Appropriations and Budget General Government Subcommittee: DO PASS",7,1,0,0,8
1919696,1596342,2025-04-15,House,"House: Appropriations and Budget Committee: DO PASS",15,12,0,0,27
1919715,1486456,2025-02-11,Senate,"Senate: Education Committee: DO PASS AMENDED",11,0,0,0,11
1919715,1525408,2025-03-24,Senate,"Senate: THIRD READING",47,0,0,0,47
1919715,1541645,2025-04-09,House,"House: Common Education Committee: DO PASS AS AMENDED BY CS",10,1,0,0,11
1919715,1568209,2025-05-08,House,"House: THIRD READING",87,6,0,5,98
1919715,1576306,2025-05-22,House,"House: FOURTH READING",76,5,0,17,98
1919715,1591477,2025-05-22,Senate,"Senate: FOURTH READING",41,5,0,2,48
1919715,1596355,2025-04-23,House,"House: Education Oversight Committee: DO PASS AS AMENDED BY CS",9,0,0,0,9
1919726,1497473,2025-02-24,House,"House: General Government Committee: DO PASS AS AMENDED BY CS",6,0,0,0,6
1919726,1507300,2025-03-06,House,"House: Government Oversight Committee: DO PASS AS AMENDED BY CS",11,3,0,0,14
1919752,1489211,2025-02-13,Senate,"Senate: Veterans & Military Affairs Committee: DO PASS AMENDED",9,0,0,0,9
1919752,1512518,2025-03-11,Senate,"Senate: THIRD READING",42,0,0,5,47
1919752,1543327,2025-04-10,House,"House: Veterans and Military Affairs Committee: DO PASS",6,0,0,0,6
1919752,1566429,2025-05-06,House,"House: THIRD READING",84,0,0,14,98
1919752,1596356,2025-02-13,Senate,"Senate: Veterans & Military Affairs Committee: DO PASS",9,0,0,0,9
1919752,1596357,2025-04-16,House,"House: Health and Human Services Oversight Committee: DO PASS",12,0,0,0,12
1919762,1501383,2025-02-27,Senate,"Senate: Business & Insurance Committee: DO PASS",10,0,0,0,10
1919762,1516848,2025-03-13,Senate,"Senate: THIRD READING",44,0,0,3,47
1919762,1541401,2025-04-09,House,"House: Alcohol, Tobacco and Controlled Substances Committee: DO PASS",7,0,0,0,7
1919762,1568148,2025-05-08,House,"House: THIRD READING",89,0,0,9,98
1919762,1596353,2025-04-14,House,"House: Health and Human Services Oversight Committee: DO PASS",13,0,0,0,13
1919776,1486765,2025-02-11,House,"House: Banking, Financial Services and Pensions Committee: DO PASS",8,0,0,0,8
1919776,1499174,2025-02-25,House,"House: Government Oversight Committee: DO PASS AS AMENDED BY CS",13,3,0,0,16
1919776,1524892,2025-03-24,House,"House: THIRD READING",77,15,0,7,99
1919776,1548291,2025-04-15,Senate,"Senate: Retirement & Government Resources Committee: DO PASS AMENDED",7,1,0,0,8
1919788,1486420,2025-02-11,House,"House: Insurance Committee: DO PASS",6,0,0,0,6
1919788,1501489,2025-02-27,House,"House: Commerce and Economic Development Oversight Committee: DO PASS",16,0,0,0,16
1919788,1526722,2025-03-25,House,"House: THIRD READING",93,0,0,6,99
1919788,1543616,2025-04-10,Senate,"Senate: Business & Insurance Committee: DO PASS",8,1,0,0,9
1919788,1559122,2025-04-28,Senate,"Senate: THIRD READING",35,9,0,3,47
1919794,1499223,2025-02-25,Senate,"Senate: Education Committee: DO PASS",10,0,0,0,10
1919799,1503303,2025-03-03,Senate,"Senate: Revenue & Taxation Committee: DO PASS AMENDED CS",7,3,0,0,10
1919799,1596341,2025-03-05,Senate,"Senate: Appropriations Committee: DO PASS AMENDED",22,0,0,0,22
1919812,1497652,2025-02-24,House,"House: Public Safety Committee: DO PASS",5,1,0,0,6
1919812,1501711,2025-02-27,House,"House: Judiciary and Public Safety Oversight Committee: DO PASS",10,3,0,0,13
1919812,1528597,2025-03-26,House,"House: THIRD READING",33,58,0,8,99
1919816,1480247,2025-02-04,House,"House: General Government Committee: DO PASS AS AMENDED BY CS",7,0,0,0,7
1919816,1488799,2025-02-13,House,"House: Government Oversight Committee: DO PASS AS AMENDED BY CS",14,1,0,0,15
1919816,1504305,2025-03-04,House,"House: THIRD READING",90,0,0,9,99
1919816,1543528,2025-04-10,Senate,"Senate: Business & Insurance Committee: DO PASS",8,0,0,0,8
1919816,1559240,2025-04-28,Senate,"Senate: THIRD READING",38,6,0,3,47
1919816,1581172,2025-05-29,House,"House: VETO OVERRIDE WITHOUT EMERGENCY",93,0,0,5,98
1919816,1581730,2025-05-29,Senate,"Senate: VETO OVERRIDE NO EMERGENCY",37,6,0,5,48
1919821,1486490,2025-02-11,House,"House: Criminal Judiciary Committee: DO PASS",5,1,0,0,6
1919821,1504517,2025-03-04,House,"House: Judiciary and Public Safety Oversight Committee: DO PASS",12,1,0,0,13
1919821,1517264,2025-03-13,House,"House: THIRD READING",76,12,0,11,99
1919821,1548088,2025-04-15,Senate,"Senate: Public Safety Committee: DO PASS",8,0,0,0,8
1919821,1565071,2025-05-05,Senate,"Senate: THIRD READING",37,4,0,6,47
1919834,1503291,2025-03-03,Senate,"Senate: Revenue & Taxation Committee: DO PASS",13,0,0,0,13
1919834,1527886,2025-03-26,Senate,"Senate: THIRD READING",45,2,0,0,47
1919834,1543835,2025-04-10,House,"House: Appropriations and Budget Finance Subcommittee: DO PASS",6,1,0,0,7
1919834,1548588,2025-04-15,House,"House: Appropriations and Budget Committee: DO PASS AS AMENDED, STRIKE THE TITLE",27,0,0,0,27
1919834,1568374,2025-05-08,House,"House: THIRD READING",69,22,0,7,98
1919834,1591422,2025-05-20,Senate,"Senate: FOURTH READING",41,2,0,4,47
1919840,1503186,2025-03-03,Senate,"Senate: Revenue & Taxation Committee: DO PASS AMENDED CS",11,2,0,0,13
1919840,1516926,2025-03-13,Senate,"Senate: THIRD READING",35,11,0,1,47
1919840,1538598,2025-04-07,House,"House: Appropriations and Budget Education Subcommittee: DO PASS",7,3,0,0,10
1919840,1567949,2025-05-07,House,"House: THIRD READING",76,18,0,4,98
1919840,1575393,2025-05-21,House,"House: FOURTH READING",68,23,1,6,98
1919840,1591312,2025-05-21,Senate,"Senate: FOURTH READING",40,0,0,8,48
1919840,1596344,2025-04-15,House,"House: Appropriations and Budget Committee: DO PASS",20,7,0,0,27
1919849,1489152,2025-02-13,Senate,"Senate: Energy Committee: DO PASS",6,4,0,0,10
1919849,1526613,2025-03-25,Senate,"Senate: THIRD READING",28,17,0,2,47
1919849,1533915,2025-04-02,House,"House: Energy Committee: DO PASS",11,0,0,0,11
1919849,1555005,2025-04-23,House,"House: Energy and Natural Resources Oversight Committee: DO PASS AS AMENDED BY CS",11,2,0,0,13
1919849,1563643,2025-05-01,House,"House: THIRD READING",64,16,0,18,98
1919849,1580961,2025-05-29,Senate,"Senate: VETO OVERRIDE NO EMERGENCY",32,15,0,1,48
1919849,1581971,2025-05-30,House,"House: VETO OVERRIDE WITHOUT EMERGENCY",68,17,0,13,98
1919849,1591717,2025-05-20,Senate,"Senate: FOURTH READING",30,16,0,1,47
1919859,1479475,2025-02-04,House,"House: General Government Committee: DO PASS",5,2,0,0,7
1919859,1498765,2025-02-25,House,"House: Government Oversight Committee: DO PASS AS AMENDED BY CS",11,4,0,0,15
1919859,1525445,2025-03-24,House,"House: THIRD READING",78,18,0,3,99
1919882,1484872,2025-02-10,Senate,"Senate: Finance Committee: DO PASS AMENDED CS",7,4,0,0,11
1919882,1512770,2025-03-11,Senate,"Senate: THIRD READING",32,14,0,1,47
1919882,1539199,2025-04-07,House,"House: Oklahoma House of Representatives: DO PASS",7,1,0,0,8
1919882,1539200,2025-04-07,House,"House: Oklahoma House of Representatives: DO PASS AS AMENDED BY CS",7,1,0,0,8
1919882,1563785,2025-05-01,House,"House: THIRD READING",62,22,0,14,98
1919882,1576327,2025-05-22,House,"House: FOURTH READING",63,17,0,18,98
1919882,1581440,2025-05-29,Senate,"Senate: VETO OVERRIDE NO EMERGENCY",38,9,0,1,48
1919882,1581972,2025-05-29,House,"House: VETO OVERRIDE WITH EMER",70,12,0,16,98
1919882,1581973,2025-05-29,House,"House: VETO OVERRIDE WITHOUT EMER",70,12,0,16,98
1919882,1591395,2025-05-22,Senate,"Senate: FOURTH READING",29,17,0,2,48
1919882,1596345,2025-02-20,Senate,"Senate: Appropriations Committee: DO PASS AMENDED",22,0,0,0,22
1919882,1596346,2025-04-07,House,"House: Appropriations and Budget General Government Subcommittee: DO PASS",7,1,0,0,8
1919882,1596347,2025-04-07,House,"House: Appropriations and Budget General Government Subcommittee: DO PASS AS AMENDED BY CS",7,1,0,0,8
1919882,1596348,2025-04-15,House,"House: Appropriations and Budget Committee: DO PASS AS AMENDED BY CS",25,2,0,0,27
1919882,1596349,2025-05-29,House,"House: VETO OVERRIDE WITH EMERGENCY",70,12,0,16,98
1919882,1596350,2025-05-29,House,"House: VETO OVERRIDE WITHOUT EMERGENCY",70,12,0,16,98
1919892,1482729,2025-02-05,House,"House: Public Safety Committee: DO PASS",6,0,0,0,6
1919902,1483091,2025-02-06,House,"House: Veterans and Military Affairs Committee: DO PASS",8,0,0,0,8
1919902,1499715,2025-02-26,House,"House: Health and Human Services Oversight Committee: DO PASS",10,0,0,0,10
1919902,1526552,2025-03-25,House,"House: THIRD READING",87,0,0,12,99
1919902,1544775,2025-04-10,Senate,"Senate: Veterans & Military Affairs Committee: DO PASS",9,0,0,0,9
1919914,1487002,2025-02-11,House,"House: Banking, Financial Services and Pensions Committee: DO PASS",6,2,0,0,8
1919914,1498912,2025-02-25,House,"House: Government Oversight Committee: DO PASS",12,2,0,0,14
1919914,1525315,2025-03-24,House,"House: THIRD READING",77,15,0,7,99
1919914,1548096,2025-04-14,Senate,"Senate: Revenue & Taxation Committee: DO PASS",5,6,0,0,11
1919997,1499185,2025-02-25,Senate,"Senate: Judiciary Committee: DO PASS AMENDED CS",6,2,0,0,8
1919997,1529553,2025-03-27,Senate,"Senate: THIRD READING",34,13,0,0,47
1919997,1544387,2025-04-10,House,"House: Civil Judiciary Committee: DO PASS AS AMENDED BY CS",8,0,0,0,8
1919997,1559061,2025-04-28,House,"House: THIRD READING",89,0,0,9,98
1919997,1591704,2025-05-20,Senate,"Senate: FOURTH READING",38,5,0,4,47
1919997,1596364,2025-02-25,Senate,"Senate: Judiciary Committee: DO PASS",6,2,0,0,8
1919997,1596365,2025-04-17,House,"House: Judiciary and Public Safety Oversight Committee: DO PASS AS AMENDED BY CS",12,0,0,0,12
1920004,1498602,2025-02-25,Senate,"Senate: Education Committee: DO PASS",9,2,0,0,11
1920005,1485404,2025-02-10,House,"House: Appropriations and Budget Education Subcommittee: DO PASS AS AMENDED BY CS",10,0,0,0,10
1920005,1506850,2025-03-05,House,"House: Appropriations and Budget Committee: DO PASS AS AMENDED BY CS",33,0,0,0,33
1920005,1516924,2025-03-13,House,"House: THIRD READING",76,5,0,18,99
1920005,1540026,2025-04-08,Senate,"Senate: Education Committee: DO PASS AMENDED",11,0,0,0,11
1920005,1568332,2025-05-08,Senate,"Senate: THIRD READING",41,0,0,6,47
1920005,1579918,2025-05-28,House,"House: FOURTH READING",86,4,0,8,98
1920005,1591550,2025-05-28,Senate,"Senate: FOURTH READING",45,2,0,1,48
1920005,1596089,2025-04-16,Senate,"Senate: Appropriations Committee: DO PASS",22,0,0,0,22
1920018,1486037,2025-02-11,House,"House: Business Committee: DO PASS",7,0,0,0,7
1920018,1507856,2025-03-06,House,"House: Commerce and Economic Development Oversight Committee: DO PASS",16,0,0,0,16
1920018,1527474,2025-03-25,House,"House: THIRD READING",88,1,0,10,99
1920018,1556881,2025-04-24,Senate,"Senate: Business & Insurance Committee: DO PASS AMENDED CS",8,1,0,0,9
1920018,1567638,2025-05-07,Senate,"Senate: THIRD READING",46,0,0,1,47
1920018,1572134,2025-05-15,House,"House: FOURTH READING",78,3,0,17,98
1920019,1497901,2025-02-24,House,"House: Business Committee: DO PASS",7,0,0,0,7
1920019,1504573,2025-03-04,House,"House: Commerce and Economic Development Oversight Committee: DO PASS",10,5,0,0,15
1920019,1528961,2025-03-27,House,"House: THIRD READING",63,22,0,14,99
1920027,1483398,2025-02-06,House,"House: Appropriations and Budget Finance Subcommittee: DO PASS",8,0,0,0,8
1920049,1486034,2025-02-11,House,"House: Postsecondary Education Committee: DO PASS AS AMENDED BY CS",7,1,0,0,8
1920051,1479989,2025-02-04,House,"House: Business Committee: DO PASS",9,1,0,0,10
1920051,1498940,2025-02-25,House,"House: Commerce and Economic Development Oversight Committee: DO PASS",14,1,0,0,15
1920051,1501544,2025-02-27,House,"House: THIRD READING",91,1,0,7,99
1920051,1550935,2025-04-17,Senate,"Senate: Business & Insurance Committee: DO PASS",9,0,0,0,9
1920051,1559394,2025-04-28,Senate,"Senate: THIRD READING",43,1,0,3,47
1920089,1504675,2025-03-04,Senate,"Senate: Judiciary Committee: DO PASS",8,0,0,0,8
1920101,1499280,2025-02-25,House,"House: Appropriations and Budget Committee: DO PASS AS AMENDED BY CS",32,0,0,0,32
1920101,1504322,2025-03-04,House,"House: SUSPEND HOUSE RULES",88,0,0,11,99
1920101,1504323,2025-03-04,House,"House: THIRD READING",86,10,0,3,99
1920101,1538272,2025-04-07,Senate,"Senate: Health & Human Services Committee: DO PASS AMENDED",12,0,0,0,12
1920101,1563847,2025-05-01,Senate,"Senate: THIRD READING",38,8,0,1,47
1920101,1596088,2025-04-16,Senate,"Senate: Appropriations Committee: DO PASS",21,2,0,0,23
1920115,1486529,2025-02-11,House,"House: Criminal Judiciary Committee: DO PASS AS AMENDED BY CS",5,0,0,0,5
1920115,1501428,2025-02-27,House,"House: Judiciary and Public Safety Oversight Committee: DO PASS AS AMENDED BY CS",13,0,0,0,13
1920115,1514727,2025-03-11,House,"House: THIRD READING",88,0,0,11,99
1920115,1548570,2025-04-15,Senate,"Senate: Judiciary Committee: DO PASS",7,0,0,0,7
1920115,1559165,2025-04-28,Senate,"Senate: THIRD READING",44,0,0,3,47
1920132,1485086,2025-02-10,Senate,"Senate: Health & Human Services Committee: DO PASS",11,2,0,0,13
1920132,1514726,2025-03-11,Senate,"Senate: THIRD READING",36,10,0,1,47
1920154,1499510,2025-02-25,Senate,"Senate: Economic Development, Workforce & Tourism Committee: DO PASS AMENDED",7,1,0,0,8
1920160,1495277,2025-02-20,House,"House: Transportation Committee: DO PASS",9,0,0,0,9
1920167,1507113,2025-03-06,Senate,"Senate: Business & Insurance Committee: DO PASS",8,1,0,0,9
1920167,1526641,2025-03-24,Senate,"Senate: THIRD READING",40,7,0,0,47
1920167,1540540,2025-04-08,House,"House: Insurance Committee: DO PASS",7,0,0,0,7
1920167,1568339,2025-05-08,House,"House: THIRD READING",18,72,0,8,98
1920167,1596358,2025-04-15,House,"House: Commerce and Economic Development Oversight Committee: DO PASS",15,2,0,0,17
1920196,1487095,2025-02-11,Senate,"Senate: General Government Committee: DO PASS",7,2,0,0,9
1920208,1494178,2025-02-19,House,"House: Criminal Judiciary Committee: DO PASS AS AMENDED BY CS",6,0,0,0,6
1920208,1504529,2025-03-04,House,"House: Judiciary and Public Safety Oversight Committee: DO PASS AS AMENDED BY CS",13,0,0,0,13
1920208,1527028,2025-03-25,House,"House: THIRD READING",90,0,0,9,99
1920208,1550975,2025-04-17,Senate,"Senate: Technology & Telecommunications Committee: DO PASS",6,0,0,0,6
1920208,1560392,2025-04-29,Senate,"Senate: THIRD READING",46,0,0,1,47
1920212,1491156,2025-02-17,Senate,"Senate: Aeronautics & Transportation Committee: DO PASS",11,1,0,0,12
1920212,1525021,2025-03-24,Senate,"Senate: THIRD READING",45,0,0,2,47
1920212,1543591,2025-04-10,House,"House: Transportation Committee: DO PASS",11,0,0,0,11
1920212,1564032,2025-05-01,House,"House: THIRD READING",85,0,0,13,98
1920212,1596359,2025-04-17,House,"House: Commerce and Economic Development Oversight Committee: DO PASS",16,0,0,0,16
1920220,1503400,2025-03-03,Senate,"Senate: Health & Human Services Committee: DO PASS AMENDED",10,1,0,0,11
1920256,1494111,2025-02-19,House,"House: Appropriations and Budget Public Safety Subcommittee: DO PASS AS AMENDED BY CS",7,2,0,0,9
1920259,1486221,2025-02-11,Senate,"Senate: Public Safety Committee: DO PASS AMENDED",6,2,0,0,8
1920326,1480819,2025-02-05,House,"House: Common Education Committee: DO PASS AS AMENDED BY CS",11,2,0,0,13
1920326,1485407,2025-02-10,House,"House: Education Oversight Committee: DO PASS AS AMENDED BY CS",9,0,0,0,9
1920326,1489105,2025-02-13,House,"House: THIRD READING",82,9,0,8,99
1920326,1539988,2025-04-08,Senate,"Senate: Education Committee: DO PASS",7,4,0,0,11
1920329,1492976,2025-02-19,House,"House: Alcohol, Tobacco and Controlled Substances Committee: DO PASS AS AMENDED BY CS",5,0,0,0,5
1920329,1506625,2025-03-05,House,"House: Health and Human Services Oversight Committee: DO PASS AS AMENDED BY CS",14,0,0,0,14
1920329,1517236,2025-03-13,House,"House: THIRD READING",86,0,0,13,99
1920329,1544201,2025-04-10,Senate,"Senate: Business & Insurance Committee: DO PASS",8,0,0,0,8
1920329,1553606,2025-04-22,Senate,"Senate: THIRD READING",43,0,0,4,47
1920337,1482388,2025-02-05,House,"House: Government Modernization and Technology Committee: DO PASS",7,1,0,0,8
1920337,1507325,2025-03-06,House,"House: Commerce and Economic Development Oversight Committee: DO PASS AS AMENDED BY CS",12,2,0,0,14
1920337,1525555,2025-03-24,House,"House: THIRD READING",64,30,0,5,99
1920337,1551118,2025-04-17,Senate,"Senate: Technology & Telecommunications Committee: DO PASS AMENDED",6,2,0,0,8
1920355,1484890,2025-02-10,Senate,"Senate: Finance Committee: DO PASS AMENDED CS",6,4,1,0,11
1920365,1493946,2025-02-17,House,"House: Appropriations and Budget General Government Subcommittee: DO PASS AS AMENDED BY CS",3,1,0,0,4
1920365,1500661,2025-02-26,House,"House: Appropriations and Budget Committee: DO PASS AS AMENDED BY CS",30,0,0,0,30
1920365,1512492,2025-03-11,House,"House: THIRD READING",82,6,1,10,99
1920365,1548130,2025-04-15,Senate,"Senate: Education Committee: DO PASS AMENDED",10,1,0,0,11
1920365,1596087,2025-04-23,Senate,"Senate: Appropriations Committee: DO PASS",21,0,0,0,21
1920380,1493710,2025-02-19,House,"House: Appropriations and Budget Education Subcommittee: DO PASS",6,4,0,0,10
1920380,1506308,2025-03-05,House,"House: Appropriations and Budget Committee: DO PASS AS AMENDED BY CS",18,12,0,0,30
1920380,1529188,2025-03-27,House,"House: THIRD READING",36,57,0,6,99
1920425,1506554,2025-03-05,House,"House: Rules Committee: DO PASS AS AMENDED BY CS",9,0,0,0,9
1920425,1514361,2025-03-11,House,"House: THIRD READING",88,0,0,11,99
1920425,1551042,2025-04-17,Senate,"Senate: Energy Committee: DO PASS AMENDED CS",8,3,0,0,11
1920425,1559429,2025-04-28,Senate,"Senate: THIRD READING",27,17,0,3,47
1920425,1575856,2025-05-21,House,"House: FOURTH READING",76,12,0,10,98
1920425,1581321,2025-05-29,House,"House: VETO OVERRIDE WITHOUT EMERGENCY",75,6,0,17,98
1920425,1581954,2025-05-29,Senate,"Senate: VETO OVERRIDE NO EMERGENCY",32,11,0,5,48
1920434,1499230,2025-02-25,Senate,"Senate: Public Safety Committee: DO PASS AMENDED",8,0,0,0,8
1920434,1596366,2025-03-05,Senate,"Senate: Appropriations Committee: DO PASS AMENDED",21,2,0,0,23
1920443,1486915,2025-02-11,Senate,"Senate: General Government Committee: DO PASS",9,0,0,0,9
1920443,1519086,2025-03-17,Senate,"Senate: THIRD READING",45,0,0,2,47
1920443,1542170,2025-04-09,House,"House: County and Municipal Government Committee: DO PASS",5,0,0,0,5
1920443,1563740,2025-05-01,House,"House: THIRD READING",76,0,0,22,98
1920443,1596368,2025-04-22,House,"House: Government Oversight Committee: DO PASS",15,1,0,0,16
1920474,1493458,2025-02-19,House,"House: Criminal Judiciary Committee: DO PASS AS AMENDED BY CS",6,0,0,0,6
1920474,1501286,2025-02-27,House,"House: Judiciary and Public Safety Oversight Committee: DO PASS AS AMENDED BY CS",13,0,0,0,13
1920474,1526535,2025-03-25,House,"House: THIRD READING",91,0,0,8,99
1920484,1486788,2025-02-11,Senate,"Senate: Public Safety Committee: DO PASS AMENDED",5,3,0,0,8
1920484,1528711,2025-03-27,Senate,"Senate: THIRD READING",43,4,0,0,47
1920484,1540492,2025-04-08,House,"House: Criminal Judiciary Committee: DO PASS AS AMENDED BY CS",4,0,0,0,4
1920484,1565812,2025-05-06,House,"House: THIRD READING",73,21,0,4,98
1920484,1596362,2025-04-17,House,"House: Judiciary and Public Safety Oversight Committee: DO PASS AS AMENDED BY CS",11,1,0,0,12
1920492,1495070,2025-02-20,House,"House: Appropriations and Budget Finance Subcommittee: DO PASS AS AMENDED BY CS",9,0,0,0,9
1920492,1500860,2025-02-26,House,"House: Appropriations and Budget Committee: DO PASS AS AMENDED BY CS",29,0,0,0,29
1920492,1509770,2025-03-10,House,"House: THIRD READING",90,0,1,8,99
1920492,1539003,2025-04-07,Senate,"Senate: Revenue & Taxation Committee: DO PASS",9,0,0,0,9
1920492,1559027,2025-04-28,Senate,"Senate: THIRD READING",44,0,0,3,47
1920498,1491472,2025-02-17,House,"House: Appropriations and Budget Education Subcommittee: DO PASS",10,0,0,0,10
1920498,1506281,2025-03-05,House,"House: Appropriations and Budget Committee: DO PASS AS AMENDED, STRIKE THE TITLE",32,0,0,0,32
1920498,1516090,2025-03-12,House,"House: THIRD READING",72,13,0,14,99
1920498,1540155,2025-04-08,Senate,"Senate: Education Committee: DO PASS AMENDED",11,0,0,0,11
1920498,1565755,2025-05-06,Senate,"Senate: THIRD READING",29,18,0,0,47
1920498,1579549,2025-05-28,House,"House: FOURTH READING",82,8,0,8,98
1920498,1591363,2025-05-28,Senate,"Senate: FOURTH READING",28,18,0,2,48
1920498,1596090,2025-04-23,Senate,"Senate: Appropriations Committee: DO PASS",23,2,0,0,25
1920514,1491415,2025-02-17,House,"House: Appropriations and Budget Education Subcommittee: DO PASS",8,2,0,0,10
1920514,1500313,2025-02-26,House,"House: Appropriations and Budget Committee: DO PASS",29,0,0,0,29
1920514,1500314,2025-02-26,House,"House: Appropriations and Budget Committee: DO PASS AS AMENDED, STRIKE THE T ITLE",29,0,0,0,29
1920514,1517100,2025-03-13,House,"House: THIRD READING",56,23,0,20,99
1920514,1554203,2025-04-22,Senate,"Senate: Education Committee: DO PASS AMENDED CS",9,1,0,0,10
1920514,1567423,2025-05-07,Senate,"Senate: THIRD READING",39,6,0,2,47
1920514,1574936,2025-05-21,House,"House: FOURTH READING",78,12,0,8,98
1920525,1486803,2025-02-11,House,"House: Business Committee: DO PASS AS AMENDED BY CS",7,0,0,0,7
1920525,1498579,2025-02-25,House,"House: Commerce and Economic Development Oversight Committee: DO PASS AS AMENDED BY CS",14,1,0,0,15
1920525,1503545,2025-03-03,House,"House: THIRD READING",90,4,0,5,99
1920525,1549115,2025-04-15,Senate,"Senate: Economic Development, Workforce & Tourism Committee: DO PASS AMENDED",9,0,0,0,9
1920525,1559229,2025-04-28,Senate,"Senate: THIRD READING",37,6,0,4,47
1920538,1491210,2025-02-17,House,"House: Appropriations and Budget Education Subcommittee: DO PASS",8,2,0,0,10
1920577,1494002,2025-02-19,House,"House: Criminal Judiciary Committee: DO PASS",6,0,0,0,6
1920577,1504223,2025-03-04,House,"House: Judiciary and Public Safety Oversight Committee: DO PASS",13,0,0,0,13
1920577,1528085,2025-03-26,House,"House: THIRD READING",63,30,0,6,99
1920577,1554946,2025-04-22,Senate,"Senate: Judiciary Committee: DO PASS AMENDED",7,1,0,0,8
1920577,1567328,2025-05-07,Senate,"Senate: THIRD READING",46,1,0,0,47
1920577,1571047,2025-05-14,House,"House: FOURTH READING",83,3,0,12,98
1920577,1580981,2025-05-29,House,"House: VETO OVERRIDE WITHOUT EMERGENCY",89,3,0,6,98
1920577,1581961,2025-05-29,Senate,"Senate: VETO OVERRIDE NO EMERGENCY",40,4,0,4,48
1920594,1504303,2025-03-04,Senate,"Senate: Education Committee: DO PASS AMENDED CS",7,5,0,0,12
1920594,1529214,2025-03-27,Senate,"Senate: THIRD READING",33,14,0,0,47
1920594,1538082,2025-04-07,House,"House: Appropriations and Budget Education Subcommittee: DO PASS",7,4,0,0,11
1920594,1560090,2025-04-29,House,"House: THIRD READING",53,32,0,13,98
1920594,1560091,2025-04-29,House,"House: EMERGENCY",55,28,0,15,98
1920594,1596369,2025-04-16,House,"House: Appropriations and Budget Committee: DO PASS",18,9,0,0,27
1920609,1493429,2025-02-19,Senate,"Senate: Public Safety Committee: DO PASS",6,0,0,0,6
1920609,1509766,2025-03-10,Senate,"Senate: THIRD READING",41,6,0,0,47
1920609,1540739,2025-04-08,House,"House: Criminal Judiciary Committee: DO PASS",4,0,0,0,4
1920609,1562890,2025-04-30,House,"House: THIRD READING",77,14,0,7,98
1920609,1596361,2025-04-17,House,"House: Judiciary and Public Safety Oversight Committee: DO PASS",12,0,0,0,12
1920625,1503256,2025-03-03,Senate,"Senate: Agriculture & Wildlife Committee: DO PASS AMENDED CS",10,2,0,0,12
1920628,1499284,2025-02-25,Senate,"Senate: Education Committee: DO PASS",11,0,0,0,11
1920628,1529396,2025-03-27,Senate,"Senate: THIRD READING",42,5,0,0,47
1920628,1534763,2025-04-02,House,"House: Common Education Committee: DO PASS AS AMENDED BY CS",12,0,0,0,12
1920628,1564080,2025-05-01,House,"House: THIRD READING",80,0,0,18,98
1920628,1591824,2025-05-14,Senate,"Senate: FOURTH READING",40,2,0,5,47
1920628,1596363,2025-04-23,House,"House: Education Oversight Committee: DO PASS AS AMENDED BY CS",10,0,0,0,10
1920635,1487020,2025-02-11,Senate,"Senate: Judiciary Committee: DO PASS",8,0,0,0,8
1920635,1512682,2025-03-11,Senate,"Senate: THIRD READING",42,0,0,5,47
1920635,1540707,2025-04-08,House,"House: Criminal Judiciary Committee: DO PASS",4,0,0,0,4
1920635,1566649,2025-05-06,House,"House: THIRD READING",94,0,0,4,98
1920635,1596360,2025-04-17,House,"House: Judiciary and Public Safety Oversight Committee: DO PASS",12,0,0,0,12
1920650,1493170,2025-02-19,House,"House: Banking, Financial Services and Pensions Committee: DO PASS",3,5,0,0,8
1920655,1503478,2025-03-03,Senate,"Senate: Health & Human Services Committee: DO PASS",9,2,0,0,11
1920679,1492962,2025-02-19,House,"House: Alcohol, Tobacco and Controlled Substances Committee: DO PASS AS AMENDED BY CS",5,0,0,0,5
1920679,1503738,2025-03-03,House,"House: Health and Human Services Oversight Committee: DO PASS AS AMENDED BY CS",10,3,0,0,13
1920679,1525402,2025-03-24,House,"House: THIRD READING",83,4,0,12,99
1920679,1550966,2025-04-17,Senate,"Senate: Business & Insurance Committee: DO PASS",9,0,0,0,9
1920716,1489413,2025-02-13,House,"House: Appropriations and Budget Finance Subcommittee: DO PASS",3,4,0,0,7
1920730,1493453,2025-02-19,House,"House: Criminal Judiciary Committee: DO PASS AS AMENDED BY CS",4,1,0,0,5
1920730,1501696,2025-02-27,House,"House: Judiciary and Public Safety Oversight Committee: DO PASS AS AMENDED BY CS",8,3,0,0,11
1920730,1517208,2025-03-13,House,"House: THIRD READING",73,16,0,10,99
1920763,1507118,2025-03-06,Senate,"Senate: Business & Insurance Committee: DO PASS",10,0,0,0,10
1920763,1528845,2025-03-27,Senate,"Senate: THIRD READING",46,1,0,0,47
1920763,1539565,2025-04-08,House,"House: Business Committee: DO PASS",9,0,0,0,9
1920763,1566619,2025-05-06,House,"House: THIRD READING",82,4,0,12,98
1920763,1596367,2025-04-24,House,"House: Commerce and Economic Development Oversight Committee: DO PASS",16,0,0,0,16
1920869,1495981,2025-02-20,House,"House: Appropriations and Budget Finance Subcommittee: DO PASS AS AMENDED BY CS",6,2,0,0,8
1920869,1506664,2025-03-05,House,"House: Appropriations and Budget Committee: DO PASS AS AMENDED BY CS",29,4,0,0,33
1920869,1525578,2025-03-24,House,"House: THIRD READING",65,25,0,9,99
1920869,1551696,2025-04-17,Senate,"Senate: Energy Committee: DO PASS AMENDED",7,2,0,0,9
1920869,1567429,2025-05-07,Senate,"Senate: THIRD READING",17,25,0,5,47
1920869,1596098,2025-04-23,Senate,"Senate: Appropriations Committee: DO PASS",20,2,0,0,22
1920869,1596099,2025-05-08,Senate,"Senate: RECONSIDER",27,15,0,5,47
1920880,1480159,2025-02-04,House,"House: Utilities Committee: DO PASS",8,0,0,0,8
1920880,1505747,2025-03-05,House,"House: Energy and Natural Resources Oversight Committee: DO PASS AS AMENDED BY CS",16,0,0,0,16
1920880,1527681,2025-03-26,House,"House: THIRD READING",86,0,0,13,99
1920880,1556807,2025-04-24,Senate,"Senate: Energy Committee: DO PASS AMENDED CS",8,2,0,0,10
1920912,1482519,2025-02-05,House,"House: Public Safety Committee: DO PASS",6,0,0,0,6
1920912,1501499,2025-02-27,House,"House: Judiciary and Public Safety Oversight Committee: DO PASS",14,0,0,0,14
1920912,1511301,2025-03-10,House,"House: THIRD READING",93,1,0,5,99
1920912,1552628,2025-04-21,Senate,"Senate: Aeronautics & Transportation Committee: DO PASS AMENDED",10,0,0,0,10
1920912,1567424,2025-05-07,Senate,"Senate: THIRD READING",37,6,0,4,47
1920912,1571188,2025-05-14,House,"House: FOURTH READING",86,1,0,11,98
1920931,1493497,2025-02-19,House,"House: Criminal Judiciary Committee: DO PASS AS AMENDED BY CS",5,0,0,0,5
1920931,1501184,2025-02-27,House,"House: Judiciary and Public Safety Oversight Committee: DO PASS AS AMENDED BY CS",13,0,0,0,13
1920931,1516369,2025-03-12,House,"House: THIRD READING",89,0,0,10,99
1920931,1541103,2025-04-08,Senate,"Senate: Judiciary Committee: DO PASS AMENDED",7,0,0,0,7
1920931,1564866,2025-05-05,Senate,"Senate: THIRD READING",47,0,0,0,47
1920931,1575097,2025-05-21,House,"House: FOURTH READING",90,0,0,8,98
1920931,1591349,2025-05-21,Senate,"Senate: FOURTH READING",46,0,0,2,48
1920944,1488906,2025-02-13,House,"House: Transportation Committee: DO PASS AS AMENDED BY CS",11,0,0,0,11
1920944,1504662,2025-03-04,House,"House: Commerce and Economic Development Oversight Committee: DO PASS AS AMENDED BY CS",16,0,0,0,16
1920944,1527109,2025-03-25,House,"House: THIRD READING",87,0,0,12,99
1920944,1527110,2025-03-25,House,"House: ADVANCE FROM GENERAL ORDER",86,0,0,13,99
1920944,1538526,2025-04-07,Senate,"Senate: Aeronautics & Transportation Committee: DO PASS AMENDED",10,0,0,0,10
1920944,1562450,2025-04-30,Senate,"Senate: THIRD READING",43,0,0,4,47
1920944,1576880,2025-05-22,House,"House: FOURTH READING",80,0,0,18,98
1920944,1591470,2025-05-28,Senate,"Senate: FOURTH READING",47,0,0,1,48
1920982,1505923,2025-03-04,House,"House: Appropriations and Budget Committee: DO PASS AS AMENDED BY CS",29,1,0,0,30
1920982,1514316,2025-03-11,House,"House: THIRD READING",67,17,0,15,99
1920982,1514317,2025-03-11,House,"House: EMERGENCY",70,6,0,23,99
1920982,1549869,2025-04-16,Senate,"Senate: Appropriations Committee: DO PASS AMENDED",21,0,0,0,21
1920982,1568389,2025-05-08,Senate,"Senate: THIRD READING",46,0,0,1,47
1920982,1575953,2025-05-22,House,"House: FOURTH READING",68,14,0,16,98
1920982,1591394,2025-05-22,Senate,"Senate: FOURTH READING",41,0,0,7,48
1920988,1497556,2025-02-24,House,"House: Insurance Committee: DO PASS AS AMENDED BY CS",8,0,0,0,8
1920988,1501270,2025-02-27,House,"House: Commerce and Economic Development Oversight Committee: DO PASS AS AMENDED BY CS",16,0,0,0,16
1920988,1525500,2025-03-24,House,"House: THIRD READING",86,1,0,12,99
1920988,1556667,2025-04-24,Senate,"Senate: Business & Insurance Committee: DO PASS",9,0,0,0,9
1920988,1568417,2025-05-08,Senate,"Senate: THIRD READING",45,0,0,2,47
1921030,1489744,2025-02-13,House,"House: Transportation Committee: DO PASS",11,0,0,0,11
1921030,1501503,2025-02-27,House,"House: Commerce and Economic Development Oversight Committee: DO PASS",16,0,0,0,16
1921030,1527191,2025-03-25,House,"House: THIRD READING",86,1,0,12,99
1921030,1538402,2025-04-07,Senate,"Senate: Aeronautics & Transportation Committee: DO PASS",10,0,0,0,10
1921030,1565126,2025-05-05,Senate,"Senate: THIRD READING",47,0,0,0,47
1921030,1580962,2025-05-29,House,"House: VETO OVERRIDE WITHOUT EMERGENCY",89,1,0,8,98
1921030,1581958,2025-05-29,Senate,"Senate: VETO OVERRIDE NO EMERGENCY",45,0,0,3,48
1921036,1483362,2025-02-06,House,"House: Civil Judiciary Committee: DO PASS",9,0,0,0,9
1921036,1504650,2025-03-04,House,"House: Judiciary and Public Safety Oversight Committee: DO PASS",12,1,0,0,13
1921036,1514303,2025-03-11,House,"House: THIRD READING",68,20,0,11,99
1921057,1492950,2025-02-17,House,"House: Appropriations and Budget Judiciary Subcommittee: DO PASS AS AMENDED BY CS",8,0,0,0,8
1921057,1506651,2025-03-05,House,"House: Appropriations and Budget Committee: DO PASS AS AMENDED BY CS",32,0,0,0,32
1921057,1529260,2025-03-27,House,"House: THIRD READING",95,0,0,4,99
1921057,1555102,2025-04-22,Senate,"Senate: Judiciary Committee: DO PASS AMENDED CS",8,0,0,0,8
1921057,1565061,2025-05-05,Senate,"Senate: THIRD READING",47,0,0,0,47
1921057,1575861,2025-05-22,House,"House: FOURTH READING",84,3,0,11,98
1921057,1591306,2025-05-22,Senate,"Senate: FOURTH READING",42,0,0,6,48
1921057,1596101,2025-04-23,Senate,"Senate: Appropriations Committee: DO PASS",25,0,0,0,25
1921071,1494954,2025-02-20,House,"House: Transportation Committee: DO PASS AS AMENDED BY CS",9,0,0,0,9
1921071,1507097,2025-03-06,House,"House: Commerce and Economic Development Oversight Committee: DO PASS AS AMENDED BY CS",15,0,0,0,15
1921071,1516873,2025-03-13,House,"House: THIRD READING",81,2,0,16,99
1921079,1484866,2025-02-10,House,"House: Appropriations and Budget Natural Resources Subcommittee: DO PASS",9,0,0,0,9
1921079,1488170,2025-02-12,House,"House: Appropriations and Budget Committee: DO PASS AS AMENDED, STRIKE THE TITLE",28,0,0,0,28
1921079,1497448,2025-02-24,House,"House: THIRD READING",89,6,0,4,99
1921079,1538373,2025-04-07,Senate,"Senate: Agriculture & Wildlife Committee: DO PASS AMENDED",10,2,0,0,12
1921079,1564976,2025-05-05,Senate,"Senate: THIRD READING",38,8,0,1,47
1921079,1580036,2025-05-28,House,"House: FOURTH READING",85,3,0,10,98
1921079,1591430,2025-05-28,Senate,"Senate: FOURTH READING",41,5,0,2,48
1921079,1596094,2025-04-23,Senate,"Senate: Appropriations Committee: DO PASS",24,1,0,0,25
1921129,1482471,2025-02-05,House,"House: Public Health Committee: DO PASS",6,0,0,0,6
1921129,1499717,2025-02-26,House,"House: Health and Human Services Oversight Committee: DO PASS AS AMENDED BY CS",9,0,0,0,9
1921129,1503539,2025-03-03,House,"House: THIRD READING",90,7,0,2,99
1921156,1487503,2025-02-12,House,"House: County and Municipal Government Committee: DO PASS",6,0,0,0,6
1921156,1507494,2025-03-06,House,"House: Government Oversight Committee: DO PASS",16,0,0,0,16
1921156,1528216,2025-03-26,House,"House: THIRD READING",90,2,0,7,99
1921156,1539800,2025-04-08,Senate,"Senate: Local & County Government Committee: DO PASS",7,0,0,0,7
1921156,1559529,2025-04-28,Senate,"Senate: THIRD READING",28,14,0,5,47
1921196,1488600,2025-02-12,House,"House: Common Education Committee: DO PASS",10,2,0,0,12
1921196,1505783,2025-03-05,House,"House: Education Oversight Committee: DO PASS",9,0,0,0,9
1921196,1515944,2025-03-12,House,"House: THIRD READING",83,1,0,15,99
1921196,1553573,2025-04-22,Senate,"Senate: Education Committee: DO PASS",10,0,0,0,10
1921196,1559150,2025-04-28,Senate,"Senate: THIRD READING",41,3,0,3,47
1921205,1488338,2025-02-12,House,"House: Common Education Committee: DO PASS AS AMENDED BY CS",12,0,0,0,12
1921205,1506023,2025-03-05,House,"House: Education Oversight Committee: DO PASS AS AMENDED BY CS",7,2,0,0,9
1921205,1528057,2025-03-26,House,"House: THIRD READING",71,23,0,5,99
1921205,1539771,2025-04-08,Senate,"Senate: Education Committee: DO PASS",10,0,0,0,10
1921205,1563341,2025-05-01,Senate,"Senate: THIRD READING",46,0,0,1,47
1921213,1506711,2025-03-05,House,"House: Appropriations and Budget Committee: DO PASS AS AMENDED BY CS",31,0,0,0,31
1921213,1516925,2025-03-13,House,"House: THIRD READING",76,6,0,17,99
1921213,1539774,2025-04-08,Senate,"Senate: Education Committee: DO PASS AMENDED",11,0,0,0,11
1921213,1596097,2025-04-16,Senate,"Senate: Appropriations Committee: DO PASS AMENDED CS",21,0,0,0,21
1921227,1498583,2025-02-25,Senate,"Senate: Education Committee: DO PASS",8,3,0,0,11
1921233,1487571,2025-02-12,House,"House: County and Municipal Government Committee: DO PASS",6,0,0,0,6
1921233,1501087,2025-02-27,House,"House: Government Oversight Committee: DO PASS",13,0,0,0,13
1921233,1519202,2025-03-17,House,"House: THIRD READING",85,0,0,14,99
1921233,1556995,2025-04-15,Senate,"Senate: Local & County Government Committee: DO PASS AMENDED CS",9,0,0,0,9
1921233,1565133,2025-05-05,Senate,"Senate: THIRD READING",47,0,0,0,47
1921233,1571169,2025-05-14,House,"House: FOURTH READING",83,0,0,15,98
1921296,1504436,2025-03-04,Senate,"Senate: Education Committee: DO PASS",7,3,0,0,10
1921296,1529436,2025-03-27,Senate,"Senate: THIRD READING",39,8,0,0,47
1921296,1540063,2025-04-08,House,"House: Postsecondary Education Committee: DO PASS",4,2,0,0,6
1921296,1565734,2025-05-06,House,"House: THIRD READING",77,18,0,3,98
1921296,1565735,2025-05-06,House,"House: EMERGENCY",76,17,0,5,98
1921296,1596377,2025-04-16,House,"House: Education Oversight Committee: DO PASS",7,2,0,0,9
1921334,1493806,2025-02-19,House,"House: Children, Youth and Family Services Committee: DO PASS",6,0,0,0,6
1921334,1506808,2025-03-05,House,"House: Health and Human Services Oversight Committee: DO PASS AS AMENDED BY CS",14,0,0,0,14
1921334,1527098,2025-03-25,House,"House: THIRD READING",75,14,0,10,99
1921334,1551448,2025-04-17,Senate,"Senate: Technology & Telecommunications Committee: DO PASS AMENDED CS",6,2,0,0,8
1921343,1486296,2025-02-11,Senate,"Senate: General Government Committee: DO PASS AMENDED",7,2,0,0,9
1921355,1482428,2025-02-05,House,"House: Alcohol, Tobacco and Controlled Substances Committee: DO PASS",7,0,0,0,7
1921355,1499922,2025-02-26,House,"House: Health and Human Services Oversight Committee: DO PASS AS AMENDED BY CS",11,0,0,0,11
1921355,1517194,2025-03-13,House,"House: THIRD READING",85,0,0,14,99
1921355,1556899,2025-04-24,Senate,"Senate: Business & Insurance Committee: DO PASS AMENDED CS",10,0,0,0,10
1921363,1494737,2025-02-20,Senate,"Senate: Business & Insurance Committee: DO PASS",10,0,0,0,10
1921363,1529174,2025-03-27,Senate,"Senate: THIRD READING",46,0,0,1,47
1921363,1541523,2025-04-09,House,"House: Public Health Committee: DO PASS",6,0,0,0,6
1921363,1552622,2025-04-21,House,"House: Health and Human Services Oversight Committee: DO PASS AS AMENDED BY CS",12,1,0,0,13
1921363,1567980,2025-05-07,House,"House: THIRD READING",89,0,0,9,98
1921363,1591453,2025-05-21,Senate,"Senate: FOURTH READING",46,0,0,2,48
1921380,1493399,2025-02-19,House,"House: Common Education Committee: DO PASS AS AMENDED BY CS",9,0,0,0,9
1921380,1503365,2025-03-03,House,"House: Education Oversight Committee: DO PASS AS AMENDED BY CS",9,0,0,0,9
1921380,1528761,2025-03-27,House,"House: THIRD READING",93,0,0,6,99
1921380,1548139,2025-04-15,Senate,"Senate: Education Committee: DO PASS AMENDED",11,0,0,0,11
1921397,1486158,2025-02-11,Senate,"Senate: Public Safety Committee: DO PASS AMENDED CS",7,1,0,0,8
1921397,1519048,2025-03-17,Senate,"Senate: THIRD READING",40,5,0,2,47
1921397,1540525,2025-04-08,House,"House: Criminal Judiciary Committee: DO PASS",4,0,0,0,4
1921397,1566412,2025-05-06,House,"House: THIRD READING",74,12,0,12,98
1921397,1596375,2025-04-17,House,"House: Judiciary and Public Safety Oversight Committee: DO PASS",10,2,0,0,12
1921443,1480636,2025-02-05,House,"House: Alcohol, Tobacco and Controlled Substances Committee: DO PASS",6,1,0,0,7
1921443,1499718,2025-02-26,House,"House: Health and Human Services Oversight Committee: DO PASS",9,2,0,0,11
1921443,1504911,2025-03-04,House,"House: THIRD READING",60,33,1,5,99
1921443,1543787,2025-04-10,Senate,"Senate: Veterans & Military Affairs Committee: DO PASS",7,2,0,0,9
1921443,1596093,2025-04-16,Senate,"Senate: Appropriations Committee: DO PASS AMENDED",6,16,1,0,23
1921464,1487809,2025-02-12,House,"House: Public Health Committee: DO PASS",6,0,0,0,6
1921470,1486356,2025-02-11,House,"House: Banking, Financial Services and Pensions Committee: DO PASS",7,0,0,0,7
1921470,1504228,2025-03-04,House,"House: Government Oversight Committee: DO PASS",14,0,0,0,14
1921470,1513881,2025-03-11,House,"House: THIRD READING",93,0,0,6,99
1921470,1548076,2025-04-15,Senate,"Senate: Retirement & Government Resources Committee: DO PASS",8,0,0,0,8
1921470,1563535,2025-05-01,Senate,"Senate: THIRD READING",46,0,0,1,47
1921480,1485198,2025-02-10,Senate,"Senate: Agriculture & Rural Affairs Committee: DO PASS AMENDED",9,2,0,0,11
1921480,1529781,2025-03-27,Senate,"Senate: THIRD READING",40,4,0,3,47
1921480,1540290,2025-04-08,House,"House: Criminal Judiciary Committee: DO PASS",3,0,0,0,3
1921480,1564079,2025-05-01,House,"House: THIRD READING",76,0,0,22,98
1921480,1596374,2025-04-22,House,"House: Judiciary and Public Safety Oversight Committee: DO PASS",10,0,0,0,10
1921515,1484658,2025-02-10,House,"House: Appropriations and Budget Transportation Subcommittee: DO PASS AS AMENDED BY CS",9,0,0,0,9
1921523,1482267,2025-02-05,House,"House: Public Health Committee: DO PASS AS AMENDED BY CS",6,0,0,0,6
1921523,1505779,2025-03-05,House,"House: Health and Human Services Oversight Committee: DO PASS AS AMENDED BY CS",12,0,0,0,12
1921523,1509071,2025-03-10,House,"House: THIRD READING",95,0,0,4,99
1921523,1538160,2025-04-07,Senate,"Senate: Health & Human Services Committee: DO PASS",10,1,0,0,11
1921523,1560991,2025-04-29,Senate,"Senate: THIRD READING",34,11,0,2,47
1921523,1581448,2025-05-29,House,"House: VETO OVERRIDE WITHOUT EMERGENCY",83,3,0,12,98
1921523,1581893,2025-05-29,Senate,"Senate: VETO OVERRIDE NO EMERGENCY",42,2,0,4,48
1921533,1498107,2025-02-24,House,"House: Agriculture Committee: DO PASS AS AMENDED BY CS",6,0,0,0,6
1921533,1503288,2025-03-03,House,"House: Energy and Natural Resources Oversight Committee: DO PASS AS AMENDED BY CS",13,0,0,0,13
1921533,1516031,2025-03-12,House,"House: THIRD READING",88,0,0,11,99
1921533,1547408,2025-04-14,Senate,"Senate: Agriculture & Wildlife Committee: DO PASS",12,0,0,0,12
1921533,1568314,2025-05-08,Senate,"Senate: THIRD READING",40,5,0,2,47
1921538,1486013,2025-02-11,House,"House: General Government Committee: DO PASS",7,0,0,0,7
1921538,1507626,2025-03-06,House,"House: Government Oversight Committee: DO PASS",15,0,0,0,15
1921538,1517232,2025-03-13,House,"House: THIRD READING",87,0,0,12,99
1921538,1551020,2025-04-17,Senate,"Senate: Technology & Telecommunications Committee: DO PASS AMENDED",8,0,0,0,8
1921547,1494746,2025-02-20,Senate,"Senate: Business & Insurance Committee: DO PASS AMENDED CS",10,0,0,0,10
1921547,1526206,2025-03-25,Senate,"Senate: THIRD READING",45,0,0,2,47
1921547,1541512,2025-04-09,House,"House: Public Health Committee: DO PASS",4,0,0,0,4
1921547,1565054,2025-05-05,House,"House: THIRD READING",88,0,0,10,98
1921547,1581343,2025-05-29,Senate,"Senate: VETO OVERRIDE NO EMERGENCY",47,0,0,1,48
1921547,1596372,2025-04-14,House,"House: Health and Human Services Oversight Committee: DO PASS",13,0,0,0,13
1921566,1493930,2025-02-19,House,"House: Common Education Committee: DO PASS",7,3,0,0,10
1921566,1505952,2025-03-05,House,"House: Education Oversight Committee: DO PASS AS AMENDED BY CS",9,0,0,0,9
1921566,1513092,2025-03-11,House,"House: THIRD READING",74,15,0,10,99
1921566,1554262,2025-04-22,Senate,"Senate: Education Committee: DO PASS AMENDED CS",10,0,0,0,10
1921566,1567704,2025-05-07,Senate,"Senate: THIRD READING",45,0,0,2,47
1921566,1574832,2025-05-21,House,"House: FOURTH READING",78,5,0,15,98
1921584,1479923,2025-02-04,House,"House: General Government Committee: DO PASS",7,0,0,0,7
1921584,1489435,2025-02-13,House,"House: Government Oversight Committee: DO PASS",12,0,0,0,12
1921584,1499339,2025-02-25,House,"House: THIRD READING",87,4,0,8,99
1921584,1549277,2025-04-15,Senate,"Senate: Economic Development, Workforce & Tourism Committee: DO PASS AMENDED",9,0,0,0,9
1921584,1565436,2025-05-05,Senate,"Senate: THIRD READING",37,4,0,6,47
1921606,1493414,2025-02-19,Senate,"Senate: Public Safety Committee: DO PASS",4,1,0,0,5
1921616,1487526,2025-02-12,House,"House: Common Education Committee: DO PASS AS AMENDED BY CS",11,1,0,0,12
1921616,1500115,2025-02-26,House,"House: Education Oversight Committee: DO PASS AS AMENDED BY CS",9,0,0,0,9
1921616,1515911,2025-03-12,House,"House: THIRD READING",73,12,0,14,99
1921616,1515912,2025-03-12,House,"House: EMERGENCY",41,42,0,16,99
1921623,1488219,2025-02-12,House,"House: Children, Youth and Family Services Committee: DO PASS AS AMENDED BY CS",5,0,0,0,5
1921623,1499720,2025-02-26,House,"House: Health and Human Services Oversight Committee: DO PASS AS AMENDED BY CS",9,0,0,0,9
1921623,1503152,2025-03-03,House,"House: THIRD READING",91,6,0,2,99
1921645,1497336,2025-02-24,House,"House: Insurance Committee: DO PASS AS AMENDED BY CS",8,0,0,0,8
1921645,1501510,2025-02-27,House,"House: Commerce and Economic Development Oversight Committee: DO PASS AS AMENDED BY CS",16,0,0,0,16
1921645,1524841,2025-03-24,House,"House: THIRD READING",87,0,0,12,99
1921645,1551679,2025-04-17,Senate,"Senate: Business & Insurance Committee: DO PASS",9,0,0,0,9
1921645,1559333,2025-04-28,Senate,"Senate: THIRD READING",44,0,0,3,47
1921669,1489203,2025-02-13,Senate,"Senate: Business & Insurance Committee: DO PASS",10,0,0,0,10
1921669,1516784,2025-03-12,Senate,"Senate: THIRD READING",42,0,0,5,47
1921669,1541379,2025-04-09,House,"House: Alcohol, Tobacco and Controlled Substances Committee: DO PASS",7,0,0,0,7
1921669,1565586,2025-05-05,House,"House: THIRD READING",90,0,0,8,98
1921669,1596373,2025-04-14,House,"House: Health and Human Services Oversight Committee: DO PASS",13,0,0,0,13
1921678,1494241,2025-02-19,House,"House: Children, Youth and Family Services Committee: DO PASS",4,0,0,0,4
1921678,1500447,2025-02-26,House,"House: Health and Human Services Oversight Committee: DO PASS",12,0,0,0,12
1921678,1504702,2025-03-04,House,"House: THIRD READING",83,13,0,3,99
1921707,1488294,2025-02-12,House,"House: Common Education Committee: DO PASS AS AMENDED BY CS",11,0,0,0,11
1921707,1499860,2025-02-26,House,"House: Education Oversight Committee: DO PASS AS AMENDED BY CS",9,0,0,0,9
1921707,1529441,2025-03-27,House,"House: THIRD READING",79,7,0,13,99
1921712,1507120,2025-03-06,Senate,"Senate: Business & Insurance Committee: DO PASS",10,0,0,0,10
1921733,1495331,2025-02-20,House,"House: Civil Judiciary Committee: DO PASS",8,0,0,0,8
1921733,1504448,2025-03-04,House,"House: Judiciary and Public Safety Oversight Committee: DO PASS",11,1,0,0,12
1921733,1516011,2025-03-12,House,"House: THIRD READING",71,12,0,16,99
1921736,1487080,2025-02-11,House,"House: Criminal Judiciary Committee: DO PASS",4,1,0,0,5
1921736,1501486,2025-02-27,House,"House: Judiciary and Public Safety Oversight Committee: DO PASS",12,1,0,0,13
1921736,1513863,2025-03-11,House,"House: THIRD READING",88,0,0,11,99
1921736,1539925,2025-04-08,Senate,"Senate: Judiciary Committee: DO PASS",7,1,0,0,8
1921736,1563911,2025-05-01,Senate,"Senate: THIRD READING",46,0,0,1,47
1921743,1497789,2025-02-24,House,"House: Insurance Committee: DO PASS",7,0,0,0,7
1921743,1507632,2025-03-06,House,"House: Commerce and Economic Development Oversight Committee: DO PASS",16,0,0,0,16
1921743,1525563,2025-03-24,House,"House: THIRD READING",89,0,0,10,99
1921743,1551469,2025-04-17,Senate,"Senate: Business & Insurance Committee: DO PASS",8,1,0,0,9
1921743,1559330,2025-04-28,Senate,"Senate: THIRD READING",44,0,0,3,47
1921761,1483464,2025-02-06,House,"House: Appropriations and Budget Finance Subcommittee: DO PASS",8,0,0,0,8
1921761,1500420,2025-02-26,House,"House: Appropriations and Budget Committee: DO PASS AS AMENDED BY CS",28,1,0,0,29
1921761,1512514,2025-03-11,House,"House: THIRD READING",90,0,0,9,99
1921761,1551706,2025-04-17,Senate,"Senate: Energy Committee: DO PASS",11,0,0,0,11
1921761,1561909,2025-04-30,Senate,"Senate: THIRD READING",43,1,0,3,47
1921771,1488257,2025-02-12,House,"House: Common Education Committee: DO PASS AS AMENDED BY CS",11,0,0,0,11
1921771,1505983,2025-03-05,House,"House: Education Oversight Committee: DO PASS AS AMENDED BY CS",9,0,0,0,9
1921771,1513858,2025-03-11,House,"House: THIRD READING",89,0,0,10,99
1921771,1554224,2025-04-22,Senate,"Senate: Education Committee: DO PASS",10,0,0,0,10
1921771,1568273,2025-05-08,Senate,"Senate: THIRD READING",44,0,0,3,47
1921775,1505098,2025-03-04,Senate,"Senate: Local & County Government Committee: DO PASS AMENDED",5,4,0,0,9
1921782,1493588,2025-02-19,House,"House: Common Education Committee: DO PASS AS AMENDED BY CS",8,0,0,0,8
1921782,1503525,2025-03-03,House,"House: Education Oversight Committee: DO PASS AS AMENDED BY CS",9,0,0,0,9
1921782,1516050,2025-03-12,House,"House: THIRD READING",84,0,0,15,99
1921782,1554157,2025-04-22,Senate,"Senate: Education Committee: DO PASS",10,0,0,0,10
1921782,1562064,2025-04-30,Senate,"Senate: THIRD READING",45,0,0,2,47
1921790,1493581,2025-02-19,House,"House: Common Education Committee: DO PASS AS AMENDED BY CS",10,2,0,0,12
1921814,1505080,2025-03-04,House,"House: Appropriations and Budget Committee: DO PASS AS AMENDED BY CS",30,0,0,0,30
1921814,1512977,2025-03-11,House,"House: THIRD READING",72,6,0,21,99
1921814,1539500,2025-04-08,Senate,"Senate: Retirement & Government Resources Committee: DO PASS",6,2,0,0,8
1921824,1480624,2025-02-05,House,"House: Energy Committee: DO PASS",10,0,0,0,10
1921824,1499741,2025-02-26,House,"House: Energy and Natural Resources Oversight Committee: DO PASS AS AMENDED BY CS",14,1,0,0,15
1921824,1506017,2025-03-05,House,"House: THIRD READING",90,3,0,6,99
1921824,1544561,2025-04-10,Senate,"Senate: Energy Committee: DO PASS AMENDED",10,0,0,0,10
1921824,1596091,2025-04-16,Senate,"Senate: Appropriations Committee: DO PASS",23,0,1,0,24
1921836,1482153,2025-02-05,House,"House: Energy Committee: DO PASS",10,0,0,0,10
1921836,1505645,2025-03-05,House,"House: Energy and Natural Resources Oversight Committee: DO PASS",15,0,0,0,15
1921836,1529052,2025-03-26,House,"House: THIRD READING",95,0,0,4,99
1921836,1557186,2025-04-24,Senate,"Senate: Energy Committee: DO PASS AMENDED",10,0,0,0,10
1921846,1505633,2025-03-04,House,"House: Appropriations and Budget Committee: DO PASS AS AMENDED BY CS",27,0,0,0,27
1921846,1515983,2025-03-12,House,"House: THIRD READING",81,0,0,18,99
1921846,1549874,2025-04-16,Senate,"Senate: Appropriations Committee: DO PASS AMENDED",17,0,0,0,17
1921882,1490973,2025-02-17,House,"House: Appropriations and Budget Natural Resources Subcommittee: DO PASS AS AMENDED BY CS",10,0,0,0,10
1921882,1500275,2025-02-26,House,"House: Appropriations and Budget Committee: DO PASS AS AMENDED BY CS",31,0,0,0,31
1921882,1509288,2025-03-10,House,"House: THIRD READING",91,2,0,6,99
1921882,1544476,2025-04-10,Senate,"Senate: Energy Committee: DO PASS",9,1,0,0,10
1921882,1560966,2025-04-29,Senate,"Senate: THIRD READING",44,1,0,2,47
1921882,1596100,2025-04-16,Senate,"Senate: Appropriations Committee: DO PASS AMENDED",21,0,0,0,21
1921907,1498608,2025-02-25,Senate,"Senate: Education Committee: DO PASS",10,0,0,0,10
1921907,1513847,2025-03-11,Senate,"Senate: THIRD READING",44,0,0,3,47
1921907,1542185,2025-04-09,House,"House: Common Education Committee: DO PASS",11,0,0,0,11
1921907,1559979,2025-04-29,House,"House: THIRD READING",86,0,0,12,98
1921907,1596376,2025-04-23,House,"House: Education Oversight Committee: DO PASS",9,0,0,0,9
1921917,1487052,2025-02-11,House,"House: Banking, Financial Services and Pensions Committee: DO PASS",3,5,0,0,8
1921971,1504241,2025-03-04,Senate,"Senate: Public Safety Committee: DO PASS AMENDED CS",5,0,0,0,5
1921990,1493644,2025-02-19,House,"House: Common Education Committee: DO PASS",8,0,0,0,8
1921998,1499191,2025-02-25,House,"House: Appropriations and Budget Committee: DO PASS AS AMENDED BY CS",29,0,0,0,29
1921998,1525235,2025-03-24,House,"House: THIRD READING",77,13,0,9,99
1921998,1552989,2025-04-21,Senate,"Senate: Health & Human Services Committee: DO PASS AMENDED",8,2,0,0,10
1921998,1596095,2025-04-23,Senate,"Senate: ADOPT",22,1,0,0,23
1921998,1596096,2025-04-23,Senate,"Senate: Appropriations Committee: DO PASS AMENDED",22,1,0,0,23
1922008,1485221,2025-02-10,House,"House: Appropriations and Budget Education Subcommittee: DO PASS",9,0,0,0,9
1922008,1500816,2025-02-26,House,"House: Appropriations and Budget Committee: DO PASS",29,0,0,0,29
1922008,1513182,2025-03-11,House,"House: THIRD READING",86,0,0,13,99
1922008,1548133,2025-04-15,Senate,"Senate: Education Committee: DO PASS",10,1,0,0,11
1922008,1560182,2025-04-29,Senate,"Senate: THIRD READING",41,3,0,3,47
1922020,1491470,2025-02-12,House,"House: Energy Committee: DO PASS",7,0,0,0,7
1922020,1500144,2025-02-26,House,"House: Energy and Natural Resources Oversight Committee: DO PASS",14,0,0,0,14
1922020,1503237,2025-03-03,House,"House: THIRD READING",94,0,0,5,99
1922020,1551510,2025-04-17,Senate,"Senate: Energy Committee: DO PASS",11,0,0,0,11
1922020,1559297,2025-04-28,Senate,"Senate: THIRD READING",44,0,0,3,47
1922027,1487517,2025-02-12,House,"House: Common Education Committee: DO PASS AS AMENDED BY CS",10,2,0,0,12
1922027,1505765,2025-03-05,House,"House: Education Oversight Committee: DO PASS AS AMENDED BY CS",9,0,0,0,9
1922027,1528461,2025-03-26,House,"House: ADVANCE FROM GENERAL ORDER",80,16,0,3,99
1922053,1482716,2025-02-05,House,"House: Energy Committee: DO PASS",9,0,0,0,9
1922053,1499735,2025-02-26,House,"House: Energy and Natural Resources Oversight Committee: DO PASS AS AMENDED BY CS",14,1,0,0,15
1922053,1506606,2025-03-05,House,"House: THIRD READING",91,3,0,5,99
1922053,1551691,2025-04-17,Senate,"Senate: Energy Committee: DO PASS",11,0,0,0,11
1922053,1558851,2025-04-28,Senate,"Senate: THIRD READING",44,0,0,3,47
1922100,1494938,2025-02-20,House,"House: Civil Judiciary Committee: DO PASS",8,0,0,0,8
1922100,1501508,2025-02-27,House,"House: Judiciary and Public Safety Oversight Committee: DO PASS",13,0,0,0,13
1922100,1515961,2025-03-12,House,"House: THIRD READING",80,5,0,14,99
1922105,1487322,2025-02-12,House,"House: Energy Committee: DO PASS AS AMENDED BY CS",7,0,0,0,7
1922105,1499940,2025-02-26,House,"House: Energy and Natural Resources Oversight Committee: DO PASS AS AMENDED BY CS",13,1,0,0,14
1922105,1504317,2025-03-04,House,"House: THIRD READING",85,4,0,10,99
1922105,1544759,2025-04-10,Senate,"Senate: Energy Committee: DO PASS AMENDED",9,1,0,0,10
1922105,1596092,2025-04-23,Senate,"Senate: Appropriations Committee: DO PASS",19,4,0,0,23
1922112,1486039,2025-02-11,Senate,"Senate: Public Safety Committee: DO PASS",6,2,0,0,8
1922120,1490877,2025-02-17,Senate,"Senate: Health & Human Services Committee: DO PASS",10,0,0,0,10
1922120,1528051,2025-03-26,Senate,"Senate: THIRD READING",44,1,0,2,47
1922120,1541863,2025-04-09,House,"House: Public Health Committee: DO PASS",6,0,0,0,6
1922120,1566286,2025-05-06,House,"House: THIRD READING",79,4,0,15,98
1922120,1580934,2025-05-29,Senate,"Senate: VETO OVERRIDE WITH EMERGENCY",47,0,0,1,48
1922120,1581927,2025-05-29,House,"House: VETO OVERRIDE WITH EMERGENCY",76,5,0,17,98
1922120,1596371,2025-04-16,House,"House: Health and Human Services Oversight Committee: DO PASS",12,0,0,0,12
1922148,1488300,2025-02-12,House,"House: Common Education Committee: DO PASS AS AMENDED BY CS",8,4,0,0,12
1922148,1505998,2025-03-05,House,"House: Education Oversight Committee: DO PASS AS AMENDED BY CS",9,0,0,0,9
1922148,1529179,2025-03-27,House,"House: THIRD READING",61,26,0,12,99
1922148,1529180,2025-03-27,House,"House: EMERGENCY",60,23,0,16,99
1922148,1539007,2025-04-07,Senate,"Senate: Revenue & Taxation Committee: DO PASS",8,2,0,0,10
1922190,1498594,2025-02-25,Senate,"Senate: Education Committee: DO PASS",9,0,0,0,9
1922217,1504762,2025-03-04,Senate,"Senate: Education Committee: DO PASS AMENDED CS",9,0,0,0,9
1922217,1516605,2025-03-12,Senate,"Senate: THIRD READING",41,2,0,4,47
1922217,1542433,2025-04-09,House,"House: Common Education Committee: DO PASS",7,4,0,0,11
1922217,1555457,2025-04-23,House,"House: Education Oversight Committee: DO PASS AS AMENDED BY CS",9,0,0,0,9
1922217,1563479,2025-05-01,House,"House: THIRD READING",52,35,0,11,98
1922217,1563480,2025-05-01,House,"House: EMERGENCY",23,26,0,49,98
1922217,1591804,2025-05-15,Senate,"Senate: FOURTH READING",43,0,0,4,47
1922516,1482344,2025-02-05,House,"House: Public Health Committee: DO PASS",6,0,0,0,6
1922516,1499997,2025-02-26,House,"House: Health and Human Services Oversight Committee: DO PASS",10,0,0,0,10
1922517,1491232,2025-02-17,Senate,"Senate: Aeronautics & Transportation Committee: DO PASS",11,0,0,0,11
1922519,1498853,2025-02-25,Senate,"Senate: Retirement & Government Resources Committee: DO PASS",8,0,0,0,8
1922519,1519414,2025-03-18,Senate,"Senate: THIRD READING",45,0,0,2,47
1922519,1540143,2025-04-08,House,"House: General Government Committee: DO PASS",8,0,0,0,8
1922519,1566560,2025-05-06,House,"House: THIRD READING",91,0,0,7,98
1922519,1596400,2025-04-15,House,"House: Government Oversight Committee: DO PASS",14,1,0,0,15
1922533,1489450,2025-02-13,Senate,"Senate: Administrative Rules Committee: DO PASS AMENDED",7,2,0,0,9
1922547,1491407,2025-02-17,Senate,"Senate: Health & Human Services Committee: DO PASS",10,0,0,0,10
1922547,1528537,2025-03-26,Senate,"Senate: THIRD READING",44,2,0,1,47
1922547,1541449,2025-04-09,House,"House: Public Health Committee: DO PASS",6,0,0,0,6
1922547,1547709,2025-04-14,House,"House: Health and Human Services Oversight Committee: DO PASS AS AMENDED BY CS",13,0,0,0,13
1922547,1568033,2025-05-07,House,"House: THIRD READING",85,5,0,8,98
1922547,1581955,2025-05-30,Senate,"Senate: VETO OVERRIDE NO EMERGENCY",43,3,0,2,48
1922547,1581956,2025-05-30,House,"House: VETO OVERRIDE WITHOUT EMERGENCY",77,6,0,15,98
1922547,1591567,2025-05-21,Senate,"Senate: FOURTH READING",36,9,0,3,48
1922565,1504540,2025-03-04,Senate,"Senate: Public Safety Committee: DO PASS AMENDED CS",5,0,0,0,5
1922565,1527451,2025-03-25,Senate,"Senate: THIRD READING",43,2,0,2,47
1922565,1538242,2025-04-03,House,"House: Civil Judiciary Committee: DO PASS",10,0,0,0,10
1922565,1554653,2025-04-22,House,"House: Judiciary and Public Safety Oversight Committee: DO PASS AS AMENDED, STRIKE THE TITLE",9,0,0,0,9
1922567,1480158,2025-02-04,House,"House: Criminal Judiciary Committee: DO PASS",4,1,0,0,5
1922567,1498614,2025-02-25,House,"House: Judiciary and Public Safety Oversight Committee: DO PASS",7,2,0,0,9
1922567,1506244,2025-03-05,House,"House: THIRD READING",91,0,0,8,99
1922567,1554137,2025-04-22,Senate,"Senate: Judiciary Committee: DO PASS AMENDED",7,1,0,0,8
1922578,1494041,2025-02-19,House,"House: Banking, Financial Services and Pensions Committee: DO PASS",8,0,0,0,8
1922578,1508177,2025-03-06,House,"House: Government Oversight Committee: DO PASS",15,0,0,0,15
1922578,1519147,2025-03-17,House,"House: THIRD READING",78,6,0,15,99
1922578,1548336,2025-04-14,Senate,"Senate: Revenue & Taxation Committee: DO PASS",11,0,0,0,11
1922578,1565763,2025-05-06,Senate,"Senate: THIRD READING",46,0,0,1,47
1922583,1507321,2025-03-06,Senate,"Senate: Technology & Telecommunications Committee: DO PASS",8,0,0,0,8
1922598,1482209,2025-02-05,House,"House: Public Health Committee: DO PASS",6,0,0,0,6
1922598,1503277,2025-03-03,House,"House: Health and Human Services Oversight Committee: DO PASS",13,0,0,0,13
1922598,1517212,2025-03-13,House,"House: THIRD READING",80,0,0,19,99
1922598,1548657,2025-04-15,Senate,"Senate: Judiciary Committee: DO PASS",6,1,0,0,7
1922598,1564940,2025-05-05,Senate,"Senate: THIRD READING",44,0,0,3,47
1922601,1486583,2025-02-11,House,"House: Criminal Judiciary Committee: DO PASS AS AMENDED BY CS",4,1,0,0,5
1922601,1499296,2025-02-25,House,"House: Judiciary and Public Safety Oversight Committee: DO PASS AS AMENDED BY CS",8,2,0,0,10
1922601,1513854,2025-03-11,House,"House: THIRD READING",73,16,0,10,99
1922601,1548058,2025-04-15,Senate,"Senate: Public Safety Committee: DO PASS",6,2,0,0,8
1922601,1563927,2025-05-01,Senate,"Senate: THIRD READING",40,6,0,1,47
1922609,1495780,2025-02-20,House,"House: Appropriations and Budget Finance Subcommittee: DO PASS",7,2,0,0,9
1922609,1506443,2025-03-05,House,"House: Appropriations and Budget Committee: DO PASS AS AMENDED, STRIKE THE TITLE",25,6,0,0,31
1922609,1526864,2025-03-25,House,"House: THIRD READING",76,20,0,3,99
1922609,1538531,2025-04-07,Senate,"Senate: Revenue & Taxation Committee: DO PASS AMENDED",10,2,0,0,12
1922609,1543497,2025-04-10,Senate,"Senate: THIRD READING",36,9,0,2,47
1922613,1486989,2025-02-11,House,"House: Insurance Committee: DO PASS",7,0,0,0,7
1922613,1498600,2025-02-25,House,"House: Commerce and Economic Development Oversight Committee: DO PASS",13,1,0,0,14
1922613,1518638,2025-03-17,House,"House: THIRD READING",79,5,0,15,99
1922613,1551664,2025-04-17,Senate,"Senate: Business & Insurance Committee: DO PASS",9,0,0,0,9
1922613,1567871,2025-05-07,Senate,"Senate: THIRD READING",44,0,0,3,47
1922617,1493752,2025-02-19,House,"House: Common Education Committee: DO PASS AS AMENDED BY CS",3,8,0,0,11
1922624,1504206,2025-03-04,Senate,"Senate: Retirement & Government Resources Committee: DO PASS AMENDED",8,0,0,0,8
1922625,1504724,2025-03-04,Senate,"Senate: Education Committee: DO PASS AMENDED",10,0,0,0,10
1922625,1519406,2025-03-18,Senate,"Senate: THIRD READING",43,1,0,3,47
1922625,1542680,2025-04-09,House,"House: Common Education Committee: DO PASS",11,0,0,0,11
1922625,1561219,2025-04-29,House,"House: THIRD READING",81,6,0,11,98
1922625,1591499,2025-05-21,Senate,"Senate: FOURTH READING",40,0,0,8,48
1922625,1596388,2025-04-16,House,"House: Education Oversight Committee: DO PASS",9,0,0,0,9
1922633,1494935,2025-02-20,House,"House: Appropriations and Budget Finance Subcommittee: DO PASS",6,3,0,0,9
1922642,1485000,2025-02-10,Senate,"Senate: Aeronautics & Transportation Committee: DO PASS",12,0,0,0,12
1922642,1528171,2025-03-26,Senate,"Senate: THIRD READING",46,0,0,1,47
1922642,1542064,2025-04-09,House,"House: Public Safety Committee: DO PASS",7,0,0,0,7
1922642,1563430,2025-05-01,House,"House: THIRD READING",82,1,0,15,98
1922642,1580905,2025-05-29,Senate,"Senate: VETO OVERRIDE NO EMERGENCY",47,0,0,1,48
1922642,1581943,2025-05-29,House,"House: VETO OVERRIDE WITHOUT EMERGENCY",78,0,0,20,98
1922642,1596387,2025-04-22,House,"House: Judiciary and Public Safety Oversight Committee: DO PASS",8,0,0,0,8
1922644,1489027,2025-02-13,House,"House: Civil Judiciary Committee: DO PASS AS AMENDED BY CS",8,0,0,0,8
1922644,1504800,2025-03-04,House,"House: Judiciary and Public Safety Oversight Committee: DO PASS AS AMENDED BY CS",14,0,0,0,14
1922644,1528747,2025-03-27,House,"House: THIRD READING",77,8,0,14,99
1922644,1555328,2025-04-22,Senate,"Senate: Judiciary Committee: DO PASS AMENDED CS",8,0,0,0,8
1922644,1562469,2025-04-30,Senate,"Senate: THIRD READING",26,18,0,3,47
1922644,1575257,2025-05-21,House,"House: FOURTH READING",85,4,0,9,98
1922644,1580888,2025-05-29,House,"House: VETO OVERRIDE WITHOUT EMERGENCY",82,4,0,12,98
1922644,1581969,2025-05-29,Senate,"Senate: VETO OVERRIDE NO EMERGENCY",45,0,0,3,48
1922644,1591730,2025-05-21,Senate,"Senate: FOURTH READING",46,0,0,2,48
1922651,1498585,2025-02-25,Senate,"Senate: Public Safety Committee: DO PASS",6,1,0,0,7
1922665,1494007,2025-02-19,Senate,"Senate: Public Safety Committee: DO PASS AMENDED CS",4,2,0,0,6
1922665,1529845,2025-03-27,Senate,"Senate: THIRD READING",36,8,0,3,47
1922665,1541518,2025-04-08,House,"House: Criminal Judiciary Committee: DO PASS",4,0,0,0,4
1922665,1551523,2025-04-17,House,"House: Judiciary and Public Safety Oversight Committee: DO PASS AS AMENDED, STRIKE THE TITLE",12,0,0,0,12
1922677,1501360,2025-02-27,Senate,"Senate: Business & Insurance Committee: DO PASS",10,0,0,0,10
1922677,1529653,2025-03-27,Senate,"Senate: THIRD READING",47,0,0,0,47
1922677,1543499,2025-04-10,House,"House: Civil Judiciary Committee: DO PASS AS AMENDED BY CS",8,0,0,0,8
1922677,1563675,2025-05-01,House,"House: THIRD READING",84,0,0,14,98
1922677,1591326,2025-05-22,Senate,"Senate: FOURTH READING",42,0,0,6,48
1922677,1591327,2025-05-22,Senate,"Senate: FOURTH READING",42,0,0,6,48
1922677,1596394,2025-04-22,House,"House: Judiciary and Public Safety Oversight Committee: DO PASS AS AMENDED BY CS",8,0,0,0,8
1922684,1505229,2025-03-04,Senate,"Senate: Judiciary Committee: DO PASS",6,2,0,0,8
1922686,1489220,2025-02-13,House,"House: Civil Judiciary Committee: DO PASS AS AMENDED BY CS",8,0,0,0,8
1922686,1505191,2025-03-04,House,"House: Judiciary and Public Safety Oversight Committee: DO PASS AS AMENDED BY CS",13,0,0,0,13
1922686,1519018,2025-03-17,House,"House: THIRD READING",83,1,0,15,99
1922691,1491311,2025-02-17,House,"House: Elections and Ethics Committee: DO PASS AS AMENDED BY CS",4,3,0,0,7
1922691,1507242,2025-03-06,House,"House: Government Oversight Committee: DO PASS AS AMENDED BY CS",6,10,0,0,16
1922694,1484870,2025-02-10,House,"House: Appropriations and Budget Natural Resources Subcommittee: DO PASS",7,2,0,0,9
1922694,1505116,2025-03-04,House,"House: Appropriations and Budget Committee: DO PASS",30,0,0,0,30
1922694,1517259,2025-03-13,House,"House: THIRD READING",76,11,0,12,99
1922694,1551659,2025-04-17,Senate,"Senate: Energy Committee: DO PASS",8,3,0,0,11
1922694,1566505,2025-05-06,Senate,"Senate: THIRD READING",31,15,0,1,47
1922694,1580971,2025-05-29,House,"House: VETO OVERRIDE WITHOUT EMERGENCY",70,10,0,18,98
1922694,1582013,2025-05-29,Senate,"Senate: VETO OVERRIDE NO EMERGENCY",32,13,0,3,48
1922702,1501173,2025-02-27,Senate,"Senate: Technology & Telecommunications Committee: DO PASS AMENDED",5,2,0,0,7
1922704,1486542,2025-02-11,House,"House: Criminal Judiciary Committee: DO PASS",4,1,0,0,5
1922704,1499187,2025-02-25,House,"House: Judiciary and Public Safety Oversight Committee: DO PASS",8,1,0,0,9
1922704,1506349,2025-03-05,House,"House: THIRD READING",89,7,0,3,99
1922713,1486947,2025-02-11,Senate,"Senate: Retirement & Insurance Committee: DO PASS",7,0,0,0,7
1922713,1519684,2025-03-18,Senate,"Senate: THIRD READING",44,0,0,3,47
1922716,1492974,2025-02-19,House,"House: Alcohol, Tobacco and Controlled Substances Committee: DO PASS",5,0,0,0,5
1922734,1498584,2025-02-25,Senate,"Senate: Public Safety Committee: DO PASS",7,1,0,0,8
1922735,1498880,2025-02-25,Senate,"Senate: Public Safety Committee: DO PASS AMENDED CS",6,2,0,0,8
1922738,1489313,2025-02-13,House,"House: Civil Judiciary Committee: DO PASS",7,1,0,0,8
1922738,1504669,2025-03-04,House,"House: Judiciary and Public Safety Oversight Committee: DO PASS AS AMENDED BY CS",14,0,0,0,14
1922738,1524853,2025-03-24,House,"House: THIRD READING",73,16,0,10,99
1922738,1548500,2025-04-15,Senate,"Senate: Judiciary Committee: DO PASS",6,2,0,0,8
1922738,1565111,2025-05-05,Senate,"Senate: THIRD READING",35,12,0,0,47
1922738,1596103,2025-04-23,Senate,"Senate: Appropriations Committee: DO PASS AMENDED",17,4,0,0,21
1922752,1480284,2025-02-04,House,"House: Agriculture Committee: DO PASS",7,0,0,0,7
1922752,1500484,2025-02-26,House,"House: Energy and Natural Resources Oversight Committee: DO PASS",15,0,0,0,15
1922752,1505125,2025-03-04,House,"House: THIRD READING",95,0,0,4,99
1922752,1547509,2025-04-14,Senate,"Senate: Agriculture & Wildlife Committee: DO PASS",12,0,0,0,12
1922752,1560435,2025-04-29,Senate,"Senate: THIRD READING",44,0,0,3,47
1922771,1486151,2025-02-11,Senate,"Senate: Judiciary Committee: DO PASS AMENDED CS",7,0,0,0,7
1922771,1515897,2025-03-12,Senate,"Senate: THIRD READING",43,0,0,4,47
1922771,1538823,2025-04-07,House,"House: Elections and Ethics Committee: DO PASS",5,0,0,0,5
1922771,1562609,2025-04-30,House,"House: THIRD READING",87,0,0,11,98
1922771,1596396,2025-04-17,House,"House: Government Oversight Committee: DO PASS",16,0,0,0,16
1922779,1497966,2025-02-24,Senate,"Senate: Health & Human Services Committee: DO PASS AMENDED CS",11,0,0,0,11
1922779,1512729,2025-03-11,Senate,"Senate: THIRD READING",42,0,0,5,47
1922779,1542509,2025-04-09,House,"House: Public Health Committee: DO PASS",6,0,0,0,6
1922779,1567531,2025-05-07,House,"House: THIRD READING",83,4,0,11,98
1922779,1596392,2025-04-21,House,"House: Health and Human Services Oversight Committee: DO PASS",13,0,0,0,13
1922810,1493165,2025-02-17,House,"House: Appropriations and Budget General Government Subcommittee: DO PASS AS AMENDED BY CS",5,0,0,0,5
1922810,1500619,2025-02-26,House,"House: Appropriations and Budget Committee: DO PASS AS AMENDED BY CS",30,0,0,0,30
1922810,1509161,2025-03-10,House,"House: THIRD READING",90,4,0,5,99
1922810,1550956,2025-04-17,Senate,"Senate: Business & Insurance Committee: DO PASS",10,0,0,0,10
1922810,1567071,2025-05-07,Senate,"Senate: THIRD READING",40,4,0,3,47
1922810,1596102,2025-04-23,Senate,"Senate: Appropriations Committee: DO PASS",24,2,0,0,26
1922816,1486614,2025-02-11,House,"House: Rules Committee: DO PASS AS AMENDED BY CS",9,0,0,0,9
1922816,1509604,2025-03-10,House,"House: THIRD READING",88,4,0,7,99
1922816,1552779,2025-04-21,Senate,"Senate: Health & Human Services Committee: DO PASS",10,0,0,0,10
1922816,1560437,2025-04-29,Senate,"Senate: THIRD READING",43,1,0,3,47
1922820,1505351,2025-03-04,Senate,"Senate: Judiciary Committee: DO PASS",8,0,0,0,8
1922820,1513628,2025-03-11,Senate,"Senate: THIRD READING",44,0,0,3,47
1922820,1540534,2025-04-08,House,"House: Criminal Judiciary Committee: DO PASS",4,0,0,0,4
1922820,1563376,2025-05-01,House,"House: THIRD READING",84,0,0,14,98
1922820,1596381,2025-04-17,House,"House: Judiciary and Public Safety Oversight Committee: DO PASS",12,0,0,0,12
1922823,1497815,2025-02-24,House,"House: Public Health Committee: DO PASS AS AMENDED BY CS",6,0,0,0,6
1922823,1505819,2025-03-05,House,"House: Health and Human Services Oversight Committee: DO PASS AS AMENDED BY CS",10,2,0,0,12
1922823,1528767,2025-03-27,House,"House: THIRD READING",84,0,0,15,99
1922823,1547437,2025-04-14,Senate,"Senate: Health & Human Services Committee: DO PASS",11,0,0,0,11
1922823,1561241,2025-04-29,Senate,"Senate: THIRD READING",43,0,0,4,47
1922828,1495976,2025-02-20,House,"House: Appropriations and Budget Finance Subcommittee: DO PASS",5,4,0,0,9
1922832,1491221,2025-02-17,Senate,"Senate: Health & Human Services Committee: DO PASS",9,0,0,0,9
1922832,1500483,2025-02-26,Senate,"Senate: THIRD READING",38,7,0,2,47
1922832,1541519,2025-04-09,House,"House: Public Health Committee: DO PASS",4,0,0,0,4
1922832,1565211,2025-05-05,House,"House: THIRD READING",78,12,0,8,98
1922832,1596401,2025-04-16,House,"House: Health and Human Services Oversight Committee: DO PASS",12,0,0,0,12
1922837,1486095,2025-02-11,Senate,"Senate: Public Safety Committee: DO PASS",6,2,0,0,8
1922839,1486499,2025-02-11,House,"House: Banking, Financial Services and Pensions Committee: DO PASS AS AMENDED BY CS",8,0,0,0,8
1922839,1505288,2025-03-04,House,"House: Government Oversight Committee: DO PASS AS AMENDED BY CS",10,2,0,0,12
1922839,1528462,2025-03-26,House,"House: THIRD READING",61,33,0,5,99
1922842,1488048,2025-02-12,House,"House: Common Education Committee: DO PASS AS AMENDED BY CS",12,0,0,0,12
1922842,1505909,2025-03-05,House,"House: Education Oversight Committee: DO PASS AS AMENDED BY CS",9,0,0,0,9
1922842,1528755,2025-03-27,House,"House: THIRD READING",85,4,0,10,99
1922842,1553392,2025-04-22,Senate,"Senate: Education Committee: DO PASS AMENDED",10,0,0,0,10
1922842,1567116,2025-05-07,Senate,"Senate: THIRD READING",45,0,0,2,47
1922842,1574817,2025-05-21,House,"House: FOURTH READING",88,0,0,10,98
1922842,1581981,2025-05-29,House,"House: VETO OVERRIDE WITH EMERGENCY",78,0,0,20,98
1922847,1484616,2025-02-10,House,"House: Appropriations and Budget Natural Resources Subcommittee: DO PASS",10,0,0,0,10
1922847,1500398,2025-02-26,House,"House: Appropriations and Budget Committee: DO PASS",30,0,0,0,30
1922847,1516482,2025-03-12,House,"House: THIRD READING",70,17,0,12,99
1922847,1555425,2025-04-23,Senate,"Senate: Appropriations Committee: DO PASS AMENDED",20,1,0,0,21
1922849,1487136,2025-02-11,House,"House: Criminal Judiciary Committee: DO PASS AS AMENDED BY CS",5,0,0,0,5
1922849,1499642,2025-02-25,House,"House: Judiciary and Public Safety Oversight Committee: DO PASS AS AMENDED BY CS",10,0,0,0,10
1922849,1513860,2025-03-11,House,"House: THIRD READING",89,0,0,10,99
1922867,1483308,2025-02-06,House,"House: Veterans and Military Affairs Committee: DO PASS",8,0,0,0,8
1922867,1489115,2025-02-13,House,"House: Health and Human Services Oversight Committee: DO PASS",12,0,0,0,12
1922867,1500093,2025-02-26,House,"House: THIRD READING",92,0,1,6,99
1922867,1538234,2025-04-07,Senate,"Senate: Aeronautics & Transportation Committee: DO PASS AMENDED",10,0,0,0,10
1922871,1504245,2025-03-04,Senate,"Senate: Retirement & Government Resources Committee: DO PASS AMENDED",5,2,0,0,7
1922878,1504256,2025-03-03,Senate,"Senate: Revenue & Taxation Committee: DO PASS AMENDED",10,0,0,0,10
1922885,1505069,2025-03-04,Senate,"Senate: Local & County Government Committee: DO PASS AMENDED",6,3,0,0,9
1922885,1529505,2025-03-27,Senate,"Senate: THIRD READING",35,12,0,0,47
1922885,1542305,2025-04-09,House,"House: County and Municipal Government Committee: DO PASS",5,0,0,0,5
1922885,1556816,2025-04-24,House,"House: Government Oversight Committee: DO PASS AS AMENDED BY CS",12,1,0,0,13
1922885,1563559,2025-05-01,House,"House: THIRD READING",64,22,0,12,98
1922885,1563560,2025-05-01,House,"House: EMERGENCY",65,20,0,13,98
1922885,1566574,2025-05-06,House,"House: RECONSIDER EMERGENCY",54,14,0,30,98
1922885,1591382,2025-05-21,Senate,"Senate: FOURTH READING",30,10,0,8,48
1922889,1489368,2025-02-13,Senate,"Senate: Administrative Rules Committee: DO PASS AMENDED CS",8,0,0,0,8
1922889,1512517,2025-03-11,Senate,"Senate: THIRD READING",42,0,1,4,47
1922889,1541006,2025-04-08,House,"House: Administrative Rules Committee: DO PASS",13,0,0,0,13
1922889,1566690,2025-05-06,House,"House: THIRD READING",92,0,0,6,98
1922889,1596398,2025-02-24,Senate,"Senate: Revenue & Taxation Committee: DO PASS",11,0,0,0,11
1922889,1596399,2025-02-24,Senate,"Senate: Revenue & Taxation Committee: DO PASS AMENDED CS",11,0,0,0,11
1922898,1498828,2025-02-25,Senate,"Senate: Public Safety Committee: DO PASS AMENDED CS",6,2,0,0,8
1922909,1484987,2025-02-10,Senate,"Senate: Health & Human Services Committee: DO PASS",10,0,0,0,10
1922909,1491500,2025-02-17,Senate,"Senate: THIRD READING",44,0,0,3,47
1922909,1541330,2025-04-09,House,"House: Alcohol, Tobacco and Controlled Substances Committee: DO PASS AS AMENDED BY CS",8,0,0,0,8
1922909,1565406,2025-05-05,House,"House: THIRD READING",78,13,0,7,98
1922909,1591354,2025-05-14,Senate,"Senate: FOURTH READING",36,4,0,7,47
1922909,1596397,2025-04-21,House,"House: Health and Human Services Oversight Committee: DO PASS AS AMENDED BY CS",11,2,0,0,13
1922911,1482545,2025-02-04,House,"House: General Government Committee: DO PASS",5,2,0,0,7
1922911,1501607,2025-02-27,House,"House: Government Oversight Committee: DO PASS",12,2,0,0,14
1922911,1516047,2025-03-12,House,"House: THIRD READING",54,33,0,12,99
1922916,1493469,2025-02-19,Senate,"Senate: Public Safety Committee: DO PASS",5,2,0,0,7
1922932,1486287,2025-02-11,House,"House: Criminal Judiciary Committee: DO PASS AS AMENDED BY CS",4,1,0,0,5
1922932,1498573,2025-02-25,House,"House: Judiciary and Public Safety Oversight Committee: DO PASS AS AMENDED BY CS",9,1,0,0,10
1922932,1514773,2025-03-11,House,"House: THIRD READING",84,5,0,10,99
1922932,1553949,2025-04-22,Senate,"Senate: Judiciary Committee: DO PASS",7,1,0,0,8
1922932,1567460,2025-05-07,Senate,"Senate: THIRD READING",38,6,0,3,47
1922935,1499104,2025-02-25,Senate,"Senate: Judiciary Committee: DO PASS",7,0,0,0,7
1922935,1513352,2025-03-11,Senate,"Senate: THIRD READING",46,0,0,1,47
1922935,1544190,2025-04-10,House,"House: Veterans and Military Affairs Committee: DO PASS",7,0,0,0,7
1922935,1549516,2025-04-16,House,"House: Health and Human Services Oversight Committee: DO PASS AS AMENDED BY CS",8,2,0,0,10
1922935,1567926,2025-05-07,House,"House: THIRD READING",85,0,0,13,98
1922945,1493708,2025-02-19,Senate,"Senate: Judiciary Committee: DO PASS",2,6,0,0,8
1922951,1493976,2025-02-19,Senate,"Senate: Public Safety Committee: DO PASS",6,2,0,0,8
1922951,1509641,2025-03-10,Senate,"Senate: THIRD READING",41,5,0,1,47
1922951,1541142,2025-04-08,House,"House: Criminal Judiciary Committee: DO PASS",4,0,0,0,4
1922951,1562550,2025-04-30,House,"House: THIRD READING",91,0,0,7,98
1922951,1596390,2025-04-17,House,"House: Judiciary and Public Safety Oversight Committee: DO PASS",11,0,0,0,11
1922954,1482512,2025-02-05,House,"House: Public Health Committee: DO PASS",5,0,0,0,5
1922954,1499941,2025-02-26,House,"House: Health and Human Services Oversight Committee: DO PASS",10,0,0,0,10
1922954,1503169,2025-03-03,House,"House: THIRD READING",83,14,0,2,99
1922954,1538523,2025-04-07,Senate,"Senate: Health & Human Services Committee: DO PASS AMENDED",11,0,0,0,11
1922954,1568382,2025-05-08,Senate,"Senate: THIRD READING",33,13,0,1,47
1922954,1575865,2025-05-22,House,"House: FOURTH READING",68,21,0,9,98
1922954,1580976,2025-05-29,House,"House: VETO OVERRIDE WITH EMERGENCY",76,12,0,10,98
1922954,1581976,2025-05-29,Senate,"Senate: VETO OVERRIDE WITH EMERGENCY",36,9,0,3,48
1922954,1591724,2025-05-22,Senate,"Senate: FOURTH READING",27,15,0,6,48
1922954,1596104,2025-04-23,Senate,"Senate: Appropriations Committee: DO PASS",20,2,0,0,22
1922966,1503549,2025-03-03,Senate,"Senate: Health & Human Services Committee: DO PASS",11,0,0,0,11
1922966,1525073,2025-03-24,Senate,"Senate: THIRD READING",46,0,0,1,47
1922966,1541279,2025-04-09,House,"House: Public Health Committee: DO PASS",3,2,0,0,5
1922966,1549578,2025-04-16,House,"House: Health and Human Services Oversight Committee: DO PASS AS AMENDED BY CS",7,4,0,0,11
1922966,1565209,2025-05-05,House,"House: THIRD READING",46,46,0,6,98
1922966,1567345,2025-05-07,House,"House: RECONSIDER MEASURE",68,18,0,12,98
1922966,1591333,2025-05-20,Senate,"Senate: FOURTH READING",35,8,0,4,47
1922972,1493215,2025-02-19,Senate,"Senate: Judiciary Committee: DO PASS AMENDED",9,0,0,0,9
1922972,1524775,2025-03-24,Senate,"Senate: THIRD READING",46,0,0,1,47
1922972,1539901,2025-04-07,House,"House: Appropriations and Budget General Government Subcommittee: DO PASS",6,0,0,0,6
1922972,1562363,2025-04-30,House,"House: THIRD READING",89,0,0,9,98
1922972,1596385,2025-02-26,Senate,"Senate: Appropriations Committee: DO PASS AMENDED",22,0,0,0,22
1922972,1596386,2025-04-16,House,"House: Appropriations and Budget Committee: DO PASS",27,0,0,0,27
1922976,1499253,2025-02-24,Senate,"Senate: Health & Human Services Committee: DO PASS",12,0,0,0,12
1922976,1514746,2025-03-11,Senate,"Senate: THIRD READING",44,0,0,3,47
1922976,1541789,2025-04-09,House,"House: Public Health Committee: DO PASS",6,0,0,0,6
1922976,1552571,2025-04-21,House,"House: THIRD READING",80,0,0,18,98
1922976,1596380,2025-04-16,House,"House: Health and Human Services Oversight Committee: DO PASS",12,0,0,0,12
1922987,1486825,2025-02-11,House,"House: Banking, Financial Services and Pensions Committee: DO PASS AS AMENDED BY CS",8,0,0,0,8
1922987,1507147,2025-03-06,House,"House: Government Oversight Committee: DO PASS AS AMENDED BY CS",14,1,0,0,15
1922987,1518426,2025-03-17,House,"House: THIRD READING",82,1,0,16,99
1922987,1538990,2025-04-07,Senate,"Senate: Agriculture & Wildlife Committee: DO PASS",11,0,0,0,11
1922987,1565540,2025-05-06,Senate,"Senate: THIRD READING",39,8,0,0,47
1922990,1491222,2025-02-17,Senate,"Senate: Health & Human Services Committee: DO PASS AMENDED",8,1,0,0,9
1922990,1515826,2025-03-12,Senate,"Senate: THIRD READING",35,8,0,4,47
1922990,1540117,2025-04-08,House,"House: Business Committee: DO PASS AS AMENDED BY CS",9,0,0,0,9
1922990,1562451,2025-04-30,House,"House: THIRD READING",80,6,0,12,98
1922990,1591463,2025-05-21,Senate,"Senate: FOURTH READING",28,12,0,8,48
1922990,1596378,2025-04-24,House,"House: Commerce and Economic Development Oversight Committee: DO PASS AS AMENDED BY CS",14,2,0,0,16
1922995,1494329,2025-02-19,House,"House: Appropriations and Budget Education Subcommittee: DO PASS AS AMENDED BY CS",5,3,0,0,8
1922998,1498136,2025-02-24,House,"House: Public Health Committee: DO PASS AS AMENDED BY CS",5,1,0,0,6
1922998,1505648,2025-03-05,House,"House: Health and Human Services Oversight Committee: DO PASS AS AMENDED BY CS",13,0,0,0,13
1922998,1525843,2025-03-25,House,"House: THIRD READING",84,10,0,5,99
1922998,1538524,2025-04-07,Senate,"Senate: Health & Human Services Committee: DO PASS",9,2,0,0,11
1922998,1561816,2025-04-30,Senate,"Senate: THIRD READING",44,0,0,3,47
1922998,1571093,2025-05-14,House,"House: FOURTH READING",83,3,0,12,98
1923006,1504974,2025-03-04,Senate,"Senate: Judiciary Committee: DO PASS AMENDED CS",8,0,0,0,8
1923006,1529803,2025-03-27,Senate,"Senate: THIRD READING",46,0,0,1,47
1923006,1542474,2025-04-09,House,"House: Children, Youth and Family Services Committee: DO PASS",6,0,0,0,6
1923006,1563520,2025-05-01,House,"House: THIRD READING",79,0,0,19,98
1923006,1581939,2025-05-29,Senate,"Senate: VETO OVERRIDE NO EMERGENCY",47,0,0,1,48
1923006,1581940,2025-05-29,House,"House: VETO OVERRIDE WITHOUT EMERGENCY",81,0,0,17,98
1923006,1596391,2025-04-21,House,"House: Health and Human Services Oversight Committee: DO PASS",13,0,0,0,13
1923013,1489209,2025-02-13,Senate,"Senate: Administrative Rules Committee: DO PASS AMENDED",10,0,0,0,10
1923013,1519513,2025-03-18,Senate,"Senate: THIRD READING",45,0,0,2,47
1923022,1498790,2025-02-25,Senate,"Senate: Judiciary Committee: DO PASS",7,2,0,0,9
1923022,1527624,2025-03-26,Senate,"Senate: THIRD READING",29,18,0,0,47
1923034,1498043,2025-02-24,Senate,"Senate: Health & Human Services Committee: DO PASS AMENDED",10,0,1,0,11
1923034,1528339,2025-03-26,Senate,"Senate: THIRD READING",44,0,0,3,47
1923034,1541285,2025-04-09,House,"House: Public Health Committee: DO PASS",5,0,0,0,5
1923034,1565384,2025-05-05,House,"House: THIRD READING",90,0,0,8,98
1923034,1596393,2025-04-14,House,"House: Health and Human Services Oversight Committee: DO PASS",13,0,0,0,13
1923042,1499108,2025-02-25,Senate,"Senate: Judiciary Committee: DO PASS",7,0,0,0,7
1923042,1516628,2025-03-12,Senate,"Senate: THIRD READING",42,0,0,5,47
1923042,1538364,2025-04-07,House,"House: Elections and Ethics Committee: DO PASS",6,0,0,0,6
1923042,1561282,2025-04-29,House,"House: THIRD READING",87,0,0,11,98
1923042,1596382,2025-04-15,House,"House: Government Oversight Committee: DO PASS",15,0,0,0,15
1923047,1495227,2025-02-20,House,"House: Civil Judiciary Committee: DO PASS AS AMENDED BY CS",8,1,0,0,9
1923047,1501395,2025-02-27,House,"House: Judiciary and Public Safety Oversight Committee: DO PASS AS AMENDED BY CS",11,0,0,0,11
1923047,1516878,2025-03-13,House,"House: THIRD READING",81,1,0,17,99
1923059,1491209,2025-02-17,House,"House: Tourism Committee: DO PASS",4,0,0,0,4
1923059,1498582,2025-02-25,House,"House: Commerce and Economic Development Oversight Committee: DO PASS",14,1,0,0,15
1923059,1501142,2025-02-27,House,"House: THIRD READING",80,11,0,8,99
1923059,1549132,2025-04-15,Senate,"Senate: Economic Development, Workforce & Tourism Committee: DO PASS",8,0,0,0,8
1923059,1561895,2025-04-29,Senate,"Senate: THIRD READING",41,4,0,2,47
1923066,1480174,2025-02-04,House,"House: Criminal Judiciary Committee: DO PASS AS AMENDED BY CS",4,1,0,0,5
1923066,1498929,2025-02-25,House,"House: Judiciary and Public Safety Oversight Committee: DO PASS AS AMENDED BY CS",6,3,0,0,9
1923066,1506483,2025-03-05,House,"House: THIRD READING",71,17,0,11,99
1923066,1553509,2025-04-22,Senate,"Senate: Public Safety Committee: DO PASS AMENDED CS",5,2,0,0,7
1923066,1567139,2025-05-07,Senate,"Senate: THIRD READING",39,6,0,2,47
1923066,1571179,2025-05-14,House,"House: FOURTH READING",83,1,0,14,98
1923066,1581039,2025-05-29,House,"House: VETO OVERRIDE WITHOUT EMERGENCY",93,0,0,5,98
1923066,1581930,2025-05-29,Senate,"Senate: VETO OVERRIDE NO EMERGENCY",38,7,0,3,48
1923076,1484881,2025-02-10,Senate,"Senate: Finance Committee: DO PASS AMENDED",9,2,0,0,11
1923076,1515930,2025-03-12,Senate,"Senate: THIRD READING",26,18,0,3,47
1923076,1544038,2025-04-10,House,"House: Appropriations and Budget Finance Subcommittee: DO PASS",5,2,0,0,7
1923076,1596383,2025-02-20,Senate,"Senate: Appropriations Committee: DO PASS",23,1,0,0,24
1923100,1482708,2025-02-05,House,"House: Common Education Committee: DO PASS AS AMENDED BY CS",9,2,0,0,11
1923100,1505993,2025-03-05,House,"House: Education Oversight Committee: DO PASS AS AMENDED BY CS",9,0,0,0,9
1923118,1493390,2025-02-19,House,"House: Common Education Committee: DO PASS AS AMENDED BY CS",5,6,0,0,11
1923122,1501490,2025-02-27,Senate,"Senate: Technology & Telecommunications Committee: DO PASS AMENDED",7,0,0,0,7
1923128,1487573,2025-02-12,House,"House: County and Municipal Government Committee: DO PASS",6,0,0,0,6
1923128,1501616,2025-02-27,House,"House: Government Oversight Committee: DO PASS",16,0,0,0,16
1923128,1515214,2025-03-11,House,"House: THIRD READING",92,0,0,7,99
1923128,1548386,2025-04-15,Senate,"Senate: Local & County Government Committee: DO PASS",9,0,0,0,9
1923128,1565437,2025-05-05,Senate,"Senate: THIRD READING",47,0,0,0,47
1923134,1493427,2025-02-19,Senate,"Senate: Public Safety Committee: DO PASS AMENDED",3,4,0,0,7
1923139,1488081,2025-02-12,House,"House: Children, Youth and Family Services Committee: DO PASS",5,0,0,0,5
1923139,1499716,2025-02-26,House,"House: Health and Human Services Oversight Committee: DO PASS",11,0,0,0,11
1923139,1514082,2025-03-11,House,"House: THIRD READING",88,3,0,8,99
1923139,1538308,2025-04-07,Senate,"Senate: Health & Human Services Committee: DO PASS",12,0,0,0,12
1923139,1565578,2025-05-06,Senate,"Senate: THIRD READING",38,8,0,1,47
1923143,1490772,2025-02-17,House,"House: Appropriations and Budget Natural Resources Subcommittee: DO PASS",10,0,0,0,10
1923143,1500662,2025-02-26,House,"House: Appropriations and Budget Committee: DO PASS",29,0,0,0,29
1923143,1504200,2025-03-04,House,"House: THIRD READING",92,1,0,6,99
1923143,1544364,2025-04-10,Senate,"Senate: Energy Committee: DO PASS",9,1,0,0,10
1923143,1563455,2025-05-01,Senate,"Senate: THIRD READING",46,0,0,1,47
1923143,1596105,2025-04-23,Senate,"Senate: Appropriations Committee: DO PASS AMENDED",22,0,0,0,22
1923152,1491468,2025-02-17,Senate,"Senate: Health & Human Services Committee: DO PASS",7,3,0,0,10
1923152,1525388,2025-03-24,Senate,"Senate: THIRD READING",41,6,0,0,47
1923152,1541342,2025-04-09,House,"House: Public Health Committee: DO PASS",4,2,0,0,6
1923152,1568139,2025-05-07,House,"House: THIRD READING",86,1,0,11,98
1923152,1596395,2025-04-21,House,"House: Health and Human Services Oversight Committee: DO PASS",13,0,0,0,13
1923157,1486248,2025-02-11,Senate,"Senate: Public Safety Committee: DO PASS",6,2,0,0,8
1923160,1493954,2025-02-19,Senate,"Senate: Education Committee: DO PASS",9,0,0,0,9
1923160,1529655,2025-03-27,Senate,"Senate: THIRD READING",47,0,0,0,47
1923160,1538262,2025-04-07,House,"House: Appropriations and Budget Education Subcommittee: DO PASS AS AMENDED BY CS",11,0,0,0,11
1923160,1548510,2025-04-15,House,"House: Appropriations and Budget Committee: DO PASS AS AMENDED, STRIKE THE TITLE",30,0,0,0,30
1923160,1559928,2025-04-29,House,"House: THIRD READING",83,0,0,15,98
1923160,1576757,2025-05-22,House,"House: FOURTH READING",80,0,0,18,98
1923160,1591528,2025-05-22,Senate,"Senate: FOURTH READING",46,0,0,2,48
1923169,1491457,2025-02-17,House,"House: Appropriations and Budget Human Services Subcommittee: DO PASS",5,0,0,0,5
1923169,1499639,2025-02-25,House,"House: Appropriations and Budget Committee: DO PASS",31,0,0,0,31
1923169,1515759,2025-03-12,House,"House: THIRD READING",79,4,0,16,99
1923169,1547454,2025-04-14,Senate,"Senate: Health & Human Services Committee: DO PASS",10,2,0,0,12
1923169,1554985,2025-04-22,Senate,"Senate: THIRD READING",41,3,0,3,47
1923171,1498091,2025-02-24,Senate,"Senate: Health & Human Services Committee: DO PASS AMENDED",12,0,0,0,12
1923171,1527617,2025-03-26,Senate,"Senate: THIRD READING",45,0,0,2,47
1923171,1541346,2025-04-09,House,"House: Public Health Committee: DO PASS",5,0,0,0,5
1923171,1563511,2025-05-01,House,"House: THIRD READING",76,8,0,14,98
1923171,1596379,2025-04-16,House,"House: Health and Human Services Oversight Committee: DO PASS",13,0,0,0,13
1923193,1494190,2025-02-19,House,"House: Children, Youth and Family Services Committee: DO PASS",4,2,0,0,6
1923193,1503628,2025-03-03,House,"House: Health and Human Services Oversight Committee: DO PASS",13,0,0,0,13
1923193,1526862,2025-03-25,House,"House: THIRD READING",71,18,0,10,99
1923193,1547507,2025-04-14,Senate,"Senate: Health & Human Services Committee: DO PASS AMENDED CS",11,0,0,0,11
1923193,1565651,2025-05-06,Senate,"Senate: THIRD READING",32,13,0,2,47
1923193,1571154,2025-05-14,House,"House: FOURTH READING",59,28,0,11,98
1923193,1571155,2025-05-14,House,"House: EMERGENCY",53,27,0,18,98
1923204,1490739,2025-02-17,House,"House: Appropriations and Budget Education Subcommittee: DO PASS",8,2,0,0,10
1923204,1506269,2025-03-05,House,"House: Appropriations and Budget Committee: DO PASS AS AMENDED BY CS",30,3,0,0,33
1923204,1519189,2025-03-17,House,"House: THIRD READING",58,27,0,14,99
1923204,1553519,2025-04-22,Senate,"Senate: Education Committee: DO PASS",10,0,0,0,10
1923204,1561847,2025-04-30,Senate,"Senate: THIRD READING",39,5,0,3,47
1923209,1498572,2025-02-25,Senate,"Senate: Education Committee: DO PASS",11,0,0,0,11
1923237,1497455,2025-02-24,Senate,"Senate: Aeronautics & Transportation Committee: DO PASS",12,0,0,0,12
1923238,1489237,2025-02-13,Senate,"Senate: Business & Insurance Committee: DO PASS AMENDED",9,1,0,0,10
1923238,1500201,2025-02-26,Senate,"Senate: THIRD READING",25,20,0,2,47
1923238,1542808,2025-04-09,House,"House: Alcohol, Tobacco and Controlled Substances Committee: DO PASS",9,0,0,0,9
1923238,1565268,2025-05-05,House,"House: THIRD READING",73,18,0,7,98
1923238,1591385,2025-05-21,Senate,"Senate: FOURTH READING",29,14,1,4,48
1923238,1596161,2025-04-16,House,"House: Health and Human Services Oversight Committee: DO PASS",13,0,0,0,13
1923238,1596162,2025-05-21,Senate,"Senate: RECONSIDER",36,9,0,3,48
1923240,1494941,2025-02-20,House,"House: Appropriations and Budget Finance Subcommittee: DO PASS",7,2,0,0,9
1923240,1505242,2025-03-04,House,"House: Appropriations and Budget Committee: DO PASS AS AMENDED, STRIKE THE TITLE",27,0,0,0,27
1923248,1495270,2025-02-20,House,"House: Civil Judiciary Committee: DO PASS",8,0,0,0,8
1923248,1504566,2025-03-04,House,"House: Judiciary and Public Safety Oversight Committee: DO PASS",13,0,0,0,13
1923248,1516872,2025-03-13,House,"House: THIRD READING",84,5,0,10,99
1923248,1548255,2025-04-15,Senate,"Senate: Judiciary Committee: DO PASS",6,0,0,0,6
1923248,1567462,2025-05-07,Senate,"Senate: THIRD READING",38,6,0,3,47
1923249,1493984,2025-02-19,House,"House: Banking, Financial Services and Pensions Committee: DO PASS",7,1,0,0,8
1923249,1501841,2025-02-27,House,"House: Government Oversight Committee: DO PASS",10,5,0,0,15
1923249,1529821,2025-03-27,House,"House: THIRD READING",81,13,0,5,99
1923249,1548328,2025-04-15,Senate,"Senate: Retirement & Government Resources Committee: DO PASS AMENDED CS",7,0,0,0,7
1923250,1486357,2025-02-11,House,"House: Criminal Judiciary Committee: DO PASS AS AMENDED BY CS",5,0,0,0,5
1923250,1507644,2025-03-06,House,"House: Judiciary and Public Safety Oversight Committee: DO PASS AS AMENDED BY CS",11,0,0,0,11
1923250,1529395,2025-03-27,House,"House: THIRD READING",87,0,0,12,99
1923250,1555226,2025-04-22,Senate,"Senate: Judiciary Committee: DO PASS AMENDED",8,0,0,0,8
1923250,1562192,2025-04-30,Senate,"Senate: THIRD READING",44,0,0,3,47
1923250,1574889,2025-05-21,House,"House: FOURTH READING",90,0,0,8,98
1923259,1480612,2025-02-05,House,"House: Energy Committee: DO PASS AS AMENDED BY CS",10,0,0,0,10
1923259,1505934,2025-03-05,House,"House: Energy and Natural Resources Oversight Committee: DO PASS AS AMENDED BY CS",12,1,0,0,13
1923259,1515978,2025-03-12,House,"House: THIRD READING",74,15,0,10,99
1923259,1544660,2025-04-10,Senate,"Senate: Energy Committee: DO PASS AMENDED",8,2,0,0,10
1923260,1498058,2025-02-24,House,"House: Public Health Committee: DO PASS AS AMENDED BY CS",6,0,0,0,6
1923260,1503653,2025-03-03,House,"House: Health and Human Services Oversight Committee: DO PASS AS AMENDED BY CS",11,0,0,0,11
1923260,1526596,2025-03-25,House,"House: THIRD READING",92,0,0,7,99
1923260,1553524,2025-04-21,Senate,"Senate: Health & Human Services Committee: DO PASS",11,0,0,0,11
1923260,1567259,2025-05-07,Senate,"Senate: THIRD READING",42,2,0,3,47
1923262,1494943,2025-02-20,House,"House: Appropriations and Budget Finance Subcommittee: DO PASS AS AMENDED BY CS",9,0,0,0,9
1923262,1505129,2025-03-04,House,"House: Appropriations and Budget Committee: DO PASS AS AMENDED BY CS",31,0,0,0,31
1923262,1514398,2025-03-11,House,"House: THIRD READING",58,25,0,16,99
1923271,1507090,2025-03-06,Senate,"Senate: Business & Insurance Committee: DO PASS",9,0,0,0,9
1923277,1499540,2025-02-25,House,"House: Rules Committee: DO PASS AS AMENDED BY CS",10,0,0,0,10
1923277,1526057,2025-03-25,House,"House: THIRD READING",85,8,0,6,99
1923277,1552610,2025-04-21,Senate,"Senate: Aeronautics & Transportation Committee: DO PASS",9,0,0,0,9
1923277,1564126,2025-05-01,Senate,"Senate: THIRD READING",36,0,0,11,47
1923277,1580963,2025-05-29,House,"House: VETO OVERRIDE WITH EMERGENCY",81,10,0,7,98
1923277,1581964,2025-05-29,Senate,"Senate: VETO OVERRIDE WITH EMERGENCY",45,0,0,3,48
1923290,1503360,2025-03-03,Senate,"Senate: Aeronautics & Transportation Committee: DO PASS AMENDED",10,0,0,0,10
1923290,1529012,2025-03-27,Senate,"Senate: THIRD READING",38,9,0,0,47
1923290,1544040,2025-04-10,House,"House: Transportation Committee: DO PASS",11,0,0,0,11
1923290,1554589,2025-04-22,House,"House: Commerce and Economic Development Oversight Committee: DO PASS AS AMENDED BY CS",17,0,0,0,17
1923290,1560041,2025-04-29,House,"House: THIRD READING",86,0,0,12,98
1923290,1591360,2025-05-13,Senate,"Senate: FOURTH READING",42,2,0,3,47
1923291,1504434,2025-03-04,Senate,"Senate: Judiciary Committee: DO PASS AMENDED CS",7,2,0,0,9
1923291,1520136,2025-03-18,Senate,"Senate: THIRD READING",36,8,0,3,47
1923291,1538473,2025-04-07,House,"House: Elections and Ethics Committee: DO PASS AS AMENDED BY CS",6,1,0,0,7
1923291,1567066,2025-05-07,House,"House: TABLE",53,17,0,28,98
1923291,1567067,2025-05-07,House,"House: THIRD READING",69,23,0,6,98
1923291,1567068,2025-05-07,House,"House: EMERGENCY",70,21,0,7,98
1923291,1591308,2025-05-21,Senate,"Senate: FOURTH READING",39,7,0,2,48
1923291,1596157,2025-03-18,Senate,"Senate: TABLE",35,8,0,4,47
1923291,1596158,2025-04-15,House,"House: Government Oversight Committee: DO PASS AS AMENDED BY CS",14,4,0,0,18
1923298,1498361,2025-02-24,House,"House: Business Committee: DO PASS AS AMENDED BY CS",8,0,0,0,8
1923298,1501040,2025-02-27,House,"House: Commerce and Economic Development Oversight Committee: DO PASS AS AMENDED BY CS",15,1,0,0,16
1923298,1528468,2025-03-26,House,"House: THIRD READING",81,12,0,6,99
1923298,1548973,2025-04-15,Senate,"Senate: Economic Development, Workforce & Tourism Committee: DO PASS",9,0,0,0,9
1923298,1565045,2025-05-05,Senate,"Senate: THIRD READING",29,16,0,2,47
1923301,1507081,2025-03-06,House,"House: Rules Committee: DO PASS AS AMENDED BY CS",8,0,0,0,8
1923301,1527013,2025-03-25,House,"House: THIRD READING",88,0,0,11,99
1923301,1540249,2025-04-08,Senate,"Senate: Judiciary Committee: DO PASS",6,0,0,0,6
1923301,1562160,2025-04-30,Senate,"Senate: THIRD READING",44,0,0,3,47
1923303,1487569,2025-02-12,House,"House: County and Municipal Government Committee: DO PASS AS AMENDED BY CS",6,0,0,0,6
1923303,1501113,2025-02-27,House,"House: Government Oversight Committee: DO PASS AS AMENDED BY CS",12,3,0,0,15
1923303,1527580,2025-03-25,House,"House: ,                    THIRD READING",78,11,0,10,99
1923303,1549474,2025-04-15,Senate,"Senate: Judiciary Committee: DO PASS",7,0,0,0,7
1923303,1565617,2025-05-06,Senate,"Senate: THIRD READING",41,5,0,1,47
1923303,1572301,2025-05-15,House,"House: FOURTH READING",69,14,0,15,98
1923303,1596107,2025-03-25,House,"House: THIRD READING",78,11,0,10,99
1923306,1499766,2025-02-25,Senate,"Senate: Judiciary Committee: DO PASS",7,0,0,0,7
1923306,1516604,2025-03-12,Senate,"Senate: THIRD READING",43,0,0,4,47
1923306,1541144,2025-04-08,House,"House: Criminal Judiciary Committee: DO PASS",3,0,0,0,3
1923306,1563743,2025-05-01,House,"House: THIRD READING",82,0,0,16,98
1923306,1596422,2025-04-17,House,"House: Judiciary and Public Safety Oversight Committee: DO PASS",12,0,0,0,12
1923307,1495119,2025-02-20,House,"House: Transportation Committee: DO PASS AS AMENDED BY CS",9,3,0,0,12
1923307,1507603,2025-03-06,House,"House: Commerce and Economic Development Oversight Committee: DO PASS AS AMENDED BY CS",18,0,0,0,18
1923322,1484544,2025-02-10,Senate,"Senate: Aeronautics & Transportation Committee: DO PASS",12,0,0,0,12
1923326,1489314,2025-02-13,House,"House: Appropriations and Budget Finance Subcommittee: DO PASS",7,0,0,0,7
1923326,1500525,2025-02-26,House,"House: Appropriations and Budget Committee: DO PASS",29,0,0,0,29
1923326,1504170,2025-03-04,House,"House: THIRD READING",91,4,0,4,99
1923326,1548982,2025-04-15,Senate,"Senate: Local & County Government Committee: DO PASS",7,2,0,0,9
1923326,1565123,2025-05-05,Senate,"Senate: THIRD READING",33,12,0,2,47
1923326,1596106,2025-04-21,Senate,"Senate: Revenue & Taxation Committee: DO PASS",11,0,0,0,11
1923338,1494720,2025-02-20,Senate,"Senate: Business & Insurance Committee: DO PASS",10,0,0,0,10
1923338,1511902,2025-03-10,Senate,"Senate: THIRD READING",45,0,0,2,47
1923338,1539137,2025-04-07,House,"House: Tourism Committee: DO PASS",4,0,0,0,4
1923338,1596428,2025-04-17,House,"House: Commerce and Economic Development Oversight Committee: DO PASS",16,0,0,0,16
1923352,1498068,2025-02-24,House,"House: Public Health Committee: DO PASS",6,0,0,0,6
1923352,1506270,2025-03-05,House,"House: Health and Human Services Oversight Committee: DO PASS",14,0,0,0,14
1923352,1528133,2025-03-26,House,"House: THIRD READING",90,1,0,8,99
1923352,1547595,2025-04-14,Senate,"Senate: Health & Human Services Committee: DO PASS AMENDED",10,1,0,0,11
1923352,1565137,2025-05-05,Senate,"Senate: THIRD READING",41,4,0,2,47
1923353,1482599,2025-02-05,House,"House: Common Education Committee: DO PASS",8,5,0,0,13
1923354,1497597,2025-02-24,House,"House: General Government Committee: DO PASS AS AMENDED BY CS",5,1,0,0,6
1923354,1507402,2025-03-06,House,"House: Government Oversight Committee: DO PASS AS AMENDED BY CS",13,3,0,0,16
1923359,1498884,2025-02-25,Senate,"Senate: Retirement & Government Resources Committee: DO PASS AMENDED CS",5,3,0,0,8
1923367,1485519,2025-02-10,House,"House: Appropriations and Budget Human Services Subcommittee: DO PASS",5,0,0,0,5
1923367,1500265,2025-02-26,House,"House: Appropriations and Budget Committee: DO PASS AS AMENDED, STRIKE THE TITLE",28,0,0,0,28
1923367,1516302,2025-03-12,House,"House: THIRD READING",76,7,0,16,99
1923367,1547559,2025-04-14,Senate,"Senate: Health & Human Services Committee: DO PASS AMENDED",11,0,0,0,11
1923367,1596109,2025-04-23,Senate,"Senate: Appropriations Committee: DO PASS",23,0,0,0,23
1923372,1505076,2025-03-04,Senate,"Senate: Education Committee: DO PASS AMENDED",11,0,0,0,11
1923372,1528089,2025-03-26,Senate,"Senate: THIRD READING",47,0,0,0,47
1923372,1556386,2025-04-24,House,"House: Rules Committee: DO PASS",8,1,0,0,9
1923372,1568270,2025-05-08,House,"House: ADOPT AMENDMENT",40,45,0,13,98
1923372,1568271,2025-05-08,House,"House: THIRD READING",54,28,0,16,98
1923373,1498130,2025-02-24,House,"House: General Government Committee: DO PASS",5,1,0,0,6
1923376,1486234,2025-02-11,Senate,"Senate: Public Safety Committee: DO PASS",9,0,0,0,9
1923376,1516085,2025-03-12,Senate,"Senate: THIRD READING",45,0,0,2,47
1923376,1541276,2025-04-09,House,"House: Public Safety Committee: DO PASS",7,0,0,0,7
1923376,1567829,2025-05-07,House,"House: THIRD READING",89,0,0,9,98
1923376,1591720,2025-05-20,Senate,"Senate: FOURTH READING",44,0,0,3,47
1923376,1596408,2025-04-17,House,"House: Judiciary and Public Safety Oversight Committee: DO PASS",12,0,0,0,12
1923377,1482187,2025-02-05,House,"House: Public Health Committee: DO PASS",6,0,0,0,6
1923377,1499719,2025-02-26,House,"House: Health and Human Services Oversight Committee: DO PASS",11,0,0,0,11
1923377,1509637,2025-03-10,House,"House: THIRD READING",86,7,0,6,99
1923377,1553063,2025-04-21,Senate,"Senate: Health & Human Services Committee: DO PASS AMENDED",10,0,0,0,10
1923383,1497941,2025-02-24,House,"House: Agriculture Committee: DO PASS",6,0,0,0,6
1923383,1503668,2025-03-03,House,"House: Energy and Natural Resources Oversight Committee: DO PASS",13,0,0,0,13
1923383,1514138,2025-03-11,House,"House: THIRD READING",91,3,0,5,99
1923384,1486407,2025-02-11,House,"House: Utilities Committee: DO PASS AS AMENDED BY CS",6,0,0,0,6
1923384,1499731,2025-02-26,House,"House: Energy and Natural Resources Oversight Committee: DO PASS AS AMENDED BY CS",14,0,0,0,14
1923384,1516710,2025-03-12,House,"House: THIRD READING",77,9,0,13,99
1923384,1557335,2025-04-24,Senate,"Senate: Energy Committee: DO PASS AMENDED",9,1,0,0,10
1923384,1568413,2025-05-08,Senate,"Senate: THIRD READING",41,3,0,3,47
1923392,1486399,2025-02-11,Senate,"Senate: Retirement & Insurance Committee: DO PASS AMENDED",8,0,0,0,8
1923392,1529732,2025-03-27,Senate,"Senate: THIRD READING",29,17,0,1,47
1923392,1543552,2025-04-10,House,"House: Civil Judiciary Committee: DO PASS",6,2,0,0,8
1923392,1567354,2025-05-07,House,"House: THIRD READING",69,17,0,12,98
1923392,1596160,2025-04-22,House,"House: Judiciary and Public Safety Oversight Committee: DO PASS",7,1,0,0,8
1923401,1484743,2025-02-10,House,"House: Appropriations and Budget Human Services Subcommittee: DO PASS",5,0,0,0,5
1923401,1500506,2025-02-26,House,"House: Appropriations and Budget Committee: DO PASS",27,0,0,0,27
1923401,1527914,2025-03-26,House,"House: THIRD READING",87,3,0,9,99
1923404,1506386,2025-03-04,House,"House: Appropriations and Budget Committee: DO PASS AS AMENDED BY CS",29,0,0,0,29
1923404,1516081,2025-03-12,House,"House: THIRD READING",74,7,0,18,99
1923404,1540312,2025-04-08,Senate,"Senate: Judiciary Committee: DO PASS AMENDED",7,0,0,0,7
1923404,1596108,2025-04-16,Senate,"Senate: Appropriations Committee: DO PASS",22,0,0,0,22
1923409,1494663,2025-02-20,Senate,"Senate: Business & Insurance Committee: DO PASS",10,0,0,0,10
1923409,1516032,2025-03-12,Senate,"Senate: THIRD READING",44,0,0,3,47
1923409,1540772,2025-04-08,House,"House: Insurance Committee: DO PASS",6,0,0,0,6
1923409,1563685,2025-05-01,House,"House: THIRD READING",85,0,0,13,98
1923409,1596156,2025-04-15,House,"House: Commerce and Economic Development Oversight Committee: DO PASS",18,0,0,0,18
1923419,1499473,2025-02-25,Senate,"Senate: Economic Development, Workforce & Tourism Committee: DO PASS",9,0,0,0,9
1923419,1525353,2025-03-24,Senate,"Senate: THIRD READING",46,0,0,1,47
1923419,1539146,2025-04-07,House,"House: Appropriations and Budget Select Agencies Subcommittee: DO PASS",6,0,0,0,6
1923419,1566096,2025-05-06,House,"House: THIRD READING",91,0,0,7,98
1923419,1596405,2025-04-15,House,"House: Appropriations and Budget Committee: DO PASS",27,1,0,0,28
1923428,1480293,2025-02-04,House,"House: Utilities Committee: DO PASS",8,0,0,0,8
1923428,1499723,2025-02-26,House,"House: Energy and Natural Resources Oversight Committee: DO PASS",15,0,0,0,15
1923428,1516679,2025-03-12,House,"House: THIRD READING",87,0,0,12,99
1923430,1499560,2025-02-25,Senate,"Senate: Public Safety Committee: DO PASS",5,3,0,0,8
1923436,1491121,2025-02-17,House,"House: Appropriations and Budget Education Subcommittee: DO PASS",8,2,0,0,10
1923436,1506792,2025-03-05,House,"House: Appropriations and Budget Committee: DO PASS",28,3,0,0,31
1923436,1527175,2025-03-25,House,"House: THIRD READING",51,43,0,5,99
1923441,1507115,2025-03-06,Senate,"Senate: Business & Insurance Committee: DO PASS AMENDED",10,0,0,0,10
1923448,1486097,2025-02-11,House,"House: Agriculture Committee: DO PASS AS AMENDED BY CS",7,1,0,0,8
1923448,1506273,2025-03-05,House,"House: Energy and Natural Resources Oversight Committee: DO PASS AS AMENDED BY CS",13,1,0,0,14
1923448,1517338,2025-03-13,House,"House: THIRD READING",44,40,0,15,99
1923448,1518654,2025-03-17,House,"House: RECONSIDER MEASURE",56,28,0,15,99
1923448,1538358,2025-04-07,Senate,"Senate: Agriculture & Wildlife Committee: DO PASS",12,0,0,0,12
1923448,1562246,2025-04-30,Senate,"Senate: THIRD READING",35,8,0,4,47
1923448,1596121,2025-04-16,Senate,"Senate: Appropriations Committee: DO PASS AMENDED",22,0,0,0,22
1923453,1489349,2025-02-13,House,"House: Civil Judiciary Committee: DO PASS",8,0,0,0,8
1923453,1504329,2025-03-04,House,"House: Judiciary and Public Safety Oversight Committee: DO PASS AS AMENDED BY CS",13,0,0,0,13
1923453,1528374,2025-03-26,House,"House: THIRD READING",83,6,0,10,99
1923453,1556605,2025-04-24,Senate,"Senate: Business & Insurance Committee: DO PASS AMENDED CS",9,0,0,0,9
1923453,1566072,2025-05-06,Senate,"Senate: THIRD READING",43,2,0,2,47
1923455,1497660,2025-02-24,House,"House: Insurance Committee: DO PASS",5,2,0,0,7
1923455,1507634,2025-03-06,House,"House: Commerce and Economic Development Oversight Committee: DO PASS",10,4,0,0,14
1923455,1525586,2025-03-24,House,"House: THIRD READING",72,20,0,7,99
1923455,1543504,2025-04-10,Senate,"Senate: Business & Insurance Committee: DO PASS",8,1,0,0,9
1923455,1567915,2025-05-07,Senate,"Senate: THIRD READING",30,16,0,1,47
1923455,1576214,2025-05-22,House,"House: FOURTH READING",76,0,0,22,98
1923455,1596111,2025-04-23,Senate,"Senate: Appropriations Committee: DO PASS AMENDED CS",19,3,0,0,22
1923459,1497632,2025-02-24,House,"House: Insurance Committee: DO PASS AS AMENDED BY CS",7,0,0,0,7
1923459,1507116,2025-03-06,House,"House: Commerce and Economic Development Oversight Committee: DO PASS AS AMENDED BY CS",16,0,0,0,16
1923459,1527965,2025-03-26,House,"House: THIRD READING",92,1,0,6,99
1923459,1551412,2025-04-17,Senate,"Senate: Business & Insurance Committee: DO PASS AMENDED CS",8,0,0,0,8
1923468,1487026,2025-02-11,Senate,"Senate: General Government Committee: DO PASS AMENDED",9,0,0,0,9
1923478,1497665,2025-02-24,House,"House: Public Safety Committee: DO PASS",6,0,0,0,6
1923478,1501409,2025-02-27,House,"House: Judiciary and Public Safety Oversight Committee: DO PASS",10,0,0,0,10
1923478,1514145,2025-03-11,House,"House: THIRD READING",87,0,0,12,99
1923478,1547084,2025-04-14,Senate,"Senate: Aeronautics & Transportation Committee: DO PASS AMENDED",8,0,0,0,8
1923478,1564038,2025-05-01,Senate,"Senate: THIRD READING",45,0,0,2,47
1923478,1572161,2025-05-15,House,"House: FOURTH READING",81,1,0,16,98
1923491,1491252,2025-02-17,Senate,"Senate: Agriculture & Wildlife Committee: DO PASS",12,0,0,0,12
1923496,1488970,2025-02-13,Senate,"Senate: Business & Insurance Committee: DO PASS",8,2,0,0,10
1923496,1527361,2025-03-26,Senate,"Senate: THIRD READING",36,10,0,1,47
1923496,1542277,2025-04-09,House,"House: Alcohol, Tobacco and Controlled Substances Committee: DO PASS AS AMENDED BY CS",6,2,0,0,8
1923496,1568175,2025-05-08,House,"House: THIRD READING",64,27,0,7,98
1923496,1580039,2025-05-28,House,"House: FOURTH READING",68,22,0,8,98
1923496,1591835,2025-05-28,Senate,"Senate: FOURTH READING",37,10,0,1,48
1923496,1596164,2025-04-21,House,"House: Health and Human Services Oversight Committee: DO PASS AS AMENDED BY CS",10,3,0,0,13
1923504,1487126,2025-02-11,Senate,"Senate: Judiciary Committee: DO PASS",8,0,0,0,8
1923504,1528109,2025-03-26,Senate,"Senate: THIRD READING",38,6,1,2,47
1923504,1538666,2025-04-03,House,"House: Civil Judiciary Committee: DO PASS",10,0,0,0,10
1923510,1483337,2025-02-06,House,"House: Civil Judiciary Committee: DO PASS AS AMENDED BY CS",8,0,0,0,8
1923510,1499518,2025-02-25,House,"House: Judiciary and Public Safety Oversight Committee: DO PASS AS AMENDED BY CS",9,0,0,0,9
1923510,1503156,2025-03-03,House,"House: THIRD READING",79,19,0,1,99
1923510,1539722,2025-04-08,Senate,"Senate: Judiciary Committee: DO PASS AMENDED",7,0,0,0,7
1923510,1562206,2025-04-30,Senate,"Senate: THIRD READING",39,3,0,5,47
1923510,1571213,2025-05-14,House,"House: FOURTH READING",60,23,0,15,98
1923515,1482789,2025-02-05,House,"House: Common Education Committee: DO PASS",12,0,0,0,12
1923515,1499742,2025-02-26,House,"House: Education Oversight Committee: DO PASS",10,0,0,0,10
1923515,1513756,2025-03-11,House,"House: THIRD READING",84,0,0,15,99
1923515,1551685,2025-04-17,Senate,"Senate: Technology & Telecommunications Committee: DO PASS",8,0,0,0,8
1923515,1562084,2025-04-30,Senate,"Senate: THIRD READING",44,0,0,3,47
1923519,1487034,2025-02-11,House,"House: Criminal Judiciary Committee: DO PASS",4,1,0,0,5
1923519,1501314,2025-02-27,House,"House: Judiciary and Public Safety Oversight Committee: DO PASS",10,0,0,0,10
1923519,1515770,2025-03-12,House,"House: THIRD READING",71,17,0,11,99
1923519,1555294,2025-04-22,Senate,"Senate: Judiciary Committee: DO PASS",7,1,0,0,8
1923519,1562432,2025-04-30,Senate,"Senate: THIRD READING",42,2,0,3,47
1923526,1501333,2025-02-27,Senate,"Senate: Business & Insurance Committee: DO PASS",10,0,0,0,10
1923526,1516871,2025-03-13,Senate,"Senate: THIRD READING",44,0,0,3,47
1923526,1542090,2025-04-09,House,"House: Alcohol, Tobacco and Controlled Substances Committee: DO PASS",7,0,0,0,7
1923526,1552522,2025-04-21,House,"House: Health and Human Services Oversight Committee: DO PASS AS AMENDED BY CS",8,5,0,0,13
1923526,1567788,2025-05-07,House,"House: THIRD READING",60,28,0,10,98
1923526,1591548,2025-05-15,Senate,"Senate: FOURTH READING",37,5,0,5,47
1923527,1498063,2025-02-24,House,"House: Public Health Committee: DO PASS AS AMENDED BY CS",4,2,0,0,6
1923529,1499101,2025-02-25,House,"House: Appropriations and Budget Committee: DO PASS AS AMENDED BY CS",31,0,0,0,31
1923529,1507280,2025-03-06,House,"House: THIRD READING",71,20,1,7,99
1923529,1539919,2025-04-08,Senate,"Senate: Education Committee: DO PASS AMENDED",11,0,0,0,11
1923529,1568188,2025-05-08,Senate,"Senate: THIRD READING",38,5,0,4,47
1923529,1579673,2025-05-28,House,"House: FOURTH READING",60,27,2,9,98
1923529,1579674,2025-05-28,House,"House: EMERGENCY",69,20,0,9,98
1923529,1591330,2025-05-28,Senate,"Senate: FOURTH READING",35,10,0,3,48
1923529,1596112,2025-04-23,Senate,"Senate: Appropriations Committee: DO PASS AMENDED CS",24,1,0,0,25
1923533,1487003,2025-02-11,Senate,"Senate: General Government Committee: DO PASS",7,2,0,0,9
1923536,1494733,2025-02-20,Senate,"Senate: Business & Insurance Committee: DO PASS AMENDED CS",10,0,0,0,10
1923536,1526139,2025-03-25,Senate,"Senate: THIRD READING",45,0,0,2,47
1923536,1541528,2025-04-09,House,"House: Public Health Committee: DO PASS",6,0,0,0,6
1923536,1547608,2025-04-14,House,"House: Health and Human Services Oversight Committee: DO PASS AS AMENDED BY CS",13,0,0,0,13
1923536,1567269,2025-05-07,House,"House: THIRD READING",89,0,0,9,98
1923536,1591715,2025-05-14,Senate,"Senate: FOURTH READING",40,0,0,7,47
1923542,1503326,2025-03-03,Senate,"Senate: Health & Human Services Committee: DO PASS AMENDED CS",12,0,0,0,12
1923542,1512515,2025-03-11,Senate,"Senate: THIRD READING",44,0,0,3,47
1923542,1544013,2025-04-10,House,"House: Civil Judiciary Committee: DO PASS",8,0,0,0,8
1923542,1565217,2025-05-05,House,"House: THIRD READING",81,8,0,9,98
1923542,1596417,2025-04-17,House,"House: Judiciary and Public Safety Oversight Committee: DO PASS",9,0,0,0,9
1923554,1491241,2025-02-17,House,"House: Appropriations and Budget Transportation Subcommittee: DO PASS",7,0,0,0,7
1923554,1507250,2025-03-05,House,"House: Appropriations and Budget Committee: DO PASS",33,0,0,0,33
1923554,1519065,2025-03-17,House,"House: THIRD READING",84,0,0,15,99
1923554,1538265,2025-04-07,Senate,"Senate: Aeronautics & Transportation Committee: DO PASS AMENDED",11,0,0,0,11
1923554,1567500,2025-05-07,Senate,"Senate: THIRD READING",46,0,0,1,47
1923554,1596117,2025-04-23,Senate,"Senate: Appropriations Committee: DO PASS",21,0,0,0,21
1923558,1497879,2025-02-24,Senate,"Senate: Agriculture & Wildlife Committee: DO PASS AMENDED CS",11,1,0,0,12
1923563,1499244,2025-02-25,Senate,"Senate: Retirement & Government Resources Committee: DO PASS",6,2,0,0,8
1923563,1525473,2025-03-24,Senate,"Senate: THIRD READING",37,9,0,1,47
1923563,1538349,2025-04-07,House,"House: Appropriations and Budget General Government Subcommittee: DO PASS",6,1,0,0,7
1923573,1498185,2025-02-24,House,"House: Public Health Committee: DO PASS AS AMENDED BY CS",6,0,0,0,6
1923573,1506544,2025-03-05,House,"House: Health and Human Services Oversight Committee: DO PASS AS AMENDED BY CS",13,0,0,0,13
1923573,1517095,2025-03-13,House,"House: THIRD READING",79,0,0,20,99
1923573,1547319,2025-04-14,Senate,"Senate: Health & Human Services Committee: DO PASS",10,1,0,0,11
1923573,1559101,2025-04-28,Senate,"Senate: THIRD READING",44,0,0,3,47
1923578,1497577,2025-02-24,House,"House: Public Health Committee: DO PASS AS AMENDED BY CS",8,0,0,0,8
1923578,1500500,2025-02-26,House,"House: Health and Human Services Oversight Committee: DO PASS AS AMENDED BY CS",12,0,0,0,12
1923578,1527693,2025-03-26,House,"House: THIRD READING",92,0,0,7,99
1923581,1497500,2025-02-24,House,"House: General Government Committee: DO PASS",6,0,0,0,6
1923581,1507616,2025-03-06,House,"House: Government Oversight Committee: DO PASS",16,0,0,0,16
1923581,1528333,2025-03-26,House,"House: THIRD READING",89,1,0,9,99
1923585,1485243,2025-02-10,House,"House: Appropriations and Budget Education Subcommittee: DO PASS",7,2,0,0,9
1923587,1482522,2025-02-05,House,"House: Public Safety Committee: DO PASS AS AMENDED BY CS",6,0,0,0,6
1923587,1507629,2025-03-06,House,"House: Judiciary and Public Safety Oversight Committee: DO PASS AS AMENDED BY CS",10,1,0,0,11
1923587,1526837,2025-03-25,House,"House: THIRD READING",67,15,0,17,99
1923599,1490977,2025-02-17,House,"House: Wildlife Committee: DO PASS",6,0,0,0,6
1923601,1494642,2025-02-20,Senate,"Senate: Business & Insurance Committee: DO PASS AMENDED CS",10,0,0,0,10
1923602,1489246,2025-02-13,Senate,"Senate: Administrative Rules Committee: DO PASS",7,2,0,0,9
1923602,1527518,2025-03-26,Senate,"Senate: THIRD READING",39,8,0,0,47
1923602,1539838,2025-04-08,House,"House: Administrative Rules Committee: DO PASS AS AMENDED BY CS",11,2,0,0,13
1923602,1567384,2025-05-07,House,"House: THIRD READING",73,14,0,11,98
1923602,1591307,2025-05-15,Senate,"Senate: FOURTH READING",34,8,0,5,47
1923610,1495984,2025-02-20,House,"House: Appropriations and Budget Finance Subcommittee: DO PASS",9,0,0,0,9
1923610,1505338,2025-03-04,House,"House: Appropriations and Budget Committee: DO PASS AS AMENDED, STRIKE THE TITLE",31,0,0,0,31
1923610,1514360,2025-03-11,House,"House: THIRD READING",92,0,0,7,99
1923614,1497952,2025-02-24,House,"House: Insurance Committee: DO PASS",7,0,0,0,7
1923614,1507374,2025-03-06,House,"House: Commerce and Economic Development Oversight Committee: DO PASS",15,0,0,0,15
1923614,1517613,2025-03-13,House,"House: THIRD READING",82,0,0,17,99
1923614,1544202,2025-04-10,Senate,"Senate: Business & Insurance Committee: DO PASS",9,0,0,0,9
1923614,1565654,2025-05-06,Senate,"Senate: THIRD READING",44,0,0,3,47
1923615,1485943,2025-02-11,House,"House: General Government Committee: DO PASS",7,0,0,0,7
1923615,1504642,2025-03-04,House,"House: Government Oversight Committee: DO PASS AS AMENDED BY CS",7,6,0,0,13
1923624,1487566,2025-02-12,House,"House: County and Municipal Government Committee: DO PASS",6,0,0,0,6
1923624,1501123,2025-02-27,House,"House: Government Oversight Committee: DO PASS",13,1,0,0,14
1923624,1519011,2025-03-17,House,"House: THIRD READING",69,11,1,18,99
1923630,1499432,2025-02-25,Senate,"Senate: Judiciary Committee: DO PASS AMENDED CS",8,0,0,0,8
1923630,1515913,2025-03-12,Senate,"Senate: THIRD READING",42,0,0,5,47
1923630,1540068,2025-04-08,House,"House: Banking, Financial Services and Pensions Committee: DO PASS AS AMENDED BY CS",8,0,0,0,8
1923630,1562625,2025-04-30,House,"House: THIRD READING",85,0,0,13,98
1923630,1591634,2025-05-20,Senate,"Senate: FOURTH READING",42,0,0,5,47
1923630,1596426,2025-04-17,House,"House: Government Oversight Committee: DO PASS AS AMENDED BY CS",14,0,0,0,14
1923635,1504628,2025-03-04,Senate,"Senate: Judiciary Committee: DO PASS AMENDED",7,1,0,0,8
1923635,1529339,2025-03-27,Senate,"Senate: THIRD READING",31,15,0,1,47
1923646,1497891,2025-02-24,House,"House: Public Health Committee: DO PASS AS AMENDED BY CS",6,1,0,0,7
1923646,1505944,2025-03-05,House,"House: Health and Human Services Oversight Committee: DO PASS AS AMENDED BY CS",13,1,0,0,14
1923646,1517409,2025-03-13,House,"House: THIRD READING",60,24,0,15,99
1923648,1493521,2025-02-19,Senate,"Senate: Public Safety Committee: DO PASS AMENDED",5,3,0,0,8
1923653,1493495,2025-02-19,Senate,"Senate: Retirement & Government Resources Committee: DO PASS AMENDED CS",6,2,0,0,8
1923656,1498064,2025-02-24,Senate,"Senate: Health & Human Services Committee: DO PASS",9,4,0,0,13
1923657,1491099,2025-02-17,Senate,"Senate: Revenue & Taxation Committee: DO PASS AMENDED CS",9,2,0,0,11
1923657,1516218,2025-03-12,Senate,"Senate: THIRD READING",44,0,0,3,47
1923657,1542315,2025-04-09,House,"House: County and Municipal Government Committee: DO PASS",5,0,0,0,5
1923657,1562043,2025-04-30,House,"House: THIRD READING",90,0,0,8,98
1923657,1596419,2025-04-22,House,"House: Government Oversight Committee: DO PASS",16,0,0,0,16
1923658,1482458,2025-02-05,House,"House: Public Health Committee: DO PASS",6,0,0,0,6
1923658,1500297,2025-02-26,House,"House: Health and Human Services Oversight Committee: DO PASS",11,0,0,0,11
1923658,1528703,2025-03-27,House,"House: THIRD READING",84,3,0,12,99
1923658,1553050,2025-04-21,Senate,"Senate: Health & Human Services Committee: DO PASS AMENDED CS",10,0,0,0,10
1923658,1567883,2025-05-07,Senate,"Senate: THIRD READING",46,0,0,1,47
1923658,1571963,2025-05-15,House,"House: FOURTH READING",78,3,0,17,98
1923664,1488678,2025-02-12,House,"House: Appropriations and Budget Committee: DO PASS AS AMENDED BY CS",28,0,0,0,28
1923664,1500572,2025-02-26,House,"House: THIRD READING",88,3,0,8,99
1923664,1538107,2025-04-07,Senate,"Senate: Agriculture & Wildlife Committee: DO PASS",12,0,0,0,12
1923664,1568211,2025-05-08,Senate,"Senate: THIRD READING",42,0,0,5,47
1923664,1596113,2025-04-23,Senate,"Senate: ADOPT",23,0,0,0,23
1923664,1596114,2025-04-23,Senate,"Senate: Appropriations Committee: DO PASS AMENDED",23,0,0,0,23
1923673,1507573,2025-03-06,Senate,"Senate: Energy Committee: DO PASS AMENDED CS",11,0,0,0,11
1923673,1516975,2025-03-13,Senate,"Senate: THIRD READING",43,3,0,1,47
1923673,1534582,2025-04-02,House,"House: Energy Committee: DO PASS AS AMENDED BY CS",9,2,0,0,11
1923673,1555359,2025-04-23,House,"House: Energy and Natural Resources Oversight Committee: DO PASS AS AMENDED, STRIKE THE TITLE",12,3,0,0,15
1923673,1564973,2025-05-05,House,"House: THIRD READING",78,13,0,7,98
1923673,1581226,2025-05-29,Senate,"Senate: VETO OVERRIDE WITH EMERGENCY",40,7,0,1,48
1923673,1591681,2025-05-20,Senate,"Senate: FOURTH READING",40,5,0,2,47
1923674,1503182,2025-03-03,Senate,"Senate: Health & Human Services Committee: DO PASS",5,7,0,0,12
1923682,1489225,2025-02-13,House,"House: Appropriations and Budget Finance Subcommittee: DO PASS AS AMENDED BY CS",5,2,0,0,7
1923682,1500323,2025-02-26,House,"House: Appropriations and Budget Committee: DO PASS AS AMENDED BY CS",30,0,0,0,30
1923682,1516690,2025-03-12,House,"House: THIRD READING",63,19,0,17,99
1923682,1540400,2025-04-08,Senate,"Senate: Economic Development, Workforce & Tourism Committee: DO PASS AMENDED",8,0,0,0,8
1923682,1596118,2025-04-23,Senate,"Senate: Appropriations Committee: DO PASS",21,2,0,0,23
1923686,1493355,2025-02-19,Senate,"Senate: Education Committee: DO PASS AMENDED CS",7,3,0,0,10
1923686,1525937,2025-03-25,Senate,"Senate: THIRD READING",31,15,0,1,47
1923686,1539486,2025-04-08,House,"House: Postsecondary Education Committee: DO PASS",5,0,0,0,5
1923686,1562349,2025-04-30,House,"House: THIRD READING",56,29,0,13,98
1923686,1562350,2025-04-30,House,"House: EMERGENCY",45,38,0,15,98
1923686,1596415,2025-04-16,House,"House: Education Oversight Committee: DO PASS",9,0,0,0,9
1923704,1505201,2025-03-04,House,"House: Rules Committee: DO PASS AS AMENDED, STRIKE THE T ITLE",8,2,0,0,10
1923704,1505629,2025-03-04,House,"House: Rules Committee: DO PASS AS AMENDED BY CS",8,2,0,0,10
1923704,1525556,2025-03-24,House,"House: THIRD READING",75,18,0,6,99
1923711,1494149,2025-02-19,House,"House: Criminal Judiciary Committee: DO PASS",5,0,0,0,5
1923711,1505024,2025-03-04,House,"House: Judiciary and Public Safety Oversight Committee: DO PASS",12,2,0,0,14
1923711,1516095,2025-03-12,House,"House: THIRD READING",69,14,0,16,99
1923711,1553814,2025-04-22,Senate,"Senate: Judiciary Committee: DO PASS",6,2,0,0,8
1923711,1564086,2025-05-01,Senate,"Senate: THIRD READING",39,7,0,1,47
1923716,1505894,2025-03-05,House,"House: Rules Committee: DO PASS",10,0,0,0,10
1923726,1497614,2025-02-24,House,"House: Public Health Committee: DO PASS",6,0,0,0,6
1923726,1505973,2025-03-05,House,"House: Health and Human Services Oversight Committee: DO PASS AS AMENDED BY CS",8,3,0,0,11
1923726,1526750,2025-03-25,House,"House: THIRD READING",60,26,0,13,99
1923727,1499119,2025-02-25,House,"House: Rules Committee: DO PASS AS AMENDED BY CS",10,0,0,0,10
1923727,1503705,2025-03-03,House,"House: THIRD READING",96,0,0,3,99
1923727,1540307,2025-04-08,Senate,"Senate: Retirement & Government Resources Committee: DO PASS",8,0,0,0,8
1923727,1568197,2025-05-08,Senate,"Senate: THIRD READING",45,0,0,2,47
1923727,1575151,2025-05-21,House,"House: FOURTH READING",90,1,0,7,98
1923741,1505959,2025-03-05,House,"House: Rules Committee: DO PASS AS AMENDED, STRIKE THE TITLE",9,0,0,0,9
1923764,1483184,2025-02-06,House,"House: Civil Judiciary Committee: DO PASS AS AMENDED BY CS",8,0,0,0,8
1923790,1493574,2025-02-19,Senate,"Senate: Judiciary Committee: DO PASS",6,2,0,0,8
1923791,1489354,2025-02-13,Senate,"Senate: Administrative Rules Committee: DO PASS",9,0,0,0,9
1923791,1528368,2025-03-26,Senate,"Senate: THIRD READING",45,0,0,2,47
1923791,1550125,2025-04-16,House,"House: Administrative Rules Committee: DO PASS AS AMENDED BY CS",11,0,0,0,11
1923791,1567931,2025-05-07,House,"House: THIRD READING",87,0,0,11,98
1923791,1591314,2025-05-15,Senate,"Senate: FOURTH READING",33,8,0,6,47
1923798,1491218,2025-02-17,House,"House: Appropriations and Budget Natural Resources Subcommittee: DO PASS AS AMENDED BY CS",9,1,0,0,10
1923801,1501393,2025-02-27,Senate,"Senate: Business & Insurance Committee: DO PASS",9,0,0,0,9
1923807,1497905,2025-02-24,Senate,"Senate: Health & Human Services Committee: DO PASS",10,3,0,0,13
1923809,1497799,2025-02-24,Senate,"Senate: Health & Human Services Committee: DO PASS",11,0,0,0,11
1923809,1518745,2025-03-17,Senate,"Senate: THIRD READING",44,0,0,3,47
1923809,1541317,2025-04-09,House,"House: Public Health Committee: DO PASS",6,0,0,0,6
1923809,1567577,2025-05-07,House,"House: THIRD READING",56,31,0,11,98
1923809,1596411,2025-04-16,House,"House: Health and Human Services Oversight Committee: DO PASS",13,0,0,0,13
1923822,1507112,2025-03-06,Senate,"Senate: Business & Insurance Committee: DO PASS AMENDED CS",10,0,0,0,10
1923822,1529243,2025-03-27,Senate,"Senate: THIRD READING",35,11,0,1,47
1923822,1542206,2025-04-09,House,"House: Alcohol, Tobacco and Controlled Substances Committee: DO PASS AS AMENDED BY CS",7,1,0,0,8
1923822,1566435,2025-05-06,House,"House: THIRD READING",31,61,0,6,98
1923822,1596165,2025-04-21,House,"House: Health and Human Services Oversight Committee: DO PASS AS AMENDED BY CS",8,5,0,0,13
1923823,1487316,2025-02-12,House,"House: Energy Committee: DO PASS",9,0,0,0,9
1923823,1503428,2025-03-03,House,"House: Energy and Natural Resources Oversight Committee: DO PASS AS AMENDED BY CS",10,2,0,0,12
1923823,1516537,2025-03-12,House,"House: THIRD READING",73,16,0,10,99
1923823,1551656,2025-04-17,Senate,"Senate: Energy Committee: DO PASS AMENDED",9,1,0,0,10
1923823,1567218,2025-05-07,Senate,"Senate: THIRD READING",31,14,0,2,47
1923823,1596115,2025-05-07,Senate,"Senate: TABLE",32,13,0,2,47
1923827,1497515,2025-02-24,Senate,"Senate: Aeronautics & Transportation Committee: DO PASS",10,0,0,0,10
1923827,1526303,2025-03-25,Senate,"Senate: THIRD READING",45,0,0,2,47
1923827,1544150,2025-04-10,House,"House: Transportation Committee: DO PASS",11,0,0,0,11
1923827,1596407,2025-04-17,House,"House: Commerce and Economic Development Oversight Committee: DO PASS",16,0,0,0,16
1923838,1494036,2025-02-19,House,"House: Common Education Committee: DO PASS AS AMENDED BY CS",9,0,0,0,9
1923838,1500463,2025-02-26,House,"House: Education Oversight Committee: DO PASS AS AMENDED BY CS",9,0,0,0,9
1923838,1516384,2025-03-12,House,"House: THIRD READING",85,1,0,13,99
1923838,1540602,2025-04-08,Senate,"Senate: Education Committee: DO PASS",10,0,0,0,10
1923838,1564435,2025-05-01,Senate,"Senate: THIRD READING",43,0,0,4,47
1923858,1497951,2025-02-24,Senate,"Senate: Health & Human Services Committee: DO PASS",10,3,0,0,13
1923863,1497756,2025-02-24,Senate,"Senate: Health & Human Services Committee: DO PASS",12,0,0,0,12
1923863,1514304,2025-03-11,Senate,"Senate: THIRD READING",43,0,0,4,47
1923863,1541361,2025-04-09,House,"House: Public Health Committee: DO PASS",6,0,0,0,6
1923863,1565033,2025-05-05,House,"House: THIRD READING",83,8,0,7,98
1923863,1596416,2025-04-16,House,"House: Health and Human Services Oversight Committee: DO PASS",12,0,0,0,12
1923866,1507104,2025-03-06,Senate,"Senate: Business & Insurance Committee: DO PASS",9,0,0,0,9
1923866,1525054,2025-03-24,Senate,"Senate: THIRD READING",38,8,0,1,47
1923866,1540466,2025-04-08,House,"House: Business Committee: DO PASS",8,1,0,0,9
1923872,1503284,2025-03-03,Senate,"Senate: Health & Human Services Committee: DO PASS AMENDED",8,4,0,0,12
1923872,1525343,2025-03-24,Senate,"Senate: THIRD READING",28,18,0,1,47
1923872,1541325,2025-04-09,House,"House: Public Health Committee: DO PASS",6,0,0,0,6
1923872,1567385,2025-05-07,House,"House: THIRD READING",81,6,0,11,98
1923872,1596403,2025-04-14,House,"House: Health and Human Services Oversight Committee: DO PASS",13,0,0,0,13
1923881,1489238,2025-02-13,Senate,"Senate: Veterans & Military Affairs Committee: DO PASS",9,0,0,0,9
1923881,1517108,2025-03-13,Senate,"Senate: THIRD READING",43,1,0,3,47
1923881,1544391,2025-04-10,House,"House: Veterans and Military Affairs Committee: DO PASS",6,0,0,0,6
1923881,1560927,2025-04-29,House,"House: THIRD READING",86,0,0,12,98
1923881,1596413,2025-04-16,House,"House: Health and Human Services Oversight Committee: DO PASS",12,0,0,0,12
1923888,1484700,2025-02-10,House,"House: Appropriations and Budget Human Services Subcommittee: DO PASS",5,0,0,0,5
1923888,1499457,2025-02-25,House,"House: Appropriations and Budget Committee: DO PASS AS AMENDED BY CS",31,1,0,0,32
1923888,1516159,2025-03-12,House,"House: THIRD READING",82,2,1,14,99
1923888,1547286,2025-04-14,Senate,"Senate: Health & Human Services Committee: DO PASS",12,0,0,0,12
1923888,1564309,2025-05-01,Senate,"Senate: THIRD READING",41,0,0,6,47
1923888,1572048,2025-05-15,House,"House: FOURTH READING",77,3,1,17,98
1923903,1495229,2025-02-20,Senate,"Senate: Energy Committee: DO PASS",4,7,0,0,11
1923904,1491294,2025-02-17,House,"House: Appropriations and Budget Education Subcommittee: DO PASS AS AMENDED BY CS",6,2,0,0,8
1923904,1506301,2025-03-05,House,"House: Appropriations and Budget Committee: DO PASS AS AMENDED BY CS",31,2,0,0,33
1923904,1529444,2025-03-27,House,"House: THIRD READING",63,31,0,5,99
1923905,1480189,2025-02-04,House,"House: Criminal Judiciary Committee: DO PASS",5,1,0,0,6
1923905,1498793,2025-02-25,House,"House: Judiciary and Public Safety Oversight Committee: DO PASS",10,0,0,0,10
1923905,1504705,2025-03-04,House,"House: THIRD READING",91,1,0,7,99
1923905,1539322,2025-04-08,Senate,"Senate: Public Safety Committee: DO PASS",7,0,0,0,7
1923905,1565139,2025-05-05,Senate,"Senate: THIRD READING",45,0,0,2,47
1923911,1494939,2025-02-20,House,"House: Transportation Committee: DO PASS AS AMENDED BY CS",8,1,0,0,9
1923911,1504598,2025-03-04,House,"House: Commerce and Economic Development Oversight Committee: DO PASS AS AMENDED BY CS",13,1,0,0,14
1923911,1529574,2025-03-27,House,"House: THIRD READING",66,20,0,13,99
1923911,1547001,2025-04-14,Senate,"Senate: Aeronautics & Transportation Committee: DO PASS AMENDED",10,1,0,0,11
1923918,1483188,2025-02-06,House,"House: Civil Judiciary Committee: DO PASS",8,0,0,0,8
1923918,1501283,2025-02-27,House,"House: Judiciary and Public Safety Oversight Committee: DO PASS",11,0,0,0,11
1923918,1528379,2025-03-26,House,"House: THIRD READING",87,6,0,6,99
1923922,1501172,2025-02-27,Senate,"Senate: Technology & Telecommunications Committee: DO PASS AMENDED",7,0,0,0,7
1923925,1507091,2025-03-06,Senate,"Senate: Business & Insurance Committee: DO PASS AMENDED CS",10,0,0,0,10
1923934,1493363,2025-02-19,House,"House: Common Education Committee: DO PASS AS AMENDED BY CS",5,6,0,0,11
1923951,1505332,2025-03-04,Senate,"Senate: Judiciary Committee: DO PASS AMENDED",8,0,0,0,8
1923951,1525217,2025-03-24,Senate,"Senate: THIRD READING",46,0,0,1,47
1923951,1540218,2025-04-08,House,"House: General Government Committee: DO PASS AS AMENDED BY CS",7,1,0,0,8
1923951,1561709,2025-04-30,House,"House: THIRD READING",85,0,0,13,98
1923951,1591377,2025-05-20,Senate,"Senate: FOURTH READING",42,1,0,4,47
1923951,1596430,2025-04-24,House,"House: Government Oversight Committee: DO PASS AS AMENDED BY CS",13,0,0,0,13
1923957,1486426,2025-02-11,House,"House: Criminal Judiciary Committee: DO PASS",5,0,0,0,5
1923957,1498782,2025-02-25,House,"House: Judiciary and Public Safety Oversight Committee: DO PASS",10,1,0,0,11
1923957,1504190,2025-03-04,House,"House: THIRD READING",80,10,0,9,99
1923957,1548052,2025-04-15,Senate,"Senate: Public Safety Committee: DO PASS AMENDED",7,1,0,0,8
1923972,1498051,2025-02-24,House,"House: Insurance Committee: DO PASS AS AMENDED BY CS",7,0,0,0,7
1923972,1504708,2025-03-04,House,"House: Commerce and Economic Development Oversight Committee: DO PASS AS AMENDED BY CS",15,0,0,0,15
1923972,1525174,2025-03-24,House,"House: THIRD READING",81,10,1,7,99
1923972,1551671,2025-04-17,Senate,"Senate: Business & Insurance Committee: DO PASS",9,0,0,0,9
1923972,1562473,2025-04-30,Senate,"Senate: THIRD READING",34,11,0,2,47
1923978,1485257,2025-02-10,Senate,"Senate: Aeronautics & Transportation Committee: DO PASS",11,1,0,0,12
1923982,1506560,2025-03-05,Senate,"Senate: Appropriations Committee: DO PASS AMENDED CS",24,0,0,0,24
1923982,1526838,2025-03-25,Senate,"Senate: THIRD READING",45,0,0,2,47
1923982,1544036,2025-04-10,House,"House: Appropriations and Budget Finance Subcommittee: DO PASS",6,1,0,0,7
1923982,1549258,2025-04-15,House,"House: Appropriations and Budget Committee: DO PASS AS AMENDED, STRIKE THE ENACTING CLAUSE",26,2,0,0,28
1923982,1566740,2025-05-06,House,"House: THIRD READING",85,9,0,4,98
1923982,1576288,2025-05-22,House,"House: FOURTH READING",64,13,0,21,98
1923982,1591558,2025-05-22,Senate,"Senate: FOURTH READING",40,5,0,3,48
1923995,1494841,2025-02-20,House,"House: Civil Judiciary Committee: DO PASS AS AMENDED BY CS",8,0,0,0,8
1923998,1507663,2025-03-06,Senate,"Senate: Energy Committee: DO PASS",8,1,0,0,9
1923998,1529158,2025-03-27,Senate,"Senate: THIRD READING",26,20,0,1,47
1923998,1540306,2025-04-08,House,"House: Utilities Committee: DO PASS",5,2,0,0,7
1923998,1565603,2025-05-06,House,"House: THIRD READING",51,39,0,8,98
1923998,1565604,2025-05-06,House,"House: EMERGENCY",48,36,0,14,98
1923998,1596429,2025-04-16,House,"House: Energy and Natural Resources Oversight Committee: DO PASS",11,3,0,0,14
1923999,1492965,2025-02-19,House,"House: Banking, Financial Services and Pensions Committee: DO PASS",7,1,0,0,8
1923999,1501080,2025-02-27,House,"House: Government Oversight Committee: DO PASS",10,5,0,0,15
1923999,1527408,2025-03-26,House,"House: THIRD READING",67,10,0,22,99
1923999,1548234,2025-04-15,Senate,"Senate: Retirement & Government Resources Committee: DO PASS",8,0,0,0,8
1924006,1480614,2025-02-05,House,"House: Energy Committee: DO PASS",10,0,0,0,10
1924006,1499767,2025-02-26,House,"House: Energy and Natural Resources Oversight Committee: DO PASS",12,0,0,0,12
1924014,1497933,2025-02-24,Senate,"Senate: Health & Human Services Committee: DO PASS AMENDED CS",11,0,0,0,11
1924014,1506634,2025-03-05,Senate,"Senate: THIRD READING",47,0,0,0,47
1924014,1541953,2025-04-09,House,"House: Public Health Committee: DO PASS",6,0,0,0,6
1924014,1563871,2025-05-01,House,"House: THIRD READING",84,0,0,14,98
1924014,1596412,2025-04-14,House,"House: Health and Human Services Oversight Committee: DO PASS",13,0,0,0,13
1924035,1492973,2025-02-19,House,"House: Alcohol, Tobacco and Controlled Substances Committee: DO PASS AS AMENDED BY CS",5,0,0,0,5
1924035,1506252,2025-03-05,House,"House: Health and Human Services Oversight Committee: DO PASS AS AMENDED BY CS",14,0,0,0,14
1924035,1516859,2025-03-13,House,"House: THIRD READING",89,0,0,10,99
1924035,1552788,2025-04-21,Senate,"Senate: Health & Human Services Committee: DO PASS",9,1,0,0,10
1924038,1485471,2025-02-10,House,"House: Appropriations and Budget Human Services Subcommittee: DO PASS",5,0,0,0,5
1924038,1506165,2025-03-04,House,"House: Appropriations and Budget Committee: DO PASS AS AMENDED BY CS",31,0,0,0,31
1924038,1528470,2025-03-26,House,"House: THIRD READING",83,12,0,4,99
1924038,1547974,2025-04-14,Senate,"Senate: Health & Human Services Committee: DO PASS AMENDED",11,1,0,0,12
1924038,1596119,2025-04-23,Senate,"Senate: Appropriations Committee: DO PASS",21,1,0,0,22
1924040,1486219,2025-02-11,Senate,"Senate: Judiciary Committee: DO PASS",8,0,0,0,8
1924040,1514339,2025-03-11,Senate,"Senate: THIRD READING",46,0,0,1,47
1924040,1539098,2025-04-03,House,"House: Civil Judiciary Committee: DO PASS",10,0,0,0,10
1924040,1596421,2025-04-22,House,"House: Judiciary and Public Safety Oversight Committee: DO PASS",8,0,0,0,8
1924046,1498354,2025-02-24,House,"House: Public Health Committee: DO PASS AS AMENDED BY CS",3,5,0,0,8
1924053,1493761,2025-02-19,Senate,"Senate: Judiciary Committee: DO PASS",7,0,0,0,7
1924053,1526192,2025-03-25,Senate,"Senate: THIRD READING",27,15,0,5,47
1924053,1538372,2025-04-03,House,"House: Civil Judiciary Committee: DO PASS",9,1,0,0,10
1924053,1562226,2025-04-30,House,"House: THIRD READING",62,24,0,12,98
1924053,1596427,2025-04-17,House,"House: Judiciary and Public Safety Oversight Committee: DO PASS",11,1,0,0,12
1924064,1498340,2025-02-24,House,"House: Public Health Committee: DO PASS",5,1,0,0,6
1924064,1506278,2025-03-05,House,"House: Health and Human Services Oversight Committee: DO PASS",12,0,0,0,12
1924064,1524714,2025-03-24,House,"House: THIRD READING",77,15,0,7,99
1924064,1547596,2025-04-14,Senate,"Senate: Health & Human Services Committee: DO PASS",11,1,0,0,12
1924064,1562633,2025-04-30,Senate,"Senate: THIRD READING",31,10,0,6,47
1924064,1581648,2025-05-29,Senate,"Senate: VETO OVERRIDE NO EMERGENCY",30,15,0,3,48
1924064,1581649,2025-05-29,House,"House: VETO OVERRIDE WITHOUT EMERGENCY",74,14,0,10,98
1924066,1486074,2025-02-11,Senate,"Senate: Retirement & Insurance Committee: DO PASS",5,2,0,0,7
1924066,1528071,2025-03-26,Senate,"Senate: THIRD READING",40,5,0,2,47
1924066,1532019,2025-04-01,House,"House: General Government Committee: DO PASS",6,2,0,0,8
1924066,1556625,2025-04-24,House,"House: Government Oversight Committee: DO PASS AS AMENDED BY CS",10,3,0,0,13
1924066,1567789,2025-05-07,House,"House: THIRD READING",78,14,0,6,98
1924076,1486072,2025-02-11,House,"House: Agriculture Committee: DO PASS",7,2,0,0,9
1924082,1505085,2025-03-04,Senate,"Senate: Education Committee: DO PASS AMENDED CS",11,0,0,0,11
1924082,1528144,2025-03-26,Senate,"Senate: THIRD READING",43,3,0,1,47
1924082,1538571,2025-04-07,House,"House: Appropriations and Budget Natural Resources Subcommittee: DO PASS",8,2,0,0,10
1924082,1549082,2025-04-15,House,"House: Appropriations and Budget Committee: DO PASS AS AMENDED, STRIKE THE TITLE",26,3,0,0,29
1924082,1553219,2025-04-22,House,"House: THIRD READING",68,18,0,12,98
1924082,1576820,2025-05-22,House,"House: FOURTH READING",60,20,0,18,98
1924082,1580970,2025-05-29,Senate,"Senate: VETO OVERRIDE NO EMERGENCY",46,1,0,1,48
1924082,1581849,2025-05-29,House,"House: VETO OVERRIDE WITHOUT EMERGENCY",70,11,0,17,98
1924082,1591648,2025-05-22,Senate,"Senate: FOURTH READING",45,1,0,2,48
1924084,1484628,2025-02-10,Senate,"Senate: Agriculture & Rural Affairs Committee: DO PASS",11,0,0,0,11
1924084,1596424,2025-02-20,Senate,"Senate: Appropriations Committee: DO PASS AMENDED",22,0,0,0,22
1924104,1498333,2025-02-24,House,"House: Public Safety Committee: DO PASS AS AMENDED BY CS",7,0,0,0,7
1924104,1507715,2025-03-06,House,"House: Judiciary and Public Safety Oversight Committee: DO PASS AS AMENDED BY CS",9,1,0,0,10
1924104,1528666,2025-03-27,House,"House: THIRD READING",67,21,0,11,99
1924104,1552617,2025-04-21,Senate,"Senate: Aeronautics & Transportation Committee: DO PASS AMENDED",8,2,0,0,10
1924108,1494237,2025-02-19,House,"House: Children, Youth and Family Services Committee: DO PASS AS AMENDED BY CS",7,0,0,0,7
1924108,1500602,2025-02-26,House,"House: Health and Human Services Oversight Committee: DO PASS AS AMENDED BY CS",12,0,0,0,12
1924108,1518451,2025-03-17,House,"House: THIRD READING",77,6,0,16,99
1924108,1538482,2025-04-07,Senate,"Senate: Health & Human Services Committee: DO PASS AMENDED",11,1,0,0,12
1924120,1493568,2025-02-19,House,"House: Common Education Committee: DO PASS AS AMENDED BY CS",11,0,0,0,11
1924120,1503704,2025-03-03,House,"House: Education Oversight Committee: DO PASS AS AMENDED BY CS",9,0,0,0,9
1924120,1516046,2025-03-12,House,"House: THIRD READING",86,0,0,13,99
1924121,1485428,2025-02-10,House,"House: Appropriations and Budget Select Agencies Subcommittee: DO PASS",5,0,0,0,5
1924121,1505154,2025-03-04,House,"House: Appropriations and Budget Committee: DO PASS AS AMENDED BY CS",29,0,0,0,29
1924121,1524748,2025-03-24,House,"House: THIRD READING",75,16,0,8,99
1924121,1551700,2025-04-17,Senate,"Senate: Business & Insurance Committee: DO PASS AMENDED CS",8,1,0,0,9
1924121,1567209,2025-05-07,Senate,"Senate: THIRD READING",41,2,0,4,47
1924121,1575030,2025-05-21,House,"House: FOURTH READING",77,9,0,12,98
1924132,1504587,2025-03-04,Senate,"Senate: Judiciary Committee: DO PASS",7,1,0,0,8
1924132,1529304,2025-03-27,Senate,"Senate: THIRD READING",40,7,0,0,47
1924132,1538230,2025-04-03,House,"House: Civil Judiciary Committee: DO PASS",9,1,0,0,10
1924132,1567393,2025-05-06,House,"House: THIRD READING",76,11,0,11,98
1924132,1596420,2025-04-22,House,"House: Judiciary and Public Safety Oversight Committee: DO PASS",8,1,0,0,9
1924139,1493770,2025-02-19,House,"House: Criminal Judiciary Committee: DO PASS",6,0,0,0,6
1924139,1501181,2025-02-27,House,"House: Judiciary and Public Safety Oversight Committee: DO PASS",12,0,0,0,12
1924139,1516524,2025-03-12,House,"House: THIRD READING",84,0,0,15,99
1924139,1540340,2025-04-08,Senate,"Senate: Judiciary Committee: DO PASS",7,0,0,0,7
1924154,1494184,2025-02-19,Senate,"Senate: Local & County Government Committee: DO PASS",7,2,0,0,9
1924154,1526550,2025-03-25,Senate,"Senate: THIRD READING",38,7,0,2,47
1924154,1540382,2025-04-08,House,"House: General Government Committee: DO PASS",8,0,0,0,8
1924154,1563523,2025-05-01,House,"House: THIRD READING",84,0,0,14,98
1924154,1580904,2025-05-29,Senate,"Senate: VETO OVERRIDE NO EMERGENCY",43,4,0,1,48
1924154,1581979,2025-05-29,House,"House: VETO OVERRIDE WITHOUT EMERGENCY",82,1,0,15,98
1924154,1596155,2025-04-17,House,"House: Government Oversight Committee: DO PASS",14,1,0,0,15
1924155,1486388,2025-02-10,Senate,"Senate: Health & Human Services Committee: DO PASS",8,3,0,0,11
1924155,1596402,2025-03-05,Senate,"Senate: Appropriations Committee: DO PASS AMENDED CS",20,2,0,0,22
1924163,1501720,2025-02-27,Senate,"Senate: Business & Insurance Committee: DO PASS AMENDED CS",10,0,0,0,10
1924168,1497554,2025-02-24,House,"House: General Government Committee: DO PASS AS AMENDED BY CS",6,0,0,0,6
1924168,1507278,2025-03-06,House,"House: Government Oversight Committee: DO PASS AS AMENDED BY CS",14,1,0,0,15
1924168,1528169,2025-03-26,House,"House: THIRD READING",91,0,0,8,99
1924168,1547605,2025-04-14,Senate,"Senate: Health & Human Services Committee: DO PASS",11,0,0,0,11
1924168,1565130,2025-05-05,Senate,"Senate: THIRD READING",44,0,0,3,47
1924208,1497653,2025-02-24,House,"House: Insurance Committee: DO PASS AS AMENDED BY CS",7,0,0,0,7
1924208,1507639,2025-03-06,House,"House: Commerce and Economic Development Oversight Committee: DO PASS AS AMENDED BY CS",14,0,0,0,14
1924208,1525166,2025-03-24,House,"House: THIRD READING",88,7,0,4,99
1924208,1543472,2025-04-10,Senate,"Senate: Business & Insurance Committee: DO PASS",9,0,0,0,9
1924208,1568082,2025-05-08,Senate,"Senate: THIRD READING",42,1,0,4,47
1924208,1576401,2025-05-22,House,"House: FOURTH READING",80,7,0,11,98
1924208,1591435,2025-05-22,Senate,"Senate: FOURTH READING",42,0,0,6,48
1924208,1596116,2025-04-23,Senate,"Senate: Appropriations Committee: DO PASS AMENDED",21,2,0,0,23
1924209,1497725,2025-02-24,Senate,"Senate: Health & Human Services Committee: DO PASS AMENDED",11,0,0,0,11
1924227,1486281,2025-02-11,Senate,"Senate: Public Safety Committee: DO PASS",6,2,0,0,8
1924237,1487589,2025-02-12,House,"House: County and Municipal Government Committee: DO PASS",6,0,0,0,6
1924237,1507623,2025-03-06,House,"House: Government Oversight Committee: DO PASS AS AMENDED BY CS",14,1,0,0,15
1924237,1524705,2025-03-24,House,"House: THIRD READING",85,6,0,8,99
1924237,1541098,2025-04-08,Senate,"Senate: Local & County Government Committee: DO PASS AMENDED",4,5,0,0,9
1924238,1488620,2025-02-13,House,"House: Civil Judiciary Committee: DO PASS AS AMENDED BY CS",8,0,0,0,8
1924238,1507528,2025-03-06,House,"House: Judiciary and Public Safety Oversight Committee: DO PASS AS AMENDED BY CS",11,0,0,0,11
1924242,1498250,2025-02-24,House,"House: Business Committee: DO PASS",7,0,0,0,7
1924242,1507320,2025-03-06,House,"House: Commerce and Economic Development Oversight Committee: DO PASS AS AMENDED BY CS",16,0,0,0,16
1924242,1525243,2025-03-24,House,"House: THIRD READING",92,0,0,7,99
1924242,1556443,2025-04-24,Senate,"Senate: Business & Insurance Committee: DO PASS AMENDED CS",10,0,0,0,10
1924242,1564121,2025-05-01,Senate,"Senate: THIRD READING",40,0,0,7,47
1924242,1571898,2025-05-15,House,"House: FOURTH READING",79,1,0,18,98
1924246,1505695,2025-03-05,House,"House: Rules Committee: DO PASS AS AMENDED BY CS",9,0,0,0,9
1924246,1516036,2025-03-12,House,"House: THIRD READING",83,5,0,11,99
1924246,1554001,2025-04-22,Senate,"Senate: Judiciary Committee: DO PASS",7,0,0,0,7
1924246,1565058,2025-05-05,Senate,"Senate: THIRD READING",43,3,0,1,47
1924266,1493272,2025-02-19,House,"House: Common Education Committee: DO PASS AS AMENDED BY CS",10,1,0,0,11
1924266,1505766,2025-03-05,House,"House: Education Oversight Committee: DO PASS AS AMENDED BY CS",9,0,0,0,9
1924266,1524885,2025-03-24,House,"House: THIRD READING",88,4,0,7,99
1924266,1540584,2025-04-08,Senate,"Senate: Education Committee: DO PASS",11,0,0,0,11
1924266,1553574,2025-04-22,Senate,"Senate: THIRD READING",43,0,0,4,47
1924271,1503229,2025-03-03,Senate,"Senate: Agriculture & Wildlife Committee: DO PASS AMENDED CS",3,9,0,0,12
1924281,1485381,2025-02-10,House,"House: Elections and Ethics Committee: DO PASS AS AMENDED BY CS",5,1,0,0,6
1924281,1499429,2025-02-25,House,"House: Government Oversight Committee: DO PASS AS AMENDED BY CS",11,3,0,0,14
1924281,1516091,2025-03-12,House,"House: THIRD READING",70,15,0,14,99
1924281,1555316,2025-04-22,Senate,"Senate: Judiciary Committee: DO PASS AMENDED",7,1,0,0,8
1924281,1567478,2025-05-07,Senate,"Senate: THIRD READING",37,8,0,2,47
1924281,1571875,2025-05-15,House,"House: FOURTH READING",68,16,0,14,98
1924284,1501165,2025-02-27,Senate,"Senate: Technology & Telecommunications Committee: DO PASS AMENDED",7,0,0,0,7
1924287,1490948,2025-02-17,Senate,"Senate: Agriculture & Wildlife Committee: DO PASS",11,0,0,0,11
1924287,1509621,2025-03-10,Senate,"Senate: THIRD READING",45,0,0,2,47
1924287,1539904,2025-04-08,House,"House: Agriculture Committee: DO PASS",8,0,0,0,8
1924287,1559542,2025-04-28,House,"House: THIRD READING",86,0,0,12,98
1924287,1596414,2025-04-16,House,"House: Energy and Natural Resources Oversight Committee: DO PASS",12,0,0,0,12
1924290,1493890,2025-02-19,House,"House: Common Education Committee: DO PASS AS AMENDED BY CS",11,0,0,0,11
1924290,1503768,2025-03-03,House,"House: Education Oversight Committee: DO PASS AS AMENDED BY CS",9,0,0,0,9
1924290,1518660,2025-03-17,House,"House: THIRD READING",65,20,0,14,99
1924290,1548138,2025-04-15,Senate,"Senate: Education Committee: DO PASS AMENDED",10,1,0,0,11
1924290,1568812,2025-05-08,Senate,"Senate: THIRD READING",42,0,0,5,47
1924290,1572318,2025-05-15,House,"House: FOURTH READING",52,28,0,18,98
1924295,1499508,2025-02-25,House,"House: Rules Committee: DO PASS AS AMENDED BY CS",10,0,0,0,10
1924295,1506749,2025-03-05,House,"House: THIRD READING",56,28,0,15,99
1924295,1548636,2025-04-15,Senate,"Senate: Judiciary Committee: DO PASS AMENDED CS",8,0,0,0,8
1924295,1563546,2025-05-01,Senate,"Senate: THIRD READING",45,0,0,2,47
1924295,1575725,2025-05-21,House,"House: FOURTH READING",82,8,0,8,98
1924299,1480177,2025-02-04,House,"House: Criminal Judiciary Committee: DO PASS AS AMENDED BY CS",4,1,0,0,5
1924299,1501203,2025-02-27,House,"House: Judiciary and Public Safety Oversight Committee: DO PASS AS AMENDED BY CS",10,1,0,0,11
1924299,1519035,2025-03-17,House,"House: THIRD READING",67,15,0,17,99
1924299,1548776,2025-04-15,Senate,"Senate: Local & County Government Committee: DO PASS",7,2,0,0,9
1924300,1504201,2025-03-04,Senate,"Senate: Retirement & Government Resources Committee: DO PASS AMENDED CS",6,2,0,0,8
1924302,1499562,2025-02-25,Senate,"Senate: Economic Development, Workforce & Tourism Committee: DO PASS AMENDED CS",9,0,0,0,9
1924302,1519888,2025-03-18,Senate,"Senate: THIRD READING",30,15,0,2,47
1924302,1539323,2025-04-08,House,"House: Business Committee: DO PASS",9,0,0,0,9
1924302,1565216,2025-05-05,House,"House: THIRD READING",62,30,0,6,98
1924302,1596425,2025-04-22,House,"House: Commerce and Economic Development Oversight Committee: DO PASS",12,5,0,0,17
1924307,1501348,2025-02-27,Senate,"Senate: Business & Insurance Committee: DO PASS",7,4,0,0,11
1924307,1529321,2025-03-27,Senate,"Senate: THIRD READING",36,10,0,1,47
1924307,1544370,2025-04-10,House,"House: Civil Judiciary Committee: DO PASS",7,0,0,0,7
1924307,1563425,2025-05-01,House,"House: THIRD READING",72,9,0,17,98
1924307,1581122,2025-05-29,Senate,"Senate: VETO OVERRIDE NO EMERGENCY",42,5,0,1,48
1924307,1581669,2025-05-29,House,"House: VETO OVERRIDE WITHOUT EMERGENCY",77,5,0,16,98
1924307,1596168,2025-04-17,House,"House: Judiciary and Public Safety Oversight Committee: DO PASS",9,0,0,0,9
1924317,1494298,2025-02-19,House,"House: Criminal Judiciary Committee: DO PASS",4,1,0,0,5
1924317,1504548,2025-03-04,House,"House: Judiciary and Public Safety Oversight Committee: DO PASS",11,2,0,0,13
1924317,1515743,2025-03-12,House,"House: THIRD READING",54,33,0,12,99
1924317,1553648,2025-04-22,Senate,"Senate: Public Safety Committee: DO PASS AMENDED",6,2,0,0,8
1924324,1491253,2025-02-17,Senate,"Senate: Agriculture & Wildlife Committee: DO PASS AMENDED CS",10,2,0,0,12
1924352,1491287,2025-02-17,Senate,"Senate: Agriculture & Wildlife Committee: DO PASS AMENDED",5,7,0,0,12
1924357,1497924,2025-02-24,House,"House: Public Health Committee: DO PASS AS AMENDED BY CS",5,1,0,0,6
1924357,1503921,2025-03-03,House,"House: Health and Human Services Oversight Committee: DO PASS AS AMENDED BY CS",11,1,0,0,12
1924357,1514429,2025-03-11,House,"House: THIRD READING",75,10,0,14,99
1924357,1552513,2025-04-21,Senate,"Senate: Health & Human Services Committee: DO PASS AMENDED CS",7,3,0,0,10
1924373,1495979,2025-02-20,House,"House: Appropriations and Budget Finance Subcommittee: DO PASS",9,0,0,0,9
1924373,1506233,2025-03-05,House,"House: Appropriations and Budget Committee: DO PASS AS AMENDED, STRIKE THE TITLE",30,1,0,0,31
1924373,1517266,2025-03-13,House,"House: THIRD READING",73,1,8,17,99
1924376,1499306,2025-02-25,House,"House: Rules Committee: DO PASS AS AMENDED BY CS",11,0,0,0,11
1924376,1516205,2025-03-12,House,"House: THIRD READING",89,1,1,8,99
1924376,1555327,2025-04-22,Senate,"Senate: Judiciary Committee: DO PASS",8,0,0,0,8
1924376,1568518,2025-05-08,Senate,"Senate: THIRD READING",45,0,0,2,47
1924379,1495130,2025-02-20,House,"House: Transportation Committee: DO PASS AS AMENDED BY CS",10,0,0,0,10
1924379,1501303,2025-02-27,House,"House: Commerce and Economic Development Oversight Committee: DO PASS AS AMENDED BY CS",14,0,0,0,14
1924379,1516449,2025-03-12,House,"House: THIRD READING",89,0,0,10,99
1924379,1538049,2025-04-07,Senate,"Senate: Aeronautics & Transportation Committee: DO PASS",10,0,0,0,10
1924381,1503477,2025-03-03,Senate,"Senate: Health & Human Services Committee: DO PASS AMENDED CS",10,2,0,0,12
1924381,1528015,2025-03-26,Senate,"Senate: THIRD READING",38,9,0,0,47
1924381,1548235,2025-04-15,House,"House: Rules Committee: DO PASS AS AMENDED, STRIKE THE TITLE",11,0,0,0,11
1924381,1568306,2025-05-08,House,"House: THIRD READING",87,6,0,5,98
1924381,1591539,2025-05-21,Senate,"Senate: FOURTH READING",32,13,0,3,48
1924389,1486531,2025-02-11,House,"House: Criminal Judiciary Committee: DO PASS AS AMENDED BY CS",6,0,0,0,6
1924389,1501513,2025-02-27,House,"House: Judiciary and Public Safety Oversight Committee: DO PASS AS AMENDED BY CS",13,0,0,0,13
1924389,1513814,2025-03-11,House,"House: THIRD READING",86,0,0,13,99
1924389,1548324,2025-04-15,Senate,"Senate: Judiciary Committee: DO PASS",7,0,0,0,7
1924389,1568307,2025-05-08,Senate,"Senate: THIRD READING",42,1,0,4,47
1924399,1485562,2025-02-10,House,"House: Elections and Ethics Committee: DO PASS",6,0,0,0,6
1924399,1505188,2025-03-04,House,"House: Government Oversight Committee: DO PASS",17,0,0,0,17
1924401,1484744,2025-02-10,House,"House: Appropriations and Budget Natural Resources Subcommittee: DO PASS AS AMENDED BY CS",9,0,0,0,9
1924401,1499377,2025-02-25,House,"House: Appropriations and Budget Committee: DO PASS AS AMENDED BY CS",33,0,0,0,33
1924401,1509274,2025-03-10,House,"House: THIRD READING",87,5,0,7,99
1924401,1550923,2025-04-17,Senate,"Senate: Business & Insurance Committee: DO PASS",8,0,0,0,8
1924401,1568378,2025-05-08,Senate,"Senate: THIRD READING",33,11,0,3,47
1924401,1571995,2025-05-15,House,"House: FOURTH READING",80,2,0,16,98
1924403,1485968,2025-02-11,House,"House: Postsecondary Education Committee: DO PASS",8,0,0,0,8
1924403,1500038,2025-02-26,House,"House: Education Oversight Committee: DO PASS",8,1,0,0,9
1924403,1529543,2025-03-27,House,"House: THIRD READING",68,18,0,13,99
1924413,1487934,2025-02-12,House,"House: Energy Committee: DO PASS",9,0,0,0,9
1924413,1499771,2025-02-26,House,"House: Energy and Natural Resources Oversight Committee: DO PASS",12,0,0,0,12
1924413,1527188,2025-03-25,House,"House: THIRD READING",49,36,0,14,99
1924414,1485202,2025-02-10,House,"House: Appropriations and Budget Transportation Subcommittee: DO PASS",8,0,0,0,8
1924414,1499454,2025-02-25,House,"House: Appropriations and Budget Committee: DO PASS",30,2,0,0,32
1924414,1513972,2025-03-11,House,"House: THIRD READING",59,27,0,13,99
1924414,1547770,2025-04-14,Senate,"Senate: Revenue & Taxation Committee: DO PASS AMENDED",7,4,0,0,11
1924414,1568462,2025-05-08,Senate,"Senate: THIRD READING",27,18,0,2,47
1924414,1575866,2025-05-22,House,"House: FOURTH READING",63,22,0,13,98
1924414,1581077,2025-05-29,House,"House: VETO OVERRIDE WITHOUT EMERGENCY",69,17,0,12,98
1924414,1582016,2025-05-29,Senate,"Senate: VETO OVERRIDE NO EMERGENCY",34,11,0,3,48
1924414,1591476,2025-05-22,Senate,"Senate: FOURTH READING",29,13,0,6,48
1924414,1596135,2025-04-23,Senate,"Senate: Appropriations Committee: DO PASS",22,3,0,0,25
1924415,1497618,2025-02-24,House,"House: General Government Committee: DO PASS AS AMENDED BY CS",6,1,0,0,7
1924415,1504823,2025-03-04,House,"House: Government Oversight Committee: DO PASS AS AMENDED BY CS",12,3,0,0,15
1924420,1486108,2025-02-11,Senate,"Senate: Judiciary Committee: DO PASS",7,2,0,0,9
1924420,1528167,2025-03-26,Senate,"Senate: THIRD READING",38,8,0,1,47
1924422,1491487,2025-02-17,House,"House: Elections and Ethics Committee: DO PASS AS AMENDED BY CS",5,1,0,0,6
1924422,1504909,2025-03-04,House,"House: Government Oversight Committee: DO PASS AS AMENDED BY CS",12,4,0,0,16
1924422,1524727,2025-03-24,House,"House: THIRD READING",92,0,0,7,99
1924422,1548555,2025-04-15,Senate,"Senate: Judiciary Committee: DO PASS AMENDED CS",6,0,0,0,6
1924431,1491317,2025-02-17,House,"House: Wildlife Committee: DO PASS AS AMENDED BY CS",6,0,0,0,6
1924431,1499737,2025-02-26,House,"House: Energy and Natural Resources Oversight Committee: DO PASS AS AMENDED BY CS",14,1,0,0,15
1924431,1525521,2025-03-24,House,"House: THIRD READING",76,16,0,7,99
1924431,1546860,2025-04-14,Senate,"Senate: Agriculture & Wildlife Committee: DO PASS AMENDED CS",12,0,0,0,12
1924434,1489095,2025-02-13,House,"House: Civil Judiciary Committee: DO PASS AS AMENDED BY CS",8,0,0,0,8
1924434,1501845,2025-02-27,House,"House: Judiciary and Public Safety Oversight Committee: DO PASS AS AMENDED BY CS",11,0,0,0,11
1924434,1528228,2025-03-26,House,"House: THIRD READING",90,1,0,8,99
1924434,1554189,2025-04-22,Senate,"Senate: Judiciary Committee: DO PASS AMENDED",9,0,0,0,9
1924434,1568395,2025-05-08,Senate,"Senate: THIRD READING",45,0,0,2,47
1924434,1576421,2025-05-22,House,"House: FOURTH READING",80,0,0,18,98
1924434,1591346,2025-05-22,Senate,"Senate: FOURTH READING",42,0,0,6,48
1924437,1493784,2025-02-19,House,"House: Appropriations and Budget Education Subcommittee: DO PASS AS AMENDED BY CS",6,2,0,0,8
1924446,1494736,2025-02-20,Senate,"Senate: Business & Insurance Committee: DO PASS AMENDED CS",10,0,0,0,10
1924467,1488995,2025-02-13,House,"House: Civil Judiciary Committee: DO PASS",8,0,0,0,8
1924467,1501090,2025-02-27,House,"House: Judiciary and Public Safety Oversight Committee: DO PASS",13,0,0,0,13
1924467,1514741,2025-03-11,House,"House: THIRD READING",84,0,0,15,99
1924467,1548958,2025-04-15,Senate,"Senate: Judiciary Committee: DO PASS",8,0,0,0,8
1924467,1561660,2025-04-30,Senate,"Senate: THIRD READING",42,1,0,4,47
1924473,1505421,2025-03-04,Senate,"Senate: Judiciary Committee: DO PASS AMENDED CS",8,0,0,0,8
1924479,1497804,2025-02-24,House,"House: General Government Committee: DO PASS AS AMENDED BY CS",7,0,0,0,7
1924479,1504260,2025-03-04,House,"House: Government Oversight Committee: DO PASS AS AMENDED BY CS",14,0,0,0,14
1924479,1525234,2025-03-24,House,"House: THIRD READING",90,0,0,9,99
1924479,1540208,2025-04-08,Senate,"Senate: Retirement & Government Resources Committee: DO PASS AMENDED",3,5,0,0,8
1924486,1501472,2025-02-27,Senate,"Senate: Technology & Telecommunications Committee: DO PASS",7,0,0,0,7
1924505,1493442,2025-02-19,House,"House: Criminal Judiciary Committee: DO PASS AS AMENDED BY CS",5,0,0,0,5
1924505,1501505,2025-02-27,House,"House: Judiciary and Public Safety Oversight Committee: DO PASS AS AMENDED BY CS",13,0,0,0,13
1924505,1513837,2025-03-11,House,"House: THIRD READING",88,0,0,11,99
1924505,1553885,2025-04-22,Senate,"Senate: Judiciary Committee: DO PASS AMENDED CS",8,0,0,0,8
1924505,1566486,2025-05-06,Senate,"Senate: THIRD READING",44,0,0,3,47
1924505,1575186,2025-05-21,House,"House: FOURTH READING",89,0,0,9,98
1924505,1581083,2025-05-29,House,"House: VETO OVERRIDE WITHOUT EMERGENCY",88,0,0,10,98
1924505,1581957,2025-05-29,Senate,"Senate: VETO OVERRIDE NO EMERGENCY",43,2,0,3,48
1924509,1486277,2025-02-11,House,"House: Postsecondary Education Committee: DO PASS",6,2,0,0,8
1924509,1505908,2025-03-05,House,"House: Education Oversight Committee: DO PASS",7,1,0,0,8
1924515,1484548,2025-02-10,House,"House: Appropriations and Budget Transportation Subcommittee: DO PASS",8,0,0,0,8
1924515,1499524,2025-02-25,House,"House: Appropriations and Budget Committee: DO PASS",32,0,0,0,32
1924515,1519089,2025-03-17,House,"House: THIRD READING",84,0,0,15,99
1924515,1546853,2025-04-14,Senate,"Senate: Aeronautics & Transportation Committee: DO PASS AMENDED",10,1,0,0,11
1924525,1491201,2025-02-17,Senate,"Senate: Revenue & Taxation Committee: DO PASS AMENDED",8,3,0,0,11
1924539,1497218,2025-02-24,Senate,"Senate: Agriculture & Wildlife Committee: DO PASS",11,1,0,0,12
1924539,1529386,2025-03-27,Senate,"Senate: THIRD READING",42,1,0,4,47
1924539,1538382,2025-04-07,House,"House: Appropriations and Budget Natural Resources Subcommittee: DO PASS",6,4,0,0,10
1924564,1501502,2025-02-27,Senate,"Senate: Business & Insurance Committee: DO PASS",10,0,0,0,10
1924565,1480838,2025-02-05,House,"House: Common Education Committee: DO PASS",13,0,0,0,13
1924565,1495934,2025-02-10,House,"House: Education Oversight Committee: DO PASS",9,0,0,0,9
1924565,1513879,2025-03-11,House,"House: THIRD READING",91,0,0,8,99
1924565,1548127,2025-04-15,Senate,"Senate: Education Committee: DO PASS",8,3,0,0,11
1924565,1566808,2025-05-06,Senate,"Senate: THIRD READING",37,7,0,3,47
1924585,1488312,2025-02-12,House,"House: Common Education Committee: DO PASS",12,0,0,0,12
1924585,1506038,2025-03-05,House,"House: Education Oversight Committee: DO PASS",9,0,0,0,9
1924585,1514389,2025-03-11,House,"House: THIRD READING",84,1,0,14,99
1924586,1487448,2025-02-12,House,"House: Common Education Committee: DO PASS",11,0,0,0,11
1924586,1500182,2025-02-26,House,"House: Education Oversight Committee: DO PASS AS AMENDED BY CS",9,0,0,0,9
1924586,1506518,2025-03-05,House,"House: THIRD READING",96,0,0,3,99
1924586,1540109,2025-04-08,Senate,"Senate: Education Committee: DO PASS",11,0,0,0,11
1924586,1562254,2025-04-30,Senate,"Senate: THIRD READING",44,0,0,3,47
1924593,1498092,2025-02-24,House,"House: General Government Committee: DO PASS AS AMENDED BY CS",7,0,0,0,7
1924593,1507030,2025-03-06,House,"House: Government Oversight Committee: DO PASS AS AMENDED BY CS",15,0,0,0,15
1924593,1527782,2025-03-26,House,"House: THIRD READING",88,0,0,11,99
1924593,1548340,2025-04-15,Senate,"Senate: Retirement & Government Resources Committee: DO PASS AMENDED CS",9,0,0,0,9
1924593,1565445,2025-05-05,Senate,"Senate: THIRD READING",45,0,0,2,47
1924593,1572257,2025-05-15,House,"House: FOURTH READING",82,0,0,16,98
1924604,1507555,2025-03-06,Senate,"Senate: Energy Committee: DO PASS AMENDED CS",11,0,0,0,11
1924605,1497939,2025-02-24,House,"House: Public Health Committee: DO PASS AS AMENDED BY CS",5,1,0,0,6
1924605,1506613,2025-03-05,House,"House: Health and Human Services Oversight Committee: DO PASS AS AMENDED BY CS",13,0,0,0,13
1924605,1526593,2025-03-25,House,"House: ADOPT AMENDMENT",64,22,0,13,99
1924605,1526594,2025-03-25,House,"House: THIRD READING",55,38,1,5,99
1924605,1552580,2025-04-21,Senate,"Senate: Health & Human Services Committee: DO PASS AMENDED CS",8,4,0,0,12
1924605,1568442,2025-05-08,Senate,"Senate: THIRD READING",34,13,0,0,47
1924605,1575004,2025-05-21,House,"House: FOURTH READING",67,23,1,7,98
1924605,1581922,2025-05-30,Senate,"Senate: VETO OVERRIDE NO EMERGENCY",32,14,0,2,48
1924605,1581923,2025-05-29,House,"House: VETO OVERRIDE WITHOUT EMERGENCY",68,13,0,17,98
1924614,1498311,2025-02-24,House,"House: Public Safety Committee: DO PASS AS AMENDED BY CS",7,0,0,0,7
1924614,1501484,2025-02-27,House,"House: Judiciary and Public Safety Oversight Committee: DO PASS AS AMENDED BY CS",13,0,0,0,13
1924614,1529103,2025-03-27,House,"House: THIRD READING",51,37,0,11,99
1924621,1489219,2025-02-13,House,"House: Civil Judiciary Committee: DO PASS",8,0,0,0,8
1924621,1507622,2025-03-06,House,"House: Judiciary and Public Safety Oversight Committee: DO PASS AS AMENDED BY CS",11,0,0,0,11
1924621,1525321,2025-03-24,House,"House: THIRD READING",90,0,1,8,99
1924621,1554228,2025-04-22,Senate,"Senate: Judiciary Committee: DO PASS AMENDED",8,0,0,0,8
1924621,1567287,2025-05-07,Senate,"Senate: THIRD READING",36,11,0,0,47
1924621,1570971,2025-05-14,House,"House: FOURTH READING",66,17,0,15,98
1924637,1480178,2025-02-04,House,"House: Criminal Judiciary Committee: DO PASS AS AMENDED BY CS",4,1,0,0,5
1924655,1491023,2025-02-17,House,"House: Appropriations and Budget Transportation Subcommittee: DO PASS AS AMENDED BY CS",9,0,0,0,9
1924665,1486831,2025-02-11,House,"House: Business Committee: DO PASS AS AMENDED BY CS",7,0,0,0,7
1924665,1501491,2025-02-27,House,"House: Commerce and Economic Development Oversight Committee: DO PASS AS AMENDED BY CS",13,2,0,0,15
1924665,1527938,2025-03-26,House,"House: THIRD READING",81,10,0,8,99
1924665,1556426,2025-04-24,Senate,"Senate: Business & Insurance Committee: DO PASS AMENDED CS",9,0,0,0,9
1924665,1568291,2025-05-08,Senate,"Senate: THIRD READING",42,2,0,3,47
1924665,1575281,2025-05-21,House,"House: FOURTH READING",84,4,0,10,98
1924668,1499248,2025-02-25,House,"House: Rules Committee: DO PASS AS AMENDED BY CS",10,0,0,0,10
1924668,1503907,2025-03-03,House,"House: THIRD READING",90,4,0,5,99
1924668,1540165,2025-04-08,Senate,"Senate: Judiciary Committee: DO PASS",7,0,0,0,7
1924668,1568008,2025-05-07,Senate,"Senate: THIRD READING",46,0,0,1,47
1924676,1483313,2025-02-06,House,"House: Transportation Committee: DO PASS AS AMENDED BY CS",11,0,0,0,11
1924676,1498824,2025-02-25,House,"House: Commerce and Economic Development Oversight Committee: DO PASS AS AMENDED BY CS",15,0,0,0,15
1924676,1505926,2025-03-05,House,"House: THIRD READING",94,0,0,5,99
1924677,1482829,2025-02-05,House,"House: Public Safety Committee: DO PASS",7,0,0,0,7
1924677,1504237,2025-03-04,House,"House: Judiciary and Public Safety Oversight Committee: DO PASS",13,0,0,0,13
1924677,1517353,2025-03-13,House,"House: THIRD READING",78,0,0,21,99
1924677,1548385,2025-04-15,Senate,"Senate: Public Safety Committee: DO PASS",8,0,0,0,8
1924677,1568014,2025-05-07,Senate,"Senate: THIRD READING",46,0,0,1,47
1924678,1486505,2025-02-11,Senate,"Senate: Judiciary Committee: DO PASS",7,2,0,0,9
1924678,1525752,2025-03-24,Senate,"Senate: THIRD READING",37,8,1,1,47
1924679,1494950,2025-02-20,House,"House: Civil Judiciary Committee: DO PASS AS AMENDED BY CS",9,0,0,0,9
1924693,1493431,2025-02-19,House,"House: Children, Youth and Family Services Committee: DO PASS AS AMENDED BY CS",6,0,0,0,6
1924693,1500547,2025-02-26,House,"House: Health and Human Services Oversight Committee: DO PASS AS AMENDED BY CS",10,0,0,0,10
1924693,1516702,2025-03-12,House,"House: THIRD READING",80,5,0,14,99
1924695,1501746,2025-02-27,Senate,"Senate: Business & Insurance Committee: DO PASS AMENDED",11,0,0,0,11
1924698,1504549,2025-03-04,House,"House: Judiciary and Public Safety Oversight Committee: DO PASS AS AMENDED BY CS",13,0,0,0,13
1924698,1514069,2025-03-11,House,"House: THIRD READING",87,3,0,9,99
1924698,1547968,2025-04-14,Senate,"Senate: Health & Human Services Committee: DO PASS",12,0,0,0,12
1924725,1488095,2025-02-12,House,"House: Public Safety Committee: DO PASS",4,0,0,0,4
1924725,1507643,2025-03-06,House,"House: Judiciary and Public Safety Oversight Committee: DO PASS",11,0,0,0,11
1924725,1525603,2025-03-24,House,"House: THIRD READING",88,4,0,7,99
1924725,1547060,2025-04-14,Senate,"Senate: Aeronautics & Transportation Committee: DO PASS",11,0,0,0,11
1924725,1563746,2025-05-01,Senate,"Senate: THIRD READING",43,0,0,4,47
1924729,1488091,2025-02-12,House,"House: Public Health Committee: DO PASS",6,0,0,0,6
1924729,1499931,2025-02-26,House,"House: Health and Human Services Oversight Committee: DO PASS",10,1,0,0,11
1924729,1509167,2025-03-10,House,"House: THIRD READING",80,12,0,7,99
1924731,1486194,2025-02-11,House,"House: General Government Committee: DO PASS",8,0,0,0,8
1924731,1507638,2025-03-06,House,"House: Government Oversight Committee: DO PASS",13,0,0,0,13
1924731,1528436,2025-03-26,House,"House: THIRD READING",84,0,0,15,99
1924731,1548310,2025-04-15,Senate,"Senate: Judiciary Committee: DO PASS AMENDED CS",6,0,0,0,6
1924731,1564910,2025-05-05,Senate,"Senate: THIRD READING",44,0,0,3,47
1924731,1575369,2025-05-21,House,"House: FOURTH READING",88,0,0,10,98
1924736,1497986,2025-02-24,House,"House: Public Safety Committee: DO PASS AS AMENDED BY CS",7,0,0,0,7
1924736,1501058,2025-02-27,House,"House: Judiciary and Public Safety Oversight Committee: DO PASS AS AMENDED BY CS",11,0,0,0,11
1924736,1518679,2025-03-17,House,"House: THIRD READING",59,24,0,16,99
1924736,1551680,2025-04-17,Senate,"Senate: Technology & Telecommunications Committee: DO PASS",8,0,0,0,8
1924736,1566144,2025-05-06,Senate,"Senate: THIRD READING",31,12,0,4,47
1924736,1580991,2025-05-29,House,"House: VETO OVERRIDE WITHOUT EMERGENCY",68,21,0,9,98
1924736,1581960,2025-05-29,Senate,"Senate: VETO OVERRIDE NO EMERGENCY",38,7,0,3,48
1924746,1497671,2025-02-24,Senate,"Senate: Revenue & Taxation Committee: DO PASS",8,0,0,0,8
1924746,1513299,2025-03-11,Senate,"Senate: THIRD READING",47,0,0,0,47
1924746,1538454,2025-04-07,House,"House: Appropriations and Budget General Government Subcommittee: DO PASS",5,1,0,0,6
1924746,1563334,2025-05-01,House,"House: THIRD READING",79,6,0,13,98
1924746,1596176,2025-02-24,Senate,"Senate: Aeronautics & Transportation Committee: DO PASS AMENDED CS",8,0,0,0,8
1924746,1596177,2025-04-16,House,"House: Appropriations and Budget Committee: DO PASS",27,0,0,0,27
1924753,1486630,2025-02-11,House,"House: Business Committee: DO PASS",9,0,0,0,9
1924753,1504531,2025-03-04,House,"House: Commerce and Economic Development Oversight Committee: DO PASS",14,1,0,0,15
1924753,1519502,2025-03-18,House,"House: THIRD READING",74,3,0,22,99
1924753,1552576,2025-04-21,Senate,"Senate: Health & Human Services Committee: DO PASS",10,0,0,0,10
1924753,1561947,2025-04-30,Senate,"Senate: THIRD READING",34,10,0,3,47
1924768,1486295,2025-02-11,House,"House: Business Committee: DO PASS",7,0,0,0,7
1924768,1504403,2025-03-04,House,"House: Commerce and Economic Development Oversight Committee: DO PASS",13,0,0,0,13
1924768,1527076,2025-03-25,House,"House: THIRD READING",88,0,0,11,99
1924768,1538684,2025-04-07,Senate,"Senate: Aeronautics & Transportation Committee: DO PASS",10,0,0,0,10
1924768,1563770,2025-05-01,Senate,"Senate: THIRD READING",43,0,0,4,47
1924778,1497461,2025-02-24,House,"House: General Government Committee: DO PASS AS AMENDED BY CS",7,0,0,0,7
1924778,1507504,2025-03-06,House,"House: Government Oversight Committee: DO PASS AS AMENDED BY CS",14,0,0,0,14
1924778,1527786,2025-03-25,House,"House: THIRD READING",89,0,0,10,99
1924778,1550965,2025-04-17,Senate,"Senate: Business & Insurance Committee: DO PASS",9,0,0,0,9
1924781,1497936,2025-02-24,House,"House: Agriculture Committee: DO PASS AS AMENDED BY CS",6,0,0,0,6
1924783,1504653,2025-03-04,Senate,"Senate: Public Safety Committee: DO PASS AMENDED",3,4,0,0,7
1924788,1487868,2025-02-12,House,"House: Appropriations and Budget Committee: DO PASS",29,0,0,0,29
1924788,1500861,2025-02-26,House,"House: THIRD READING",90,3,0,6,99
1924788,1555378,2025-04-23,Senate,"Senate: Appropriations Committee: DO PASS",25,0,0,0,25
1924800,1482812,2025-02-05,House,"House: Common Education Committee: DO PASS",10,1,0,0,11
1924804,1493163,2025-02-17,House,"House: Appropriations and Budget Judiciary Subcommittee: DO PASS AS AMENDED BY CS",6,2,0,0,8
1924804,1506384,2025-03-05,House,"House: Appropriations and Budget Committee: DO PASS AS AMENDED BY CS",31,0,0,0,31
1924804,1528849,2025-03-27,House,"House: THIRD READING",75,13,0,11,99
1924804,1540061,2025-04-08,Senate,"Senate: Judiciary Committee: DO PASS AMENDED",9,0,0,0,9
1924804,1566568,2025-05-06,Senate,"Senate: THIRD READING",42,1,0,4,47
1924804,1572000,2025-05-15,House,"House: FOURTH READING",51,32,0,15,98
1924804,1572001,2025-05-15,House,"House: EMERGENCY",41,37,0,20,98
1924804,1596134,2025-04-16,Senate,"Senate: Appropriations Committee: DO PASS",19,0,0,0,19
1924811,1494877,2025-02-20,House,"House: Civil Judiciary Committee: DO PASS",9,0,0,0,9
1924811,1507637,2025-03-06,House,"House: Judiciary and Public Safety Oversight Committee: DO PASS",10,1,0,0,11
1924811,1527430,2025-03-25,House,"House: THIRD READING",75,16,0,8,99
1924811,1553775,2025-04-22,Senate,"Senate: Judiciary Committee: DO PASS",7,1,0,0,8
1924811,1568728,2025-05-08,Senate,"Senate: THIRD READING",27,19,0,1,47
1924811,1574995,2025-05-21,House,"House: FOURTH READING",58,29,0,11,98
1924811,1581427,2025-05-29,House,"House: VETO OVERRIDE WITHOUT EMERGENCY",70,18,0,10,98
1924811,1581946,2025-05-29,Senate,"Senate: VETO OVERRIDE NO EMERGENCY",37,8,0,3,48
1924812,1494660,2025-02-20,Senate,"Senate: Business & Insurance Committee: DO PASS",10,0,0,0,10
1924816,1493665,2025-02-19,Senate,"Senate: Economic Development, Workforce & Tourism Committee: DO PASS",8,1,0,0,9
1924816,1524873,2025-03-24,Senate,"Senate: THIRD READING",43,3,0,1,47
1924816,1539840,2025-04-08,House,"House: Business Committee: DO PASS",7,0,0,0,7
1924816,1565043,2025-05-05,House,"House: THIRD READING",90,0,0,8,98
1924816,1596409,2025-04-17,House,"House: Commerce and Economic Development Oversight Committee: DO PASS",16,0,0,0,16
1924830,1497717,2025-02-24,Senate,"Senate: Health & Human Services Committee: DO PASS AMENDED",11,0,0,0,11
1924831,1501341,2025-02-27,Senate,"Senate: Business & Insurance Committee: DO PASS",10,0,0,0,10
1924831,1520389,2025-03-18,Senate,"Senate: THIRD READING",45,0,0,2,47
1924831,1540046,2025-04-08,House,"House: Banking, Financial Services and Pensions Committee: DO PASS",9,0,0,0,9
1924831,1550261,2025-04-16,House,"House: THIRD READING",86,0,1,11,98
1924831,1596169,2025-04-15,House,"House: Government Oversight Committee: DO PASS",16,0,0,0,16
1924832,1497628,2025-02-24,House,"House: Business Committee: DO PASS AS AMENDED BY CS",5,1,0,0,6
1924839,1483244,2025-02-06,House,"House: Transportation Committee: DO PASS",11,0,0,0,11
1924839,1498612,2025-02-25,House,"House: Commerce and Economic Development Oversight Committee: DO PASS",15,0,0,0,15
1924839,1511230,2025-03-10,House,"House: THIRD READING",90,0,0,9,99
1924847,1490822,2025-02-17,House,"House: Appropriations and Budget Human Services Subcommittee: DO PASS",5,0,0,0,5
1924847,1506570,2025-03-05,House,"House: Appropriations and Budget Committee: DO PASS AS AMENDED, STRIKE THE TITLE",32,0,0,0,32
1924847,1525030,2025-03-24,House,"House: THIRD READING",90,4,0,5,99
1924847,1547979,2025-04-14,Senate,"Senate: Health & Human Services Committee: DO PASS AMENDED",10,0,0,0,10
1924847,1596123,2025-04-23,Senate,"Senate: Appropriations Committee: DO PASS",25,0,0,0,25
1924863,1499509,2025-02-25,House,"House: Appropriations and Budget Committee: DO PASS AS AMENDED, STRIKE THE TITLE",29,4,0,0,33
1924863,1509534,2025-03-10,House,"House: THIRD READING",73,16,0,10,99
1924867,1498957,2025-02-25,House,"House: Rules Committee: DO PASS AS AMENDED BY CS",9,1,0,0,10
1924867,1509285,2025-03-10,House,"House: THIRD READING",78,11,1,9,99
1924867,1544555,2025-04-10,Senate,"Senate: Veterans & Military Affairs Committee: DO PASS",6,3,0,0,9
1924867,1568566,2025-05-08,Senate,"Senate: THIRD READING",32,14,0,1,47
1924867,1596129,2025-04-23,Senate,"Senate: Appropriations Committee: DO PASS AMENDED",16,5,1,0,22
1924870,1489187,2025-02-13,House,"House: Civil Judiciary Committee: DO PASS",8,0,0,0,8
1924870,1504553,2025-03-04,House,"House: Judiciary and Public Safety Oversight Committee: DO PASS",14,0,0,0,14
1924870,1525025,2025-03-24,House,"House: THIRD READING",89,0,0,10,99
1924870,1549211,2025-04-15,Senate,"Senate: Judiciary Committee: DO PASS",8,0,0,0,8
1924870,1563907,2025-05-01,Senate,"Senate: THIRD READING",44,0,0,3,47
1924877,1479621,2025-02-04,House,"House: General Government Committee: DO PASS",8,0,0,0,8
1924877,1504176,2025-03-04,House,"House: Government Oversight Committee: DO PASS",11,4,0,0,15
1924877,1526617,2025-03-25,House,"House: THIRD READING",80,9,0,10,99
1924877,1540683,2025-04-08,Senate,"Senate: Judiciary Committee: DO PASS",7,0,0,0,7
1924877,1565283,2025-05-05,Senate,"Senate: THIRD READING",40,5,0,2,47
1924877,1581414,2025-05-29,House,"House: VETO OVERRIDE WITH EMERGENCY",76,13,0,9,98
1924877,1581962,2025-05-29,Senate,"Senate: VETO OVERRIDE WITH EMERGENCY",37,8,0,3,48
1924880,1487901,2025-02-12,House,"House: Children, Youth and Family Services Committee: DO PASS AS AMENDED BY CS",5,0,0,0,5
1924880,1506072,2025-03-05,House,"House: Health and Human Services Oversight Committee: DO PASS AS AMENDED BY CS",11,0,0,0,11
1924880,1513287,2025-03-11,House,"House: THIRD READING",88,4,0,7,99
1924880,1538609,2025-04-07,Senate,"Senate: Health & Human Services Committee: DO PASS",13,0,0,0,13
1924882,1494719,2025-02-20,House,"House: Veterans and Military Affairs Committee: DO PASS AS AMENDED BY CS",7,0,0,0,7
1924882,1505642,2025-03-05,House,"House: Health and Human Services Oversight Committee: DO PASS AS AMENDED BY CS",11,0,0,0,11
1924882,1528801,2025-03-26,House,"House: THIRD READING",92,1,0,6,99
1924882,1543637,2025-04-10,Senate,"Senate: Veterans & Military Affairs Committee: DO PASS AMENDED",6,0,0,0,6
1924882,1568355,2025-05-08,Senate,"Senate: THIRD READING",46,0,0,1,47
1924882,1596128,2025-04-16,Senate,"Senate: Appropriations Committee: DO PASS",17,3,0,0,20
1924889,1493804,2025-02-19,House,"House: Energy Committee: DO PASS",11,0,0,0,11
1924889,1499749,2025-02-26,House,"House: Energy and Natural Resources Oversight Committee: DO PASS",13,1,0,0,14
1924889,1528937,2025-03-27,House,"House: THIRD READING",60,30,0,9,99
1924889,1555587,2025-04-23,Senate,"Senate: Appropriations Committee: DO PASS AMENDED",22,2,0,0,24
1924895,1494961,2025-02-20,House,"House: Appropriations and Budget Finance Subcommittee: DO PASS AS AMENDED BY CS",9,0,0,0,9
1924895,1505244,2025-03-04,House,"House: Appropriations and Budget Committee: DO PASS AS AMENDED BY CS",29,1,0,0,30
1924895,1527816,2025-03-26,House,"House: THIRD READING",91,2,0,6,99
1924897,1501347,2025-02-27,Senate,"Senate: Business & Insurance Committee: DO PASS AMENDED CS",10,0,0,0,10
1924897,1527991,2025-03-26,Senate,"Senate: THIRD READING",47,0,0,0,47
1924897,1543461,2025-04-10,House,"House: Civil Judiciary Committee: DO PASS",8,0,0,0,8
1924897,1565068,2025-05-05,House,"House: THIRD READING",91,0,0,7,98
1924897,1596172,2025-04-17,House,"House: Judiciary and Public Safety Oversight Committee: DO PASS",9,0,0,0,9
1924912,1491309,2025-02-17,House,"House: Appropriations and Budget Education Subcommittee: DO PASS",9,1,0,0,10
1924918,1497666,2025-02-24,House,"House: Public Safety Committee: DO PASS",7,0,0,0,7
1924918,1507609,2025-03-06,House,"House: Judiciary and Public Safety Oversight Committee: DO PASS",9,2,0,0,11
1924918,1518932,2025-03-17,House,"House: THIRD READING",83,0,0,16,99
1924918,1553896,2025-04-22,Senate,"Senate: Judiciary Committee: DO PASS",8,0,0,0,8
1924918,1564323,2025-05-01,Senate,"Senate: THIRD READING",46,0,0,1,47
1924919,1504812,2025-03-04,Senate,"Senate: Judiciary Committee: DO PASS",8,0,0,0,8
1924927,1491250,2025-02-17,Senate,"Senate: Agriculture & Wildlife Committee: DO PASS",12,0,0,0,12
1924939,1480172,2025-02-04,House,"House: Utilities Committee: DO PASS AS AMENDED BY CS",9,0,0,0,9
1924939,1499734,2025-02-26,House,"House: Energy and Natural Resources Oversight Committee: DO PASS AS AMENDED BY CS",13,2,0,0,15
1924939,1506420,2025-03-05,House,"House: THIRD READING",82,11,0,6,99
1924939,1556743,2025-04-24,Senate,"Senate: Energy Committee: DO PASS AMENDED",8,2,0,0,10
1924939,1568582,2025-05-08,Senate,"Senate: THIRD READING",44,1,0,2,47
1924954,1503941,2025-03-03,Senate,"Senate: Revenue & Taxation Committee: DO PASS",6,4,0,0,10
1924960,1498963,2025-02-25,Senate,"Senate: Judiciary Committee: DO PASS",6,1,0,0,7
1924960,1529577,2025-03-27,Senate,"Senate: THIRD READING",18,26,0,3,47
1924970,1486171,2025-02-11,House,"House: Criminal Judiciary Committee: DO PASS",5,0,0,0,5
1924970,1504462,2025-03-04,House,"House: Judiciary and Public Safety Oversight Committee: DO PASS",13,0,0,0,13
1924970,1514470,2025-03-11,House,"House: THIRD READING",85,0,0,14,99
1924970,1540138,2025-04-08,Senate,"Senate: Judiciary Committee: DO PASS",7,0,0,0,7
1924970,1562711,2025-04-30,Senate,"Senate: THIRD READING",46,0,0,1,47
1924972,1495250,2025-02-20,House,"House: Civil Judiciary Committee: DO PASS",9,0,0,0,9
1924976,1487128,2025-02-11,House,"House: Criminal Judiciary Committee: DO PASS",5,0,0,0,5
1924976,1501900,2025-02-27,House,"House: Judiciary and Public Safety Oversight Committee: DO PASS",13,0,0,0,13
1924976,1526119,2025-03-24,House,"House: THIRD READING",86,6,0,7,99
1924976,1539369,2025-04-08,Senate,"Senate: Public Safety Committee: DO PASS",7,0,0,0,7
1924976,1563316,2025-04-30,Senate,"Senate: THIRD READING",40,1,0,6,47
1924981,1486131,2025-02-11,House,"House: General Government Committee: DO PASS",7,0,0,0,7
1924981,1504296,2025-03-04,House,"House: Government Oversight Committee: DO PASS",13,0,0,0,13
1924981,1513020,2025-03-11,House,"House: THIRD READING",83,3,0,13,99
1924981,1554884,2025-04-22,Senate,"Senate: Local & County Government Committee: DO PASS AMENDED CS",7,1,0,0,8
1924981,1565500,2025-05-06,Senate,"Senate: THIRD READING",43,2,0,2,47
1924981,1572204,2025-05-15,House,"House: FOURTH READING",79,3,0,16,98
1924985,1500599,2025-02-26,House,"House: Appropriations and Budget Committee: DO PASS",27,0,0,0,27
1924985,1517422,2025-03-13,House,"House: THIRD READING",80,5,0,14,99
1924985,1538670,2025-04-07,Senate,"Senate: Aeronautics & Transportation Committee: DO PASS",11,0,0,0,11
1924985,1596137,2025-04-23,Senate,"Senate: Appropriations Committee: DO PASS AMENDED",24,0,0,0,24
1924996,1494061,2025-02-19,House,"House: Common Education Committee: DO PASS",11,0,0,0,11
1924996,1503985,2025-03-03,House,"House: Education Oversight Committee: DO PASS",9,0,0,0,9
1924996,1528180,2025-03-26,House,"House: THIRD READING",92,0,0,7,99
1924996,1548140,2025-04-15,Senate,"Senate: Education Committee: DO PASS",11,0,0,0,11
1924996,1566515,2025-05-06,Senate,"Senate: THIRD READING",45,0,0,2,47
1925002,1507101,2025-03-06,Senate,"Senate: Business & Insurance Committee: DO PASS",10,0,0,0,10
1925002,1529256,2025-03-27,Senate,"Senate: THIRD READING",45,0,0,2,47
1925002,1542215,2025-04-09,House,"House: Alcohol, Tobacco and Controlled Substances Committee: DO PASS",8,0,0,0,8
1925002,1565207,2025-05-05,House,"House: THIRD READING",89,2,0,7,98
1925002,1596170,2025-04-21,House,"House: Health and Human Services Oversight Committee: DO PASS",13,0,0,0,13
1925004,1486562,2025-02-11,House,"House: Banking, Financial Services and Pensions Committee: DO PASS",8,0,0,0,8
1925004,1505007,2025-03-04,House,"House: Government Oversight Committee: DO PASS",14,0,0,0,14
1925004,1527204,2025-03-25,House,"House: THIRD READING",87,0,0,12,99
1925004,1540467,2025-04-08,Senate,"Senate: Judiciary Committee: DO PASS",6,0,0,0,6
1925004,1566927,2025-05-06,Senate,"Senate: THIRD READING",44,0,0,3,47
1925013,1499553,2025-02-25,House,"House: Rules Committee: DO PASS",10,0,0,0,10
1925013,1509312,2025-03-10,House,"House: THIRD READING",86,3,0,10,99
1925018,1499597,2025-02-24,Senate,"Senate: Revenue & Taxation Committee: DO PASS",11,0,0,0,11
1925018,1530070,2025-03-27,Senate,"Senate: THIRD READING",42,0,0,5,47
1925018,1543752,2025-04-10,House,"House: Appropriations and Budget Finance Subcommittee: DO PASS",7,0,0,0,7
1925018,1567470,2025-05-07,House,"House: THIRD READING",85,4,0,9,98
1925018,1596179,2025-04-16,House,"House: Appropriations and Budget Committee: DO PASS",20,8,0,0,28
1925035,1494276,2025-02-19,House,"House: Criminal Judiciary Committee: DO PASS",5,0,0,0,5
1925035,1507646,2025-03-06,House,"House: Judiciary and Public Safety Oversight Committee: DO PASS AS AMENDED BY CS",8,3,0,0,11
1925035,1526191,2025-03-25,House,"House: THIRD READING",62,32,0,5,99
1925035,1551674,2025-04-17,Senate,"Senate: Technology & Telecommunications Committee: DO PASS AMENDED",8,0,0,0,8
1925040,1497683,2025-02-24,Senate,"Senate: Revenue & Taxation Committee: DO PASS",9,2,0,0,11
1925043,1498187,2025-02-24,House,"House: Public Health Committee: DO PASS AS AMENDED BY CS",8,0,0,0,8
1925043,1506476,2025-03-05,House,"House: Health and Human Services Oversight Committee: DO PASS AS AMENDED BY CS",15,0,0,0,15
1925043,1525232,2025-03-24,House,"House: THIRD READING",84,6,0,9,99
1925043,1547510,2025-04-14,Senate,"Senate: Health & Human Services Committee: DO PASS",12,0,0,0,12
1925043,1562449,2025-04-30,Senate,"Senate: THIRD READING",46,0,0,1,47
1925047,1492951,2025-02-17,House,"House: Appropriations and Budget General Government Subcommittee: DO PASS AS AMENDED BY CS",5,1,0,0,6
1925047,1505861,2025-03-04,House,"House: Appropriations and Budget Committee: DO PASS AS AMENDED BY CS",29,0,0,0,29
1925047,1516899,2025-03-13,House,"House: THIRD READING",77,4,0,18,99
1925047,1539050,2025-04-07,Senate,"Senate: Revenue & Taxation Committee: DO PASS",8,2,0,0,10
1925047,1561671,2025-04-30,Senate,"Senate: THIRD READING",43,0,0,4,47
1925053,1504678,2025-03-04,House,"House: Rules Committee: DO PASS AS AMENDED BY CS",10,0,0,0,10
1925059,1486075,2025-02-11,House,"House: General Government Committee: DO PASS",6,0,0,0,6
1925059,1504987,2025-03-04,House,"House: Government Oversight Committee: DO PASS",16,0,0,0,16
1925059,1517602,2025-03-13,House,"House: THIRD READING",83,0,0,16,99
1925059,1539319,2025-04-08,Senate,"Senate: Retirement & Government Resources Committee: DO PASS AMENDED",8,0,0,0,8
1925059,1554311,2025-04-22,Senate,"Senate: THIRD READING",42,0,0,5,47
1925059,1572022,2025-05-15,House,"House: FOURTH READING",81,4,0,13,98
1925059,1596126,2025-04-08,Senate,"Senate: Retirement & Government Resources Committee: DO PASS",8,0,0,0,8
1925061,1486326,2025-02-11,House,"House: General Government Committee: DO PASS",7,0,0,0,7
1925061,1507203,2025-03-06,House,"House: Government Oversight Committee: DO PASS",16,0,0,0,16
1925061,1527508,2025-03-26,House,"House: THIRD READING",96,0,0,3,99
1925061,1554963,2025-04-22,Senate,"Senate: Judiciary Committee: DO PASS",8,0,0,0,8
1925062,1484731,2025-02-10,House,"House: Appropriations and Budget Natural Resources Subcommittee: DO PASS",7,2,0,0,9
1925062,1506652,2025-03-05,House,"House: Appropriations and Budget Committee: DO PASS AS AMENDED, STRIKE THE TITLE",32,0,0,0,32
1925062,1528338,2025-03-26,House,"House: THIRD READING",73,20,0,6,99
1925062,1556482,2025-04-24,Senate,"Senate: Energy Committee: DO PASS AMENDED",9,2,0,0,11
1925062,1567246,2025-05-07,Senate,"Senate: THIRD READING",21,22,0,4,47
1925062,1596130,2025-05-07,Senate,"Senate: RECONSIDER",43,0,0,4,47
1925080,1506491,2025-03-05,House,"House: Rules Committee: DO PASS AS AMENDED BY CS",9,0,0,0,9
1925080,1513791,2025-03-11,House,"House: THIRD READING",68,18,0,13,99
1925080,1516380,2025-03-12,House,"House: RECONSIDER MEASURE",67,0,0,32,99
1925088,1501275,2025-02-27,Senate,"Senate: Technology & Telecommunications Committee: DO PASS AMENDED",7,0,0,0,7
1925088,1529688,2025-03-27,Senate,"Senate: THIRD READING",41,4,0,2,47
1925088,1541048,2025-04-08,House,"House: Banking, Financial Services and Pensions Committee: DO PASS AS AMENDED BY CS",8,0,0,0,8
1925088,1562697,2025-04-30,House,"House: THIRD READING",84,2,1,11,98
1925088,1580900,2025-05-29,Senate,"Senate: VETO OVERRIDE NO EMERGENCY",37,9,0,2,48
1925088,1581966,2025-05-29,House,"House: VETO OVERRIDE WITHOUT EMERGENCY",78,4,0,16,98
1925088,1591671,2025-05-15,Senate,"Senate: FOURTH READING",28,15,0,4,47
1925088,1596174,2025-04-24,House,"House: Government Oversight Committee: DO PASS AS AMENDED BY CS",14,1,0,0,15
1925103,1489122,2025-02-12,House,"House: Common Education Committee: DO PASS",12,0,0,0,12
1925103,1500005,2025-02-26,House,"House: Education Oversight Committee: DO PASS AS AMENDED BY CS",9,0,0,0,9
1925103,1519359,2025-03-17,House,"House: THIRD READING",80,1,0,18,99
1925103,1566969,2025-04-15,Senate,"Senate: Education Committee: DO PASS",11,0,0,0,11
1925103,1566970,2025-05-06,Senate,"Senate: THIRD READING",46,0,0,1,47
1925119,1493014,2025-02-17,House,"House: Appropriations and Budget Judiciary Subcommittee: DO PASS AS AMENDED BY CS",6,2,0,0,8
1925119,1506832,2025-03-05,House,"House: Appropriations and Budget Committee: DO PASS AS AMENDED BY CS",31,0,0,0,31
1925123,1490907,2025-02-17,House,"House: Appropriations and Budget Natural Resources Subcommittee: DO PASS AS AMENDED BY CS",7,3,0,0,10
1925123,1506838,2025-03-04,House,"House: Appropriations and Budget Committee: DO PASS AS AMENDED BY CS",27,2,0,0,29
1925123,1526504,2025-03-25,House,"House: THIRD READING",68,23,0,8,99
1925123,1540216,2025-04-08,Senate,"Senate: Economic Development, Workforce & Tourism Committee: DO PASS AMENDED",7,2,0,0,9
1925123,1565575,2025-05-06,Senate,"Senate: THIRD READING",31,14,0,2,47
1925123,1572236,2025-05-15,House,"House: FOURTH READING",58,27,0,13,98
1925123,1596127,2025-04-23,Senate,"Senate: Appropriations Committee: DO PASS",21,2,0,0,23
1925129,1497676,2025-02-24,House,"House: Business Committee: DO PASS AS AMENDED BY CS",6,0,0,0,6
1925129,1507625,2025-03-06,House,"House: Commerce and Economic Development Oversight Committee: DO PASS AS AMENDED BY CS",15,1,0,0,16
1925129,1526253,2025-03-25,House,"House: THIRD READING",81,9,0,9,99
1925129,1550960,2025-04-17,Senate,"Senate: Business & Insurance Committee: DO PASS",9,0,0,0,9
1925129,1567234,2025-05-07,Senate,"Senate: THIRD READING",38,7,0,2,47
1925136,1488133,2025-02-12,House,"House: Common Education Committee: DO PASS",11,0,0,0,11
1925136,1499732,2025-02-26,House,"House: Education Oversight Committee: DO PASS AS AMENDED BY CS",9,0,0,0,9
1925136,1527094,2025-03-25,House,"House: THIRD READING",76,13,0,10,99
1925136,1553899,2025-04-22,Senate,"Senate: Education Committee: DO PASS",8,1,0,0,9
1925138,1495789,2025-02-20,House,"House: Appropriations and Budget Finance Subcommittee: DO PASS AS AMENDED BY CS",5,4,0,0,9
1925166,1493423,2025-02-17,House,"House: Appropriations and Budget Health Subcommittee: DO PASS",6,0,0,0,6
1925166,1506369,2025-03-05,House,"House: Appropriations and Budget Committee: DO PASS",31,0,0,0,31
1925166,1525510,2025-03-24,House,"House: THIRD READING",75,14,0,10,99
1925166,1552561,2025-04-21,Senate,"Senate: Health & Human Services Committee: DO PASS",10,0,0,0,10
1925166,1561964,2025-04-30,Senate,"Senate: THIRD READING",33,11,0,3,47
1925178,1486903,2025-02-11,House,"House: General Government Committee: DO PASS AS AMENDED BY CS",7,0,0,0,7
1925178,1501370,2025-02-27,House,"House: Government Oversight Committee: DO PASS AS AMENDED BY CS",15,0,0,0,15
1925178,1528334,2025-03-26,House,"House: THIRD READING",90,3,0,6,99
1925184,1494647,2025-02-20,Senate,"Senate: Business & Insurance Committee: DO PASS AMENDED",10,0,0,0,10
1925211,1486973,2025-02-11,House,"House: Rules Committee: DO PASS AS AMENDED BY CS",8,2,0,0,10
1925211,1527344,2025-03-25,House,"House: THIRD READING",51,37,0,11,99
1925213,1489123,2025-02-13,House,"House: Civil Judiciary Committee: DO PASS",8,0,0,0,8
1925213,1507146,2025-03-06,House,"House: Judiciary and Public Safety Oversight Committee: DO PASS",13,0,0,0,13
1925213,1528072,2025-03-26,House,"House: THIRD READING",83,8,0,8,99
1925213,1547175,2025-04-14,Senate,"Senate: Health & Human Services Committee: DO PASS AMENDED",12,1,0,0,13
1925213,1568151,2025-05-08,Senate,"Senate: THIRD READING",40,5,0,2,47
1925213,1580966,2025-05-29,House,"House: VETO OVERRIDE WITHOUT EMERGENCY",79,9,0,10,98
1925213,1581942,2025-05-29,Senate,"Senate: VETO OVERRIDE NO EMERGENCY",42,3,0,3,48
1925213,1596124,2025-04-23,Senate,"Senate: Appropriations Committee: DO PASS",22,1,0,0,23
1925214,1501433,2025-02-27,Senate,"Senate: Business & Insurance Committee: DO PASS",10,0,0,0,10
1925214,1519408,2025-03-18,Senate,"Senate: THIRD READING",45,0,0,2,47
1925214,1539291,2025-04-08,House,"House: Business Committee: DO PASS",6,0,0,0,6
1925214,1549113,2025-04-15,House,"House: Commerce and Economic Development Oversight Committee: DO PASS AS AMENDED BY CS",18,0,0,0,18
1925214,1566799,2025-05-06,House,"House: THIRD READING",89,4,0,5,98
1925214,1591351,2025-05-14,Senate,"Senate: FOURTH READING",39,2,0,6,47
1925218,1494990,2025-02-20,House,"House: Civil Judiciary Committee: DO PASS AS AMENDED BY CS",8,0,0,0,8
1925227,1504661,2025-03-04,House,"House: Rules Committee: DO PASS AS AMENDED BY CS",10,0,0,0,10
1925227,1517071,2025-03-13,House,"House: THIRD READING",84,0,0,15,99
1925227,1553806,2025-04-22,Senate,"Senate: Judiciary Committee: DO PASS",8,0,0,0,8
1925227,1559363,2025-04-28,Senate,"Senate: THIRD READING",44,0,0,3,47
1925230,1482402,2025-02-05,House,"House: Common Education Committee: DO PASS",11,0,0,0,11
1925230,1505950,2025-03-05,House,"House: Education Oversight Committee: DO PASS AS AMENDED BY CS",9,0,0,0,9
1925230,1513277,2025-03-11,House,"House: THIRD READING",87,0,0,12,99
1925235,1497707,2025-02-24,House,"House: Business Committee: DO PASS AS AMENDED BY CS",6,0,0,0,6
1925235,1505267,2025-03-04,House,"House: Commerce and Economic Development Oversight Committee: DO PASS AS AMENDED BY CS",13,3,0,0,16
1925243,1490742,2025-02-17,House,"House: Appropriations and Budget Natural Resources Subcommittee: DO PASS AS AMENDED BY CS",9,1,0,0,10
1925243,1506370,2025-03-05,House,"House: Appropriations and Budget Committee: DO PASS AS AMENDED BY CS",30,3,0,0,33
1925243,1525809,2025-03-25,House,"House: THIRD READING",80,11,0,8,99
1925243,1541005,2025-04-08,Senate,"Senate: Economic Development, Workforce & Tourism Committee: DO PASS",7,0,0,0,7
1925243,1566572,2025-05-06,Senate,"Senate: THIRD READING",33,12,0,2,47
1925243,1580977,2025-05-29,House,"House: VETO OVERRIDE WITH EMERGENCY",76,13,0,9,98
1925243,1582125,2025-05-29,Senate,"Senate: VETO OVERRIDE WITH EMERGENCY",36,9,0,3,48
1925243,1596140,2025-04-16,Senate,"Senate: Appropriations Committee: DO PASS AMENDED",21,1,0,0,22
1925245,1503317,2025-03-03,Senate,"Senate: Revenue & Taxation Committee: DO PASS AMENDED CS",9,1,0,0,10
1925245,1526726,2025-03-25,Senate,"Senate: THIRD READING",37,9,0,1,47
1925245,1548273,2025-04-15,House,"House: Rules Committee: DO PASS AS AMENDED, STRIKE THE TITLE",8,2,0,0,10
1925255,1483104,2025-02-06,House,"House: Civil Judiciary Committee: DO PASS",9,0,0,0,9
1925255,1501423,2025-02-27,House,"House: Judiciary and Public Safety Oversight Committee: DO PASS",12,0,0,0,12
1925255,1525374,2025-03-24,House,"House: THIRD READING",92,0,0,7,99
1925255,1555386,2025-04-22,Senate,"Senate: Judiciary Committee: DO PASS",8,0,0,0,8
1925255,1563564,2025-05-01,Senate,"Senate: THIRD READING",42,0,0,5,47
1925268,1493468,2025-02-19,House,"House: Criminal Judiciary Committee: DO PASS",5,1,0,0,6
1925268,1501025,2025-02-27,House,"House: Judiciary and Public Safety Oversight Committee: DO PASS",9,1,0,0,10
1925268,1509053,2025-03-10,House,"House: THIRD READING",81,12,0,6,99
1925268,1547429,2025-04-14,Senate,"Senate: Health & Human Services Committee: DO PASS AMENDED",10,2,0,0,12
1925271,1505697,2025-03-05,House,"House: Rules Committee: DO PASS AS AMENDED BY CS",9,0,0,0,9
1925271,1527887,2025-03-26,House,"House: THIRD READING",75,17,0,7,99
1925271,1552559,2025-04-21,Senate,"Senate: Health & Human Services Committee: DO PASS AMENDED",8,2,0,0,10
1925271,1567572,2025-05-07,Senate,"Senate: THIRD READING",31,14,0,2,47
1925272,1498965,2025-02-24,House,"House: Business Committee: DO PASS AS AMENDED BY CS",7,0,0,0,7
1925272,1507490,2025-03-06,House,"House: Commerce and Economic Development Oversight Committee: DO PASS AS AMENDED BY CS",15,0,0,0,15
1925272,1527909,2025-03-25,House,"House: THIRD READING",89,2,0,8,99
1925272,1551140,2025-04-17,Senate,"Senate: Business & Insurance Committee: DO PASS",9,0,0,0,9
1925272,1562184,2025-04-30,Senate,"Senate: THIRD READING",44,0,0,3,47
1925297,1497674,2025-02-24,House,"House: Agriculture Committee: DO PASS AS AMENDED BY CS",5,2,0,0,7
1925297,1503643,2025-03-03,House,"House: Energy and Natural Resources Oversight Committee: DO PASS AS AMENDED BY CS",10,3,0,0,13
1925300,1504938,2025-03-04,Senate,"Senate: Judiciary Committee: DO PASS AMENDED CS",8,0,0,0,8
1925300,1515885,2025-03-12,Senate,"Senate: THIRD READING",42,0,0,5,47
1925300,1539688,2025-04-08,House,"House: Criminal Judiciary Committee: DO PASS",4,0,0,0,4
1925300,1563930,2025-05-01,House,"House: THIRD READING",86,0,0,12,98
1925300,1581435,2025-05-29,Senate,"Senate: VETO OVERRIDE NO EMERGENCY",45,2,0,1,48
1925300,1581936,2025-05-29,House,"House: VETO OVERRIDE WITHOUT EMERGENCY",81,0,0,17,98
1925300,1596175,2025-04-17,House,"House: Judiciary and Public Safety Oversight Committee: DO PASS",12,0,0,0,12
1925301,1497662,2025-02-24,House,"House: Business Committee: DO PASS",6,0,0,0,6
1925320,1479454,2025-02-04,House,"House: Business Committee: DO PASS",9,0,0,0,9
1925320,1507187,2025-03-06,House,"House: Commerce and Economic Development Oversight Committee: DO PASS AS AMENDED BY CS",15,2,0,0,17
1925320,1526879,2025-03-25,House,"House: THIRD READING",53,45,0,1,99
1925321,1499122,2025-02-25,Senate,"Senate: Judiciary Committee: DO PASS AMENDED CS",6,1,0,0,7
1925321,1529637,2025-03-27,Senate,"Senate: THIRD READING",39,7,0,1,47
1925321,1539151,2025-04-07,House,"House: Elections and Ethics Committee: DO PASS",5,1,0,0,6
1925321,1548711,2025-04-15,House,"House: Government Oversight Committee: DO PASS AS AMENDED BY CS",12,2,0,0,14
1925321,1566747,2025-05-06,House,"House: THIRD READING",71,16,0,11,98
1925321,1591651,2025-05-20,Senate,"Senate: FOURTH READING",39,7,0,1,47
1925323,1490863,2025-02-17,Senate,"Senate: Agriculture & Wildlife Committee: DO PASS AMENDED CS",10,2,0,0,12
1925323,1525284,2025-03-24,Senate,"Senate: THIRD READING",39,7,0,1,47
1925323,1538749,2025-04-07,House,"House: Wildlife Committee: DO PASS",4,0,0,0,4
1925323,1563692,2025-05-01,House,"House: THIRD READING",69,15,0,14,98
1925323,1596171,2025-04-16,House,"House: Energy and Natural Resources Oversight Committee: DO PASS",12,0,0,0,12
1925328,1497956,2025-02-24,House,"House: Public Health Committee: DO PASS AS AMENDED BY CS",5,0,0,0,5
1925328,1505647,2025-03-05,House,"House: Health and Human Services Oversight Committee: DO PASS AS AMENDED BY CS",13,0,0,0,13
1925328,1527199,2025-03-24,House,"House: ,                  THIRD READING",92,1,0,6,99
1925328,1547523,2025-04-14,Senate,"Senate: Health & Human Services Committee: DO PASS AMENDED CS",11,0,0,0,11
1925328,1563829,2025-05-01,Senate,"Senate: THIRD READING",46,0,0,1,47
1925328,1576626,2025-05-22,House,"House: FOURTH READING",83,3,0,12,98
1925328,1591828,2025-05-28,Senate,"Senate: FOURTH READING",42,4,0,2,48
1925328,1596136,2025-03-24,House,"House: THIRD READING",92,1,0,6,99
1925344,1487810,2025-02-12,House,"House: Public Safety Committee: DO PASS",5,0,0,0,5
1925344,1504533,2025-03-04,House,"House: Judiciary and Public Safety Oversight Committee: DO PASS",10,0,0,0,10
1925344,1516860,2025-03-13,House,"House: THIRD READING",83,4,0,12,99
1925344,1539302,2025-04-08,Senate,"Senate: Public Safety Committee: DO PASS",8,0,0,0,8
1925344,1563583,2025-05-01,Senate,"Senate: THIRD READING",46,0,0,1,47
1925345,1493912,2025-02-17,House,"House: Appropriations and Budget Health Subcommittee: DO PASS AS AMENDED BY CS",5,1,0,0,6
1925349,1483758,2025-02-06,House,"House: Civil Judiciary Committee: DO PASS",9,0,0,0,9
1925353,1493831,2025-02-19,House,"House: Energy Committee: DO PASS AS AMENDED BY CS",10,0,0,0,10
1925353,1505838,2025-03-05,House,"House: Energy and Natural Resources Oversight Committee: DO PASS AS AMENDED BY CS",15,0,0,0,15
1925353,1527975,2025-03-26,House,"House: THIRD READING",73,23,0,3,99
1925353,1556769,2025-04-24,Senate,"Senate: Energy Committee: DO PASS",7,3,0,0,10
1925359,1497529,2025-02-24,House,"House: Public Safety Committee: DO PASS AS AMENDED BY CS",6,0,0,0,6
1925359,1504442,2025-03-04,House,"House: Judiciary and Public Safety Oversight Committee: DO PASS AS AMENDED BY CS",13,0,0,0,13
1925359,1525224,2025-03-24,House,"House: THIRD READING",88,2,0,9,99
1925372,1493666,2025-02-17,House,"House: Appropriations and Budget Health Subcommittee: DO PASS",6,0,0,0,6
1925378,1493222,2025-02-19,House,"House: Banking, Financial Services and Pensions Committee: DO PASS AS AMENDED BY CS",7,1,0,0,8
1925378,1507077,2025-03-06,House,"House: Government Oversight Committee: DO PASS AS AMENDED BY CS",12,1,0,0,13
1925378,1517195,2025-03-13,House,"House: THIRD READING",74,7,5,13,99
1925378,1548226,2025-04-15,Senate,"Senate: Retirement & Government Resources Committee: DO PASS AMENDED",8,0,0,0,8
1925378,1596138,2025-04-23,Senate,"Senate: Appropriations Committee: DO PASS",23,0,0,0,23
1925380,1493550,2025-02-19,House,"House: Energy Committee: DO PASS AS AMENDED BY CS",5,7,0,0,12
1925383,1495216,2025-02-20,House,"House: Civil Judiciary Committee: DO PASS AS AMENDED BY CS",9,0,0,0,9
1925383,1507344,2025-03-06,House,"House: Judiciary and Public Safety Oversight Committee: DO PASS AS AMENDED BY CS",11,0,0,0,11
1925383,1528088,2025-03-26,House,"House: THIRD READING",90,3,0,6,99
1925383,1549249,2025-04-15,Senate,"Senate: Judiciary Committee: DO PASS AMENDED",8,0,0,0,8
1925383,1567842,2025-05-07,Senate,"Senate: THIRD READING",45,0,0,2,47
1925383,1574855,2025-05-21,House,"House: FOURTH READING",91,0,0,7,98
1925407,1482146,2025-02-05,House,"House: Common Education Committee: DO PASS AS AMENDED BY CS",11,0,0,0,11
1925407,1500151,2025-02-26,House,"House: Education Oversight Committee: DO PASS AS AMENDED BY CS",9,0,0,0,9
1925407,1513896,2025-03-11,House,"House: THIRD READING",87,0,0,12,99
1925407,1563602,2025-04-15,Senate,"Senate: Education Committee: DO PASS AMENDED",11,0,0,0,11
1925407,1563603,2025-05-01,Senate,"Senate: THIRD READING",44,0,0,3,47
1925407,1574917,2025-05-21,House,"House: FOURTH READING",91,0,0,7,98
1925407,1591433,2025-05-21,Senate,"Senate: FOURTH READING",46,0,0,2,48
1925412,1491337,2025-02-17,House,"House: Elections and Ethics Committee: DO PASS AS AMENDED BY CS",5,1,0,0,6
1925412,1501399,2025-02-27,House,"House: Government Oversight Committee: DO PASS AS AMENDED BY CS",9,7,0,0,16
1925412,1527971,2025-03-26,House,"House: THIRD READING",67,28,0,4,99
1925412,1555248,2025-04-22,Senate,"Senate: Judiciary Committee: DO PASS",6,2,0,0,8
1925416,1506076,2025-03-05,House,"House: Administrative Rules Committee: DO PASS AS AMENDED BY CS",10,5,0,0,15
1925416,1526077,2025-03-25,House,"House: THIRD READING",52,41,0,6,99
1925416,1553054,2025-04-21,Senate,"Senate: Health & Human Services Committee: DO PASS",8,2,0,0,10
1925427,1491293,2025-02-17,Senate,"Senate: Revenue & Taxation Committee: DO PASS AMENDED CS",6,5,0,0,11
1925434,1497963,2025-02-24,House,"House: General Government Committee: DO PASS AS AMENDED BY CS",6,1,0,0,7
1925434,1507441,2025-03-06,House,"House: Government Oversight Committee: DO PASS AS AMENDED BY CS",12,2,0,0,14
1925434,1527339,2025-03-25,House,"House: THIRD READING",83,6,0,10,99
1925434,1551157,2025-04-17,Senate,"Senate: Business & Insurance Committee: DO PASS",9,0,0,0,9
1925434,1559345,2025-04-28,Senate,"Senate: THIRD READING",36,6,0,5,47
1925434,1580893,2025-05-29,House,"House: VETO OVERRIDE WITHOUT EMERGENCY",83,3,0,12,98
1925434,1581975,2025-05-29,Senate,"Senate: VETO OVERRIDE NO EMERGENCY",35,10,0,3,48
1925439,1484896,2025-02-10,House,"House: Appropriations and Budget Human Services Subcommittee: DO PASS",5,0,0,0,5
1925439,1498961,2025-02-25,House,"House: Appropriations and Budget Committee: DO PASS AS AMENDED BY CS",26,7,0,0,33
1925439,1525335,2025-03-24,House,"House: THIRD READING",59,30,0,10,99
1925439,1538164,2025-04-07,Senate,"Senate: Health & Human Services Committee: DO PASS AMENDED",12,0,0,0,12
1925439,1568439,2025-05-08,Senate,"Senate: THIRD READING",42,3,0,2,47
1925439,1572029,2025-05-15,House,"House: FOURTH READING",60,22,0,16,98
1925448,1505179,2025-03-04,Senate,"Senate: Judiciary Committee: DO PASS AMENDED CS",8,0,0,0,8
1925453,1488959,2025-02-13,House,"House: Transportation Committee: DO PASS",10,0,0,0,10
1925453,1505409,2025-03-04,House,"House: Commerce and Economic Development Oversight Committee: DO PASS",16,0,0,0,16
1925453,1525715,2025-03-24,House,"House: THIRD READING",92,0,0,7,99
1925453,1538681,2025-04-07,Senate,"Senate: Aeronautics & Transportation Committee: DO PASS",10,0,0,0,10
1925453,1565206,2025-05-05,Senate,"Senate: THIRD READING",38,7,0,2,47
1925453,1596125,2025-04-16,Senate,"Senate: Appropriations Committee: DO PASS AMENDED",17,3,0,0,20
1925454,1486798,2025-02-11,House,"House: Postsecondary Education Committee: DO PASS",8,0,0,0,8
1925454,1500246,2025-02-26,House,"House: Education Oversight Committee: DO PASS",9,0,0,0,9
1925454,1506753,2025-03-05,House,"House: THIRD READING",86,6,1,6,99
1925454,1554993,2025-04-22,Senate,"Senate: Education Committee: DO PASS AMENDED",10,0,0,0,10
1925454,1568450,2025-05-08,Senate,"Senate: THIRD READING",42,2,1,2,47
1925454,1575363,2025-05-21,House,"House: FOURTH READING",91,0,0,7,98
1925454,1591364,2025-05-21,Senate,"Senate: FOURTH READING",46,0,0,2,48
1925457,1505177,2025-03-04,Senate,"Senate: Judiciary Committee: DO PASS",6,2,0,0,8
1925462,1507117,2025-03-06,Senate,"Senate: Business & Insurance Committee: DO PASS AMENDED CS",9,0,0,0,9
1925462,1529495,2025-03-27,Senate,"Senate: THIRD READING",45,1,0,1,47
1925462,1540237,2025-04-08,House,"House: Insurance Committee: DO PASS",6,1,0,0,7
1925466,1479913,2025-02-04,House,"House: Agriculture Committee: DO PASS",6,1,0,0,7
1925466,1505866,2025-03-05,House,"House: Energy and Natural Resources Oversight Committee: DO PASS",14,1,0,0,15
1925466,1512510,2025-03-11,House,"House: THIRD READING",83,4,0,12,99
1925466,1538348,2025-04-07,Senate,"Senate: Agriculture & Wildlife Committee: DO PASS AMENDED",12,0,0,0,12
1925466,1563766,2025-05-01,Senate,"Senate: THIRD READING",43,0,0,4,47
1925466,1596132,2025-04-16,Senate,"Senate: Appropriations Committee: DO PASS",22,0,0,0,22
1925470,1479487,2025-02-04,House,"House: General Government Committee: DO PASS",8,0,0,0,8
1925470,1499500,2025-02-25,House,"House: Government Oversight Committee: DO PASS AS AMENDED BY CS",14,1,0,0,15
1925470,1503162,2025-03-03,House,"House: THIRD READING",92,5,0,2,99
1925477,1486266,2025-02-11,House,"House: Banking, Financial Services and Pensions Committee: DO PASS",8,0,0,0,8
1925477,1504775,2025-03-04,House,"House: Government Oversight Committee: DO PASS",14,0,0,0,14
1925477,1527201,2025-03-25,House,"House: THIRD READING",60,26,0,13,99
1925477,1556882,2025-04-24,Senate,"Senate: Business & Insurance Committee: DO PASS",9,0,0,0,9
1925477,1562702,2025-04-30,Senate,"Senate: THIRD READING",46,0,0,1,47
1925483,1490746,2025-02-17,House,"House: Appropriations and Budget Natural Resources Subcommittee: DO PASS AS AMENDED BY CS",7,3,0,0,10
1925499,1501547,2025-02-27,Senate,"Senate: Business & Insurance Committee: DO PASS",10,0,0,0,10
1925499,1529952,2025-03-27,Senate,"Senate: THIRD READING",37,9,0,1,47
1925499,1541495,2025-04-09,House,"House: Alcohol, Tobacco and Controlled Substances Committee: DO PASS",5,2,0,0,7
1925501,1486290,2025-02-11,House,"House: Postsecondary Education Committee: DO PASS",5,2,0,0,7
1925502,1493956,2025-02-19,House,"House: Criminal Judiciary Committee: DO PASS",6,0,0,0,6
1925502,1504253,2025-03-04,House,"House: Judiciary and Public Safety Oversight Committee: DO PASS",12,0,0,0,12
1925502,1525790,2025-03-25,House,"House: THIRD READING",74,0,0,25,99
1925502,1540908,2025-04-08,Senate,"Senate: Judiciary Committee: DO PASS",8,0,0,0,8
1925502,1561681,2025-04-30,Senate,"Senate: THIRD READING",44,0,0,3,47
1925504,1503295,2025-03-03,Senate,"Senate: Revenue & Taxation Committee: DO PASS AMENDED CS",5,5,0,0,10
1925509,1482472,2025-02-05,House,"House: Public Safety Committee: DO PASS",7,0,0,0,7
1925509,1507671,2025-03-06,House,"House: Judiciary and Public Safety Oversight Committee: DO PASS",12,0,0,0,12
1925509,1518801,2025-03-17,House,"House: THIRD READING",82,3,0,14,99
1925509,1538576,2025-04-07,Senate,"Senate: Aeronautics & Transportation Committee: DO PASS",11,0,0,0,11
1925509,1562031,2025-04-30,Senate,"Senate: THIRD READING",44,0,0,3,47
1925517,1504367,2025-03-04,Senate,"Senate: Judiciary Committee: DO PASS",7,0,0,0,7
1925517,1529926,2025-03-27,Senate,"Senate: THIRD READING",47,0,0,0,47
1925517,1540151,2025-04-08,House,"House: Criminal Judiciary Committee: DO PASS",4,0,0,0,4
1925517,1562690,2025-04-30,House,"House: THIRD READING",90,0,0,8,98
1925517,1596410,2025-04-17,House,"House: Judiciary and Public Safety Oversight Committee: DO PASS",12,0,0,0,12
1925527,1489092,2025-02-13,House,"House: Civil Judiciary Committee: DO PASS AS AMENDED BY CS",8,0,0,0,8
1925527,1504538,2025-03-04,House,"House: Judiciary and Public Safety Oversight Committee: DO PASS AS AMENDED BY CS",13,0,0,0,13
1925527,1512706,2025-03-11,House,"House: THIRD READING",84,6,0,9,99
1925527,1540300,2025-04-08,Senate,"Senate: Judiciary Committee: DO PASS",7,0,0,0,7
1925527,1568705,2025-05-08,Senate,"Senate: THIRD READING",45,2,0,0,47
1925527,1581016,2025-05-29,House,"House: VETO OVERRIDE WITHOUT EMERGENCY",82,6,0,10,98
1925527,1581941,2025-05-29,Senate,"Senate: VETO OVERRIDE NO EMERGENCY",32,13,0,3,48
1925535,1493256,2025-02-19,House,"House: Children, Youth and Family Services Committee: DO PASS AS AMENDED BY CS",6,0,0,0,6
1925535,1505930,2025-03-05,House,"House: Health and Human Services Oversight Committee: DO PASS AS AMENDED BY CS",13,0,0,0,13
1925535,1513196,2025-03-11,House,"House: ,                 THIRD READING",83,0,0,16,99
1925535,1596133,2025-03-11,House,"House: THIRD READING",83,0,0,16,99
1925537,1493195,2025-02-19,House,"House: Alcohol, Tobacco and Controlled Substances Committee: DO PASS AS AMENDED BY CS",5,1,0,0,6
1925537,1506815,2025-03-05,House,"House: Health and Human Services Oversight Committee: DO PASS AS AMENDED BY CS",12,2,0,0,14
1925537,1529365,2025-03-27,House,"House: THIRD READING",82,2,0,15,99
1925537,1550963,2025-04-17,Senate,"Senate: Business & Insurance Committee: DO PASS",10,0,0,0,10
1925537,1566341,2025-05-06,Senate,"Senate: THIRD READING",45,0,1,1,47
1925537,1596139,2025-04-23,Senate,"Senate: Appropriations Committee: DO PASS AMENDED",25,0,1,0,26
1925540,1498611,2025-02-24,House,"House: Public Health Committee: DO PASS AS AMENDED BY CS",6,0,0,0,6
1925540,1503716,2025-03-03,House,"House: Health and Human Services Oversight Committee: DO PASS AS AMENDED BY CS",12,0,0,0,12
1925540,1517216,2025-03-13,House,"House: THIRD READING",83,0,0,16,99
1925540,1539150,2025-04-07,Senate,"Senate: Health & Human Services Committee: DO PASS",12,0,0,0,12
1925540,1568118,2025-05-08,Senate,"Senate: THIRD READING",43,0,0,4,47
1925546,1485175,2025-02-10,House,"House: Appropriations and Budget Education Subcommittee: DO PASS",9,1,0,0,10
1925554,1489333,2025-02-13,House,"House: Transportation Committee: DO PASS",10,0,0,0,10
1925563,1503150,2025-03-03,Senate,"Senate: Agriculture & Wildlife Committee: DO PASS AMENDED CS",10,2,0,0,12
1925567,1498143,2025-02-24,House,"House: Business Committee: DO PASS",7,0,0,0,7
1925567,1504614,2025-03-04,House,"House: Commerce and Economic Development Oversight Committee: DO PASS",14,0,0,0,14
1925567,1525597,2025-03-24,House,"House: THIRD READING",82,11,0,6,99
1925567,1545321,2025-04-10,Senate,"Senate: Business & Insurance Committee: DO PASS",7,1,0,0,8
1925567,1565325,2025-05-05,Senate,"Senate: THIRD READING",25,20,0,2,47
1925567,1571828,2025-05-15,House,"House: FOURTH READING",72,15,0,11,98
1925569,1507099,2025-03-06,Senate,"Senate: Business & Insurance Committee: DO PASS AMENDED",10,1,0,0,11
1925582,1507119,2025-03-06,Senate,"Senate: Business & Insurance Committee: DO PASS",10,0,0,0,10
1925596,1491130,2025-02-17,House,"House: Appropriations and Budget Health Subcommittee: DO PASS",6,0,0,0,6
1925596,1506824,2025-03-05,House,"House: Appropriations and Budget Committee: DO PASS AS AMENDED, STRIKE THE TITLE",30,0,0,0,30
1925596,1516500,2025-03-12,House,"House: THIRD READING",78,4,0,17,99
1925611,1493819,2025-02-19,House,"House: Appropriations and Budget Education Subcommittee: DO PASS AS AMENDED BY CS",8,0,0,0,8
1925611,1506804,2025-03-05,House,"House: Appropriations and Budget Committee: DO PASS AS AMENDED BY CS",31,0,0,0,31
1925611,1526709,2025-03-25,House,"House: THIRD READING",75,16,0,8,99
1925616,1495379,2025-02-20,House,"House: Civil Judiciary Committee: DO PASS",9,0,0,0,9
1925616,1504719,2025-03-04,House,"House: Judiciary and Public Safety Oversight Committee: DO PASS",13,0,0,0,13
1925616,1517210,2025-03-13,House,"House: THIRD READING",84,0,0,15,99
1925616,1556406,2025-04-24,Senate,"Senate: Rules Committee: DO PASS AMENDED",17,2,0,0,19
1925619,1487129,2025-02-11,Senate,"Senate: General Government Committee: DO PASS",7,2,0,0,9
1925619,1525035,2025-03-24,Senate,"Senate: THIRD READING",46,0,0,1,47
1925619,1532045,2025-04-01,House,"House: General Government Committee: DO PASS",8,0,0,0,8
1925619,1557100,2025-04-24,House,"House: Government Oversight Committee: DO PASS AS AMENDED BY CS",14,0,0,0,14
1925619,1564999,2025-05-05,House,"House: THIRD READING",91,2,0,5,98
1925619,1591783,2025-05-14,Senate,"Senate: FOURTH READING",38,2,0,7,47
1925620,1486516,2025-02-11,House,"House: Criminal Judiciary Committee: DO PASS",4,1,0,0,5
1925620,1501444,2025-02-27,House,"House: Judiciary and Public Safety Oversight Committee: DO PASS",13,0,0,0,13
1925620,1527959,2025-03-26,House,"House: THIRD READING",93,0,0,6,99
1925620,1554308,2025-04-22,Senate,"Senate: Public Safety Committee: DO PASS",7,1,0,0,8
1925624,1494848,2025-02-20,House,"House: Veterans and Military Affairs Committee: DO PASS AS AMENDED BY CS",7,0,0,0,7
1925624,1505921,2025-03-05,House,"House: Health and Human Services Oversight Committee: DO PASS AS AMENDED BY CS",11,0,0,0,11
1925624,1527989,2025-03-26,House,"House: THIRD READING",94,0,0,5,99
1925624,1557329,2025-04-24,Senate,"Senate: Energy Committee: DO PASS",10,0,0,0,10
1925628,1491240,2025-02-17,House,"House: Appropriations and Budget Transportation Subcommittee: DO PASS",10,0,0,0,10
1925628,1506465,2025-03-05,House,"House: Appropriations and Budget Committee: DO PASS",31,1,0,0,32
1925628,1516589,2025-03-12,House,"House: THIRD READING",64,24,0,11,99
1925628,1538626,2025-04-07,Senate,"Senate: Aeronautics & Transportation Committee: DO PASS",9,1,0,0,10
1925628,1596122,2025-04-23,Senate,"Senate: Appropriations Committee: DO PASS AMENDED",21,2,0,0,23
1925629,1487565,2025-02-12,House,"House: County and Municipal Government Committee: DO PASS",6,0,0,0,6
1925629,1504191,2025-03-04,House,"House: Government Oversight Committee: DO PASS",13,1,0,0,14
1925629,1517609,2025-03-13,House,"House: THIRD READING",73,6,0,20,99
1925629,1554209,2025-04-22,Senate,"Senate: Local & County Government Committee: DO PASS",8,0,0,0,8
1925629,1558994,2025-04-28,Senate,"Senate: THIRD READING",44,0,0,3,47
1925640,1493358,2025-02-19,House,"House: Energy Committee: DO PASS AS AMENDED BY CS",8,1,0,0,9
1925643,1504532,2025-03-04,Senate,"Senate: Economic Development, Workforce & Tourism Committee: DO PASS AMENDED CS",7,1,0,0,8
1925643,1525201,2025-03-24,Senate,"Senate: THIRD READING",32,14,0,1,47
1925643,1544166,2025-04-10,House,"House: Appropriations and Budget Finance Subcommittee: DO PASS AS AMENDED BY CS",7,0,0,0,7
1925652,1493345,2025-02-17,House,"House: Appropriations and Budget Judiciary Subcommittee: DO PASS AS AMENDED BY CS",7,1,0,0,8
1925652,1506796,2025-03-05,House,"House: Appropriations and Budget Committee: DO PASS AS AMENDED BY CS",31,0,0,0,31
1925652,1529336,2025-03-27,House,"House: THIRD READING",56,30,0,13,99
1925653,1504212,2025-03-03,Senate,"Senate: Revenue & Taxation Committee: DO PASS AMENDED",6,4,0,0,10
1925694,1493775,2025-02-19,House,"House: Appropriations and Budget Public Safety Subcommittee: DO PASS",9,0,0,0,9
1925695,1493196,2025-02-19,House,"House: Energy Committee: DO PASS AS AMENDED BY CS",9,2,0,0,11
1925695,1499748,2025-02-26,House,"House: Energy and Natural Resources Oversight Committee: DO PASS AS AMENDED BY CS",15,0,0,0,15
1925695,1506485,2025-03-05,House,"House: THIRD READING",92,0,0,7,99
1925695,1551683,2025-04-17,Senate,"Senate: Energy Committee: DO PASS",9,0,0,0,9
1925695,1563912,2025-05-01,Senate,"Senate: THIRD READING",43,1,0,3,47
1925699,1493250,2025-02-19,House,"House: Common Education Committee: DO PASS AS AMENDED BY CS",8,3,0,0,11
1925699,1503678,2025-03-03,House,"House: Education Oversight Committee: DO PASS AS AMENDED BY CS",7,2,0,0,9
1925699,1515960,2025-03-12,House,"House: THIRD READING",68,22,0,9,99
1925708,1505159,2025-03-04,House,"House: Rules Committee: DO PASS AS AMENDED BY CS",10,0,0,0,10
1925708,1517589,2025-03-13,House,"House: THIRD READING",79,4,0,16,99
1925708,1540716,2025-04-08,Senate,"Senate: Judiciary Committee: DO PASS",5,1,0,0,6
1925708,1566397,2025-05-06,Senate,"Senate: THIRD READING",35,9,0,3,47
1925716,1493173,2025-02-19,Senate,"Senate: Retirement & Government Resources Committee: DO PASS",6,2,0,0,8
1925727,1495589,2025-02-20,House,"House: Civil Judiciary Committee: DO PASS AS AMENDED BY CS",9,0,0,0,9
1925727,1505234,2025-03-04,House,"House: Judiciary and Public Safety Oversight Committee: DO PASS AS AMENDED BY CS",13,0,0,0,13
1925727,1513411,2025-03-11,House,"House: THIRD READING",83,4,0,12,99
1925727,1548319,2025-04-15,Senate,"Senate: Judiciary Committee: DO PASS",8,0,0,0,8
1925735,1497694,2025-02-24,Senate,"Senate: Agriculture & Wildlife Committee: DO PASS AMENDED",12,0,0,0,12
1925735,1527792,2025-03-26,Senate,"Senate: THIRD READING",45,0,0,2,47
1925735,1538147,2025-04-07,House,"House: Wildlife Committee: DO PASS",6,0,0,0,6
1925735,1566108,2025-05-06,House,"House: THIRD READING",93,0,0,5,98
1925735,1596173,2025-04-16,House,"House: Energy and Natural Resources Oversight Committee: DO PASS",12,0,0,0,12
1925743,1494234,2025-02-19,House,"House: Appropriations and Budget Education Subcommittee: DO PASS AS AMENDED BY CS",7,1,0,0,8
1925746,1499211,2025-02-25,House,"House: Rules Committee: DO PASS AS AMENDED, STRIKE THE T ITLE",10,0,0,0,10
1925746,1499212,2025-02-25,House,"House: Rules Committee: DO PASS AS AMENDED BY CS",10,0,0,0,10
1925746,1503427,2025-03-03,House,"House: THIRD READING",59,33,0,7,99
1925746,1540436,2025-04-08,Senate,"Senate: Economic Development, Workforce & Tourism Committee: DO PASS AMENDED",5,4,0,0,9
1925752,1495190,2025-02-20,House,"House: Civil Judiciary Committee: DO PASS AS AMENDED BY CS",8,0,0,0,8
1925752,1501155,2025-02-27,House,"House: Judiciary and Public Safety Oversight Committee: DO PASS AS AMENDED BY CS",12,0,0,0,12
1925752,1515073,2025-03-11,House,"House: THIRD READING",84,0,0,15,99
1925752,1548550,2025-04-15,Senate,"Senate: Judiciary Committee: DO PASS",8,0,0,0,8
1925753,1486842,2025-02-11,House,"House: Business Committee: DO PASS",7,0,0,0,7
1925753,1504541,2025-03-04,House,"House: Commerce and Economic Development Oversight Committee: DO PASS",16,0,0,0,16
1925753,1526435,2025-03-25,House,"House: THIRD READING",86,5,0,8,99
1925753,1543496,2025-04-10,Senate,"Senate: Business & Insurance Committee: DO PASS",10,0,0,0,10
1925753,1562145,2025-04-30,Senate,"Senate: THIRD READING",44,0,0,3,47
1925773,1488077,2025-02-12,House,"House: Public Safety Committee: DO PASS",4,0,0,0,4
1925773,1501091,2025-02-27,House,"House: Judiciary and Public Safety Oversight Committee: DO PASS",13,0,0,0,13
1925773,1516082,2025-03-12,House,"House: ,                  THIRD READING",85,0,0,14,99
1925773,1538639,2025-04-07,Senate,"Senate: Aeronautics & Transportation Committee: DO PASS",10,0,0,0,10
1925773,1559626,2025-04-28,Senate,"Senate: THIRD READING",44,0,0,3,47
1925773,1596131,2025-03-12,House,"House: THIRD READING",85,0,0,14,99
1925778,1497681,2025-02-24,House,"House: Public Health Committee: DO PASS AS AMENDED BY CS",6,0,0,0,6
1925778,1503880,2025-03-03,House,"House: Health and Human Services Oversight Committee: DO PASS AS AMENDED BY CS",12,0,0,0,12
1925778,1517008,2025-03-12,House,"House: THIRD READING",84,0,0,15,99
1925778,1538537,2025-04-07,Senate,"Senate: Health & Human Services Committee: DO PASS",12,0,0,0,12
1925778,1562065,2025-04-30,Senate,"Senate: THIRD READING",42,1,0,4,47
1925803,1501445,2025-02-26,House,"House: Appropriations and Budget Committee: DO PASS AS AMENDED BY CS",33,0,0,0,33
1925803,1513857,2025-03-10,House,"House: THIRD READING",90,3,1,5,99
1925803,1544008,2025-04-10,Senate,"Senate: Veterans & Military Affairs Committee: DO PASS",5,3,0,0,8
1925803,1562268,2025-04-30,Senate,"Senate: THIRD READING",44,1,0,2,47
1925803,1575860,2025-05-22,House,"House: FOURTH READING",77,3,0,18,98
1925803,1591536,2025-05-22,Senate,"Senate: FOURTH READING",30,12,0,6,48
1925803,1596142,2025-04-23,Senate,"Senate: Appropriations Committee: DO PASS AMENDED",19,4,0,0,23
1925822,1484651,2025-02-10,House,"House: Appropriations and Budget Natural Resources Subcommittee: DO PASS AS AMENDED BY CS",9,1,0,0,10
1925822,1499319,2025-02-25,House,"House: Appropriations and Budget Committee: DO PASS AS AMENDED BY CS",32,0,0,0,32
1925822,1525536,2025-03-24,House,"House: THIRD READING",68,27,0,4,99
1925822,1540282,2025-04-08,Senate,"Senate: Economic Development, Workforce & Tourism Committee: DO PASS AMENDED",7,1,0,0,8
1925822,1596141,2025-04-16,Senate,"Senate: Appropriations Committee: DO PASS AMENDED",19,2,0,0,21
1925830,1506383,2025-03-05,House,"House: Rules Committee: DO PASS AS AMENDED BY CS",9,1,0,0,10
1925830,1515910,2025-03-12,House,"House: THIRD READING",78,13,1,7,99
1925840,1483701,2025-02-06,House,"House: Appropriations and Budget Finance Subcommittee: DO PASS",8,0,0,0,8
1925871,1505165,2025-03-04,House,"House: Appropriations and Budget Committee: DO PASS AS AMENDED BY CS",30,0,0,0,30
1925871,1527788,2025-03-25,House,"House: THIRD READING",87,4,0,8,99
1925871,1548068,2025-04-15,Senate,"Senate: Retirement & Government Resources Committee: DO PASS",9,0,0,0,9
1925871,1565667,2025-05-06,Senate,"Senate: THIRD READING",42,2,0,3,47
1925888,1498900,2025-02-25,House,"House: Rules Committee: DO PASS AS AMENDED BY CS",10,0,0,0,10
1925888,1527445,2025-03-25,House,"House: THIRD READING",77,8,0,14,99
1925888,1556757,2025-04-24,Senate,"Senate: Business & Insurance Committee: DO PASS AMENDED",8,2,0,0,10
1925888,1566806,2025-05-06,Senate,"Senate: THIRD READING",20,23,1,3,47
1925888,1596144,2025-05-08,Senate,"Senate: RECONSIDER",28,15,0,4,47
1925900,1479486,2025-02-04,House,"House: Business Committee: DO PASS AS AMENDED BY CS",9,0,0,0,9
1925900,1499201,2025-02-25,House,"House: Commerce and Economic Development Oversight Committee: DO PASS AS AMENDED BY CS",15,0,0,0,15
1925900,1514769,2025-03-11,House,"House: THIRD READING",90,0,0,9,99
1925900,1544164,2025-04-10,Senate,"Senate: Business & Insurance Committee: DO PASS",8,0,0,0,8
1925900,1566263,2025-05-06,Senate,"Senate: THIRD READING",46,0,0,1,47
1925906,1487479,2025-02-12,House,"House: County and Municipal Government Committee: DO PASS",6,0,0,0,6
1925936,1495719,2025-02-20,House,"House: Civil Judiciary Committee: DO PASS AS AMENDED BY CS",8,1,0,0,9
1925936,1505295,2025-03-04,House,"House: Judiciary and Public Safety Oversight Committee: DO PASS AS AMENDED BY CS",13,0,0,0,13
1925936,1514132,2025-03-11,House,"House: THIRD READING",48,45,0,6,99
1925939,1486971,2025-02-11,House,"House: Rules Committee: DO PASS AS AMENDED BY CS",9,0,0,0,9
1925939,1517156,2025-03-13,House,"House: THIRD READING",78,4,0,17,99
1925939,1539624,2025-04-08,Senate,"Senate: Judiciary Committee: DO PASS",5,1,0,0,6
1925939,1565455,2025-05-06,Senate,"Senate: THIRD READING",37,7,0,3,47
1925939,1576124,2025-05-22,House,"House: FOURTH READING",74,7,0,17,98
1925939,1591749,2025-05-28,Senate,"Senate: FOURTH READING",43,4,0,1,48
1925981,1493253,2025-02-19,House,"House: Criminal Judiciary Committee: DO PASS AS AMENDED BY CS",4,2,0,0,6
1925981,1504607,2025-03-04,House,"House: Judiciary and Public Safety Oversight Committee: DO PASS AS AMENDED BY CS",13,0,0,0,13
1925981,1517323,2025-03-13,House,"House: THIRD READING",27,62,0,10,99
1925994,1493436,2025-02-19,House,"House: Criminal Judiciary Committee: DO PASS",6,0,0,0,6
1925994,1507384,2025-03-06,House,"House: Judiciary and Public Safety Oversight Committee: DO PASS",12,0,0,0,12
1925994,1528237,2025-03-26,House,"House: THIRD READING",82,3,0,14,99
1926001,1493572,2025-02-19,House,"House: Common Education Committee: DO PASS AS AMENDED BY CS",12,0,0,0,12
1926001,1499928,2025-02-26,House,"House: Education Oversight Committee: DO PASS AS AMENDED BY CS",9,0,0,0,9
1926005,1500874,2025-02-26,House,"House: Appropriations and Budget Committee: DO PASS AS AMENDED BY CS",33,0,0,0,33
1926005,1509742,2025-03-10,House,"House: THIRD READING",91,3,1,4,99
1926005,1545854,2025-04-10,Senate,"Senate: Veterans & Military Affairs Committee: DO PASS",5,3,0,0,8
1926005,1562712,2025-04-30,Senate,"Senate: THIRD READING",44,1,0,2,47
1926005,1575800,2025-05-22,House,"House: FOURTH READING",76,3,1,18,98
1926005,1591352,2025-05-22,Senate,"Senate: FOURTH READING",36,6,0,6,48
1926005,1596143,2025-04-23,Senate,"Senate: Appropriations Committee: DO PASS AMENDED",18,3,0,0,21
1926057,1498462,2025-02-24,House,"House: Public Health Committee: DO PASS AS AMENDED BY CS",5,1,0,0,6
1926057,1506136,2025-03-05,House,"House: Health and Human Services Oversight Committee: DO PASS AS AMENDED BY CS",14,0,0,0,14
1926057,1526680,2025-03-25,House,"House: THIRD READING",63,33,0,3,99
1926057,1526681,2025-03-25,House,"House: EMERGENCY",67,26,0,6,99
1926057,1553111,2025-04-21,Senate,"Senate: Health & Human Services Committee: DO PASS AMENDED",7,5,0,0,12
1926057,1568357,2025-05-08,Senate,"Senate: THIRD READING",32,14,0,1,47
1926057,1574823,2025-05-21,House,"House: FOURTH READING",63,29,0,6,98
1926057,1581900,2025-05-30,Senate,"Senate: VETO OVERRIDE NO EMERGENCY",33,13,0,2,48
1926057,1581901,2025-05-29,House,"House: VETO OVERRIDE WITHOUT EMERGENCY",68,16,0,14,98
1926061,1494869,2025-02-20,House,"House: Transportation Committee: DO PASS",9,2,0,0,11
1926061,1505231,2025-03-04,House,"House: Commerce and Economic Development Oversight Committee: DO PASS",11,5,0,0,16
1926061,1527039,2025-03-25,House,"House: THIRD READING",54,35,0,10,99
1926076,1480176,2025-02-04,House,"House: Administrative Rules Committee: DO PASS AS AMENDED BY CS",12,1,0,0,13
1926076,1487860,2025-02-12,House,"House: Appropriations and Budget Committee: DO PASS AS AMENDED BY CS",29,0,0,0,29
1926076,1494598,2025-02-20,House,"House: THIRD READING",86,3,0,10,99
1926076,1536858,2025-04-03,Senate,"Senate: House Bill 2728: DO PASS",5,1,0,0,6
1926076,1563929,2025-05-01,Senate,"Senate: THIRD READING",37,7,0,3,47
1926076,1571033,2025-05-14,House,"House: FOURTH READING",74,12,0,12,98
1926078,1480200,2025-02-04,House,"House: Administrative Rules Committee: DO PASS",13,0,0,0,13
1926078,1500120,2025-02-26,House,"House: THIRD READING",92,0,0,7,99
1926078,1536722,2025-04-03,Senate,"Senate: Administrative Rules Committee: DO PASS",6,0,0,0,6
1926078,1562446,2025-04-30,Senate,"Senate: THIRD READING",43,0,0,4,47
1926080,1494967,2025-02-20,House,"House: Civil Judiciary Committee: DO PASS AS AMENDED BY CS",9,0,0,0,9
1926080,1504459,2025-03-04,House,"House: Judiciary and Public Safety Oversight Committee: DO PASS AS AMENDED BY CS",14,0,0,0,14
1926080,1516014,2025-03-12,House,"House: THIRD READING",86,0,0,13,99
1926080,1553897,2025-04-22,Senate,"Senate: Judiciary Committee: DO PASS",8,0,0,0,8
1926080,1564225,2025-05-01,Senate,"Senate: THIRD READING",45,0,0,2,47
1926114,1483418,2025-02-06,House,"House: Civil Judiciary Committee: DO PASS",8,0,0,0,8
1926114,1504259,2025-03-04,House,"House: Judiciary and Public Safety Oversight Committee: DO PASS",14,0,0,0,14
1926114,1512599,2025-03-11,House,"House: THIRD READING",88,0,0,11,99
1926114,1556753,2025-04-24,Senate,"Senate: Rules Committee: DO PASS AMENDED CS",14,4,0,0,18
1926114,1568363,2025-05-08,Senate,"Senate: THIRD READING",39,7,0,1,47
1926114,1575868,2025-05-22,House,"House: FOURTH READING",76,0,0,22,98
1926114,1591437,2025-05-22,Senate,"Senate: FOURTH READING",42,0,0,6,48
1926125,1480277,2025-02-04,House,"House: Business Committee: DO PASS",9,0,0,0,9
1926125,1505067,2025-03-04,House,"House: Commerce and Economic Development Oversight Committee: DO PASS AS AMENDED BY CS",14,0,0,0,14
1926125,1513569,2025-03-11,House,"House: THIRD READING",79,12,0,8,99
1926125,1544383,2025-04-10,Senate,"Senate: Business & Insurance Committee: DO PASS",8,0,0,0,8
1926136,1505049,2025-03-04,House,"House: Appropriations and Budget Committee: DO PASS AS AMENDED BY CS",29,0,0,0,29
1926136,1526582,2025-03-25,House,"House: THIRD READING",71,17,0,11,99
1926136,1548263,2025-04-14,Senate,"Senate: Health & Human Services Committee: DO PASS AMENDED",9,3,1,0,13
1926136,1568548,2025-05-08,Senate,"Senate: THIRD READING",34,13,0,0,47
1926136,1579930,2025-05-28,House,"House: FOURTH READING",68,24,0,6,98
1926136,1591748,2025-05-29,Senate,"Senate: FOURTH READING",31,14,0,3,48
1926136,1596146,2025-04-23,Senate,"Senate: Appropriations Committee: DO PASS AMENDED CS",22,2,0,0,24
1926150,1574859,2025-05-21,House,"House: THIRD READING",90,0,0,8,98
1926150,1579553,2025-05-28,Senate,"Senate: THIRD READING",33,14,0,1,48
1926152,1494804,2025-02-20,House,"House: Civil Judiciary Committee: DO PASS AS AMENDED BY CS",7,2,0,0,9
1926161,1479915,2025-02-04,House,"House: Criminal Judiciary Committee: DO PASS",6,0,0,0,6
1926161,1504755,2025-03-04,House,"House: Judiciary and Public Safety Oversight Committee: DO PASS",13,0,0,0,13
1926161,1514445,2025-03-11,House,"House: THIRD READING",90,0,0,9,99
1926161,1548465,2025-04-15,Senate,"Senate: Judiciary Committee: DO PASS",8,0,0,0,8
1926161,1562492,2025-04-30,Senate,"Senate: THIRD READING",42,0,0,5,47
1926193,1497690,2025-02-24,House,"House: Public Safety Committee: DO PASS AS AMENDED BY CS",4,3,0,0,7
1926193,1507277,2025-03-06,House,"House: Judiciary and Public Safety Oversight Committee: DO PASS AS AMENDED BY CS",10,1,0,0,11
1926193,1527458,2025-03-25,House,"House: THIRD READING",87,7,0,5,99
1926193,1556884,2025-04-24,Senate,"Senate: Business & Insurance Committee: DO PASS AMENDED CS",8,2,0,0,10
1926193,1566802,2025-05-06,Senate,"Senate: THIRD READING",33,13,0,1,47
1926193,1575432,2025-05-21,House,"House: FOURTH READING",85,7,0,6,98
1926193,1581367,2025-05-29,House,"House: VETO OVERRIDE WITHOUT EMERGENCY",79,8,0,11,98
1926193,1581944,2025-05-29,Senate,"Senate: VETO OVERRIDE NO EMERGENCY",39,6,0,3,48
1926233,1494817,2025-02-20,House,"House: Civil Judiciary Committee: DO PASS",9,0,0,0,9
1926245,1500704,2025-02-26,House,"House: Appropriations and Budget Committee: DO PASS AS AMENDED BY CS",28,3,0,0,31
1926245,1525817,2025-03-25,House,"House: THIRD READING",68,25,0,6,99
1926245,1547661,2025-04-14,Senate,"Senate: Revenue & Taxation Committee: DO PASS AMENDED",9,2,0,0,11
1926245,1568783,2025-05-08,Senate,"Senate: THIRD READING",32,15,0,0,47
1926245,1579537,2025-05-28,House,"House: FOURTH READING",61,25,0,12,98
1926245,1591919,2025-05-28,Senate,"Senate: FOURTH READING",38,9,0,1,48
1926245,1596147,2025-04-23,Senate,"Senate: Appropriations Committee: DO PASS",18,5,0,0,23
1926261,1494062,2025-02-19,House,"House: Appropriations and Budget Public Safety Subcommittee: DO PASS AS AMENDED BY CS",9,0,0,0,9
1926261,1506834,2025-03-05,House,"House: Appropriations and Budget Committee: DO PASS AS AMENDED BY CS",32,1,0,0,33
1926265,1488337,2025-02-12,House,"House: Common Education Committee: DO PASS AS AMENDED BY CS",11,0,0,0,11
1926265,1499847,2025-02-26,House,"House: Education Oversight Committee: DO PASS AS AMENDED BY CS",10,0,0,0,10
1926265,1527077,2025-03-25,House,"House: THIRD READING",95,0,0,4,99
1926317,1498197,2025-02-24,House,"House: General Government Committee: DO PASS",6,0,0,0,6
1926317,1504269,2025-03-04,House,"House: Government Oversight Committee: DO PASS",14,0,0,0,14
1926317,1509681,2025-03-10,House,"House: THIRD READING",78,12,0,9,99
1926320,1497852,2025-02-24,House,"House: Business Committee: DO PASS AS AMENDED BY CS",6,1,0,0,7
1926320,1501448,2025-02-27,House,"House: Commerce and Economic Development Oversight Committee: DO PASS AS AMENDED BY CS",16,0,0,0,16
1926320,1516922,2025-03-13,House,"House: THIRD READING",81,0,2,16,99
1926355,1506524,2025-03-05,House,"House: Appropriations and Budget Committee: DO PASS AS AMENDED BY CS",32,0,0,0,32
1926355,1529880,2025-03-27,House,"House: THIRD READING",75,14,0,10,99
1926355,1556292,2025-04-23,Senate,"Senate: Appropriations Committee: DO PASS",20,4,0,0,24
1926355,1568294,2025-05-08,Senate,"Senate: THIRD READING",28,18,0,1,47
1926415,1497937,2025-02-24,House,"House: General Government Committee: DO PASS",7,0,0,0,7
1926415,1507182,2025-03-06,House,"House: Government Oversight Committee: DO PASS",16,0,0,0,16
1926415,1517284,2025-03-13,House,"House: THIRD READING",85,0,0,14,99
1926415,1540480,2025-04-08,Senate,"Senate: Retirement & Government Resources Committee: DO PASS AMENDED",6,2,0,0,8
1926415,1563959,2025-05-01,Senate,"Senate: THIRD READING",37,9,0,1,47
1926415,1572018,2025-05-15,House,"House: FOURTH READING",82,0,0,16,98
1926418,1495765,2025-02-20,House,"House: Appropriations and Budget Finance Subcommittee: DO PASS AS AMENDED BY CS",9,0,0,0,9
1926418,1507503,2025-03-05,House,"House: Appropriations and Budget Committee: DO PASS AS AMENDED BY CS",32,0,0,0,32
1926418,1516200,2025-03-12,House,"House: THIRD READING",82,0,0,17,99
1926418,1539047,2025-04-07,Senate,"Senate: Revenue & Taxation Committee: DO PASS AMENDED",10,0,0,0,10
1926418,1568016,2025-05-07,Senate,"Senate: THIRD READING",42,0,0,5,47
1926418,1579672,2025-05-28,House,"House: FOURTH READING",87,0,1,10,98
1926418,1591744,2025-05-28,Senate,"Senate: FOURTH READING",46,0,0,2,48
1926418,1596145,2025-04-16,Senate,"Senate: Appropriations Committee: DO PASS",22,0,0,0,22
1926456,1495055,2025-02-20,House,"House: Civil Judiciary Committee: DO PASS AS AMENDED BY CS",8,1,0,0,9
1926456,1504377,2025-03-04,House,"House: Judiciary and Public Safety Oversight Committee: DO PASS AS AMENDED BY CS",14,0,0,0,14
1926456,1512508,2025-03-11,House,"House: THIRD READING",88,2,0,9,99
1926456,1554234,2025-04-22,Senate,"Senate: Judiciary Committee: DO PASS",6,2,0,0,8
1926456,1568463,2025-05-08,Senate,"Senate: THIRD READING",40,5,0,2,47
1926459,1485961,2025-02-11,House,"House: General Government Committee: DO PASS",7,0,0,0,7
1926459,1504947,2025-03-04,House,"House: Government Oversight Committee: DO PASS",14,0,0,0,14
1926459,1516681,2025-03-12,House,"House: THIRD READING",87,1,0,11,99
1926459,1546871,2025-04-14,Senate,"Senate: Aeronautics & Transportation Committee: DO PASS AMENDED",8,0,0,0,8
1926486,1497728,2025-02-24,House,"House: General Government Committee: DO PASS AS AMENDED BY CS",6,1,0,0,7
1926486,1507628,2025-03-06,House,"House: Government Oversight Committee: DO PASS AS AMENDED BY CS",14,2,0,0,16
1926486,1526581,2025-03-25,House,"House: THIRD READING",75,16,0,8,99
1926486,1539809,2025-04-08,Senate,"Senate: Retirement & Government Resources Committee: DO PASS",8,0,0,0,8
1926507,1573043,2025-05-19,House,"House: Committee on Appropriations and Budget Committee: DO PASS AS AMENDED BY CS",27,0,0,0,27
1926507,1573791,2025-05-19,Senate,"Senate: Committee on Appropriations and Budget: DO PASS AMENDED CS",24,0,0,0,24
1926507,1574140,2025-05-20,House,"House: THIRD READING",61,26,0,11,98
1926507,1574141,2025-05-20,House,"House: EMERGENCY",58,23,0,17,98
1926507,1576805,2025-05-22,Senate,"Senate: THIRD READING",31,14,0,3,48
1926528,1482737,2025-02-05,House,"House: Common Education Committee: DO PASS",11,0,0,0,11
1926578,1573123,2025-05-19,House,"House: Committee on Appropriations and Budget Committee: DO PASS AS AMENDED BY CS",29,0,0,0,29
1926578,1574360,2025-05-19,Senate,"Senate: Committee on Appropriations and Budget: DO PASS AMENDED CS",25,0,0,0,25
1926578,1574361,2025-05-20,House,"House: THIRD READING",83,7,0,8,98
1926578,1576807,2025-05-22,Senate,"Senate: THIRD READING",31,12,0,5,48
1926598,1573045,2025-05-19,House,"House: Committee on Appropriations and Budget Committee: DO PASS AS AMENDED BY CS",29,0,0,0,29
1926598,1574368,2025-05-19,Senate,"Senate: Committee on Appropriations and Budget: DO PASS AMENDED CS",24,0,0,0,24
1926598,1574369,2025-05-20,House,"House: THIRD READING",83,7,0,8,98
1926598,1576791,2025-05-22,Senate,"Senate: THIRD READING",34,10,0,4,48
1926600,1493395,2025-02-19,House,"House: Criminal Judiciary Committee: DO PASS",4,1,0,0,5
1926600,1501349,2025-02-27,House,"House: Judiciary and Public Safety Oversight Committee: DO PASS",10,2,0,0,12
1926600,1526601,2025-03-25,House,"House: THIRD READING",73,16,0,10,99
1926600,1539271,2025-04-08,Senate,"Senate: Public Safety Committee: DO PASS",6,2,0,0,8
1926600,1568510,2025-05-08,Senate,"Senate: THIRD READING",39,7,0,1,47
1926603,1498797,2025-02-25,House,"House: Rules Committee: DO PASS",10,0,0,0,10
1926603,1515783,2025-03-12,House,"House: THIRD READING",81,7,0,11,99
1926608,1480864,2025-02-05,House,"House: Public Health Committee: DO PASS",5,0,0,0,5
1926608,1505912,2025-03-05,House,"House: Health and Human Services Oversight Committee: DO PASS",14,0,0,0,14
1926608,1511471,2025-03-10,House,"House: THIRD READING",64,25,0,10,99
1926609,1479950,2025-02-04,House,"House: Business Committee: DO PASS",9,0,0,0,9
1926609,1498598,2025-02-25,House,"House: Commerce and Economic Development Oversight Committee: DO PASS",15,0,0,0,15
1926609,1503224,2025-03-03,House,"House: THIRD READING",91,7,0,1,99
1926609,1551694,2025-04-17,Senate,"Senate: Business & Insurance Committee: DO PASS",7,2,0,0,9
1926614,1491473,2025-02-17,House,"House: Appropriations and Budget Education Subcommittee: DO PASS",8,0,0,0,8
1926614,1507670,2025-03-05,House,"House: Appropriations and Budget Committee: DO PASS",32,0,0,0,32
1926614,1517231,2025-03-13,House,"House: THIRD READING",80,3,0,16,99
1926614,1554184,2025-04-22,Senate,"Senate: Education Committee: DO PASS",10,0,0,0,10
1926614,1562467,2025-04-30,Senate,"Senate: THIRD READING",43,0,0,4,47
1926630,1493953,2025-02-19,House,"House: Alcohol, Tobacco and Controlled Substances Committee: DO PASS AS AMENDED BY CS",4,1,0,0,5
1926630,1500889,2025-02-26,House,"House: Health and Human Services Oversight Committee: DO PASS AS AMENDED BY CS",12,0,0,0,12
1926630,1516102,2025-03-12,House,"House: THIRD READING",89,0,0,10,99
1926630,1556892,2025-04-24,Senate,"Senate: Business & Insurance Committee: DO PASS AMENDED CS",9,0,0,0,9
1926630,1563148,2025-04-30,Senate,"Senate: THIRD READING",46,0,0,1,47
1926630,1571868,2025-05-15,House,"House: FOURTH READING",79,5,0,14,98
1926631,1491270,2025-02-17,House,"House: Appropriations and Budget Natural Resources Subcommittee: DO PASS AS AMENDED BY CS",7,3,0,0,10
1926633,1494594,2025-02-20,House,"House: Utilities Committee: DO PASS AS AMENDED BY CS",8,2,0,0,10
1926633,1506152,2025-03-05,House,"House: Energy and Natural Resources Oversight Committee: DO PASS AS AMENDED BY CS",13,2,0,0,15
1926633,1527844,2025-03-26,House,"House: THIRD READING",68,28,0,3,99
1926634,1498164,2025-02-24,House,"House: Insurance Committee: DO PASS AS AMENDED BY CS",7,0,0,0,7
1926636,1492993,2025-02-19,House,"House: Alcohol, Tobacco and Controlled Substances Committee: DO PASS",4,1,0,0,5
1926636,1505924,2025-03-05,House,"House: Health and Human Services Oversight Committee: DO PASS AS AMENDED BY CS",14,0,0,0,14
1926636,1526490,2025-03-25,House,"House: THIRD READING",89,3,0,7,99
1926636,1551663,2025-04-17,Senate,"Senate: Business & Insurance Committee: DO PASS AMENDED CS",9,0,0,0,9
1926636,1558892,2025-04-28,Senate,"Senate: THIRD READING",41,3,0,3,47
1926636,1575864,2025-05-22,House,"House: FOURTH READING",38,48,0,12,98
1926637,1493515,2025-02-19,House,"House: Criminal Judiciary Committee: DO PASS AS AMENDED BY CS",2,3,0,0,5
1926641,1573693,2025-05-19,Senate,"Senate: Committee on Appropriations and Budget: DO PASS AMENDED CS",22,3,0,0,25
1926641,1573694,2025-05-19,House,"House: Committee on Appropriations and Budget Committee: DO PASS AS AMENDED BY CS",27,1,0,0,28
1926641,1573843,2025-05-20,House,"House: THIRD READING",82,5,0,11,98
1926641,1576814,2025-05-22,Senate,"Senate: THIRD READING",25,18,0,5,48
1926641,1580872,2025-05-29,House,"House: VETO OVERRIDE WITHOUT EMERGENCY",79,6,0,13,98
1926641,1581953,2025-05-29,Senate,"Senate: VETO OVERRIDE NO EMERGENCY",32,14,0,2,48
1926644,1487837,2025-02-12,House,"House: Appropriations and Budget Committee: DO PASS",28,0,0,0,28
1926644,1516683,2025-03-12,House,"House: THIRD READING",80,7,0,12,99
1926644,1541040,2025-04-08,Senate,"Senate: Economic Development, Workforce & Tourism Committee: DO PASS",9,0,0,0,9
1926644,1564919,2025-05-05,Senate,"Senate: THIRD READING",33,13,0,1,47
1926644,1596148,2025-04-16,Senate,"Senate: Appropriations Committee: DO PASS AMENDED",18,2,0,0,20
1926647,1496037,2025-02-20,House,"House: Appropriations and Budget Finance Subcommittee: DO PASS AS AMENDED BY CS",7,2,0,0,9
1926647,1506525,2025-03-05,House,"House: Appropriations and Budget Committee: DO PASS AS AMENDED BY CS",30,2,0,0,32
1926647,1527506,2025-03-26,House,"House: THIRD READING",63,31,0,5,99
1926647,1539824,2025-04-08,Senate,"Senate: Economic Development, Workforce & Tourism Committee: DO PASS",7,0,0,0,7
1926647,1596153,2025-04-14,Senate,"Senate: Revenue & Taxation Committee: DO PASS",7,4,0,0,11
1926653,1482552,2025-02-05,House,"House: Alcohol, Tobacco and Controlled Substances Committee: DO PASS",7,0,0,0,7
1926653,1489104,2025-02-13,House,"House: Health and Human Services Oversight Committee: DO PASS AS AMENDED BY CS",10,2,0,0,12
1926653,1512847,2025-03-11,House,"House: THIRD READING",87,0,0,12,99
1926653,1556888,2025-04-24,Senate,"Senate: Business & Insurance Committee: DO PASS AMENDED CS",9,0,0,0,9
1926653,1567826,2025-05-07,Senate,"Senate: THIRD READING",45,0,0,2,47
1926653,1571902,2025-05-15,House,"House: FOURTH READING",79,2,0,17,98
1926656,1506653,2025-03-05,House,"House: Appropriations and Budget Committee: DO PASS AS AMENDED BY CS",32,0,0,0,32
1926656,1527068,2025-03-25,House,"House: THIRD READING",82,9,0,8,99
1926656,1527069,2025-03-25,House,"House: EMERGENCY",68,14,0,17,99
1926656,1539033,2025-04-07,Senate,"Senate: Health & Human Services Committee: DO PASS AMENDED",10,2,0,0,12
1926656,1596149,2025-04-23,Senate,"Senate: Appropriations Committee: DO PASS",25,0,0,0,25
1926659,1573048,2025-05-19,House,"House: Committee on Appropriations and Budget Committee: DO PASS AS AMENDED BY CS",26,0,0,0,26
1926659,1574258,2025-05-19,Senate,"Senate: Committee on Appropriations and Budget: DO PASS AMENDED CS",24,0,0,0,24
1926659,1574259,2025-05-20,House,"House: THIRD READING",83,5,0,10,98
1926659,1576804,2025-05-22,Senate,"Senate: THIRD READING",36,8,0,4,48
1926661,1483328,2025-02-06,House,"House: Civil Judiciary Committee: DO PASS",6,2,0,0,8
1926661,1499264,2025-02-25,House,"House: Judiciary and Public Safety Oversight Committee: DO PASS",6,2,0,0,8
1926661,1503877,2025-03-03,House,"House: THIRD READING",79,16,0,4,99
1926661,1553845,2025-04-22,Senate,"Senate: Judiciary Committee: DO PASS AMENDED CS",8,1,0,0,9
1926661,1564979,2025-05-05,Senate,"Senate: THIRD READING",37,8,0,2,47
1926661,1570987,2025-05-14,House,"House: FOURTH READING",71,16,0,11,98
1926662,1573134,2025-05-19,House,"House: Committee on Appropriations and Budget Committee: DO PASS AS AMENDED BY CS",28,0,0,0,28
1926662,1574081,2025-05-19,Senate,"Senate: Committee on Appropriations and Budget: DO PASS AMENDED CS",21,0,0,0,21
1926662,1574578,2025-05-20,House,"House: THIRD READING",80,5,0,13,98
1926662,1576803,2025-05-22,Senate,"Senate: THIRD READING",41,3,0,4,48
1926670,1495506,2025-02-20,House,"House: Appropriations and Budget Finance Subcommittee: DO PASS AS AMENDED BY CS",10,0,0,0,10
1926670,1506439,2025-03-05,House,"House: Appropriations and Budget Committee: DO PASS AS AMENDED BY CS",24,6,0,0,30
1926674,1573050,2025-05-19,House,"House: Committee on Appropriations and Budget Committee: DO PASS AS AMENDED BY CS",26,0,0,0,26
1926674,1574401,2025-05-19,Senate,"Senate: Committee on Appropriations and Budget: DO PASS AMENDED CS",24,1,0,0,25
1926674,1574402,2025-05-20,House,"House: THIRD READING",78,10,0,10,98
1926674,1576790,2025-05-22,Senate,"Senate: THIRD READING",29,16,0,3,48
1926676,1573052,2025-05-19,House,"House: Committee on Appropriations and Budget Committee: DO PASS AS AMENDED BY CS",24,0,0,0,24
1926676,1573790,2025-05-19,Senate,"Senate: Committee on Appropriations and Budget: DO PASS AMENDED CS",22,1,0,0,23
1926676,1574102,2025-05-20,House,"House: THIRD READING",67,19,0,12,98
1926676,1576796,2025-05-22,Senate,"Senate: THIRD READING",32,12,0,4,48
1926676,1581405,2025-05-29,House,"House: VETO OVERRIDE WITHOUT EMER",69,17,0,12,98
1926676,1581945,2025-05-29,Senate,"Senate: VETO OVERRIDE",36,9,0,3,48
1926684,1573788,2025-05-19,Senate,"Senate: Committee on Appropriations and Budget: DO PASS AMENDED CS",18,6,0,0,24
1926684,1573789,2025-05-19,House,"House: Committee on Appropriations and Budget Committee: DO PASS AS AMENDED BY CS",21,6,0,0,27
1926684,1574589,2025-05-20,House,"House: THIRD READING",60,30,1,7,98
1926684,1576800,2025-05-22,Senate,"Senate: THIRD READING",36,8,0,4,48
1926685,1491195,2025-02-17,House,"House: Appropriations and Budget Education Subcommittee: DO PASS",9,1,0,0,10
1926688,1573122,2025-05-19,House,"House: Committee on Appropriations and Budget Committee: DO PASS AS AMENDED BY CS",23,6,0,0,29
1926688,1574040,2025-05-19,Senate,"Senate: Committee on Appropriations and Budget: DO PASS AMENDED CS",19,6,0,0,25
1926688,1574603,2025-05-20,House,"House: THIRD READING",61,30,0,7,98
1926688,1576808,2025-05-22,Senate,"Senate: THIRD READING",25,20,0,3,48
1926691,1573041,2025-05-19,House,"House: Committee on Appropriations and Budget Committee: DO PASS AS AMENDED BY CS",29,0,0,0,29
1926691,1574393,2025-05-19,Senate,"Senate: Committee on Appropriations and Budget: DO PASS AMENDED CS",23,1,0,0,24
1926691,1574394,2025-05-20,House,"House: THIRD READING",82,8,0,8,98
1926691,1576792,2025-05-22,Senate,"Senate: THIRD READING",34,10,0,4,48
1926695,1573037,2025-05-19,House,"House: Committee on Appropriations and Budget Committee: DO PASS AS AMENDED BY CS",26,0,0,0,26
1926695,1574313,2025-05-19,Senate,"Senate: Committee on Appropriations and Budget: DO PASS AMENDED CS",25,0,0,0,25
1926695,1574314,2025-05-20,House,"House: THIRD READING",86,0,0,12,98
1926695,1576795,2025-05-22,Senate,"Senate: THIRD READING",43,1,0,4,48
1926698,1506272,2025-03-05,House,"House: Appropriations and Budget Committee: DO PASS AS AMENDED, STRIKE THE TITLE",30,0,0,0,30
1926698,1526331,2025-03-25,House,"House: THIRD READING",84,7,0,8,99
1926698,1548666,2025-04-15,Senate,"Senate: Economic Development, Workforce & Tourism Committee: DO PASS AMENDED",9,0,0,0,9
1926698,1565950,2025-05-06,Senate,"Senate: THIRD READING",45,0,0,2,47
1926698,1575765,2025-05-22,House,"House: FOURTH READING",85,0,0,13,98
1926698,1591455,2025-05-22,Senate,"Senate: FOURTH READING",41,0,1,6,48
1926701,1483136,2025-02-06,House,"House: Veterans and Military Affairs Committee: DO PASS",8,0,0,0,8
1926701,1506859,2025-03-05,House,"House: Health and Human Services Oversight Committee: DO PASS",11,3,0,0,14
1926701,1527202,2025-03-25,House,"House: THIRD READING",94,0,1,4,99
1926701,1545112,2025-04-10,Senate,"Senate: Veterans & Military Affairs Committee: DO PASS",5,1,0,0,6
1926701,1568227,2025-05-07,Senate,"Senate: THIRD READING",42,3,0,2,47
1926702,1494080,2025-02-19,House,"House: Children, Youth and Family Services Committee: DO PASS",6,0,0,0,6
1926702,1500750,2025-02-26,House,"House: Health and Human Services Oversight Committee: DO PASS",12,0,0,0,12
1926702,1516149,2025-03-12,House,"House: THIRD READING",89,0,0,10,99
1926702,1552542,2025-04-21,Senate,"Senate: Health & Human Services Committee: DO PASS AMENDED",10,0,0,0,10
1926704,1482478,2025-02-05,House,"House: Alcohol, Tobacco and Controlled Substances Committee: DO PASS",5,2,0,0,7
1926704,1503583,2025-03-03,House,"House: Health and Human Services Oversight Committee: DO PASS",9,3,0,0,12
1926704,1517399,2025-03-13,House,"House: THIRD READING",60,17,0,22,99
1926704,1556889,2025-04-24,Senate,"Senate: Business & Insurance Committee: DO PASS AMENDED CS",4,5,0,0,9
1926705,1573150,2025-05-19,House,"House: Committee on Appropriations and Budget Committee: DO PASS AS AMENDED BY CS",28,1,0,0,29
1926705,1573802,2025-05-19,Senate,"Senate: Committee on Appropriations and Budget: DO PASS AMENDED CS",22,0,0,0,22
1926705,1574160,2025-05-20,House,"House: THIRD READING",78,8,0,12,98
1926705,1576806,2025-05-22,Senate,"Senate: THIRD READING",35,9,0,4,48
1926707,1573133,2025-05-19,House,"House: Committee on Appropriations and Budget Committee: DO PASS AS AMENDED BY CS",23,5,0,0,28
1926707,1573935,2025-05-19,Senate,"Senate: Committee on Appropriations and Budget: DO PASS AMENDED CS",17,7,0,0,24
1926707,1574427,2025-05-20,House,"House: THIRD READING",74,19,0,5,98
1926707,1576909,2025-05-22,Senate,"Senate: THIRD READING",34,11,0,3,48
1926715,1573161,2025-05-19,House,"House: Committee on Appropriations and Budget Committee: DO PASS AS AMENDED BY CS",26,0,0,0,26
1926715,1573796,2025-05-19,Senate,"Senate: Committee on Appropriations and Budget: DO PASS AMENDED CS",22,2,0,0,24
1926715,1574576,2025-05-20,House,"House: THIRD READING",83,6,0,9,98
1926715,1576785,2025-05-22,Senate,"Senate: THIRD READING",39,7,0,2,48
1926716,1482573,2025-02-05,House,"House: Public Safety Committee: DO PASS",7,0,0,0,7
1926716,1501352,2025-02-27,House,"House: Judiciary and Public Safety Oversight Committee: DO PASS",11,0,0,0,11
1926716,1512529,2025-03-11,House,"House: THIRD READING",85,0,0,14,99
1926716,1552811,2025-04-21,Senate,"Senate: Health & Human Services Committee: DO PASS",10,0,0,0,10
1926719,1491239,2025-02-17,House,"House: Appropriations and Budget Transportation Subcommittee: DO PASS AS AMENDED BY CS",9,0,0,0,9
1926722,1493789,2025-02-19,House,"House: Alcohol, Tobacco and Controlled Substances Committee: DO PASS",5,0,0,0,5
1926722,1506388,2025-03-05,House,"House: Health and Human Services Oversight Committee: DO PASS",14,0,0,0,14
1926722,1514353,2025-03-11,House,"House: THIRD READING",86,9,0,4,99
1926722,1556901,2025-04-24,Senate,"Senate: Business & Insurance Committee: DO PASS AMENDED",8,1,0,0,9
1926722,1565221,2025-05-05,Senate,"Senate: THIRD READING",31,14,0,2,47
1926722,1572298,2025-05-15,House,"House: FOURTH READING",75,12,0,11,98
1926724,1573148,2025-05-19,House,"House: Committee on Appropriations and Budget Committee: DO PASS AS AMENDED BY CS",28,0,0,0,28
1926724,1574293,2025-05-19,Senate,"Senate: Committee on Appropriations and Budget: DO PASS AMENDED CS",21,2,0,0,23
1926724,1574294,2025-05-20,House,"House: THIRD READING",84,0,0,14,98
1926724,1576809,2025-05-22,Senate,"Senate: THIRD READING",42,4,0,2,48
1926728,1493642,2025-02-19,House,"House: Common Education Committee: DO PASS",11,0,0,0,11
1926728,1505947,2025-03-05,House,"House: Education Oversight Committee: DO PASS AS AMENDED BY CS",9,0,0,0,9
1926728,1512714,2025-03-11,House,"House: THIRD READING",92,0,0,7,99
1926728,1553746,2025-04-22,Senate,"Senate: Education Committee: DO PASS",10,0,0,0,10
1926730,1573046,2025-05-19,House,"House: Committee on Appropriations and Budget Committee: DO PASS AS AMENDED BY CS",27,0,0,0,27
1926730,1574221,2025-05-19,Senate,"Senate: Committee on Appropriations and Budget: DO PASS AMENDED CS",24,0,0,0,24
1926730,1574222,2025-05-20,House,"House: THIRD READING",68,18,0,12,98
1926730,1576781,2025-05-22,Senate,"Senate: THIRD READING",36,9,0,3,48
1926733,1506788,2025-03-05,House,"House: Appropriations and Budget Committee: DO PASS AS AMENDED BY CS",32,0,0,0,32
1926733,1526790,2025-03-25,House,"House: THIRD READING",91,0,0,8,99
1926733,1555418,2025-04-23,Senate,"Senate: Appropriations Committee: DO PASS",22,3,0,0,25
1926733,1565101,2025-05-05,Senate,"Senate: THIRD READING",36,10,0,1,47
1926733,1579865,2025-05-28,House,"House: FOURTH READING",91,0,0,7,98
1926733,1591713,2025-05-28,Senate,"Senate: FOURTH READING",40,6,0,2,48
1926734,1498103,2025-02-24,House,"House: Insurance Committee: DO PASS AS AMENDED BY CS",6,2,0,0,8
1926734,1507259,2025-03-06,House,"House: Commerce and Economic Development Oversight Committee: DO PASS AS AMENDED BY CS",17,1,0,0,18
1926734,1528362,2025-03-26,House,"House: THIRD READING",81,8,0,10,99
1926739,1495350,2025-02-20,House,"House: Appropriations and Budget Finance Subcommittee: DO PASS",9,0,0,0,9
1926742,1573039,2025-05-19,House,"House: Committee on Appropriations and Budget Committee: DO PASS AS AMENDED BY CS",27,1,0,0,28
1926742,1573139,2025-05-19,Senate,"Senate: Committee on Appropriations and Budget: DO PASS AMENDED CS",20,6,0,0,26
1926742,1574592,2025-05-20,House,"House: THIRD READING",77,11,0,10,98
1926742,1576782,2025-05-22,Senate,"Senate: THIRD READING",36,8,0,4,48
1926744,1573047,2025-05-19,House,"House: Committee on Appropriations and Budget Committee: DO PASS AS AMENDED BY CS",25,0,0,0,25
1926744,1574307,2025-05-19,Senate,"Senate: Committee on Appropriations and Budget: DO PASS AMENDED CS",15,8,0,0,23
1926744,1574308,2025-05-20,House,"House: THIRD READING",65,20,1,12,98
1926744,1576794,2025-05-22,Senate,"Senate: THIRD READING",31,13,0,4,48
1926747,1573166,2025-05-19,House,"House: Committee on Appropriations and Budget Committee: DO PASS AS AMENDED BY CS",21,5,0,0,26
1926747,1574018,2025-05-19,Senate,"Senate: Committee on Appropriations and Budget: DO PASS AMENDED CS",20,3,0,0,23
1926747,1574019,2025-05-20,House,"House: THIRD READING",73,20,0,5,98
1926747,1576789,2025-05-22,Senate,"Senate: THIRD READING",27,19,0,2,48
1926748,1573153,2025-05-19,House,"House: Committee on Appropriations and Budget Committee: DO PASS AS AMENDED BY CS",21,5,0,0,26
1926748,1574013,2025-05-19,Senate,"Senate: Committee on Appropriations and Budget: DO PASS AMENDED CS",16,9,0,0,25
1926748,1574014,2025-05-20,House,"House: THIRD READING",56,34,0,8,98
1926748,1576798,2025-05-22,Senate,"Senate: THIRD READING",36,9,0,3,48
1926753,1493830,2025-02-19,House,"House: Alcohol, Tobacco and Controlled Substances Committee: DO PASS",4,1,0,0,5
1926753,1506851,2025-03-05,House,"House: Health and Human Services Oversight Committee: DO PASS",13,0,0,0,13
1926753,1526024,2025-03-24,House,"House: THIRD READING",78,13,0,8,99
1926753,1551788,2025-04-17,Senate,"Senate: Business & Insurance Committee: DO PASS",9,0,0,0,9
1926753,1562286,2025-04-30,Senate,"Senate: THIRD READING",33,10,0,4,47
1926755,1499465,2025-02-25,House,"House: Appropriations and Budget Committee: DO PASS AS AMENDED, STRIKE THE TITLE",30,1,0,0,31
1926755,1527435,2025-03-25,House,"House: THIRD READING",94,0,0,5,99
1926755,1551716,2025-04-17,Senate,"Senate: Business & Insurance Committee: DO PASS AMENDED",9,0,0,0,9
1926756,1506807,2025-03-05,House,"House: Appropriations and Budget Committee: DO PASS AS AMENDED BY CS",33,0,0,0,33
1926756,1526034,2025-03-25,House,"House: THIRD READING",72,11,0,16,99
1926756,1562515,2025-04-07,Senate,"Senate: Revenue & Taxation Committee: DO PASS",6,4,0,0,10
1926756,1562516,2025-04-30,Senate,"Senate: THIRD READING",32,14,0,1,47
1926758,1486775,2025-02-11,House,"House: Agriculture Committee: DO PASS",7,1,0,0,8
1926758,1505929,2025-03-05,House,"House: Energy and Natural Resources Oversight Committee: DO PASS",11,2,0,0,13
1926758,1526090,2025-03-25,House,"House: THIRD READING",72,18,0,9,99
1926761,1497931,2025-02-24,House,"House: Public Health Committee: DO PASS",7,0,0,0,7
1926761,1500808,2025-02-26,House,"House: Health and Human Services Oversight Committee: DO PASS",12,0,0,0,12
1926761,1509102,2025-03-10,House,"House: THIRD READING",87,0,0,12,99
1926765,1573044,2025-05-19,House,"House: Committee on Appropriations and Budget Committee: DO PASS AS AMENDED BY CS",24,4,0,0,28
1926765,1573782,2025-05-19,Senate,"Senate: Committee on Appropriations and Budget: DO PASS AMENDED CS",23,0,0,0,23
1926765,1574580,2025-05-20,House,"House: THIRD READING",58,30,1,9,98
1926765,1576787,2025-05-22,Senate,"Senate: THIRD READING",31,15,0,2,48
1926768,1495486,2025-02-20,House,"House: Utilities Committee: DO PASS AS AMENDED BY CS",9,0,0,0,9
1926768,1500112,2025-02-26,House,"House: Energy and Natural Resources Oversight Committee: DO PASS AS AMENDED BY CS",12,3,0,0,15
1926768,1527434,2025-03-26,House,"House: THIRD READING",84,10,0,5,99
1926768,1557143,2025-04-24,Senate,"Senate: Energy Committee: DO PASS AMENDED CS",8,2,0,0,10
1926768,1568040,2025-05-07,Senate,"Senate: THIRD READING",43,0,0,4,47
1926768,1574962,2025-05-21,House,"House: FOURTH READING",85,4,0,9,98
1926776,1573035,2025-05-19,House,"House: Committee on Appropriations and Budget Committee: DO PASS AS AMENDED BY CS",26,0,0,0,26
1926776,1573786,2025-05-19,Senate,"Senate: Committee on Appropriations and Budget: DO PASS AMENDED CS",23,0,0,0,23
1926776,1574586,2025-05-20,House,"House: THIRD READING",82,7,0,9,98
1926776,1576801,2025-05-22,Senate,"Senate: THIRD READING",31,13,0,4,48
1926779,1498867,2025-02-25,House,"House: Rules Committee: DO PASS AS AMENDED BY CS",9,1,0,0,10
1926788,1499405,2025-02-25,House,"House: Appropriations and Budget Committee: DO PASS AS AMENDED, STRIKE THE TITLE",31,0,0,0,31
1926788,1516373,2025-03-12,House,"House: THIRD READING",68,16,0,15,99
1926788,1555512,2025-04-23,Senate,"Senate: Appropriations Committee: DO PASS AMENDED",22,1,0,0,23
1926788,1567386,2025-05-07,Senate,"Senate: THIRD READING",38,9,0,0,47
1926788,1579563,2025-05-28,House,"House: FOURTH READING",74,17,0,7,98
1926788,1591814,2025-05-28,Senate,"Senate: FOURTH READING",34,13,0,1,48
1926792,1500798,2025-02-26,House,"House: Appropriations and Budget Committee: DO PASS",30,0,0,0,30
1926792,1526612,2025-03-25,House,"House: THIRD READING",85,0,0,14,99
1926792,1555072,2025-04-23,Senate,"Senate: Appropriations Committee: DO PASS AMENDED",22,1,0,0,23
1926795,1573162,2025-05-19,House,"House: Committee on Appropriations and Budget Committee: DO PASS AS AMENDED BY CS",26,0,0,0,26
1926795,1573784,2025-05-19,Senate,"Senate: Committee on Appropriations and Budget: DO PASS AMENDED CS",21,2,0,0,23
1926795,1574574,2025-05-20,House,"House: THIRD READING",80,10,0,8,98
1926795,1576799,2025-05-22,Senate,"Senate: THIRD READING",31,14,0,3,48
1926796,1494897,2025-02-20,House,"House: Utilities Committee: DO PASS AS AMENDED BY CS",8,3,0,0,11
1926796,1505833,2025-03-05,House,"House: Energy and Natural Resources Oversight Committee: DO PASS AS AMENDED BY CS",10,6,0,0,16
1926796,1527417,2025-03-26,House,"House: ADOPT AMENDMENT",18,72,0,9,99
1926796,1527418,2025-03-26,House,"House: THIRD READING",68,22,2,7,99
1926796,1556458,2025-04-24,Senate,"Senate: Energy Committee: DO PASS",4,6,0,0,10
1926804,1573113,2025-05-19,House,"House: Committee on Appropriations and Budget Committee: DO PASS AS AMENDED BY CS",27,0,0,0,27
1926804,1574197,2025-05-19,Senate,"Senate: Committee on Appropriations and Budget: DO PASS AMENDED CS",20,5,0,0,25
1926804,1574198,2025-05-20,House,"House: THIRD READING",66,23,0,9,98
1926806,1573114,2025-05-19,House,"House: Committee on Appropriations and Budget Committee: DO PASS AS AMENDED BY CS",26,0,0,0,26
1926806,1574106,2025-05-19,Senate,"Senate: Committee on Appropriations and Budget: DO PASS AMENDED CS",25,0,0,0,25
1926806,1574107,2025-05-20,House,"House: THIRD READING",89,0,0,9,98
1926806,1576802,2025-05-22,Senate,"Senate: THIRD READING",43,0,0,5,48
1926806,1581469,2025-05-29,House,"House: VETO OVERRIDE WITH EMER",88,0,0,10,98
1926806,1581978,2025-05-29,Senate,"Senate: VETO OVERRIDE WITH EMERGENCY",44,1,0,3,48
1926810,1494832,2025-02-20,House,"House: Civil Judiciary Committee: DO PASS AS AMENDED BY CS",8,0,0,0,8
1926810,1507212,2025-03-06,House,"House: Judiciary and Public Safety Oversight Committee: DO PASS AS AMENDED BY CS",11,0,0,0,11
1926810,1529164,2025-03-27,House,"House: RECONSIDER MEASURE",71,13,0,15,99
1926810,1529165,2025-03-27,House,"House: THIRD READING",73,14,0,12,99
1926817,1497457,2025-02-24,House,"House: Postsecondary Education Committee: DO PASS AS AMENDED BY CS",5,1,0,0,6
1926817,1503856,2025-03-03,House,"House: Education Oversight Committee: DO PASS AS AMENDED BY CS",9,0,0,0,9
1926817,1517061,2025-03-13,House,"House: THIRD READING",68,21,0,10,99
1926817,1553341,2025-04-22,Senate,"Senate: Education Committee: DO PASS AMENDED CS",6,4,0,0,10
1926822,1499888,2025-02-25,House,"House: Appropriations and Budget Committee: DO PASS AS AMENDED BY CS",18,14,0,0,32
1926824,1488126,2025-02-12,House,"House: Appropriations and Budget Committee: DO PASS AS AMENDED BY CS",26,2,0,0,28
1926827,1573115,2025-05-19,House,"House: Committee on Appropriations and Budget Committee: DO PASS AS AMENDED BY CS",28,0,0,0,28
1926827,1573931,2025-05-19,Senate,"Senate: Committee on Appropriations and Budget: DO PASS AMENDED CS",25,0,0,0,25
1926827,1574573,2025-05-20,House,"House: THIRD READING",74,15,0,9,98
1926827,1576810,2025-05-22,Senate,"Senate: THIRD READING",35,10,0,3,48
1926830,1483635,2025-02-06,House,"House: Transportation Committee: DO PASS",11,0,0,0,11
1926830,1504247,2025-03-04,House,"House: Commerce and Economic Development Oversight Committee: DO PASS",14,1,0,0,15
1926830,1516601,2025-03-12,House,"House: THIRD READING",83,5,0,11,99
1926830,1538591,2025-04-07,Senate,"Senate: Aeronautics & Transportation Committee: DO PASS AMENDED",11,0,0,0,11
1926830,1596151,2025-04-23,Senate,"Senate: Appropriations Committee: DO PASS",23,0,0,0,23
1926838,1489264,2025-02-12,House,"House: Appropriations and Budget Committee: DO PASS AS AMENDED BY CS",26,0,0,0,26
1926838,1501029,2025-02-27,House,"House: THIRD READING",87,5,0,7,99
1926838,1554223,2025-04-22,Senate,"Senate: Judiciary Committee: DO PASS",7,1,0,0,8
1926838,1567401,2025-05-07,Senate,"Senate: THIRD READING",26,17,0,4,47
1926839,1490801,2025-02-17,House,"House: Appropriations and Budget Natural Resources Subcommittee: DO PASS AS AMENDED BY CS",6,4,0,0,10
1926842,1573439,2025-05-19,Senate,"Senate: Committee on Appropriations and Budget: DO PASS AMENDED CS",20,4,0,0,24
1926842,1573440,2025-05-19,House,"House: Committee on Appropriations and Budget Committee: DO PASS AS AMENDED BY CS",20,5,0,0,25
1926842,1574565,2025-05-20,House,"House: THIRD READING",55,32,0,11,98
1926842,1576788,2025-05-22,Senate,"Senate: THIRD READING",35,11,0,2,48
1926861,1573140,2025-05-19,House,"House: Committee on Appropriations and Budget Committee: DO PASS AS AMENDED BY CS",26,0,0,0,26
1926861,1574269,2025-05-19,Senate,"Senate: Committee on Appropriations and Budget: DO PASS AMENDED CS",25,0,0,0,25
1926861,1574270,2025-05-20,House,"House: THIRD READING",81,4,0,13,98
1926861,1576784,2025-05-22,Senate,"Senate: THIRD READING",45,0,0,3,48
1926862,1495424,2025-02-20,House,"House: Utilities Committee: DO PASS AS AMENDED BY CS",9,0,0,0,9
1926862,1499772,2025-02-26,House,"House: Energy and Natural Resources Oversight Committee: DO PASS AS AMENDED BY CS",15,0,0,0,15
1926862,1527414,2025-03-26,House,"House: THIRD READING",83,11,0,5,99
1926862,1563661,2025-04-15,Senate,"Senate: Judiciary Committee: DO PASS",6,2,0,0,8
1926862,1566196,2025-05-06,Senate,"Senate: THIRD READING",46,1,0,0,47
1926862,1576470,2025-05-22,House,"House: FOURTH READING",73,4,0,21,98
1926862,1591523,2025-05-28,Senate,"Senate: FOURTH READING",45,2,0,1,48
1926864,1497444,2025-02-24,House,"House: General Government Committee: DO PASS",8,0,0,0,8
1926864,1507558,2025-03-06,House,"House: Government Oversight Committee: DO PASS AS AMENDED BY CS",15,0,0,0,15
1926864,1525013,2025-03-24,House,"House: THIRD READING",88,4,0,7,99
1926871,1491150,2025-02-17,House,"House: Appropriations and Budget Natural Resources Subcommittee: DO PASS",10,0,0,0,10
1926871,1506785,2025-03-05,House,"House: Appropriations and Budget Committee: DO PASS",33,0,0,0,33
1926871,1517333,2025-03-13,House,"House: THIRD READING",80,4,0,15,99
1926871,1538266,2025-04-07,Senate,"Senate: Agriculture & Wildlife Committee: DO PASS",9,2,1,0,12
1926881,1573040,2025-05-19,House,"House: Committee on Appropriations and Budget Committee: DO PASS AS AMENDED BY CS",26,0,0,0,26
1926881,1574326,2025-05-19,Senate,"Senate: Committee on Appropriations and Budget: DO PASS AMENDED CS",23,1,0,0,24
1926881,1574327,2025-05-20,House,"House: THIRD READING",83,5,0,10,98
1926881,1576777,2025-05-22,Senate,"Senate: THIRD READING",34,10,0,4,48
1926884,1573127,2025-05-19,House,"House: Committee on Appropriations and Budget Committee: DO PASS AS AMENDED BY CS",29,0,0,0,29
1926884,1574227,2025-05-19,Senate,"Senate: Committee on Appropriations and Budget: DO PASS AMENDED CS",19,2,0,0,21
1926884,1574228,2025-05-20,House,"House: THIRD READING",87,0,1,10,98
1926884,1576793,2025-05-22,Senate,"Senate: THIRD READING",43,0,0,5,48
1926887,1491234,2025-02-17,House,"House: Appropriations and Budget Natural Resources Subcommittee: DO PASS",3,7,0,0,10
1926889,1486810,2025-02-11,House,"House: Postsecondary Education Committee: DO PASS",8,0,0,0,8
1926889,1503635,2025-03-03,House,"House: Education Oversight Committee: DO PASS",9,0,0,0,9
1926889,1527260,2025-03-26,House,"House: THIRD READING",81,5,0,13,99
1926889,1554238,2025-04-22,Senate,"Senate: Education Committee: DO PASS",10,0,0,0,10
1926889,1561970,2025-04-30,Senate,"Senate: THIRD READING",43,0,0,4,47
1926890,1500784,2025-02-26,House,"House: Appropriations and Budget Committee: DO PASS",30,0,0,0,30
1926890,1516067,2025-03-12,House,"House: THIRD READING",72,11,0,16,99
1926890,1538213,2025-04-07,Senate,"Senate: Health & Human Services Committee: DO PASS AMENDED",8,3,0,0,11
1926890,1596150,2025-04-23,Senate,"Senate: Appropriations Committee: DO PASS",15,6,0,0,21
1926892,1487060,2025-02-11,House,"House: Criminal Judiciary Committee: DO PASS",5,0,0,0,5
1926892,1504617,2025-03-04,House,"House: Judiciary and Public Safety Oversight Committee: DO PASS",13,0,0,0,13
1926892,1517144,2025-03-13,House,"House: THIRD READING",84,0,0,15,99
1926892,1539293,2025-04-08,Senate,"Senate: Public Safety Committee: DO PASS",7,1,0,0,8
1926892,1565151,2025-05-05,Senate,"Senate: THIRD READING",43,3,0,1,47
1926892,1571331,2025-05-14,House,"House: FOURTH READING",84,0,0,14,98
1926895,1573036,2025-05-19,House,"House: Committee on Appropriations and Budget Committee: DO PASS AS AMENDED BY CS",27,0,0,0,27
1926895,1573779,2025-05-19,Senate,"Senate: Committee on Appropriations and Budget: DO PASS AMENDED CS",24,0,0,0,24
1926895,1574566,2025-05-20,House,"House: THIRD READING",86,0,0,12,98
1926895,1576797,2025-05-22,Senate,"Senate: THIRD READING",43,0,0,5,48
1926990,1484661,2025-02-10,House,"House: Appropriations and Budget Education Subcommittee: DO PASS",9,0,0,0,9
1926990,1500418,2025-02-26,House,"House: Appropriations and Budget Committee: DO PASS AS AMENDED BY CS",30,0,0,0,30
1926990,1526875,2025-03-25,House,"House: THIRD READING",86,1,0,12,99
1950238,1479220,2025-02-03,House,"House: ADOPT RESOLUTION",71,20,0,8,99
1955576,1482434,2025-02-05,House,"House: ADOPT RESOLUTION",74,11,0,14,99
1965043,1488552,2025-02-12,House,"House: Appropriations and Budget Committee: DO PASS",27,0,0,0,27
1965043,1493724,2025-02-19,House,"House: ,                    ADOPT RESOLUTION",91,0,0,8,99
1965043,1596154,2025-02-19,House,"House: ADOPT RESOLUTION",91,0,0,8,99
2015861,1536008,2025-04-03,Senate,"Senate: Administrative Rules Committee: DO PASS",6,0,0,0,6
2015861,1570481,2025-05-13,Senate,"Senate: THIRD READING",44,0,0,3,47
2015861,1573319,2025-05-19,House,"House: Administrative Rules Committee: DO PASS",12,0,0,0,12
2015861,1575379,2025-05-21,House,"House: THIRD READING",82,0,0,16,98
2016841,1573164,2025-05-19,Senate,"Senate: Committee on Appropriations and Budget: DO PASS AMENDED CS",21,5,0,0,26
2016841,1573787,2025-05-19,House,"House: Committee on Appropriations and Budget Committee: DO PASS AS AMENDED BY CS",26,0,0,0,26
2016841,1573996,2025-05-20,Senate,"Senate: THIRD READING",30,16,0,1,47
2016841,1576369,2025-05-22,House,"House: THIRD READING",86,6,0,6,98
2016855,1573168,2025-05-19,Senate,"Senate: Committee on Appropriations and Budget: DO PASS AMENDED CS",23,3,0,0,26
2016855,1573792,2025-05-19,House,"House: Committee on Appropriations and Budget Committee: DO PASS AS AMENDED BY CS",25,0,0,0,25
2016855,1574037,2025-05-20,Senate,"Senate: THIRD READING",28,16,0,3,47
2016855,1576264,2025-05-22,House,"House: THIRD READING",92,0,0,6,98
2016889,1573154,2025-05-19,Senate,"Senate: Committee on Appropriations and Budget: DO PASS AMENDED CS",26,0,0,0,26
2016889,1573155,2025-05-19,House,"House: Committee on Appropriations and Budget Committee: DO PASS AS AMENDED BY CS",28,0,0,0,28
2016889,1574353,2025-05-20,Senate,"Senate: THIRD READING",33,13,0,1,47
2016889,1576331,2025-05-22,House,"House: THIRD READING",78,12,0,8,98
2016892,1573143,2025-05-19,Senate,"Senate: Committee on Appropriations and Budget: DO PASS AMENDED CS",24,1,0,0,25
2016892,1573144,2025-05-19,House,"House: Committee on Appropriations and Budget Committee: DO PASS AS AMENDED BY CS",24,1,0,0,25
2016892,1574384,2025-05-20,Senate,"Senate: THIRD READING",31,14,0,2,47
2016892,1575977,2025-05-22,House,"House: THIRD READING",85,6,0,7,98
2016907,1573119,2025-05-19,Senate,"Senate: Committee on Appropriations and Budget: DO PASS AMENDED CS",25,1,0,0,26
2016907,1573120,2025-05-19,House,"House: Committee on Appropriations and Budget Committee: DO PASS AS AMENDED BY CS",28,0,0,0,28
2016907,1574209,2025-05-20,Senate,"Senate: THIRD READING",31,14,0,2,47
2016907,1576217,2025-05-22,House,"House: THIRD READING",76,13,0,9,98
2016918,1573131,2025-05-19,Senate,"Senate: Committee on Appropriations and Budget: DO PASS AMENDED CS",25,1,0,0,26
2016918,1573132,2025-05-19,House,"House: Committee on Appropriations and Budget Committee: DO PASS AS AMENDED BY CS",27,0,0,0,27
2016918,1574245,2025-05-20,Senate,"Senate: THIRD READING",35,11,0,1,47
2016918,1576267,2025-05-22,House,"House: THIRD READING",81,12,0,5,98
2016922,1574238,2025-05-19,Senate,"Senate: Committee on Appropriations and Budget: DO PASS AMENDED CS",22,1,0,0,23
2016922,1574239,2025-05-20,Senate,"Senate: THIRD READING",29,15,0,3,47
2016922,1574240,2025-05-19,House,"House: Committee on Appropriations and Budget Committee: DO PASS AS AMENDED BY CS",26,0,0,0,26
2016922,1576219,2025-05-22,House,"House: THIRD READING",72,12,0,14,98
2016937,1574284,2025-05-19,Senate,"Senate: Committee on Appropriations and Budget: DO PASS AMENDED CS",20,5,0,0,25
2016937,1574285,2025-05-20,Senate,"Senate: THIRD READING",30,13,0,4,47
2016937,1574286,2025-05-19,House,"House: Committee on Appropriations and Budget Committee: DO PASS AS AMENDED BY CS",20,5,0,0,25
2016937,1576309,2025-05-22,House,"House: THIRD READING",62,30,0,6,98
2016937,1576310,2025-05-22,House,"House: EMERGENCY",69,20,0,9,98
2016943,1573145,2025-05-19,Senate,"Senate: Committee on Appropriations and Budget: DO PASS AMENDED CS",17,9,0,0,26
2016943,1574304,2025-05-20,Senate,"Senate: THIRD READING",40,6,0,1,47
2016943,1574305,2025-05-19,House,"House: Committee on Appropriations and Budget Committee: DO PASS AS AMENDED BY CS",19,6,0,0,25
2016943,1576338,2025-05-22,House,"House: THIRD READING",76,16,0,6,98
2016957,1573156,2025-05-19,Senate,"Senate: Committee on Appropriations and Budget: DO PASS AMENDED CS",25,1,0,0,26
2016957,1573157,2025-05-19,House,"House: Committee on Appropriations and Budget Committee: DO PASS AS AMENDED BY CS",26,0,0,0,26
2016957,1573950,2025-05-20,Senate,"Senate: THIRD READING",34,12,0,1,47
2016957,1576190,2025-05-22,House,"House: THIRD READING",73,17,0,8,98
2016972,1573146,2025-05-19,Senate,"Senate: Committee on Appropriations and Budget: DO PASS AMENDED CS",26,0,0,0,26
2016972,1573147,2025-05-19,House,"House: Committee on Appropriations and Budget Committee: DO PASS AS AMENDED BY CS",24,0,0,0,24
2016972,1574275,2025-05-20,Senate,"Senate: THIRD READING",42,4,0,1,47
2016972,1576314,2025-05-22,House,"House: THIRD READING",87,0,0,11,98
2016975,1573798,2025-05-19,Senate,"Senate: Committee on Appropriations and Budget: DO PASS AMENDED CS",22,3,0,0,25
2016975,1573799,2025-05-19,House,"House: Committee on Appropriations and Budget Committee: DO PASS AS AMENDED BY CS",25,0,0,0,25
2016975,1574448,2025-05-20,Senate,"Senate: THIRD READING",30,13,0,4,47
2016975,1576402,2025-05-22,House,"House: THIRD READING",42,48,0,8,98
2016987,1573167,2025-05-19,Senate,"Senate: Committee on Appropriations and Budget: DO PASS AMENDED CS",25,0,0,0,25
2016987,1573797,2025-05-19,House,"House: Committee on Appropriations and Budget Committee: DO PASS AS AMENDED BY CS",26,0,0,0,26
2016987,1574001,2025-05-20,Senate,"Senate: THIRD READING",35,9,0,3,47
2016987,1576397,2025-05-22,House,"House: THIRD READING",92,0,0,6,98
2016998,1573130,2025-05-19,House,"House: Committee on Appropriations and Budget Committee: DO PASS AS AMENDED BY CS",25,2,0,0,27
2016998,1574277,2025-05-19,Senate,"Senate: Committee on Appropriations and Budget: DO PASS AMENDED CS",16,7,0,0,23
2016998,1574278,2025-05-20,Senate,"Senate: THIRD READING",31,15,0,1,47
2016998,1576324,2025-05-22,House,"House: THIRD READING",80,7,0,11,98
2017001,1573124,2025-05-19,Senate,"Senate: Committee on Appropriations and Budget: DO PASS AMENDED CS",25,0,0,0,25
2017001,1573125,2025-05-19,House,"House: Committee on Appropriations and Budget Committee: DO PASS AS AMENDED BY CS",27,0,0,0,27
2017001,1573922,2025-05-20,Senate,"Senate: THIRD READING",45,0,0,2,47
2017001,1576371,2025-05-22,House,"House: THIRD READING",82,2,0,14,98
2017152,1573958,2025-05-19,Senate,"Senate: Committee on Appropriations and Budget: DO PASS AMENDED CS",23,2,0,0,25
2017152,1573959,2025-05-20,Senate,"Senate: THIRD READING",25,19,0,3,47
2017152,1573960,2025-05-19,House,"House: Committee on Appropriations and Budget Committee: DO PASS AS AMENDED BY CS",26,0,0,0,26
2017152,1576399,2025-05-22,House,"House: THIRD READING",65,23,0,10,98
2017177,1573151,2025-05-19,House,"House: Committee on Appropriations and Budget Committee: DO PASS AS AMENDED BY CS",23,6,0,0,29
2017177,1573785,2025-05-19,Senate,"Senate: Committee on Appropriations and Budget: DO PASS AMENDED CS",21,0,0,0,21
2017177,1574577,2025-05-20,Senate,"Senate: THIRD READING",42,0,0,5,47
2017177,1576290,2025-05-22,House,"House: THIRD READING",85,1,0,12,98
2017268,1574289,2025-05-19,Senate,"Senate: Committee on Appropriations and Budget: DO PASS AMENDED CS",22,0,0,0,22
2017268,1574290,2025-05-20,Senate,"Senate: THIRD READING",29,16,0,2,47
2017268,1574291,2025-05-19,House,"House: Committee on Appropriations and Budget Committee: DO PASS AS AMENDED BY CS",26,0,0,0,26
2017268,1576322,2025-05-22,House,"House: THIRD READING",70,19,0,9,98
2017389,1574233,2025-05-19,Senate,"Senate: Committee on Appropriations and Budget: DO PASS AMENDED CS",23,0,0,0,23
2017389,1574234,2025-05-20,Senate,"Senate: THIRD READING",45,0,0,2,47
2017389,1574235,2025-05-19,House,"House: Committee on Appropriations and Budget Committee: DO PASS AS AMENDED BY CS",23,0,0,0,23
2017389,1576247,2025-05-22,House,"House: THIRD READING",87,0,0,11,98
2017413,1573793,2025-05-19,Senate,"Senate: Committee on Appropriations and Budget: DO PASS AMENDED CS",23,0,0,0,23
2017413,1573794,2025-05-19,House,"House: Committee on Appropriations and Budget Committee: DO PASS AS AMENDED BY CS",26,0,0,0,26
2017413,1574002,2025-05-20,Senate,"Senate: THIRD READING",32,12,0,3,47
2017413,1576393,2025-05-22,House,"House: THIRD READING",72,13,0,13,98
2017461,1574386,2025-05-19,Senate,"Senate: Committee on Appropriations and Budget: DO PASS AMENDED CS",24,1,0,0,25
2017461,1574387,2025-05-20,Senate,"Senate: THIRD READING",44,2,0,1,47
2017461,1574388,2025-05-19,House,"House: Committee on Appropriations and Budget Committee: DO PASS AS AMENDED BY CS",23,1,0,0,24
2017461,1576374,2025-05-22,House,"House: THIRD READING",72,0,0,26,98
2017461,1576375,2025-05-22,House,"House: EMERGENCY",14,12,0,72,98
2017497,1574300,2025-05-19,Senate,"Senate: Committee on Appropriations and Budget: DO PASS AMENDED CS",24,0,0,0,24
2017497,1574301,2025-05-20,Senate,"Senate: THIRD READING",44,2,0,1,47
2017497,1574302,2025-05-19,House,"House: Committee on Appropriations and Budget Committee: DO PASS AS AMENDED BY CS",25,1,0,0,26
2017497,1576332,2025-05-22,House,"House: THIRD READING",80,11,0,7,98
2024055,1551045,2025-04-17,House,"House: ADOPT RESOLUTION",71,16,0,11,98
2027617,1565155,2025-05-05,House,"House: Administrative Rules Committee: DO PASS AS AMENDED BY CS",11,0,0,0,11
2027617,1571852,2025-05-15,House,"House: THIRD READING",81,0,0,17,98
2027617,1576813,2025-05-21,Senate,"Senate: THIRD READING",42,0,0,6,48
2027630,1564867,2025-05-05,House,"House: Administrative Rules Committee: DO PASS",11,0,0,0,11
2027630,1571866,2025-05-15,House,"House: THIRD READING",78,3,0,17,98
2027630,1576812,2025-05-21,Senate,"Senate: THIRD READING",43,0,0,5,48
2027643,1564932,2025-05-05,House,"House: Administrative Rules Committee: DO PASS",10,0,0,0,10
2027643,1571931,2025-05-15,House,"House: THIRD READING",83,0,0,15,98
2027643,1576811,2025-05-21,Senate,"Senate: THIRD READING",44,0,0,4,48
2027655,1565144,2025-05-05,House,"House: Administrative Rules Committee: DO PASS",9,2,0,0,11
2027655,1575412,2025-05-21,House,"House: THIRD READING",70,16,0,12,98
2027689,1567215,2025-05-07,Senate,"Senate: Administrative Rules Committee: DO PASS",6,1,0,0,7
2027689,1570519,2025-05-13,Senate,"Senate: THIRD READING",43,0,0,4,47
2027689,1573429,2025-05-19,House,"House: Administrative Rules Committee: DO PASS",13,0,0,0,13
2027689,1575170,2025-05-21,House,"House: THIRD READING",90,0,0,8,98
2027689,1596432,2025-05-13,Senate,"Senate: TABLE",27,17,0,3,47
2027689,1596433,2025-05-13,Senate,"Senate: AMENDMENT",43,0,0,4,47
2027780,1567058,2025-05-07,Senate,"Senate: Administrative Rules Committee: DO PASS AMENDED",9,0,0,0,9
2027780,1570246,2025-05-13,Senate,"Senate: THIRD READING",43,0,0,4,47
2027780,1573364,2025-05-19,House,"House: Administrative Rules Committee: DO PASS",12,0,0,0,12
2027780,1575125,2025-05-21,House,"House: THIRD READING",86,0,0,12,98
2034529,1581959,2025-05-29,House,"House: ADOPT RESOLUTION",81,5,0,12,98
2034529,1596431,2025-05-29,Senate,"Senate: ADOPT",43,1,0,4,48
