bill_id,roll_call_id,date,chamber,description,yea,nay,nv,absent,total
1895895,1480870,2025-01-15,House,"(H) Education--Do Pass",15,0,0,0,15
1895895,1480871,2025-01-20,House,"(H) 2nd Reading Passed",91,8,0,1,100
1895895,1480872,2025-01-21,House,"(H) 3rd Reading Passed",79,20,0,1,100
1895895,1520245,2025-03-18,Senate,"(S) Education and Cultural Resources--Be Concurred In",14,0,0,0,14
1895895,1523215,2025-03-20,Senate,"(S) 2nd Reading Concurred",49,1,0,0,50
1895895,1524155,2025-03-21,Senate,"(S) 3rd Reading Concurred",49,1,0,0,50
1895895,1569472,2025-01-15,House,"(H) Education--Do Pass",15,0,0,0,15
1895896,1480873,2025-01-10,House,"(H) State Administration--Do Pass",19,0,0,0,19
1895896,1480874,2025-01-13,House,"(H) 2nd Reading Passed",99,0,0,1,100
1895896,1480875,2025-01-14,House,"(H) 3rd Reading Passed",100,0,0,0,100
1895896,1527728,2025-03-26,Senate,"(S) State Administration--Be Concurred In",9,0,0,0,9
1895896,1546548,2025-04-12,Senate,"(S) 2nd Reading Concurred",49,0,0,1,50
1895896,1546898,2025-04-14,Senate,"(S) 3rd Reading Concurred",48,0,0,2,50
1895897,1480877,2025-01-14,House,"(H) Taxation--Do Pass",21,0,0,0,21
1895897,1480878,2025-01-17,House,"(H) 2nd Reading Passed",100,0,0,0,100
1895897,1480879,2025-01-20,House,"(H) 3rd Reading Passed",98,0,0,2,100
1895897,1488094,2025-01-29,Senate,"(S) Taxation--Be Concurred In",8,0,0,0,8
1895897,1490688,2025-02-15,Senate,"(S) 2nd Reading Concurred",46,4,0,0,50
1895897,1492428,2025-02-18,Senate,"(S) 3rd Reading Concurred",48,2,0,0,50
1895898,1480881,2025-01-15,Senate,"(S) Highways and Transportation--Do Pass",16,0,0,0,16
1895898,1480883,2025-01-17,Senate,"(S) 2nd Reading Passed",48,2,0,0,50
1895898,1480884,2025-01-29,Senate,"(S) Highways and Transportation--Do Pass As Amended",8,0,0,0,8
1895898,1480885,2025-02-05,Senate,"(S) 2nd Reading Passed",50,0,0,0,50
1895898,1483397,2025-02-06,Senate,"(S) 3rd Reading Passed",48,1,0,1,50
1895898,1496228,2025-02-21,House,"(H) Legislative Administration--Be Concurred In",12,0,0,2,14
1895898,1519319,2025-03-17,House,"(H) 2nd Reading Concurred",97,3,0,0,100
1895898,1519668,2025-03-18,House,"(H) 3rd Reading Concurred",96,2,0,2,100
1895899,1488756,2025-02-13,Senate,"(S) Taxation--To Table",8,0,0,0,8
1895900,1484736,2025-01-10,Senate,"(S) Rules--Resolution Adopted",12,6,0,0,18
1895900,1539673,2025-04-08,Senate,"(S) 2nd Reading Passed",50,0,0,0,50
1895900,1542098,2025-04-09,Senate,"(S) 3rd Reading Passed",44,5,0,1,50
1895900,1550004,2025-04-16,House,"(H) Rules--Resolution Adopted",15,1,6,0,22
1895900,1551210,2025-04-16,House,"(H) Rules--Resolution Adopted",15,1,6,0,22
1895900,1555638,2025-04-23,House,"(H) 2nd Reading Concurred",77,23,0,0,100
1895900,1556947,2025-04-24,House,"(H) 3rd Reading Concurred",80,20,0,0,100
1895901,1480887,2025-01-10,House,"(H) State Administration--Do Pass As Amended",19,0,0,0,19
1895901,1480888,2025-01-14,House,"(H) 2nd Reading Passed",99,1,0,0,100
1895901,1480889,2025-01-15,House,"(H) 3rd Reading Passed",100,0,0,0,100
1895901,1527819,2025-03-26,Senate,"(S) State Administration--To Table",9,0,0,0,9
1895901,1529961,2025-03-26,Senate,"(S) State Administration--To Table",9,0,0,0,9
1895902,1480890,2025-01-15,House,"(H) Natural Resources--Do Pass",14,0,0,0,14
1895902,1480891,2025-01-20,House,"(H) 2nd Reading Passed",99,0,0,1,100
1895902,1480892,2025-01-21,House,"(H) 3rd Reading Passed",99,0,0,1,100
1895902,1524220,2025-03-21,Senate,"(S) Natural Resources--Be Concurred In",11,0,0,0,11
1895902,1527431,2025-03-26,Senate,"(S) 2nd Reading Concurred",47,3,0,0,50
1895902,1528980,2025-03-27,Senate,"(S) 3rd Reading Concurred",45,5,0,0,50
1895903,1480901,2025-01-10,House,"(H) Education--Do Pass As Amended",11,4,0,0,15
1895903,1480902,2025-01-16,House,"(H) 2nd Reading Passed",74,26,0,0,100
1895903,1480903,2025-01-17,House,"(H) 3rd Reading Passed",73,25,0,2,100
1895903,1488215,2025-02-04,Senate,"(S) Education and Cultural Resources--Be Concurred In",9,5,0,0,14
1895903,1493801,2025-02-19,Senate,"(S) 2nd Reading Concurred",28,21,0,1,50
1895903,1523037,2025-03-20,Senate,"(S) Finance and Claims--Be Concurred In",22,0,0,0,22
1895903,1524102,2025-03-21,Senate,"(S) 3rd Reading Concurred",42,8,0,0,50
1895904,1480904,2025-01-15,House,"(H) Energy, Technology and Federal Relations--Do Pass",13,1,0,0,14
1895904,1480905,2025-01-20,House,"(H) 2nd Reading Passed",89,10,0,1,100
1895904,1480906,2025-01-21,House,"(H) 3rd Reading Passed",85,14,0,1,100
1895904,1538130,2025-04-01,Senate,"(S) Energy, Technology & Federal Relations--Be Concurred In As Amended",13,0,0,0,13
1895904,1542219,2025-04-09,Senate,"(S) 2nd Reading Concurred",50,0,0,0,50
1895904,1543782,2025-04-10,Senate,"(S) 3rd Reading Concurred",48,0,0,2,50
1895904,1548444,2025-04-15,House,"(H) 2nd Reading Senate Amendments Concurred",100,0,0,0,100
1895904,1550149,2025-04-16,House,"(H) 3rd Reading Passed as Amended by Senate",97,1,0,2,100
1895904,1561581,2025-01-15,House,"(H) Energy, Technology and Federal Relations--Do Pass",13,1,0,0,14
1895905,1480908,2025-02-05,Senate,"(S) 2nd Reading Passed",32,18,0,0,50
1895905,1499242,2025-02-25,Senate,"(S) Finance and Claims--Do Pass",14,8,0,0,22
1895905,1501654,2025-02-27,Senate,"(S) 3rd Reading Passed",34,16,0,0,50
1895905,1539967,2025-04-08,House,"(H) Judiciary--Be Concurred In As Amended",13,7,0,0,20
1895905,1542405,2025-04-09,House,"(H) Appropriations--Be Concurred In",15,8,0,0,23
1895905,1545497,2025-04-11,House,"(H) 2nd Reading Concurred",63,37,0,0,100
1895905,1546102,2025-04-11,House,"(H) 3rd Reading Concurred",61,38,0,1,100
1895905,1549680,2025-04-16,Senate,"(S) 2nd Reading House Amendments Concurred",47,2,0,1,50
1895905,1551478,2025-04-17,Senate,"(S) 3rd Reading Passed as Amended by House",37,13,0,0,50
1895906,1480909,2025-01-22,Senate,"(S) State Administration--Do Pass",5,4,0,0,9
1895906,1480910,2025-01-30,Senate,"(S) 2nd Reading Passed",29,21,0,0,50
1895906,1480911,2025-01-31,Senate,"(S) 3rd Reading Passed",31,19,0,0,50
1895906,1522412,2025-03-20,House,"(H) State Administration--Be Concurred In",19,0,0,0,19
1895906,1525333,2025-03-24,House,"(H) 2nd Reading Concurred",76,22,0,2,100
1895906,1526353,2025-03-25,House,"(H) 3rd Reading Concurred",63,36,0,1,100
1895907,1480912,2025-01-15,House,"(H) Energy, Technology and Federal Relations--Do Pass",14,0,0,0,14
1895907,1480913,2025-01-20,House,"(H) 2nd Reading Motion to Amend Carried",99,0,0,1,100
1895907,1480914,2025-01-20,House,"(H) 2nd Reading Passed as Amended",97,2,0,1,100
1895907,1480915,2025-01-22,House,"(H) 3rd Reading Passed",99,1,0,0,100
1895907,1522059,2025-03-19,Senate,"(S) State Administration--Be Concurred In",9,0,0,0,9
1895907,1524716,2025-03-24,Senate,"(S) 2nd Reading Concurred",50,0,0,0,50
1895907,1526226,2025-03-25,Senate,"(S) 3rd Reading Concurred",47,3,0,0,50
1895907,1553872,2025-01-15,House,"(H) Energy, Technology and Federal Relations--Do Pass",14,0,0,0,14
1895908,1480917,2025-01-20,House,"(H) 2nd Reading Passed",96,3,0,1,100
1895908,1480918,2025-01-21,House,"(H) 3rd Reading Passed",94,5,0,1,100
1895908,1480919,2025-01-15,House,"(H) Energy, Technology and Federal Relations--",11,3,0,0,14
1895908,1529516,2025-03-27,Senate,"(S) Energy, Technology & Federal Relations--Resolution Adopted",8,0,0,5,13
1895908,1552072,2025-04-18,Senate,"(S) 2nd Reading Concurred",48,1,0,1,50
1895908,1553923,2025-04-22,Senate,"(S) 3rd Reading Concurred",47,3,0,0,50
1895908,1553924,2025-01-15,House,"(H) Energy, Technology and Federal Relations--Do Pass",11,3,0,0,14
1895909,1480930,2025-01-14,House,"(H) Local Government--Do Pass",119,0,0,0,119
1895909,1480937,2025-01-24,House,"(H) 2nd Reading Passed",100,0,0,0,100
1895909,1480938,2025-01-27,House,"(H) Appropriations--Do Pass",20,0,0,3,23
1895909,1480939,2025-01-30,House,"(H) 3rd Reading Passed",100,0,0,0,100
1895909,1524179,2025-03-21,Senate,"(S) Natural Resources--Be Concurred In",11,0,0,0,11
1895909,1534358,2025-04-02,Senate,"(S) 2nd Reading Concurred",50,0,0,0,50
1895909,1546842,2025-04-14,Senate,"(S) Finance and Claims--Be Concurred In",22,0,0,0,22
1895909,1548957,2025-04-15,Senate,"(S) 3rd Reading Concurred",49,0,0,1,50
1895910,1480945,2025-01-16,House,"(H) Judiciary--Do Pass",79,0,0,0,79
1895910,1480949,2025-01-20,House,"(H) 2nd Reading Passed",90,9,0,1,100
1895910,1480950,2025-01-21,House,"(H) 3rd Reading Passed",77,22,0,1,100
1895910,1493156,2025-02-19,Senate,"(S) Judiciary--Be Concurred In",8,0,0,1,9
1895910,1523090,2025-03-20,Senate,"(S) 2nd Reading Concurred",48,1,0,1,50
1895910,1524123,2025-03-21,Senate,"(S) 3rd Reading Concurred",49,1,0,0,50
1895911,1480951,2025-01-10,House,"(H) Judiciary--Do Pass",15,5,0,0,20
1895911,1480952,2025-01-17,House,"(H) 2nd Reading Passed",87,13,0,0,100
1895911,1480953,2025-01-20,House,"(H) 3rd Reading Passed",85,13,0,2,100
1895911,1488921,2025-02-06,Senate,"(S) Judiciary--Be Concurred In",8,1,0,0,9
1895911,1490386,2025-02-14,Senate,"(S) 2nd Reading Concurred",48,2,0,0,50
1895911,1490712,2025-02-15,Senate,"(S) 3rd Reading Concurred",46,2,0,2,50
1895912,1480955,2025-01-14,House,"(H) Taxation--Do Pass",21,0,0,0,21
1895912,1480956,2025-01-16,House,"(H) 2nd Reading Passed",100,0,0,0,100
1895912,1480957,2025-01-17,House,"(H) 3rd Reading Passed",97,1,0,2,100
1895912,1487619,2025-01-29,Senate,"(S) Taxation--Be Concurred In",8,0,0,0,8
1895912,1489374,2025-02-13,Senate,"(S) 2nd Reading Concurred",49,1,0,0,50
1895912,1490263,2025-02-14,Senate,"(S) 3rd Reading Concurred",49,0,0,1,50
1895913,1480958,2025-01-29,House,"(H) Judiciary--Do Pass",11,9,0,0,20
1895913,1480959,2025-02-03,House,"(H) 2nd Reading Not Passed",37,63,0,0,100
1895914,1480962,2025-01-09,House,"(H) Taxation--Do Pass As Amended",20,0,0,1,21
1895914,1480963,2025-01-10,House,"(H) 2nd Reading Passed",100,0,0,0,100
1895914,1480964,2025-01-14,House,"(H) Appropriations--Do Pass",23,0,0,0,23
1895914,1480965,2025-01-16,House,"(H) 3rd Reading Passed",98,0,0,2,100
1895914,1487512,2025-01-29,Senate,"(S) Taxation--Be Concurred In",8,0,0,0,8
1895914,1489353,2025-02-13,Senate,"(S) 2nd Reading Concurred",47,3,0,0,50
1895914,1523080,2025-03-20,Senate,"(S) Finance and Claims--Be Concurred In",22,0,0,0,22
1895914,1524101,2025-03-21,Senate,"(S) 3rd Reading Concurred",42,8,0,0,50
1895915,1480966,2025-01-10,House,"(H) Human Services--Do Pass As Amended",21,0,0,0,21
1895915,1480967,2025-01-15,House,"(H) 2nd Reading Passed",100,0,0,0,100
1895915,1480968,2025-01-16,House,"(H) 3rd Reading Passed",98,0,0,2,100
1895915,1526221,2025-01-10,House,"(H) Human Services--Do Pass As Amended",21,0,0,0,21
1895916,1480970,2025-01-09,House,"(H) Taxation--Do Pass",20,0,0,1,21
1895916,1480971,2025-01-10,House,"(H) 2nd Reading Passed",100,0,0,0,100
1895916,1480972,2025-01-13,House,"(H) 3rd Reading Passed",99,0,0,1,100
1895916,1487911,2025-01-23,Senate,"(S) Taxation--Be Concurred In",8,0,0,0,8
1895916,1487912,2025-02-12,Senate,"(S) 2nd Reading Concurred",47,3,0,0,50
1895916,1489176,2025-02-13,Senate,"(S) 3rd Reading Concurred",49,1,0,0,50
1895917,1480973,2025-01-13,House,"(H) Judiciary--Do Pass As Amended",18,2,0,0,20
1895917,1480974,2025-01-16,House,"(H) 2nd Reading Passed",96,4,0,0,100
1895917,1480975,2025-01-17,House,"(H) 3rd Reading Passed",94,4,0,2,100
1895917,1494851,2025-02-06,Senate,"(S) Judiciary--Be Concurred In",8,1,0,0,9
1895917,1496438,2025-02-21,Senate,"(S) 2nd Reading Concurred",44,6,0,0,50
1895917,1497927,2025-02-24,Senate,"(S) 3rd Reading Concurred",45,4,0,1,50
1895918,1480976,2025-01-22,Senate,"(S) Judiciary--Do Pass",6,3,0,0,9
1895918,1480977,2025-01-23,Senate,"(S) 2nd Reading Passed",32,18,0,0,50
1895918,1480978,2025-01-24,Senate,"(S) 3rd Reading Passed",31,18,0,1,50
1895918,1535810,2025-04-03,House,"(H) Judiciary--Be Concurred In",11,9,0,0,20
1895918,1543804,2025-04-10,House,"(H) 2nd Reading Not Concurred",27,73,0,0,100
1895919,1480980,2025-01-24,Senate,"(S) Highways and Transportation--Do Pass",7,1,0,0,8
1895919,1480981,2025-01-29,Senate,"(S) 2nd Reading Passed",47,3,0,0,50
1895919,1483503,2025-02-04,Senate,"(S) Finance and Claims--Do Pass",22,0,0,0,22
1895919,1484109,2025-02-07,Senate,"(S) 3rd Reading Passed",49,0,0,1,50
1895919,1493996,2025-02-19,House,"(H) Transportation--To Table",13,1,0,0,14
1895919,1530040,2025-02-19,House,"(H) Transportation--To Table",13,1,0,0,14
1895919,1553848,2025-02-19,House,"(H) Transportation--To Table",13,1,0,0,14
1895919,1577009,2025-02-19,House,"(H) Transportation--To Table",13,1,0,0,14
1895920,1480982,2025-01-09,House,"(H) Taxation--Do Pass",20,0,0,1,21
1895920,1480983,2025-01-10,House,"(H) 2nd Reading Passed",99,1,0,0,100
1895920,1480984,2025-01-13,House,"(H) 3rd Reading Passed",98,0,0,2,100
1895920,1480985,2025-01-10,House,"(H) 2nd Reading Motion to Amend Failed",38,62,0,0,100
1895920,1495405,2025-02-06,Senate,"(S) Taxation--Be Concurred In",8,0,0,0,8
1895920,1522757,2025-03-20,Senate,"(S) 2nd Reading Concurred",50,0,0,0,50
1895920,1524200,2025-03-21,Senate,"(S) 3rd Reading Concurred",49,1,0,0,50
1895921,1480986,2025-01-20,House,"(H) Judiciary--Do Pass",20,0,0,0,20
1895921,1480987,2025-01-22,House,"(H) 2nd Reading Passed",97,3,0,0,100
1895921,1480988,2025-01-23,House,"(H) 3rd Reading Passed",96,4,0,0,100
1895921,1504668,2025-03-04,Senate,"(S) Judiciary--Be Concurred In",5,3,0,0,8
1895921,1519936,2025-03-18,Senate,"(S) 2nd Reading Concurred",47,3,0,0,50
1895921,1521289,2025-03-19,Senate,"(S) 3rd Reading Concurred",47,3,0,0,50
1895922,1480989,2025-01-27,Senate,"(S) Local Government--Do Pass As Amended",11,0,0,0,11
1895922,1480990,2025-01-30,Senate,"(S) 2nd Reading Passed",50,0,0,0,50
1895922,1480991,2025-01-31,Senate,"(S) 3rd Reading Passed",50,0,0,0,50
1895922,1522365,2025-03-20,House,"(H) State Administration--Be Concurred In As Amended",19,0,0,0,19
1895922,1526319,2025-03-25,House,"(H) 2nd Reading Concurred",100,0,0,0,100
1895922,1527764,2025-03-26,House,"(H) 3rd Reading Concurred",99,0,0,1,100
1895922,1530247,2025-03-28,Senate,"(S) 2nd Reading House Amendments Concurred",48,1,0,1,50
1895922,1531402,2025-03-31,Senate,"(S) 3rd Reading Passed as Amended by House",50,0,0,0,50
1895923,1497077,2025-01-22,Senate,"(S) Local Government--Do Pass",11,0,0,0,11
1895923,1497078,2025-01-24,Senate,"(S) 2nd Reading Passed",50,0,0,0,50
1895923,1497079,2025-01-27,Senate,"(S) 3rd Reading Passed",49,0,0,1,50
1895923,1592184,2025-03-20,House,"(H) Local Government--Be Concurred In",17,0,0,0,17
1895923,1592185,2025-03-26,House,"(H) 2nd Reading Concurred",100,0,0,0,100
1895923,1592186,2025-03-27,House,"(H) 3rd Reading Concurred",99,0,0,1,100
1895924,1480992,2025-01-15,House,"(H) Natural Resources--Do Pass",14,0,0,0,14
1895924,1480993,2025-01-20,House,"(H) 2nd Reading Passed",99,0,0,1,100
1895924,1480994,2025-01-21,House,"(H) 3rd Reading Passed",99,0,0,1,100
1895924,1492433,2025-02-18,Senate,"(S) Energy, Technology & Federal Relations--Be Concurred In As Amended",13,0,0,0,13
1895924,1542348,2025-04-08,Senate,"(S) Energy, Technology & Federal Relations--Be Concurred In As Amended",10,0,3,0,13
1895924,1543850,2025-04-08,Senate,"(S) Energy, Technology & Federal Relations--Be Concurred In As Amended",10,0,3,0,13
1895924,1544944,2025-04-10,Senate,"(S) 2nd Reading Motion to Amend Failed",14,36,0,0,50
1895924,1544945,2025-04-10,Senate,"(S) 2nd Reading Concurred",44,6,0,0,50
1895924,1546088,2025-04-11,Senate,"(S) 3rd Reading Concurred",46,2,0,2,50
1895924,1550235,2025-04-16,House,"(H) 2nd Reading Senate Amendments Concurred",100,0,0,0,100
1895924,1551400,2025-04-17,House,"(H) 3rd Reading Passed as Amended by Senate",99,0,0,1,100
1895925,1480995,2025-01-24,Senate,"(S) Public Health, Welfare and Safety--Do Pass",10,1,0,0,11
1895925,1480996,2025-01-29,Senate,"(S) 2nd Reading Passed",47,3,0,0,50
1895925,1480997,2025-01-30,Senate,"(S) 3rd Reading Passed",48,1,0,1,50
1895925,1488798,2025-02-11,House,"(H) Human Services--Be Concurred In",21,0,0,0,21
1895925,1519317,2025-03-17,House,"(H) 2nd Reading Concurred",96,4,0,0,100
1895925,1520103,2025-03-18,House,"(H) 3rd Reading Concurred",91,7,0,2,100
1895925,1557965,2025-02-11,House,"(H) Human Services--Be Concurred In",21,0,0,0,21
1895927,1480998,2025-01-23,Senate,"(S) 2nd Reading Passed",50,0,0,0,50
1895927,1480999,2025-01-24,Senate,"(S) 3rd Reading Passed",49,0,0,1,50
1895927,1495639,2025-02-12,House,"(H) Energy, Technology and Federal Relations--Be Concurred In",14,0,0,0,14
1895927,1515832,2025-01-21,Senate,"(S) Energy, Technology & Federal Relations--Do Pass",13,0,0,0,13
1895927,1519318,2025-03-17,House,"(H) 2nd Reading Concurred",99,1,0,0,100
1895927,1519695,2025-03-18,House,"(H) 3rd Reading Concurred",97,1,0,2,100
1895928,1481004,2025-01-10,House,"(H) State Administration--Do Pass",11,8,0,0,19
1895928,1481005,2025-01-14,House,"(H) 2nd Reading Passed",57,43,0,0,100
1895928,1481006,2025-01-15,House,"(H) 3rd Reading Passed",57,43,0,0,100
1895928,1483520,2025-02-05,Senate,"(S) Judiciary--Be Concurred In",6,3,0,0,9
1895928,1490401,2025-02-14,Senate,"(S) 2nd Reading Concurred",26,24,0,0,50
1895928,1490713,2025-02-15,Senate,"(S) 3rd Reading Concurred",25,23,0,2,50
1895929,1481007,2025-01-15,House,"(H) Natural Resources--Do Pass",14,0,0,0,14
1895929,1481008,2025-01-20,House,"(H) 2nd Reading Passed",98,1,0,1,100
1895929,1481009,2025-01-21,House,"(H) 3rd Reading Passed",99,0,0,1,100
1895929,1543094,2025-04-09,Senate,"(S) Natural Resources--Be Concurred In",11,0,0,0,11
1895929,1545926,2025-04-11,Senate,"(S) 2nd Reading Concurred",42,8,0,0,50
1895929,1546688,2025-04-12,Senate,"(S) 3rd Reading Concurred",46,4,0,0,50
1895930,1481018,2025-01-14,House,"(H) Local Government--Do Pass",153,0,0,0,153
1895930,1481027,2025-01-17,House,"(H) 2nd Reading Passed",91,9,0,0,100
1895930,1481028,2025-01-20,House,"(H) 3rd Reading Passed",90,8,0,2,100
1895930,1518955,2025-03-17,Senate,"(S) Local Government--Be Concurred In",10,0,0,1,11
1895930,1521619,2025-03-19,Senate,"(S) 2nd Reading Concurred",46,4,0,0,50
1895930,1523233,2025-03-20,Senate,"(S) 3rd Reading Concurred",46,4,0,0,50
1895930,1559290,2025-01-14,House,"(H) Local Government--Do Pass",17,0,0,0,17
1895931,1481030,2025-01-09,House,"(H) Taxation--Do Pass",20,0,0,1,21
1895931,1481031,2025-01-10,House,"(H) 2nd Reading Passed",99,0,0,1,100
1895931,1481032,2025-01-13,House,"(H) 3rd Reading Passed",99,0,0,1,100
1895931,1488008,2025-01-23,Senate,"(S) Taxation--Be Concurred In",8,0,0,0,8
1895931,1493765,2025-02-19,Senate,"(S) 2nd Reading Concurred",50,0,0,0,50
1895931,1495238,2025-02-20,Senate,"(S) 3rd Reading Concurred",46,4,0,0,50
1895932,1481033,2025-01-22,Senate,"(S) Judiciary--Do Pass",6,3,0,0,9
1895932,1481034,2025-01-24,Senate,"(S) 2nd Reading Passed",32,18,0,0,50
1895932,1481035,2025-01-27,Senate,"(S) 3rd Reading Passed",31,18,0,1,50
1895932,1528712,2025-03-27,House,"(H) Judiciary--Be Concurred In",12,8,0,0,20
1895932,1543262,2025-04-10,House,"(H) 2nd Reading Concurred",58,42,0,0,100
1895932,1546146,2025-04-11,House,"(H) 3rd Reading Concurred",57,42,0,1,100
1895933,1481036,2025-01-31,Senate,"(S) State Administration--Do Pass",9,0,0,0,9
1895933,1481037,2025-02-05,Senate,"(S) 2nd Reading Passed",49,1,0,0,50
1895933,1483411,2025-02-06,Senate,"(S) 3rd Reading Passed",48,1,0,1,50
1895933,1488236,2025-01-31,Senate,"(S) State Administration--Do Pass",9,0,0,0,9
1895933,1522471,2025-03-20,House,"(H) State Administration--Be Concurred In",19,0,0,0,19
1895933,1526445,2025-03-25,House,"(H) 2nd Reading Concurred",100,0,0,0,100
1895933,1527842,2025-03-26,House,"(H) 3rd Reading Concurred",99,0,0,1,100
1895933,1539283,2025-01-31,Senate,"(S) State Administration--Do Pass",9,0,0,0,9
1895934,1491781,2025-02-18,Senate,"(S) Judiciary--To Table",9,0,0,0,9
1895935,1481038,2025-01-17,House,"(H) Taxation--Do Pass As Amended",16,5,0,0,21
1895935,1481039,2025-01-22,House,"(H) 2nd Reading Passed",59,41,0,0,100
1895935,1481040,2025-01-23,House,"(H) 3rd Reading Passed",63,37,0,0,100
1895935,1495373,2025-02-13,Senate,"(S) Taxation--Be Concurred In As Amended",7,1,0,0,8
1895935,1500254,2025-02-26,Senate,"(S) 2nd Reading Concurred",35,15,0,0,50
1895935,1501599,2025-02-27,Senate,"(S) 3rd Reading Concurred",34,16,0,0,50
1895935,1524723,2025-03-24,House,"(H) 2nd Reading Senate Amendments Concurred",57,42,0,1,100
1895935,1526179,2025-03-25,House,"(H) 3rd Reading Passed as Amended by Senate",57,42,0,1,100
1895936,1481041,2025-01-23,Senate,"(S) 2nd Reading Passed",46,4,0,0,50
1895936,1481042,2025-01-24,Senate,"(S) 3rd Reading Passed",45,4,0,1,50
1895936,1495504,2025-02-12,House,"(H) Energy, Technology and Federal Relations--Be Concurred In As Amended",14,0,0,0,14
1895936,1516029,2025-01-21,Senate,"(S) Energy, Technology & Federal Relations--Do Pass",0,13,0,0,13
1895936,1521201,2025-03-19,House,"(H) 2nd Reading Concurred",98,2,0,0,100
1895936,1523326,2025-03-20,House,"(H) 3rd Reading Concurred",97,1,0,2,100
1895936,1526695,2025-03-25,Senate,"(S) 2nd Reading House Amendments Concurred",48,2,0,0,50
1895936,1528066,2025-03-26,Senate,"(S) 3rd Reading Passed as Amended by House",50,0,0,0,50
1895936,1530065,2025-01-21,Senate,"(S) Energy, Technology & Federal Relations--Do Pass",13,0,0,0,13
1895936,1547046,2025-02-12,House,"(H) Energy, Technology and Federal Relations--Be Concurred In As Amended",14,0,0,0,14
1895937,1481043,2025-01-31,Senate,"(S) Business, Labor  and Economic Affairs--Do Pass",8,3,0,0,11
1895937,1481044,2025-02-04,Senate,"(S) 2nd Reading Passed",42,8,0,0,50
1895937,1487587,2025-02-11,Senate,"(S) Finance and Claims--Do Pass As Amended",21,1,0,0,22
1895937,1490700,2025-02-15,Senate,"(S) 2nd Reading Passed",47,3,0,0,50
1895937,1491898,2025-02-18,Senate,"(S) 3rd Reading Passed",47,3,0,0,50
1895937,1524006,2025-03-21,House,"(H) Business and Labor--Be Concurred In",17,3,0,0,20
1895937,1527936,2025-03-26,House,"(H) 2nd Reading Concurred",77,23,0,0,100
1895937,1540036,2025-04-08,House,"(H) Appropriations--To Table",12,11,0,0,23
1895937,1540037,2025-04-08,House,"(H) Appropriations--To Take From The Table",10,10,3,0,23
1895937,1543247,2025-04-09,House,"(H) Appropriations--Be Concurred In",15,8,0,0,23
1895937,1543248,2025-04-08,House,"(H) Appropriations--To Table",12,11,0,0,23
1895937,1543249,2025-04-09,House,"(H) Appropriations--To Take From The Table",15,7,1,0,23
1895938,1481045,2025-01-24,Senate,"(S) Judiciary--Do Pass",6,3,0,0,9
1895938,1490420,2025-02-14,Senate,"(S) 2nd Reading Passed",26,24,0,0,50
1895938,1490716,2025-02-15,Senate,"(S) 3rd Reading Passed",25,23,0,2,50
1895938,1551328,2025-04-17,House,"(H) Judiciary--To Table",20,0,0,0,20
1895938,1552079,2025-04-17,House,"(H) Judiciary--To Table",20,0,0,0,20
1895938,1580124,2025-04-17,House,"(H) Judiciary--To Table",20,0,0,0,20
1895939,1490525,2025-02-14,Senate,"(S) State Administration--Do Pass",9,0,0,0,9
1895939,1496728,2025-02-21,Senate,"(S) 2nd Reading Motion to Amend Carried",46,4,0,0,50
1895939,1496729,2025-02-21,Senate,"(S) 2nd Reading Passed as Amended",47,3,0,0,50
1895939,1499080,2025-02-25,Senate,"(S) 3rd Reading Passed",45,4,0,1,50
1895939,1528814,2025-03-27,House,"(H) State Administration--Be Concurred In",17,2,0,0,19
1895939,1530724,2025-03-29,House,"(H) 2nd Reading Concurred",80,20,0,0,100
1895939,1531121,2025-03-31,House,"(H) 3rd Reading Concurred",88,11,0,1,100
1895940,1481046,2025-01-24,Senate,"(S) Judiciary--Do Pass As Amended",6,3,0,0,9
1895940,1481047,2025-01-28,Senate,"(S) 2nd Reading Motion to Amend Failed",19,31,0,0,50
1895940,1481048,2025-01-28,Senate,"(S) 2nd Reading Passed",32,18,0,0,50
1895940,1481049,2025-01-29,Senate,"(S) 3rd Reading Passed",31,17,0,2,50
1895940,1524681,2025-03-24,House,"(H) Judiciary--Be Concurred In",12,8,0,0,20
1895940,1529091,2025-03-27,House,"(H) 2nd Reading Concurred",57,43,0,0,100
1895940,1530174,2025-03-28,House,"(H) 3rd Reading Failed",39,60,0,1,100
1895941,1481051,2025-01-15,House,"(H) Transportation--Do Pass As Amended",14,0,0,0,14
1895941,1481052,2025-01-20,House,"(H) 2nd Reading Passed",99,0,0,1,100
1895941,1481053,2025-01-21,House,"(H) 3rd Reading Passed",99,0,0,1,100
1895941,1487976,2025-01-29,Senate,"(S) Highways and Transportation--Be Concurred In",8,0,0,0,8
1895941,1490686,2025-02-15,Senate,"(S) 2nd Reading Concurred",44,6,0,0,50
1895941,1492387,2025-02-18,Senate,"(S) 3rd Reading Concurred",46,4,0,0,50
1895942,1481060,2025-01-20,House,"(H) Judiciary--Do Pass",12,8,0,0,20
1895942,1481061,2025-01-23,House,"(H) 2nd Reading Passed",57,42,0,1,100
1895942,1481062,2025-01-24,House,"(H) 3rd Reading Passed",58,39,0,3,100
1895942,1483517,2025-02-05,Senate,"(S) Judiciary--Be Concurred In",6,3,0,0,9
1895942,1490394,2025-02-14,Senate,"(S) 2nd Reading Concur Motion Failed",25,25,0,0,50
1895942,1490395,2025-02-14,Senate,"(S) 2nd Reading Indefinitely Postponed",28,22,0,0,50
1895942,1558853,2025-01-20,House,"(H) Judiciary--Do Pass",12,8,0,0,20
1895943,1482241,2025-01-21,Senate,"(S) Energy, Technology & Federal Relations--To Table",13,0,0,0,13
1895944,1481063,2025-01-24,Senate,"(S) State Administration--Do Pass As Amended",9,0,0,0,9
1895944,1481064,2025-01-30,Senate,"(S) 2nd Reading Passed",45,3,0,2,50
1895944,1481065,2025-01-31,Senate,"(S) 3rd Reading Passed",46,4,0,0,50
1895944,1522366,2025-03-20,House,"(H) State Administration--Be Concurred In",19,0,0,0,19
1895944,1526323,2025-03-25,House,"(H) 2nd Reading Concurred",100,0,0,0,100
1895944,1527778,2025-03-26,House,"(H) 3rd Reading Concurred",98,0,0,2,100
1895945,1481072,2025-01-17,House,"(H) Education--Do Pass",15,0,0,0,15
1895945,1481073,2025-01-22,House,"(H) 2nd Reading Passed",85,15,0,0,100
1895945,1481074,2025-01-23,House,"(H) Appropriations--Do Pass",21,0,0,2,23
1895945,1481075,2025-01-27,House,"(H) 3rd Reading Passed",78,20,0,2,100
1895945,1496548,2025-02-20,Senate,"(S) Education and Cultural Resources--Be Concurred In",12,2,0,0,14
1895945,1518073,2025-03-14,Senate,"(S) 2nd Reading Concurred",34,16,0,0,50
1895945,1522893,2025-03-20,Senate,"(S) Finance and Claims--Be Concurred In",18,4,0,0,22
1895945,1524072,2025-03-21,Senate,"(S) 3rd Reading Concurred",33,17,0,0,50
1895945,1570358,2025-01-17,House,"(H) Education--Do Pass",15,0,0,0,15
1895946,1481076,2025-01-24,Senate,"(S) Public Health, Welfare and Safety--Do Pass",11,0,0,0,11
1895946,1481077,2025-01-29,Senate,"(S) 2nd Reading Passed",50,0,0,0,50
1895946,1481078,2025-01-30,Senate,"(S) 3rd Reading Passed",49,0,0,1,50
1895946,1488998,2025-02-11,House,"(H) Human Services--Be Concurred In",21,0,0,0,21
1895946,1519316,2025-03-17,House,"(H) 2nd Reading Concurred",100,0,0,0,100
1895946,1519747,2025-03-18,House,"(H) 3rd Reading Concurred",98,0,0,2,100
1895948,1481082,2025-01-14,House,"(H) Local Government--Do Pass",170,0,0,0,170
1895948,1481092,2025-01-17,House,"(H) 2nd Reading Passed",87,13,0,0,100
1895948,1481093,2025-01-29,House,"(H) Appropriations--",23,0,0,0,23
1895948,1548082,2025-01-29,House,"(H) Appropriations--To Table",23,0,0,0,23
1895949,1481094,2025-01-14,House,"(H) Taxation--Do Pass",15,6,0,0,21
1895949,1481095,2025-01-16,House,"(H) 2nd Reading Passed",75,25,0,0,100
1895949,1481096,2025-01-29,House,"(H) Appropriations--",22,1,0,0,23
1895949,1535921,2025-04-03,House,"(H) Appropriations--To Take From The Table",9,12,2,0,23
1895950,1481097,2025-01-22,Senate,"(S) Local Government--Do Pass",11,0,0,0,11
1895950,1481098,2025-01-24,Senate,"(S) 2nd Reading Passed",50,0,0,0,50
1895950,1481099,2025-01-27,Senate,"(S) 3rd Reading Passed",49,0,0,1,50
1895950,1529833,2025-03-27,House,"(H) Local Government--Be Concurred In",17,0,0,0,17
1895950,1530960,2025-03-31,House,"(H) 2nd Reading Concurred",100,0,0,0,100
1895950,1533116,2025-04-01,House,"(H) 3rd Reading Concurred",99,0,0,1,100
1895951,1481100,2025-01-10,House,"(H) State Administration--Do Pass",19,0,0,0,19
1895951,1481101,2025-01-13,House,"(H) 2nd Reading Passed",99,0,0,1,100
1895951,1481102,2025-01-14,House,"(H) 3rd Reading Passed",100,0,0,0,100
1895951,1496750,2025-02-21,Senate,"(S) State Administration--Be Concurred In",9,0,0,0,9
1895951,1502957,2025-03-01,Senate,"(S) 2nd Reading Concurred",49,0,0,1,50
1895951,1503613,2025-03-03,Senate,"(S) 3rd Reading Concurred",50,0,0,0,50
1895952,1481103,2025-01-20,House,"(H) Judiciary--Do Pass As Amended",18,2,0,0,20
1895952,1481104,2025-01-23,House,"(H) 2nd Reading Motion to Amend Carried",79,21,0,0,100
1895952,1481105,2025-01-23,House,"(H) 2nd Reading Passed as Amended",93,7,0,0,100
1895952,1481106,2025-01-27,House,"(H) 3rd Reading Passed",93,5,0,2,100
1895952,1496627,2025-02-21,Senate,"(S) Highways and Transportation--Be Concurred In",8,0,0,0,8
1895952,1502943,2025-03-01,Senate,"(S) 2nd Reading Concurred",41,9,0,0,50
1895952,1503546,2025-03-03,Senate,"(S) 3rd Reading Concurred",43,7,0,0,50
1895952,1559217,2025-01-20,House,"(H) Judiciary--Do Pass As Amended",18,2,0,0,20
1895953,1481107,2025-02-03,Senate,"(S) Judiciary--Do Pass",6,3,0,0,9
1895953,1481108,2025-02-05,Senate,"(S) 2nd Reading Passed",32,18,0,0,50
1895953,1483435,2025-02-06,Senate,"(S) 3rd Reading Passed",30,19,0,1,50
1895953,1524883,2025-03-24,House,"(H) Judiciary--Be Concurred In",12,8,0,0,20
1895953,1529222,2025-03-27,House,"(H) 2nd Reading Not Concurred",43,57,0,0,100
1895954,1502847,2025-02-28,Senate,"(S) State Administration--Do Pass",8,1,0,0,9
1895954,1505762,2025-02-28,Senate,"(S) State Administration--Do Pass As Amended",8,1,0,0,9
1895954,1507685,2025-03-06,Senate,"(S) 2nd Reading Passed",38,12,0,0,50
1895954,1508162,2025-03-06,Senate,"(S) 3rd Reading Passed",38,11,0,1,50
1895954,1536077,2025-04-03,House,"(H) State Administration--Be Concurred In As Amended",15,4,0,0,19
1895954,1540099,2025-04-08,House,"(H) 2nd Reading Motion to Amend Failed",46,52,0,2,100
1895954,1540100,2025-04-08,House,"(H) 2nd Reading Concurred",79,19,0,2,100
1895954,1541543,2025-04-09,House,"(H) 3rd Reading Concurred",80,17,0,3,100
1895954,1546606,2025-04-12,Senate,"(S) 2nd Reading House Amendments Concurred",50,0,0,0,50
1895954,1547100,2025-04-14,Senate,"(S) 3rd Reading Passed as Amended by House",45,3,0,2,50
1895955,1481109,2025-01-20,House,"(H) Judiciary--Do Pass",12,8,0,0,20
1895955,1481110,2025-01-23,House,"(H) 2nd Reading Not Passed",50,50,0,0,100
1895955,1481111,2025-01-24,House,"(H) Reconsidered Previous Action; Placed on 2nd Reading",52,46,0,2,100
1895955,1481112,2025-01-27,House,"(H) 2nd Reading Passed",52,48,0,0,100
1895955,1481113,2025-01-28,House,"(H) 3rd Reading Passed",51,48,0,1,100
1895955,1490689,2025-02-15,Senate,"(S) 2nd Reading Concur Motion Failed",25,25,0,0,50
1895955,1490722,2025-02-15,Senate,"(S) 2nd Reading Indefinitely Postponed",31,18,0,1,50
1895955,1495871,2025-02-13,Senate,"(S) Judiciary--Be Concurred In",6,0,0,3,9
1895955,1541492,2025-01-24,House,"(H) Reconsidered Previous Action; Placed on 2nd Reading",52,46,0,2,100
1895955,1559162,2025-01-20,House,"(H) Judiciary--Do Pass",12,8,0,0,20
1895956,1481116,2025-01-07,House,"(H) Appropriations--Do Pass",23,0,0,0,23
1895956,1481117,2025-01-09,House,"(H) 2nd Reading Passed",95,5,0,0,100
1895956,1481118,2025-01-10,House,"(H) 3rd Reading Passed",97,3,0,0,100
1895956,1481119,2025-01-09,House,"(H) 2nd Reading Motion to Amend Failed",41,59,0,0,100
1895956,1481120,2025-01-15,Senate,"(S) Finance and Claims--",19,3,0,0,22
1895956,1481121,2025-01-17,Senate,"(S) Finance and Claims--",44,0,0,0,44
1895956,1481123,2025-01-21,Senate,"(S) 2nd Reading Concurred",49,1,0,0,50
1895956,1481124,2025-01-22,Senate,"(S) 3rd Reading Concurred",50,0,0,0,50
1895957,1481125,2025-01-23,Senate,"(S) Taxation--Do Pass As Amended",8,0,0,0,8
1895957,1481126,2025-01-27,Senate,"(S) 2nd Reading Passed",50,0,0,0,50
1895957,1481127,2025-01-28,Senate,"(S) 3rd Reading Passed",50,0,0,0,50
1895957,1488994,2025-02-12,House,"(H) Taxation--Be Concurred In",21,0,0,0,21
1895957,1519315,2025-03-17,House,"(H) 2nd Reading Concurred",100,0,0,0,100
1895957,1519710,2025-03-18,House,"(H) 3rd Reading Concurred",98,0,0,2,100
1895958,1481129,2025-01-15,House,"(H) Transportation--Do Pass As Amended",14,0,0,0,14
1895958,1481130,2025-01-20,House,"(H) 2nd Reading Passed",97,1,0,2,100
1895958,1481131,2025-01-21,House,"(H) 3rd Reading Passed",99,0,0,1,100
1895958,1488086,2025-01-29,Senate,"(S) Highways and Transportation--Be Concurred In",8,0,0,0,8
1895958,1496652,2025-02-21,Senate,"(S) 2nd Reading Concurred",30,20,0,0,50
1895958,1497732,2025-02-24,Senate,"(S) 3rd Reading Concurred",30,19,0,1,50
1895959,1481140,2025-01-20,House,"(H) Judiciary--Do Pass",12,8,0,0,20
1895959,1481141,2025-01-23,House,"(H) 2nd Reading Motion to Amend Failed",42,58,0,0,100
1895959,1481142,2025-01-23,House,"(H) 2nd Reading Passed",58,42,0,0,100
1895959,1481143,2025-01-24,House,"(H) 3rd Reading Passed",59,38,0,3,100
1895959,1483534,2025-02-05,Senate,"(S) Judiciary--Be Concurred In",6,3,0,0,9
1895959,1490273,2025-02-14,Senate,"(S) 2nd Reading Concur Motion Failed",25,25,0,0,50
1895959,1490274,2025-02-14,Senate,"(S) 2nd Reading Indefinitely Postponed",28,21,0,1,50
1895959,1558858,2025-01-20,House,"(H) Judiciary--Do Pass",12,8,0,0,20
1895961,1482482,2025-01-22,House,"(H) Education--To Table",15,0,0,0,15
1895961,1569431,2025-01-22,House,"(H) Education--To Table",15,0,0,0,15
1895962,1481144,2025-01-29,Senate,"(S) Taxation--Do Pass As Amended",8,0,0,0,8
1895962,1481145,2025-01-31,Senate,"(S) 2nd Reading Passed",50,0,0,0,50
1895962,1481146,2025-02-03,Senate,"(S) 3rd Reading Passed",49,0,0,1,50
1895962,1491852,2025-02-18,House,"(H) Taxation--Be Concurred In",21,0,0,0,21
1895962,1519320,2025-03-17,House,"(H) 2nd Reading Concurred",100,0,0,0,100
1895962,1519992,2025-03-18,House,"(H) 3rd Reading Concurred",96,2,0,2,100
1895963,1481147,2025-01-21,House,"(H) Appropriations--Do Pass As Amended",20,3,0,0,23
1895963,1481148,2025-01-27,House,"(H) 2nd Reading Passed",100,0,0,0,100
1895963,1481149,2025-01-28,House,"(H) 3rd Reading Passed",70,29,0,1,100
1895963,1502241,2025-02-25,Senate,"(S) Finance and Claims--Be Concurred In As Amended",21,1,0,0,22
1895963,1517998,2025-03-14,Senate,"(S) 2nd Reading Concurred",26,24,0,0,50
1895963,1518248,2025-03-15,Senate,"(S) 3rd Reading Concurred",27,22,0,1,50
1895963,1523136,2025-03-20,House,"(H) 2nd Reading Senate Amendments Concurred",55,45,0,0,100
1895963,1524132,2025-03-21,House,"(H) 3rd Reading Passed as Amended by Senate",51,45,0,4,100
1895964,1487361,2025-02-12,House,"(H) Taxation--Do Pass As Amended",11,10,0,0,21
1895964,1488625,2025-02-12,House,"(H) Taxation--Do Pass As Amended",11,10,0,0,21
1895964,1522769,2025-03-20,House,"(H) 2nd Reading Motion to Amend Carried",83,17,0,0,100
1895964,1522770,2025-03-20,House,"(H) 2nd Reading Not Passed as Amended",40,60,0,0,100
1895965,1482287,2025-01-17,House,"(H) Taxation--To Table",21,0,0,0,21
1895966,1497073,2025-02-13,Senate,"(S) Taxation--Do Pass",6,2,0,0,8
1895966,1592178,2025-03-18,Senate,"(S) 2nd Reading Passed",32,18,0,0,50
1895966,1592179,2025-03-19,Senate,"(S) 3rd Reading Passed",31,19,0,0,50
1895966,1592180,2025-04-09,House,"(H) Taxation--Be Concurred In As Amended",11,10,0,0,21
1895966,1592181,2025-04-14,House,"(H) 2nd Reading Concurred",53,47,0,0,100
1895966,1592182,2025-04-15,House,"(H) 3rd Reading Concurred",49,48,0,3,100
1895966,1592183,2025-04-17,Senate,"(S) 2nd Reading House Amendments Not Concurred",32,17,0,1,50
1895967,1531935,2025-03-31,House,"(H) Appropriations--Do Pass As Amended",21,2,0,0,23
1895967,1538274,2025-04-07,House,"(H) 2nd Reading Passed",92,8,0,0,100
1895967,1540262,2025-04-08,House,"(H) 3rd Reading Passed",84,13,0,3,100
1895967,1551030,2025-04-16,Senate,"(S) Finance and Claims--Be Concurred In As Amended",22,0,0,0,22
1895967,1555047,2025-04-23,Senate,"(S) 2nd Reading Concurred",28,21,0,1,50
1895967,1557362,2025-04-24,Senate,"(S) 3rd Reading Concurred",30,20,0,0,50
1895967,1559143,2025-04-28,House,"(H) 2nd Reading Senate Amendments Concurred",86,14,0,0,100
1895967,1560013,2025-04-29,House,"(H) 3rd Reading Passed as Amended by Senate",73,26,0,1,100
1895968,1481150,2025-01-10,House,"(H) Judiciary--Do Pass",20,0,0,0,20
1895968,1481151,2025-01-13,House,"(H) 2nd Reading Passed",98,0,0,2,100
1895968,1481152,2025-01-14,House,"(H) 3rd Reading Passed",99,0,0,1,100
1895968,1487785,2025-02-12,Senate,"(S) Judiciary--Be Concurred In",6,0,0,3,9
1895968,1490365,2025-02-14,Senate,"(S) 2nd Reading Concurred",39,11,0,0,50
1895968,1490710,2025-02-15,Senate,"(S) 3rd Reading Concurred",43,5,0,2,50
1895969,1502285,2025-01-22,Senate,"(S) State Administration--To Table",4,5,0,0,9
1895969,1506894,2025-03-05,Senate,"(S) Motion Failed",24,26,0,0,50
1895970,1490740,2025-02-13,Senate,"(S) Judiciary--Do Pass",6,0,0,3,9
1895970,1502472,2025-02-28,Senate,"(S) 2nd Reading Passed",28,22,0,0,50
1895970,1502906,2025-03-01,Senate,"(S) 3rd Reading Passed",29,21,0,0,50
1895970,1524808,2025-03-24,House,"(H) Judiciary--Be Concurred In",12,8,0,0,20
1895970,1530252,2025-03-28,House,"(H) 2nd Reading Not Concurred",40,60,0,0,100
1895974,1481156,2025-01-20,House,"(H) Human Services--Do Pass As Amended",102,24,0,0,126
1895974,1481162,2025-01-24,House,"(H) 2nd Reading Passed",77,23,0,0,100
1895974,1486568,2025-02-11,House,"(H) Appropriations--Do Pass As Amended",19,4,0,0,23
1895974,1495021,2025-02-20,House,"(H) 2nd Reading Passed",87,13,0,0,100
1895974,1496560,2025-02-21,House,"(H) 3rd Reading Passed",83,15,0,2,100
1895974,1536723,2025-04-03,Senate,"(S) Taken from Committee; Placed on 2nd Reading",27,22,0,1,50
1895974,1537552,2025-04-04,Senate,"(S) 2nd Reading Concurred",29,21,0,0,50
1895974,1547009,2025-04-14,Senate,"(S) Finance and Claims--Be Concurred In",14,8,0,0,22
1895974,1548543,2025-04-15,Senate,"(S) 3rd Reading Concurred",29,20,0,1,50
1895974,1572384,2025-01-20,House,"(H) Human Services--Do Pass As Amended",17,4,0,0,21
1895988,1481164,2025-01-20,House,"(H) 2nd Reading Passed",75,24,0,1,100
1895988,1481165,2025-01-21,House,"(H) 3rd Reading Passed",74,25,0,1,100
1895988,1484584,2025-01-15,House,"(H) Energy, Technology and Federal Relations--Do Pass As Amended",12,2,0,0,14
1895988,1532321,2025-03-25,Senate,"(S) Energy, Technology & Federal Relations--Be Concurred In As Amended",13,0,0,0,13
1895988,1536535,2025-04-03,Senate,"(S) 2nd Reading Concurred",46,4,0,0,50
1895988,1546874,2025-04-14,Senate,"(S) Finance and Claims--Be Concurred In",22,0,0,0,22
1895988,1549084,2025-04-15,Senate,"(S) 3rd Reading Concurred",49,0,0,1,50
1895988,1552220,2025-04-18,House,"(H) 2nd Reading Senate Amendments Concurred",87,11,0,2,100
1895988,1553264,2025-04-22,House,"(H) 3rd Reading Passed as Amended by Senate",63,35,0,2,100
1896002,1481166,2025-01-09,House,"(H) Fish, Wildlife and Parks--Do Pass",13,7,0,0,20
1896002,1481167,2025-01-13,House,"(H) 2nd Reading Passed",55,44,0,1,100
1896002,1481168,2025-01-14,House,"(H) 3rd Reading Passed",50,48,0,2,100
1896002,1487750,2025-02-11,Senate,"(S) Fish and Game--Be Concurred In",7,5,0,0,12
1896002,1496475,2025-02-21,Senate,"(S) 2nd Reading Concur Motion Failed",15,35,0,0,50
1896002,1496476,2025-02-21,Senate,"(S) 2nd Reading Indefinitely Postponed",49,1,0,0,50
1896038,1481169,2025-01-10,House,"(H) State Administration--Do Pass",19,0,0,0,19
1896038,1481170,2025-01-14,House,"(H) 2nd Reading Passed",100,0,0,0,100
1896038,1481171,2025-01-15,House,"(H) 3rd Reading Passed",99,1,0,0,100
1896038,1495718,2025-02-14,Senate,"(S) State Administration--Be Concurred In",9,0,0,0,9
1896038,1497621,2025-02-24,Senate,"(S) 2nd Reading Concurred",44,6,0,0,50
1896038,1498826,2025-02-25,Senate,"(S) 3rd Reading Concurred",44,5,0,1,50
1896050,1498146,2025-02-24,House,"(H) Appropriations--Do Pass",23,0,0,0,23
1896050,1502412,2025-02-28,House,"(H) 2nd Reading Passed",94,5,0,1,100
1896050,1503070,2025-03-01,House,"(H) 3rd Reading Passed",91,6,0,3,100
1896050,1532190,2025-04-01,Senate,"(S) Finance and Claims--Be Concurred In",22,0,0,0,22
1896050,1546527,2025-04-12,Senate,"(S) 2nd Reading Concurred",50,0,0,0,50
1896050,1547225,2025-04-14,Senate,"(S) 3rd Reading Concurred",48,0,0,2,50
1896062,1498226,2025-02-24,House,"(H) Appropriations--Do Pass As Amended",23,0,0,0,23
1896062,1519313,2025-03-17,House,"(H) 2nd Reading Motion to Amend Carried",75,25,0,0,100
1896062,1519314,2025-03-17,House,"(H) 2nd Reading Passed as Amended",100,0,0,0,100
1896062,1521071,2025-03-19,House,"(H) 3rd Reading Passed",96,2,0,2,100
1896062,1532294,2025-04-01,Senate,"(S) Finance and Claims--Be Concurred In As Amended",22,0,0,0,22
1896062,1546535,2025-04-12,Senate,"(S) 2nd Reading Concurred",49,0,0,1,50
1896062,1547379,2025-04-14,Senate,"(S) 3rd Reading Concurred",48,0,0,2,50
1896062,1549970,2025-04-16,House,"(H) 2nd Reading Senate Amendments Concurred",90,10,0,0,100
1896062,1551765,2025-04-17,House,"(H) 3rd Reading Passed as Amended by Senate",87,12,0,1,100
1896076,1481172,2025-01-15,House,"(H) Natural Resources--Do Pass",14,0,0,0,14
1896076,1481173,2025-01-20,House,"(H) 2nd Reading Passed",99,1,0,0,100
1896076,1481174,2025-01-22,House,"(H) Appropriations--Do Pass",23,0,0,0,23
1896076,1481175,2025-01-24,House,"(H) 3rd Reading Passed",96,1,0,3,100
1896076,1524237,2025-03-21,Senate,"(S) Natural Resources--Be Concurred In",11,0,0,0,11
1896076,1527616,2025-03-26,Senate,"(S) 2nd Reading Concurred",44,6,0,0,50
1896076,1529119,2025-03-27,Senate,"(S) 3rd Reading Concurred",47,3,0,0,50
1896087,1481176,2025-01-10,House,"(H) State Administration--Do Pass",19,0,0,0,19
1896087,1481177,2025-01-14,House,"(H) 2nd Reading Passed",97,3,0,0,100
1896087,1481178,2025-01-15,House,"(H) 3rd Reading Passed",94,6,0,0,100
1896087,1495679,2025-02-14,Senate,"(S) State Administration--Be Concurred In",9,0,0,0,9
1896087,1498073,2025-02-24,Senate,"(S) 2nd Reading Concurred",37,13,0,0,50
1896087,1498741,2025-02-25,Senate,"(S) 3rd Reading Concurred",38,11,0,1,50
1896099,1503101,2025-03-03,House,"(H) Appropriations--Do Pass As Amended",22,1,0,0,23
1896099,1519310,2025-03-17,House,"(H) 2nd Reading Motion to Amend Carried",98,2,0,0,100
1896099,1519311,2025-03-17,House,"(H) 2nd Reading Passed as Amended",61,39,0,0,100
1896099,1521291,2025-03-19,House,"(H) 3rd Reading Passed",70,28,0,2,100
1896099,1551399,2025-04-16,Senate,"(S) Finance and Claims--Be Concurred In As Amended",22,0,0,0,22
1896099,1555348,2025-04-23,Senate,"(S) 2nd Reading Concurred",44,6,0,0,50
1896099,1557215,2025-04-24,Senate,"(S) 3rd Reading Concurred",39,10,0,1,50
1896099,1559057,2025-04-28,House,"(H) 2nd Reading Senate Amendments Concurred",69,31,0,0,100
1896099,1559919,2025-04-29,House,"(H) 3rd Reading Passed as Amended by Senate",70,29,0,1,100
1896111,1502277,2025-02-27,House,"(H) Appropriations--Do Pass As Amended",21,2,0,0,23
1896111,1519308,2025-03-17,House,"(H) 2nd Reading Passed",87,13,0,0,100
1896111,1519662,2025-03-18,House,"(H) 3rd Reading Passed",82,16,0,2,100
1896111,1550051,2025-04-16,Senate,"(S) Finance and Claims--Be Concurred In As Amended",15,7,0,0,22
1896111,1553850,2025-04-22,Senate,"(S) 2nd Reading Concurred",37,12,0,1,50
1896111,1555651,2025-04-23,Senate,"(S) 3rd Reading Concurred",39,11,0,0,50
1896111,1558022,2025-04-25,House,"(H) 2nd Reading Senate Amendments Concurred",98,2,0,0,100
1896111,1559004,2025-04-28,House,"(H) 3rd Reading Passed as Amended by Senate",93,7,0,0,100
1896126,1481181,2025-01-10,House,"(H) Business and Labor--Do Pass As Amended",20,0,0,0,20
1896126,1481182,2025-01-14,House,"(H) 2nd Reading Passed",100,0,0,0,100
1896126,1481183,2025-01-15,House,"(H) 3rd Reading Passed",100,0,0,0,100
1896126,1497064,2025-01-31,Senate,"(S) Business, Labor  and Economic Affairs--Be Concurred In",11,0,0,0,11
1896126,1497065,2025-02-14,Senate,"(S) 2nd Reading Concurred",44,6,0,0,50
1896126,1497066,2025-02-15,Senate,"(S) 3rd Reading Concurred",39,9,0,2,50
1896137,1522271,2025-03-19,House,"(H) Appropriations--Do Pass As Amended",22,1,0,0,23
1896137,1527480,2025-03-26,House,"(H) 2nd Reading Motion to Amend Failed",22,78,0,0,100
1896137,1527481,2025-03-26,House,"(H) 2nd Reading Motion to Amend Failed",34,66,0,0,100
1896137,1527482,2025-03-26,House,"(H) 2nd Reading Passed",84,16,0,0,100
1896137,1529125,2025-03-27,House,"(H) 3rd Reading Passed",83,16,0,1,100
1896137,1551002,2025-04-16,Senate,"(S) Finance and Claims--Be Concurred In As Amended",21,1,0,0,22
1896137,1555361,2025-04-23,Senate,"(S) 2nd Reading Motion to Amend Carried",50,0,0,0,50
1896137,1555362,2025-04-23,Senate,"(S) 2nd Reading Concurred as Amended",47,3,0,0,50
1896137,1558085,2025-04-25,Senate,"(S) 3rd Reading Concurred",43,6,0,1,50
1896137,1559106,2025-04-28,House,"(H) 2nd Reading Senate Amendments Concurred",83,17,0,0,100
1896137,1559956,2025-04-29,House,"(H) 3rd Reading Passed as Amended by Senate",79,19,0,2,100
1896150,1481191,2025-01-16,House,"(H) Appropriations--Do Pass As Amended",16,7,0,0,23
1896150,1481192,2025-01-24,House,"(H) 2nd Reading Motion to Amend Failed",45,55,0,0,100
1896150,1481193,2025-01-24,House,"(H) 2nd Reading Passed",70,30,0,0,100
1896150,1481194,2025-01-27,House,"(H) 3rd Reading Passed",71,27,0,2,100
1896150,1499335,2025-02-25,Senate,"(S) Finance and Claims--Be Concurred In",14,8,0,0,22
1896150,1521469,2025-03-19,Senate,"(S) 2nd Reading Motion to Amend Failed",12,38,0,0,50
1896150,1521470,2025-03-19,Senate,"(S) 2nd Reading Concurred",37,13,0,0,50
1896150,1523179,2025-03-20,Senate,"(S) 3rd Reading Concurred",38,12,0,0,50
1896160,1481195,2025-01-10,House,"(H) State Administration--Do Pass",19,0,0,0,19
1896160,1481196,2025-01-13,House,"(H) 2nd Reading Passed as Amended",99,0,0,1,100
1896160,1481197,2025-01-13,House,"(H) 2nd Reading Motion to Amend Carried",77,22,0,1,100
1896160,1481198,2025-01-15,House,"(H) 3rd Reading Passed",100,0,0,0,100
1896160,1537339,2025-04-04,Senate,"(S) State Administration--Be Concurred In As Amended",9,0,0,0,9
1896160,1540217,2025-04-08,Senate,"(S) 2nd Reading Concurred",34,15,0,1,50
1896160,1541568,2025-04-09,Senate,"(S) 3rd Reading Concurred",32,16,0,2,50
1896160,1548789,2025-04-15,House,"(H) 2nd Reading Senate Amendments Concurred",98,2,0,0,100
1896160,1549809,2025-04-16,House,"(H) 3rd Reading Passed as Amended by Senate",96,2,0,2,100
1896173,1481199,2025-01-22,House,"(H) Natural Resources--Do Pass As Amended",14,0,0,0,14
1896173,1481200,2025-01-28,House,"(H) 2nd Reading Passed",99,1,0,0,100
1896173,1481201,2025-01-29,House,"(H) 3rd Reading Passed",99,1,0,0,100
1896173,1524117,2025-03-21,Senate,"(S) Natural Resources--Be Concurred In",10,1,0,0,11
1896173,1527757,2025-03-26,Senate,"(S) 2nd Reading Motion to Amend Carried",35,13,0,2,50
1896173,1527758,2025-03-26,Senate,"(S) 2nd Reading Concurred as Amended",50,0,0,0,50
1896173,1529191,2025-03-27,Senate,"(S) 3rd Reading Concurred",50,0,0,0,50
1896173,1546154,2025-04-11,House,"(H) 2nd Reading Senate Amendments Not Concurred",99,1,0,0,100
1896173,1554977,2025-04-23,Senate,"(S) 2nd Reading Conference Committee Report Adopted",39,11,0,0,50
1896173,1555346,2025-04-23,House,"(H) 2nd Reading Conference Committee Report Adopted",58,42,0,0,100
1896173,1558131,2025-04-25,House,"(H) 3rd Reading Conference Committee Report Adopted",57,43,0,0,100
1896173,1558132,2025-04-25,Senate,"(S) 3rd Reading Conference Committee Report Adopted",35,14,0,1,50
1896185,1536226,2025-04-03,House,"(H) Appropriations--Do Pass As Amended",22,0,1,0,23
1896185,1538965,2025-04-07,House,"(H) 2nd Reading Motion to Amend Failed",26,74,0,0,100
1896185,1538966,2025-04-07,House,"(H) 2nd Reading Passed",60,40,0,0,100
1896185,1540288,2025-04-08,House,"(H) 3rd Reading Passed",58,39,0,3,100
1896185,1549782,2025-04-16,Senate,"(S) Finance and Claims--Be Concurred In As Amended",17,5,0,0,22
1896185,1553462,2025-04-22,Senate,"(S) 2nd Reading Concurred",29,21,0,0,50
1896185,1555329,2025-04-23,Senate,"(S) 3rd Reading Concurred",32,18,0,0,50
1896185,1558117,2025-04-25,House,"(H) 2nd Reading Senate Amendments Concurred",83,17,0,0,100
1896185,1558773,2025-04-28,House,"(H) 3rd Reading Passed as Amended by Senate",68,32,0,0,100
1896198,1503011,2025-02-28,House,"(H) Appropriations--Do Pass As Amended",18,0,0,5,23
1896198,1519309,2025-03-17,House,"(H) 2nd Reading Passed",100,0,0,0,100
1896198,1520176,2025-03-18,House,"(H) 3rd Reading Passed",98,0,0,2,100
1896198,1549900,2025-04-16,Senate,"(S) Finance and Claims--Be Concurred In As Amended",22,0,0,0,22
1896198,1553792,2025-04-22,Senate,"(S) 2nd Reading Concurred",47,1,0,2,50
1896198,1555583,2025-04-23,Senate,"(S) 3rd Reading Concurred",47,3,0,0,50
1896198,1557982,2025-04-25,House,"(H) 2nd Reading Senate Amendments Concurred",98,2,0,0,100
1896198,1558888,2025-04-28,House,"(H) 3rd Reading Passed as Amended by Senate",99,1,0,0,100
1896210,1498217,2025-02-24,House,"(H) Appropriations--Do Pass As Amended",23,0,0,0,23
1896210,1502446,2025-02-28,House,"(H) 2nd Reading Passed",96,3,0,1,100
1896210,1503076,2025-03-01,House,"(H) 3rd Reading Passed",93,4,0,3,100
1896210,1533224,2025-04-01,Senate,"(S) Finance and Claims--Be Concurred In As Amended",22,0,0,0,22
1896210,1546525,2025-04-12,Senate,"(S) 2nd Reading Concurred",50,0,0,0,50
1896210,1547244,2025-04-14,Senate,"(S) 3rd Reading Concurred",48,0,0,2,50
1896210,1549923,2025-04-16,House,"(H) 2nd Reading Senate Amendments Concurred",88,12,0,0,100
1896210,1551725,2025-04-17,House,"(H) 3rd Reading Passed as Amended by Senate",91,8,0,1,100
1896220,1481202,2025-01-17,House,"(H) Natural Resources--Do Pass",14,0,0,0,14
1896220,1481203,2025-01-22,House,"(H) 2nd Reading Passed",99,1,0,0,100
1896220,1481204,2025-01-23,House,"(H) 3rd Reading Passed",99,1,0,0,100
1896220,1488267,2025-02-10,Senate,"(S) Natural Resources--Be Concurred In",10,1,0,0,11
1896220,1490702,2025-02-15,Senate,"(S) 3rd Reading Concurred",43,5,0,2,50
1896230,1481205,2025-01-24,Senate,"(S) Judiciary--Do Pass As Amended",6,3,0,0,9
1896230,1481206,2025-01-28,Senate,"(S) 2nd Reading Passed",32,18,0,0,50
1896230,1481207,2025-01-29,Senate,"(S) 3rd Reading Passed",32,17,0,1,50
1896230,1539668,2025-04-08,House,"(H) Judiciary--Be Concurred In As Amended",17,3,0,0,20
1896230,1544704,2025-04-10,House,"(H) 2nd Reading Concurred",67,32,0,1,100
1896230,1546380,2025-04-11,House,"(H) 3rd Reading Concurred",61,38,0,1,100
1896230,1549998,2025-04-16,Senate,"(S) 2nd Reading House Amendments Concurred",31,18,0,1,50
1896230,1553307,2025-04-16,Senate,"(S) 2nd Reading House Amendments Not Concurred",31,18,0,1,50
1896230,1560414,2025-04-29,Senate,"(S) 2nd Reading Free Conference Committee Report Adopted",47,2,0,1,50
1896230,1560415,2025-04-29,House,"(H) 2nd Reading Free Conference Committee Report Adopted",85,15,0,0,100
1896230,1561927,2025-04-30,House,"(H) 3rd Reading Free Conference Committee Report Adopted",77,23,0,0,100
1896230,1562526,2025-04-30,Senate,"(S) 3rd Reading Free Conference Committee Report Adopted",33,17,0,0,50
1896233,1481208,2025-01-14,House,"(H) State Administration--Do Pass",19,0,0,0,19
1896233,1481209,2025-01-16,House,"(H) 2nd Reading Passed",99,1,0,0,100
1896233,1481210,2025-01-17,House,"(H) 3rd Reading Passed",97,1,0,2,100
1896233,1495929,2025-02-14,Senate,"(S) State Administration--Be Concurred In",9,0,0,0,9
1896233,1497813,2025-02-24,Senate,"(S) 2nd Reading Concurred",49,1,0,0,50
1896233,1499112,2025-02-25,Senate,"(S) 3rd Reading Concurred",48,1,0,1,50
1896238,1481211,2025-01-15,House,"(H) Education--Do Pass",15,0,0,0,15
1896238,1481212,2025-01-20,House,"(H) 2nd Reading Passed",98,1,0,1,100
1896238,1481213,2025-01-21,House,"(H) 3rd Reading Passed",97,1,0,2,100
1896238,1526222,2025-03-21,Senate,"(S) State Administration--Be Concurred In",9,0,0,0,9
1896238,1531369,2025-03-31,Senate,"(S) 2nd Reading Concurred",33,17,0,0,50
1896238,1532708,2025-04-01,Senate,"(S) 3rd Reading Concurred",32,18,0,0,50
1896241,1481214,2025-01-16,Senate,"(S) Education and Cultural Resources--Do Pass",14,0,0,0,14
1896241,1481215,2025-01-20,Senate,"(S) 2nd Reading Passed",50,0,0,0,50
1896241,1481216,2025-01-21,Senate,"(S) 3rd Reading Passed",50,0,0,0,50
1896241,1524257,2025-03-21,House,"(H) Education--Be Concurred In",15,0,0,0,15
1896241,1530228,2025-03-28,House,"(H) 2nd Reading Concurred",100,0,0,0,100
1896241,1530686,2025-03-29,House,"(H) 3rd Reading Concurred",96,0,0,4,100
1896247,1481217,2025-01-29,Senate,"(S) Judiciary--Do Pass",6,3,0,0,9
1896247,1481218,2025-01-31,Senate,"(S) 2nd Reading Passed",32,18,0,0,50
1896247,1481219,2025-02-03,Senate,"(S) 3rd Reading Passed",36,13,0,1,50
1896247,1539404,2025-04-08,House,"(H) Judiciary--Be Concurred In",12,8,0,0,20
1896247,1543376,2025-04-10,House,"(H) 2nd Reading Concurred",58,42,0,0,100
1896247,1546261,2025-04-11,House,"(H) 3rd Reading Concurred",58,41,0,1,100
1896255,1481220,2025-01-31,Senate,"(S) State Administration--Do Pass As Amended",9,0,0,0,9
1896255,1481221,2025-02-05,Senate,"(S) 2nd Reading Passed",36,14,0,0,50
1896255,1482316,2025-01-31,Senate,"(S) State Administration--Do Pass As Amended",9,0,0,0,9
1896255,1483471,2025-02-06,Senate,"(S) 3rd Reading Passed",31,18,0,1,50
1896255,1522378,2025-03-20,House,"(H) State Administration--Be Concurred In",10,9,0,0,19
1896255,1526382,2025-03-25,House,"(H) 2nd Reading Concurred",59,41,0,0,100
1896255,1527812,2025-03-26,House,"(H) 3rd Reading Concurred",60,39,0,1,100
1896255,1535616,2025-01-31,Senate,"(S) State Administration--Do Pass As Amended",9,0,0,0,9
1896259,1481222,2025-01-23,Senate,"(S) Judiciary--Do Pass As Amended",6,3,0,0,9
1896259,1481223,2025-01-28,Senate,"(S) 2nd Reading Passed",32,18,0,0,50
1896259,1481224,2025-01-29,Senate,"(S) 3rd Reading Passed",32,17,0,1,50
1896259,1498026,2025-01-23,Senate,"(S) Judiciary--Do Pass As Amended",6,3,0,0,9
1896259,1536466,2025-01-23,Senate,"(S) Judiciary--Do Pass As Amended",6,3,0,0,9
1896259,1539602,2025-04-08,House,"(H) Judiciary--Be Concurred In",12,8,0,0,20
1896259,1543529,2025-04-10,House,"(H) 2nd Reading Concurred",56,42,0,2,100
1896259,1546344,2025-04-11,House,"(H) 3rd Reading Concurred",56,43,0,1,100
1896264,1481225,2025-01-14,House,"(H) State Administration--Do Pass",19,0,0,0,19
1896264,1481226,2025-01-16,House,"(H) 2nd Reading Passed",100,0,0,0,100
1896264,1481227,2025-01-17,House,"(H) 3rd Reading Passed",98,0,0,2,100
1896264,1498223,2025-02-24,Senate,"(S) State Administration--Be Concurred In",6,3,0,0,9
1896264,1502926,2025-03-01,Senate,"(S) 2nd Reading Concurred",37,13,0,0,50
1896264,1503420,2025-03-03,Senate,"(S) 3rd Reading Concurred",39,11,0,0,50
1896269,1506127,2025-03-05,Senate,"(S) Judiciary--Do Pass",5,3,0,0,8
1896269,1507473,2025-03-06,Senate,"(S) 2nd Reading Pass Motion Failed",22,28,0,0,50
1896269,1507474,2025-03-06,Senate,"(S) 2nd Reading Indefinitely Postponed",30,19,0,1,50
1896276,1482501,2025-01-14,House,"(H) Agriculture--To Table",11,6,0,0,17
1896276,1507923,2025-01-14,House,"(H) Agriculture--To Table",11,6,0,0,17
1896276,1518034,2025-01-14,House,"(H) Agriculture--To Table",11,6,0,0,17
1896282,1481228,2025-01-27,House,"(H) Natural Resources--Do Pass",14,0,0,0,14
1896282,1481229,2025-01-30,House,"(H) 2nd Reading Passed",98,1,0,1,100
1896282,1481230,2025-01-31,House,"(H) 3rd Reading Passed",99,0,0,1,100
1896282,1524191,2025-03-21,Senate,"(S) Natural Resources--Be Concurred In As Amended",11,0,0,0,11
1896282,1538470,2025-04-07,Senate,"(S) 2nd Reading Concurred",49,0,0,1,50
1896282,1540565,2025-04-08,Senate,"(S) 3rd Reading Concurred",47,1,0,2,50
1896282,1549078,2025-04-15,House,"(H) 2nd Reading Senate Amendments Concurred",98,2,0,0,100
1896282,1549989,2025-04-16,House,"(H) 3rd Reading Passed as Amended by Senate",93,5,0,2,100
1896286,1481231,2025-01-23,House,"(H) Fish, Wildlife and Parks--Do Pass",20,0,0,0,20
1896286,1481232,2025-01-30,House,"(H) 2nd Reading Passed",89,11,0,0,100
1896286,1481233,2025-01-31,House,"(H) 3rd Reading Passed",85,14,0,1,100
1896286,1489571,2025-02-13,Senate,"(S) Fish and Game--To Table",12,0,0,0,12
1896286,1495614,2025-02-13,Senate,"(S) Fish and Game--Be Concurred In",1,11,0,0,12
1896286,1530138,2025-02-13,Senate,"(S) Fish and Game--To Table",12,0,0,0,12
1896286,1559857,2025-01-23,House,"(H) Fish, Wildlife and Parks--Do Pass",20,0,0,0,20
1896292,1481234,2025-01-24,Senate,"(S) Judiciary--Do Pass As Amended",9,0,0,0,9
1896292,1481235,2025-01-29,Senate,"(S) 2nd Reading Passed",33,17,0,0,50
1896292,1481236,2025-01-30,Senate,"(S) 3rd Reading Passed",32,17,0,1,50
1896292,1539605,2025-04-08,House,"(H) Judiciary--Be Concurred In As Amended",12,8,0,0,20
1896292,1543562,2025-04-10,House,"(H) 2nd Reading Motion to Amend Carried",81,19,0,0,100
1896292,1546356,2025-04-11,House,"(H) 3rd Reading Concurred",60,39,0,1,100
1896292,1546876,2025-04-10,House,"(H) 2nd Reading Concurred as Amended",60,40,0,0,100
1896292,1547398,2025-04-14,Senate,"(S) 2nd Reading House Amendments Concurred",32,18,0,0,50
1896292,1549122,2025-04-15,Senate,"(S) 3rd Reading Passed as Amended by House",31,19,0,0,50
1896298,1481238,2025-01-20,House,"(H) Judiciary--Do Pass",12,8,0,0,20
1896298,1481239,2025-01-23,House,"(H) 2nd Reading Passed",51,49,0,0,100
1896298,1481240,2025-01-24,House,"(H) Reconsidered Previous Action; Placed on 2nd Reading",57,41,0,2,100
1896298,1481241,2025-01-27,House,"(H) 2nd Reading Motion to Amend Failed",42,58,0,0,100
1896298,1481242,2025-01-27,House,"(H) 2nd Reading Motion to Amend Carried",99,1,0,0,100
1896298,1481243,2025-01-27,House,"(H) 2nd Reading Passed as Amended",58,42,0,0,100
1896298,1481244,2025-01-29,House,"(H) 3rd Reading Passed",57,43,0,0,100
1896298,1487893,2025-02-12,Senate,"(S) Judiciary--Be Concurred In As Amended",6,0,0,3,9
1896298,1490444,2025-02-14,Senate,"(S) 2nd Reading Concurred",26,24,0,0,50
1896298,1524075,2025-03-21,Senate,"(S) Finance and Claims--To Table",12,10,0,0,22
1896298,1524076,2025-03-21,Senate,"(S) Finance and Claims--Be Concurred In",10,12,0,0,22
1896298,1529859,2025-03-21,Senate,"(S) Finance and Claims--To Table",12,10,0,0,22
1896298,1599172,2025-01-20,House,"(H) Judiciary--Do Pass",12,8,0,0,20
1896303,1485264,2025-02-10,Senate,"(S) Local Government--Do Pass As Amended",8,3,0,0,11
1896303,1500413,2025-02-26,Senate,"(S) 2nd Reading Passed",37,13,0,0,50
1896303,1532726,2025-04-01,Senate,"(S) Finance and Claims--To Table",22,0,0,0,22
1896303,1534685,2025-04-02,Senate,"(S) Motion Failed",24,26,0,0,50
1896307,1481245,2025-01-17,House,"(H) Natural Resources--Do Pass",12,2,0,0,14
1896307,1481246,2025-01-24,House,"(H) 2nd Reading Passed",94,6,0,0,100
1896307,1481247,2025-01-27,House,"(H) 3rd Reading Passed",90,8,0,2,100
1896307,1537420,2025-04-04,Senate,"(S) Natural Resources--Be Concurred In",11,0,0,0,11
1896307,1552055,2025-04-18,Senate,"(S) 2nd Reading Concurred",46,2,0,2,50
1896307,1553861,2025-04-22,Senate,"(S) 3rd Reading Concurred",49,1,0,0,50
1896313,1481248,2025-01-16,Senate,"(S) Education and Cultural Resources--Do Pass",14,0,0,0,14
1896313,1481249,2025-01-20,Senate,"(S) 2nd Reading Passed",50,0,0,0,50
1896313,1481250,2025-01-21,Senate,"(S) 3rd Reading Passed",48,1,0,1,50
1896313,1524151,2025-03-21,House,"(H) Education--Be Concurred In",15,0,0,0,15
1896313,1529354,2025-03-27,House,"(H) 2nd Reading Concurred",99,0,0,1,100
1896313,1529997,2025-03-28,House,"(H) 3rd Reading Concurred",99,0,0,1,100
1896321,1481251,2025-01-16,Senate,"(S) Education and Cultural Resources--Do Pass",14,0,0,0,14
1896321,1481252,2025-01-20,Senate,"(S) 2nd Reading Passed",50,0,0,0,50
1896321,1481253,2025-01-21,Senate,"(S) 3rd Reading Passed",50,0,0,0,50
1896321,1524146,2025-03-21,House,"(H) Education--Be Concurred In",15,0,0,0,15
1896321,1530309,2025-03-28,House,"(H) 2nd Reading Concurred",100,0,0,0,100
1896321,1530711,2025-03-29,House,"(H) 3rd Reading Concurred",95,0,0,5,100
1896324,1481254,2025-01-09,House,"(H) Local Government--Do Pass",17,0,0,0,17
1896324,1481255,2025-01-14,House,"(H) 2nd Reading Passed",100,0,0,0,100
1896324,1481256,2025-01-15,House,"(H) 3rd Reading Passed",98,1,0,1,100
1896324,1518619,2025-03-17,Senate,"(S) Local Government--Be Concurred In",10,0,0,1,11
1896324,1521300,2025-03-19,Senate,"(S) 2nd Reading Concurred",37,13,0,0,50
1896324,1522949,2025-03-20,Senate,"(S) 3rd Reading Concurred",38,12,0,0,50
1896329,1481257,2025-01-16,Senate,"(S) Education and Cultural Resources--Do Pass",14,0,0,0,14
1896329,1481258,2025-01-20,Senate,"(S) 2nd Reading Passed",50,0,0,0,50
1896329,1481259,2025-01-21,Senate,"(S) 3rd Reading Passed",50,0,0,0,50
1896329,1528052,2025-03-26,House,"(H) Education--Be Concurred In",15,0,0,0,15
1896329,1530648,2025-03-29,House,"(H) 2nd Reading Concurred",100,0,0,0,100
1896329,1531162,2025-03-31,House,"(H) 3rd Reading Concurred",99,0,0,1,100
1896370,1481260,2025-01-27,Senate,"(S) State Administration--Do Pass",6,3,0,0,9
1896370,1481261,2025-01-31,Senate,"(S) 2nd Reading Passed",29,21,0,0,50
1896370,1481262,2025-02-03,Senate,"(S) 3rd Reading Failed",17,32,0,1,50
1896370,1481263,2025-02-04,Senate,"(S) Motion to Reconsider Failed",17,33,0,0,50
1896377,1481275,2025-01-28,Senate,"(S) 2nd Reading Passed",32,18,0,0,50
1896377,1481276,2025-01-24,Senate,"(S) Judiciary--Do Pass",6,3,0,0,9
1896377,1481277,2025-01-28,Senate,"(S) 2nd Reading Motion to Amend Failed",18,32,0,0,50
1896377,1481278,2025-01-29,Senate,"(S) 3rd Reading Failed",23,26,0,1,50
1896387,1481284,2025-02-03,Senate,"(S) Judiciary--Do Pass As Amended",12,6,0,0,18
1896387,1497074,2025-02-07,Senate,"(S) 2nd Reading Motion to Amend Carried",34,15,0,1,50
1896387,1497075,2025-02-07,Senate,"(S) 2nd Reading Passed as Amended",27,22,0,1,50
1896387,1497076,2025-02-20,Senate,"(S) Finance and Claims--To Table",22,0,0,0,22
1896387,1501459,2025-02-27,Senate,"(S) 3rd Reading Passed",28,22,0,0,50
1896387,1535781,2025-04-03,House,"(H) Judiciary--Be Concurred In As Amended",12,8,0,0,20
1896387,1539760,2025-04-08,House,"(H) 2nd Reading Concurred",54,44,0,2,100
1896387,1543128,2025-04-09,House,"(H) Appropriations--Be Concurred In As Amended",13,10,0,0,23
1896387,1545978,2025-04-11,House,"(H) 2nd Reading Concurred",58,42,0,0,100
1896387,1546385,2025-04-11,House,"(H) 3rd Reading Concurred",58,41,0,1,100
1896387,1550042,2025-04-16,Senate,"(S) 2nd Reading House Amendments Concurred",46,2,0,2,50
1896387,1551286,2025-04-17,Senate,"(S) 3rd Reading Passed as Amended by House",33,17,0,0,50
1896387,1557054,2025-04-24,Senate,"(S) 2nd Reading Governor's Proposed Amendments Adopted",46,3,0,1,50
1896387,1558038,2025-04-25,House,"(H) 2nd Reading Governor's Proposed Amendments Adopted",85,15,0,0,100
1896387,1558039,2025-04-25,Senate,"(S) 3rd Reading Governor's Proposed Amendments Adopted",31,18,0,1,50
1896387,1558967,2025-04-28,House,"(H) 3rd Reading Governor's Proposed Amendments Adopted",56,44,0,0,100
1896387,1559768,2025-04-28,House,"(H) 3rd Reading Governor's Proposed Amendments Adopted",56,44,0,0,100
1896395,1481287,2025-01-29,Senate,"(S) 2nd Reading Motion to Amend Failed",18,32,0,0,50
1896395,1481288,2025-01-29,Senate,"(S) 2nd Reading Passed",31,19,0,0,50
1896395,1481289,2025-01-30,Senate,"(S) 3rd Reading Passed",30,19,0,1,50
1896395,1540060,2025-04-08,House,"(H) Judiciary--Be Concurred In",12,8,0,0,20
1896395,1544016,2025-04-10,House,"(H) 2nd Reading Concurred",55,43,0,2,100
1896395,1546126,2025-04-11,House,"(H) 3rd Reading Concurred",57,42,0,1,100
1896406,1490443,2025-02-13,Senate,"(S) Judiciary--Do Pass As Amended",6,0,0,3,9
1896406,1490678,2025-02-15,Senate,"(S) 2nd Reading Pass Motion Failed",22,28,0,0,50
1896406,1490719,2025-02-15,Senate,"(S) 2nd Reading Indefinitely Postponed",31,19,0,0,50
1896406,1491357,2025-02-17,Senate,"(S) Motion to Reconsider Failed",24,26,0,0,50
1896413,1481290,2025-02-03,Senate,"(S) Judiciary--Do Pass",6,3,0,0,9
1896413,1500577,2025-02-26,Senate,"(S) 2nd Reading Passed",29,21,0,0,50
1896413,1501416,2025-02-27,Senate,"(S) 3rd Reading Passed",28,22,0,0,50
1896413,1529991,2025-03-28,House,"(H) Judiciary--Be Concurred In As Amended",11,9,0,0,20
1896413,1531396,2025-03-31,House,"(H) Judiciary--Be Concurred In As Amended",11,9,0,0,20
1896413,1532641,2025-04-01,House,"(H) 2nd Reading Not Passed",41,59,0,0,100
1896420,1481291,2025-01-29,Senate,"(S) Natural Resources--Do Pass",11,0,0,0,11
1896420,1481292,2025-02-04,Senate,"(S) 2nd Reading Passed",46,4,0,0,50
1896420,1482456,2025-02-05,Senate,"(S) 3rd Reading Passed",44,4,0,2,50
1896420,1524297,2025-03-21,House,"(H) Natural Resources--Be Concurred In",14,0,0,0,14
1896420,1547546,2025-04-14,House,"(H) 2nd Reading Concurred",99,1,0,0,100
1896420,1548482,2025-04-15,House,"(H) 3rd Reading Concurred",96,1,0,3,100
1896430,1481296,2025-01-16,House,"(H) Judiciary--Do Pass",500,0,0,0,500
1896430,1481321,2025-01-20,House,"(H) 2nd Reading Passed",99,0,0,1,100
1896430,1481322,2025-01-21,House,"(H) 3rd Reading Passed",99,0,0,1,100
1896430,1497067,2025-02-21,Senate,"(S) Judiciary--Be Concurred In",8,0,0,0,8
1896430,1498033,2025-02-24,Senate,"(S) 2nd Reading Concurred",50,0,0,0,50
1896430,1499326,2025-02-25,Senate,"(S) 3rd Reading Concurred",49,0,0,1,50
1896430,1586689,2025-01-16,House,"(H) Judiciary--Do Pass",20,0,0,0,20
1896439,1481323,2025-01-17,House,"(H) Natural Resources--Do Pass As Amended",11,3,0,0,14
1896439,1481324,2025-01-29,House,"(H) 2nd Reading Passed",76,24,0,0,100
1896439,1481325,2025-01-30,House,"(H) 3rd Reading Passed",78,22,0,0,100
1896439,1495536,2025-02-20,Senate,"(S) Agriculture, Livestock and Irrigation--Be Concurred In",11,0,0,0,11
1896439,1518460,2025-03-17,Senate,"(S) 2nd Reading Concurred",29,21,0,0,50
1896439,1519772,2025-03-18,Senate,"(S) 3rd Reading Concurred",30,19,0,1,50
1896465,1481326,2025-01-10,House,"(H) Human Services--Do Pass As Amended",19,3,0,0,22
1896465,1481327,2025-01-16,House,"(H) 2nd Reading Passed",76,24,0,0,100
1896465,1481328,2025-01-17,House,"(H) 3rd Reading Passed",69,29,0,2,100
1896465,1530367,2025-03-28,Senate,"(S) Public Health, Welfare and Safety--Be Concurred In As Amended",5,6,0,0,11
1896465,1530368,2025-03-28,Senate,"(S) Public Health, Welfare and Safety--To Table",11,0,0,0,11
1896465,1536413,2025-03-28,Senate,"(S) Public Health, Welfare and Safety--To Table",11,0,0,0,11
1896465,1544667,2025-04-10,Senate,"(S) Taken from Committee; Placed on 2nd Reading",27,21,0,2,50
1896465,1545938,2025-04-10,Senate,"(S) Taken from Committee; Placed on 2nd Reading",27,21,0,2,50
1896465,1545939,2025-04-11,Senate,"(S) 2nd Reading Concurred",32,18,0,0,50
1896465,1546687,2025-04-12,Senate,"(S) 3rd Reading Concurred",31,19,0,0,50
1896465,1557979,2025-04-25,House,"(H) 2nd Reading Governor's Proposed Amendments Adopted",88,12,0,0,100
1896465,1558902,2025-04-25,House,"(H) 2nd Reading Governor's Proposed Amendments Adopted",88,12,0,0,100
1896465,1558903,2025-04-28,House,"(H) 3rd Reading Governor's Proposed Amendments Adopted",69,31,0,0,100
1896465,1558904,2025-04-28,Senate,"(S) 2nd Reading Governor's Proposed Amendments Adopted",48,2,0,0,50
1896465,1560372,2025-04-29,Senate,"(S) 3rd Reading Governor's Proposed Amendments Adopted",42,8,0,0,50
1896479,1481329,2025-01-14,House,"(H) State Administration--Do Pass",19,0,0,0,19
1896479,1481330,2025-01-16,House,"(H) 2nd Reading Passed",100,0,0,0,100
1896479,1481331,2025-01-17,House,"(H) 3rd Reading Passed",98,0,0,2,100
1896479,1495751,2025-02-14,Senate,"(S) State Administration--Be Concurred In",9,0,0,0,9
1896479,1518091,2025-03-14,Senate,"(S) 2nd Reading Concurred",36,14,0,0,50
1896479,1518245,2025-03-15,Senate,"(S) 3rd Reading Concurred",35,14,0,1,50
1896493,1481332,2025-01-20,House,"(H) Judiciary--Do Pass As Amended",20,0,0,0,20
1896493,1481333,2025-01-23,House,"(H) 2nd Reading Motion to Amend Failed",4,96,0,0,100
1896493,1481334,2025-01-23,House,"(H) 2nd Reading Passed",100,0,0,0,100
1896493,1481335,2025-01-24,House,"(H) 3rd Reading Passed",97,0,0,3,100
1896493,1486138,2025-02-11,Senate,"(S) 2nd Reading Concurred",46,4,0,0,50
1896493,1488020,2025-02-12,Senate,"(S) 3rd Reading Concurred",47,3,0,0,50
1896493,1488021,2025-02-07,Senate,"(S) Judiciary--Be Concurred In",8,1,0,0,9
1896493,1592174,2025-01-20,House,"(H) Judiciary--Do Pass As Amended",20,0,0,0,20
1896506,1481336,2025-01-08,Senate,"(S) Rules--",10,8,0,0,18
1896506,1481337,2025-01-09,Senate,"(S) Resolution Failed",23,27,0,0,50
1896506,1481338,2025-01-09,Senate,"(S) 2nd Reading Indefinitely Postponed",27,23,0,0,50
1896519,1541624,2025-04-09,House,"(H) Taxation--Resolution Adopted",21,0,0,0,21
1896534,1481339,2025-01-10,House,"(H) Business and Labor--Do Pass",20,0,0,0,20
1896534,1481340,2025-01-15,House,"(H) 2nd Reading Passed",96,4,0,0,100
1896534,1481341,2025-01-16,House,"(H) 3rd Reading Passed",97,2,0,1,100
1896534,1481342,2025-01-29,Senate,"(S) Business, Labor  and Economic Affairs--",11,0,0,0,11
1896534,1518612,2025-03-17,Senate,"(S) 2nd Reading Concurred",29,21,0,0,50
1896534,1519952,2025-03-18,Senate,"(S) 3rd Reading Concurred",29,20,0,1,50
1896546,1481343,2025-01-17,House,"(H) Natural Resources--Do Pass",14,0,0,0,14
1896546,1481344,2025-01-22,House,"(H) 2nd Reading Passed",100,0,0,0,100
1896546,1481345,2025-01-23,House,"(H) 3rd Reading Passed",100,0,0,0,100
1896546,1490845,2025-02-13,Senate,"(S) Agriculture, Livestock and Irrigation--Be Concurred In",11,0,0,0,11
1896546,1503470,2025-03-03,Senate,"(S) 2nd Reading Concurred",47,3,0,0,50
1896546,1504785,2025-03-04,Senate,"(S) 3rd Reading Concurred",47,3,0,0,50
1896559,1490441,2025-02-14,House,"(H) Natural Resources--Do Pass As Amended",14,0,0,0,14
1896559,1494963,2025-02-20,House,"(H) 2nd Reading Passed",97,3,0,0,100
1896559,1496549,2025-02-21,House,"(H) 3rd Reading Passed",94,4,0,2,100
1896559,1539133,2025-04-07,Senate,"(S) Natural Resources--Be Concurred In As Amended",10,1,0,0,11
1896559,1545957,2025-04-11,Senate,"(S) 3rd Reading Concurred",48,0,0,2,50
1896559,1549966,2025-04-16,House,"(H) 2nd Reading Senate Amendments Concurred",100,0,0,0,100
1896559,1551767,2025-04-17,House,"(H) 3rd Reading Passed as Amended by Senate",97,2,0,1,100
1896574,1481346,2025-01-17,House,"(H) Natural Resources--Do Pass As Amended",14,0,0,0,14
1896574,1481347,2025-01-23,House,"(H) 2nd Reading Passed",100,0,0,0,100
1896574,1481348,2025-01-24,House,"(H) 3rd Reading Passed",97,0,0,3,100
1896574,1488335,2025-02-10,Senate,"(S) Natural Resources--Be Concurred In",10,1,0,0,11
1896574,1503028,2025-03-01,Senate,"(S) 2nd Reading Concurred",49,1,0,0,50
1896574,1503724,2025-03-03,Senate,"(S) 3rd Reading Concurred",49,1,0,0,50
1896588,1481349,2025-01-13,House,"(H) Judiciary--Do Pass As Amended",20,0,0,0,20
1896588,1481350,2025-01-15,House,"(H) 2nd Reading Passed",100,0,0,0,100
1896588,1481351,2025-01-21,House,"(H) Appropriations--Do Pass",22,1,0,0,23
1896588,1481352,2025-01-23,House,"(H) 3rd Reading Passed",100,0,0,0,100
1896588,1487931,2025-02-12,Senate,"(S) Judiciary--Be Concurred In As Amended",6,0,0,3,9
1896588,1499974,2025-02-26,Senate,"(S) Finance and Claims--Be Concurred In",22,0,0,0,22
1896588,1501507,2025-02-27,Senate,"(S) 3rd Reading Concurred",50,0,0,0,50
1896588,1523212,2025-03-20,House,"(H) 2nd Reading Senate Amendments Concurred",99,1,0,0,100
1896588,1524154,2025-03-21,House,"(H) 3rd Reading Passed as Amended by Senate",97,0,0,3,100
1896599,1481353,2025-01-10,House,"(H) Human Services--Do Pass",21,0,0,0,21
1896599,1481354,2025-01-16,House,"(H) 2nd Reading Passed",99,1,0,0,100
1896599,1481355,2025-01-17,House,"(H) 3rd Reading Passed",98,0,0,2,100
1896599,1521701,2025-03-19,Senate,"(S) Public Health, Welfare and Safety--Be Concurred In",11,0,0,0,11
1896599,1525101,2025-03-24,Senate,"(S) 2nd Reading Concurred",50,0,0,0,50
1896599,1526637,2025-01-10,House,"(H) Human Services--Do Pass",15,0,0,6,21
1896599,1526638,2025-03-25,Senate,"(S) 3rd Reading Concurred",50,0,0,0,50
1896795,1481356,2025-01-21,Senate,"(S) Energy, Technology & Federal Relations--Do Pass",13,0,0,0,13
1896795,1481357,2025-01-23,Senate,"(S) 2nd Reading Passed",46,4,0,0,50
1896795,1481358,2025-01-24,Senate,"(S) 3rd Reading Passed",43,6,0,1,50
1896795,1496020,2025-02-12,House,"(H) Energy, Technology and Federal Relations--Be Concurred In",14,0,0,0,14
1896795,1521151,2025-03-19,House,"(H) 2nd Reading Concurred",100,0,0,0,100
1896795,1523951,2025-03-20,House,"(H) 3rd Reading Concurred",98,0,0,2,100
1896795,1530075,2025-01-21,Senate,"(S) Energy, Technology & Federal Relations--Do Pass",13,0,0,0,13
1896807,1490587,2025-02-14,Senate,"(S) Public Health, Welfare and Safety--Do Pass As Amended",10,1,0,0,11
1896807,1493284,2025-02-19,Senate,"(S) 2nd Reading Motion to Amend Carried",49,1,0,0,50
1896807,1493285,2025-02-19,Senate,"(S) 2nd Reading Passed as Amended",46,4,0,0,50
1896807,1499237,2025-02-25,Senate,"(S) Finance and Claims--Do Pass",22,0,0,0,22
1896807,1502589,2025-02-28,Senate,"(S) 3rd Reading Passed",48,1,0,1,50
1896807,1536258,2025-04-03,House,"(H) Judiciary--Be Concurred In",19,1,0,0,20
1896807,1541821,2025-04-09,House,"(H) 2nd Reading Concurred",95,4,0,1,100
1896807,1543054,2025-04-09,House,"(H) Appropriations--To Table",14,9,0,0,23
1896807,1544594,2025-04-09,House,"(H) Appropriations--To Table",14,9,0,0,23
1896819,1492209,2025-02-13,Senate,"(S) Judiciary--Do Pass As Amended",6,0,0,3,9
1896819,1493526,2025-02-19,Senate,"(S) 2nd Reading Passed",26,24,0,0,50
1896819,1493527,2025-02-13,Senate,"(S) Judiciary--Do Pass As Amended",6,0,0,3,9
1896819,1495666,2025-02-20,Senate,"(S) 3rd Reading Passed",29,21,0,0,50
1896819,1528903,2025-03-27,House,"(H) Judiciary--Be Concurred In As Amended",12,8,0,0,20
1896819,1539616,2025-04-08,House,"(H) 2nd Reading Not Concurred",45,53,0,2,100
1896832,1481361,2025-01-24,Senate,"(S) Highways and Transportation--",6,2,0,0,8
1896832,1481362,2025-02-03,Senate,"(S) 2nd Reading Passed",42,8,0,0,50
1896832,1481363,2025-02-04,Senate,"(S) 3rd Reading Passed",46,4,0,0,50
1896832,1496131,2025-02-12,House,"(H) Transportation--Be Concurred In",13,1,0,0,14
1896832,1525497,2025-03-24,House,"(H) 2nd Reading Concurred",94,4,0,2,100
1896832,1527033,2025-03-25,House,"(H) 3rd Reading Concurred",96,3,0,1,100
1896880,1481364,2025-01-24,Senate,"(S) Legislative Administration--Do Pass",6,0,0,0,6
1896880,1481365,2025-02-05,Senate,"(S) 2nd Reading Passed",40,10,0,0,50
1896880,1483775,2025-02-06,Senate,"(S) 3rd Reading Passed",39,10,0,1,50
1896880,1496229,2025-02-21,House,"(H) Legislative Administration--Be Concurred In As Amended",11,1,0,2,14
1896880,1522066,2025-03-19,House,"(H) 2nd Reading Concurred",99,1,0,0,100
1896880,1523802,2025-03-20,House,"(H) 3rd Reading Concurred",90,8,0,2,100
1896880,1527060,2025-03-25,Senate,"(S) 2nd Reading House Amendments Concurred",49,1,0,0,50
1896880,1528369,2025-03-26,Senate,"(S) 3rd Reading Passed as Amended by House",49,1,0,0,50
1896880,1569101,2025-02-21,House,"(H) Legislative Administration--Be Concurred In As Amended",11,1,2,0,14
1896884,1481368,2025-01-08,Senate,"(S) 2nd Reading Passed",50,0,0,0,50
1896884,1481369,2025-01-08,Senate,"(S) 3rd Reading Passed",50,0,0,0,50
1896884,1481370,2025-01-14,House,"(H) 2nd Reading Concurred",99,1,0,0,100
1896884,1481371,2025-01-15,House,"(H) 3rd Reading Concurred",97,2,0,1,100
1896884,1592188,2025-01-07,Senate,"(S) Education and Cultural Resources--Do Pass",14,0,0,0,14
1896884,1592189,2025-01-10,House,"(H) Transportation--Be Concurred In",13,0,1,0,14
1896891,1481372,2025-01-23,Senate,"(S) Fish and Game--Do Pass",8,4,0,0,12
1896891,1492279,2025-02-18,Senate,"(S) 2nd Reading Passed",34,16,0,0,50
1896891,1493579,2025-02-19,Senate,"(S) 3rd Reading Passed",34,15,0,1,50
1896891,1540878,2025-04-08,House,"(H) Fish, Wildlife and Parks--To Table",20,0,0,0,20
1896891,1544783,2025-04-08,House,"(H) Fish, Wildlife and Parks--To Table",20,0,0,0,20
1896897,1481373,2025-01-15,Senate,"(S) Natural Resources--Do Pass",11,0,0,0,11
1896897,1481374,2025-01-22,Senate,"(S) 2nd Reading Passed",29,21,0,0,50
1896897,1481375,2025-01-23,Senate,"(S) 3rd Reading Passed",30,20,0,0,50
1896897,1496101,2025-02-14,House,"(H) Natural Resources--Be Concurred In",12,2,0,0,14
1896897,1522117,2025-03-19,House,"(H) 2nd Reading Concurred",89,11,0,0,100
1896897,1523839,2025-03-20,House,"(H) 3rd Reading Concurred",85,13,0,2,100
1896900,1481376,2025-01-23,Senate,"(S) Taxation--Do Pass",8,0,0,0,8
1896900,1481377,2025-01-27,Senate,"(S) 2nd Reading Passed",47,3,0,0,50
1896900,1481378,2025-01-28,Senate,"(S) 3rd Reading Passed",47,3,0,0,50
1896900,1489035,2025-02-06,House,"(H) Taxation--Be Concurred In",21,0,0,0,21
1896900,1490415,2025-02-14,House,"(H) 2nd Reading Concurred",97,3,0,0,100
1896900,1492175,2025-02-18,House,"(H) 3rd Reading Concurred",96,3,0,1,100
1896900,1556886,2025-02-06,House,"(H) Taxation--Be Concurred In",21,0,0,0,21
1896907,1481381,2025-01-22,Senate,"(S) State Administration--Do Pass As Amended",9,4,0,0,13
1896907,1484101,2025-02-07,Senate,"(S) 2nd Reading Passed",47,2,0,1,50
1896907,1485249,2025-02-10,Senate,"(S) 3rd Reading Passed",47,2,0,1,50
1896907,1522456,2025-03-20,House,"(H) State Administration--Be Concurred In",19,0,0,0,19
1896907,1547206,2025-04-14,House,"(H) 2nd Reading Concurred",100,0,0,0,100
1896907,1548896,2025-04-15,House,"(H) 3rd Reading Concurred",97,0,0,3,100
1896914,1481382,2025-01-29,Senate,"(S) Judiciary--Do Pass As Amended",9,0,0,0,9
1896914,1481383,2025-01-31,Senate,"(S) 2nd Reading Passed",50,0,0,0,50
1896914,1481384,2025-02-03,Senate,"(S) 3rd Reading Passed",49,0,0,1,50
1896914,1539975,2025-04-08,House,"(H) Judiciary--Be Concurred In",20,0,0,0,20
1896914,1543873,2025-04-10,House,"(H) 2nd Reading Concurred",100,0,0,0,100
1896914,1546099,2025-04-11,House,"(H) 3rd Reading Concurred",98,1,0,1,100
1896918,1487317,2025-02-12,Senate,"(S) Judiciary--To Table",6,0,0,3,9
1896923,1481385,2025-02-05,Senate,"(S) Business, Labor  and Economic Affairs--Do Pass",11,0,0,0,11
1896923,1484151,2025-02-07,Senate,"(S) 2nd Reading Passed",45,4,0,1,50
1896923,1486711,2025-02-11,Senate,"(S) Finance and Claims--Do Pass",20,2,0,0,22
1896923,1490188,2025-02-14,Senate,"(S) 3rd Reading Passed",50,0,0,0,50
1896923,1524053,2025-03-21,House,"(H) Business and Labor--Be Concurred In",20,0,0,0,20
1896923,1526740,2025-03-25,House,"(H) 2nd Reading Concurred",99,1,0,0,100
1896923,1539604,2025-04-08,House,"(H) Appropriations--Be Concurred In",19,4,0,0,23
1896923,1542056,2025-04-09,House,"(H) 3rd Reading Concurred",95,2,0,3,100
1896926,1481386,2025-01-22,Senate,"(S) State Administration--Do Pass As Amended",5,4,0,0,9
1896926,1488675,2025-01-22,Senate,"(S) State Administration--Do Pass As Amended",5,4,0,0,9
1896926,1490687,2025-02-15,Senate,"(S) 2nd Reading Passed",31,19,0,0,50
1896926,1495853,2025-02-20,Senate,"(S) Finance and Claims--Do Pass",14,8,0,0,22
1896926,1497706,2025-02-24,Senate,"(S) 3rd Reading Passed",33,16,0,1,50
1896926,1529029,2025-03-27,House,"(H) State Administration--Be Concurred In",19,0,0,0,19
1896926,1530650,2025-03-29,House,"(H) 2nd Reading Concurred",82,18,0,0,100
1896926,1540598,2025-04-08,House,"(H) Appropriations--Be Concurred In",23,0,0,0,23
1896926,1543555,2025-04-10,House,"(H) 3rd Reading Concurred",82,15,0,3,100
1896932,1481387,2025-01-29,Senate,"(S) Judiciary--",5,4,0,0,9
1896932,1529009,2025-03-27,Senate,"(S) 2nd Reading Pass Motion Failed",23,27,0,0,50
1896932,1529010,2025-03-27,Senate,"(S) 2nd Reading Indefinitely Postponed",35,15,0,0,50
1896939,1481389,2025-01-15,Senate,"(S) Natural Resources--Do Pass",11,0,0,0,11
1896939,1481390,2025-01-17,Senate,"(S) 2nd Reading Passed",34,16,0,0,50
1896939,1481391,2025-01-20,Senate,"(S) 3rd Reading Passed",28,21,0,1,50
1896939,1488793,2025-01-31,House,"(H) Natural Resources--Be Concurred In",14,0,0,0,14
1896939,1490515,2025-02-14,House,"(H) 2nd Reading Concurred",92,8,0,0,100
1896939,1491876,2025-01-15,Senate,"(S) Natural Resources--Do Pass",11,0,0,0,11
1896939,1491877,2025-02-18,House,"(H) 3rd Reading Concurred",88,11,0,1,100
1896942,1481392,2025-01-17,House,"(H) State Administration--Do Pass As Amended",19,0,0,0,19
1896942,1481393,2025-01-22,House,"(H) 2nd Reading Passed",81,19,0,0,100
1896942,1481394,2025-01-29,House,"(H) Appropriations--Do Pass",22,1,0,0,23
1896942,1481395,2025-01-31,House,"(H) 3rd Reading Passed",93,6,0,1,100
1896942,1484528,2025-01-29,House,"(H) Appropriations--Do Pass",22,1,0,0,23
1896942,1537395,2025-04-04,Senate,"(S) State Administration--Be Concurred In As Amended",5,4,0,0,9
1896942,1544584,2025-04-10,Senate,"(S) 2nd Reading Concurred",27,23,0,0,50
1896942,1546859,2025-04-14,Senate,"(S) Finance and Claims--Be Concurred In",13,9,0,0,22
1896942,1548233,2025-01-29,House,"(H) Appropriations--Do Pass",22,1,0,0,23
1896942,1548978,2025-04-15,Senate,"(S) 3rd Reading Concurred",29,20,0,1,50
1896942,1552198,2025-04-18,House,"(H) 2nd Reading Senate Amendments Concurred",96,2,0,2,100
1896942,1553790,2025-04-22,House,"(H) 3rd Reading Passed as Amended by Senate",83,15,0,2,100
1896947,1481396,2025-01-16,House,"(H) Business and Labor--Do Pass As Amended",20,0,0,3,23
1896947,1481397,2025-01-28,House,"(H) 2nd Reading Passed",100,0,0,0,100
1896947,1481398,2025-01-29,House,"(H) 3rd Reading Passed",100,0,0,0,100
1896947,1527756,2025-03-26,Senate,"(S) Business, Labor  and Economic Affairs--Be Concurred In",12,0,0,0,12
1896947,1552138,2025-04-18,Senate,"(S) 2nd Reading Concurred",44,5,0,1,50
1896947,1553608,2025-04-22,Senate,"(S) 3rd Reading Concurred",42,8,0,0,50
1896953,1481399,2025-01-24,Senate,"(S) Public Health, Welfare and Safety--Do Pass",6,5,0,0,11
1896953,1486124,2025-02-11,Senate,"(S) 2nd Reading Pass Motion Failed",20,30,0,0,50
1896953,1486125,2025-02-11,Senate,"(S) 2nd Reading Indefinitely Postponed",31,19,0,0,50
1896957,1489650,2025-02-13,Senate,"(S) Taxation--Do Pass As Amended",8,0,0,0,8
1896957,1499503,2025-02-25,Senate,"(S) 2nd Reading Passed",50,0,0,0,50
1896957,1500842,2025-02-26,Senate,"(S) 3rd Reading Passed",50,0,0,0,50
1896957,1523338,2025-03-20,House,"(H) Taxation--Be Concurred In",21,0,0,0,21
1896957,1547798,2025-04-14,House,"(H) 2nd Reading Concurred",99,1,0,0,100
1896957,1549220,2025-04-15,House,"(H) 3rd Reading Concurred",97,0,0,3,100
1896961,1481400,2025-01-31,Senate,"(S) State Administration--Do Pass As Amended",9,0,0,0,9
1896961,1481401,2025-02-05,Senate,"(S) 2nd Reading Passed",50,0,0,0,50
1896961,1483469,2025-02-06,Senate,"(S) 3rd Reading Passed",49,0,0,1,50
1896961,1522971,2025-03-20,House,"(H) State Administration--Be Concurred In",19,0,0,0,19
1896961,1526071,2025-03-25,House,"(H) 2nd Reading Concurred",100,0,0,0,100
1896961,1527559,2025-03-26,House,"(H) 3rd Reading Concurred",99,0,0,1,100
1896970,1481402,2025-01-09,House,"(H) Fish, Wildlife and Parks--Do Pass",20,0,0,0,20
1896970,1481403,2025-01-13,House,"(H) 2nd Reading Passed",93,6,0,1,100
1896970,1481404,2025-01-14,House,"(H) 3rd Reading Passed",83,15,0,2,100
1896970,1488323,2025-02-11,Senate,"(S) Fish and Game--Be Concurred In",12,0,0,0,12
1896970,1518242,2025-03-15,Senate,"(S) 2nd Reading Concurred",43,5,0,2,50
1896970,1518652,2025-03-17,Senate,"(S) 3rd Reading Concurred",45,4,0,1,50
1896972,1481405,2025-01-17,House,"(H) Taxation--Do Pass",21,0,0,0,21
1896972,1481406,2025-01-29,House,"(H) 2nd Reading Passed",100,0,0,0,100
1896972,1481407,2025-01-30,House,"(H) 3rd Reading Passed",100,0,0,0,100
1896972,1496249,2025-02-21,Senate,"(S) Taxation--Be Concurred In",8,0,0,0,8
1896972,1520024,2025-03-18,Senate,"(S) 2nd Reading Concurred",48,2,0,0,50
1896972,1521356,2025-03-19,Senate,"(S) 3rd Reading Concurred",46,4,0,0,50
1896975,1481408,2025-01-14,House,"(H) State Administration--Do Pass",19,0,0,0,19
1896975,1481409,2025-01-16,House,"(H) 2nd Reading Passed",100,0,0,0,100
1896975,1481410,2025-01-17,House,"(H) 3rd Reading Passed",98,0,0,2,100
1896975,1521664,2025-03-19,Senate,"(S) State Administration--Be Concurred In As Amended",9,0,0,0,9
1896975,1525053,2025-03-24,Senate,"(S) 2nd Reading Concurred",50,0,0,0,50
1896975,1526578,2025-03-25,Senate,"(S) 3rd Reading Concurred",50,0,0,0,50
1896975,1530037,2025-03-28,House,"(H) 2nd Reading Senate Amendments Concurred",100,0,0,0,100
1896975,1530721,2025-03-29,House,"(H) 3rd Reading Passed as Amended by Senate",96,0,0,4,100
1896981,1481411,2025-01-27,House,"(H) Transportation--Do Pass As Amended",14,0,0,0,14
1896981,1481412,2025-02-04,House,"(H) 2nd Reading Motion to Amend Carried",84,16,0,0,100
1896981,1481413,2025-02-04,House,"(H) 2nd Reading Passed as Amended",95,5,0,0,100
1896981,1483424,2025-02-06,House,"(H) 3rd Reading Passed",98,1,0,1,100
1896981,1497736,2025-02-21,Senate,"(S) Highways and Transportation--Be Concurred In",7,1,0,0,8
1896981,1518240,2025-03-15,Senate,"(S) 2nd Reading Concurred",34,16,0,0,50
1896981,1518569,2025-03-17,Senate,"(S) 3rd Reading Concurred",29,20,0,1,50
1896985,1481414,2025-01-15,House,"(H) Business and Labor--Do Pass",20,0,0,0,20
1896985,1481415,2025-01-21,House,"(H) 2nd Reading Passed",98,1,0,1,100
1896985,1481416,2025-01-22,House,"(H) 3rd Reading Passed",98,2,0,0,100
1896985,1521561,2025-03-19,Senate,"(S) Business, Labor  and Economic Affairs--Be Concurred In",11,0,0,1,12
1896985,1526484,2025-03-25,Senate,"(S) 2nd Reading Concurred",47,3,0,0,50
1896985,1527873,2025-03-26,Senate,"(S) 3rd Reading Concurred",49,1,0,0,50
1896989,1502954,2025-03-01,House,"(H) Judiciary--Do Pass As Amended",20,0,0,0,20
1896989,1503616,2025-03-03,House,"(H) 2nd Reading Passed",92,6,0,2,100
1896989,1504275,2025-03-04,House,"(H) Appropriations--Do Pass",23,0,0,0,23
1896989,1505752,2025-03-05,House,"(H) 3rd Reading Passed",96,2,0,2,100
1896989,1541524,2025-04-09,Senate,"(S) Judiciary--Be Concurred In As Amended",5,3,0,0,8
1896989,1545572,2025-04-11,Senate,"(S) 2nd Reading Concurred",26,23,0,1,50
1896989,1546602,2025-04-12,Senate,"(S) 3rd Reading Failed",24,26,0,0,50
1896995,1481417,2025-01-21,House,"(H) Business and Labor--Do Pass",34,6,0,0,40
1896995,1481419,2025-01-24,House,"(H) 2nd Reading Passed",63,37,0,0,100
1896995,1481420,2025-01-27,House,"(H) 3rd Reading Passed",61,37,0,2,100
1896995,1522048,2025-03-19,Senate,"(S) Business, Labor  and Economic Affairs--Be Concurred In",7,4,0,1,12
1896995,1524920,2025-03-24,Senate,"(S) 2nd Reading Concur Motion Failed",21,29,0,0,50
1896995,1524921,2025-03-24,Senate,"(S) 2nd Reading Indefinitely Postponed",46,4,0,0,50
1897000,1481421,2025-01-14,House,"(H) Taxation--Do Pass As Amended",21,0,0,0,21
1897000,1481422,2025-01-21,House,"(H) 2nd Reading Passed",99,0,0,1,100
1897000,1481423,2025-01-23,House,"(H) Appropriations--Do Pass",21,0,0,2,23
1897000,1481424,2025-01-27,House,"(H) 3rd Reading Passed",98,0,0,2,100
1897000,1534113,2025-04-02,Senate,"(S) Taxation--Be Concurred In",8,0,0,0,8
1897000,1541573,2025-04-02,Senate,"(S) Taxation--Be Concurred In",8,0,0,0,8
1897000,1544085,2025-04-10,Senate,"(S) 2nd Reading Concurred",50,0,0,0,50
1897000,1546174,2025-04-11,Senate,"(S) 3rd Reading Concurred",48,0,0,2,50
1897004,1481425,2025-01-14,House,"(H) State Administration--Do Pass",19,0,0,0,19
1897004,1481426,2025-01-21,House,"(H) 2nd Reading Passed",99,0,0,1,100
1897004,1481427,2025-01-22,House,"(H) 3rd Reading Passed",100,0,0,0,100
1897004,1521395,2025-03-19,Senate,"(S) Taxation--Be Concurred In",8,0,0,0,8
1897004,1524876,2025-03-24,Senate,"(S) 2nd Reading Concurred",49,1,0,0,50
1897004,1526373,2025-03-25,Senate,"(S) 3rd Reading Concurred",49,1,0,0,50
1897013,1481428,2025-01-14,House,"(H) Taxation--Do Pass",18,3,0,0,21
1897013,1481429,2025-01-20,House,"(H) 2nd Reading Passed",86,13,0,1,100
1897013,1481430,2025-01-21,House,"(H) 3rd Reading Passed",85,14,0,1,100
1897013,1496536,2025-02-21,Senate,"(S) Taxation--Be Concurred In",8,0,0,0,8
1897013,1518266,2025-03-15,Senate,"(S) 2nd Reading Concurred",50,0,0,0,50
1897013,1519023,2025-03-17,Senate,"(S) 3rd Reading Concurred",49,0,0,1,50
1897017,1482198,2025-01-23,House,"(H) Fish, Wildlife and Parks--To Table",8,12,0,0,20
1897017,1482199,2025-01-30,House,"(H) Fish, Wildlife and Parks--To Table",12,8,0,0,20
1897017,1483069,2025-01-30,House,"(H) Fish, Wildlife and Parks--To Table",12,8,0,0,20
1897017,1503110,2025-03-01,House,"(H) Taken from Committee; Placed on 2nd Reading",41,56,0,3,100
1897017,1542286,2025-03-01,House,"(H) Taken from Committee; Placed on 2nd Reading",41,56,0,3,100
1897021,1481431,2025-01-23,House,"(H) State Administration--Do Pass As Amended",19,0,0,0,19
1897021,1481432,2025-01-29,House,"(H) 2nd Reading Passed",100,0,0,0,100
1897021,1481433,2025-01-30,House,"(H) 3rd Reading Passed",100,0,0,0,100
1897021,1521556,2025-03-19,Senate,"(S) State Administration--Be Concurred In As Amended",9,0,0,0,9
1897021,1546516,2025-04-12,Senate,"(S) 2nd Reading Concurred",49,0,0,1,50
1897021,1547177,2025-04-14,Senate,"(S) 3rd Reading Concurred",47,1,0,2,50
1897021,1551657,2025-04-17,House,"(H) 2nd Reading Senate Amendments Concurred",100,0,0,0,100
1897021,1552151,2025-04-18,House,"(H) 3rd Reading Passed as Amended by Senate",98,0,0,2,100
1897027,1481435,2025-01-09,House,"(H) Fish, Wildlife and Parks--Do Pass",20,0,0,0,20
1897027,1481436,2025-01-15,House,"(H) 2nd Reading Passed",99,1,0,0,100
1897027,1481437,2025-01-16,House,"(H) 3rd Reading Passed",98,1,0,1,100
1897027,1488156,2025-01-30,Senate,"(S) Fish and Game--Be Concurred In",12,0,0,0,12
1897027,1518239,2025-03-15,Senate,"(S) 2nd Reading Concurred",49,0,0,1,50
1897027,1518639,2025-03-17,Senate,"(S) 3rd Reading Concurred",49,0,0,1,50
1897032,1481438,2025-01-23,House,"(H) Fish, Wildlife and Parks--Do Pass As Amended",20,0,0,0,20
1897032,1481439,2025-01-29,House,"(H) 2nd Reading Passed",89,11,0,0,100
1897032,1481440,2025-01-30,House,"(H) 3rd Reading Passed",86,14,0,0,100
1897032,1487978,2025-02-11,Senate,"(S) Fish and Game--Be Concurred In",12,0,0,0,12
1897032,1518241,2025-03-15,Senate,"(S) 2nd Reading Concurred",44,5,0,1,50
1897032,1518615,2025-03-17,Senate,"(S) 3rd Reading Concurred",43,6,0,1,50
1897032,1560047,2025-01-23,House,"(H) Fish, Wildlife and Parks--Do Pass As Amended",20,0,0,0,20
1897036,1481441,2025-01-20,House,"(H) Judiciary--Do Pass",20,0,0,0,20
1897036,1481442,2025-01-23,House,"(H) 2nd Reading Passed",56,44,0,0,100
1897036,1481443,2025-01-24,House,"(H) 3rd Reading Passed",60,38,0,2,100
1897036,1515844,2025-02-11,Senate,"(S) Judiciary--Be Concurred In",9,0,0,0,9
1897036,1522578,2025-03-20,Senate,"(S) 2nd Reading Motion to Amend Failed",23,26,0,1,50
1897036,1523237,2025-03-20,Senate,"(S) 2nd Reading Concurred",32,18,0,0,50
1897036,1538241,2025-04-07,Senate,"(S) Finance and Claims--Be Concurred In",19,3,0,0,22
1897036,1540195,2025-04-08,Senate,"(S) 3rd Reading Concurred",39,9,0,2,50
1897036,1558801,2025-01-20,House,"(H) Judiciary--Do Pass",20,0,0,0,20
1897043,1481444,2025-01-15,House,"(H) Transportation--Do Pass",14,0,0,0,14
1897043,1481445,2025-01-21,House,"(H) 2nd Reading Passed",98,1,0,1,100
1897043,1481446,2025-01-22,House,"(H) 3rd Reading Passed",99,1,0,0,100
1897043,1495969,2025-02-12,Senate,"(S) Highways and Transportation--Be Concurred In",8,0,0,0,8
1897043,1518255,2025-03-15,Senate,"(S) 2nd Reading Concurred",41,8,0,1,50
1897043,1518441,2025-03-17,Senate,"(S) 3rd Reading Concurred",37,12,0,1,50
1897047,1481447,2025-01-20,House,"(H) Energy, Technology and Federal Relations--Do Pass",14,0,0,0,14
1897047,1481448,2025-01-23,House,"(H) 2nd Reading Passed",98,2,0,0,100
1897047,1481449,2025-02-03,House,"(H) Appropriations--",13,10,0,0,23
1897063,1481450,2025-01-22,Senate,"(S) Judiciary--Do Pass",6,3,0,0,9
1897063,1481451,2025-01-24,Senate,"(S) 2nd Reading Pass Motion Failed",25,25,0,0,50
1897063,1481452,2025-01-24,Senate,"(S) 2nd Reading Indefinitely Postponed",29,20,0,1,50
1897218,1481453,2025-01-16,House,"(H) Fish, Wildlife and Parks--Do Pass",20,0,0,0,20
1897218,1481454,2025-01-28,House,"(H) 2nd Reading Passed",94,6,0,0,100
1897218,1481455,2025-01-29,House,"(H) 3rd Reading Passed",97,3,0,0,100
1897218,1492410,2025-02-18,Senate,"(S) Fish and Game--Be Concurred In As Amended",12,0,0,0,12
1897218,1518595,2025-03-17,Senate,"(S) 2nd Reading Concurred",48,2,0,0,50
1897218,1519915,2025-03-18,Senate,"(S) 3rd Reading Concurred",47,2,0,1,50
1897218,1524073,2025-03-21,House,"(H) 2nd Reading Senate Amendments Concurred",99,0,0,1,100
1897218,1524674,2025-03-24,House,"(H) 3rd Reading Passed as Amended by Senate",97,0,0,3,100
1897241,1481456,2025-01-13,House,"(H) Judiciary--Do Pass As Amended",20,0,0,0,20
1897241,1481457,2025-01-15,House,"(H) 2nd Reading Passed",100,0,0,0,100
1897241,1481458,2025-01-16,House,"(H) 3rd Reading Passed",99,0,0,1,100
1897241,1495781,2025-02-11,Senate,"(S) Judiciary--Be Concurred In",9,0,0,0,9
1897241,1518236,2025-03-15,Senate,"(S) 2nd Reading Concurred",49,0,0,1,50
1897241,1518548,2025-03-17,Senate,"(S) 3rd Reading Concurred",49,0,0,1,50
1897264,1481459,2025-01-23,House,"(H) Fish, Wildlife and Parks--Do Pass As Amended",20,0,0,0,20
1897264,1481460,2025-01-29,House,"(H) 2nd Reading Passed",98,2,0,0,100
1897264,1481461,2025-01-30,House,"(H) 3rd Reading Passed",97,3,0,0,100
1897264,1488200,2025-02-11,Senate,"(S) Fish and Game--Be Concurred In",9,3,0,0,12
1897264,1519672,2025-03-18,Senate,"(S) 2nd Reading Concurred",32,18,0,0,50
1897264,1521731,2025-03-19,Senate,"(S) 3rd Reading Concurred",32,18,0,0,50
1897292,1481462,2025-01-16,House,"(H) Fish, Wildlife and Parks--Do Pass",20,0,0,0,20
1897292,1481463,2025-01-29,House,"(H) 2nd Reading Passed",98,2,0,0,100
1897292,1481464,2025-01-30,House,"(H) 3rd Reading Passed",98,2,0,0,100
1897292,1488078,2025-02-11,Senate,"(S) Fish and Game--Be Concurred In",12,0,0,0,12
1897292,1518466,2025-03-17,Senate,"(S) 2nd Reading Concurred",39,11,0,0,50
1897292,1519799,2025-03-18,Senate,"(S) 3rd Reading Concurred",34,15,0,1,50
1898312,1481465,2025-01-14,House,"(H) Taxation--Do Pass",21,0,0,0,21
1898312,1481466,2025-01-21,House,"(H) 2nd Reading Passed",99,0,0,1,100
1898312,1481467,2025-01-22,House,"(H) 3rd Reading Passed",100,0,0,0,100
1898312,1521378,2025-03-19,Senate,"(S) Taxation--Be Concurred In",8,0,0,0,8
1898312,1526162,2025-03-25,Senate,"(S) 2nd Reading Concurred",50,0,0,0,50
1898312,1527641,2025-03-26,Senate,"(S) 3rd Reading Concurred",50,0,0,0,50
1899691,1481470,2025-01-10,House,"(H) Rules--Do Pass As Amended",13,9,0,0,22
1899691,1481471,2025-01-14,House,"(H) 2nd Reading Passed",58,42,0,0,100
1899703,1481472,2025-01-15,House,"(H) Business and Labor--Do Pass",20,0,0,0,20
1899703,1481473,2025-01-21,House,"(H) 2nd Reading Passed",99,0,0,1,100
1899703,1481474,2025-01-22,House,"(H) 3rd Reading Passed",100,0,0,0,100
1899703,1521640,2025-03-19,Senate,"(S) Business, Labor  and Economic Affairs--Be Concurred In",11,0,0,1,12
1899703,1522946,2025-03-20,Senate,"(S) 2nd Reading Concurred",50,0,0,0,50
1899703,1524106,2025-03-21,Senate,"(S) 3rd Reading Concurred",50,0,0,0,50
1899705,1481475,2025-01-16,House,"(H) State Administration--Do Pass",19,0,0,0,19
1899705,1481476,2025-01-21,House,"(H) 2nd Reading Passed",99,0,0,1,100
1899705,1481477,2025-01-22,House,"(H) 3rd Reading Passed",100,0,0,0,100
1899705,1499102,2025-02-25,Senate,"(S) Legislative Administration--Be Concurred In",6,0,0,0,6
1899705,1518244,2025-03-15,Senate,"(S) 2nd Reading Concurred",47,3,0,0,50
1899705,1518635,2025-03-17,Senate,"(S) 3rd Reading Concurred",47,2,0,1,50
1899706,1481480,2025-01-31,House,"(H) 2nd Reading Passed",99,0,0,1,100
1899706,1481481,2025-02-03,House,"(H) 3rd Reading Passed",99,0,0,1,100
1899706,1520768,2025-03-19,Senate,"(S) Business, Labor  and Economic Affairs--Be Concurred In",11,0,0,1,12
1899706,1538161,2025-04-07,Senate,"(S) 2nd Reading Concurred",49,0,0,1,50
1899706,1540034,2025-04-08,Senate,"(S) 3rd Reading Concurred",48,0,0,2,50
1899707,1481482,2025-01-20,House,"(H) Legislative Administration--Do Pass",14,0,0,0,14
1899707,1481483,2025-01-23,House,"(H) 2nd Reading Passed",99,1,0,0,100
1899707,1481484,2025-01-24,House,"(H) 3rd Reading Passed",98,0,0,2,100
1899707,1493849,2025-02-19,Senate,"(S) Legislative Administration--Be Concurred In",6,0,0,0,6
1899707,1518268,2025-03-15,Senate,"(S) 2nd Reading Concurred",42,8,0,0,50
1899707,1519010,2025-03-17,Senate,"(S) 3rd Reading Concurred",41,8,0,1,50
1899707,1564789,2025-01-20,House,"(H) Legislative Administration--Do Pass",14,0,0,0,14
1899709,1481485,2025-01-16,House,"(H) State Administration--Do Pass",18,1,0,0,19
1899709,1497806,2025-02-24,House,"(H) State Administration--To Table",19,0,0,0,19
1899710,1481486,2025-01-16,House,"(H) State Administration--Do Pass",19,0,0,0,19
1899710,1481487,2025-01-21,House,"(H) 2nd Reading Passed",91,8,0,1,100
1899710,1481488,2025-01-22,House,"(H) 3rd Reading Passed",76,24,0,0,100
1899710,1499359,2025-02-25,Senate,"(S) Legislative Administration--Be Concurred In",4,2,0,0,6
1899710,1518267,2025-03-15,Senate,"(S) 2nd Reading Concurred",38,11,0,1,50
1899710,1519027,2025-03-17,Senate,"(S) 3rd Reading Concurred",41,8,0,1,50
1899712,1481489,2025-01-16,House,"(H) State Administration--Do Pass",19,0,0,0,19
1899712,1481490,2025-01-21,House,"(H) 2nd Reading Passed",93,6,0,1,100
1899712,1481491,2025-01-22,House,"(H) 3rd Reading Passed",86,14,0,0,100
1899712,1494278,2025-02-19,Senate,"(S) Legislative Administration--Be Concurred In",6,0,0,0,6
1899712,1518257,2025-03-15,Senate,"(S) 2nd Reading Concurred",50,0,0,0,50
1899712,1518564,2025-03-17,Senate,"(S) 3rd Reading Concurred",49,0,0,1,50
1899723,1482268,2025-01-29,Senate,"(S) Natural Resources--To Table",7,4,0,0,11
1899723,1524111,2025-03-21,Senate,"(S) Natural Resources--Do Pass",11,0,0,0,11
1899723,1534087,2025-04-02,Senate,"(S) 2nd Reading Passed",48,2,0,0,50
1899723,1535956,2025-04-03,Senate,"(S) Finance and Claims--Do Pass",22,0,0,0,22
1899723,1537304,2025-04-04,Senate,"(S) 3rd Reading Passed",46,3,0,1,50
1899723,1547588,2025-04-14,House,"(H) Natural Resources--Be Concurred In",14,0,0,0,14
1899723,1551450,2025-04-17,House,"(H) 2nd Reading Concurred",100,0,0,0,100
1899723,1551936,2025-04-17,House,"(H) Appropriations--To Table",21,1,1,0,23
1899723,1552118,2025-04-17,House,"(H) Appropriations--To Table",21,1,1,0,23
1899723,1552119,2025-04-18,House,"(H) Appropriations--Be Concurred In",23,0,0,0,23
1899723,1553484,2025-04-22,House,"(H) 3rd Reading Concurred",98,0,0,2,100
1899726,1481492,2025-02-04,Senate,"(S) Legislative Administration--Do Pass",6,0,0,0,6
1899726,1483391,2025-02-06,Senate,"(S) 2nd Reading Passed",48,0,0,2,50
1899726,1484237,2025-02-07,Senate,"(S) 3rd Reading Passed",45,4,0,1,50
1899726,1496232,2025-02-21,House,"(H) Legislative Administration--Be Concurred In",12,0,0,2,14
1899726,1521306,2025-03-19,House,"(H) 2nd Reading Concurred",78,22,0,0,100
1899726,1522965,2025-03-20,House,"(H) 3rd Reading Concurred",76,22,0,2,100
1899729,1481493,2025-01-27,Senate,"(S) Local Government--Do Pass As Amended",7,4,0,0,11
1899729,1500532,2025-02-26,Senate,"(S) 2nd Reading Motion to Amend Carried",45,5,0,0,50
1899729,1500533,2025-02-26,Senate,"(S) 2nd Reading Passed as Amended",50,0,0,0,50
1899729,1501013,2025-01-27,Senate,"(S) Local Government--Do Pass As Amended",7,4,0,0,11
1899729,1502591,2025-02-28,Senate,"(S) 3rd Reading Passed",42,7,0,1,50
1899729,1535896,2025-04-03,House,"(H) Taxation--To Table",16,5,0,0,21
1899729,1537281,2025-04-03,House,"(H) Taxation--To Table",16,5,0,0,21
1899729,1546069,2025-04-11,House,"(H) Taken from Committee; Placed on 2nd Reading",51,46,0,3,100
1899729,1550172,2025-04-16,House,"(H) Taken from Committee; Placed on 2nd Reading",54,41,0,5,100
1899729,1551853,2025-04-17,House,"(H) Taken from Committee; Placed on 2nd Reading",38,59,0,3,100
1899732,1481494,2025-02-04,Senate,"(S) Legislative Administration--Do Pass",6,0,0,0,6
1899732,1483516,2025-02-06,Senate,"(S) 2nd Reading Passed",49,0,0,1,50
1899732,1484250,2025-02-07,Senate,"(S) 3rd Reading Passed",49,0,0,1,50
1899732,1497693,2025-02-24,House,"(H) Legislative Administration--Be Concurred In",14,0,0,0,14
1899732,1520402,2025-03-18,House,"(H) 2nd Reading Concurred",98,1,0,1,100
1899732,1521752,2025-03-19,House,"(H) 3rd Reading Concurred",98,0,0,2,100
1899735,1484524,2025-02-06,Senate,"(S) Judiciary--Do Pass",5,4,0,0,9
1899735,1486413,2025-02-11,Senate,"(S) 2nd Reading Motion to Amend Carried",48,2,0,0,50
1899735,1486414,2025-02-11,Senate,"(S) 2nd Reading Passed as Amended",47,3,0,0,50
1899735,1487727,2025-02-12,Senate,"(S) 3rd Reading Passed",48,2,0,0,50
1899735,1541812,2025-04-09,House,"(H) Judiciary--Be Concurred In",20,0,0,0,20
1899735,1545819,2025-04-11,House,"(H) 2nd Reading Concurred",99,1,0,0,100
1899735,1546309,2025-04-11,House,"(H) 3rd Reading Concurred",98,1,0,1,100
1899738,1487805,2025-02-12,Senate,"(S) Legislative Administration--Do Pass",6,0,0,0,6
1899738,1490383,2025-02-14,Senate,"(S) 2nd Reading Passed",40,10,0,0,50
1899738,1490711,2025-02-15,Senate,"(S) 3rd Reading Passed",43,5,0,2,50
1899738,1497935,2025-02-24,House,"(H) Legislative Administration--Be Concurred In",13,1,0,0,14
1899738,1525122,2025-03-24,House,"(H) 2nd Reading Motion to Amend Carried",88,11,0,1,100
1899738,1525123,2025-03-24,House,"(H) 2nd Reading Concurred as Amended",98,1,0,1,100
1899738,1527423,2025-03-26,House,"(H) 3rd Reading Concurred",99,0,0,1,100
1899738,1534424,2025-04-02,Senate,"(S) 2nd Reading House Amendments Concurred",32,17,0,1,50
1899738,1536460,2025-04-03,Senate,"(S) 3rd Reading Passed as Amended by House",44,6,0,0,50
1899740,1490087,2025-02-14,Senate,"(S) Business, Labor  and Economic Affairs--Do Pass As Amended",8,3,0,0,11
1899740,1524057,2025-03-21,Senate,"(S) 2nd Reading Passed",47,3,0,0,50
1899740,1526040,2025-03-25,Senate,"(S) Finance and Claims--Do Pass",20,2,0,0,22
1899740,1528983,2025-03-27,Senate,"(S) 3rd Reading Passed",38,12,0,0,50
1899740,1542027,2025-04-09,House,"(H) Business and Labor--Be Concurred In",20,0,0,0,20
1899740,1548274,2025-04-15,House,"(H) 2nd Reading Concurred",76,24,0,0,100
1899740,1549544,2025-04-16,House,"(H) Appropriations--Be Concurred In",14,9,0,0,23
1899740,1551760,2025-04-17,House,"(H) 3rd Reading Concurred",70,28,0,2,100
1899744,1481495,2025-01-24,Senate,"(S) Public Health, Welfare and Safety--Do Pass",11,0,0,0,11
1899744,1481496,2025-01-29,Senate,"(S) 2nd Reading Passed",50,0,0,0,50
1899744,1481497,2025-01-30,Senate,"(S) 3rd Reading Passed",49,0,0,1,50
1899744,1488835,2025-02-11,House,"(H) Human Services--Be Concurred In",21,0,0,0,21
1899744,1520135,2025-03-18,House,"(H) 2nd Reading Concurred",99,0,0,1,100
1899744,1521464,2025-03-19,House,"(H) 3rd Reading Concurred",98,0,0,2,100
1899746,1481498,2025-01-29,Senate,"(S) Public Health, Welfare and Safety--Do Pass",9,2,0,0,11
1899746,1481499,2025-02-03,Senate,"(S) 2nd Reading Passed",42,8,0,0,50
1899746,1481500,2025-02-04,Senate,"(S) 3rd Reading Passed",44,6,0,0,50
1899746,1492913,2025-02-18,House,"(H) Human Services--Be Concurred In",21,0,0,0,21
1899746,1521997,2025-03-19,House,"(H) 2nd Reading Concurred",79,21,0,0,100
1899746,1523049,2025-03-20,House,"(H) 3rd Reading Concurred",84,14,0,2,100
1899749,1481501,2025-01-23,Senate,"(S) Judiciary--Do Pass",9,0,0,0,9
1899749,1481502,2025-01-28,Senate,"(S) 2nd Reading Passed",39,11,0,0,50
1899749,1503337,2025-01-23,Senate,"(S) Judiciary--Do Pass",9,0,0,0,9
1899749,1503338,2025-03-03,Senate,"(S) Finance and Claims--To Table",22,0,0,0,22
1899755,1481503,2025-01-30,Senate,"(S) Agriculture, Livestock and Irrigation--Do Pass",11,0,0,0,11
1899755,1484051,2025-02-07,Senate,"(S) 2nd Reading Passed",44,5,0,1,50
1899755,1485102,2025-02-10,Senate,"(S) 3rd Reading Passed",47,2,0,1,50
1899755,1523121,2025-03-20,House,"(H) Agriculture--Be Concurred In",17,0,0,0,17
1899755,1530280,2025-03-28,House,"(H) 2nd Reading Concurred",100,0,0,0,100
1899755,1530701,2025-03-29,House,"(H) 3rd Reading Concurred",96,0,0,4,100
1899758,1481504,2025-01-31,Senate,"(S) State Administration--Do Pass",9,0,0,0,9
1899758,1484134,2025-02-07,Senate,"(S) 2nd Reading Passed",36,13,0,1,50
1899758,1485218,2025-01-31,Senate,"(S) State Administration--Do Pass",9,0,0,0,9
1899758,1485219,2025-02-10,Senate,"(S) 3rd Reading Passed",38,11,0,1,50
1899758,1538295,2025-04-07,House,"(H) Natural Resources--Be Concurred In As Amended",14,0,0,0,14
1899758,1545165,2025-04-10,House,"(H) 2nd Reading Concurred",100,0,0,0,100
1899758,1546209,2025-04-11,House,"(H) 3rd Reading Concurred",98,1,0,1,100
1899758,1549843,2025-04-16,Senate,"(S) 2nd Reading House Amendments Concurred",49,1,0,0,50
1899758,1551585,2025-04-17,Senate,"(S) 3rd Reading Passed as Amended by House",48,2,0,0,50
1899761,1481505,2025-01-23,Senate,"(S) Judiciary--",5,4,0,0,9
1899761,1481506,2025-01-27,Senate,"(S) Judiciary--Do Pass As Amended",9,0,0,0,9
1899761,1481507,2025-01-29,Senate,"(S) 2nd Reading Passed",48,2,0,0,50
1899761,1481508,2025-01-30,Senate,"(S) 3rd Reading Passed",47,2,0,1,50
1899761,1508750,2025-01-27,Senate,"(S) Judiciary--To Take From The Table",9,0,0,0,9
1899761,1527114,2025-03-25,House,"(H) Fish, Wildlife and Parks--Be Concurred In",20,0,0,0,20
1899761,1530336,2025-03-28,House,"(H) 2nd Reading Concurred",99,1,0,0,100
1899761,1530714,2025-03-29,House,"(H) 3rd Reading Concurred",95,1,0,4,100
1899761,1552181,2025-01-27,Senate,"(S) Judiciary--Do Pass As Amended",9,0,0,0,9
1899764,1481534,2025-01-16,House,"(H) Judiciary--Do Pass As Amended",68,12,0,0,80
1899764,1481538,2025-01-21,House,"(H) 2nd Reading Passed",68,31,0,1,100
1899764,1481539,2025-01-22,House,"(H) 3rd Reading Passed",73,27,0,0,100
1899764,1499874,2025-02-26,Senate,"(S) Judiciary--To Table",7,1,0,0,8
1899764,1530012,2025-02-26,Senate,"(S) Judiciary--To Table",7,1,0,0,8
1899764,1557312,2025-04-24,Senate,"(S) Motion Failed",23,27,0,0,50
1899764,1560154,2025-01-16,House,"(H) Judiciary--Do Pass As Amended",17,3,0,0,20
1899764,1560155,2025-04-29,Senate,"(S) Taken from Committee; Placed on 2nd Reading",26,24,0,0,50
1899764,1560914,2025-04-29,Senate,"(S) 2nd Reading Indefinitely Postponed",30,20,0,0,50
1899764,1560915,2025-04-29,Senate,"(S) 2nd Reading Pass Motion Failed",25,25,0,0,50
1899764,1561720,2025-02-26,Senate,"(S) Judiciary--To Table",7,1,0,0,8
1899769,1481540,2025-01-30,Senate,"(S) Agriculture, Livestock and Irrigation--Do Pass",11,0,0,0,11
1899769,1488904,2025-01-30,Senate,"(S) Agriculture, Livestock and Irrigation--Do Pass",11,0,0,0,11
1899769,1490709,2025-02-15,Senate,"(S) 2nd Reading Passed",49,0,0,1,50
1899769,1491956,2025-02-18,Senate,"(S) 3rd Reading Passed",48,2,0,0,50
1899769,1523225,2025-03-20,House,"(H) Agriculture--Be Concurred In",17,0,0,0,17
1899769,1526538,2025-03-25,House,"(H) 2nd Reading Concurred",100,0,0,0,100
1899769,1527911,2025-03-26,House,"(H) 3rd Reading Concurred",98,1,0,1,100
1899772,1481542,2025-02-05,Senate,"(S) 2nd Reading Motion to Amend Failed",20,30,0,0,50
1899772,1481543,2025-02-05,Senate,"(S) 2nd Reading Passed",32,18,0,0,50
1899772,1502224,2025-02-25,Senate,"(S) Finance and Claims--Do Pass As Amended",13,9,0,0,22
1899772,1508003,2025-03-06,Senate,"(S) 2nd Reading Passed",34,16,0,0,50
1899772,1508004,2025-03-06,Senate,"(S) 3rd Reading Passed",33,16,0,1,50
1899772,1548523,2025-04-15,House,"(H) Judiciary--Be Concurred In",12,8,0,0,20
1899772,1551447,2025-04-17,House,"(H) 2nd Reading Concurred",56,44,0,0,100
1899772,1552110,2025-04-18,House,"(H) 3rd Reading Concurred",58,40,0,2,100
1899774,1482839,2025-01-24,Senate,"(S) Legislative Administration--To Table",4,1,0,1,6
1899777,1503072,2025-03-01,Senate,"(S) Energy, Technology & Federal Relations--To Table",7,6,0,0,13
1899777,1504869,2025-03-04,Senate,"(S) Taken from Committee; Placed on 2nd Reading",27,23,0,0,50
1899777,1506683,2025-03-05,Senate,"(S) 2nd Reading Pass Motion Failed",24,26,0,0,50
1899777,1506684,2025-03-05,Senate,"(S) 2nd Reading Indefinitely Postponed",30,20,0,0,50
1899777,1506685,2025-03-05,Senate,"(S) Reconsidered Previous Action; Placed on 2nd Reading",27,23,0,0,50
1899777,1507575,2025-03-06,Senate,"(S) 2nd Reading Passed",27,23,0,0,50
1899777,1508033,2025-03-06,Senate,"(S) 3rd Reading Failed",22,27,0,1,50
1899780,1481545,2025-01-15,Senate,"(S) Natural Resources--Do Pass",11,0,0,0,11
1899780,1481546,2025-01-17,Senate,"(S) 2nd Reading Passed",48,2,0,0,50
1899780,1481547,2025-01-20,Senate,"(S) 3rd Reading Passed",48,1,0,1,50
1899780,1488945,2025-02-03,House,"(H) Natural Resources--Be Concurred In",14,0,0,0,14
1899780,1490366,2025-02-14,House,"(H) 2nd Reading Concurred",99,1,0,0,100
1899780,1492006,2025-02-18,House,"(H) 3rd Reading Concurred",98,1,0,1,100
1899784,1481548,2025-02-03,Senate,"(S) Judiciary--Do Pass",9,0,0,0,9
1899784,1481549,2025-02-05,Senate,"(S) 2nd Reading Passed",46,4,0,0,50
1899784,1483759,2025-02-06,Senate,"(S) 3rd Reading Passed",46,3,0,1,50
1899784,1542198,2025-04-09,House,"(H) Judiciary--Be Concurred In As Amended",20,0,0,0,20
1899784,1544403,2025-04-10,House,"(H) Appropriations--To Table",14,9,0,0,23
1899786,1482354,2025-01-24,Senate,"(S) Public Health, Welfare and Safety--To Table",11,0,0,0,11
1899786,1482355,2025-02-05,Senate,"(S) Public Health, Welfare and Safety--Do Pass",30,3,0,0,33
1899786,1484530,2025-02-05,Senate,"(S) Public Health, Welfare and Safety--Do Pass As Amended",10,1,0,0,11
1899786,1484675,2025-02-05,Senate,"(S) Public Health, Welfare and Safety--Do Pass As Amended",10,1,0,0,11
1899786,1485215,2025-02-10,Senate,"(S) 2nd Reading Passed",44,6,0,0,50
1899786,1495964,2025-02-20,Senate,"(S) Finance and Claims--Do Pass",16,6,0,0,22
1899786,1497860,2025-02-24,Senate,"(S) 3rd Reading Passed",44,5,0,1,50
1899786,1527941,2025-03-26,House,"(H) 2nd Reading Concurred",71,29,0,0,100
1899786,1530342,2025-03-28,House,"(H) Appropriations--Be Concurred In As Amended",22,0,0,1,23
1899786,1540116,2025-04-08,House,"(H) 2nd Reading Concurred",80,18,0,2,100
1899786,1541529,2025-04-09,House,"(H) 3rd Reading Concurred",72,24,0,4,100
1899786,1545545,2025-04-11,Senate,"(S) 2nd Reading House Amendments Concurred",50,0,0,0,50
1899786,1546600,2025-04-12,Senate,"(S) 3rd Reading Passed as Amended by House",45,5,0,0,50
1899789,1481554,2025-01-16,House,"(H) Judiciary--Do Pass",460,0,0,0,460
1899789,1481578,2025-01-20,House,"(H) 2nd Reading Passed",96,3,0,1,100
1899789,1481579,2025-01-29,House,"(H) Appropriations--Do Pass",17,6,0,0,23
1899789,1481580,2025-01-31,House,"(H) 3rd Reading Passed",96,3,0,1,100
1899789,1530183,2025-03-28,Senate,"(S) Judiciary--Be Concurred In As Amended",8,0,0,0,8
1899789,1532709,2025-04-01,Senate,"(S) 2nd Reading Concurred",48,2,0,0,50
1899789,1546838,2025-04-14,Senate,"(S) Finance and Claims--Be Concurred In As Amended",22,0,0,0,22
1899789,1549164,2025-01-29,House,"(H) Appropriations--Do Pass",17,6,0,0,23
1899789,1549165,2025-04-15,Senate,"(S) 2nd Reading Concurred",50,0,0,0,50
1899789,1550428,2025-04-16,Senate,"(S) 3rd Reading Concurred",50,0,0,0,50
1899789,1552284,2025-04-18,House,"(H) 2nd Reading Senate Amendments Not Concurred",37,62,0,1,100
1899789,1560951,2025-01-16,House,"(H) Judiciary--Do Pass",20,0,0,0,20
1899789,1560952,2025-04-29,Senate,"(S) 2nd Reading Free Conference Committee Report Adopted",47,2,0,1,50
1899789,1560953,2025-04-29,House,"(H) 2nd Reading Free Conference Committee Report Adopted",100,0,0,0,100
1899789,1562738,2025-04-30,House,"(H) 3rd Reading Free Conference Committee Report Adopted",100,0,0,0,100
1899789,1562739,2025-04-30,Senate,"(S) 3rd Reading Free Conference Committee Report Adopted",45,5,0,0,50
1899791,1481581,2025-01-29,Senate,"(S) Judiciary--Do Pass",9,0,0,0,9
1899791,1481582,2025-02-03,Senate,"(S) 2nd Reading Passed",50,0,0,0,50
1899791,1481583,2025-02-04,Senate,"(S) 3rd Reading Passed",50,0,0,0,50
1899791,1539455,2025-04-08,House,"(H) Judiciary--Be Concurred In",20,0,0,0,20
1899791,1543357,2025-04-10,House,"(H) 2nd Reading Motion to Amend Carried",86,14,0,0,100
1899791,1543358,2025-04-10,House,"(H) 2nd Reading Concurred as Amended",98,2,0,0,100
1899791,1546253,2025-04-11,House,"(H) 3rd Reading Concurred",97,2,0,1,100
1899791,1549839,2025-04-16,Senate,"(S) 2nd Reading House Amendments Concurred",49,0,0,1,50
1899791,1551599,2025-04-17,Senate,"(S) 3rd Reading Passed as Amended by House",50,0,0,0,50
1899794,1483322,2025-02-06,Senate,"(S) 2nd Reading Passed",41,9,0,0,50
1899794,1484217,2025-02-07,Senate,"(S) 3rd Reading Passed",35,14,0,1,50
1899794,1484527,2025-01-31,Senate,"(S) Business, Labor  and Economic Affairs--Do Pass",9,2,0,0,11
1899794,1491767,2025-02-18,House,"(H) Business and Labor--To Table",20,0,0,0,20
1899794,1515664,2025-02-19,House,"(H) Business and Labor--To Take From The Table",9,5,0,6,20
1899794,1526210,2025-03-25,House,"(H) Business and Labor--Be Concurred In",12,8,0,0,20
1899794,1542458,2025-02-18,House,"(H) Business and Labor--To Table",20,0,0,0,20
1899794,1542459,2025-02-19,House,"(H) Business and Labor--To Take From The Table",9,5,6,0,20
1899794,1557314,2025-04-24,House,"(H) 2nd Reading Concurred",60,40,0,0,100
1899794,1558170,2025-04-25,House,"(H) 3rd Reading Concurred",65,35,0,0,100
1899794,1586777,2025-02-19,House,"(H) Business and Labor--To Take From The Table",9,5,6,0,20
1899797,1481585,2025-01-24,Senate,"(S) Public Health, Welfare and Safety--Do Pass",11,0,0,0,11
1899797,1481586,2025-01-29,Senate,"(S) 2nd Reading Passed",50,0,0,0,50
1899797,1481587,2025-01-30,Senate,"(S) 3rd Reading Passed",48,1,0,1,50
1899797,1495600,2025-02-13,House,"(H) Human Services--Be Concurred In",21,0,0,0,21
1899797,1519744,2025-03-18,House,"(H) 2nd Reading Concurred",99,0,0,1,100
1899797,1521130,2025-03-19,House,"(H) 3rd Reading Concurred",98,0,0,2,100
1899797,1556910,2025-02-13,House,"(H) Human Services--Be Concurred In",21,0,0,0,21
1899801,1481588,2025-01-30,Senate,"(S) Agriculture, Livestock and Irrigation--Do Pass",11,0,0,0,11
1899801,1481589,2025-02-04,Senate,"(S) 2nd Reading Passed",50,0,0,0,50
1899801,1482596,2025-02-05,Senate,"(S) 3rd Reading Passed",48,0,0,2,50
1899801,1523158,2025-03-20,House,"(H) Agriculture--Be Concurred In",17,0,0,0,17
1899801,1529262,2025-03-27,House,"(H) 2nd Reading Concurred",98,0,0,2,100
1899801,1529949,2025-03-28,House,"(H) 3rd Reading Concurred",99,0,0,1,100
1899803,1592190,2025-03-03,Senate,"(S) 2nd Reading Motion to Amend Carried",50,0,0,0,50
1899803,1592191,2025-03-03,Senate,"(S) 2nd Reading Passed as Amended",37,13,0,0,50
1899803,1592192,2025-03-05,Senate,"(S) 3rd Reading Passed",40,9,0,1,50
1899803,1592193,2025-01-21,Senate,"(S) Energy, Technology & Federal Relations--Do Pass",9,4,0,0,13
1899803,1592194,2025-03-31,House,"(H) Transportation--Be Concurred In",14,0,0,0,14
1899803,1592195,2025-04-09,House,"(H) Appropriations--Be Concurred In",21,0,2,0,23
1899803,1592196,2025-04-11,House,"(H) 2nd Reading Concurred",94,6,0,0,100
1899803,1592197,2025-04-11,House,"(H) 3rd Reading Concurred",93,6,0,1,100
1899807,1481590,2025-01-24,Senate,"(S) Public Health, Welfare and Safety--Do Pass",10,1,0,0,11
1899807,1481591,2025-01-29,Senate,"(S) 2nd Reading Passed",49,1,0,0,50
1899807,1481592,2025-01-30,Senate,"(S) 3rd Reading Passed",49,0,0,1,50
1899807,1495630,2025-02-13,House,"(H) Human Services--Be Concurred In",21,0,0,0,21
1899807,1522871,2025-03-20,House,"(H) 2nd Reading Concurred",95,3,0,2,100
1899807,1524070,2025-03-21,House,"(H) 3rd Reading Concurred",97,0,0,3,100
1899807,1557189,2025-02-13,House,"(H) Human Services--Be Concurred In",21,0,0,0,21
1902004,1481593,2025-01-31,Senate,"(S) State Administration--Do Pass As Amended",5,4,0,0,9
1902004,1493546,2025-02-19,Senate,"(S) 2nd Reading Pass Motion Failed",21,29,0,0,50
1902004,1493547,2025-02-19,Senate,"(S) 2nd Reading Indefinitely Postponed",31,19,0,0,50
1902082,1481594,2025-01-22,Senate,"(S) Judiciary--Do Pass",6,3,0,0,9
1902082,1481595,2025-01-23,Senate,"(S) 2nd Reading Passed",32,18,0,0,50
1902082,1481596,2025-01-24,Senate,"(S) 3rd Reading Passed",31,18,0,1,50
1902082,1539677,2025-04-08,House,"(H) Judiciary--Be Concurred In",11,9,0,0,20
1902082,1543603,2025-04-10,House,"(H) 2nd Reading Not Concurred",43,57,0,0,100
1902172,1481597,2025-01-29,Senate,"(S) Taxation--Do Pass",8,0,0,0,8
1902172,1481598,2025-01-31,Senate,"(S) 2nd Reading Passed",48,2,0,0,50
1902172,1481599,2025-02-03,Senate,"(S) 3rd Reading Passed",46,3,0,1,50
1902172,1491923,2025-02-18,House,"(H) Taxation--To Table",21,0,0,0,21
1902172,1529941,2025-03-19,House,"(H) Taxation--To Table",21,0,0,0,21
1902172,1544137,2025-03-19,House,"(H) Taxation--To Table",21,0,0,0,21
1902172,1551548,2025-04-17,House,"(H) Taxation--Be Concurred In As Amended",13,8,0,0,21
1902172,1551549,2025-04-17,House,"(H) Taxation--To Take From The Table",14,3,4,0,21
1902172,1553605,2025-04-22,House,"(H) 2nd Reading Concurred",88,10,0,2,100
1902172,1555422,2025-04-23,House,"(H) Appropriations--Be Concurred In",22,0,1,0,23
1902172,1557324,2025-04-24,House,"(H) 3rd Reading Concurred",93,7,0,0,100
1902172,1559198,2025-04-28,Senate,"(S) 2nd Reading House Amendments Concurred",50,0,0,0,50
1902172,1560094,2025-04-29,Senate,"(S) 3rd Reading Passed as Amended by House",50,0,0,0,50
1902255,1481601,2025-01-17,House,"(H) Education--Do Pass As Amended",15,0,0,0,15
1902255,1481602,2025-01-23,House,"(H) 2nd Reading Passed",99,0,0,1,100
1902255,1481603,2025-01-24,House,"(H) 3rd Reading Passed",98,0,0,2,100
1902255,1488161,2025-02-04,Senate,"(S) Education and Cultural Resources--Be Concurred In",12,2,0,0,14
1902255,1518247,2025-03-15,Senate,"(S) 2nd Reading Concurred",49,1,0,0,50
1902255,1518859,2025-03-17,Senate,"(S) 3rd Reading Concurred",48,1,0,1,50
1902941,1481604,2025-01-22,Senate,"(S) Judiciary--Do Pass",6,3,0,0,9
1902941,1481605,2025-01-30,Senate,"(S) 2nd Reading Passed",31,19,0,0,50
1902941,1481606,2025-01-31,Senate,"(S) 3rd Reading Passed",32,18,0,0,50
1902941,1539734,2025-04-08,House,"(H) Judiciary--Be Concurred In",12,8,0,0,20
1902941,1544755,2025-04-10,House,"(H) 2nd Reading Concurred",56,44,0,0,100
1902941,1546393,2025-04-11,House,"(H) 3rd Reading Concurred",57,42,0,1,100
1902972,1490929,2025-02-14,Senate,"(S) Public Health, Welfare and Safety--To Table",7,4,0,0,11
1902972,1502769,2025-02-28,Senate,"(S) Public Health, Welfare and Safety--Do Pass As Amended",7,4,0,0,11
1902972,1504405,2025-03-04,Senate,"(S) 2nd Reading Passed",43,7,0,0,50
1902972,1523129,2025-03-20,Senate,"(S) Finance and Claims--Do Pass",12,10,0,0,22
1902972,1524131,2025-03-21,Senate,"(S) 3rd Reading Passed",39,11,0,0,50
1902972,1538300,2025-04-07,House,"(H) Human Services--Be Concurred In",21,0,0,0,21
1902972,1547220,2025-04-14,House,"(H) 2nd Reading Concurred",94,6,0,0,100
1902972,1548217,2025-04-15,House,"(H) Appropriations--Be Concurred In",13,10,0,0,23
1902972,1551733,2025-04-17,House,"(H) 3rd Reading Concurred",90,6,0,4,100
1903008,1481607,2025-01-21,House,"(H) Agriculture--Do Pass As Amended",10,7,0,0,17
1903008,1481608,2025-01-28,House,"(H) 2nd Reading Passed",59,41,0,0,100
1903008,1481609,2025-02-04,House,"(H) Appropriations--Do Pass",13,10,0,0,23
1903008,1483514,2025-02-06,House,"(H) 3rd Reading Passed",52,47,0,1,100
1903008,1533577,2025-04-01,Senate,"(S) Agriculture, Livestock and Irrigation--To Table",7,4,0,0,11
1903008,1536656,2025-04-01,Senate,"(S) Agriculture, Livestock and Irrigation--To Table",7,4,0,0,11
1903041,1481610,2025-01-27,Senate,"(S) Local Government--Do Pass",8,3,0,0,11
1903041,1481611,2025-01-30,Senate,"(S) 2nd Reading Passed",39,11,0,0,50
1903041,1481612,2025-01-31,Senate,"(S) 3rd Reading Passed",40,10,0,0,50
1903041,1488632,2025-01-27,Senate,"(S) Local Government--Do Pass",8,3,0,0,11
1903041,1523247,2025-03-20,House,"(H) Local Government--To Table",17,0,0,0,17
1903041,1530030,2025-03-20,House,"(H) Local Government--To Table",17,0,0,0,17
1903041,1586576,2025-03-20,House,"(H) Local Government--To Table",17,0,0,0,17
1903081,1481613,2025-01-17,House,"(H) State Administration--Do Pass",19,0,0,0,19
1903081,1481614,2025-01-21,House,"(H) 2nd Reading Passed",99,0,0,1,100
1903081,1481615,2025-01-22,House,"(H) 3rd Reading Passed",99,0,0,1,100
1903081,1592175,2025-03-19,Senate,"(S) State Administration--Be Concurred In",9,0,0,0,9
1903081,1592176,2025-03-24,Senate,"(S) 2nd Reading Concurred",45,5,0,0,50
1903081,1592177,2025-03-25,Senate,"(S) 3rd Reading Concurred",44,6,0,0,50
1903111,1481616,2025-01-22,Senate,"(S) Judiciary--Do Pass",6,3,0,0,9
1903111,1481617,2025-01-23,Senate,"(S) 2nd Reading Passed",35,15,0,0,50
1903111,1481618,2025-01-24,Senate,"(S) 3rd Reading Passed",35,14,0,1,50
1903111,1524067,2025-03-21,House,"(H) Business and Labor--Be Concurred In As Amended",13,7,0,0,20
1903111,1527454,2025-03-26,House,"(H) 2nd Reading Concurred",58,42,0,0,100
1903111,1529013,2025-03-27,House,"(H) 3rd Reading Concurred",58,41,0,1,100
1903111,1531064,2025-03-31,Senate,"(S) 2nd Reading House Amendments Concurred",37,13,0,0,50
1903111,1533264,2025-04-01,Senate,"(S) 3rd Reading Passed as Amended by House",35,15,0,0,50
1903149,1481624,2025-01-13,House,"(H) Judiciary--Do Pass",12,8,0,0,20
1903149,1481625,2025-01-16,House,"(H) 3rd Reading Passed",58,41,0,1,100
1903149,1481626,2025-01-15,House,"(H) 2nd Reading Passed",58,42,0,0,100
1903149,1484525,2025-02-05,Senate,"(S) Judiciary--Be Concurred In",6,3,0,0,9
1903149,1484775,2025-02-10,Senate,"(S) 2nd Reading Motion to Amend Failed",22,28,0,0,50
1903149,1484776,2025-02-10,Senate,"(S) 2nd Reading Concurred",32,18,0,0,50
1903149,1485635,2025-01-13,House,"(H) Judiciary--Do Pass",12,8,0,0,20
1903149,1486495,2025-02-11,Senate,"(S) 3rd Reading Concurred",32,18,0,0,50
1903182,1490530,2025-02-14,Senate,"(S) Public Health, Welfare and Safety--Do Pass As Amended",7,4,0,0,11
1903182,1490692,2025-02-14,Senate,"(S) Public Health, Welfare and Safety--Do Pass As Amended",7,4,0,0,11
1903182,1493861,2025-02-19,Senate,"(S) 2nd Reading Passed",32,18,0,0,50
1903182,1499746,2025-02-26,Senate,"(S) Finance and Claims--Do Pass",11,11,0,0,22
1903182,1502211,2025-02-26,Senate,"(S) Finance and Claims--To Table",16,6,0,0,22
1903255,1481627,2025-01-27,Senate,"(S) Local Government--Do Pass As Amended",7,4,0,0,11
1903255,1481628,2025-01-30,Senate,"(S) 2nd Reading Passed",30,20,0,0,50
1903255,1481629,2025-01-31,Senate,"(S) 3rd Reading Passed",27,23,0,0,50
1903255,1485844,2025-01-27,Senate,"(S) Local Government--Do Pass As Amended",7,4,0,0,11
1903255,1491810,2025-02-18,House,"(H) Taxation--To Table",21,0,0,0,21
1903255,1529983,2025-02-18,House,"(H) Taxation--To Table",21,0,0,0,21
1903289,1482825,2025-01-22,Senate,"(S) Local Government--To Table",11,0,0,0,11
1903434,1481630,2025-01-27,Senate,"(S) Local Government--Do Pass",10,1,0,0,11
1903434,1481631,2025-01-30,Senate,"(S) 2nd Reading Passed",43,7,0,0,50
1903434,1481632,2025-01-31,Senate,"(S) 3rd Reading Passed",47,3,0,0,50
1903434,1523320,2025-03-20,House,"(H) Local Government--Be Concurred In As Amended",17,0,0,0,17
1903434,1549265,2025-04-15,House,"(H) 2nd Reading Concurred",97,3,0,0,100
1903434,1550612,2025-04-16,House,"(H) 3rd Reading Concurred",97,1,0,2,100
1903434,1552244,2025-04-18,Senate,"(S) 2nd Reading House Amendments Concurred",49,0,0,1,50
1903434,1554840,2025-04-22,Senate,"(S) 3rd Reading Passed as Amended by House",47,3,0,0,50
1903521,1481633,2025-01-16,House,"(H) Business and Labor--Do Pass As Amended",19,1,0,0,20
1903521,1481634,2025-01-21,House,"(H) 2nd Reading Passed",86,13,0,1,100
1903521,1481635,2025-01-22,House,"(H) 3rd Reading Passed",89,11,0,0,100
1903521,1521222,2025-03-19,Senate,"(S) Business, Labor  and Economic Affairs--To Table",10,2,0,0,12
1903521,1530122,2025-03-19,Senate,"(S) Business, Labor  and Economic Affairs--To Table",10,2,0,0,12
1903521,1534481,2025-04-02,Senate,"(S) Business, Labor  and Economic Affairs--Be Concurred In",7,4,0,0,11
1903521,1539765,2025-04-08,Senate,"(S) 2nd Reading Concurred",29,20,0,1,50
1903521,1542212,2025-04-09,Senate,"(S) 3rd Reading Concurred",26,22,0,2,50
1903521,1556439,2025-03-19,Senate,"(S) Business, Labor  and Economic Affairs--To Table",10,2,0,0,12
1903608,1481636,2025-01-22,House,"(H) Energy, Technology and Federal Relations--Do Pass As Amended",9,5,0,0,14
1903608,1481637,2025-01-28,House,"(H) 2nd Reading Passed",70,30,0,0,100
1903608,1481638,2025-01-29,House,"(H) 3rd Reading Passed",76,24,0,0,100
1903608,1528197,2025-03-25,Senate,"(S) Energy, Technology & Federal Relations--Be Concurred In",13,0,0,0,13
1903608,1530765,2025-03-25,Senate,"(S) Energy, Technology & Federal Relations--Be Concurred In",9,4,0,0,13
1903608,1538581,2025-04-07,Senate,"(S) 2nd Reading Concurred",27,23,0,0,50
1903608,1540610,2025-04-08,Senate,"(S) 3rd Reading Concurred",31,17,0,2,50
1903768,1481639,2025-01-21,House,"(H) State Administration--Do Pass",19,0,0,0,19
1903768,1481640,2025-01-24,House,"(H) 2nd Reading Passed",100,0,0,0,100
1903768,1481641,2025-01-27,House,"(H) 3rd Reading Passed",98,0,0,2,100
1903768,1521941,2025-03-19,Senate,"(S) State Administration--Be Concurred In",9,0,0,0,9
1903768,1546578,2025-04-12,Senate,"(S) 2nd Reading Concurred",49,0,0,1,50
1903768,1546943,2025-04-14,Senate,"(S) 3rd Reading Concurred",47,0,0,3,50
1904353,1497480,2025-02-24,Senate,"(S) Business, Labor  and Economic Affairs--Do Pass",11,1,0,0,12
1904353,1499318,2025-02-25,Senate,"(S) 2nd Reading Passed",37,13,0,0,50
1904353,1502635,2025-02-28,Senate,"(S) 3rd Reading Passed",38,11,0,1,50
1904353,1521005,2025-03-19,House,"(H) Business and Labor--Be Concurred In",20,0,0,0,20
1904353,1526609,2025-03-25,House,"(H) 2nd Reading Concurred",88,12,0,0,100
1904353,1529421,2025-03-27,House,"(H) Appropriations--Be Concurred In",18,5,0,0,23
1904353,1531053,2025-03-31,House,"(H) 3rd Reading Concurred",86,13,0,1,100
1904404,1481645,2025-01-31,House,"(H) 2nd Reading Passed",96,3,0,1,100
1904404,1481646,2025-02-03,House,"(H) 3rd Reading Passed",97,2,0,1,100
1904404,1528532,2025-03-26,Senate,"(S) Business, Labor  and Economic Affairs--Be Concurred In",10,2,0,0,12
1904404,1530845,2025-03-31,Senate,"(S) 2nd Reading Concurred",36,14,0,0,50
1904404,1532853,2025-04-01,Senate,"(S) 3rd Reading Concurred",35,15,0,0,50
1904453,1496781,2025-02-21,Senate,"(S) State Administration--Do Pass",7,2,0,0,9
1904453,1499161,2025-02-25,Senate,"(S) 2nd Reading Passed",28,22,0,0,50
1904453,1500296,2025-02-26,Senate,"(S) 3rd Reading Passed",28,22,0,0,50
1904453,1528832,2025-03-27,House,"(H) State Administration--Be Concurred In As Amended",19,0,0,0,19
1904453,1530723,2025-03-29,House,"(H) 2nd Reading Concurred",90,10,0,0,100
1904453,1531112,2025-03-31,House,"(H) 3rd Reading Concurred",77,21,0,2,100
1904453,1536356,2025-04-03,Senate,"(S) 2nd Reading House Amendments Concurred",44,6,0,0,50
1904453,1537120,2025-04-04,Senate,"(S) 3rd Reading Passed as Amended by House",36,13,0,1,50
1904503,1482535,2025-01-24,House,"(H) Taxation--To Table",21,0,0,0,21
1904554,1481647,2025-01-23,Senate,"(S) Education and Cultural Resources--",14,0,0,0,14
1904554,1481648,2025-01-27,Senate,"(S) 2nd Reading Passed",49,1,0,0,50
1904554,1481649,2025-01-28,Senate,"(S) 3rd Reading Passed",49,1,0,0,50
1904554,1489199,2025-02-07,House,"(H) Education--Be Concurred In",15,0,0,0,15
1904554,1490456,2025-02-14,House,"(H) 2nd Reading Concurred",91,9,0,0,100
1904554,1492309,2025-02-18,House,"(H) 3rd Reading Concurred",89,10,0,1,100
1904601,1481652,2025-02-05,House,"(H) 2nd Reading Motion to Amend Carried",69,31,0,0,100
1904601,1481653,2025-02-05,House,"(H) 2nd Reading Passed as Amended",56,44,0,0,100
1904601,1496904,2025-02-21,House,"(H) Appropriations--To Table",18,5,0,0,23
1904649,1481655,2025-01-28,House,"(H) 2nd Reading Passed",100,0,0,0,100
1904649,1481656,2025-01-29,House,"(H) 3rd Reading Passed",100,0,0,0,100
1904649,1482982,2025-01-23,House,"(H) State Administration--Do Pass As Amended",19,0,0,0,19
1904649,1536752,2025-04-03,Senate,"(S) Legislative Administration--Be Concurred In",5,1,0,0,6
1904649,1540476,2025-04-08,Senate,"(S) 2nd Reading Concurred",48,1,0,1,50
1904649,1542457,2025-04-09,Senate,"(S) 3rd Reading Concurred",48,0,0,2,50
1904695,1481657,2025-01-22,House,"(H) Natural Resources--Do Pass",14,0,0,0,14
1904695,1481658,2025-01-27,House,"(H) 2nd Reading Motion to Amend Carried",100,0,0,0,100
1904695,1481659,2025-01-27,House,"(H) 2nd Reading Passed as Amended",100,0,0,0,100
1904695,1481660,2025-01-29,House,"(H) 3rd Reading Passed",99,1,0,0,100
1904695,1537293,2025-04-04,Senate,"(S) Natural Resources--Be Concurred In",11,0,0,0,11
1904695,1540052,2025-04-08,Senate,"(S) 2nd Reading Concurred",50,0,0,0,50
1904695,1541501,2025-04-09,Senate,"(S) 3rd Reading Concurred",47,1,0,2,50
1904744,1481661,2025-01-17,House,"(H) Natural Resources--Do Pass",14,0,0,0,14
1904744,1481662,2025-01-23,House,"(H) 2nd Reading Passed",99,1,0,0,100
1904744,1481663,2025-01-24,House,"(H) 3rd Reading Passed",96,1,0,3,100
1904744,1488173,2025-02-10,Senate,"(S) Natural Resources--Be Concurred In",9,2,0,0,11
1904744,1532236,2025-04-01,Senate,"(S) 2nd Reading Concurred",35,15,0,0,50
1904744,1534382,2025-04-02,Senate,"(S) 3rd Reading Concurred",36,14,0,0,50
1904789,1481664,2025-01-17,House,"(H) Taxation--Do Pass",21,0,0,0,21
1904789,1481665,2025-01-28,House,"(H) 2nd Reading Passed",98,2,0,0,100
1904789,1481666,2025-02-03,House,"(H) Appropriations--Do Pass",23,0,0,0,23
1904789,1481667,2025-02-05,House,"(H) 3rd Reading Passed",96,4,0,0,100
1904789,1549658,2025-04-16,Senate,"(S) Taxation--Be Concurred In",5,3,0,0,8
1904789,1551387,2025-04-17,Senate,"(S) 2nd Reading Concurred",32,18,0,0,50
1904789,1555290,2025-04-23,Senate,"(S) Taken from Committee; Placed on 2nd Reading",26,23,0,1,50
1904789,1555291,2025-04-23,Senate,"(S) Motion Carried",28,22,0,0,50
1904789,1555864,2025-04-23,Senate,"(S) Taken from Committee; Placed on 2nd Reading",26,23,0,1,50
1904789,1555865,2025-04-23,Senate,"(S) Motion Carried",28,22,0,0,50
1904789,1557141,2025-04-24,Senate,"(S) 3rd Reading Concurred",32,18,0,0,50
1905406,1481668,2025-01-17,House,"(H) Business and Labor--Do Pass As Amended",20,0,0,0,20
1905406,1481669,2025-01-24,House,"(H) 2nd Reading Passed",99,1,0,0,100
1905406,1481670,2025-01-27,House,"(H) 3rd Reading Passed",96,2,0,2,100
1905406,1521635,2025-03-19,Senate,"(S) Business, Labor  and Economic Affairs--Be Concurred In",11,0,0,1,12
1905406,1548578,2025-04-15,Senate,"(S) 2nd Reading Concurred as Amended",50,0,0,0,50
1905406,1548579,2025-04-15,Senate,"(S) 2nd Reading Motion to Amend Carried",50,0,0,0,50
1905406,1549994,2025-04-16,Senate,"(S) 3rd Reading Concurred",50,0,0,0,50
1905406,1552210,2025-04-18,House,"(H) 2nd Reading Senate Amendments Concurred",97,2,0,1,100
1905406,1553261,2025-04-22,House,"(H) 3rd Reading Passed as Amended by Senate",95,4,0,1,100
1905491,1497044,2025-01-30,House,"(H) Fish, Wildlife and Parks--To Table",20,0,0,0,20
1905580,1481672,2025-01-22,House,"(H) 2nd Reading Passed",99,1,0,0,100
1905580,1481673,2025-01-23,House,"(H) 3rd Reading Passed",99,1,0,0,100
1905580,1481674,2025-01-17,House,"(H) Business and Labor--Do Pass",20,0,0,0,20
1905580,1489061,2025-01-17,House,"(H) Business and Labor--Do Pass",20,0,0,0,20
1905580,1489062,2025-02-05,Senate,"(S) Business, Labor  and Economic Affairs--Be Concurred In As Amended",11,0,0,0,11
1905580,1518256,2025-03-15,Senate,"(S) 2nd Reading Concurred",48,1,0,1,50
1905580,1518465,2025-03-17,Senate,"(S) 3rd Reading Concurred",48,1,0,1,50
1905580,1522682,2025-03-20,House,"(H) 2nd Reading Senate Amendments Concurred",98,2,0,0,100
1905580,1524192,2025-03-21,House,"(H) 3rd Reading Passed as Amended by Senate",97,0,0,3,100
1905667,1481675,2025-01-21,House,"(H) Business and Labor--Do Pass As Amended",40,0,0,0,40
1905667,1481677,2025-01-24,House,"(H) 2nd Reading Passed",100,0,0,0,100
1905667,1481678,2025-01-27,House,"(H) 3rd Reading Passed",97,1,0,2,100
1905667,1523285,2025-03-20,Senate,"(S) Judiciary--Be Concurred In",5,3,0,0,8
1905667,1528357,2025-01-21,House,"(H) Business and Labor--Do Pass As Amended",20,0,0,0,20
1905667,1528358,2025-03-26,Senate,"(S) 2nd Reading Concurred",43,7,0,0,50
1905667,1528986,2025-03-27,Senate,"(S) 3rd Reading Concurred",44,6,0,0,50
1905752,1498061,2025-02-24,Senate,"(S) Natural Resources--Do Pass",11,0,0,0,11
1905752,1501496,2025-02-27,Senate,"(S) 2nd Reading Passed",50,0,0,0,50
1905752,1502357,2025-02-28,Senate,"(S) 3rd Reading Passed",49,0,0,1,50
1905752,1541089,2025-04-08,House,"(H) Fish, Wildlife and Parks--Be Concurred In As Amended",19,1,0,0,20
1905752,1545508,2025-04-11,House,"(H) 2nd Reading Concurred",97,3,0,0,100
1905752,1546118,2025-04-11,House,"(H) 3rd Reading Concurred",98,1,0,1,100
1905752,1546995,2025-04-14,Senate,"(S) 2nd Reading House Amendments Concurred",48,0,0,2,50
1905752,1548524,2025-04-15,Senate,"(S) 3rd Reading Passed as Amended by House",48,2,0,0,50
1905840,1481679,2025-01-22,Senate,"(S) Judiciary--Do Pass",8,1,0,0,9
1905840,1481680,2025-01-28,Senate,"(S) 2nd Reading Motion to Amend Failed",20,30,0,0,50
1905840,1481681,2025-01-28,Senate,"(S) 2nd Reading Passed",44,6,0,0,50
1905840,1481682,2025-01-29,Senate,"(S) 3rd Reading Passed",42,7,0,1,50
1905840,1530337,2025-03-28,House,"(H) Education--Be Concurred In",15,0,0,0,15
1905840,1543796,2025-04-10,House,"(H) 2nd Reading Concurred",96,4,0,0,100
1905840,1546035,2025-04-11,House,"(H) 3rd Reading Concurred",90,9,0,1,100
1906009,1482853,2025-01-22,House,"(H) Education--To Table",15,0,0,0,15
1906009,1575853,2025-01-22,House,"(H) Education--To Table",15,0,0,0,15
1907234,1481683,2025-01-20,House,"(H) Legislative Administration--Do Pass",8,6,0,0,14
1907234,1481684,2025-01-24,House,"(H) 2nd Reading Passed",53,47,0,0,100
1907234,1481685,2025-01-27,House,"(H) 3rd Reading Passed",54,44,0,2,100
1907234,1493663,2025-02-19,Senate,"(S) Legislative Administration--Be Concurred In",4,2,0,0,6
1907234,1529161,2025-03-27,Senate,"(S) 2nd Reading Concurred",32,18,0,0,50
1907234,1530074,2025-03-28,Senate,"(S) 3rd Reading Concurred",32,16,0,2,50
1907261,1481686,2025-02-03,Senate,"(S) Local Government--Do Pass As Amended",8,3,0,0,11
1907261,1484263,2025-02-07,Senate,"(S) 2nd Reading Passed",31,18,0,1,50
1907261,1485304,2025-02-10,Senate,"(S) 3rd Reading Passed",33,16,0,1,50
1907261,1493837,2025-02-19,House,"(H) Taxation--To Table",21,0,0,0,21
1907261,1530126,2025-02-19,House,"(H) Taxation--To Table",21,0,0,0,21
1907295,1497045,2025-01-24,House,"(H) Taxation--Do Pass As Amended",20,1,0,0,21
1907295,1497046,2025-01-30,House,"(H) 2nd Reading Passed",98,2,0,0,100
1907295,1497047,2025-01-31,House,"(H) 3rd Reading Passed",97,2,0,1,100
1907295,1549589,2025-04-16,Senate,"(S) Taxation--Be Concurred In",8,0,0,0,8
1907295,1552073,2025-04-18,Senate,"(S) 2nd Reading Concurred",46,3,0,1,50
1907295,1553935,2025-04-22,Senate,"(S) 3rd Reading Concurred",45,5,0,0,50
1907327,1481689,2025-02-05,Senate,"(S) Business, Labor  and Economic Affairs--Do Pass As Amended",7,4,0,0,11
1907327,1484363,2025-02-07,Senate,"(S) 2nd Reading Passed",32,17,0,1,50
1907327,1485531,2025-02-10,Senate,"(S) 3rd Reading Passed",33,16,0,1,50
1907327,1499942,2025-02-26,House,"(H) Business and Labor--Be Concurred In",19,1,0,0,20
1907327,1525477,2025-03-24,House,"(H) 2nd Reading Concurred",92,7,0,1,100
1907327,1527019,2025-03-25,House,"(H) 3rd Reading Concurred",94,5,0,1,100
1907367,1481690,2025-01-21,House,"(H) Business and Labor--Do Pass",40,0,0,0,40
1907367,1481692,2025-01-24,House,"(H) 2nd Reading Passed",96,4,0,0,100
1907367,1481693,2025-01-27,House,"(H) 3rd Reading Passed",94,4,0,2,100
1907367,1521232,2025-03-19,Senate,"(S) Business, Labor  and Economic Affairs--To Table",11,0,0,1,12
1907367,1529870,2025-03-28,Senate,"(S) Business, Labor  and Economic Affairs--Be Concurred In",8,4,0,0,12
1907367,1535269,2025-03-26,Senate,"(S) Business, Labor  and Economic Affairs--To Take From The Table",6,3,3,0,12
1907367,1536544,2025-03-19,Senate,"(S) Business, Labor  and Economic Affairs--To Table",11,0,1,0,12
1907367,1539654,2025-04-08,Senate,"(S) 2nd Reading Concurred",34,16,0,0,50
1907367,1542103,2025-04-09,Senate,"(S) 3rd Reading Concurred",34,15,0,1,50
1907367,1542104,2025-03-26,Senate,"(S) Business, Labor  and Economic Affairs--To Take From The Table",6,3,3,0,12
1907367,1556959,2025-03-19,Senate,"(S) Business, Labor  and Economic Affairs--To Table",11,0,1,0,12
1907367,1558874,2025-03-26,Senate,"(S) Business, Labor  and Economic Affairs--To Take From The Table",6,3,3,0,12
1907367,1558875,2025-03-19,Senate,"(S) Business, Labor  and Economic Affairs--To Table",11,0,1,0,12
1907402,1481695,2025-01-21,House,"(H) Business and Labor--Do Pass",20,0,0,0,20
1907402,1481696,2025-01-24,House,"(H) 2nd Reading Passed",100,0,0,0,100
1907402,1481697,2025-01-27,House,"(H) 3rd Reading Passed",98,0,0,2,100
1907402,1521883,2025-03-19,Senate,"(S) Public Health, Welfare and Safety--Be Concurred In",11,0,0,0,11
1907402,1526092,2025-01-21,House,"(H) Business and Labor--Do Pass",20,0,0,0,20
1907402,1527571,2025-03-26,Senate,"(S) 2nd Reading Concurred",44,6,0,0,50
1907402,1529098,2025-03-27,Senate,"(S) 3rd Reading Concurred",50,0,0,0,50
1907438,1486865,2025-02-11,House,"(H) Fish, Wildlife and Parks--Do Pass As Amended",11,9,0,0,20
1907438,1496705,2025-02-21,House,"(H) 2nd Reading Not Passed",49,51,0,0,100
1907438,1497123,2025-02-22,House,"(H) Reconsidered Previous Action; Placed on 2nd Reading",50,48,0,2,100
1907438,1497750,2025-02-24,House,"(H) 2nd Reading Not Passed",43,57,0,0,100
1907471,1481698,2025-01-29,Senate,"(S) Business, Labor  and Economic Affairs--Do Pass",11,0,0,0,11
1907471,1487340,2025-01-29,Senate,"(S) Business, Labor  and Economic Affairs--Do Pass",11,0,0,0,11
1907471,1490677,2025-02-15,Senate,"(S) 2nd Reading Passed",49,1,0,0,50
1907471,1492231,2025-02-18,Senate,"(S) 3rd Reading Passed",50,0,0,0,50
1907471,1524040,2025-03-21,House,"(H) Business and Labor--Be Concurred In",20,0,0,0,20
1907471,1528010,2025-03-26,House,"(H) 2nd Reading Concurred",100,0,0,0,100
1907471,1528892,2025-03-27,House,"(H) 3rd Reading Concurred",99,0,0,1,100
1907505,1481699,2025-01-23,Senate,"(S) Taxation--Do Pass",8,0,0,0,8
1907505,1481700,2025-01-28,Senate,"(S) 2nd Reading Passed",46,4,0,0,50
1907505,1481701,2025-01-29,Senate,"(S) 3rd Reading Passed",44,5,0,1,50
1907505,1489618,2025-02-06,House,"(H) Taxation--Be Concurred In",21,0,0,0,21
1907505,1490269,2025-02-14,House,"(H) 2nd Reading Concurred",99,1,0,0,100
1907505,1492513,2025-02-18,House,"(H) 3rd Reading Concurred",99,0,0,1,100
1907609,1481702,2025-01-24,Senate,"(S) Highways and Transportation--Do Pass",8,0,0,0,8
1907609,1481703,2025-01-29,Senate,"(S) 2nd Reading Passed",50,0,0,0,50
1907609,1481704,2025-01-30,Senate,"(S) 3rd Reading Passed",47,2,0,1,50
1907609,1521206,2025-03-19,House,"(H) Transportation--Be Concurred In As Amended",14,0,0,0,14
1907609,1530164,2025-03-28,House,"(H) 2nd Reading Concurred",100,0,0,0,100
1907609,1530659,2025-03-29,House,"(H) 3rd Reading Concurred",96,0,0,4,100
1907609,1536628,2025-04-03,Senate,"(S) 2nd Reading House Amendments Concurred",43,6,0,1,50
1907609,1537265,2025-04-04,Senate,"(S) 3rd Reading Passed as Amended by House",45,4,0,1,50
1907676,1481705,2025-01-29,Senate,"(S) Business, Labor  and Economic Affairs--Do Pass",11,0,0,0,11
1907676,1481706,2025-02-03,Senate,"(S) 2nd Reading Motion to Amend Carried",46,4,0,0,50
1907676,1481707,2025-02-03,Senate,"(S) 2nd Reading Passed as Amended",49,1,0,0,50
1907676,1481708,2025-02-04,Senate,"(S) 3rd Reading Passed",49,1,0,0,50
1907676,1490902,2025-02-17,House,"(H) Business and Labor--Be Concurred In As Amended",20,0,0,0,20
1907676,1522840,2025-03-20,House,"(H) 2nd Reading Concurred",63,37,0,0,100
1907676,1523361,2025-01-29,Senate,"(S) Business, Labor  and Economic Affairs--Do Pass",11,0,0,0,11
1907676,1524060,2025-03-21,House,"(H) 3rd Reading Concurred",76,21,0,3,100
1907676,1526052,2025-03-25,Senate,"(S) 2nd Reading House Amendments Concurred",50,0,0,0,50
1907676,1527494,2025-03-26,Senate,"(S) 3rd Reading Passed as Amended by House",50,0,0,0,50
1907746,1481710,2025-01-24,House,"(H) 2nd Reading Passed",93,7,0,0,100
1907746,1481711,2025-01-27,House,"(H) 3rd Reading Passed",90,7,0,3,100
1907746,1536138,2025-04-03,Senate,"(S) Judiciary--Be Concurred In",5,3,0,0,8
1907746,1548888,2025-04-15,Senate,"(S) 2nd Reading Concurred",32,18,0,0,50
1907746,1549880,2025-04-16,Senate,"(S) 3rd Reading Concurred",34,16,0,0,50
1907814,1483547,2025-02-06,House,"(H) Fish, Wildlife and Parks--Do Pass As Amended",20,0,0,0,20
1907814,1487841,2025-02-12,House,"(H) 2nd Reading Passed",100,0,0,0,100
1907814,1491339,2025-02-17,House,"(H) Appropriations--Do Pass As Amended",20,1,0,2,23
1907814,1497111,2025-02-22,House,"(H) 2nd Reading Passed",97,2,0,1,100
1907814,1497999,2025-02-24,House,"(H) 3rd Reading Passed",99,0,0,1,100
1907814,1540236,2025-04-08,Senate,"(S) Fish and Game--Be Concurred In",8,3,0,0,11
1907814,1544192,2025-04-10,Senate,"(S) 2nd Reading Concurred",46,3,0,1,50
1907814,1547165,2025-04-14,Senate,"(S) Finance and Claims--Be Concurred In",19,3,0,0,22
1907814,1548800,2025-04-15,Senate,"(S) 3rd Reading Concurred",44,5,0,1,50
1907814,1557216,2025-04-24,Senate,"(S) 2nd Reading Governor's Proposed Amendments Adopted",46,2,0,2,50
1907814,1557217,2025-04-24,House,"(H) 2nd Reading Governor's Proposed Amendments Adopted",96,4,0,0,100
1907814,1558124,2025-04-25,House,"(H) 3rd Reading Governor's Proposed Amendments Adopted",100,0,0,0,100
1907814,1558125,2025-04-25,Senate,"(S) 3rd Reading Governor's Proposed Amendments Adopted",46,3,0,1,50
1907814,1558763,2025-04-25,House,"(H) 3rd Reading Governor's Proposed Amendments Adopted",100,0,0,0,100
1907814,1558764,2025-04-25,Senate,"(S) 3rd Reading Governor's Proposed Amendments Adopted",46,3,0,1,50
1907883,1481712,2025-01-29,Senate,"(S) Public Health, Welfare and Safety--Do Pass",11,0,0,0,11
1907883,1481713,2025-02-03,Senate,"(S) 2nd Reading Passed",49,1,0,0,50
1907883,1481714,2025-02-04,Senate,"(S) 3rd Reading Passed",49,1,0,0,50
1907883,1492292,2025-02-18,House,"(H) Human Services--To Table",17,0,0,4,21
1907883,1530045,2025-02-18,House,"(H) Human Services--To Table",17,0,0,4,21
1907883,1577050,2025-02-18,House,"(H) Human Services--To Table",17,0,4,0,21
1907951,1481715,2025-01-21,House,"(H) Local Government--Do Pass",17,0,0,0,17
1907951,1481716,2025-01-24,House,"(H) 2nd Reading Passed",98,2,0,0,100
1907951,1481717,2025-01-27,House,"(H) 3rd Reading Passed",94,3,0,3,100
1907951,1519365,2025-03-17,Senate,"(S) Local Government--Be Concurred In",10,0,0,1,11
1907951,1521429,2025-03-19,Senate,"(S) 2nd Reading Concurred",29,21,0,0,50
1907951,1522978,2025-03-20,Senate,"(S) 3rd Reading Concurred",31,19,0,0,50
1908015,1481718,2025-01-30,House,"(H) Fish, Wildlife and Parks--Do Pass",20,0,0,0,20
1908015,1481719,2025-02-04,House,"(H) 2nd Reading Passed",96,4,0,0,100
1908015,1481720,2025-02-05,House,"(H) 3rd Reading Passed",96,4,0,0,100
1908015,1519838,2025-03-18,Senate,"(S) Fish and Game--Be Concurred In",12,0,0,0,12
1908015,1524054,2025-03-21,Senate,"(S) 2nd Reading Concurred",32,18,0,0,50
1908015,1525221,2025-03-24,Senate,"(S) 3rd Reading Concurred",40,10,0,0,50
1908015,1559988,2025-01-30,House,"(H) Fish, Wildlife and Parks--Do Pass",20,0,0,0,20
1908241,1481721,2025-01-21,House,"(H) Business and Labor--Do Pass As Amended",33,27,0,0,60
1908241,1481724,2025-01-28,House,"(H) Business and Labor--Do Pass As Amended",11,9,0,0,20
1908241,1499920,2025-02-26,House,"(H) 2nd Reading Motion to Amend Carried",60,40,0,0,100
1908241,1499921,2025-02-26,House,"(H) 2nd Reading Not Passed as Amended",38,62,0,0,100
1908316,1481725,2025-01-22,House,"(H) Education--Do Pass As Amended",15,0,0,0,15
1908316,1481726,2025-01-27,House,"(H) 2nd Reading Passed",100,0,0,0,100
1908316,1481727,2025-01-28,House,"(H) 3rd Reading Passed",99,0,0,1,100
1908316,1490756,2025-02-13,Senate,"(S) Education and Cultural Resources--Be Concurred In As Amended",9,5,0,0,14
1908316,1522832,2025-02-13,Senate,"(S) Education and Cultural Resources--Be Concurred In As Amended",9,5,0,0,14
1908316,1522833,2025-03-20,Senate,"(S) 2nd Reading Concurred",47,3,0,0,50
1908316,1524063,2025-03-21,Senate,"(S) 3rd Reading Concurred",47,3,0,0,50
1908316,1530109,2025-03-28,House,"(H) 2nd Reading Senate Amendments Not Concurred",72,27,0,1,100
1908316,1541758,2025-04-09,Senate,"(S) 2nd Reading Conference Committee Report Adopted",49,1,0,0,50
1908316,1544367,2025-04-10,Senate,"(S) 3rd Reading Conference Committee Report Adopted",47,1,0,2,50
1908316,1546275,2025-04-11,House,"(H) 2nd Reading Conference Committee Report Adopted",94,6,0,0,100
1908316,1546276,2025-04-11,House,"(H) 3rd Reading Conference Committee Report Adopted",90,9,0,1,100
1908316,1568836,2025-02-13,Senate,"(S) Education and Cultural Resources--Be Concurred In As Amended",9,5,0,0,14
1908316,1569505,2025-01-22,House,"(H) Education--Do Pass As Amended",15,0,0,0,15
1908397,1481728,2025-01-17,House,"(H) State Administration--",18,1,0,0,19
1908397,1484546,2025-01-17,House,"(H) State Administration--To Table",18,1,0,0,19
1908397,1484726,2025-01-17,House,"(H) State Administration--Do Pass As Amended",6,13,0,0,19
1908479,1481730,2025-02-05,House,"(H) Business and Labor--Do Pass As Amended",40,0,0,0,40
1908479,1484931,2025-02-10,House,"(H) 2nd Reading Passed",100,0,0,0,100
1908479,1486593,2025-02-11,House,"(H) 3rd Reading Passed",99,0,0,1,100
1908479,1522486,2025-03-20,Senate,"(S) Business, Labor  and Economic Affairs--Be Concurred In",12,0,0,0,12
1908479,1526461,2025-03-25,Senate,"(S) 2nd Reading Concurred",45,5,0,0,50
1908479,1527850,2025-03-26,Senate,"(S) 3rd Reading Concurred",45,5,0,0,50
1908560,1481734,2025-01-27,House,"(H) Education--",12,3,0,0,15
1908560,1481735,2025-02-03,House,"(H) Education--Do Pass As Amended",75,0,0,0,75
1908560,1489647,2025-02-13,House,"(H) 2nd Reading Passed",100,0,0,0,100
1908560,1490246,2025-02-14,House,"(H) 3rd Reading Passed",94,0,0,6,100
1908560,1533857,2025-04-01,Senate,"(S) Education and Cultural Resources--Be Concurred In As Amended",9,5,0,0,14
1908560,1546157,2025-02-03,House,"(H) Education--To Take From The Table",14,0,1,0,15
1908560,1546686,2025-04-12,Senate,"(S) 2nd Reading Concurred",48,2,0,0,50
1908560,1547304,2025-04-14,Senate,"(S) 3rd Reading Concurred",42,6,0,2,50
1908560,1548671,2025-02-03,House,"(H) Education--Do Pass As Amended",15,0,0,0,15
1908560,1550059,2025-04-16,House,"(H) 2nd Reading Senate Amendments Concurred",99,1,0,0,100
1908560,1551554,2025-04-17,House,"(H) 3rd Reading Passed as Amended by Senate",98,1,0,1,100
1908634,1481740,2025-01-24,House,"(H) Taxation--Do Pass",14,7,0,0,21
1908634,1481741,2025-02-03,House,"(H) 2nd Reading Passed",53,47,0,0,100
1908634,1486585,2025-02-11,House,"(H) Appropriations--To Table",15,8,0,0,23
1908731,1481742,2025-01-31,Senate,"(S) Judiciary--Do Pass",6,3,0,0,9
1908731,1481743,2025-02-05,Senate,"(S) 2nd Reading Motion to Amend Failed",21,29,0,0,50
1908731,1481744,2025-02-05,Senate,"(S) 2nd Reading Motion to Amend Failed",17,32,0,1,50
1908731,1482352,2025-02-05,Senate,"(S) 2nd Reading Pass Motion Failed",25,25,0,0,50
1908731,1490278,2025-02-13,Senate,"(S) Judiciary--Do Pass As Amended",4,2,0,3,9
1908731,1490705,2025-02-15,Senate,"(S) 2nd Reading Indefinitely Postponed",29,19,0,2,50
1908731,1490706,2025-02-13,Senate,"(S) Judiciary--Do Pass As Amended",4,2,0,3,9
1908731,1490707,2025-02-15,Senate,"(S) 2nd Reading Pass Motion Failed",24,26,0,0,50
1908731,1490768,2025-02-05,Senate,"(S) 2nd Reading Indefinitely Postponed",24,24,0,2,50
1908842,1481745,2025-01-21,House,"(H) Business and Labor--Do Pass As Amended",40,0,0,0,40
1908842,1481747,2025-01-24,House,"(H) 2nd Reading Passed",85,15,0,0,100
1908842,1481748,2025-01-27,House,"(H) 3rd Reading Passed",85,12,0,3,100
1908842,1520866,2025-03-19,Senate,"(S) Business, Labor  and Economic Affairs--Be Concurred In",11,0,0,1,12
1908842,1524141,2025-03-21,Senate,"(S) 2nd Reading Concurred",45,5,0,0,50
1908842,1525010,2025-03-24,Senate,"(S) 3rd Reading Concurred",40,10,0,0,50
1908842,1526471,2025-01-21,House,"(H) Business and Labor--Do Pass As Amended",20,0,0,0,20
1908961,1481750,2025-01-27,House,"(H) Education--Do Pass As Amended",15,0,0,0,15
1908961,1481751,2025-02-03,House,"(H) 2nd Reading Passed",80,20,0,0,100
1908961,1481752,2025-02-04,House,"(H) 3rd Reading Passed",81,19,0,0,100
1908961,1534257,2025-04-01,Senate,"(S) Education and Cultural Resources--Be Concurred In As Amended",9,5,0,0,14
1908961,1536992,2025-04-03,Senate,"(S) 2nd Reading Concurred",45,4,0,1,50
1908961,1537503,2025-04-04,Senate,"(S) 3rd Reading Concurred",46,3,0,1,50
1908961,1546441,2025-04-11,House,"(H) 2nd Reading Senate Amendments Concurred",100,0,0,0,100
1908961,1546442,2025-04-11,House,"(H) 3rd Reading Passed as Amended by Senate",96,1,0,3,100
1908961,1569491,2025-01-27,House,"(H) Education--Do Pass As Amended",15,0,0,0,15
1909080,1481755,2025-01-27,Senate,"(S) State Administration--Do Pass",9,0,0,0,9
1909080,1497068,2025-01-27,Senate,"(S) State Administration--Do Pass",9,0,0,0,9
1909080,1497069,2025-01-31,Senate,"(S) 2nd Reading Passed",49,1,0,0,50
1909080,1497070,2025-02-03,Senate,"(S) 3rd Reading Passed",47,2,0,1,50
1909080,1522364,2025-03-20,House,"(H) State Administration--Be Concurred In",19,0,0,0,19
1909080,1530516,2025-03-28,House,"(H) 2nd Reading Concurred",100,0,0,0,100
1909080,1530673,2025-03-29,House,"(H) 3rd Reading Concurred",96,0,0,4,100
1909204,1481756,2025-01-29,House,"(H) Taxation--Do Pass As Amended",14,7,0,0,21
1909204,1495605,2025-02-20,House,"(H) Appropriations--Do Pass",16,7,0,0,23
1909204,1500442,2025-02-26,House,"(H) 2nd Reading Passed",60,40,0,0,100
1909204,1501678,2025-02-27,House,"(H) 3rd Reading Passed",59,39,0,2,100
1909204,1534179,2025-04-02,Senate,"(S) Taxation--To Table",8,0,0,0,8
1909204,1536851,2025-04-02,Senate,"(S) Taxation--To Table",8,0,0,0,8
1909204,1576155,2025-04-16,Senate,"(S) Taxation--To Table",8,0,0,0,8
1909327,1482479,2025-01-31,House,"(H) Taxation--Do Pass As Amended",16,5,0,0,21
1909327,1483226,2025-02-06,House,"(H) 2nd Reading Passed",79,21,0,0,100
1909327,1495725,2025-02-20,House,"(H) Appropriations--Do Pass As Amended",15,8,0,0,23
1909327,1500498,2025-02-26,House,"(H) 2nd Reading Passed",87,13,0,0,100
1909327,1501430,2025-02-27,House,"(H) 3rd Reading Passed",68,30,0,2,100
1909327,1549891,2025-04-16,Senate,"(S) Taxation--Be Concurred In As Amended",7,1,0,0,8
1909327,1551688,2025-04-17,Senate,"(S) 2nd Reading Concur Motion Failed",21,29,0,0,50
1909327,1551689,2025-04-17,Senate,"(S) 2nd Reading Indefinitely Postpone Motion Failed",21,28,0,1,50
1909327,1558223,2025-04-25,Senate,"(S) Motion Failed",20,28,0,2,50
1909520,1481758,2025-01-27,Senate,"(S) Judiciary--Do Pass",5,4,0,0,9
1909520,1481759,2025-01-29,Senate,"(S) 2nd Reading Passed",29,21,0,0,50
1909520,1481760,2025-01-30,Senate,"(S) 3rd Reading Passed",28,21,0,1,50
1909520,1497749,2025-02-24,House,"(H) Legislative Administration--Be Concurred In As Amended",8,6,0,0,14
1909520,1521135,2025-03-19,House,"(H) 2nd Reading Not Concurred",41,59,0,0,100
1909520,1551319,2025-01-27,Senate,"(S) Judiciary--Do Pass",5,4,0,0,9
1909553,1481761,2025-01-23,House,"(H) Human Services--Do Pass",21,0,0,0,21
1909553,1481762,2025-01-29,House,"(H) 2nd Reading Passed",99,1,0,0,100
1909553,1481763,2025-01-30,House,"(H) 3rd Reading Passed",98,2,0,0,100
1909553,1522376,2025-03-19,Senate,"(S) Taxation--Be Concurred In",8,0,0,0,8
1909553,1552133,2025-04-18,Senate,"(S) 2nd Reading Concurred",44,3,0,3,50
1909553,1554670,2025-04-22,Senate,"(S) 3rd Reading Concurred",47,3,0,0,50
1909598,1492848,2025-02-18,Senate,"(S) Energy, Technology & Federal Relations--To Table",12,1,0,0,13
1909633,1523997,2025-03-21,Senate,"(S) Taxation--Do Pass As Amended",8,0,0,0,8
1909633,1529342,2025-03-27,Senate,"(S) 2nd Reading Passed",38,12,0,0,50
1909633,1530317,2025-03-28,Senate,"(S) 3rd Reading Passed",39,9,0,2,50
1909633,1541777,2025-04-09,House,"(H) Taxation--Be Concurred In",11,10,0,0,21
1909633,1548728,2025-04-15,House,"(H) 2nd Reading Concurred",56,44,0,0,100
1909633,1550344,2025-04-16,House,"(H) 3rd Reading Concurred",67,31,0,2,100
1909675,1482360,2025-01-21,House,"(H) Local Government--To Table",17,0,0,0,17
1909675,1486327,2025-01-21,House,"(H) Local Government--To Table",17,0,0,0,17
1909675,1491205,2025-01-21,House,"(H) Local Government--To Table",17,0,0,0,17
1909675,1491206,2025-01-21,House,"(H) Local Government--Do Pass As Amended",7,10,0,0,17
1909714,1489732,2025-02-13,Senate,"(S) Education and Cultural Resources--Do Pass As Amended",9,5,0,0,14
1909714,1493799,2025-02-19,Senate,"(S) 2nd Reading Motion to Amend Failed",18,32,0,0,50
1909714,1493800,2025-02-19,Senate,"(S) 2nd Reading Passed",43,7,0,0,50
1909714,1495252,2025-02-20,Senate,"(S) 3rd Reading Passed",43,7,0,0,50
1909714,1529073,2025-03-27,House,"(H) State Administration--Be Concurred In",18,1,0,0,19
1909714,1532496,2025-04-01,House,"(H) 2nd Reading Motion to Amend Failed",18,82,0,0,100
1909714,1532497,2025-04-01,House,"(H) 2nd Reading Concurred",96,4,0,0,100
1909714,1534566,2025-04-02,House,"(H) 3rd Reading Concurred",94,1,0,5,100
1909714,1555212,2025-04-23,Senate,"(S) 2nd Reading Governor's Proposed Amendments Adopted",44,5,0,1,50
1909714,1558040,2025-04-25,House,"(H) 2nd Reading Governor's Proposed Amendments Adopted",71,29,0,0,100
1909714,1558041,2025-04-25,Senate,"(S) 3rd Reading Governor's Proposed Amendments Adopted",45,4,0,1,50
1909714,1558991,2025-04-28,House,"(H) 3rd Reading Governor's Proposed Amendments Adopted",58,41,0,1,100
1909755,1481764,2025-01-21,House,"(H) Local Government--Do Pass",17,0,0,0,17
1909755,1481765,2025-01-24,House,"(H) 2nd Reading Passed",98,2,0,0,100
1909755,1481766,2025-01-27,House,"(H) 3rd Reading Passed",94,4,0,2,100
1909755,1519490,2025-03-17,Senate,"(S) Local Government--Be Concurred In",10,0,0,1,11
1909755,1522026,2025-03-19,Senate,"(S) 2nd Reading Concurred",39,10,0,1,50
1909755,1523736,2025-03-20,Senate,"(S) 3rd Reading Concurred",37,13,0,0,50
1909795,1481767,2025-01-17,House,"(H) Education--Do Pass",15,0,0,0,15
1909795,1481768,2025-01-24,House,"(H) 2nd Reading Passed",99,1,0,0,100
1909795,1481769,2025-01-27,House,"(H) 3rd Reading Passed",97,1,0,2,100
1909795,1528090,2025-03-20,Senate,"(S) Education and Cultural Resources--Be Concurred In",14,0,0,0,14
1909795,1530340,2025-03-28,Senate,"(S) 2nd Reading Concurred",50,0,0,0,50
1909795,1531493,2025-03-31,Senate,"(S) 3rd Reading Concurred",50,0,0,0,50
1909839,1489536,2025-02-13,Senate,"(S) Education and Cultural Resources--Do Pass As Amended",12,2,0,0,14
1909839,1492134,2025-02-18,Senate,"(S) 2nd Reading Passed",50,0,0,0,50
1909839,1503306,2025-03-03,Senate,"(S) Finance and Claims--Do Pass",22,0,0,0,22
1909839,1505170,2025-03-04,Senate,"(S) 3rd Reading Passed",49,1,0,0,50
1909839,1531606,2025-03-31,House,"(H) Education--Be Concurred In As Amended",12,3,0,0,15
1909839,1539541,2025-04-08,House,"(H) 2nd Reading Concurred",88,9,0,3,100
1909839,1544535,2025-04-10,House,"(H) Appropriations--To Table",19,4,0,0,23
1909839,1558887,2025-04-28,House,"(H) Motion Failed",33,67,0,0,100
1909839,1561878,2025-02-13,Senate,"(S) Education and Cultural Resources--Do Pass As Amended",12,2,0,0,14
1910267,1485197,2025-02-10,Senate,"(S) Local Government--Do Pass As Amended",11,0,0,0,11
1910267,1489359,2025-02-13,Senate,"(S) 2nd Reading Passed",50,0,0,0,50
1910267,1490230,2025-02-14,Senate,"(S) 3rd Reading Passed",50,0,0,0,50
1910267,1540350,2025-04-08,House,"(H) Local Government--Be Concurred In As Amended",17,0,0,0,17
1910267,1545685,2025-04-11,House,"(H) 2nd Reading Concurred",99,1,0,0,100
1910267,1546237,2025-04-11,House,"(H) 3rd Reading Concurred",99,0,0,1,100
1910267,1547161,2025-04-14,Senate,"(S) 2nd Reading House Amendments Concurred",44,4,0,2,50
1910267,1548792,2025-04-15,Senate,"(S) 3rd Reading Passed as Amended by House",50,0,0,0,50
1910294,1481770,2025-01-28,House,"(H) State Administration--Do Pass",19,0,0,0,19
1910294,1481771,2025-01-30,House,"(H) 2nd Reading Passed",97,3,0,0,100
1910294,1481772,2025-01-31,House,"(H) 3rd Reading Passed",95,4,0,1,100
1910294,1522352,2025-03-19,Senate,"(S) State Administration--Be Concurred In",9,0,0,0,9
1910294,1536862,2025-04-03,Senate,"(S) 2nd Reading Concurred",42,8,0,0,50
1910294,1537482,2025-04-04,Senate,"(S) 3rd Reading Concurred",46,3,0,1,50
1910294,1565020,2025-01-28,House,"(H) State Administration--Do Pass",19,0,0,0,19
1910323,1482975,2025-01-15,House,"(H) Transportation--To Table",10,4,0,0,14
1910352,1481773,2025-01-21,House,"(H) Business and Labor--Do Pass As Amended",40,0,0,0,40
1910352,1481775,2025-01-28,House,"(H) 2nd Reading Passed",100,0,0,0,100
1910352,1481776,2025-01-29,House,"(H) 3rd Reading Passed",100,0,0,0,100
1910352,1522269,2025-03-19,Senate,"(S) Business, Labor  and Economic Affairs--Be Concurred In",11,0,0,1,12
1910352,1526385,2025-03-25,Senate,"(S) 2nd Reading Concurred",49,1,0,0,50
1910352,1527761,2025-03-26,Senate,"(S) 3rd Reading Concurred",50,0,0,0,50
1910381,1481777,2025-01-14,House,"(H) Agriculture--Do Pass",17,0,0,0,17
1910381,1481778,2025-01-27,House,"(H) 2nd Reading Passed",100,0,0,0,100
1910381,1481779,2025-01-28,House,"(H) 3rd Reading Passed",97,2,0,1,100
1910381,1533121,2025-04-01,Senate,"(S) Agriculture, Livestock and Irrigation--Be Concurred In As Amended",9,2,0,0,11
1910381,1537653,2025-04-05,Senate,"(S) 2nd Reading Concurred",32,16,0,2,50
1910381,1537762,2025-04-05,Senate,"(S) 2nd Reading Concurred",32,16,0,2,50
1910381,1538324,2025-04-07,Senate,"(S) 3rd Reading Concurred",35,14,0,1,50
1910381,1546226,2025-04-11,House,"(H) 2nd Reading Senate Amendments Concurred",100,0,0,0,100
1910381,1546227,2025-04-11,House,"(H) 3rd Reading Passed as Amended by Senate",98,1,0,1,100
1910409,1481780,2025-01-23,House,"(H) Local Government--Do Pass",17,0,0,0,17
1910409,1481781,2025-01-30,House,"(H) 2nd Reading Passed",86,14,0,0,100
1910409,1481782,2025-01-31,House,"(H) 3rd Reading Passed",79,20,0,1,100
1910409,1531650,2025-03-31,Senate,"(S) Local Government--Be Concurred In As Amended",11,0,0,0,11
1910409,1536339,2025-04-03,Senate,"(S) 2nd Reading Concurred",33,16,0,1,50
1910409,1537137,2025-04-04,Senate,"(S) 3rd Reading Concurred",35,14,0,1,50
1910409,1545897,2025-04-11,House,"(H) 2nd Reading Senate Amendments Concurred",94,6,0,0,100
1910409,1546358,2025-04-11,House,"(H) 3rd Reading Passed as Amended by Senate",82,17,0,1,100
1910436,1481783,2025-01-27,House,"(H) Education--Do Pass",15,0,0,0,15
1910436,1481784,2025-01-30,House,"(H) 2nd Reading Passed",67,32,0,1,100
1910436,1531013,2025-03-31,House,"(H) Appropriations--Do Pass As Amended",14,9,0,0,23
1910436,1537088,2025-04-04,House,"(H) 2nd Reading Passed",63,37,0,0,100
1910436,1537640,2025-04-05,House,"(H) 3rd Reading Passed",64,34,0,2,100
1910436,1549336,2025-04-15,Senate,"(S) Education and Cultural Resources--To Table",14,0,0,0,14
1910436,1549794,2025-04-16,Senate,"(S) Motion Failed",24,26,0,0,50
1910436,1550393,2025-04-15,Senate,"(S) Education and Cultural Resources--To Table",14,0,0,0,14
1910436,1551562,2025-04-17,Senate,"(S) Taken from Committee; Placed on 2nd Reading",27,23,0,0,50
1910436,1552134,2025-04-18,Senate,"(S) 2nd Reading Concurred",27,23,0,0,50
1910436,1554305,2025-04-22,Senate,"(S) 3rd Reading Concurred",29,21,0,0,50
1910436,1573287,2025-01-27,House,"(H) Education--Do Pass",15,0,0,0,15
1910469,1496796,2025-02-21,Senate,"(S) State Administration--To Table",9,0,0,0,9
1910469,1515689,2025-02-21,Senate,"(S) State Administration--Do Pass",4,5,0,0,9
1910497,1485228,2025-02-10,Senate,"(S) Natural Resources--To Table",11,0,0,0,11
1910527,1483028,2025-01-15,House,"(H) Transportation--To Table",14,0,0,0,14
1910554,1482586,2025-01-24,House,"(H) Taxation--To Table",21,0,0,0,21
1910584,1481786,2025-01-29,House,"(H) 2nd Reading Passed",100,0,0,0,100
1910584,1481787,2025-01-30,House,"(H) 3rd Reading Passed",100,0,0,0,100
1910584,1482843,2025-01-23,House,"(H) State Administration--Do Pass As Amended",19,0,0,0,19
1910584,1498283,2025-02-24,Senate,"(S) State Administration--Be Concurred In",7,2,0,0,9
1910584,1518265,2025-03-15,Senate,"(S) 2nd Reading Concurred",33,17,0,0,50
1910584,1518996,2025-03-17,Senate,"(S) 3rd Reading Concurred",31,18,0,1,50
1910612,1481788,2025-01-22,House,"(H) Transportation--Do Pass",10,4,0,0,14
1910612,1481789,2025-01-28,House,"(H) 2nd Reading Passed",92,8,0,0,100
1910612,1481790,2025-01-29,House,"(H) 3rd Reading Passed",91,9,0,0,100
1910612,1521612,2025-03-19,Senate,"(S) Highways and Transportation--Be Concurred In",6,2,0,0,8
1910612,1526470,2025-03-25,Senate,"(S) 2nd Reading Concurred",39,11,0,0,50
1910612,1527866,2025-03-26,Senate,"(S) 3rd Reading Concurred",37,13,0,0,50
1910663,1481793,2025-01-20,House,"(H) Judiciary--Do Pass As Amended",12,8,0,0,20
1910663,1481794,2025-01-23,House,"(H) 2nd Reading Passed",56,44,0,0,100
1910663,1481795,2025-01-24,House,"(H) 3rd Reading Passed",56,42,0,2,100
1910663,1483544,2025-02-05,Senate,"(S) Judiciary--Be Concurred In",6,3,0,0,9
1910663,1518237,2025-03-15,Senate,"(S) 2nd Reading Concur Motion Failed",22,27,0,1,50
1910663,1518238,2025-03-15,Senate,"(S) 2nd Reading Indefinitely Postponed",29,20,0,1,50
1910663,1576047,2025-01-20,House,"(H) Judiciary--Do Pass As Amended",12,8,0,0,20
1910869,1481796,2025-01-23,House,"(H) Judiciary--Do Pass",36,24,0,0,60
1910869,1481799,2025-01-27,House,"(H) 2nd Reading Motion to Amend Carried",74,26,0,0,100
1910869,1481800,2025-01-27,House,"(H) 2nd Reading Passed as Amended",59,41,0,0,100
1910869,1481801,2025-01-29,House,"(H) 3rd Reading Passed",60,40,0,0,100
1910869,1524239,2025-03-21,Senate,"(S) Judiciary--To Table",8,0,0,0,8
1910869,1524240,2025-03-21,Senate,"(S) Judiciary--Be Concurred In As Amended",4,4,0,0,8
1910869,1525022,2025-03-24,Senate,"(S) Judiciary--To Take From The Table",5,3,0,0,8
1910869,1526123,2025-03-24,Senate,"(S) Judiciary--Be Concurred In As Amended",5,3,0,0,8
1910869,1530359,2025-03-21,Senate,"(S) Judiciary--To Table",8,0,0,0,8
1910869,1530360,2025-03-28,Senate,"(S) 2nd Reading Concurred",28,22,0,0,50
1910869,1531613,2025-03-21,Senate,"(S) Judiciary--To Table",8,0,0,0,8
1910869,1531614,2025-03-31,Senate,"(S) 3rd Reading Concurred",31,19,0,0,50
1910869,1541762,2025-03-24,Senate,"(S) Judiciary--To Take From The Table",5,3,0,0,8
1910869,1545895,2025-04-11,House,"(H) 2nd Reading Senate Amendments Concurred",56,44,0,0,100
1910869,1546469,2025-04-11,House,"(H) 3rd Reading Not Passed as Amended by Senate",44,55,0,1,100
1911065,1481802,2025-01-24,Senate,"(S) Public Health, Welfare and Safety--",11,0,0,0,11
1911065,1505403,2025-01-24,Senate,"(S) Public Health, Welfare and Safety--To Table",11,0,0,0,11
1911065,1505404,2025-03-04,Senate,"(S) Taken from Committee; Placed on 2nd Reading",26,24,0,0,50
1911065,1506400,2025-03-05,Senate,"(S) 2nd Reading Motion to Amend Failed",21,28,0,1,50
1911065,1506401,2025-03-05,Senate,"(S) 2nd Reading Pass Motion Failed",16,34,0,0,50
1911065,1506402,2025-03-05,Senate,"(S) 2nd Reading Indefinitely Postponed",41,9,0,0,50
1911267,1482836,2025-01-24,Senate,"(S) Judiciary--To Table",6,3,0,0,9
1911460,1481803,2025-01-21,Senate,"(S) Energy, Technology & Federal Relations--Do Pass",13,0,0,0,13
1911460,1481804,2025-01-23,Senate,"(S) 2nd Reading Passed",50,0,0,0,50
1911460,1481805,2025-01-24,Senate,"(S) 3rd Reading Passed",48,1,0,1,50
1911460,1521592,2025-03-19,House,"(H) Judiciary--Be Concurred In As Amended",20,0,0,0,20
1911460,1528375,2025-03-26,House,"(H) 2nd Reading Concurred",100,0,0,0,100
1911460,1529693,2025-03-27,House,"(H) 3rd Reading Concurred",99,0,0,1,100
1911460,1530766,2025-01-21,Senate,"(S) Energy, Technology & Federal Relations--Do Pass",13,0,0,0,13
1911460,1531102,2025-03-31,Senate,"(S) 2nd Reading House Amendments Concurred",50,0,0,0,50
1911460,1532799,2025-04-01,Senate,"(S) 3rd Reading Passed as Amended by House",50,0,0,0,50
1911460,1532800,2025-03-31,Senate,"(S) 2nd Reading House Amendments Concurred",50,0,0,0,50
1911657,1481807,2025-01-23,House,"(H) Judiciary--Do Pass As Amended",24,16,0,0,40
1911657,1481809,2025-01-28,House,"(H) 2nd Reading Passed",59,40,0,1,100
1911657,1481810,2025-01-29,House,"(H) 3rd Reading Passed",59,41,0,0,100
1911657,1524247,2025-03-21,Senate,"(S) Judiciary--Be Concurred In",5,3,0,0,8
1911657,1527828,2025-03-26,Senate,"(S) 2nd Reading Concurred",32,18,0,0,50
1911657,1529200,2025-03-27,Senate,"(S) 3rd Reading Concurred",32,18,0,0,50
1911851,1482307,2025-01-31,Senate,"(S) Judiciary--To Table",9,0,0,0,9
1911851,1501072,2025-02-26,Senate,"(S) Judiciary--Do Pass As Amended",5,3,0,0,8
1911851,1502297,2025-02-28,Senate,"(S) 2nd Reading Passed",26,24,0,0,50
1911851,1502908,2025-03-01,Senate,"(S) 3rd Reading Failed",23,27,0,0,50
1911851,1516387,2025-02-26,Senate,"(S) Judiciary--To Take From The Table",7,1,0,0,8
1911957,1481811,2025-01-28,House,"(H) State Administration--Do Pass",11,8,0,0,19
1911957,1481812,2025-02-03,House,"(H) 2nd Reading Passed",58,42,0,0,100
1911957,1481813,2025-02-04,House,"(H) 3rd Reading Passed",58,42,0,0,100
1911957,1521549,2025-03-19,Senate,"(S) State Administration--Be Concurred In",9,0,0,0,9
1911957,1527843,2025-03-26,Senate,"(S) 2nd Reading Concurred",50,0,0,0,50
1911957,1529327,2025-03-27,Senate,"(S) 3rd Reading Concurred",50,0,0,0,50
1912007,1481814,2025-01-27,Senate,"(S) State Administration--",9,0,0,0,9
1912057,1481815,2025-01-27,Senate,"(S) State Administration--",9,0,0,0,9
1912107,1481816,2025-02-03,House,"(H) Judiciary--Do Pass As Amended",14,6,0,0,20
1912107,1487717,2025-02-12,House,"(H) 2nd Reading Passed",86,14,0,0,100
1912107,1489407,2025-02-13,House,"(H) 3rd Reading Passed",88,11,0,1,100
1912107,1523264,2025-03-20,Senate,"(S) Energy, Technology & Federal Relations--Be Concurred In As Amended",13,0,0,0,13
1912107,1527966,2025-03-26,Senate,"(S) 2nd Reading Concurred",46,4,0,0,50
1912107,1529418,2025-03-27,Senate,"(S) 3rd Reading Concurred",50,0,0,0,50
1912107,1546152,2025-04-11,House,"(H) 2nd Reading Senate Amendments Concurred",100,0,0,0,100
1912107,1546153,2025-04-11,House,"(H) 3rd Reading Passed as Amended by Senate",96,3,0,1,100
1912107,1571203,2025-02-03,House,"(H) Judiciary--Do Pass As Amended",14,6,0,0,20
1912154,1481817,2025-01-27,Senate,"(S) State Administration--Do Pass As Amended",6,3,0,0,9
1912154,1481818,2025-01-30,Senate,"(S) 2nd Reading Passed",30,20,0,0,50
1912154,1481819,2025-01-31,Senate,"(S) 3rd Reading Passed",29,21,0,0,50
1912154,1523039,2025-03-20,House,"(H) State Administration--Be Concurred In",12,7,0,0,19
1912154,1530245,2025-03-28,House,"(H) 2nd Reading Not Concurred",48,52,0,0,100
1912204,1481821,2025-01-23,House,"(H) Fish, Wildlife and Parks--Do Pass As Amended",12,8,0,0,20
1912204,1481822,2025-01-31,House,"(H) 2nd Reading Motion to Amend Carried",78,21,0,1,100
1912204,1481823,2025-01-31,House,"(H) 2nd Reading Passed as Amended",57,42,0,1,100
1912204,1481824,2025-02-04,House,"(H) 3rd Reading Passed",56,44,0,0,100
1912204,1523219,2025-03-20,Senate,"(S) Fish and Game--Be Concurred In As Amended",8,4,0,0,12
1912204,1530300,2025-03-28,Senate,"(S) 2nd Reading Concurred",26,24,0,0,50
1912204,1531034,2025-03-31,Senate,"(S) 3rd Reading Failed",23,27,0,0,50
1912204,1533208,2025-04-01,Senate,"(S) Motion to Reconsider Failed",24,26,0,0,50
1912254,1482369,2025-01-21,House,"(H) Business and Labor--To Table",24,16,0,0,40
1912254,1526242,2025-01-21,House,"(H) Business and Labor--To Table",12,8,0,0,20
1912304,1481825,2025-01-27,Senate,"(S) Local Government--Do Pass",9,2,0,0,11
1912304,1481826,2025-01-30,Senate,"(S) 2nd Reading Passed",33,17,0,0,50
1912304,1481827,2025-01-31,Senate,"(S) 3rd Reading Passed",33,17,0,0,50
1912304,1523969,2025-03-20,House,"(H) State Administration--To Table",17,2,0,0,19
1912304,1530390,2025-03-20,House,"(H) State Administration--To Table",17,2,0,0,19
1912304,1578009,2025-03-20,House,"(H) State Administration--To Table",17,2,0,0,19
1912350,1481828,2025-01-30,House,"(H) Fish, Wildlife and Parks--Do Pass",20,0,0,0,20
1912350,1481829,2025-02-04,House,"(H) 2nd Reading Passed",98,2,0,0,100
1912350,1481830,2025-02-05,House,"(H) 3rd Reading Passed",97,3,0,0,100
1912350,1520205,2025-03-18,Senate,"(S) Fish and Game--Be Concurred In",12,0,0,0,12
1912350,1524133,2025-03-21,Senate,"(S) 2nd Reading Concurred",50,0,0,0,50
1912350,1524912,2025-03-24,Senate,"(S) 3rd Reading Concurred",49,1,0,0,50
1915388,1481831,2025-01-23,House,"(H) Local Government--Do Pass As Amended",17,0,0,0,17
1915388,1481832,2025-01-30,House,"(H) 2nd Reading Passed",100,0,0,0,100
1915388,1481833,2025-01-31,House,"(H) 3rd Reading Passed",99,0,0,1,100
1915388,1524163,2025-03-21,Senate,"(S) Local Government--Be Concurred In",11,0,0,0,11
1915388,1540481,2025-04-08,Senate,"(S) 2nd Reading Concurred",49,0,0,1,50
1915388,1541805,2025-04-09,Senate,"(S) 3rd Reading Concurred",49,0,0,1,50
1915388,1559266,2025-01-23,House,"(H) Local Government--Do Pass As Amended",17,0,0,0,17
1915514,1481834,2025-01-22,House,"(H) Business and Labor--Do Pass",20,0,0,0,20
1915514,1481835,2025-01-27,House,"(H) 2nd Reading Passed",100,0,0,0,100
1915514,1481836,2025-01-28,House,"(H) 3rd Reading Passed",98,0,0,2,100
1915514,1497488,2025-02-24,Senate,"(S) Business, Labor  and Economic Affairs--Be Concurred In",12,0,0,0,12
1915514,1518258,2025-03-15,Senate,"(S) 2nd Reading Concurred",48,2,0,0,50
1915514,1518571,2025-03-17,Senate,"(S) 3rd Reading Concurred",47,2,0,1,50
1915643,1481837,2025-01-21,House,"(H) State Administration--Do Pass",11,8,0,0,19
1915643,1481838,2025-01-22,House,"(H) 2nd Reading Passed",80,20,0,0,100
1915643,1481839,2025-01-23,House,"(H) 3rd Reading Passed",80,20,0,0,100
1915643,1491518,2025-01-21,House,"(H) State Administration--Do Pass",11,8,0,0,19
1915643,1491519,2025-02-14,Senate,"(S) State Administration--Be Concurred In",9,0,0,0,9
1915643,1492740,2025-02-18,Senate,"(S) 2nd Reading Concurred",44,6,0,0,50
1915643,1494011,2025-02-19,Senate,"(S) 3rd Reading Concurred",44,5,0,1,50
1915769,1481840,2025-02-03,Senate,"(S) Judiciary--Do Pass",6,3,0,0,9
1915769,1483617,2025-02-06,Senate,"(S) 2nd Reading Passed",38,11,0,1,50
1915769,1484302,2025-02-07,Senate,"(S) 3rd Reading Passed",37,12,0,1,50
1915769,1521078,2025-03-19,House,"(H) Judiciary--Be Concurred In",20,0,0,0,20
1915769,1526615,2025-03-25,House,"(H) 2nd Reading Concurred",100,0,0,0,100
1915769,1527983,2025-03-26,House,"(H) 3rd Reading Concurred",99,0,0,1,100
1915893,1481843,2025-02-03,House,"(H) 2nd Reading Passed",79,21,0,0,100
1915893,1487259,2025-02-11,House,"(H) Appropriations--Do Pass",15,8,0,0,23
1915893,1488976,2025-02-13,House,"(H) 3rd Reading Passed",75,24,0,1,100
1915893,1521762,2025-03-19,Senate,"(S) Business, Labor  and Economic Affairs--Be Concurred In",7,4,0,1,12
1915893,1524264,2025-03-21,Senate,"(S) 2nd Reading Concurred",30,20,0,0,50
1915893,1547055,2025-04-14,Senate,"(S) Finance and Claims--Be Concurred In",17,5,0,0,22
1915893,1549282,2025-04-15,Senate,"(S) 3rd Reading Concurred",30,19,0,1,50
1915904,1481844,2025-01-23,House,"(H) Human Services--Do Pass As Amended",21,0,0,0,21
1915904,1481845,2025-01-29,House,"(H) 2nd Reading Passed",81,19,0,0,100
1915904,1481846,2025-01-30,House,"(H) 3rd Reading Passed",78,22,0,0,100
1915904,1488662,2025-01-23,House,"(H) Human Services--Do Pass As Amended",21,0,0,0,21
1915904,1530229,2025-03-28,Senate,"(S) Public Health, Welfare and Safety--Be Concurred In",11,0,0,0,11
1915904,1539992,2025-04-08,Senate,"(S) 2nd Reading Concurred",50,0,0,0,50
1915904,1542396,2025-04-09,Senate,"(S) 3rd Reading Concurred",49,0,0,1,50
1915984,1482540,2025-01-31,House,"(H) State Administration--To Table",19,0,0,0,19
1916074,1481847,2025-01-23,House,"(H) Human Services--Do Pass As Amended",17,4,0,0,21
1916074,1481848,2025-01-29,House,"(H) 2nd Reading Passed",57,43,0,0,100
1916074,1509634,2025-01-23,House,"(H) Human Services--Do Pass As Amended",17,4,0,0,21
1916074,1536405,2025-04-03,House,"(H) Appropriations--Do Pass As Amended",17,6,0,0,23
1916074,1538557,2025-04-07,House,"(H) 2nd Reading Passed",57,43,0,0,100
1916074,1539721,2025-04-08,House,"(H) 3rd Reading Passed",55,42,0,3,100
1916074,1547540,2025-04-14,Senate,"(S) Public Health, Welfare and Safety--Be Concurred In",5,6,0,0,11
1916074,1549637,2025-04-14,Senate,"(S) Public Health, Welfare and Safety--To Table",11,0,0,0,11
1916074,1550155,2025-04-14,Senate,"(S) Public Health, Welfare and Safety--To Table",11,0,0,0,11
1916074,1558082,2025-01-23,House,"(H) Human Services--Do Pass As Amended",17,4,0,0,21
1916163,1481849,2025-02-03,Senate,"(S) Local Government--Do Pass As Amended",7,4,0,0,11
1916163,1483776,2025-02-06,Senate,"(S) 2nd Reading Passed",31,19,0,0,50
1916163,1484106,2025-02-07,Senate,"(S) 3rd Reading Passed",32,17,0,1,50
1916163,1541021,2025-04-08,House,"(H) Local Government--Be Concurred In As Amended",9,8,0,0,17
1916163,1545540,2025-04-11,House,"(H) 2nd Reading Concurred",56,44,0,0,100
1916163,1546389,2025-04-11,House,"(H) 3rd Reading Concurred",54,45,0,1,100
1916163,1547180,2025-04-14,Senate,"(S) 2nd Reading House Amendments Concurred",32,17,0,1,50
1916163,1548486,2025-04-15,Senate,"(S) 3rd Reading Passed as Amended by House",32,18,0,0,50
1916250,1481850,2025-01-20,House,"(H) Energy, Technology and Federal Relations--Do Pass",14,0,0,0,14
1916250,1481851,2025-01-24,House,"(H) 2nd Reading Passed",100,0,0,0,100
1916250,1481852,2025-01-27,House,"(H) 3rd Reading Passed",98,0,0,2,100
1916250,1485201,2025-01-20,House,"(H) Energy, Technology and Federal Relations--Do Pass",14,0,0,0,14
1916250,1487502,2025-01-20,House,"(H) Energy, Technology and Federal Relations--Do Pass",14,0,0,0,14
1916250,1529221,2025-03-27,Senate,"(S) Energy, Technology & Federal Relations--Resolution Adopted",8,0,0,5,13
1916250,1535871,2025-04-03,Senate,"(S) 2nd Reading Concurred",47,3,0,0,50
1916250,1537269,2025-04-04,Senate,"(S) 3rd Reading Concurred",44,5,0,1,50
1916341,1482827,2025-01-24,Senate,"(S) Public Health, Welfare and Safety--To Table",11,0,0,0,11
1916430,1481853,2025-01-23,House,"(H) Judiciary--Do Pass",60,0,0,0,60
1916430,1481856,2025-01-27,House,"(H) 2nd Reading Passed",97,3,0,0,100
1916430,1481857,2025-01-28,House,"(H) 3rd Reading Passed",94,5,0,1,100
1916430,1525862,2025-03-25,Senate,"(S) Judiciary--Be Concurred In",8,0,0,0,8
1916430,1530348,2025-03-28,Senate,"(S) 2nd Reading Concurred",42,7,0,1,50
1916430,1531462,2025-03-31,Senate,"(S) 3rd Reading Concurred",45,5,0,0,50
1916520,1486621,2025-02-06,Senate,"(S) Judiciary--Do Pass As Amended",9,0,0,0,9
1916520,1488486,2025-02-12,Senate,"(S) 2nd Reading Motion to Amend Carried",48,1,0,1,50
1916520,1488487,2025-02-12,Senate,"(S) 2nd Reading Passed as Amended",45,5,0,0,50
1916520,1490625,2025-02-14,Senate,"(S) 3rd Reading Passed",33,17,0,0,50
1916520,1525044,2025-03-24,House,"(H) Judiciary--Be Concurred In",18,2,0,0,20
1916520,1529387,2025-03-27,House,"(H) 2nd Reading Concurred",79,21,0,0,100
1916520,1530021,2025-03-28,House,"(H) 3rd Reading Concurred",81,18,0,1,100
1917012,1481859,2025-02-03,Senate,"(S) Judiciary--Do Pass As Amended",7,2,0,0,9
1917012,1483457,2025-02-06,Senate,"(S) 2nd Reading Passed",28,22,0,0,50
1917012,1484041,2025-02-07,Senate,"(S) 3rd Reading Passed",29,20,0,1,50
1917012,1524948,2025-03-24,House,"(H) Judiciary--Be Concurred In",11,9,0,0,20
1917012,1541795,2025-04-09,House,"(H) 2nd Reading Not Concurred",42,58,0,0,100
1917161,1481860,2025-01-29,House,"(H) State Administration--Do Pass",19,0,0,0,19
1917161,1481861,2025-01-31,House,"(H) 2nd Reading Passed",99,0,0,1,100
1917161,1481862,2025-02-03,House,"(H) 3rd Reading Passed",99,0,0,1,100
1917161,1524206,2025-03-21,Senate,"(S) Natural Resources--Be Concurred In",11,0,0,0,11
1917161,1527462,2025-03-26,Senate,"(S) 2nd Reading Concurred",50,0,0,0,50
1917161,1529023,2025-03-27,Senate,"(S) 3rd Reading Concurred",50,0,0,0,50
1917322,1481863,2025-01-23,House,"(H) State Administration--Do Pass",19,0,0,0,19
1917322,1481864,2025-01-27,House,"(H) 2nd Reading Passed",97,3,0,0,100
1917322,1481865,2025-01-28,House,"(H) 3rd Reading Passed",98,1,0,1,100
1917322,1495959,2025-02-13,Senate,"(S) Agriculture, Livestock and Irrigation--Be Concurred In As Amended",11,0,0,0,11
1917322,1518253,2025-03-15,Senate,"(S) 2nd Reading Concurred",39,11,0,0,50
1917322,1518431,2025-03-17,Senate,"(S) 3rd Reading Concurred",40,9,0,1,50
1917322,1521084,2025-03-19,House,"(H) 2nd Reading Senate Amendments Concurred",97,2,0,1,100
1917322,1523274,2025-03-20,House,"(H) 3rd Reading Passed as Amended by Senate",95,2,0,3,100
1917486,1482835,2025-02-03,House,"(H) Legislative Administration--To Table",8,6,0,0,14
1917699,1481867,2025-01-29,Senate,"(S) Public Health, Welfare and Safety--Do Pass",11,0,0,0,11
1917699,1481868,2025-02-04,Senate,"(S) 3rd Reading Passed",50,0,0,0,50
1917699,1492892,2025-02-18,House,"(H) Human Services--Be Concurred In",21,0,0,0,21
1917699,1522897,2025-03-20,House,"(H) 2nd Reading Concurred",97,2,0,1,100
1917699,1524099,2025-03-21,House,"(H) 3rd Reading Concurred",91,6,0,3,100
1917746,1481869,2025-01-28,House,"(H) State Administration--Do Pass",19,0,0,0,19
1917746,1481870,2025-02-03,House,"(H) 2nd Reading Passed",99,0,0,1,100
1917746,1481871,2025-02-04,House,"(H) 3rd Reading Passed",100,0,0,0,100
1917746,1526562,2025-03-21,Senate,"(S) State Administration--Be Concurred In",9,0,0,0,9
1917746,1540668,2025-04-08,Senate,"(S) 2nd Reading Concurred",49,0,0,1,50
1917746,1542431,2025-04-09,Senate,"(S) 3rd Reading Concurred",48,1,0,1,50
1917746,1569350,2025-01-28,House,"(H) State Administration--Do Pass",19,0,0,0,19
1917796,1482445,2025-02-05,Senate,"(S) Public Health, Welfare and Safety--To Table",33,0,0,0,33
1917796,1502918,2025-02-28,Senate,"(S) Public Health, Welfare and Safety--To Table",11,0,0,0,11
1917796,1507167,2025-02-28,Senate,"(S) Public Health, Welfare and Safety--To Take From The Table",5,6,0,0,11
1917796,1579733,2025-02-28,Senate,"(S) Public Health, Welfare and Safety--To Take From The Table",5,6,0,0,11
1917845,1484403,2025-02-07,Senate,"(S) State Administration--To Table",9,0,0,0,9
1917845,1516214,2025-02-07,Senate,"(S) State Administration--Do Pass",0,9,0,0,9
1917898,1481873,2025-01-31,Senate,"(S) State Administration--Do Pass",5,4,0,0,9
1917898,1483255,2025-02-06,Senate,"(S) 2nd Reading Pass Motion Failed",24,26,0,0,50
1917898,1483256,2025-02-06,Senate,"(S) 2nd Reading Indefinitely Postponed",30,19,0,1,50
1917946,1483790,2025-02-06,Senate,"(S) 2nd Reading Passed",44,6,0,0,50
1917946,1484281,2025-02-07,Senate,"(S) 3rd Reading Passed",43,6,0,1,50
1917946,1493883,2025-02-19,House,"(H) Energy, Technology and Federal Relations--Be Concurred In",8,6,0,0,14
1917946,1516504,2025-01-30,Senate,"(S) Energy, Technology & Federal Relations--Resolution Adopted",8,5,0,0,13
1917946,1525547,2025-03-24,House,"(H) 2nd Reading Concurred",58,41,0,1,100
1917946,1527080,2025-03-25,House,"(H) 3rd Reading Concurred",59,40,0,1,100
1917995,1481874,2025-01-29,House,"(H) Judiciary--Do Pass",14,6,0,0,20
1917995,1481875,2025-01-31,House,"(H) 2nd Reading Motion to Amend Failed",41,58,0,1,100
1917995,1481876,2025-01-31,House,"(H) 2nd Reading Passed",67,32,0,1,100
1917995,1481877,2025-02-03,House,"(H) 3rd Reading Passed",71,28,0,1,100
1917995,1540012,2025-04-08,Senate,"(S) Judiciary--Be Concurred In",5,3,0,0,8
1917995,1546590,2025-04-12,Senate,"(S) 2nd Reading Concurred",50,0,0,0,50
1917995,1546967,2025-04-14,Senate,"(S) 3rd Reading Concurred",43,4,0,3,50
1918045,1481878,2025-02-03,Senate,"(S) Judiciary--Do Pass",9,0,0,0,9
1918045,1481879,2025-02-05,Senate,"(S) 2nd Reading Passed",40,10,0,0,50
1918045,1483351,2025-02-06,Senate,"(S) 3rd Reading Passed",38,11,0,1,50
1918045,1521410,2025-03-19,House,"(H) Judiciary--Be Concurred In",20,0,0,0,20
1918045,1528208,2025-03-26,House,"(H) 2nd Reading Concurred",92,7,0,1,100
1918045,1529491,2025-03-27,House,"(H) 3rd Reading Concurred",90,9,0,1,100
1918094,1481880,2025-01-21,House,"(H) Business and Labor--Do Pass",40,0,0,0,40
1918094,1481882,2025-01-27,House,"(H) 2nd Reading Passed",94,6,0,0,100
1918094,1481883,2025-01-28,House,"(H) 3rd Reading Passed",95,4,0,1,100
1918094,1495628,2025-02-14,Senate,"(S) Business, Labor  and Economic Affairs--Be Concurred In",11,0,0,0,11
1918094,1496501,2025-02-21,Senate,"(S) 2nd Reading Concurred",48,2,0,0,50
1918094,1498001,2025-02-24,Senate,"(S) 3rd Reading Concurred",47,2,0,1,50
1918144,1497008,2025-02-21,Senate,"(S) State Administration--Do Pass",9,0,0,0,9
1918144,1498606,2025-02-21,Senate,"(S) State Administration--To Table",9,0,0,0,9
1918192,1481886,2025-01-30,Senate,"(S) Education and Cultural Resources--Do Pass As Amended",8,6,0,0,14
1918192,1484992,2025-02-10,Senate,"(S) 2nd Reading Passed",35,15,0,0,50
1918192,1486618,2025-02-11,Senate,"(S) 3rd Reading Passed",35,15,0,0,50
1918192,1530236,2025-03-28,House,"(H) Education--To Table",15,0,0,0,15
1918192,1537286,2025-03-28,House,"(H) Education--To Table",15,0,0,0,15
1918192,1550265,2025-04-16,House,"(H) Education--Be Concurred In",9,6,0,0,15
1918192,1553492,2025-04-22,House,"(H) 2nd Reading Not Concurred",34,64,0,2,100
1918241,1481888,2025-01-27,House,"(H) Business and Labor--Do Pass",16,4,0,0,20
1918241,1481889,2025-02-04,House,"(H) 2nd Reading Passed",85,15,0,0,100
1918241,1481890,2025-02-05,House,"(H) 3rd Reading Passed",84,16,0,0,100
1918241,1520012,2025-03-18,Senate,"(S) Energy, Technology & Federal Relations--Be Concurred In",8,0,0,5,13
1918241,1524109,2025-03-21,Senate,"(S) 2nd Reading Concurred",44,6,0,0,50
1918241,1525430,2025-03-24,Senate,"(S) 3rd Reading Concurred",48,2,0,0,50
1918293,1481891,2025-01-30,House,"(H) State Administration--Do Pass",18,1,0,0,19
1918293,1481892,2025-02-03,House,"(H) 2nd Reading Passed",89,10,0,1,100
1918293,1481893,2025-02-04,House,"(H) 3rd Reading Passed",87,13,0,0,100
1918293,1524204,2025-03-21,Senate,"(S) Local Government--Be Concurred In As Amended",11,0,0,0,11
1918293,1540502,2025-04-08,Senate,"(S) 2nd Reading Concurred",46,4,0,0,50
1918293,1541826,2025-04-09,Senate,"(S) 3rd Reading Concurred",44,5,0,1,50
1918293,1548251,2025-01-30,House,"(H) State Administration--Do Pass",18,1,0,0,19
1918293,1551764,2025-04-17,House,"(H) 2nd Reading Senate Amendments Concurred",99,0,0,1,100
1918293,1552209,2025-04-18,House,"(H) 3rd Reading Passed as Amended by Senate",96,2,0,2,100
1918342,1482365,2025-01-29,Senate,"(S) Judiciary--To Table",7,2,0,0,9
1918391,1483651,2025-02-05,Senate,"(S) Judiciary--Do Pass As Amended",6,3,0,0,9
1918391,1489296,2025-02-13,Senate,"(S) 2nd Reading Pass Motion Failed",24,26,0,0,50
1918391,1489297,2025-02-13,Senate,"(S) 2nd Reading Indefinitely Postponed",29,21,0,0,50
1918391,1490509,2025-02-14,Senate,"(S) Motion to Reconsider Failed",25,25,0,0,50
1918438,1481894,2025-01-23,House,"(H) Judiciary--Do Pass",60,0,0,0,60
1918438,1481897,2025-01-28,House,"(H) 2nd Reading Passed",100,0,0,0,100
1918438,1481898,2025-02-05,House,"(H) Appropriations--Do Pass",21,0,0,2,23
1918438,1497048,2025-02-07,House,"(H) 3rd Reading Passed",99,0,0,1,100
1918438,1520210,2025-03-18,Senate,"(S) Judiciary--Be Concurred In",8,0,0,0,8
1918438,1521764,2025-03-19,Senate,"(S) 2nd Reading Concurred",45,5,0,0,50
1918438,1522962,2025-03-20,Senate,"(S) 3rd Reading Concurred",46,4,0,0,50
1918480,1481900,2025-01-27,House,"(H) Business and Labor--Do Pass",12,8,0,0,20
1918480,1481901,2025-01-29,House,"(H) 2nd Reading Passed",58,42,0,0,100
1918480,1481902,2025-01-30,House,"(H) 3rd Reading Passed",58,42,0,0,100
1918480,1497824,2025-02-24,Senate,"(S) Business, Labor  and Economic Affairs--Be Concurred In As Amended",12,0,0,0,12
1918480,1518264,2025-03-15,Senate,"(S) 2nd Reading Concurred",47,3,0,0,50
1918480,1518988,2025-03-17,Senate,"(S) 3rd Reading Concurred",35,14,0,1,50
1918480,1520967,2025-01-27,House,"(H) Business and Labor--Do Pass",12,8,0,0,20
1918480,1520968,2025-03-19,House,"(H) 2nd Reading Senate Amendments Concurred",60,40,0,0,100
1918480,1523909,2025-03-20,House,"(H) 3rd Reading Passed as Amended by Senate",59,39,0,2,100
1918480,1529268,2025-01-27,House,"(H) Business and Labor--Do Pass",12,8,0,0,20
1918537,1483979,2025-02-07,Senate,"(S) Business, Labor  and Economic Affairs--To Table",11,0,0,0,11
1918537,1529955,2025-03-28,Senate,"(S) Taxation--To Table",8,0,0,0,8
1918537,1534824,2025-04-02,Senate,"(S) Taken from Committee; Placed on 2nd Reading",29,21,0,0,50
1918537,1536832,2025-04-03,Senate,"(S) 2nd Reading Indefinitely Postponed",37,12,0,1,50
1918537,1536833,2025-04-03,Senate,"(S) 2nd Reading Pass Motion Failed",20,29,0,1,50
1918579,1481903,2025-01-29,Senate,"(S) Judiciary--Do Pass As Amended",6,3,0,0,9
1918579,1481904,2025-01-31,Senate,"(S) 2nd Reading Passed",34,16,0,0,50
1918579,1481905,2025-02-03,Senate,"(S) 3rd Reading Passed",37,12,0,1,50
1918579,1524636,2025-03-24,House,"(H) Judiciary--Be Concurred In As Amended",12,8,0,0,20
1918579,1540561,2025-04-08,House,"(H) 2nd Reading Concurred",58,40,0,2,100
1918579,1541949,2025-04-09,House,"(H) 3rd Reading Concurred",62,35,0,3,100
1918579,1545889,2025-04-11,Senate,"(S) 2nd Reading House Amendments Concurred",49,1,0,0,50
1918579,1546668,2025-04-12,Senate,"(S) 3rd Reading Passed as Amended by House",40,10,0,0,50
1918626,1481907,2025-01-23,House,"(H) State Administration--Do Pass",18,1,0,0,19
1918626,1481908,2025-01-27,House,"(H) 2nd Reading Passed",96,4,0,0,100
1918626,1481909,2025-01-28,House,"(H) 3rd Reading Passed",94,5,0,1,100
1918626,1484721,2025-02-03,Senate,"(S) State Administration--Be Concurred In",7,2,0,0,9
1918626,1487036,2025-02-11,Senate,"(S) 2nd Reading Concurred",40,10,0,0,50
1918626,1488457,2025-02-12,Senate,"(S) 3rd Reading Concurred",41,9,0,0,50
1918668,1481910,2025-01-23,Senate,"(S) Fish and Game--Do Pass",12,0,0,0,12
1918668,1481911,2025-01-30,Senate,"(S) 2nd Reading Passed",50,0,0,0,50
1918668,1481912,2025-01-31,Senate,"(S) 3rd Reading Passed",50,0,0,0,50
1918668,1533237,2025-04-01,House,"(H) Fish, Wildlife and Parks--Be Concurred In",19,1,0,0,20
1918668,1544458,2025-04-10,House,"(H) 2nd Reading Concurred",100,0,0,0,100
1918668,1546301,2025-04-11,House,"(H) 3rd Reading Concurred",98,1,0,1,100
1918714,1481916,2025-02-04,House,"(H) Business and Labor--Do Pass As Amended",20,0,0,0,20
1918714,1484997,2025-02-10,House,"(H) 2nd Reading Passed",100,0,0,0,100
1918714,1486363,2025-02-04,House,"(H) Business and Labor--Do Pass As Amended",20,0,0,0,20
1918714,1486364,2025-02-11,House,"(H) 3rd Reading Passed",99,0,0,1,100
1918714,1521503,2025-03-19,Senate,"(S) Public Health, Welfare and Safety--Be Concurred In",11,0,0,0,11
1918714,1530288,2025-03-28,Senate,"(S) 2nd Reading Concurred",49,0,0,1,50
1918714,1531259,2025-02-04,House,"(H) Business and Labor--Do Pass As Amended",20,0,0,0,20
1918714,1531260,2025-03-31,Senate,"(S) 3rd Reading Concurred",48,2,0,0,50
1918757,1481918,2025-01-27,House,"(H) Business and Labor--Do Pass",12,8,0,0,20
1918757,1481919,2025-01-29,House,"(H) 2nd Reading Not Passed",49,51,0,0,100
1918757,1576123,2025-01-27,House,"(H) Business and Labor--Do Pass",12,8,0,0,20
1918803,1487423,2025-02-12,House,"(H) Taxation--To Table",21,0,0,0,21
1918845,1481922,2025-01-30,Senate,"(S) 2nd Reading Motion to Amend Carried",50,0,0,0,50
1918845,1481923,2025-01-30,Senate,"(S) 2nd Reading Passed",44,6,0,0,50
1918845,1487850,2025-02-11,Senate,"(S) Finance and Claims--Do Pass As Amended",22,0,0,0,22
1918845,1490714,2025-02-15,Senate,"(S) 2nd Reading Passed",48,2,0,0,50
1918845,1492080,2025-02-18,Senate,"(S) 3rd Reading Passed",47,3,0,0,50
1918845,1536358,2025-04-03,House,"(H) Judiciary--Be Concurred In",20,0,0,0,20
1918845,1541877,2025-04-09,House,"(H) 2nd Reading Concurred",97,3,0,0,100
1918845,1543023,2025-04-09,House,"(H) Appropriations--To Table",12,11,0,0,23
1918845,1544470,2025-04-09,House,"(H) Appropriations--To Table",12,11,0,0,23
1918845,1586534,2025-04-23,House,"(H) Appropriations--To Take From The Table",11,10,2,0,23
1918845,1586535,2025-04-24,House,"(H) Appropriations--To Table",11,12,0,0,23
1918845,1586536,2025-04-25,House,"(H) Motion Failed",49,50,0,1,100
1918889,1490449,2025-02-14,Senate,"(S) Public Health, Welfare and Safety--To Table",6,5,0,0,11
1918889,1497238,2025-02-14,Senate,"(S) Public Health, Welfare and Safety--Do Pass",5,6,0,0,11
1918889,1497719,2025-02-24,Senate,"(S) 2nd Reading Passed",31,19,0,0,50
1918889,1498998,2025-02-25,Senate,"(S) 3rd Reading Passed",30,19,0,1,50
1918889,1538656,2025-04-07,House,"(H) Human Services--Be Concurred In As Amended",21,0,0,0,21
1918889,1543157,2025-04-09,House,"(H) Appropriations--Be Concurred In",21,0,2,0,23
1918889,1545432,2025-04-11,House,"(H) 2nd Reading Concurred",95,5,0,0,100
1918889,1546043,2025-04-11,House,"(H) 3rd Reading Concurred",95,4,0,1,100
1918889,1550163,2025-04-16,Senate,"(S) 2nd Reading House Amendments Concurred",36,14,0,0,50
1918889,1551380,2025-04-17,Senate,"(S) 3rd Reading Passed as Amended by House",31,19,0,0,50
1918933,1498915,2025-02-25,Senate,"(S) 2nd Reading Passed",30,20,0,0,50
1918933,1500651,2025-02-26,Senate,"(S) 3rd Reading Passed",29,21,0,0,50
1918933,1551085,2025-04-17,House,"(H) Business and Labor--Be Concurred In As Amended",12,8,0,0,20
1918933,1553733,2025-04-22,House,"(H) 2nd Reading Concurred",51,49,0,0,100
1918933,1555450,2025-04-23,House,"(H) 3rd Reading Failed",45,54,0,1,100
1918980,1481924,2025-01-30,House,"(H) Fish, Wildlife and Parks--Do Pass As Amended",20,0,0,0,20
1918980,1481925,2025-02-05,House,"(H) 2nd Reading Passed",100,0,0,0,100
1918980,1483294,2025-02-06,House,"(H) 3rd Reading Passed",99,0,0,1,100
1918980,1542161,2025-04-09,Senate,"(S) Natural Resources--Be Concurred In As Amended",11,0,0,0,11
1918980,1545921,2025-04-11,Senate,"(S) 2nd Reading Concurred",48,0,0,2,50
1918980,1546683,2025-04-12,Senate,"(S) 3rd Reading Concurred",49,1,0,0,50
1918980,1549986,2025-04-16,House,"(H) 2nd Reading Senate Amendments Concurred",96,4,0,0,100
1918980,1551806,2025-04-17,House,"(H) 3rd Reading Passed as Amended by Senate",98,1,0,1,100
1918980,1559827,2025-01-30,House,"(H) Fish, Wildlife and Parks--Do Pass As Amended",20,0,0,0,20
1919022,1481926,2025-01-29,House,"(H) State Administration--Do Pass",11,8,0,0,19
1919022,1481927,2025-02-03,House,"(H) 2nd Reading Passed",59,41,0,0,100
1919022,1481928,2025-02-04,House,"(H) 3rd Reading Passed",59,41,0,0,100
1919022,1500610,2025-02-26,Senate,"(S) State Administration--Be Concurred In As Amended",9,0,0,0,9
1919022,1518254,2025-03-15,Senate,"(S) 2nd Reading Concurred",44,6,0,0,50
1919022,1519004,2025-03-17,Senate,"(S) 3rd Reading Concurred",39,10,0,1,50
1919022,1524174,2025-03-21,House,"(H) 2nd Reading Senate Amendments Not Concurred",52,47,0,1,100
1919022,1531129,2025-03-31,House,"(H) 2nd Reading Free Conference Committee Report Adopted",58,42,0,0,100
1919022,1532267,2025-04-01,House,"(H) 3rd Reading Free Conference Committee Report Adopted",57,42,0,1,100
1919022,1536380,2025-04-03,Senate,"(S) 2nd Reading Free Conference Committee Report Adopted",32,18,0,0,50
1919022,1537129,2025-04-04,Senate,"(S) 3rd Reading Free Conference Committee Report Adopted",27,22,0,1,50
1919058,1506993,2025-02-04,Senate,"(S) Finance and Claims--To Table",17,5,0,0,22
1919420,1483068,2025-01-21,House,"(H) Business and Labor--To Table",12,8,0,0,20
1919506,1481931,2025-01-27,House,"(H) Business and Labor--Do Pass",20,0,0,0,20
1919506,1481932,2025-01-29,House,"(H) 2nd Reading Passed",100,0,0,0,100
1919506,1481933,2025-02-03,House,"(H) Appropriations--Do Pass",23,0,0,0,23
1919506,1481934,2025-02-05,House,"(H) 3rd Reading Passed",100,0,0,0,100
1919506,1520753,2025-03-19,Senate,"(S) Business, Labor  and Economic Affairs--Be Concurred In",11,0,0,1,12
1919506,1524071,2025-03-21,Senate,"(S) 2nd Reading Concurred",49,1,0,0,50
1919506,1526105,2025-03-25,Senate,"(S) Finance and Claims--Be Concurred In",22,0,0,0,22
1919506,1527544,2025-03-26,Senate,"(S) 3rd Reading Concurred",49,1,0,0,50
1919506,1530657,2025-01-27,House,"(H) Business and Labor--Do Pass",20,0,0,0,20
1919588,1481936,2025-01-27,House,"(H) Business and Labor--Do Pass As Amended",11,9,0,0,20
1919588,1481937,2025-01-30,House,"(H) 2nd Reading Passed",58,42,0,0,100
1919588,1481938,2025-01-31,House,"(H) 3rd Reading Passed",59,40,0,1,100
1919588,1526860,2025-03-25,Senate,"(S) Business, Labor  and Economic Affairs--Be Concurred In As Amended",11,1,0,0,12
1919588,1529974,2025-03-28,Senate,"(S) 2nd Reading Concurred",32,18,0,0,50
1919588,1531411,2025-03-31,Senate,"(S) 3rd Reading Concurred",32,18,0,0,50
1919588,1545992,2025-04-11,House,"(H) 2nd Reading Senate Amendments Concurred",71,28,0,1,100
1919588,1546484,2025-04-11,House,"(H) 3rd Reading Passed as Amended by Senate",62,37,0,1,100
1919677,1482346,2025-01-29,House,"(H) Taxation--To Table",21,0,0,0,21
1919758,1481939,2025-01-23,House,"(H) Judiciary--Do Pass",33,27,0,0,60
1919758,1481942,2025-01-30,House,"(H) 2nd Reading Not Passed",49,51,0,0,100
1919848,1481943,2025-01-31,House,"(H) State Administration--Do Pass As Amended",11,8,0,0,19
1919848,1483371,2025-02-06,House,"(H) 2nd Reading Motion to Amend Carried",74,26,0,0,100
1919848,1483372,2025-02-06,House,"(H) 2nd Reading Passed as Amended",59,41,0,0,100
1919848,1485673,2025-01-31,House,"(H) State Administration--Do Pass As Amended",11,8,0,0,19
1919848,1485674,2025-02-10,House,"(H) 3rd Reading Passed",59,41,0,0,100
1919848,1539598,2025-04-07,Senate,"(S) State Administration--Be Concurred In As Amended",9,0,0,0,9
1919848,1543372,2025-04-10,Senate,"(S) 2nd Reading Concurred",47,3,0,0,50
1919848,1546374,2025-04-11,Senate,"(S) 3rd Reading Concurred",43,5,0,2,50
1919848,1550074,2025-04-16,House,"(H) 2nd Reading Senate Amendments Concurred",100,0,0,0,100
1919848,1551996,2025-04-17,House,"(H) 3rd Reading Passed as Amended by Senate",63,36,0,1,100
1919926,1483819,2025-02-06,House,"(H) Local Government--Do Pass As Amended",16,1,0,0,17
1919926,1489142,2025-02-13,House,"(H) 2nd Reading Passed",79,21,0,0,100
1919926,1490255,2025-02-14,House,"(H) 3rd Reading Passed",77,17,0,6,100
1919926,1531592,2025-03-31,Senate,"(S) Local Government--Be Concurred In",11,0,0,0,11
1919926,1539637,2025-04-08,Senate,"(S) 2nd Reading Concurred",38,11,0,1,50
1919926,1543113,2025-04-09,Senate,"(S) 3rd Reading Concurred",43,6,0,1,50
1919926,1569351,2025-02-06,House,"(H) Local Government--Do Pass As Amended",16,1,0,0,17
1920036,1481944,2025-01-27,House,"(H) Transportation--Do Pass As Amended",8,6,0,0,14
1920036,1501680,2025-02-26,House,"(H) Transportation--Do Pass As Amended",8,6,0,0,14
1920036,1504431,2025-03-04,House,"(H) 2nd Reading Passed",50,49,0,1,100
1920036,1505979,2025-03-05,House,"(H) 3rd Reading Passed",51,47,0,2,100
1920036,1527960,2025-03-26,Senate,"(S) Highways and Transportation--To Table",8,0,0,0,8
1920036,1530061,2025-03-26,Senate,"(S) Highways and Transportation--To Table",8,0,0,0,8
1920084,1482592,2025-01-27,House,"(H) Business and Labor--To Table",18,2,0,0,20
1920084,1528842,2025-01-27,House,"(H) Business and Labor--To Table",18,2,0,0,20
1920084,1530819,2025-03-31,House,"(H) Business and Labor--Resolution Adopted",11,9,0,0,20
1920084,1537035,2025-04-03,House,"(H) 2nd Reading Not Passed",42,58,0,0,100
1920137,1489592,2025-02-13,House,"(H) Fish, Wildlife and Parks--To Table",17,3,0,0,20
1920137,1560108,2025-02-13,House,"(H) Fish, Wildlife and Parks--To Table",17,3,0,0,20
1920185,1481945,2025-01-30,Senate,"(S) Education and Cultural Resources--Do Pass",9,5,0,0,14
1920185,1481946,2025-02-04,Senate,"(S) 2nd Reading Pass Motion Failed",22,28,0,0,50
1920185,1481947,2025-02-04,Senate,"(S) 2nd Reading Indefinitely Postponed",31,19,0,0,50
1920185,1482381,2025-02-05,Senate,"(S) Reconsidered Previous Action; Placed on 2nd Reading",26,22,0,2,50
1920185,1483780,2025-02-06,Senate,"(S) 2nd Reading Passed",39,11,0,0,50
1920185,1488448,2025-02-11,Senate,"(S) Finance and Claims--To Table",12,10,0,0,22
1920246,1481948,2025-01-30,House,"(H) State Administration--Do Pass",19,0,0,0,19
1920246,1481949,2025-02-03,House,"(H) 2nd Reading Motion to Amend Carried",100,0,0,0,100
1920246,1481950,2025-02-03,House,"(H) 2nd Reading Passed as Amended",100,0,0,0,100
1920246,1481951,2025-02-05,House,"(H) 3rd Reading Passed",100,0,0,0,100
1920246,1531046,2025-03-31,Senate,"(S) State Administration--Be Concurred In As Amended",9,0,0,0,9
1920246,1536364,2025-01-30,House,"(H) State Administration--Do Pass",19,0,0,0,19
1920246,1536365,2025-04-03,Senate,"(S) 2nd Reading Concurred",44,6,0,0,50
1920246,1537344,2025-04-04,Senate,"(S) 3rd Reading Concurred",47,2,0,1,50
1920246,1538983,2025-04-07,House,"(H) 2nd Reading Senate Amendments Concurred",99,0,0,1,100
1920246,1540149,2025-04-08,House,"(H) 3rd Reading Passed as Amended by Senate",97,0,0,3,100
1920296,1482200,2025-02-04,House,"(H) Taxation--To Table",19,2,0,0,21
1920350,1481952,2025-02-03,Senate,"(S) Judiciary--Do Pass",7,2,0,0,9
1920350,1485763,2025-02-10,Senate,"(S) 2nd Reading Passed",31,19,0,0,50
1920350,1486907,2025-02-11,Senate,"(S) 3rd Reading Passed",35,15,0,0,50
1920350,1521259,2025-03-19,House,"(H) Judiciary--Be Concurred In",11,9,0,0,20
1920350,1526128,2025-03-25,House,"(H) 2nd Reading Not Concurred",44,56,0,0,100
1920350,1527492,2025-03-26,House,"(H) Motion to Reconsider Failed",45,53,0,2,100
1920402,1481953,2025-02-03,House,"(H) Judiciary--Do Pass",12,8,0,0,20
1920402,1481954,2025-02-05,House,"(H) 2nd Reading Passed",58,42,0,0,100
1920402,1483359,2025-02-06,House,"(H) 3rd Reading Passed",58,41,0,1,100
1920402,1520728,2025-03-19,Senate,"(S) Judiciary--Be Concurred In",5,0,0,3,8
1920402,1524218,2025-03-21,Senate,"(S) 2nd Reading Concurred",31,19,0,0,50
1920402,1525154,2025-03-24,Senate,"(S) 3rd Reading Concurred",33,17,0,0,50
1920452,1489005,2025-02-13,Senate,"(S) Taxation--To Table",8,0,0,0,8
1920510,1481955,2025-01-29,Senate,"(S) Judiciary--Do Pass",6,3,0,0,9
1920510,1481956,2025-02-03,Senate,"(S) 2nd Reading Passed",28,22,0,0,50
1920510,1481957,2025-02-04,Senate,"(S) 3rd Reading Failed",22,28,0,0,50
1920563,1492847,2025-02-18,Senate,"(S) Energy, Technology & Federal Relations--To Table",10,3,0,0,13
1920616,1481958,2025-01-27,Senate,"(S) Judiciary--Do Pass",6,3,0,0,9
1920616,1481959,2025-01-29,Senate,"(S) 2nd Reading Passed",31,19,0,0,50
1920616,1481960,2025-01-30,Senate,"(S) 3rd Reading Passed",30,19,0,1,50
1920616,1521447,2025-03-19,House,"(H) Judiciary--Be Concurred In As Amended",12,8,0,0,20
1920616,1540326,2025-04-08,House,"(H) 2nd Reading Motion to Amend Carried",64,34,0,2,100
1920616,1540327,2025-04-08,House,"(H) 2nd Reading Concurred as Amended",57,41,0,2,100
1920616,1543333,2025-04-10,House,"(H) 3rd Reading Concurred",56,42,0,2,100
1920616,1545726,2025-04-11,Senate,"(S) 2nd Reading House Amendments Concurred",46,4,0,0,50
1920616,1546642,2025-04-12,Senate,"(S) 3rd Reading Passed as Amended by House",36,14,0,0,50
1920616,1553654,2025-01-27,Senate,"(S) Judiciary--Do Pass",6,3,0,0,9
1920670,1481962,2025-01-27,House,"(H) Business and Labor--Do Pass As Amended",19,1,0,0,20
1920670,1481963,2025-01-31,House,"(H) 2nd Reading Passed",84,15,0,1,100
1920670,1481964,2025-02-03,House,"(H) 3rd Reading Passed",84,15,0,1,100
1920670,1497446,2025-02-24,Senate,"(S) Business, Labor  and Economic Affairs--Be Concurred In",9,3,0,0,12
1920670,1518422,2025-03-17,Senate,"(S) 2nd Reading Concurred",38,12,0,0,50
1920670,1519648,2025-03-18,Senate,"(S) 3rd Reading Concurred",37,12,0,1,50
1920670,1531017,2025-01-27,House,"(H) Business and Labor--Do Pass As Amended",19,1,0,0,20
1920722,1481965,2025-02-03,House,"(H) Judiciary--Do Pass As Amended",12,8,0,0,20
1920722,1486104,2025-02-11,House,"(H) 2nd Reading Passed",58,42,0,0,100
1920722,1487964,2025-02-12,House,"(H) 3rd Reading Passed",58,42,0,0,100
1920722,1520978,2025-03-19,Senate,"(S) Judiciary--Be Concurred In",5,0,0,3,8
1920722,1524168,2025-03-21,Senate,"(S) 2nd Reading Concurred",31,19,0,0,50
1920722,1525087,2025-03-24,Senate,"(S) 3rd Reading Concurred",32,18,0,0,50
1920768,1482343,2025-02-05,Senate,"(S) Public Health, Welfare and Safety--To Table",33,0,0,0,33
1920768,1483472,2025-02-05,Senate,"(S) Public Health, Welfare and Safety--Do Pass",3,8,0,0,11
1920850,1481966,2025-01-31,House,"(H) State Administration--Do Pass As Amended",11,8,0,0,19
1920850,1483616,2025-02-06,House,"(H) 2nd Reading Passed",55,45,0,0,100
1920850,1484276,2025-02-07,House,"(H) 3rd Reading Passed",57,42,0,1,100
1920850,1538744,2025-04-07,Senate,"(S) Local Government--To Table",9,1,0,0,10
1920850,1543121,2025-04-07,Senate,"(S) Local Government--To Table",9,1,0,0,10
1920925,1481967,2025-01-30,House,"(H) Fish, Wildlife and Parks--Do Pass",12,8,0,0,20
1920925,1481968,2025-02-04,House,"(H) 2nd Reading Motion to Amend Failed",46,54,0,0,100
1920925,1481969,2025-02-04,House,"(H) 2nd Reading Passed",57,43,0,0,100
1920925,1481970,2025-02-05,House,"(H) 3rd Reading Passed",57,43,0,0,100
1920925,1523127,2025-03-20,Senate,"(S) Fish and Game--Be Concurred In",8,4,0,0,12
1920925,1527835,2025-03-26,Senate,"(S) 2nd Reading Concurred",32,18,0,0,50
1920925,1529320,2025-03-27,Senate,"(S) 3rd Reading Concurred",31,19,0,0,50
1920925,1560157,2025-01-30,House,"(H) Fish, Wildlife and Parks--Do Pass",12,8,0,0,20
1921007,1481972,2025-01-27,House,"(H) Business and Labor--Do Pass",20,0,0,0,20
1921007,1481973,2025-01-31,House,"(H) 2nd Reading Passed",96,3,0,1,100
1921007,1481974,2025-02-03,House,"(H) 3rd Reading Passed",94,5,0,1,100
1921007,1522361,2025-03-19,Senate,"(S) Business, Labor  and Economic Affairs--Be Concurred In",11,0,0,1,12
1921007,1531460,2025-03-31,Senate,"(S) 2nd Reading Concurred",35,15,0,0,50
1921007,1533546,2025-04-01,Senate,"(S) 3rd Reading Concurred",35,15,0,0,50
1921088,1481975,2025-01-31,House,"(H) Business and Labor--Do Pass As Amended",20,0,0,0,20
1921088,1481976,2025-02-05,House,"(H) 2nd Reading Passed",100,0,0,0,100
1921088,1483286,2025-02-06,House,"(H) 3rd Reading Passed",99,0,0,1,100
1921088,1526037,2025-03-25,Senate,"(S) Business, Labor  and Economic Affairs--Be Concurred In As Amended",12,0,0,0,12
1921088,1539858,2025-04-08,Senate,"(S) 2nd Reading Concurred",44,6,0,0,50
1921088,1541824,2025-04-09,Senate,"(S) 3rd Reading Concurred",43,6,0,1,50
1921088,1551257,2025-04-17,House,"(H) 2nd Reading Senate Amendments Concurred",100,0,0,0,100
1921088,1552130,2025-04-18,House,"(H) 3rd Reading Passed as Amended by Senate",98,0,0,2,100
1921170,1488408,2025-02-12,Senate,"(S) Legislative Administration--Do Pass",6,0,0,0,6
1921170,1498276,2025-02-24,Senate,"(S) 2nd Reading Passed",50,0,0,0,50
1921170,1499477,2025-02-25,Senate,"(S) 3rd Reading Passed",49,0,0,1,50
1921170,1531316,2025-03-31,House,"(H) Legislative Administration--Be Concurred In",14,0,0,0,14
1921170,1553327,2025-04-22,House,"(H) 2nd Reading Concurred",89,10,0,1,100
1921170,1555445,2025-04-23,House,"(H) 3rd Reading Concurred",89,10,0,1,100
1921253,1481977,2025-01-22,House,"(H) Business and Labor--Do Pass",18,2,0,0,20
1921253,1481978,2025-01-28,House,"(H) 2nd Reading Passed",76,24,0,0,100
1921253,1481979,2025-01-29,House,"(H) 3rd Reading Passed",76,24,0,0,100
1921253,1526247,2025-03-25,Senate,"(S) Business, Labor  and Economic Affairs--Be Concurred In",10,2,0,0,12
1921253,1531043,2025-03-31,Senate,"(S) 2nd Reading Concurred",40,10,0,0,50
1921253,1533358,2025-04-01,Senate,"(S) 3rd Reading Concurred",38,12,0,0,50
1921333,1481981,2025-01-27,House,"(H) Business and Labor--Do Pass As Amended",20,0,0,0,20
1921333,1481982,2025-01-31,House,"(H) 2nd Reading Passed",99,0,0,1,100
1921333,1481983,2025-02-03,House,"(H) 3rd Reading Passed",99,0,0,1,100
1921333,1524245,2025-03-21,Senate,"(S) Highways and Transportation--Be Concurred In",7,1,0,0,8
1921333,1528127,2025-03-26,Senate,"(S) 2nd Reading Indefinitely Postponed",43,6,0,1,50
1921333,1528128,2025-03-26,Senate,"(S) 2nd Reading Concur Motion Failed",15,33,0,2,50
1921333,1528919,2025-01-27,House,"(H) Business and Labor--Do Pass As Amended",20,0,0,0,20
1921333,1528920,2025-03-27,Senate,"(S) Reconsidered Previous Action; Placed on 2nd Reading",26,24,0,0,50
1921333,1530363,2025-03-28,Senate,"(S) 2nd Reading Concur Motion Failed",24,26,0,0,50
1921333,1530364,2025-03-28,Senate,"(S) 2nd Reading Indefinitely Postponed",39,11,0,0,50
1921418,1497049,2025-02-04,House,"(H) Taxation--To Table",20,1,0,0,21
1921418,1530084,2025-03-28,House,"(H) Taxation--Do Pass",13,8,0,0,21
1921418,1530085,2025-03-28,House,"(H) Taxation--To Take From The Table",12,4,0,5,21
1921418,1531126,2025-03-31,House,"(H) 2nd Reading Passed",69,30,0,1,100
1921418,1532244,2025-04-01,House,"(H) Appropriations--Do Pass",22,1,0,0,23
1921418,1536502,2025-04-03,House,"(H) 3rd Reading Passed",72,27,0,1,100
1921418,1549583,2025-04-16,Senate,"(S) Taxation--Be Concurred In",5,3,0,0,8
1921418,1551820,2025-04-17,Senate,"(S) 2nd Reading Concurred",28,22,0,0,50
1921418,1576496,2025-02-04,House,"(H) Taxation--To Table",20,1,0,0,21
1921496,1481984,2025-01-23,House,"(H) Fish, Wildlife and Parks--Do Pass As Amended",12,8,0,0,20
1921496,1481985,2025-01-30,House,"(H) 2nd Reading Motion to Amend Carried",52,46,0,2,100
1921496,1481986,2025-01-30,House,"(H) 2nd Reading Not Passed",40,60,0,0,100
1921496,1575842,2025-01-23,House,"(H) Fish, Wildlife and Parks--Do Pass As Amended",12,8,0,0,20
1921583,1481987,2025-01-27,Senate,"(S) 2nd Reading Passed",50,0,0,0,50
1921583,1481988,2025-01-28,Senate,"(S) 3rd Reading Passed",50,0,0,0,50
1921583,1483448,2025-01-23,Senate,"(S) Energy, Technology & Federal Relations--Do Pass",13,0,0,0,13
1921583,1526549,2025-03-25,House,"(H) 2nd Reading Concurred",100,0,0,0,100
1921583,1527932,2025-03-26,House,"(H) 3rd Reading Concurred",99,0,0,1,100
1921583,1534129,2025-04-02,Senate,"(S) 2nd Reading House Amendments Concurred",50,0,0,0,50
1921583,1536064,2025-04-03,Senate,"(S) 3rd Reading Passed as Amended by House",49,1,0,0,50
1921668,1481989,2025-02-03,Senate,"(S) Judiciary--Do Pass",9,0,0,0,9
1921668,1485563,2025-02-10,Senate,"(S) 2nd Reading Passed",40,10,0,0,50
1921668,1486539,2025-02-11,Senate,"(S) 3rd Reading Passed",48,2,0,0,50
1921668,1525524,2025-03-24,House,"(H) Judiciary--Be Concurred In",20,0,0,0,20
1921668,1530631,2025-03-29,House,"(H) 2nd Reading Concurred",100,0,0,0,100
1921668,1531634,2025-03-31,House,"(H) 3rd Reading Concurred",99,0,0,1,100
1921748,1481990,2025-01-30,Senate,"(S) Agriculture, Livestock and Irrigation--Do Pass As Amended",11,0,0,0,11
1921748,1487367,2025-01-30,Senate,"(S) Agriculture, Livestock and Irrigation--Do Pass As Amended",11,0,0,0,11
1921748,1490679,2025-02-15,Senate,"(S) 2nd Reading Passed",48,2,0,0,50
1921748,1492262,2025-02-18,Senate,"(S) 3rd Reading Passed",47,3,0,0,50
1921748,1523327,2025-03-20,House,"(H) Agriculture--Be Concurred In As Amended",17,0,0,0,17
1921748,1530152,2025-03-28,House,"(H) 2nd Reading Motion to Amend Carried",99,0,0,1,100
1921748,1530153,2025-03-28,House,"(H) 2nd Reading Concurred as Amended",99,1,0,0,100
1921748,1532390,2025-04-01,House,"(H) 3rd Reading Concurred",97,2,0,1,100
1921748,1536545,2025-04-03,Senate,"(S) 2nd Reading House Amendments Concurred",46,4,0,0,50
1921748,1537223,2025-04-04,Senate,"(S) 3rd Reading Passed as Amended by House",47,2,0,1,50
1921829,1481991,2025-01-30,House,"(H) Appropriations--Do Pass",23,0,0,0,23
1921829,1481992,2025-02-05,House,"(H) 2nd Reading Passed",100,0,0,0,100
1921829,1483721,2025-02-06,House,"(H) 3rd Reading Passed",99,0,0,1,100
1921829,1524242,2025-03-21,Senate,"(S) Finance and Claims--Be Concurred In",22,0,0,0,22
1921829,1530022,2025-03-28,Senate,"(S) 2nd Reading Concurred",50,0,0,0,50
1921829,1531492,2025-03-31,Senate,"(S) 3rd Reading Concurred",50,0,0,0,50
1921829,1557689,2025-04-24,Senate,"(S) 2nd Reading Governor's Proposed Amendments Adopted",44,4,0,2,50
1921829,1557690,2025-04-24,House,"(H) 2nd Reading Governor's Proposed Amendments Adopted",64,35,0,1,100
1921829,1558302,2025-04-25,House,"(H) 3rd Reading Governor's Proposed Amendments Adopted",95,5,0,0,100
1921829,1558303,2025-04-25,Senate,"(S) 3rd Reading Governor's Proposed Amendments Adopted",48,1,0,1,50
1921829,1558783,2025-04-25,House,"(H) 3rd Reading Governor's Proposed Amendments Adopted",95,5,0,0,100
1921829,1558784,2025-04-25,Senate,"(S) 3rd Reading Governor's Proposed Amendments Adopted",48,1,0,1,50
1921914,1484254,2025-02-07,House,"(H) Natural Resources--To Table",10,4,0,0,14
1921995,1481993,2025-01-28,House,"(H) Business and Labor--Do Pass As Amended",20,0,0,0,20
1921995,1481994,2025-02-03,House,"(H) 2nd Reading Passed",89,11,0,0,100
1921995,1481995,2025-02-04,House,"(H) 3rd Reading Passed",87,13,0,0,100
1921995,1537081,2025-04-04,Senate,"(S) Business, Labor  and Economic Affairs--Be Concurred In",6,5,0,0,11
1921995,1541111,2025-04-08,Senate,"(S) 2nd Reading Concurred",47,3,0,0,50
1921995,1544089,2025-04-10,Senate,"(S) 3rd Reading Concurred",44,4,0,2,50
1921995,1599222,2025-01-28,House,"(H) Business and Labor--Do Pass As Amended",20,0,0,0,20
1922077,1482946,2025-01-30,House,"(H) State Administration--To Table",19,0,0,0,19
1922077,1516020,2025-01-30,House,"(H) State Administration--To Table",19,0,0,0,19
1922857,1497050,2025-01-31,House,"(H) Taxation--Do Pass As Amended",17,4,0,0,21
1922857,1497051,2025-02-06,House,"(H) 2nd Reading Motion to Amend Failed",16,84,0,0,100
1922857,1497052,2025-02-06,House,"(H) 2nd Reading Passed",75,25,0,0,100
1922857,1497053,2025-02-20,House,"(H) Appropriations--Do Pass As Amended",15,8,0,0,23
1922857,1500428,2025-02-26,House,"(H) 2nd Reading Motion to Amend Failed",40,60,0,0,100
1922857,1500429,2025-02-26,House,"(H) 2nd Reading Motion to Amend Failed",30,70,0,0,100
1922857,1500430,2025-02-26,House,"(H) 2nd Reading Motion to Amend Failed",35,65,0,0,100
1922857,1500431,2025-02-26,House,"(H) 2nd Reading Passed",72,27,0,1,100
1922857,1501661,2025-02-27,House,"(H) 3rd Reading Passed",68,30,0,2,100
1922857,1534157,2025-04-02,Senate,"(S) Taxation--To Table",8,0,0,0,8
1922857,1537064,2025-04-02,Senate,"(S) Taxation--To Table",8,0,0,0,8
1922857,1541485,2025-04-09,Senate,"(S) Taxation--To Take From The Table",4,2,2,0,8
1922857,1542389,2025-04-09,Senate,"(S) Taxation--To Take From The Table",4,2,2,0,8
1922857,1550927,2025-04-09,Senate,"(S) Taxation--To Take From The Table",4,2,2,0,8
1922857,1550928,2025-04-16,Senate,"(S) Taxation--Be Concurred In As Amended",6,2,0,0,8
1922857,1551940,2025-04-17,Senate,"(S) 2nd Reading Indefinitely Postponed",26,24,0,0,50
1922857,1551941,2025-04-17,Senate,"(S) 2nd Reading Concur Motion Failed",25,25,0,0,50
1922857,1552111,2025-04-09,Senate,"(S) Taxation--To Take From The Table",4,2,2,0,8
1922857,1552281,2025-04-18,Senate,"(S) Reconsidered Previous Action; Placed on 2nd Reading",26,24,0,0,50
1922857,1554280,2025-04-22,Senate,"(S) 2nd Reading Motion to Amend Carried",27,22,0,1,50
1922857,1554281,2025-04-22,Senate,"(S) 2nd Reading Motion to Amend Carried",44,6,0,0,50
1922857,1554282,2025-04-22,Senate,"(S) 2nd Reading Motion to Amend Failed",24,26,0,0,50
1922857,1554283,2025-04-22,Senate,"(S) 2nd Reading Motion to Amend Failed",24,26,0,0,50
1922857,1554284,2025-04-22,Senate,"(S) 2nd Reading Concurred as Amended",26,24,0,0,50
1922857,1557137,2025-01-31,House,"(H) Taxation--Do Pass As Amended",17,4,0,0,21
1922857,1557138,2025-04-24,Senate,"(S) 3rd Reading Failed",25,25,0,0,50
1922857,1557139,2025-04-24,Senate,"(S) Reconsidered Previous Action; Remains in 3rd Reading Process",28,22,0,0,50
1922857,1558093,2025-04-25,Senate,"(S) 3rd Reading Concurred",25,24,0,1,50
1922857,1558931,2025-04-24,Senate,"(S) Reconsidered Previous Action; Remains in 3rd Reading Process",28,22,0,0,50
1922857,1558932,2025-04-28,House,"(H) 2nd Reading Senate Amendments Not Concurred",71,29,0,0,100
1922857,1561263,2025-04-29,Senate,"(S) 2nd Reading Conference Committee Report Adopted",28,22,0,0,50
1922857,1561885,2025-04-30,House,"(H) 2nd Reading Conference Committee Report Adopted",69,31,0,0,100
1922857,1561886,2025-04-30,House,"(H) 3rd Reading Conference Committee Report Adopted",60,39,0,1,100
1922857,1562488,2025-04-30,Senate,"(S) 3rd Reading Conference Committee Report Adopted",28,22,0,0,50
1923218,1482258,2025-01-28,House,"(H) Human Services--To Table",21,0,0,0,21
1923218,1584762,2025-01-28,House,"(H) Human Services--To Table",21,0,0,0,21
1923783,1481996,2025-01-29,Senate,"(S) Judiciary--Do Pass",6,3,0,0,9
1923783,1481997,2025-02-03,Senate,"(S) 2nd Reading Passed",30,19,0,1,50
1923783,1481998,2025-02-04,Senate,"(S) 3rd Reading Passed",30,20,0,0,50
1923783,1528699,2025-03-27,House,"(H) Judiciary--Be Concurred In As Amended",12,8,0,0,20
1923783,1539792,2025-04-08,House,"(H) 2nd Reading Not Concurred",40,58,0,2,100
1924336,1481999,2025-02-03,Senate,"(S) Local Government--Do Pass",11,0,0,0,11
1924336,1483309,2025-02-06,Senate,"(S) 2nd Reading Passed",43,6,0,1,50
1924336,1484099,2025-02-07,Senate,"(S) 3rd Reading Passed",47,2,0,1,50
1924336,1521572,2025-03-19,House,"(H) Judiciary--Be Concurred In",12,8,0,0,20
1924336,1529703,2025-03-27,House,"(H) 2nd Reading Concurred",58,42,0,0,100
1924336,1530366,2025-03-28,House,"(H) 3rd Reading Concurred",58,41,0,1,100
1924464,1482000,2025-01-28,House,"(H) Business and Labor--Do Pass",20,0,0,0,20
1924464,1482001,2025-01-30,House,"(H) 2nd Reading Passed",99,1,0,0,100
1924464,1482002,2025-01-31,House,"(H) 3rd Reading Passed",98,1,0,1,100
1924464,1495889,2025-01-28,House,"(H) Business and Labor--Do Pass",20,0,0,0,20
1924464,1521375,2025-03-19,Senate,"(S) Business, Labor  and Economic Affairs--Be Concurred In",11,0,0,1,12
1924464,1529600,2025-01-28,House,"(H) Business and Labor--Do Pass",20,0,0,0,20
1924464,1530214,2025-03-28,Senate,"(S) 2nd Reading Concurred",46,4,0,0,50
1924464,1531218,2025-03-31,Senate,"(S) 3rd Reading Concurred",48,2,0,0,50
1924584,1482004,2025-02-04,House,"(H) 2nd Reading Not Passed",30,70,0,0,100
1924703,1482005,2025-01-30,Senate,"(S) Fish and Game--Do Pass As Amended",11,1,0,0,12
1924703,1482006,2025-02-04,Senate,"(S) 2nd Reading Passed",45,5,0,0,50
1924703,1487165,2025-02-11,Senate,"(S) Finance and Claims--Do Pass",21,1,0,0,22
1924703,1490282,2025-02-14,Senate,"(S) 3rd Reading Passed",43,7,0,0,50
1924703,1527155,2025-03-25,House,"(H) Fish, Wildlife and Parks--Be Concurred In",20,0,0,0,20
1924703,1528449,2025-03-25,House,"(H) Fish, Wildlife and Parks--Be Concurred In",20,0,0,0,20
1924703,1530146,2025-03-28,House,"(H) 2nd Reading Concurred",100,0,0,0,100
1924703,1532319,2025-04-01,House,"(H) 3rd Reading Concurred",99,0,0,1,100
1924703,1535549,2025-03-31,House,"(H) Appropriations--Be Concurred In",22,0,1,0,23
1924825,1482007,2025-01-31,House,"(H) Business and Labor--Do Pass As Amended",20,0,0,0,20
1924825,1482008,2025-02-05,House,"(H) 2nd Reading Passed",98,2,0,0,100
1924825,1483369,2025-02-06,House,"(H) 3rd Reading Passed",97,2,0,1,100
1924825,1522344,2025-03-19,Senate,"(S) Highways and Transportation--Be Concurred In",8,0,0,0,8
1924825,1526281,2025-03-25,Senate,"(S) 2nd Reading Concurred",50,0,0,0,50
1924825,1527755,2025-03-26,Senate,"(S) 3rd Reading Concurred",48,2,0,0,50
1924825,1529934,2025-01-31,House,"(H) Business and Labor--Do Pass As Amended",20,0,0,0,20
1924944,1488030,2025-02-12,House,"(H) Business and Labor--Do Pass As Amended",20,0,0,0,20
1924944,1495602,2025-02-20,House,"(H) 2nd Reading Passed",96,4,0,0,100
1924944,1496440,2025-02-21,House,"(H) 3rd Reading Passed",98,0,0,2,100
1924944,1526199,2025-03-25,Senate,"(S) Business, Labor  and Economic Affairs--Be Concurred In",12,0,0,0,12
1924944,1533970,2025-02-12,House,"(H) Business and Labor--Do Pass As Amended",20,0,0,0,20
1924944,1552074,2025-04-18,Senate,"(S) 2nd Reading Concurred",31,19,0,0,50
1924944,1553971,2025-04-22,Senate,"(S) 3rd Reading Concurred",38,12,0,0,50
1925068,1482009,2025-01-22,House,"(H) Appropriations--Do Pass As Amended",23,0,0,0,23
1925068,1482010,2025-01-28,House,"(H) 2nd Reading Passed",97,3,0,0,100
1925068,1482011,2025-01-29,House,"(H) 3rd Reading Passed",97,3,0,0,100
1925068,1522501,2025-03-20,Senate,"(S) Finance and Claims--Be Concurred In",21,1,0,0,22
1925068,1529555,2025-03-27,Senate,"(S) 2nd Reading Concurred",48,1,0,1,50
1925068,1530414,2025-03-28,Senate,"(S) 3rd Reading Concurred",46,2,0,2,50
1925188,1482295,2025-01-30,House,"(H) Human Services--To Table",11,10,0,0,21
1925188,1489868,2025-02-13,House,"(H) Human Services--Do Pass As Amended",21,0,0,0,21
1925188,1492706,2025-02-18,House,"(H) 2nd Reading Passed",83,17,0,0,100
1925188,1494162,2025-02-19,House,"(H) 3rd Reading Passed",82,18,0,0,100
1925188,1520780,2025-03-19,Senate,"(S) Judiciary--To Table",5,0,0,3,8
1925188,1530193,2025-03-19,Senate,"(S) Judiciary--To Table",5,0,0,3,8
1925188,1576816,2025-02-13,House,"(H) Human Services--Do Pass As Amended",21,0,0,0,21
1925309,1482019,2025-01-31,House,"(H) Natural Resources--",14,0,0,0,14
1925309,1482020,2025-02-05,House,"(H) Resolution Adopted",93,7,0,0,100
1925429,1482022,2025-02-05,House,"(H) Business and Labor--Do Pass As Amended",40,0,0,0,40
1925429,1486084,2025-02-11,House,"(H) 2nd Reading Passed",100,0,0,0,100
1925429,1487645,2025-02-12,House,"(H) 3rd Reading Passed",100,0,0,0,100
1925429,1522466,2025-03-20,Senate,"(S) Business, Labor  and Economic Affairs--Be Concurred In",12,0,0,0,12
1925429,1530495,2025-03-28,Senate,"(S) 2nd Reading Concurred",49,0,0,1,50
1925429,1530997,2025-02-05,House,"(H) Business and Labor--Do Pass As Amended",20,0,0,0,20
1925429,1530998,2025-03-31,Senate,"(S) 3rd Reading Concurred",50,0,0,0,50
1925548,1482024,2025-01-29,House,"(H) Judiciary--Do Pass As Amended",11,9,0,0,20
1925548,1483996,2025-02-07,House,"(H) 2nd Reading Motion to Amend Carried",64,36,0,0,100
1925548,1484284,2025-02-07,House,"(H) 2nd Reading Passed as Amended",60,40,0,0,100
1925548,1486213,2025-02-11,House,"(H) 3rd Reading Passed",63,36,0,1,100
1925548,1524091,2025-03-21,Senate,"(S) Local Government--Be Concurred In",11,0,0,0,11
1925548,1531413,2025-03-31,Senate,"(S) 2nd Reading Concurred",42,8,0,0,50
1925548,1532813,2025-04-01,Senate,"(S) 3rd Reading Concurred",42,8,0,0,50
1925786,1482848,2025-01-30,House,"(H) Judiciary--To Table",20,0,0,0,20
1925786,1559603,2025-01-30,House,"(H) Judiciary--To Table",20,0,0,0,20
1926902,1483477,2025-02-06,House,"(H) Fish, Wildlife and Parks--Do Pass",20,0,0,0,20
1926902,1486289,2025-02-11,House,"(H) 2nd Reading Passed",100,0,0,0,100
1926902,1487539,2025-02-12,House,"(H) 3rd Reading Passed",100,0,0,0,100
1926902,1526224,2025-03-25,Senate,"(S) Fish and Game--Be Concurred In",12,0,0,0,12
1926902,1531336,2025-03-31,Senate,"(S) 2nd Reading Concurred",50,0,0,0,50
1926902,1532655,2025-04-01,Senate,"(S) 3rd Reading Concurred",50,0,0,0,50
1926993,1482821,2025-01-29,House,"(H) Taxation--To Table",13,8,0,0,21
1927086,1489420,2025-02-13,House,"(H) Fish, Wildlife and Parks--Do Pass As Amended",20,0,0,0,20
1927086,1493292,2025-02-19,House,"(H) 2nd Reading Passed",100,0,0,0,100
1927086,1495508,2025-02-20,House,"(H) 3rd Reading Passed",99,0,0,1,100
1927086,1540603,2025-04-08,Senate,"(S) Fish and Game--Be Concurred In",11,0,0,0,11
1927086,1544629,2025-04-10,Senate,"(S) 2nd Reading Concurred",47,2,0,1,50
1927086,1545898,2025-04-11,Senate,"(S) 3rd Reading Concurred",46,2,0,2,50
1927188,1482025,2025-02-04,House,"(H) Human Services--Do Pass As Amended",15,6,0,0,21
1927188,1485355,2025-02-10,House,"(H) 2nd Reading Passed",91,8,0,1,100
1927188,1486729,2025-02-11,House,"(H) 3rd Reading Passed",92,7,0,1,100
1927188,1521681,2025-03-19,Senate,"(S) Public Health, Welfare and Safety--Be Concurred In",11,0,0,0,11
1927188,1530027,2025-03-28,Senate,"(S) 2nd Reading Concurred",48,0,0,2,50
1927188,1531354,2025-03-31,Senate,"(S) 3rd Reading Concurred",50,0,0,0,50
1927297,1482028,2025-02-03,House,"(H) Education--Do Pass",75,0,0,0,75
1927297,1497054,2025-02-06,House,"(H) 2nd Reading Passed",100,0,0,0,100
1927297,1497055,2025-02-07,House,"(H) 3rd Reading Passed",99,0,0,1,100
1927297,1529479,2025-03-27,Senate,"(S) Education and Cultural Resources--Be Concurred In As Amended",14,0,0,0,14
1927297,1532288,2025-04-01,Senate,"(S) 2nd Reading Concurred",47,0,0,3,50
1927297,1534461,2025-04-02,Senate,"(S) 3rd Reading Concurred",49,1,0,0,50
1927297,1545893,2025-02-03,House,"(H) Education--Do Pass",15,0,0,0,15
1927297,1545894,2025-04-11,House,"(H) 2nd Reading Senate Amendments Concurred",100,0,0,0,100
1927297,1546355,2025-04-11,House,"(H) 3rd Reading Passed as Amended by Senate",98,1,0,1,100
1927410,1482033,2025-01-29,House,"(H) Business and Labor--Do Pass",20,0,0,0,20
1927410,1482034,2025-02-04,House,"(H) 2nd Reading Passed",99,1,0,0,100
1927410,1482035,2025-02-05,House,"(H) 3rd Reading Passed",100,0,0,0,100
1927410,1523134,2025-03-20,Senate,"(S) Business, Labor  and Economic Affairs--Be Concurred In",12,0,0,0,12
1927410,1530287,2025-03-28,Senate,"(S) 2nd Reading Concurred",36,13,0,1,50
1927410,1531011,2025-03-31,Senate,"(S) 3rd Reading Concurred",34,16,0,0,50
1927528,1482036,2025-01-31,House,"(H) State Administration--Do Pass",19,0,0,0,19
1927528,1483682,2025-02-06,House,"(H) 2nd Reading Passed",100,0,0,0,100
1927528,1484248,2025-02-07,House,"(H) 3rd Reading Passed",97,2,0,1,100
1927528,1526842,2025-03-21,Senate,"(S) State Administration--Be Concurred In",9,0,0,0,9
1927528,1531633,2025-03-31,Senate,"(S) 2nd Reading Concurred",50,0,0,0,50
1927528,1533724,2025-04-01,Senate,"(S) 3rd Reading Concurred",50,0,0,0,50
1927641,1482037,2025-01-29,House,"(H) Judiciary--Do Pass",20,0,0,0,20
1927641,1482038,2025-02-04,House,"(H) 2nd Reading Passed",80,20,0,0,100
1927641,1482039,2025-02-05,House,"(H) 3rd Reading Passed",84,16,0,0,100
1927641,1523380,2025-03-20,Senate,"(S) Judiciary--To Table",8,0,0,0,8
1927641,1523381,2025-03-20,Senate,"(S) Judiciary--Be Concurred In",4,4,0,0,8
1927641,1530425,2025-03-20,Senate,"(S) Judiciary--To Table",8,0,0,0,8
1927641,1556428,2025-04-24,Senate,"(S) Judiciary--To Take From The Table",4,1,3,0,8
1927641,1583072,2025-03-20,Senate,"(S) Judiciary--To Table",8,0,0,0,8
1927641,1583073,2025-04-24,Senate,"(S) Judiciary--Be Concurred In",7,0,1,0,8
1927641,1583074,2025-04-25,Senate,"(S) 2nd Reading Pass Motion Failed",16,34,0,0,50
1927641,1583075,2025-04-25,Senate,"(S) 2nd Reading Indefinitely Postponed",42,8,0,0,50
1927753,1482040,2025-01-28,House,"(H) Business and Labor--Do Pass",20,0,0,0,20
1927753,1482041,2025-02-03,House,"(H) 2nd Reading Passed",100,0,0,0,100
1927753,1482042,2025-02-04,House,"(H) 3rd Reading Passed",100,0,0,0,100
1927753,1496785,2025-01-28,House,"(H) Business and Labor--Do Pass",20,0,0,0,20
1927753,1503020,2025-03-01,Senate,"(S) Business, Labor  and Economic Affairs--Be Concurred In",12,0,0,0,12
1927753,1518918,2025-03-17,Senate,"(S) 2nd Reading Concurred",50,0,0,0,50
1927753,1520177,2025-03-18,Senate,"(S) 3rd Reading Concurred",49,0,0,1,50
1927875,1482929,2025-02-05,House,"(H) Education--Do Pass As Amended",15,0,0,0,15
1927875,1485187,2025-02-10,House,"(H) 2nd Reading Passed",93,7,0,0,100
1927875,1491341,2025-02-17,House,"(H) Appropriations--Do Pass As Amended",20,2,0,1,23
1927875,1496523,2025-02-21,House,"(H) 2nd Reading Passed",92,8,0,0,100
1927875,1497112,2025-02-22,House,"(H) 3rd Reading Passed",88,9,0,3,100
1927875,1536842,2025-04-03,Senate,"(S) Education and Cultural Resources--Be Concurred In",10,4,0,0,14
1927875,1548333,2025-04-15,Senate,"(S) 2nd Reading Concurred",40,10,0,0,50
1927875,1552200,2025-04-18,Senate,"(S) Finance and Claims--Be Concurred In",22,0,0,0,22
1927875,1553700,2025-04-22,Senate,"(S) 3rd Reading Concurred",43,7,0,0,50
1927988,1482045,2025-02-03,House,"(H) Education--Do Pass",60,15,0,0,75
1927988,1497056,2025-02-10,House,"(H) 2nd Reading Passed",87,13,0,0,100
1927988,1497057,2025-02-11,House,"(H) 3rd Reading Passed",85,14,0,1,100
1927988,1529435,2025-03-27,Senate,"(S) Education and Cultural Resources--Be Concurred In",14,0,0,0,14
1927988,1540575,2025-04-08,Senate,"(S) 2nd Reading Concurred",48,2,0,0,50
1927988,1543525,2025-04-10,Senate,"(S) 3rd Reading Concurred",47,1,0,2,50
1927988,1545340,2025-02-03,House,"(H) Education--Do Pass",12,3,0,0,15
1928105,1482050,2025-01-29,House,"(H) Business and Labor--Do Pass",19,1,0,0,20
1928105,1482051,2025-01-31,House,"(H) 2nd Reading Passed",89,10,0,1,100
1928105,1482052,2025-02-03,House,"(H) 3rd Reading Passed",86,13,0,1,100
1928105,1520232,2025-03-18,Senate,"(S) Energy, Technology & Federal Relations--Be Concurred In",8,0,0,5,13
1928105,1524148,2025-03-21,Senate,"(S) 2nd Reading Concurred",48,2,0,0,50
1928105,1525020,2025-03-24,Senate,"(S) 3rd Reading Concurred",46,4,0,0,50
1928105,1531497,2025-01-29,House,"(H) Business and Labor--Do Pass",19,1,0,0,20
1928219,1482053,2025-01-28,House,"(H) Human Services--Do Pass",14,7,0,0,21
1928219,1484147,2025-02-07,House,"(H) 2nd Reading Motion to Amend Failed",35,65,0,0,100
1928219,1484148,2025-02-07,House,"(H) 2nd Reading Passed",63,37,0,0,100
1928219,1484149,2025-02-07,House,"(H) Motion Failed",38,61,0,1,100
1928219,1485363,2025-02-10,House,"(H) 3rd Reading Passed",63,37,0,0,100
1928219,1491302,2025-02-17,Senate,"(S) Public Health, Welfare and Safety--Be Concurred In",6,5,0,0,11
1928219,1495569,2025-02-20,Senate,"(S) 2nd Reading Concurred",29,21,0,0,50
1928219,1499208,2025-02-25,Senate,"(S) Finance and Claims--Be Concurred In",13,9,0,0,22
1928219,1501769,2025-02-27,Senate,"(S) 3rd Reading Concurred",30,20,0,0,50
1928343,1483172,2025-02-06,Senate,"(S) Taxation--Do Pass As Amended",8,0,0,0,8
1928343,1486233,2025-02-11,Senate,"(S) 2nd Reading Passed",42,8,0,0,50
1928343,1487519,2025-02-12,Senate,"(S) 3rd Reading Passed",38,12,0,0,50
1928343,1496244,2025-02-21,House,"(H) Taxation--Be Concurred In",13,8,0,0,21
1928343,1523055,2025-03-20,House,"(H) 2nd Reading Motion to Amend Failed",38,62,0,0,100
1928343,1523056,2025-03-20,House,"(H) 2nd Reading Concurred",58,42,0,0,100
1928343,1524092,2025-03-21,House,"(H) 3rd Reading Concurred",57,40,0,3,100
1928390,1485435,2025-02-10,Senate,"(S) Local Government--Do Pass As Amended",9,2,0,0,11
1928390,1490683,2025-02-15,Senate,"(S) 2nd Reading Passed",42,8,0,0,50
1928390,1492340,2025-02-18,Senate,"(S) 3rd Reading Passed",44,6,0,0,50
1928390,1540983,2025-04-08,House,"(H) Local Government--Be Concurred In",10,7,0,0,17
1928390,1544810,2025-04-10,House,"(H) 2nd Reading Concurred",63,37,0,0,100
1928390,1546399,2025-04-11,House,"(H) 3rd Reading Concurred",64,35,0,1,100
1928439,1482494,2025-02-05,Senate,"(S) Public Health, Welfare and Safety--Do Pass",27,6,0,0,33
1928439,1484674,2025-02-10,Senate,"(S) 2nd Reading Passed",33,17,0,0,50
1928439,1486314,2025-02-05,Senate,"(S) Public Health, Welfare and Safety--Do Pass",9,2,0,0,11
1928439,1486315,2025-02-11,Senate,"(S) 3rd Reading Passed",34,16,0,0,50
1928439,1493855,2025-02-19,House,"(H) Human Services--Be Concurred In",21,0,0,0,21
1928439,1497354,2025-02-19,House,"(H) Human Services--Be Concurred In",21,0,0,0,21
1928439,1523310,2025-03-20,House,"(H) 2nd Reading Concurred",62,38,0,0,100
1928439,1524212,2025-03-21,House,"(H) 3rd Reading Concurred",57,40,0,3,100
1928488,1482054,2025-01-29,Senate,"(S) Business, Labor  and Economic Affairs--Do Pass",11,0,0,0,11
1928488,1486966,2025-01-29,Senate,"(S) Business, Labor  and Economic Affairs--Do Pass",11,0,0,0,11
1928488,1490724,2025-02-15,Senate,"(S) 2nd Reading Passed",49,1,0,0,50
1928488,1492833,2025-02-18,Senate,"(S) 3rd Reading Passed",48,2,0,0,50
1928488,1521510,2025-03-19,House,"(H) Business and Labor--Be Concurred In As Amended",20,0,0,0,20
1928488,1529230,2025-03-27,House,"(H) 2nd Reading Concurred",100,0,0,0,100
1928488,1530460,2025-03-28,House,"(H) 3rd Reading Concurred",99,0,0,1,100
1928488,1536622,2025-04-03,Senate,"(S) 2nd Reading House Amendments Concurred",47,3,0,0,50
1928488,1537402,2025-04-04,Senate,"(S) 3rd Reading Passed as Amended by House",48,1,0,1,50
1928541,1482057,2025-02-03,House,"(H) Natural Resources--Do Pass",14,0,0,0,14
1928541,1483540,2025-02-06,House,"(H) 2nd Reading Passed",88,12,0,0,100
1928541,1535911,2025-04-03,House,"(H) Appropriations--To Table",19,4,0,0,23
1928589,1492686,2025-02-18,House,"(H) Fish, Wildlife and Parks--Do Pass",12,8,0,0,20
1928589,1497882,2025-02-24,House,"(H) 2nd Reading Motion to Amend Carried",91,9,0,0,100
1928589,1497883,2025-02-24,House,"(H) 2nd Reading Passed as Amended",57,42,0,1,100
1928589,1500283,2025-02-26,House,"(H) 3rd Reading Passed",57,43,0,0,100
1928589,1523261,2025-03-20,Senate,"(S) Fish and Game--Be Concurred In As Amended",8,4,0,0,12
1928589,1530335,2025-03-28,Senate,"(S) 2nd Reading Concurred",31,19,0,0,50
1928589,1531352,2025-03-31,Senate,"(S) 3rd Reading Concurred",31,19,0,0,50
1928589,1546034,2025-04-11,House,"(H) 2nd Reading Senate Amendments Concurred",91,8,0,1,100
1928589,1546394,2025-04-11,House,"(H) 3rd Reading Not Passed as Amended by Senate",44,54,0,2,100
1928639,1482058,2025-01-29,House,"(H) Energy, Technology and Federal Relations--Do Pass As Amended",13,1,0,0,14
1928639,1482059,2025-02-04,House,"(H) 2nd Reading Passed",89,11,0,0,100
1928639,1482060,2025-02-05,House,"(H) 3rd Reading Passed",90,10,0,0,100
1928639,1520307,2025-03-18,Senate,"(S) Energy, Technology & Federal Relations--Be Concurred In",8,0,0,5,13
1928639,1524167,2025-03-21,Senate,"(S) 2nd Reading Concurred",48,2,0,0,50
1928639,1525055,2025-03-24,Senate,"(S) 3rd Reading Concurred",49,1,0,0,50
1928697,1483419,2025-02-06,House,"(H) Fish, Wildlife and Parks--Do Pass",12,8,0,0,20
1928697,1497780,2025-02-24,House,"(H) 2nd Reading Motion to Amend Failed",43,57,0,0,100
1928697,1497781,2025-02-24,House,"(H) 2nd Reading Passed",55,45,0,0,100
1928697,1499043,2025-02-25,House,"(H) 3rd Reading Passed",56,44,0,0,100
1928697,1526642,2025-03-25,Senate,"(S) Fish and Game--Be Concurred In As Amended",8,4,0,0,12
1928697,1530053,2025-03-28,Senate,"(S) 2nd Reading Concurred",32,18,0,0,50
1928697,1531438,2025-03-31,Senate,"(S) 3rd Reading Concurred",32,18,0,0,50
1928697,1546149,2025-04-11,House,"(H) 2nd Reading Senate Amendments Concurred",95,4,0,1,100
1928697,1546150,2025-04-11,House,"(H) 3rd Reading Passed as Amended by Senate",56,43,0,1,100
1928697,1560084,2025-02-06,House,"(H) Fish, Wildlife and Parks--Do Pass",12,8,0,0,20
1928743,1482823,2025-01-29,Senate,"(S) Taxation--To Table",8,0,0,0,8
1928792,1483620,2025-02-04,Senate,"(S) Finance and Claims--Do Pass",15,7,0,0,22
1928792,1485785,2025-02-10,Senate,"(S) 2nd Reading Passed",27,23,0,0,50
1928792,1486200,2025-02-11,Senate,"(S) 3rd Reading Passed",32,18,0,0,50
1928792,1540508,2025-04-08,House,"(H) Appropriations--To Table",19,4,0,0,23
1928792,1544648,2025-04-08,House,"(H) Appropriations--To Table",19,4,0,0,23
1928841,1483575,2025-02-04,Senate,"(S) Finance and Claims--Do Pass As Amended",22,0,0,0,22
1928841,1489049,2025-02-13,Senate,"(S) 2nd Reading Passed",46,4,0,0,50
1928841,1490419,2025-02-14,Senate,"(S) 3rd Reading Passed",48,2,0,0,50
1928841,1529485,2025-03-27,House,"(H) Appropriations--Be Concurred In As Amended",21,0,0,2,23
1928841,1533376,2025-04-01,House,"(H) 2nd Reading Concurred",88,12,0,0,100
1928841,1534465,2025-04-02,House,"(H) 3rd Reading Concurred",81,14,0,5,100
1928841,1538568,2025-04-07,Senate,"(S) 2nd Reading House Amendments Concurred",44,6,0,0,50
1928841,1539717,2025-04-08,Senate,"(S) 3rd Reading Passed as Amended by House",42,6,0,2,50
1928895,1482063,2025-02-03,House,"(H) Education--Do Pass",75,0,0,0,75
1928895,1497058,2025-02-07,House,"(H) 2nd Reading Passed",98,2,0,0,100
1928895,1497059,2025-02-10,House,"(H) 3rd Reading Passed",98,2,0,0,100
1928895,1540798,2025-04-08,Senate,"(S) Education and Cultural Resources--To Table",14,0,0,0,14
1928895,1542251,2025-04-08,Senate,"(S) Education and Cultural Resources--To Table",14,0,0,0,14
1928895,1545408,2025-02-03,House,"(H) Education--Do Pass",15,0,0,0,15
1928895,1583025,2025-04-08,Senate,"(S) Education and Cultural Resources--To Table",14,0,0,0,14
1928947,1482070,2025-02-03,House,"(H) Education--Do Pass",75,0,0,0,75
1928947,1497060,2025-02-07,House,"(H) 2nd Reading Passed",99,1,0,0,100
1928947,1497061,2025-02-10,House,"(H) 3rd Reading Passed",99,1,0,0,100
1928947,1528139,2025-03-20,Senate,"(S) Education and Cultural Resources--Be Concurred In",13,1,0,0,14
1928947,1531696,2025-03-31,Senate,"(S) 2nd Reading Concurred",48,2,0,0,50
1928947,1533236,2025-04-01,Senate,"(S) 3rd Reading Concurred",48,2,0,0,50
1928947,1550967,2025-02-03,House,"(H) Education--Do Pass",15,0,0,0,15
1928999,1489260,2025-02-13,Senate,"(S) Taxation--To Table",8,0,0,0,8
1929964,1502386,2025-02-28,Senate,"(S) Judiciary--To Table",0,8,0,0,8
1929964,1502387,2025-02-28,Senate,"(S) Judiciary--Do Pass As Amended",2,6,0,0,8
1929991,1485259,2025-02-10,Senate,"(S) Local Government--Do Pass As Amended",11,0,0,0,11
1929991,1490324,2025-02-14,Senate,"(S) 3rd Reading Passed",49,1,0,0,50
1929991,1536644,2025-04-03,House,"(H) Local Government--Be Concurred In As Amended",17,0,0,0,17
1929991,1543631,2025-04-10,House,"(H) 2nd Reading Concurred",97,1,0,2,100
1929991,1546382,2025-04-11,House,"(H) 3rd Reading Concurred",99,0,0,1,100
1929991,1550097,2025-04-16,Senate,"(S) 2nd Reading House Amendments Concurred",48,2,0,0,50
1929991,1551291,2025-04-17,Senate,"(S) 3rd Reading Passed as Amended by House",50,0,0,0,50
1930020,1482075,2025-02-03,Senate,"(S) Local Government--Do Pass As Amended",11,0,0,0,11
1930020,1483289,2025-02-06,Senate,"(S) 2nd Reading Passed",48,1,0,1,50
1930020,1484145,2025-02-07,Senate,"(S) 3rd Reading Passed",49,0,0,1,50
1930020,1529831,2025-03-27,House,"(H) Local Government--Be Concurred In",17,0,0,0,17
1930020,1531127,2025-03-31,House,"(H) 2nd Reading Concurred",98,2,0,0,100
1930020,1533333,2025-04-01,House,"(H) 3rd Reading Concurred",97,2,0,1,100
1930050,1482076,2025-01-28,House,"(H) Business and Labor--Do Pass",20,0,0,0,20
1930050,1482077,2025-01-31,House,"(H) 2nd Reading Passed",98,1,0,1,100
1930050,1482078,2025-02-03,House,"(H) 3rd Reading Passed",94,5,0,1,100
1930050,1521774,2025-03-19,Senate,"(S) Business, Labor  and Economic Affairs--Be Concurred In",11,0,0,1,12
1930050,1530033,2025-03-28,Senate,"(S) 2nd Reading Concurred",47,3,0,0,50
1930050,1530958,2025-03-31,Senate,"(S) 3rd Reading Concurred",45,5,0,0,50
1930081,1484401,2025-02-07,House,"(H) Education--Do Pass As Amended",15,0,0,0,15
1930081,1489470,2025-02-13,House,"(H) 2nd Reading Passed",100,0,0,0,100
1930081,1490605,2025-02-14,House,"(H) 3rd Reading Passed",94,0,0,6,100
1930081,1527401,2025-03-20,Senate,"(S) Education and Cultural Resources--To Table",14,0,0,0,14
1930081,1569577,2025-02-07,House,"(H) Education--Do Pass As Amended",15,0,0,0,15
1930133,1497071,2025-02-10,Senate,"(S) Natural Resources--Do Pass As Amended",11,0,0,0,11
1930133,1497072,2025-02-14,Senate,"(S) 3rd Reading Passed",33,17,0,0,50
1930133,1592199,2025-04-07,House,"(H) Natural Resources--Be Concurred In As Amended",14,0,0,0,14
1930133,1592200,2025-04-10,House,"(H) 2nd Reading Concurred",94,6,0,0,100
1930133,1592201,2025-04-11,House,"(H) 3rd Reading Concurred",99,0,0,1,100
1930133,1592202,2025-04-16,Senate,"(S) 2nd Reading House Amendments Concurred",43,7,0,0,50
1930133,1592203,2025-04-17,Senate,"(S) 3rd Reading Passed as Amended by House",47,3,0,0,50
1930185,1482079,2025-01-30,Senate,"(S) Education and Cultural Resources--Do Pass",12,2,0,0,14
1930185,1482190,2025-02-05,Senate,"(S) 2nd Reading Passed",40,10,0,0,50
1930185,1483650,2025-02-06,Senate,"(S) 3rd Reading Passed",38,11,0,1,50
1930185,1530487,2025-03-28,House,"(H) Education--Be Concurred In",9,6,0,0,15
1930185,1543818,2025-04-10,House,"(H) 2nd Reading Concurred",58,42,0,0,100
1930185,1546071,2025-04-11,House,"(H) 3rd Reading Concurred",57,42,0,1,100
1930234,1482080,2025-01-29,Senate,"(S) Business, Labor  and Economic Affairs--",11,0,0,0,11
1930234,1482081,2025-01-29,Senate,"(S) Business, Labor  and Economic Affairs--Do Pass",5,6,0,0,11
1930234,1507218,2025-03-05,Senate,"(S) Motion Failed",19,31,0,0,50
1930330,1482336,2025-02-03,House,"(H) Energy, Technology and Federal Relations--To Table",12,2,0,0,14
1930330,1555100,2025-02-03,House,"(H) Energy, Technology and Federal Relations--To Table",12,2,0,0,14
1930428,1482830,2025-01-30,Senate,"(S) Education and Cultural Resources--To Table",10,4,0,0,14
1930428,1497784,2025-02-24,Senate,"(S) 2nd Reading Passed",31,19,0,0,50
1930428,1499537,2025-02-25,Senate,"(S) 3rd Reading Passed",29,20,0,1,50
1930428,1530463,2025-03-28,House,"(H) Education--Be Concurred In As Amended",15,0,0,0,15
1930428,1540445,2025-04-08,House,"(H) 2nd Reading Concurred",74,24,0,2,100
1930428,1541804,2025-04-09,House,"(H) 3rd Reading Concurred",69,28,0,3,100
1930428,1546531,2025-04-12,Senate,"(S) 2nd Reading House Amendments Concurred",50,0,0,0,50
1930428,1547342,2025-04-14,Senate,"(S) 3rd Reading Passed as Amended by House",42,6,0,2,50
1930526,1482082,2025-01-30,Senate,"(S) Education and Cultural Resources--Do Pass",13,1,0,0,14
1930526,1482083,2025-02-04,Senate,"(S) 2nd Reading Passed",38,12,0,0,50
1930526,1482838,2025-02-05,Senate,"(S) 3rd Reading Passed",35,13,0,2,50
1930526,1530519,2025-03-28,House,"(H) Education--Be Concurred In",15,0,0,0,15
1930526,1545192,2025-04-10,House,"(H) 2nd Reading Concurred",92,8,0,0,100
1930526,1546398,2025-04-11,House,"(H) 3rd Reading Concurred",94,5,0,1,100
1930624,1490640,2025-02-14,Senate,"(S) Public Health, Welfare and Safety--To Table",7,4,0,0,11
1930624,1502794,2025-02-14,Senate,"(S) Public Health, Welfare and Safety--To Table",7,4,0,0,11
1930624,1502795,2025-02-28,Senate,"(S) 2nd Reading Motion to Amend Carried",50,0,0,0,50
1930624,1502796,2025-02-28,Senate,"(S) 2nd Reading Passed as Amended",30,20,0,0,50
1930624,1503761,2025-03-03,Senate,"(S) 3rd Reading Passed",33,17,0,0,50
1930624,1528294,2025-03-26,House,"(H) Human Services--To Table",12,9,0,0,21
1930624,1530409,2025-03-26,House,"(H) Human Services--To Table",12,9,0,0,21
1930624,1577957,2025-03-26,House,"(H) Human Services--To Table",12,9,0,0,21
1930881,1484400,2025-02-07,House,"(H) Education--To Table",15,0,0,0,15
1930947,1484394,2025-02-07,House,"(H) Education--Do Pass As Amended",15,0,0,0,15
1930947,1490402,2025-02-14,House,"(H) 2nd Reading Passed",77,23,0,0,100
1930947,1497916,2025-02-24,House,"(H) Appropriations--Do Pass As Amended",23,0,0,0,23
1930947,1502701,2025-02-28,House,"(H) 2nd Reading Passed",91,8,0,1,100
1930947,1503032,2025-03-01,House,"(H) 3rd Reading Passed",88,9,0,3,100
1930947,1526686,2025-03-25,Senate,"(S) Education and Cultural Resources--Be Concurred In As Amended",8,6,0,0,14
1930947,1533374,2025-04-01,Senate,"(S) 2nd Reading Concurred",34,16,0,0,50
1930947,1534942,2025-04-02,Senate,"(S) 3rd Reading Concurred",31,19,0,0,50
1930947,1547034,2025-04-14,House,"(H) 2nd Reading Senate Amendments Concurred",90,10,0,0,100
1930947,1549159,2025-04-15,House,"(H) 3rd Reading Passed as Amended by Senate",77,20,0,3,100
1931015,1484399,2025-02-07,Senate,"(S) State Administration--Do Pass",9,0,0,0,9
1931015,1488445,2025-02-12,Senate,"(S) 2nd Reading Passed",48,2,0,0,50
1931015,1489055,2025-02-13,Senate,"(S) 3rd Reading Passed",49,1,0,0,50
1931015,1522530,2025-03-20,House,"(H) State Administration--Be Concurred In",19,0,0,0,19
1931015,1528048,2025-03-26,House,"(H) 2nd Reading Concurred",93,6,0,1,100
1931015,1528861,2025-03-27,House,"(H) 3rd Reading Concurred",97,2,0,1,100
1931081,1482084,2025-01-31,Senate,"(S) Business, Labor  and Economic Affairs--Do Pass",10,1,0,0,11
1931081,1482085,2025-02-04,Senate,"(S) 2nd Reading Passed",39,11,0,0,50
1931081,1482832,2025-02-05,Senate,"(S) 3rd Reading Passed",39,9,0,2,50
1931081,1540615,2025-04-08,House,"(H) Business and Labor--Be Concurred In As Amended",20,0,0,0,20
1931081,1544414,2025-04-10,House,"(H) 2nd Reading Concurred",96,4,0,0,100
1931081,1546446,2025-04-11,House,"(H) 3rd Reading Concurred",96,3,0,1,100
1931081,1547142,2025-04-14,Senate,"(S) 2nd Reading House Amendments Concurred",45,4,0,1,50
1931081,1548448,2025-04-15,Senate,"(S) 3rd Reading Passed as Amended by House",43,7,0,0,50
1931144,1483395,2025-02-06,House,"(H) Fish, Wildlife and Parks--Do Pass As Amended",17,3,0,0,20
1931144,1489245,2025-02-13,House,"(H) 2nd Reading Passed",85,15,0,0,100
1931144,1490473,2025-02-14,House,"(H) 3rd Reading Passed",78,16,0,6,100
1931144,1533347,2025-04-01,Senate,"(S) Fish and Game--Be Concurred In As Amended",11,0,1,0,12
1931144,1537667,2025-04-05,Senate,"(S) 2nd Reading Concurred",28,19,0,3,50
1931144,1538477,2025-04-07,Senate,"(S) 3rd Reading Concurred",32,17,0,1,50
1931144,1545917,2025-04-11,House,"(H) 2nd Reading Senate Amendments Concurred",99,0,0,1,100
1931144,1546367,2025-04-11,House,"(H) 3rd Reading Passed as Amended by Senate",92,6,0,2,100
1931155,1496818,2025-02-21,Senate,"(S) State Administration--Do Pass",7,2,0,0,9
1931155,1505021,2025-03-04,Senate,"(S) 2nd Reading Passed",40,10,0,0,50
1931155,1505786,2025-03-05,Senate,"(S) 3rd Reading Passed",33,16,0,1,50
1931155,1529881,2025-03-28,House,"(H) State Administration--Be Concurred In",11,8,0,0,19
1931155,1551514,2025-04-17,House,"(H) 2nd Reading Concurred",57,43,0,0,100
1931155,1552126,2025-04-18,House,"(H) 3rd Reading Concurred",58,40,0,2,100
1931155,1552387,2025-04-18,House,"(H) 3rd Reading Failed; 2nd House Vote Required",58,40,0,2,100
1931263,1483261,2025-02-06,House,"(H) 2nd Reading Passed",92,8,0,0,100
1931263,1491644,2025-02-17,House,"(H) Appropriations--Do Pass",21,0,0,2,23
1931263,1493261,2025-02-19,House,"(H) 3rd Reading Passed",94,6,0,0,100
1931263,1535922,2025-04-03,Senate,"(S) Judiciary--Be Concurred In As Amended",6,2,0,0,8
1931263,1542326,2025-04-09,Senate,"(S) 2nd Reading Concurred",45,5,0,0,50
1931263,1546918,2025-04-14,Senate,"(S) Finance and Claims--Be Concurred In",22,0,0,0,22
1931263,1548439,2025-04-15,Senate,"(S) 3rd Reading Concurred",45,4,0,1,50
1931263,1552075,2025-04-18,House,"(H) 2nd Reading Senate Amendments Concurred",99,1,0,0,100
1931263,1553281,2025-04-22,House,"(H) 3rd Reading Passed as Amended by Senate",95,3,0,2,100
1931374,1482087,2025-02-03,House,"(H) Judiciary--Do Pass",12,8,0,0,20
1931374,1482088,2025-02-05,House,"(H) 2nd Reading Passed",60,40,0,0,100
1931374,1483807,2025-02-06,House,"(H) 3rd Reading Passed",60,39,0,1,100
1931374,1520211,2025-03-18,Senate,"(S) Judiciary--Be Concurred In",8,0,0,0,8
1931374,1521732,2025-03-19,Senate,"(S) 2nd Reading Concurred",50,0,0,0,50
1931374,1522941,2025-03-20,Senate,"(S) 3rd Reading Concurred",50,0,0,0,50
1931374,1564653,2025-02-03,House,"(H) Judiciary--Do Pass",12,8,0,0,20
1931486,1496173,2025-02-21,Senate,"(S) Judiciary--Do Pass",5,3,0,0,8
1931486,1501483,2025-02-27,Senate,"(S) 2nd Reading Pass Motion Failed",25,25,0,0,50
1931486,1502260,2025-02-27,Senate,"(S) 2nd Reading Pass Motion Failed",25,25,0,0,50
1931486,1502261,2025-02-27,Senate,"(S) 2nd Reading Indefinitely Postponed",28,22,0,0,50
1931486,1502584,2025-02-28,Senate,"(S) Reconsidered Previous Action; Placed on 2nd Reading",26,23,0,1,50
1931486,1502977,2025-03-01,Senate,"(S) 2nd Reading Pass Motion Failed",24,26,0,0,50
1931598,1491144,2025-02-17,House,"(H) Judiciary--Do Pass As Amended",14,6,0,0,20
1931598,1495278,2025-02-20,House,"(H) 2nd Reading Passed",87,13,0,0,100
1931598,1496660,2025-02-21,House,"(H) 3rd Reading Passed",84,14,0,2,100
1931598,1534076,2025-04-01,Senate,"(S) Education and Cultural Resources--Be Concurred In",11,3,0,0,14
1931598,1549783,2025-04-16,Senate,"(S) 2nd Reading Concurred",41,9,0,0,50
1931598,1551573,2025-04-17,Senate,"(S) 3rd Reading Concurred",44,6,0,0,50
1931720,1484344,2025-02-07,Senate,"(S) Judiciary--Do Pass As Amended",6,3,0,0,9
1931720,1487180,2025-02-11,Senate,"(S) 2nd Reading Motion to Amend Failed",18,32,0,0,50
1931720,1487181,2025-02-11,Senate,"(S) 2nd Reading Passed",30,20,0,0,50
1931720,1488273,2025-02-12,Senate,"(S) 3rd Reading Passed",31,19,0,0,50
1931720,1543097,2025-04-09,House,"(H) Judiciary--Be Concurred In",11,9,0,0,20
1931720,1545419,2025-04-11,House,"(H) 2nd Reading Concurred",58,42,0,0,100
1931720,1546351,2025-04-11,House,"(H) 3rd Reading Concurred",57,42,0,1,100
1931770,1482901,2025-02-03,House,"(H) Judiciary--To Table",20,0,0,0,20
1931824,1482089,2025-02-04,House,"(H) Human Services--Do Pass As Amended",13,8,0,0,21
1931824,1486619,2025-02-11,House,"(H) 2nd Reading Not Passed",46,54,0,0,100
1931877,1521804,2025-03-19,Senate,"(S) Taxation--To Table",8,0,0,0,8
1931932,1487019,2025-02-11,House,"(H) State Administration--Do Pass",18,1,0,0,19
1931932,1488969,2025-02-13,House,"(H) 2nd Reading Passed",82,18,0,0,100
1931932,1490626,2025-02-14,House,"(H) 3rd Reading Passed",78,16,0,6,100
1931932,1546487,2025-04-11,Senate,"(S) State Administration--Be Concurred In",7,2,0,0,9
1931932,1547089,2025-04-14,Senate,"(S) 2nd Reading Concurred",46,2,0,2,50
1931932,1549254,2025-04-15,Senate,"(S) 3rd Reading Concurred",47,3,0,0,50
1931988,1482090,2025-01-31,House,"(H) State Administration--Do Pass",19,0,0,0,19
1931988,1482091,2025-02-04,House,"(H) 2nd Reading Passed",96,3,0,1,100
1931988,1482092,2025-02-05,House,"(H) 3rd Reading Passed",100,0,0,0,100
1931988,1527704,2025-03-26,Senate,"(S) State Administration--Be Concurred In",9,0,0,0,9
1931988,1531059,2025-03-31,Senate,"(S) 2nd Reading Concurred",45,4,0,1,50
1931988,1533009,2025-04-01,Senate,"(S) 3rd Reading Concurred",46,4,0,0,50
1932042,1485245,2025-02-10,Senate,"(S) Natural Resources--Do Pass",10,1,0,0,11
1932042,1488874,2025-02-13,Senate,"(S) 2nd Reading Passed",50,0,0,0,50
1932042,1490336,2025-02-14,Senate,"(S) 3rd Reading Passed",50,0,0,0,50
1932042,1524152,2025-03-21,House,"(H) Natural Resources--Be Concurred In",14,0,0,0,14
1932042,1529324,2025-03-27,House,"(H) 2nd Reading Concurred",95,3,0,2,100
1932042,1529975,2025-03-28,House,"(H) 3rd Reading Concurred",95,4,0,1,100
1932098,1506645,2025-02-11,Senate,"(S) Judiciary--To Table",9,0,0,0,9
1932152,1482525,2025-02-05,Senate,"(S) Public Health, Welfare and Safety--Do Pass",11,0,0,0,11
1932152,1487753,2025-02-12,Senate,"(S) 2nd Reading Pass Motion Failed",23,27,0,0,50
1932152,1487754,2025-02-12,Senate,"(S) 2nd Reading Indefinitely Postponed",28,22,0,0,50
1932210,1482093,2025-02-03,House,"(H) Judiciary--Do Pass As Amended",13,7,0,0,20
1932210,1486386,2025-02-11,House,"(H) 2nd Reading Passed",59,41,0,0,100
1932210,1488434,2025-02-12,House,"(H) 3rd Reading Passed",60,40,0,0,100
1932210,1522666,2025-03-20,Senate,"(S) Judiciary--Be Concurred In",5,3,0,0,8
1932210,1531161,2025-03-31,Senate,"(S) 2nd Reading Concurred",32,18,0,0,50
1932210,1533387,2025-04-01,Senate,"(S) 3rd Reading Concurred",30,20,0,0,50
1932264,1489206,2025-02-13,Senate,"(S) Judiciary--To Table",6,0,0,3,9
1932264,1515916,2025-02-13,Senate,"(S) Judiciary--Do Pass",1,5,0,3,9
1932320,1493934,2025-02-19,House,"(H) Transportation--Do Pass As Amended",8,6,0,0,14
1932320,1496255,2025-02-19,House,"(H) Transportation--Do Pass As Amended",8,6,0,0,14
1932320,1524999,2025-03-24,House,"(H) 2nd Reading Passed",52,46,0,2,100
1932320,1527333,2025-03-25,House,"(H) 3rd Reading Passed",51,48,0,1,100
1932320,1541947,2025-04-09,Senate,"(S) Judiciary--To Table",5,3,0,0,8
1932372,1482094,2025-01-29,Senate,"(S) Public Health, Welfare and Safety--Do Pass",11,0,0,0,11
1932372,1482095,2025-02-03,Senate,"(S) 2nd Reading Passed",45,5,0,0,50
1932372,1482096,2025-02-04,Senate,"(S) 3rd Reading Passed",45,5,0,0,50
1932372,1492912,2025-02-18,House,"(H) Human Services--To Table",17,0,0,4,21
1932372,1530634,2025-02-18,House,"(H) Human Services--To Table",17,0,0,4,21
1932372,1538820,2025-04-07,House,"(H) Human Services--Be Concurred In",12,9,0,0,21
1932372,1545296,2025-04-10,House,"(H) 2nd Reading Concurred",56,44,0,0,100
1932372,1546375,2025-04-11,House,"(H) 3rd Reading Concurred",56,43,0,1,100
1932372,1557952,2025-02-18,House,"(H) Human Services--To Table",17,0,4,0,21
1932372,1559028,2025-02-18,House,"(H) Human Services--To Table",17,0,4,0,21
1932432,1502656,2025-02-28,Senate,"(S) Public Health, Welfare and Safety--Do Pass",5,6,0,0,11
1932432,1502657,2025-02-28,Senate,"(S) Public Health, Welfare and Safety--To Table",11,0,0,0,11
1932484,1482097,2025-01-29,House,"(H) Business and Labor--Do Pass",20,0,0,0,20
1932484,1482098,2025-02-03,House,"(H) 2nd Reading Passed",99,0,0,1,100
1932484,1482099,2025-02-04,House,"(H) 3rd Reading Passed",100,0,0,0,100
1932484,1522472,2025-03-20,Senate,"(S) Business, Labor  and Economic Affairs--Be Concurred In",12,0,0,0,12
1932484,1542148,2025-04-09,Senate,"(S) 2nd Reading Motion to Amend Failed",17,33,0,0,50
1932484,1542149,2025-04-09,Senate,"(S) 2nd Reading Concurred",49,1,0,0,50
1932484,1544372,2025-04-10,Senate,"(S) 3rd Reading Concurred",46,2,0,2,50
1932540,1485317,2025-02-10,Senate,"(S) Local Government--Do Pass",7,4,0,0,11
1932540,1489441,2025-02-13,Senate,"(S) 2nd Reading Pass Motion Failed",12,38,0,0,50
1932540,1489442,2025-02-13,Senate,"(S) 2nd Reading Indefinitely Postponed",35,15,0,0,50
1932594,1482957,2025-02-05,Senate,"(S) Public Health, Welfare and Safety--Do Pass",10,1,0,0,11
1932594,1483250,2025-02-05,Senate,"(S) Public Health, Welfare and Safety--Do Pass",10,1,0,0,11
1932594,1487189,2025-02-11,Senate,"(S) 2nd Reading Passed",42,8,0,0,50
1932594,1488459,2025-02-12,Senate,"(S) 3rd Reading Passed",46,4,0,0,50
1932594,1527170,2025-03-25,House,"(H) Human Services--Be Concurred In As Amended",20,1,0,0,21
1932594,1533739,2025-04-01,House,"(H) 2nd Reading Concurred",93,7,0,0,100
1932594,1534960,2025-04-02,House,"(H) 3rd Reading Concurred",90,4,0,6,100
1932594,1539074,2025-04-07,Senate,"(S) 2nd Reading Passed",50,0,0,0,50
1932594,1541090,2025-04-08,Senate,"(S) 3rd Reading Passed as Amended by House",48,0,0,2,50
1932652,1482840,2025-02-04,House,"(H) Human Services--To Table",21,0,0,0,21
1932652,1502098,2025-02-27,House,"(H) Human Services--Do Pass",15,6,0,0,21
1932652,1503796,2025-03-03,House,"(H) 2nd Reading Passed",55,44,0,1,100
1932652,1505368,2025-03-04,House,"(H) Appropriations--Do Pass",17,6,0,0,23
1932652,1505654,2025-03-05,House,"(H) 3rd Reading Passed",55,43,0,2,100
1932652,1539019,2025-04-07,Senate,"(S) Public Health, Welfare and Safety--To Table",6,5,0,0,11
1932652,1542100,2025-04-07,Senate,"(S) Public Health, Welfare and Safety--To Table",6,5,0,0,11
1932706,1499346,2025-02-25,Senate,"(S) Energy, Technology & Federal Relations--Do Pass",12,1,0,0,13
1932706,1501363,2025-02-27,Senate,"(S) 2nd Reading Passed",40,10,0,0,50
1932706,1502583,2025-02-28,Senate,"(S) 3rd Reading Passed",38,11,0,1,50
1932706,1537539,2025-04-04,House,"(H) Energy, Technology and Federal Relations--Be Concurred In As Amended",10,4,0,0,14
1932706,1540003,2025-04-08,House,"(H) 2nd Reading Concurred",57,41,0,2,100
1932706,1542271,2025-04-09,House,"(H) 3rd Reading Concurred",54,43,0,3,100
1932706,1545435,2025-04-11,Senate,"(S) 2nd Reading House Amendments Concurred",50,0,0,0,50
1932706,1546682,2025-04-12,Senate,"(S) 3rd Reading Passed as Amended by House",46,4,0,0,50
1932762,1521799,2025-03-19,Senate,"(S) Taxation--To Table",8,0,0,0,8
1932762,1526647,2025-03-25,Senate,"(S) Motion Failed",22,28,0,0,50
1932815,1488406,2025-02-12,Senate,"(S) 2nd Reading Passed",43,7,0,0,50
1932815,1489110,2025-02-13,Senate,"(S) 3rd Reading Passed",42,8,0,0,50
1932815,1520920,2025-03-19,House,"(H) Business and Labor--Be Concurred In",12,8,0,0,20
1932815,1530632,2025-03-29,House,"(H) 2nd Reading Concurred",56,44,0,0,100
1932815,1531386,2025-03-31,House,"(H) 3rd Reading Concurred",57,42,0,1,100
1932873,1482100,2025-01-31,House,"(H) State Administration--Do Pass",13,6,0,0,19
1932873,1485778,2025-01-31,House,"(H) State Administration--Do Pass",13,6,0,0,19
1932873,1485779,2025-02-10,House,"(H) 2nd Reading Not Passed",46,54,0,0,100
1932928,1482101,2025-02-04,House,"(H) Agriculture--Do Pass As Amended",17,0,0,0,17
1932928,1485556,2025-02-10,House,"(H) 2nd Reading Passed",98,2,0,0,100
1932928,1486994,2025-02-11,House,"(H) 3rd Reading Passed",96,3,0,1,100
1932928,1533956,2025-04-01,Senate,"(S) Agriculture, Livestock and Irrigation--Be Concurred In",11,0,0,0,11
1932928,1541156,2025-04-08,Senate,"(S) 2nd Reading Concurred",48,2,0,0,50
1932928,1544767,2025-04-10,Senate,"(S) 3rd Reading Concurred",46,2,0,2,50
1932981,1484398,2025-02-07,House,"(H) Natural Resources--Do Pass",14,0,0,0,14
1932981,1488455,2025-02-12,House,"(H) 2nd Reading Passed",100,0,0,0,100
1932981,1489537,2025-02-13,House,"(H) 3rd Reading Passed",99,0,0,1,100
1932981,1524393,2025-03-21,Senate,"(S) Natural Resources--Be Concurred In",10,1,0,0,11
1932981,1534796,2025-03-21,Senate,"(S) Natural Resources--Be Concurred In",10,1,0,0,11
1932981,1534797,2025-03-28,Senate,"(S) Natural Resources--Be Concurred In As Amended",11,0,0,0,11
1932981,1536665,2025-04-03,Senate,"(S) 2nd Reading Concurred",47,2,0,1,50
1932981,1537206,2025-04-04,Senate,"(S) 3rd Reading Concurred",44,5,0,1,50
1932981,1547349,2025-04-14,House,"(H) 2nd Reading Senate Amendments Concurred",61,39,0,0,100
1932981,1548325,2025-04-15,House,"(H) 3rd Reading Passed as Amended by Senate",64,33,0,3,100
1933035,1482102,2025-01-31,House,"(H) State Administration--Do Pass As Amended",12,7,0,0,19
1933035,1486533,2025-02-11,House,"(H) 2nd Reading Passed",52,48,0,0,100
1933035,1488254,2025-02-12,House,"(H) 3rd Reading Passed",56,44,0,0,100
1933035,1556986,2025-04-24,Senate,"(S) Judiciary--To Table",8,0,0,0,8
1933035,1558007,2025-04-25,Senate,"(S) Judiciary--To Take From The Table",5,2,1,0,8
1933035,1558921,2025-04-24,Senate,"(S) Judiciary--To Table",8,0,0,0,8
1933035,1558922,2025-04-25,Senate,"(S) Judiciary--Be Concurred In",8,0,0,0,8
1933035,1558923,2025-04-28,Senate,"(S) 2nd Reading Concurred",31,18,0,1,50
1933035,1560418,2025-04-29,Senate,"(S) 3rd Reading Concurred",27,23,0,0,50
1934798,1491604,2025-02-17,Senate,"(S) Natural Resources--Do Pass As Amended",11,0,0,0,11
1934798,1496004,2025-02-20,Senate,"(S) 2nd Reading Passed",50,0,0,0,50
1934798,1496498,2025-02-21,Senate,"(S) 3rd Reading Passed",49,1,0,0,50
1934798,1543033,2025-04-09,House,"(H) Judiciary--Be Concurred In",20,0,0,0,20
1934798,1544838,2025-04-10,House,"(H) 2nd Reading Concurred",100,0,0,0,100
1934798,1546318,2025-04-11,House,"(H) 3rd Reading Concurred",99,0,0,1,100
1935067,1500666,2025-02-26,Senate,"(S) State Administration--Do Pass",9,0,0,0,9
1935067,1503029,2025-03-01,Senate,"(S) 2nd Reading Passed as Amended",50,0,0,0,50
1935067,1503030,2025-03-01,Senate,"(S) 2nd Reading Motion to Amend Carried",45,4,0,1,50
1935067,1505294,2025-03-04,Senate,"(S) 3rd Reading Passed",50,0,0,0,50
1935067,1530058,2025-03-28,House,"(H) State Administration--Be Concurred In",12,7,0,0,19
1935067,1532325,2025-04-01,House,"(H) 2nd Reading Concurred",99,1,0,0,100
1935067,1535302,2025-04-02,House,"(H) 3rd Reading Concurred",95,0,0,5,100
1935327,1482103,2025-02-03,House,"(H) Appropriations--Do Pass As Amended",22,1,0,0,23
1935327,1487628,2025-02-12,House,"(H) 2nd Reading Passed",99,1,0,0,100
1935327,1489852,2025-02-13,House,"(H) 3rd Reading Passed",99,0,0,1,100
1935327,1547012,2025-04-14,Senate,"(S) Finance and Claims--Be Concurred In",22,0,0,0,22
1935327,1555192,2025-04-23,Senate,"(S) 2nd Reading Concurred",46,4,0,0,50
1935327,1557452,2025-04-24,Senate,"(S) 3rd Reading Concurred",43,7,0,0,50
1935335,1491483,2025-02-17,House,"(H) Judiciary--Do Pass As Amended",13,7,0,0,20
1935335,1495409,2025-02-20,House,"(H) 2nd Reading Passed",59,41,0,0,100
1935335,1496525,2025-02-21,House,"(H) 3rd Reading Passed",59,39,0,2,100
1935335,1536269,2025-04-03,Senate,"(S) Judiciary--Be Concurred In",5,3,0,0,8
1935335,1546518,2025-04-12,Senate,"(S) 2nd Reading Motion to Amend Carried",44,6,0,0,50
1935335,1546519,2025-04-12,Senate,"(S) 2nd Reading Concurred as Amended",30,20,0,0,50
1935335,1547358,2025-04-14,Senate,"(S) 3rd Reading Concurred",29,19,0,2,50
1935335,1550394,2025-04-16,House,"(H) 2nd Reading Senate Amendments Concurred",71,29,0,0,100
1935335,1551835,2025-04-17,House,"(H) 3rd Reading Passed as Amended by Senate",58,41,0,1,100
1935412,1483158,2025-02-06,House,"(H) Judiciary--Do Pass",20,0,0,0,20
1935412,1487012,2025-02-11,House,"(H) 2nd Reading Motion to Amend Carried",100,0,0,0,100
1935412,1487013,2025-02-11,House,"(H) 2nd Reading Passed as Amended",100,0,0,0,100
1935412,1488965,2025-02-13,House,"(H) 3rd Reading Passed",99,0,0,1,100
1935412,1526566,2025-03-25,Senate,"(S) Judiciary--Be Concurred In As Amended",8,0,0,0,8
1935412,1533241,2025-04-01,Senate,"(S) 2nd Reading Concurred",49,1,0,0,50
1935412,1535471,2025-04-02,Senate,"(S) 3rd Reading Concurred",50,0,0,0,50
1935412,1547618,2025-04-14,House,"(H) 2nd Reading Senate Amendments Concurred",100,0,0,0,100
1935412,1549062,2025-04-15,House,"(H) 3rd Reading Passed as Amended by Senate",96,1,0,3,100
1935492,1484105,2025-02-07,House,"(H) Natural Resources--Do Pass",8,6,0,0,14
1935492,1487670,2025-02-12,House,"(H) 2nd Reading Passed",58,42,0,0,100
1935492,1489394,2025-02-13,House,"(H) 3rd Reading Passed",57,42,0,1,100
1935492,1530354,2025-03-28,Senate,"(S) Natural Resources--Be Concurred In As Amended",7,4,0,0,11
1935492,1536869,2025-04-03,Senate,"(S) 2nd Reading Concurred",31,19,0,0,50
1935492,1537318,2025-04-04,Senate,"(S) 3rd Reading Concurred",31,18,0,1,50
1935492,1547071,2025-04-14,House,"(H) 2nd Reading Senate Amendments Concurred",65,35,0,0,100
1935492,1548641,2025-04-15,House,"(H) 3rd Reading Passed as Amended by Senate",63,34,0,3,100
1935572,1483496,2025-02-06,House,"(H) Fish, Wildlife and Parks--Do Pass",20,0,0,0,20
1935572,1486358,2025-02-11,House,"(H) 2nd Reading Passed",100,0,0,0,100
1935572,1487610,2025-02-12,House,"(H) 3rd Reading Passed",100,0,0,0,100
1935572,1526527,2025-03-25,Senate,"(S) Fish and Game--Be Concurred In",4,8,0,0,12
1935572,1526528,2025-03-25,Senate,"(S) Fish and Game--To Table",8,4,0,0,12
1935572,1530010,2025-03-25,Senate,"(S) Fish and Game--To Table",8,4,0,0,12
1935572,1532935,2025-03-25,Senate,"(S) Fish and Game--To Table",8,4,0,0,12
1935572,1534120,2025-04-01,Senate,"(S) Fish and Game--Be Concurred In",6,5,1,0,12
1935572,1546509,2025-04-12,Senate,"(S) 2nd Reading Concurred",34,16,0,0,50
1935572,1547077,2025-04-14,Senate,"(S) 3rd Reading Concurred",29,18,0,3,50
1935572,1560225,2025-02-06,House,"(H) Fish, Wildlife and Parks--Do Pass",20,0,0,0,20
1935652,1482104,2025-02-03,House,"(H) Judiciary--Do Pass As Amended",20,0,0,0,20
1935652,1485230,2025-02-10,House,"(H) 2nd Reading Motion to Amend Carried",99,1,0,0,100
1935652,1485231,2025-02-10,House,"(H) 2nd Reading Passed as Amended",100,0,0,0,100
1935652,1487913,2025-02-12,House,"(H) 3rd Reading Passed",100,0,0,0,100
1935652,1530184,2025-03-28,Senate,"(S) Judiciary--To Table",8,0,0,0,8
1935652,1537312,2025-03-28,Senate,"(S) Judiciary--To Table",8,0,0,0,8
1935815,1484270,2025-02-07,House,"(H) Natural Resources--Do Pass",8,6,0,0,14
1935815,1487629,2025-02-12,House,"(H) 2nd Reading Motion to Amend Carried",99,1,0,0,100
1935815,1487630,2025-02-12,House,"(H) 2nd Reading Passed",60,40,0,0,100
1935815,1490769,2025-02-12,House,"(H) 2nd Reading Passed as Amended",60,40,0,0,100
1935815,1491902,2025-02-18,House,"(H) 3rd Reading Passed",61,38,0,1,100
1935815,1530240,2025-03-28,Senate,"(S) Natural Resources--Be Concurred In",6,5,0,0,11
1935815,1536702,2025-04-03,Senate,"(S) 2nd Reading Concurred",32,18,0,0,50
1935815,1537295,2025-04-04,Senate,"(S) 3rd Reading Concurred",30,19,0,1,50
1935892,1487813,2025-02-11,House,"(H) State Administration--Do Pass",17,2,0,0,19
1935892,1488916,2025-02-11,House,"(H) State Administration--Do Pass",17,2,0,0,19
1935892,1488917,2025-02-13,House,"(H) 2nd Reading Passed",96,4,0,0,100
1935892,1490130,2025-02-14,House,"(H) 3rd Reading Passed",90,4,0,6,100
1935892,1526042,2025-03-21,Senate,"(S) State Administration--Be Concurred In",8,1,0,0,9
1935892,1541249,2025-04-08,Senate,"(S) 2nd Reading Concurred",41,9,0,0,50
1935892,1545090,2025-04-10,Senate,"(S) 3rd Reading Concurred",44,4,0,2,50
1935974,1487796,2025-02-12,House,"(H) Judiciary--To Table",20,0,0,0,20
1936055,1530082,2025-03-28,Senate,"(S) Taxation--Do Pass",6,2,0,0,8
1936055,1530911,2025-03-31,Senate,"(S) 2nd Reading Passed",47,3,0,0,50
1936055,1534159,2025-04-02,Senate,"(S) Finance and Claims--To Table",22,0,0,0,22
1936055,1534828,2025-04-02,Senate,"(S) Motion Carried",28,22,0,0,50
1936055,1535611,2025-04-02,Senate,"(S) Motion Carried",28,22,0,0,50
1936055,1536101,2025-04-03,Senate,"(S) 3rd Reading Passed",31,19,0,0,50
1936055,1549609,2025-04-16,House,"(H) Taxation--To Table",21,0,0,0,21
1936055,1550130,2025-04-16,House,"(H) Taxation--To Table",21,0,0,0,21
1936136,1502996,2025-03-01,Senate,"(S) Business, Labor  and Economic Affairs--To Table",12,0,0,0,12
1936216,1483216,2025-02-06,House,"(H) Judiciary--To Table",19,1,0,0,20
1936297,1482105,2025-01-31,House,"(H) Business and Labor--",13,0,0,7,20
1936297,1530112,2025-01-31,House,"(H) Business and Labor--Do Pass",8,12,0,0,20
1936297,1534976,2025-01-31,House,"(H) Business and Labor--Do Pass",8,12,0,0,20
1936376,1485963,2025-02-11,House,"(H) State Administration--To Table",18,1,0,0,19
1936819,1483272,2025-02-06,House,"(H) Judiciary--Do Pass",12,8,0,0,20
1936819,1501372,2025-02-27,House,"(H) 2nd Reading Not Passed",47,53,0,0,100
1937294,1497004,2025-02-19,Senate,"(S) Local Government--Do Pass As Amended",5,6,0,0,11
1937294,1497204,2025-02-19,Senate,"(S) Local Government--To Table",11,0,0,0,11
1937294,1501309,2025-02-27,Senate,"(S) 2nd Reading Motion to Amend Carried",37,10,0,3,50
1937294,1501794,2025-02-27,Senate,"(S) 2nd Reading Pass Motion Failed",25,25,0,0,50
1937294,1501795,2025-02-27,Senate,"(S) 2nd Reading Indefinitely Postponed",29,21,0,0,50
1937425,1482212,2025-02-05,House,"(H) Business and Labor--To Table",20,0,0,0,20
1937425,1482213,2025-02-05,House,"(H) Business and Labor--To Table",20,0,0,0,20
1937425,1530784,2025-02-05,House,"(H) Business and Labor--To Table",20,0,0,0,20
1937559,1482106,2025-02-03,House,"(H) Natural Resources--Do Pass",14,0,0,0,14
1937559,1484034,2025-02-07,House,"(H) 2nd Reading Passed",98,2,0,0,100
1937559,1485073,2025-02-10,House,"(H) 3rd Reading Passed",97,3,0,0,100
1937559,1524230,2025-03-21,Senate,"(S) Natural Resources--Be Concurred In",11,0,0,0,11
1937559,1544366,2025-04-10,Senate,"(S) 2nd Reading Concurred",49,0,0,1,50
1937559,1546284,2025-04-11,Senate,"(S) 3rd Reading Concurred",48,0,0,2,50
1937695,1482841,2025-02-05,Senate,"(S) Public Health, Welfare and Safety--To Table",11,0,0,0,11
1937695,1491463,2025-02-17,Senate,"(S) Public Health, Welfare and Safety--Do Pass As Amended",10,1,0,0,11
1937695,1495153,2025-02-20,Senate,"(S) 2nd Reading Passed",50,0,0,0,50
1937695,1496603,2025-02-21,Senate,"(S) 3rd Reading Passed",50,0,0,0,50
1937695,1520386,2025-03-18,House,"(H) Human Services--Be Concurred In",20,0,0,1,21
1937695,1525153,2025-03-24,House,"(H) 2nd Reading Concurred",99,0,0,1,100
1937695,1526733,2025-03-25,House,"(H) 3rd Reading Concurred",99,0,0,1,100
1937826,1504139,2025-02-26,House,"(H) State Administration--To Table",19,0,0,0,19
1937960,1496196,2025-02-19,Senate,"(S) Local Government--To Table",11,0,0,0,11
1937960,1501344,2025-02-27,Senate,"(S) 2nd Reading Motion to Amend Carried",40,10,0,0,50
1937960,1501345,2025-02-27,Senate,"(S) 2nd Reading Pass Motion Failed",24,26,0,0,50
1937960,1501811,2025-02-27,Senate,"(S) 2nd Reading Indefinitely Postponed",29,21,0,0,50
1937960,1502598,2025-02-28,Senate,"(S) Reconsidered Previous Action; Placed on 2nd Reading",29,20,0,1,50
1937960,1502912,2025-03-01,Senate,"(S) 2nd Reading Motion to Amend Carried",48,2,0,0,50
1937960,1502913,2025-03-01,Senate,"(S) 2nd Reading Passed as Amended",30,20,0,0,50
1937960,1505055,2025-03-04,Senate,"(S) 3rd Reading Failed",24,26,0,0,50
1938092,1482107,2025-01-30,House,"(H) Business and Labor--Do Pass",20,0,0,0,20
1938092,1482108,2025-02-05,House,"(H) 2nd Reading Passed",96,4,0,0,100
1938092,1483772,2025-02-06,House,"(H) 3rd Reading Passed",97,2,0,1,100
1938092,1521095,2025-03-19,Senate,"(S) Business, Labor  and Economic Affairs--Be Concurred In",11,0,0,1,12
1938092,1530048,2025-01-30,House,"(H) Business and Labor--Do Pass",20,0,0,0,20
1938092,1541109,2025-04-08,Senate,"(S) 2nd Reading Concurred",44,6,0,0,50
1938092,1544072,2025-04-10,Senate,"(S) 3rd Reading Concurred",45,3,0,2,50
1938185,1482109,2025-01-29,House,"(H) Energy, Technology and Federal Relations--Do Pass",8,6,0,0,14
1938185,1482110,2025-02-03,House,"(H) 2nd Reading Motion to Amend Carried",78,21,0,1,100
1938185,1482111,2025-02-03,House,"(H) 2nd Reading Motion to Amend Failed",49,51,0,0,100
1938185,1482112,2025-02-03,House,"(H) 2nd Reading Passed as Amended",53,47,0,0,100
1938185,1482113,2025-02-05,House,"(H) 3rd Reading Passed",53,47,0,0,100
1938185,1502938,2025-01-29,House,"(H) Energy, Technology and Federal Relations--Resolution Adopted",8,6,0,0,14
1938185,1538922,2025-04-01,Senate,"(S) Energy, Technology & Federal Relations--Resolution Adopted",7,6,0,0,13
1938185,1552040,2025-04-18,Senate,"(S) 2nd Reading Concurred",25,24,0,1,50
1938185,1554831,2025-04-22,Senate,"(S) 3rd Reading Concurred",30,20,0,0,50
1938275,1483311,2025-02-06,House,"(H) Judiciary--Do Pass",11,9,0,0,20
1938275,1485346,2025-02-10,House,"(H) 2nd Reading Passed",55,45,0,0,100
1938275,1486491,2025-02-11,House,"(H) 3rd Reading Passed",53,46,0,1,100
1938275,1530113,2025-03-28,Senate,"(S) Judiciary--To Table",8,0,0,0,8
1938275,1537074,2025-03-28,Senate,"(S) Judiciary--To Table",8,0,0,0,8
1938363,1483149,2025-02-06,House,"(H) Judiciary--To Table",19,1,0,0,20
1938363,1506982,2025-03-05,House,"(H) Taken from Committee; Placed on 2nd Reading",50,48,0,2,100
1938363,1543467,2025-03-05,House,"(H) Taken from Committee; Placed on 2nd Reading",50,48,0,2,100
1938453,1483684,2025-02-06,House,"(H) Taxation--To Table",21,0,0,0,21
1938544,1489980,2025-02-14,Senate,"(S) Business, Labor  and Economic Affairs--Do Pass",7,4,0,0,11
1938544,1491824,2025-02-18,Senate,"(S) 2nd Reading Passed",47,3,0,0,50
1938544,1494425,2025-02-19,Senate,"(S) 3rd Reading Passed",47,2,0,1,50
1938544,1530114,2025-03-28,House,"(H) State Administration--Be Concurred In",19,0,0,0,19
1938544,1531667,2025-03-31,House,"(H) 2nd Reading Concurred",98,1,0,1,100
1938544,1533717,2025-04-01,House,"(H) 3rd Reading Concurred",99,0,0,1,100
1938631,1483559,2025-02-06,House,"(H) Judiciary--Do Pass",11,9,0,0,20
1938631,1485786,2025-02-10,House,"(H) 2nd Reading Passed",55,45,0,0,100
1938631,1486550,2025-02-11,House,"(H) 3rd Reading Passed",55,44,0,1,100
1938631,1524700,2025-03-24,Senate,"(S) Judiciary--To Table",8,0,0,0,8
1938631,1530200,2025-03-24,Senate,"(S) Judiciary--To Table",8,0,0,0,8
1938631,1530201,2025-03-28,Senate,"(S) Judiciary--To Take From The Table",7,1,0,0,8
1938631,1541763,2025-03-24,Senate,"(S) Judiciary--To Table",8,0,0,0,8
1938631,1543416,2025-03-28,Senate,"(S) Judiciary--To Take From The Table",7,1,0,0,8
1938631,1576119,2025-03-24,Senate,"(S) Judiciary--To Table",8,0,0,0,8
1938719,1483288,2025-02-06,House,"(H) Judiciary--Do Pass",11,9,0,0,20
1938719,1487871,2025-02-12,House,"(H) 2nd Reading Passed",54,46,0,0,100
1938719,1489070,2025-02-13,House,"(H) 3rd Reading Passed",52,47,0,1,100
1938719,1530034,2025-03-28,Senate,"(S) Judiciary--To Table",8,0,0,0,8
1938719,1537065,2025-03-28,Senate,"(S) Judiciary--To Table",8,0,0,0,8
1938809,1496250,2025-02-21,House,"(H) Judiciary--To Table",20,0,0,0,20
1938897,1482117,2025-02-05,House,"(H) 2nd Reading Passed",58,42,0,0,100
1938897,1483327,2025-02-06,House,"(H) 3rd Reading Passed",57,42,0,1,100
1938897,1483991,2025-02-03,House,"(H) Judiciary--Do Pass As Amended",12,8,0,0,20
1938897,1494924,2025-02-20,Senate,"(S) Judiciary--Be Concurred In",5,3,0,0,8
1938897,1521351,2025-03-19,Senate,"(S) 2nd Reading Concurred",31,18,0,1,50
1938897,1522954,2025-03-20,Senate,"(S) 3rd Reading Concurred",32,18,0,0,50
1938897,1558962,2025-02-03,House,"(H) Judiciary--Do Pass As Amended",12,8,0,0,20
1938978,1501813,2025-02-27,Senate,"(S) Energy, Technology & Federal Relations--To Table",13,0,0,0,13
1939569,1489606,2025-02-12,House,"(H) Transportation--Do Pass As Amended",8,6,0,0,14
1939569,1527088,2025-03-24,House,"(H) 2nd Reading Not Passed",46,53,0,1,100
1939569,1527089,2025-02-12,House,"(H) Transportation--Do Pass As Amended",8,6,0,0,14
1939738,1487708,2025-02-11,House,"(H) Fish, Wildlife and Parks--Do Pass",20,0,0,0,20
1939738,1492743,2025-02-18,House,"(H) 2nd Reading Passed",100,0,0,0,100
1939738,1493897,2025-02-19,House,"(H) 3rd Reading Passed",100,0,0,0,100
1939738,1526687,2025-03-25,Senate,"(S) Fish and Game--Be Concurred In",12,0,0,0,12
1939738,1540550,2025-04-08,Senate,"(S) 2nd Reading Concurred",49,1,0,0,50
1939738,1543502,2025-04-10,Senate,"(S) 3rd Reading Concurred",48,0,0,2,50
1940150,1491482,2025-02-17,Senate,"(S) Local Government--Do Pass As Amended",11,0,0,0,11
1940150,1495275,2025-02-20,Senate,"(S) 2nd Reading Passed",43,7,0,0,50
1940150,1496666,2025-02-21,Senate,"(S) 3rd Reading Passed",43,7,0,0,50
1940150,1523317,2025-03-20,House,"(H) Local Government--Be Concurred In",11,6,0,0,17
1940150,1544664,2025-04-10,House,"(H) 2nd Reading Concurred",60,40,0,0,100
1940150,1546377,2025-04-11,House,"(H) 3rd Reading Concurred",67,32,0,1,100
1940386,1482118,2025-02-03,House,"(H) Appropriations--Do Pass As Amended",23,0,0,0,23
1940386,1484031,2025-02-07,House,"(H) 2nd Reading Passed",100,0,0,0,100
1940386,1485074,2025-02-10,House,"(H) 3rd Reading Passed",100,0,0,0,100
1940386,1524084,2025-03-21,Senate,"(S) Finance and Claims--Be Concurred In",22,0,0,0,22
1940386,1529089,2025-03-27,Senate,"(S) 2nd Reading Concurred",50,0,0,0,50
1940386,1530173,2025-03-28,Senate,"(S) 3rd Reading Concurred",48,0,0,2,50
1940623,1482593,2025-02-04,Senate,"(S) Judiciary--To Table",9,0,0,0,9
1940857,1496142,2025-02-04,Senate,"(S) Education and Cultural Resources--To Table",13,1,0,0,14
1941091,1499292,2025-02-25,Senate,"(S) Energy, Technology & Federal Relations--Do Pass As Amended",13,0,0,0,13
1941091,1502535,2025-02-28,Senate,"(S) 2nd Reading Passed",50,0,0,0,50
1941091,1502911,2025-03-01,Senate,"(S) 3rd Reading Passed",50,0,0,0,50
1941091,1524134,2025-03-21,House,"(H) Business and Labor--Be Concurred In",20,0,0,0,20
1941091,1529277,2025-03-27,House,"(H) 2nd Reading Concurred",61,39,0,0,100
1941091,1529953,2025-03-28,House,"(H) 3rd Reading Concurred",61,38,0,1,100
1941322,1482603,2025-02-05,Senate,"(S) Public Health, Welfare and Safety--Do Pass",33,0,0,0,33
1941322,1486502,2025-02-11,Senate,"(S) 2nd Reading Passed",49,1,0,0,50
1941322,1487857,2025-02-12,Senate,"(S) 3rd Reading Passed",50,0,0,0,50
1941322,1520361,2025-03-18,House,"(H) Human Services--Be Concurred In",20,1,0,0,21
1941322,1526016,2025-03-25,House,"(H) 2nd Reading Concurred",82,18,0,0,100
1941322,1527446,2025-03-26,House,"(H) 3rd Reading Concurred",85,14,0,1,100
1941401,1486952,2025-02-11,House,"(H) State Administration--Do Pass As Amended",13,6,0,0,19
1941401,1492625,2025-02-18,House,"(H) 2nd Reading Not Passed",40,60,0,0,100
1941470,1482120,2025-02-05,House,"(H) Business and Labor--Do Pass As Amended",32,8,0,0,40
1941470,1497129,2025-02-22,House,"(H) 2nd Reading Passed",63,37,0,0,100
1941470,1502120,2025-02-27,House,"(H) Appropriations--To Table",13,10,0,0,23
1941541,1497907,2025-02-24,Senate,"(S) Local Government--Do Pass As Amended",8,3,0,0,11
1941541,1500337,2025-02-26,Senate,"(S) 2nd Reading Passed",34,15,0,1,50
1941541,1501786,2025-02-27,Senate,"(S) 3rd Reading Passed",34,16,0,0,50
1941541,1541149,2025-04-08,House,"(H) Local Government--Be Concurred In",10,7,0,0,17
1941541,1545667,2025-04-11,House,"(H) 2nd Reading Motion to Amend Failed",41,59,0,0,100
1941541,1545668,2025-04-11,House,"(H) 2nd Reading Concurred",52,48,0,0,100
1941541,1546212,2025-04-11,House,"(H) 3rd Reading Concurred",50,48,0,2,100
1941608,1482244,2025-02-05,House,"(H) Transportation--Do Pass As Amended",9,5,0,0,14
1941608,1486549,2025-02-11,House,"(H) 2nd Reading Passed",76,24,0,0,100
1941608,1487891,2025-02-12,House,"(H) 3rd Reading Passed",78,22,0,0,100
1941608,1521750,2025-03-19,Senate,"(S) Highways and Transportation--Be Concurred In",7,1,0,0,8
1941608,1540635,2025-04-08,Senate,"(S) 2nd Reading Concurred",43,7,0,0,50
1941608,1543514,2025-04-10,Senate,"(S) 3rd Reading Concurred",44,4,0,2,50
1941675,1490828,2025-02-17,House,"(H) Judiciary--To Table",18,2,0,0,20
1941675,1504649,2025-03-04,House,"(H) Taken from Committee; Placed on 2nd Reading",57,42,0,1,100
1941675,1506608,2025-03-05,House,"(H) 2nd Reading Passed",68,31,0,1,100
1941675,1508672,2025-03-07,House,"(H) 3rd Reading Passed",67,32,0,1,100
1941675,1534460,2025-04-02,Senate,"(S) Business, Labor  and Economic Affairs--Be Concurred In As Amended",11,0,0,0,11
1941675,1537692,2025-04-05,Senate,"(S) 2nd Reading Motion to Amend Carried",28,21,0,1,50
1941675,1537693,2025-04-05,Senate,"(S) 2nd Reading House Amendments Concurred",36,14,0,0,50
1941675,1540633,2025-04-08,Senate,"(S) 3rd Reading Concurred",34,14,0,2,50
1941675,1542002,2025-03-04,House,"(H) Taken from Committee; Placed on 2nd Reading",57,42,0,1,100
1941675,1547323,2025-04-14,House,"(H) 2nd Reading Senate Amendments Concurred",78,22,0,0,100
1941675,1549032,2025-04-15,House,"(H) 3rd Reading Passed as Amended by Senate",68,29,0,3,100
1941743,1483771,2025-02-06,House,"(H) Local Government--Do Pass As Amended",14,3,0,0,17
1941743,1489318,2025-02-13,House,"(H) 2nd Reading Passed",59,41,0,0,100
1941743,1530194,2025-03-28,House,"(H) Appropriations--Do Pass As Amended",16,7,0,0,23
1941743,1536249,2025-04-03,House,"(H) 2nd Reading Passed",64,36,0,0,100
1941743,1537656,2025-04-05,House,"(H) 3rd Reading Passed",62,36,0,2,100
1941743,1547810,2025-04-14,Senate,"(S) Local Government--Be Concurred In As Amended",6,4,0,0,10
1941743,1549819,2025-04-16,Senate,"(S) 2nd Reading Concurred",26,24,0,0,50
1941743,1552155,2025-04-18,Senate,"(S) Finance and Claims--Be Concurred In As Amended",12,10,0,0,22
1941743,1555042,2025-04-23,Senate,"(S) 2nd Reading Concur Motion Failed",25,25,0,0,50
1941743,1555043,2025-04-23,Senate,"(S) 2nd Reading Indefinitely Postponed",27,21,0,2,50
1941952,1482122,2025-01-31,House,"(H) Business and Labor--",12,0,0,8,20
1941952,1530072,2025-01-31,House,"(H) Business and Labor--Do Pass",2,18,0,0,20
1941952,1534933,2025-01-31,House,"(H) Business and Labor--To Table",12,0,8,0,20
1942044,1489559,2025-02-13,Senate,"(S) Education and Cultural Resources--Do Pass",8,6,0,0,14
1942044,1492177,2025-02-18,Senate,"(S) 2nd Reading Passed",31,19,0,0,50
1942044,1493509,2025-02-19,Senate,"(S) 3rd Reading Passed",29,20,0,1,50
1942044,1538555,2025-04-07,House,"(H) Education--To Table",14,1,0,0,15
1942044,1544712,2025-04-07,House,"(H) Education--To Table",14,1,0,0,15
1942044,1561992,2025-02-13,Senate,"(S) Education and Cultural Resources--Do Pass",8,6,0,0,14
1942129,1485552,2025-02-10,House,"(H) Energy, Technology and Federal Relations--Do Pass As Amended",11,3,0,0,14
1942129,1500122,2025-02-26,House,"(H) 2nd Reading Passed",93,7,0,0,100
1942129,1501590,2025-02-27,House,"(H) Appropriations--To Table",17,6,0,0,23
1942227,1484486,2025-02-07,House,"(H) Education--Do Pass",15,0,0,0,15
1942227,1489460,2025-02-13,House,"(H) 2nd Reading Passed",100,0,0,0,100
1942227,1490186,2025-02-14,House,"(H) 3rd Reading Passed",94,0,0,6,100
1942227,1529454,2025-03-27,Senate,"(S) Education and Cultural Resources--Be Concurred In",14,0,0,0,14
1942227,1544544,2025-04-10,Senate,"(S) 2nd Reading Concurred",48,1,0,1,50
1942227,1546208,2025-04-11,Senate,"(S) 3rd Reading Concurred",48,0,0,2,50
1942314,1483298,2025-02-06,House,"(H) Judiciary--Do Pass",12,8,0,0,20
1942314,1526656,2025-03-25,House,"(H) 2nd Reading Passed",57,43,0,0,100
1942314,1528009,2025-03-26,House,"(H) 3rd Reading Passed",58,41,0,1,100
1942314,1539807,2025-04-08,Senate,"(S) Judiciary--Be Concurred In",5,3,0,0,8
1942314,1551780,2025-04-17,Senate,"(S) 2nd Reading Concurred",30,19,0,1,50
1942314,1552237,2025-04-18,Senate,"(S) 3rd Reading Failed; 2nd House Vote Required",33,17,0,0,50
1942412,1483805,2025-02-06,House,"(H) Local Government--Do Pass",17,0,0,0,17
1942412,1489849,2025-02-13,House,"(H) 2nd Reading Passed",98,2,0,0,100
1942412,1490129,2025-02-14,House,"(H) 3rd Reading Passed",92,2,0,6,100
1942412,1536134,2025-03-31,Senate,"(S) Local Government--Be Concurred In As Amended",11,0,0,0,11
1942412,1537807,2025-04-05,Senate,"(S) 2nd Reading Concurred",49,0,0,1,50
1942412,1539131,2025-04-07,Senate,"(S) 3rd Reading Concurred",49,0,0,1,50
1942412,1547563,2025-04-14,House,"(H) 2nd Reading Senate Amendments Concurred",52,48,0,0,100
1942412,1548992,2025-04-15,House,"(H) 3rd Reading Passed as Amended by Senate",87,10,0,3,100
1942412,1555098,2025-02-06,House,"(H) Local Government--Do Pass",17,0,0,0,17
1942503,1490531,2025-02-14,Senate,"(S) Public Health, Welfare and Safety--Do Pass As Amended",7,4,0,0,11
1942503,1493811,2025-02-19,Senate,"(S) 2nd Reading Passed",36,14,0,0,50
1942503,1502227,2025-02-26,Senate,"(S) Finance and Claims--To Table",21,1,0,0,22
1942503,1530770,2025-02-14,Senate,"(S) Public Health, Welfare and Safety--Do Pass As Amended",7,4,0,0,11
1942593,1483994,2025-02-07,Senate,"(S) Judiciary--Do Pass",9,0,0,0,9
1942593,1486132,2025-02-11,Senate,"(S) 2nd Reading Motion to Amend Carried",47,3,0,0,50
1942593,1486133,2025-02-11,Senate,"(S) 2nd Reading Passed as Amended",49,1,0,0,50
1942593,1487564,2025-02-12,Senate,"(S) 3rd Reading Passed",49,1,0,0,50
1942593,1542497,2025-04-09,House,"(H) Judiciary--Be Concurred In",20,0,0,0,20
1942593,1544747,2025-04-10,House,"(H) Appropriations--Be Concurred In",23,0,0,0,23
1942593,1546086,2025-04-11,House,"(H) 2nd Reading Concurred",99,1,0,0,100
1942593,1546087,2025-04-11,House,"(H) 3rd Reading Concurred",99,0,0,1,100
1942684,1496368,2025-02-21,House,"(H) Judiciary--To Table",19,1,0,0,20
1942774,1487341,2025-02-12,House,"(H) Judiciary--Resolution Adopted",17,3,0,0,20
1942774,1492142,2025-02-12,House,"(H) Judiciary--Do Pass",17,3,0,0,20
1942774,1519947,2025-03-18,House,"(H) 2nd Reading Passed",89,9,0,2,100
1942774,1521299,2025-03-19,House,"(H) 3rd Reading Passed",82,16,0,2,100
1942774,1542312,2025-04-09,Senate,"(S) Judiciary--Resolution Adopted",6,2,0,0,8
1942774,1544843,2025-04-10,Senate,"(S) 2nd Reading Concurred",43,5,0,2,50
1942774,1546025,2025-04-11,Senate,"(S) 3rd Reading Concurred",43,5,0,2,50
1942861,1483968,2025-02-07,Senate,"(S) Judiciary--Do Pass",6,3,0,0,9
1942861,1490715,2025-02-15,Senate,"(S) 2nd Reading Passed",31,19,0,0,50
1942861,1492242,2025-02-18,Senate,"(S) 3rd Reading Passed",30,20,0,0,50
1942861,1535910,2025-04-03,House,"(H) Judiciary--Be Concurred In As Amended",12,8,0,0,20
1942861,1542137,2025-04-09,House,"(H) 2nd Reading Motion to Amend Carried",57,43,0,0,100
1942861,1542138,2025-04-09,House,"(H) 2nd Reading Concurred as Amended",57,43,0,0,100
1942861,1546384,2025-04-11,House,"(H) 3rd Reading Concurred",55,44,0,1,100
1942861,1550005,2025-04-16,Senate,"(S) 2nd Reading House Amendments Concurred",44,5,0,1,50
1942861,1551250,2025-04-17,Senate,"(S) 3rd Reading Passed as Amended by House",32,18,0,0,50
1942861,1559215,2025-04-28,House,"(H) 2nd Reading Governor's Proposed Amendments Not Adopted",46,54,0,0,100
1942861,1559216,2025-04-28,Senate,"(S) 2nd Reading Governor's Proposed Amendments Adopted",29,20,0,1,50
1942861,1560193,2025-04-29,Senate,"(S) 3rd Reading Governor's Proposed Amendments Adopted",31,19,0,0,50
1942861,1560194,2025-04-29,House,"(H) Reconsidered Previous Action; Placed on 2nd Reading",38,59,0,3,100
1942927,1482123,2025-01-31,House,"(H) Business and Labor--Do Pass",20,0,0,0,20
1942927,1482124,2025-02-05,House,"(H) 2nd Reading Passed",99,1,0,0,100
1942927,1483766,2025-02-06,House,"(H) 3rd Reading Passed",98,1,0,1,100
1942927,1498157,2025-02-24,Senate,"(S) Business, Labor  and Economic Affairs--Be Concurred In",12,0,0,0,12
1942927,1518782,2025-03-17,Senate,"(S) 2nd Reading Concurred",50,0,0,0,50
1942927,1519681,2025-03-18,Senate,"(S) 3rd Reading Concurred",49,0,0,1,50
1942927,1530484,2025-01-31,House,"(H) Business and Labor--Do Pass",20,0,0,0,20
1942985,1484303,2025-02-07,Senate,"(S) Business, Labor  and Economic Affairs--To Table",11,0,0,0,11
1943044,1502886,2025-02-28,Senate,"(S) State Administration--To Table",8,1,0,0,9
1943101,1482937,2025-02-05,House,"(H) Education--Do Pass As Amended",8,7,0,0,15
1943101,1485140,2025-02-10,House,"(H) 2nd Reading Passed",51,48,0,1,100
1943101,1489202,2025-02-13,House,"(H) Appropriations--Do Pass",12,11,0,0,23
1943101,1493564,2025-02-19,House,"(H) 3rd Reading Failed",45,55,0,0,100
1943101,1569629,2025-02-05,House,"(H) Education--Do Pass As Amended",8,7,0,0,15
1943157,1485122,2025-02-10,Senate,"(S) Natural Resources--Do Pass As Amended",8,3,0,0,11
1943157,1487446,2025-02-12,Senate,"(S) 2nd Reading Passed",37,13,0,0,50
1943157,1489304,2025-02-13,Senate,"(S) 3rd Reading Passed",37,13,0,0,50
1943157,1528744,2025-03-26,House,"(H) Natural Resources--Be Concurred In",8,6,0,0,14
1943157,1542513,2025-04-09,House,"(H) 2nd Reading Concurred",62,38,0,0,100
1943157,1543279,2025-04-10,House,"(H) 3rd Reading Concurred",63,35,0,2,100
1943511,1488024,2025-02-12,House,"(H) Judiciary--Do Pass",18,2,0,0,20
1943511,1491819,2025-02-18,House,"(H) 2nd Reading Passed",98,2,0,0,100
1943511,1494131,2025-02-19,House,"(H) 3rd Reading Passed",98,2,0,0,100
1943511,1523341,2025-03-20,Senate,"(S) Judiciary--Be Concurred In",8,0,0,0,8
1943511,1538779,2025-04-07,Senate,"(S) 2nd Reading Concurred",49,1,0,0,50
1943511,1540649,2025-04-08,Senate,"(S) 3rd Reading Concurred",47,1,0,2,50
1943511,1569758,2025-02-12,House,"(H) Judiciary--Do Pass",18,2,0,0,20
1943571,1482125,2025-02-05,House,"(H) Business and Labor--Do Pass As Amended",60,0,0,0,60
1943571,1497062,2025-02-13,House,"(H) 2nd Reading Passed",100,0,0,0,100
1943571,1497063,2025-02-14,House,"(H) 3rd Reading Passed",94,0,0,6,100
1943571,1523041,2025-03-20,Senate,"(S) Business, Labor  and Economic Affairs--Be Concurred In",12,0,0,0,12
1943571,1531282,2025-02-05,House,"(H) Business and Labor--Do Pass As Amended",20,0,0,0,20
1943571,1538717,2025-04-07,Senate,"(S) 2nd Reading Concurred",49,0,0,1,50
1943571,1540646,2025-04-08,Senate,"(S) 3rd Reading Concurred",48,0,0,2,50
1943635,1487161,2025-02-11,House,"(H) Local Government--Do Pass As Amended",16,1,0,0,17
1943635,1494152,2025-02-19,House,"(H) 2nd Reading Passed",91,9,0,0,100
1943635,1496097,2025-02-20,House,"(H) 3rd Reading Passed",91,8,0,1,100
1943635,1539182,2025-04-07,Senate,"(S) Local Government--Be Concurred In",10,0,0,0,10
1943635,1545216,2025-04-10,Senate,"(S) 2nd Reading Concurred",48,1,0,1,50
1943635,1546416,2025-04-11,Senate,"(S) 3rd Reading Concurred",47,1,0,2,50
1943700,1496984,2025-02-21,Senate,"(S) State Administration--Do Pass",7,2,0,0,9
1943700,1499482,2025-02-25,Senate,"(S) 2nd Reading Passed",38,12,0,0,50
1943700,1500620,2025-02-26,Senate,"(S) 3rd Reading Passed",42,8,0,0,50
1943700,1528636,2025-03-27,House,"(H) State Administration--To Table",19,0,0,0,19
1943700,1535945,2025-04-03,House,"(H) State Administration--Be Concurred In",13,6,0,0,19
1943700,1535946,2025-04-03,House,"(H) State Administration--To Take From The Table",13,5,1,0,19
1943700,1545272,2025-03-27,House,"(H) State Administration--To Table",19,0,0,0,19
1943700,1545273,2025-04-03,House,"(H) State Administration--To Take From The Table",13,5,1,0,19
1943700,1545274,2025-04-10,House,"(H) 2nd Reading Not Concurred",40,60,0,0,100
1943700,1546454,2025-04-11,House,"(H) Reconsidered Previous Action; Placed on 2nd Reading",55,44,0,1,100
1943700,1551162,2025-04-17,House,"(H) 2nd Reading Not Concurred",26,74,0,0,100
1943764,1487601,2025-02-12,House,"(H) Judiciary--Do Pass As Amended",12,8,0,0,20
1943764,1497011,2025-02-22,House,"(H) 2nd Reading Not Passed",29,71,0,0,100
1943764,1576299,2025-02-12,House,"(H) Judiciary--Do Pass As Amended",12,8,0,0,20
1943926,1496870,2025-02-21,Senate,"(S) State Administration--Do Pass As Amended",6,3,0,0,9
1943926,1499293,2025-02-25,Senate,"(S) 2nd Reading Passed",48,2,0,0,50
1943926,1500457,2025-02-26,Senate,"(S) 3rd Reading Passed",47,3,0,0,50
1943926,1519602,2025-03-18,House,"(H) State Administration--Be Concurred In",18,1,0,0,19
1943926,1542631,2025-04-09,House,"(H) 2nd Reading Motion to Amend Failed",27,71,0,2,100
1943926,1542632,2025-04-09,House,"(H) 2nd Reading Concurred",88,12,0,0,100
1943926,1543320,2025-04-10,House,"(H) 3rd Reading Concurred",81,17,0,2,100
1944016,1487536,2025-02-12,House,"(H) Taxation--To Table",21,0,0,0,21
1944016,1526154,2025-03-25,House,"(H) Taxation--Do Pass As Amended",12,9,0,0,21
1944016,1529120,2025-03-27,House,"(H) 2nd Reading Not Passed",50,50,0,0,100
1944109,1483403,2025-02-06,House,"(H) Fish, Wildlife and Parks--Do Pass",19,1,0,0,20
1944109,1490217,2025-02-14,House,"(H) 2nd Reading Passed",97,3,0,0,100
1944109,1492544,2025-02-18,House,"(H) 3rd Reading Passed",97,2,0,1,100
1944109,1526867,2025-03-25,Senate,"(S) Fish and Game--Be Concurred In",12,0,0,0,12
1944109,1541068,2025-04-08,Senate,"(S) 2nd Reading Concurred",49,1,0,0,50
1944109,1544004,2025-04-10,Senate,"(S) 3rd Reading Concurred",46,2,0,2,50
1944109,1560055,2025-02-06,House,"(H) Fish, Wildlife and Parks--Do Pass",19,1,0,0,20
1944201,1483690,2025-02-06,House,"(H) Taxation--To Table",20,1,0,0,21
1944290,1488352,2025-02-12,House,"(H) Taxation--To Table",21,0,0,0,21
1944290,1521385,2025-03-19,House,"(H) Taxation--Do Pass As Amended",11,10,0,0,21
1944290,1528858,2025-03-27,House,"(H) 2nd Reading Passed",52,48,0,0,100
1944290,1530365,2025-03-28,House,"(H) 3rd Reading Passed",51,48,0,1,100
1944290,1542470,2025-04-09,Senate,"(S) Taxation--Be Concurred In As Amended",6,2,0,0,8
1944290,1546526,2025-04-12,Senate,"(S) 2nd Reading Concurred",39,11,0,0,50
1944290,1547688,2025-04-14,Senate,"(S) 3rd Reading Concurred",34,14,0,2,50
1944290,1551762,2025-04-17,House,"(H) 2nd Reading Senate Amendments Not Concurred",44,56,0,0,100
1944290,1560947,2025-04-29,Senate,"(S) 2nd Reading Conference Committee Report Adopted",46,3,0,1,50
1944290,1560948,2025-04-29,House,"(H) 2nd Reading Conference Committee Report Adopted",60,40,0,0,100
1944290,1562426,2025-04-30,House,"(H) 3rd Reading Conference Committee Report Adopted",55,45,0,0,100
1944290,1562427,2025-04-30,Senate,"(S) 3rd Reading Conference Committee Report Adopted",41,9,0,0,50
1944379,1496187,2025-02-21,Senate,"(S) Taxation--To Table",8,0,0,0,8
1944470,1483596,2025-02-04,Senate,"(S) Finance and Claims--Do Pass",22,0,0,0,22
1944470,1484056,2025-02-07,Senate,"(S) 2nd Reading Passed",49,0,0,1,50
1944470,1484899,2025-02-10,Senate,"(S) 3rd Reading Passed",49,0,0,1,50
1944470,1541239,2025-04-08,House,"(H) Appropriations--Be Concurred In",22,1,0,0,23
1944470,1544230,2025-04-10,House,"(H) 2nd Reading Concurred",98,0,0,2,100
1944470,1546450,2025-04-11,House,"(H) 3rd Reading Concurred",95,4,0,1,100
1944558,1502871,2025-02-28,Senate,"(S) State Administration--Do Pass As Amended",6,3,0,0,9
1944558,1505281,2025-03-04,Senate,"(S) 2nd Reading Passed",32,18,0,0,50
1944558,1505705,2025-03-05,Senate,"(S) 3rd Reading Passed",31,18,0,1,50
1944558,1530266,2025-03-28,House,"(H) State Administration--Be Concurred In As Amended",18,1,0,0,19
1944558,1541133,2025-04-08,House,"(H) 2nd Reading Concurred",94,4,0,2,100
1944558,1542843,2025-04-09,House,"(H) 3rd Reading Concurred",94,3,0,3,100
1944558,1545455,2025-04-11,Senate,"(S) 2nd Reading House Amendments Not Concurred",32,18,0,0,50
1944558,1557408,2025-04-24,Senate,"(S) 2nd Reading Conference Committee Report Adopted",47,2,0,1,50
1944558,1557944,2025-04-25,House,"(H) 2nd Reading Conference Committee Report Adopted",98,2,0,0,100
1944558,1558341,2025-04-25,Senate,"(S) 3rd Reading Conference Committee Report Adopted",47,2,0,1,50
1944558,1559518,2025-04-28,House,"(H) 3rd Reading Conference Committee Report Adopted",95,5,0,0,100
1944569,1492758,2025-02-18,Senate,"(S) Energy, Technology & Federal Relations--Do Pass As Amended",10,3,0,0,13
1944569,1498380,2025-02-24,Senate,"(S) 2nd Reading Passed",49,1,0,0,50
1944569,1499575,2025-02-25,Senate,"(S) 3rd Reading Passed",46,3,0,1,50
1944569,1522975,2025-03-20,House,"(H) Taxation--Be Concurred In",20,1,0,0,21
1944569,1529465,2025-03-27,House,"(H) 2nd Reading Motion to Amend Failed",39,61,0,0,100
1944569,1529466,2025-03-27,House,"(H) 2nd Reading Concurred",89,11,0,0,100
1944569,1530358,2025-03-28,House,"(H) 3rd Reading Concurred",90,9,0,1,100
1944614,1487606,2025-02-12,House,"(H) Judiciary--Do Pass",16,4,0,0,20
1944614,1492486,2025-02-18,House,"(H) 2nd Reading Passed",74,26,0,0,100
1944614,1494275,2025-02-19,House,"(H) 3rd Reading Passed",66,34,0,0,100
1944614,1535801,2025-04-03,Senate,"(S) Judiciary--Be Concurred In",5,3,0,0,8
1944614,1544697,2025-04-10,Senate,"(S) 2nd Reading Concurred",29,21,0,0,50
1944614,1545985,2025-04-11,Senate,"(S) 3rd Reading Concurred",30,18,0,2,50
1944662,1487693,2025-02-12,House,"(H) State Administration--Do Pass",19,0,0,0,19
1944662,1497014,2025-02-22,House,"(H) 2nd Reading Passed",85,15,0,0,100
1944662,1500320,2025-02-26,House,"(H) Appropriations--Do Pass As Amended",20,3,0,0,23
1944662,1523254,2025-03-20,House,"(H) 2nd Reading Passed",84,16,0,0,100
1944662,1524162,2025-03-21,House,"(H) 3rd Reading Passed",83,14,0,3,100
1944662,1537397,2025-04-04,Senate,"(S) State Administration--Be Concurred In",5,4,0,0,9
1944662,1546533,2025-04-12,Senate,"(S) 2nd Reading Concurred",32,18,0,0,50
1944662,1551248,2025-04-16,Senate,"(S) Finance and Claims--To Table",22,0,0,0,22
1944662,1552065,2025-04-16,Senate,"(S) Finance and Claims--To Table",22,0,0,0,22
1944662,1555233,2025-04-23,Senate,"(S) 2nd Reading Indefinitely Postponed",30,18,0,2,50
1944662,1555234,2025-04-16,Senate,"(S) Finance and Claims--To Table",22,0,0,0,22
1944662,1555235,2025-04-23,Senate,"(S) 2nd Reading Concur Motion Failed",20,29,0,1,50
1944662,1558992,2025-04-16,Senate,"(S) Finance and Claims--To Table",22,0,0,0,22
1944710,1482518,2025-02-05,Senate,"(S) Public Health, Welfare and Safety--To Table",33,0,0,0,33
1944710,1516328,2025-02-05,Senate,"(S) Public Health, Welfare and Safety--To Table",11,0,0,0,11
1944760,1483290,2025-02-06,House,"(H) Local Government--Do Pass As Amended",17,0,0,0,17
1944760,1490448,2025-02-14,House,"(H) 2nd Reading Passed",99,1,0,0,100
1944760,1492246,2025-02-18,House,"(H) 3rd Reading Passed",99,0,0,1,100
1944760,1531637,2025-03-31,Senate,"(S) Local Government--Be Concurred In",7,4,0,0,11
1944760,1540552,2025-04-08,Senate,"(S) 2nd Reading Concurred",45,5,0,0,50
1944760,1541870,2025-04-09,Senate,"(S) 3rd Reading Concurred",44,5,0,1,50
1944760,1555438,2025-02-06,House,"(H) Local Government--Do Pass As Amended",17,0,0,0,17
1944808,1490476,2025-02-14,Senate,"(S) Public Health, Welfare and Safety--To Table",10,1,0,0,11
1944808,1502863,2025-02-14,Senate,"(S) Public Health, Welfare and Safety--To Table",10,1,0,0,11
1944808,1502864,2025-02-28,Senate,"(S) Public Health, Welfare and Safety--Do Pass As Amended",7,4,0,0,11
1944808,1504674,2025-03-04,Senate,"(S) 2nd Reading Passed",33,17,0,0,50
1944808,1505774,2025-03-05,Senate,"(S) 3rd Reading Passed",34,15,0,1,50
1944808,1539108,2025-04-07,House,"(H) Human Services--To Table",20,1,0,0,21
1944808,1545163,2025-04-07,House,"(H) Human Services--To Table",20,1,0,0,21
1944808,1580687,2025-04-07,House,"(H) Human Services--To Table",20,1,0,0,21
1944857,1528165,2025-03-26,Senate,"(S) State Administration--Resolution Adopted",6,3,0,0,9
1944857,1538709,2025-04-07,Senate,"(S) 2nd Reading Indefinitely Postponed",32,17,0,1,50
1944857,1538710,2025-04-07,Senate,"(S) Resolution Failed",23,27,0,0,50
1944905,1483437,2025-02-06,House,"(H) Fish, Wildlife and Parks--Do Pass",20,0,0,0,20
1944905,1490533,2025-02-14,House,"(H) 2nd Reading Passed",91,9,0,0,100
1944905,1492665,2025-02-18,House,"(H) 3rd Reading Passed",92,7,0,1,100
1944905,1533846,2025-04-01,Senate,"(S) Fish and Game--Be Concurred In",11,0,1,0,12
1944905,1541077,2025-04-08,Senate,"(S) 2nd Reading Concurred",44,6,0,0,50
1944905,1544021,2025-04-10,Senate,"(S) 3rd Reading Concurred",39,9,0,2,50
1944905,1559984,2025-02-06,House,"(H) Fish, Wildlife and Parks--Do Pass",20,0,0,0,20
1944954,1500727,2025-02-26,Senate,"(S) Business, Labor  and Economic Affairs--Do Pass",12,0,0,0,12
1944954,1502609,2025-02-28,Senate,"(S) 2nd Reading Passed",49,1,0,0,50
1944954,1502958,2025-03-01,Senate,"(S) 3rd Reading Passed",49,1,0,0,50
1944954,1524968,2025-03-24,House,"(H) Business and Labor--Be Concurred In",20,0,0,0,20
1944954,1545262,2025-04-10,House,"(H) 2nd Reading Concurred",99,1,0,0,100
1944954,1546447,2025-04-11,House,"(H) 3rd Reading Concurred",98,1,0,1,100
1945002,1483034,2025-02-06,House,"(H) Business and Labor--To Table",14,0,0,6,20
1945051,1482985,2025-02-05,Senate,"(S) Public Health, Welfare and Safety--To Table",11,0,0,0,11
1945543,1484261,2025-02-07,Senate,"(S) Business, Labor  and Economic Affairs--Do Pass",11,0,0,0,11
1945543,1488501,2025-02-12,Senate,"(S) 2nd Reading Passed",43,7,0,0,50
1945543,1489307,2025-02-13,Senate,"(S) 3rd Reading Passed",41,9,0,0,50
1945543,1521864,2025-03-19,House,"(H) Business and Labor--Be Concurred In",20,0,0,0,20
1945543,1530656,2025-03-29,House,"(H) 2nd Reading Concurred",93,7,0,0,100
1945543,1530850,2025-03-31,House,"(H) 3rd Reading Concurred",84,15,0,1,100
1945634,1483992,2025-02-07,Senate,"(S) Business, Labor  and Economic Affairs--To Table",11,0,0,0,11
1945721,1490588,2025-02-13,Senate,"(S) Judiciary--Do Pass As Amended",6,0,0,3,9
1945721,1493744,2025-02-19,Senate,"(S) 2nd Reading Motion to Amend Carried",40,10,0,0,50
1945721,1493745,2025-02-19,Senate,"(S) 2nd Reading Passed as Amended",46,4,0,0,50
1945721,1496836,2025-02-21,Senate,"(S) 3rd Reading Passed",43,7,0,0,50
1945721,1529469,2025-03-27,House,"(H) Judiciary--Be Concurred In As Amended",17,3,0,0,20
1945721,1539836,2025-04-08,House,"(H) 2nd Reading Concurred",93,5,0,2,100
1945721,1542929,2025-04-09,House,"(H) 3rd Reading Concurred",93,4,0,3,100
1945721,1546042,2025-04-11,Senate,"(S) 2nd Reading House Amendments Concurred",49,0,0,1,50
1945721,1546652,2025-04-12,Senate,"(S) 3rd Reading Passed as Amended by House",50,0,0,0,50
1945811,1497472,2025-02-24,House,"(H) Business and Labor--Do Pass",20,0,0,0,20
1945811,1502291,2025-02-28,House,"(H) 2nd Reading Passed",98,1,0,1,100
1945811,1503042,2025-03-01,House,"(H) 3rd Reading Passed",97,0,0,3,100
1945811,1530007,2025-03-28,Senate,"(S) Business, Labor  and Economic Affairs--Be Concurred In",12,0,0,0,12
1945811,1540437,2025-04-08,Senate,"(S) 2nd Reading Concurred",48,2,0,0,50
1945811,1541803,2025-04-09,Senate,"(S) 3rd Reading Concurred",46,3,0,1,50
1945901,1487737,2025-02-12,House,"(H) Business and Labor--Do Pass As Amended",20,0,0,0,20
1945901,1493246,2025-02-19,House,"(H) 2nd Reading Passed",100,0,0,0,100
1945901,1496089,2025-02-20,House,"(H) 3rd Reading Passed",99,0,0,1,100
1945901,1521649,2025-03-19,Senate,"(S) Business, Labor  and Economic Affairs--Be Concurred In",11,0,0,1,12
1945901,1524324,2025-03-21,Senate,"(S) 2nd Reading Concurred",40,10,0,0,50
1945901,1524886,2025-03-24,Senate,"(S) 3rd Reading Concurred",41,9,0,0,50
1945990,1486646,2025-02-11,House,"(H) Taxation--To Table",20,1,0,0,21
1945990,1494107,2025-02-19,House,"(H) Taxation--Do Pass As Amended",12,9,0,0,21
1945990,1530515,2025-03-28,House,"(H) Appropriations--Do Pass",13,10,0,0,23
1945990,1532240,2025-04-01,House,"(H) 2nd Reading Motion to Amend Failed",42,58,0,0,100
1945990,1532241,2025-04-01,House,"(H) 2nd Reading Passed",58,42,0,0,100
1945990,1535087,2025-04-02,House,"(H) 3rd Reading Passed",55,40,0,5,100
1945990,1549873,2025-04-16,Senate,"(S) Taxation--Be Concurred In As Amended",7,1,0,0,8
1945990,1552107,2025-04-18,Senate,"(S) 2nd Reading Motion to Amend Carried",47,2,0,1,50
1945990,1552108,2025-04-18,Senate,"(S) 2nd Reading Motion to Amend Failed",14,36,0,0,50
1945990,1552109,2025-04-18,Senate,"(S) 2nd Reading Concurred as Amended",32,18,0,0,50
1945990,1554357,2025-04-22,Senate,"(S) 3rd Reading Concurred",34,16,0,0,50
1946000,1491780,2025-02-13,Senate,"(S) Fish and Game--Do Pass As Amended",12,0,0,0,12
1946000,1494127,2025-02-19,Senate,"(S) 2nd Reading Motion to Amend Carried",49,0,0,1,50
1946000,1494128,2025-02-19,Senate,"(S) 2nd Reading Passed as Amended",49,0,0,1,50
1946000,1496297,2025-02-21,Senate,"(S) 3rd Reading Passed",50,0,0,0,50
1946000,1533365,2025-04-01,House,"(H) Fish, Wildlife and Parks--Be Concurred In As Amended",19,1,0,0,20
1946000,1540553,2025-04-08,House,"(H) 2nd Reading Concurred",98,0,0,2,100
1946000,1541663,2025-04-09,House,"(H) 3rd Reading Concurred",97,0,0,3,100
1946000,1545617,2025-04-11,Senate,"(S) 2nd Reading House Amendments Concurred",50,0,0,0,50
1946000,1546752,2025-04-12,Senate,"(S) 3rd Reading Passed as Amended by House",50,0,0,0,50
1946046,1487494,2025-02-12,House,"(H) Judiciary--Do Pass As Amended",15,5,0,0,20
1946046,1492874,2025-02-18,House,"(H) 2nd Reading Passed",67,33,0,0,100
1946046,1494138,2025-02-19,House,"(H) 3rd Reading Passed",62,38,0,0,100
1946046,1526174,2025-03-25,Senate,"(S) Judiciary--Be Concurred In As Amended",7,1,0,0,8
1946046,1532571,2025-04-01,Senate,"(S) 2nd Reading Concurred",34,16,0,0,50
1946046,1534593,2025-04-02,Senate,"(S) 3rd Reading Concurred",36,14,0,0,50
1946046,1547585,2025-04-14,House,"(H) 2nd Reading Senate Amendments Concurred",95,5,0,0,100
1946046,1548471,2025-04-15,House,"(H) 3rd Reading Passed as Amended by Senate",68,29,0,3,100
1946046,1558919,2025-02-12,House,"(H) Judiciary--Do Pass As Amended",15,5,0,0,20
1946094,1483599,2025-02-06,House,"(H) Business and Labor--Do Pass",11,8,0,1,20
1946094,1488464,2025-02-12,House,"(H) 2nd Reading Passed",58,42,0,0,100
1946094,1489730,2025-02-13,House,"(H) 3rd Reading Passed",57,42,0,1,100
1946094,1528231,2025-03-26,Senate,"(S) Business, Labor  and Economic Affairs--Be Concurred In",12,0,0,0,12
1946094,1535299,2025-02-06,House,"(H) Business and Labor--Do Pass",11,8,1,0,20
1946094,1539685,2025-04-08,Senate,"(S) 2nd Reading Concurred",30,20,0,0,50
1946094,1542136,2025-04-09,Senate,"(S) 3rd Reading Concurred",32,17,0,1,50
1946142,1488362,2025-02-12,House,"(H) Education--Do Pass As Amended",10,5,0,0,15
1946142,1528382,2025-03-26,House,"(H) 2nd Reading Passed",67,33,0,0,100
1946142,1529456,2025-03-27,House,"(H) Appropriations--Do Pass As Amended",14,9,0,0,23
1946142,1536951,2025-04-03,House,"(H) 2nd Reading Passed",64,36,0,0,100
1946142,1537859,2025-04-05,House,"(H) 3rd Reading Passed",61,37,0,2,100
1946142,1549471,2025-04-15,Senate,"(S) Education and Cultural Resources--To Table",14,0,0,0,14
1946142,1549960,2025-04-15,Senate,"(S) Education and Cultural Resources--To Table",14,0,0,0,14
1946142,1556230,2025-04-23,Senate,"(S) Taken from Committee; Placed on 2nd Reading",27,23,0,0,50
1946142,1557195,2025-04-24,Senate,"(S) 2nd Reading Concurred",26,24,0,0,50
1946142,1558264,2025-04-25,Senate,"(S) 3rd Reading Concurred",26,23,0,1,50
1946190,1489977,2025-02-14,Senate,"(S) Judiciary--Do Pass As Amended",9,0,0,0,9
1946190,1492053,2025-02-18,Senate,"(S) 2nd Reading Passed",34,16,0,0,50
1946190,1494083,2025-02-19,Senate,"(S) 3rd Reading Passed",32,17,0,1,50
1946190,1528728,2025-03-27,House,"(H) Judiciary--Be Concurred In",20,0,0,0,20
1946190,1530707,2025-03-29,House,"(H) 2nd Reading Concurred",58,42,0,0,100
1946190,1530890,2025-03-31,House,"(H) 3rd Reading Concurred",70,28,0,2,100
1946238,1493734,2025-02-19,House,"(H) Education--Do Pass As Amended",14,1,0,0,15
1946238,1498962,2025-02-25,House,"(H) 2nd Reading Passed",68,32,0,0,100
1946238,1531240,2025-03-31,House,"(H) Appropriations--Do Pass As Amended",16,7,0,0,23
1946238,1537221,2025-04-04,House,"(H) 2nd Reading Passed",59,41,0,0,100
1946238,1537698,2025-04-05,House,"(H) 3rd Reading Passed",59,39,0,2,100
1946238,1549058,2025-04-15,Senate,"(S) Education and Cultural Resources--To Table",14,0,0,0,14
1946238,1549963,2025-04-15,Senate,"(S) Education and Cultural Resources--To Table",14,0,0,0,14
1946289,1489686,2025-02-13,House,"(H) Human Services--Do Pass",21,0,0,0,21
1946289,1497117,2025-02-22,House,"(H) 2nd Reading Passed",100,0,0,0,100
1946289,1498153,2025-02-24,House,"(H) Appropriations--Do Pass",23,0,0,0,23
1946289,1500643,2025-02-26,House,"(H) 3rd Reading Passed",100,0,0,0,100
1946289,1521432,2025-03-19,Senate,"(S) Highways and Transportation--Be Concurred In",8,0,0,0,8
1946289,1543273,2025-04-10,Senate,"(S) 2nd Reading Concurred",42,8,0,0,50
1946289,1547043,2025-04-14,Senate,"(S) Finance and Claims--Be Concurred In",22,0,0,0,22
1946289,1548587,2025-04-15,Senate,"(S) 3rd Reading Concurred",44,6,0,0,50
1946338,1521806,2025-03-19,Senate,"(S) Taxation--Do Pass As Amended",8,0,0,0,8
1946338,1526975,2025-03-25,Senate,"(S) 2nd Reading Passed",47,2,0,1,50
1946338,1528327,2025-03-26,Senate,"(S) 3rd Reading Passed",49,1,0,0,50
1946338,1542316,2025-04-09,House,"(H) Taxation--Be Concurred In",13,8,0,0,21
1946338,1549360,2025-04-15,House,"(H) 2nd Reading Concurred",70,30,0,0,100
1946338,1550668,2025-04-16,House,"(H) 3rd Reading Concurred",66,32,0,2,100
1946385,1502624,2025-02-28,House,"(H) Education--Do Pass As Amended",8,7,0,0,15
1946385,1504991,2025-03-04,House,"(H) 2nd Reading Passed",54,45,0,1,100
1946385,1505800,2025-03-05,House,"(H) 3rd Reading Passed",56,42,0,2,100
1946385,1549240,2025-04-15,Senate,"(S) Education and Cultural Resources--To Take From The Table",7,4,3,0,14
1946385,1550197,2025-04-15,Senate,"(S) Education and Cultural Resources--Be Concurred In",9,5,0,0,14
1946385,1552093,2025-04-15,Senate,"(S) Education and Cultural Resources--Be Concurred In",9,5,0,0,14
1946385,1552094,2025-04-17,Senate,"(S) 2nd Reading Concurred",26,24,0,0,50
1946385,1552256,2025-04-18,Senate,"(S) 3rd Reading Concurred",31,19,0,0,50
1946433,1484402,2025-02-07,House,"(H) Education--Do Pass",15,0,0,0,15
1946433,1490631,2025-02-14,House,"(H) 2nd Reading Passed",99,1,0,0,100
1946433,1492306,2025-02-18,House,"(H) 3rd Reading Passed",99,0,0,1,100
1946433,1527189,2025-03-25,Senate,"(S) Education and Cultural Resources--Be Concurred In",8,6,0,0,14
1946433,1545081,2025-04-10,Senate,"(S) 2nd Reading Concurred",34,13,0,3,50
1946433,1546110,2025-04-11,Senate,"(S) 3rd Reading Concurred",32,16,0,2,50
1946495,1484125,2025-02-07,Senate,"(S) Business, Labor  and Economic Affairs--Do Pass",11,0,0,0,11
1946495,1486975,2025-02-11,Senate,"(S) 2nd Reading Passed",49,1,0,0,50
1946495,1488331,2025-02-12,Senate,"(S) 3rd Reading Passed",48,2,0,0,50
1946495,1524199,2025-03-21,House,"(H) Business and Labor--Be Concurred In",20,0,0,0,20
1946495,1531666,2025-03-31,House,"(H) 2nd Reading Concurred",99,1,0,0,100
1946495,1533718,2025-04-01,House,"(H) 3rd Reading Concurred",97,1,0,2,100
1946557,1502932,2025-03-01,Senate,"(S) Business, Labor  and Economic Affairs--To Table",10,2,0,0,12
1946623,1488499,2025-02-12,House,"(H) Transportation--Do Pass",14,0,0,0,14
1946623,1492831,2025-02-18,House,"(H) 2nd Reading Passed",99,1,0,0,100
1946623,1494277,2025-02-19,House,"(H) 3rd Reading Passed",100,0,0,0,100
1946623,1527957,2025-03-26,Senate,"(S) Highways and Transportation--Be Concurred In",8,0,0,0,8
1946623,1545286,2025-04-10,Senate,"(S) 2nd Reading Concurred",48,0,0,2,50
1946623,1546464,2025-04-11,Senate,"(S) 3rd Reading Concurred",48,0,0,2,50
1946623,1570991,2025-02-12,House,"(H) Transportation--Do Pass",14,0,0,0,14
1946690,1491506,2025-02-17,Senate,"(S) Local Government--Do Pass",11,0,0,0,11
1946690,1496524,2025-02-21,Senate,"(S) 2nd Reading Passed",34,16,0,0,50
1946690,1497730,2025-02-24,Senate,"(S) 3rd Reading Passed",31,18,0,1,50
1946690,1535858,2025-04-03,House,"(H) Judiciary--Be Concurred In",12,8,0,0,20
1946690,1543316,2025-04-10,House,"(H) 2nd Reading Concurred",54,46,0,0,100
1946690,1546370,2025-04-11,House,"(H) 3rd Reading Concurred",54,45,0,1,100
1946761,1482128,2025-02-03,House,"(H) Natural Resources--Do Pass",14,0,0,0,14
1946761,1487455,2025-02-12,House,"(H) 2nd Reading Passed",99,1,0,0,100
1946761,1489004,2025-02-13,House,"(H) 3rd Reading Passed",98,1,0,1,100
1946761,1543112,2025-04-09,Senate,"(S) Natural Resources--Be Concurred In",11,0,0,0,11
1946761,1546706,2025-04-12,Senate,"(S) 2nd Reading Concurred",46,3,0,1,50
1946761,1547693,2025-04-14,Senate,"(S) 3rd Reading Concurred",44,3,0,3,50
1946827,1487633,2025-02-12,House,"(H) State Administration--Do Pass",19,0,0,0,19
1946827,1496503,2025-02-21,House,"(H) 2nd Reading Passed",97,3,0,0,100
1946827,1497168,2025-02-22,House,"(H) 3rd Reading Passed",95,3,0,2,100
1946827,1546352,2025-04-11,Senate,"(S) State Administration--Be Concurred In",9,0,0,0,9
1946827,1547044,2025-04-14,Senate,"(S) 2nd Reading Concurred",39,11,0,0,50
1946827,1549233,2025-04-15,Senate,"(S) 3rd Reading Concurred",35,15,0,0,50
1946892,1485711,2025-02-10,House,"(H) Legislative Administration--Do Pass",9,5,0,0,14
1946892,1496925,2025-02-21,House,"(H) 2nd Reading Motion to Amend Failed",42,58,0,0,100
1946892,1496926,2025-02-21,House,"(H) 2nd Reading Passed",64,36,0,0,100
1946892,1497139,2025-02-22,House,"(H) 3rd Reading Passed",65,32,0,3,100
1946892,1542695,2025-04-09,Senate,"(S) Legislative Administration--To Table",5,1,0,0,6
1946892,1551658,2025-04-17,Senate,"(S) Taken from Committee; Placed on 2nd Reading",28,22,0,0,50
1946892,1552262,2025-04-18,Senate,"(S) 2nd Reading Concurred",29,21,0,0,50
1946892,1554343,2025-04-22,Senate,"(S) 3rd Reading Concurred",29,21,0,0,50
1946892,1563539,2025-02-10,House,"(H) Legislative Administration--Do Pass",9,5,0,0,14
1946958,1521111,2025-03-18,Senate,"(S) Fish and Game--To Table",11,1,0,0,12
1946958,1533757,2025-04-01,Senate,"(S) Fish and Game--Do Pass",8,3,1,0,12
1946958,1536960,2025-04-03,Senate,"(S) 2nd Reading Passed",38,12,0,0,50
1946958,1537096,2025-04-04,Senate,"(S) 3rd Reading Passed",38,11,0,1,50
1946958,1540749,2025-04-08,House,"(H) Fish, Wildlife and Parks--Be Concurred In",20,0,0,0,20
1946958,1548341,2025-04-15,House,"(H) 2nd Reading Concurred",79,21,0,0,100
1946958,1550601,2025-04-16,House,"(H) 3rd Reading Concurred",71,26,0,3,100
1947029,1491899,2025-02-12,House,"(H) Judiciary--Do Pass",12,8,0,0,20
1947029,1530663,2025-03-29,House,"(H) 2nd Reading Passed",58,42,0,0,100
1947029,1530906,2025-03-31,House,"(H) 3rd Reading Passed",58,41,0,1,100
1947029,1549753,2025-04-16,Senate,"(S) Judiciary--Resolution Adopted",5,3,0,0,8
1947029,1552132,2025-04-18,Senate,"(S) 2nd Reading Concurred",31,18,0,1,50
1947029,1553562,2025-04-22,Senate,"(S) 3rd Reading Concurred",31,19,0,0,50
1947094,1488188,2025-02-12,House,"(H) Energy, Technology and Federal Relations--Do Pass",8,6,0,0,14
1947094,1493575,2025-02-19,House,"(H) 2nd Reading Passed",58,42,0,0,100
1947094,1496092,2025-02-20,House,"(H) 3rd Reading Passed",57,42,0,1,100
1947094,1527496,2025-03-25,Senate,"(S) Energy, Technology & Federal Relations--Be Concurred In",8,5,0,0,13
1947094,1545257,2025-04-10,Senate,"(S) 2nd Reading Concurred",33,16,0,1,50
1947094,1546438,2025-04-11,Senate,"(S) 3rd Reading Concurred",32,16,0,2,50
1947094,1547938,2025-02-12,House,"(H) Energy, Technology and Federal Relations--Do Pass",8,6,0,0,14
1947161,1500706,2025-02-26,Senate,"(S) Business, Labor  and Economic Affairs--Do Pass",8,4,0,0,12
1947161,1502786,2025-02-28,Senate,"(S) 2nd Reading Passed",34,16,0,0,50
1947161,1502923,2025-03-01,Senate,"(S) 3rd Reading Passed",31,19,0,0,50
1947161,1528811,2025-03-27,House,"(H) State Administration--Be Concurred In",17,2,0,0,19
1947161,1530642,2025-03-29,House,"(H) 2nd Reading Concurred",80,20,0,0,100
1947161,1531507,2025-03-31,House,"(H) 3rd Reading Concurred",71,28,0,1,100
1947231,1495982,2025-02-20,Senate,"(S) Agriculture, Livestock and Irrigation--Do Pass As Amended",11,0,0,0,11
1947231,1520264,2025-03-18,Senate,"(S) 2nd Reading Passed",36,14,0,0,50
1947231,1521811,2025-03-19,Senate,"(S) 3rd Reading Passed",34,16,0,0,50
1947231,1533843,2025-04-01,House,"(H) Agriculture--Be Concurred In",17,0,0,0,17
1947231,1549935,2025-04-16,House,"(H) 2nd Reading Concurred",83,17,0,0,100
1947231,1551886,2025-04-17,House,"(H) 3rd Reading Concurred",69,30,0,1,100
1947298,1491930,2025-02-18,House,"(H) 2nd Reading Not Passed",49,51,0,0,100
1947298,1493274,2025-02-19,House,"(H) Motion Failed",50,50,0,0,100
1947364,1495438,2025-02-20,House,"(H) Fish, Wildlife and Parks--To Table",20,0,0,0,20
1947712,1482940,2025-02-05,House,"(H) Transportation--Do Pass",14,0,0,0,14
1947712,1484797,2025-02-10,House,"(H) 2nd Reading Passed",100,0,0,0,100
1947712,1486292,2025-02-11,House,"(H) 3rd Reading Passed",99,0,0,1,100
1947712,1528177,2025-03-26,Senate,"(S) Highways and Transportation--Be Concurred In",8,0,0,0,8
1947712,1544546,2025-04-10,Senate,"(S) 2nd Reading Concurred",50,0,0,0,50
1947712,1546321,2025-04-11,Senate,"(S) 3rd Reading Concurred",48,0,0,2,50
1947712,1558215,2025-02-05,House,"(H) Transportation--Do Pass",14,0,0,0,14
1947987,1489386,2025-02-13,House,"(H) Human Services--Do Pass As Amended",21,0,0,0,21
1947987,1493213,2025-02-19,House,"(H) 2nd Reading Passed",90,10,0,0,100
1947987,1495378,2025-02-20,House,"(H) 3rd Reading Passed",93,6,0,1,100
1947987,1530391,2025-03-28,Senate,"(S) Public Health, Welfare and Safety--Be Concurred In As Amended",8,3,0,0,11
1947987,1534333,2025-04-02,Senate,"(S) 2nd Reading Concurred",35,13,0,2,50
1947987,1536334,2025-04-03,Senate,"(S) 3rd Reading Concurred",35,15,0,0,50
1947987,1547352,2025-04-14,House,"(H) 2nd Reading Senate Amendments Concurred",94,6,0,0,100
1947987,1549060,2025-04-15,House,"(H) 3rd Reading Passed as Amended by Senate",95,2,0,3,100
1948277,1498169,2025-02-24,Senate,"(S) Local Government--Do Pass As Amended",10,1,0,0,11
1948277,1502392,2025-02-28,Senate,"(S) 2nd Reading Passed",46,4,0,0,50
1948277,1502934,2025-03-01,Senate,"(S) 3rd Reading Passed",47,3,0,0,50
1948277,1540399,2025-04-08,House,"(H) Local Government--Be Concurred In As Amended",15,2,0,0,17
1948277,1545768,2025-04-11,House,"(H) 2nd Reading Motion to Amend Failed",33,67,0,0,100
1948277,1545769,2025-04-11,House,"(H) 2nd Reading Concurred",79,21,0,0,100
1948277,1546282,2025-04-11,House,"(H) 3rd Reading Concurred",77,22,0,1,100
1948277,1549890,2025-04-16,Senate,"(S) 2nd Reading House Amendments Concurred",38,12,0,0,50
1948277,1551709,2025-04-17,Senate,"(S) 3rd Reading Passed as Amended by House",41,9,0,0,50
1948364,1497871,2025-02-24,Senate,"(S) Highways and Transportation--Do Pass As Amended",8,0,0,0,8
1948364,1502521,2025-02-28,Senate,"(S) 2nd Reading Passed",49,0,0,1,50
1948364,1502909,2025-03-01,Senate,"(S) 3rd Reading Passed",49,0,0,1,50
1948364,1531575,2025-03-31,House,"(H) Transportation--Be Concurred In",14,0,0,0,14
1948364,1544448,2025-04-10,House,"(H) 2nd Reading Concurred",98,2,0,0,100
1948364,1546319,2025-04-11,House,"(H) 3rd Reading Concurred",96,3,0,1,100
1948460,1495701,2025-02-20,House,"(H) Fish, Wildlife and Parks--Do Pass",13,7,0,0,20
1948460,1501511,2025-02-27,House,"(H) 2nd Reading Passed",64,36,0,0,100
1948460,1502361,2025-02-28,House,"(H) 3rd Reading Passed",67,31,0,2,100
1948460,1533644,2025-04-01,Senate,"(S) Fish and Game--Be Concurred In As Amended",11,0,1,0,12
1948460,1541000,2025-04-08,Senate,"(S) Fish and Game--Be Concurred In",6,5,0,0,11
1948460,1544912,2025-04-10,Senate,"(S) 2nd Reading Concurred",45,5,0,0,50
1948460,1546050,2025-04-11,Senate,"(S) 3rd Reading Concurred",46,2,0,2,50
1948553,1483761,2025-02-06,House,"(H) Agriculture--Do Pass",17,0,0,0,17
1948553,1486294,2025-02-11,House,"(H) 2nd Reading Passed",96,4,0,0,100
1948553,1488350,2025-02-12,House,"(H) 3rd Reading Passed",94,6,0,0,100
1948553,1526185,2025-03-25,Senate,"(S) Agriculture, Livestock and Irrigation--Be Concurred In",11,0,0,0,11
1948553,1551856,2025-04-17,Senate,"(S) 2nd Reading Concurred",48,2,0,0,50
1948553,1552266,2025-04-18,Senate,"(S) 3rd Reading Concurred",48,2,0,0,50
1948650,1489434,2025-02-13,House,"(H) Fish, Wildlife and Parks--To Table",12,8,0,0,20
1948748,1494387,2025-02-19,House,"(H) Education--Do Pass As Amended",15,0,0,0,15
1948748,1497476,2025-02-24,House,"(H) 2nd Reading Passed",96,4,0,0,100
1948748,1498716,2025-02-25,House,"(H) 3rd Reading Passed",88,12,0,0,100
1948748,1527178,2025-03-25,Senate,"(S) Education and Cultural Resources--Be Concurred In",13,1,0,0,14
1948748,1531113,2025-03-31,Senate,"(S) 2nd Reading Concurred",44,6,0,0,50
1948748,1533774,2025-04-01,Senate,"(S) 3rd Reading Concurred",44,6,0,0,50
1948849,1488528,2025-02-12,House,"(H) Natural Resources--Do Pass",14,0,0,0,14
1948849,1492518,2025-02-18,House,"(H) 2nd Reading Passed",98,2,0,0,100
1948849,1494141,2025-02-19,House,"(H) 3rd Reading Passed",98,2,0,0,100
1948849,1543122,2025-04-09,Senate,"(S) Natural Resources--Be Concurred In",11,0,0,0,11
1948849,1546555,2025-04-12,Senate,"(S) 2nd Reading Concurred",49,1,0,0,50
1948849,1547041,2025-04-14,Senate,"(S) 3rd Reading Concurred",47,1,0,2,50
1948948,1526745,2025-03-25,House,"(H) Appropriations--Do Pass As Amended",19,4,0,0,23
1948948,1537138,2025-04-02,House,"(H) 2nd Reading Motion to Amend Carried",98,1,0,1,100
1948948,1537139,2025-04-02,House,"(H) 2nd Reading Motion to Amend Failed",28,72,0,0,100
1948948,1537140,2025-04-02,House,"(H) 2nd Reading Motion to Amend Failed",30,69,0,1,100
1948948,1537141,2025-04-02,House,"(H) 2nd Reading Motion to Amend Carried",58,41,0,1,100
1948948,1537142,2025-04-02,House,"(H) 2nd Reading Motion to Amend Failed",35,65,0,0,100
1948948,1537143,2025-04-02,House,"(H) 2nd Reading Motion to Amend Failed",42,58,0,0,100
1948948,1537144,2025-04-02,House,"(H) 2nd Reading Motion to Amend Failed",42,58,0,0,100
1948948,1537145,2025-04-02,House,"(H) 2nd Reading Motion to Amend Carried",60,40,0,0,100
1948948,1537146,2025-04-02,House,"(H) 2nd Reading Motion to Amend Failed",44,56,0,0,100
1948948,1537147,2025-04-02,House,"(H) 2nd Reading Motion to Amend Failed",40,60,0,0,100
1948948,1537148,2025-04-02,House,"(H) 2nd Reading Motion to Amend Carried",98,2,0,0,100
1948948,1537149,2025-04-02,House,"(H) 2nd Reading Motion to Amend Failed",42,58,0,0,100
1948948,1537150,2025-04-02,House,"(H) 2nd Reading Motion to Amend Failed",30,70,0,0,100
1948948,1537151,2025-04-02,House,"(H) 2nd Reading Motion to Amend Failed",34,64,0,2,100
1948948,1537152,2025-04-02,House,"(H) 2nd Reading Motion to Amend Carried",60,40,0,0,100
1948948,1537153,2025-04-02,House,"(H) 2nd Reading Motion to Amend Carried",66,34,0,0,100
1948948,1537154,2025-04-02,House,"(H) 2nd Reading Motion to Amend Failed",43,57,0,0,100
1948948,1537155,2025-04-02,House,"(H) 2nd Reading Motion to Amend Failed",43,57,0,0,100
1948948,1537156,2025-04-02,House,"(H) 2nd Reading Motion to Amend Failed",37,63,0,0,100
1948948,1537157,2025-04-02,House,"(H) 2nd Reading Motion to Amend Failed",36,64,0,0,100
1948948,1537158,2025-04-02,House,"(H) 2nd Reading Motion to Amend Failed",35,64,0,1,100
1948948,1537159,2025-04-02,House,"(H) 2nd Reading Motion to Amend Failed",44,56,0,0,100
1948948,1537160,2025-04-02,House,"(H) 2nd Reading Motion to Amend Failed",36,62,0,2,100
1948948,1537161,2025-04-02,House,"(H) 2nd Reading Motion to Amend Failed",35,64,0,1,100
1948948,1537162,2025-04-02,House,"(H) 2nd Reading Motion to Amend Failed",45,54,0,1,100
1948948,1537163,2025-04-02,House,"(H) 2nd Reading Motion to Amend Failed",35,65,0,0,100
1948948,1537164,2025-04-02,House,"(H) 2nd Reading Motion to Amend Failed",35,64,0,1,100
1948948,1537165,2025-04-02,House,"(H) 2nd Reading Motion to Amend Failed",39,61,0,0,100
1948948,1537166,2025-04-02,House,"(H) 2nd Reading Motion to Amend Failed",28,71,0,1,100
1948948,1537167,2025-04-02,House,"(H) 2nd Reading Passed as Amended",60,40,0,0,100
1948948,1538411,2025-04-07,House,"(H) 3rd Reading Passed",61,38,0,1,100
1948948,1545624,2025-04-11,Senate,"(S) Finance and Claims--Be Concurred In As Amended",13,9,0,0,22
1948948,1550936,2025-04-17,Senate,"(S) 2nd Reading Motion to Amend Failed",21,27,0,2,50
1948948,1550937,2025-04-17,Senate,"(S) 2nd Reading Motion to Amend Failed",21,29,0,0,50
1948948,1550938,2025-04-17,Senate,"(S) 2nd Reading Motion to Amend Failed",23,27,0,0,50
1948948,1550939,2025-04-17,Senate,"(S) 2nd Reading Motion to Amend Failed",23,27,0,0,50
1948948,1550940,2025-04-17,Senate,"(S) 2nd Reading Motion to Amend Failed",24,26,0,0,50
1948948,1550941,2025-04-17,Senate,"(S) 2nd Reading Motion to Amend Carried",27,22,0,1,50
1948948,1550942,2025-04-17,Senate,"(S) 2nd Reading Motion to Amend Failed",21,28,0,1,50
1948948,1550943,2025-04-17,Senate,"(S) 2nd Reading Motion to Amend Failed",22,28,0,0,50
1948948,1550944,2025-04-17,Senate,"(S) 2nd Reading Motion to Amend Failed",24,26,0,0,50
1948948,1550945,2025-04-17,Senate,"(S) 2nd Reading Motion to Amend Failed",23,27,0,0,50
1948948,1550946,2025-04-17,Senate,"(S) 2nd Reading Motion to Amend Failed",23,27,0,0,50
1948948,1550947,2025-04-17,Senate,"(S) 2nd Reading Motion to Amend Failed",23,27,0,0,50
1948948,1550948,2025-04-17,Senate,"(S) 2nd Reading Motion to Amend Failed",23,27,0,0,50
1948948,1550949,2025-04-17,Senate,"(S) 2nd Reading Motion to Amend Failed",23,26,0,1,50
1948948,1550950,2025-04-17,Senate,"(S) 2nd Reading Motion to Amend Failed",23,27,0,0,50
1948948,1550951,2025-04-17,Senate,"(S) 2nd Reading Motion to Amend Failed",23,26,0,1,50
1948948,1551437,2025-04-17,Senate,"(S) 2nd Reading Motion to Amend Failed",27,23,0,0,50
1948948,1551438,2025-04-17,Senate,"(S) 2nd Reading Motion to Amend Failed",21,29,0,0,50
1948948,1551439,2025-04-17,Senate,"(S) 2nd Reading Motion to Amend Carried",26,24,0,0,50
1948948,1551440,2025-04-17,Senate,"(S) 2nd Reading Motion to Amend Failed",24,26,0,0,50
1948948,1551441,2025-04-17,Senate,"(S) 2nd Reading Motion to Amend Failed",23,27,0,0,50
1948948,1551442,2025-04-17,Senate,"(S) 2nd Reading Motion to Amend Carried",27,23,0,0,50
1948948,1551443,2025-04-17,Senate,"(S) 2nd Reading Concurred as Amended",27,23,0,0,50
1948948,1555295,2025-04-23,Senate,"(S) 3rd Reading Concurred",27,23,0,0,50
1948948,1558977,2025-04-28,House,"(H) 2nd Reading Senate Amendments Concurred",67,33,0,0,100
1948948,1562041,2025-04-30,House,"(H) 3rd Reading Passed as Amended by Senate",66,34,0,0,100
1949049,1490331,2025-02-14,Senate,"(S) Business, Labor  and Economic Affairs--Do Pass As Amended",11,0,0,0,11
1949049,1492716,2025-02-18,Senate,"(S) 2nd Reading Passed",43,7,0,0,50
1949049,1493646,2025-02-19,Senate,"(S) 3rd Reading Passed",40,8,0,2,50
1949049,1529455,2025-03-27,House,"(H) Business and Labor--Be Concurred In As Amended",14,6,0,0,20
1949049,1533074,2025-04-01,House,"(H) 2nd Reading Concurred",73,27,0,0,100
1949049,1537331,2025-04-04,House,"(H) Appropriations--Be Concurred In",21,1,1,0,23
1949049,1540223,2025-04-08,House,"(H) 3rd Reading Concurred",72,25,0,3,100
1949049,1545140,2025-04-10,Senate,"(S) 2nd Reading House Amendments Concurred",44,5,0,1,50
1949049,1546605,2025-04-12,Senate,"(S) 3rd Reading Passed as Amended by House",44,6,0,0,50
1949238,1521052,2025-03-19,Senate,"(S) Taxation--Do Pass As Amended",8,0,0,0,8
1949238,1533764,2025-04-01,Senate,"(S) 2nd Reading Passed",49,1,0,0,50
1949238,1535370,2025-04-02,Senate,"(S) 3rd Reading Passed",49,1,0,0,50
1949238,1542587,2025-04-09,House,"(H) Taxation--Be Concurred In",20,1,0,0,21
1949238,1548756,2025-04-15,House,"(H) 2nd Reading Concurred",56,44,0,0,100
1949238,1550158,2025-04-16,House,"(H) 3rd Reading Concurred",57,41,0,2,100
1949329,1485300,2025-02-10,House,"(H) Human Services--To Table",17,0,0,4,21
1949329,1558118,2025-02-10,House,"(H) Human Services--To Table",17,0,4,0,21
1949418,1497953,2025-02-24,Senate,"(S) State Administration--Do Pass",9,0,0,0,9
1949418,1502411,2025-02-28,Senate,"(S) 2nd Reading Passed",45,4,0,1,50
1949418,1502925,2025-03-01,Senate,"(S) 3rd Reading Passed",44,6,0,0,50
1949418,1528601,2025-03-27,House,"(H) State Administration--Be Concurred In As Amended",14,5,0,0,19
1949418,1532387,2025-04-01,House,"(H) 2nd Reading Concurred",68,31,0,1,100
1949418,1535298,2025-04-02,House,"(H) 3rd Reading Concurred",60,35,0,5,100
1949418,1538712,2025-04-07,Senate,"(S) 2nd Reading House Amendments Concurred",45,4,0,1,50
1949418,1540067,2025-04-08,Senate,"(S) 3rd Reading Passed as Amended by House",41,7,0,2,50
1949507,1487412,2025-02-12,House,"(H) State Administration--Do Pass",19,0,0,0,19
1949507,1492698,2025-02-18,House,"(H) 2nd Reading Passed",92,8,0,0,100
1949507,1496983,2025-02-21,House,"(H) Appropriations--Do Pass",22,0,0,1,23
1949507,1498190,2025-02-24,House,"(H) 3rd Reading Passed",90,9,0,1,100
1949507,1531750,2025-03-31,Senate,"(S) State Administration--Be Concurred In",9,0,0,0,9
1949507,1544729,2025-04-10,Senate,"(S) 2nd Reading Concurred",45,5,0,0,50
1949507,1546210,2025-04-11,Senate,"(S) Finance and Claims--Be Concurred In",13,9,0,0,22
1949507,1546696,2025-04-12,Senate,"(S) 3rd Reading Concurred",37,13,0,0,50
1949592,1488345,2025-02-12,House,"(H) State Administration--Do Pass",19,0,0,0,19
1949592,1493248,2025-02-19,House,"(H) 2nd Reading Passed",93,7,0,0,100
1949592,1495813,2025-02-20,House,"(H) 3rd Reading Passed",93,6,0,1,100
1949592,1531764,2025-03-31,Senate,"(S) State Administration--Be Concurred In",8,1,0,0,9
1949592,1543737,2025-04-10,Senate,"(S) 2nd Reading Concurred",50,0,0,0,50
1949592,1546289,2025-04-11,Senate,"(S) 3rd Reading Concurred",45,3,0,2,50
1949928,1488146,2025-02-12,House,"(H) Judiciary--Do Pass",12,8,0,0,20
1949928,1492803,2025-02-18,House,"(H) 2nd Reading Passed",58,42,0,0,100
1949928,1494271,2025-02-19,House,"(H) 3rd Reading Passed",57,43,0,0,100
1949928,1523273,2025-03-20,Senate,"(S) Judiciary--Be Concurred In",5,3,0,0,8
1949928,1546694,2025-04-12,Senate,"(S) 2nd Reading Concurred",32,18,0,0,50
1949928,1547627,2025-04-14,Senate,"(S) 3rd Reading Concurred",31,17,0,2,50
1949965,1496527,2025-02-21,Senate,"(S) Public Health, Welfare and Safety--Do Pass",11,0,0,0,11
1949965,1498743,2025-02-25,Senate,"(S) 2nd Reading Passed",49,1,0,0,50
1949965,1500539,2025-02-26,Senate,"(S) 3rd Reading Passed",49,1,0,0,50
1949965,1520218,2025-03-18,House,"(H) Human Services--Be Concurred In",21,0,0,0,21
1949965,1526540,2025-03-25,House,"(H) 2nd Reading Concurred",99,0,0,1,100
1949965,1527925,2025-03-26,House,"(H) 3rd Reading Concurred",98,1,0,1,100
1950006,1490624,2025-02-14,Senate,"(S) Public Health, Welfare and Safety--Do Pass",11,0,0,0,11
1950006,1496083,2025-02-20,Senate,"(S) 2nd Reading Passed",50,0,0,0,50
1950006,1496934,2025-02-21,Senate,"(S) 3rd Reading Passed",50,0,0,0,50
1950006,1520156,2025-03-18,House,"(H) Human Services--Be Concurred In",12,9,0,0,21
1950006,1529704,2025-03-27,House,"(H) 2nd Reading Concurred",62,38,0,0,100
1950006,1529989,2025-03-28,House,"(H) 3rd Reading Concurred",61,38,0,1,100
1950043,1485406,2025-02-10,House,"(H) Human Services--To Table",17,0,0,4,21
1950043,1497643,2025-02-21,House,"(H) Human Services--Do Pass As Amended",16,5,0,0,21
1950043,1503069,2025-03-01,House,"(H) 2nd Reading Passed",78,22,0,0,100
1950043,1503488,2025-03-03,House,"(H) 3rd Reading Passed",66,31,0,3,100
1950043,1536689,2025-04-03,Senate,"(S) Education and Cultural Resources--To Table",14,0,0,0,14
1950043,1542380,2025-04-03,Senate,"(S) Education and Cultural Resources--To Table",14,0,0,0,14
1950043,1555306,2025-04-23,Senate,"(S) Taken from Committee; Placed on 2nd Reading",26,24,0,0,50
1950043,1557148,2025-04-24,Senate,"(S) 2nd Reading Concur Motion Failed",21,29,0,0,50
1950043,1557149,2025-04-24,Senate,"(S) 2nd Reading Indefinitely Postponed",33,17,0,0,50
1950043,1583022,2025-04-03,Senate,"(S) Education and Cultural Resources--To Table",14,0,0,0,14
1950081,1487574,2025-02-12,House,"(H) Business and Labor--To Table",19,1,0,0,20
1950081,1507066,2025-03-04,House,"(H) Business and Labor--To Take From The Table",7,10,0,2,19
1950119,1496531,2025-02-21,Senate,"(S) Public Health, Welfare and Safety--Do Pass As Amended",7,4,0,0,11
1950119,1499321,2025-02-25,Senate,"(S) 2nd Reading Motion to Amend Carried",49,1,0,0,50
1950119,1499322,2025-02-25,Senate,"(S) 2nd Reading Passed as Amended",37,13,0,0,50
1950119,1505999,2025-02-27,Senate,"(S) Finance and Claims--To Table",22,0,0,0,22
1950158,1494156,2025-02-19,House,"(H) Energy, Technology and Federal Relations--To Table",10,4,0,0,14
1950196,1496954,2025-02-21,House,"(H) Education--Do Pass As Amended",15,0,0,0,15
1950196,1520048,2025-03-18,House,"(H) 2nd Reading Passed",57,42,0,1,100
1950196,1530333,2025-03-28,House,"(H) Appropriations--Do Pass As Amended",17,6,0,0,23
1950196,1537036,2025-04-04,House,"(H) 2nd Reading Passed",55,45,0,0,100
1950196,1537636,2025-04-05,House,"(H) 3rd Reading Passed",57,41,0,2,100
1950196,1549489,2025-04-15,Senate,"(S) Education and Cultural Resources--To Table",14,0,0,0,14
1950196,1550227,2025-04-15,Senate,"(S) Education and Cultural Resources--To Table",14,0,0,0,14
1950196,1550228,2025-04-04,House,"(H) 2nd Reading Passed",55,45,0,0,100
1950226,1490589,2025-02-14,Senate,"(S) Public Health, Welfare and Safety--Do Pass",11,0,0,0,11
1950226,1496010,2025-02-20,Senate,"(S) 2nd Reading Passed",41,9,0,0,50
1950226,1496930,2025-02-21,Senate,"(S) 3rd Reading Passed",37,13,0,0,50
1950226,1520641,2025-03-18,House,"(H) Human Services--Be Concurred In",13,8,0,0,21
1950226,1529706,2025-03-27,House,"(H) 2nd Reading Concurred",62,38,0,0,100
1950226,1529988,2025-03-28,House,"(H) 3rd Reading Concurred",61,38,0,1,100
1950351,1490793,2025-02-17,House,"(H) Business and Labor--Do Pass As Amended",20,0,0,0,20
1950351,1494952,2025-02-20,House,"(H) 2nd Reading Passed",100,0,0,0,100
1950351,1496733,2025-02-21,House,"(H) 3rd Reading Passed",98,0,0,2,100
1950351,1523238,2025-03-20,Senate,"(S) Business, Labor  and Economic Affairs--Be Concurred In",12,0,0,0,12
1950351,1544525,2025-04-10,Senate,"(S) 2nd Reading Concurred",50,0,0,0,50
1950351,1546428,2025-04-11,Senate,"(S) 3rd Reading Concurred",47,1,0,2,50
1950472,1498201,2025-02-24,Senate,"(S) Local Government--Do Pass As Amended",11,0,0,0,11
1950472,1502420,2025-02-28,Senate,"(S) 2nd Reading Passed",48,1,0,1,50
1950472,1502937,2025-03-01,Senate,"(S) 3rd Reading Passed",48,1,0,1,50
1950472,1526689,2025-03-25,House,"(H) Local Government--Be Concurred In As Amended",17,0,0,0,17
1950472,1532379,2025-04-01,House,"(H) 2nd Reading Concurred",98,2,0,0,100
1950472,1534508,2025-04-02,House,"(H) 3rd Reading Concurred",91,4,0,5,100
1950472,1538586,2025-04-07,Senate,"(S) 2nd Reading Passed",49,1,0,0,50
1950472,1539737,2025-04-08,Senate,"(S) 3rd Reading Passed as Amended by House",48,0,0,2,50
1950591,1531007,2025-03-31,House,"(H) Judiciary--Do Pass As Amended",14,6,0,0,20
1950591,1535772,2025-04-03,House,"(H) Appropriations--To Table",22,1,0,0,23
1950715,1498123,2025-02-24,House,"(H) Natural Resources--Do Pass As Amended",14,0,0,0,14
1950715,1502968,2025-03-01,House,"(H) 2nd Reading Passed",100,0,0,0,100
1950715,1503170,2025-03-03,House,"(H) Appropriations--Do Pass",22,1,0,0,23
1950715,1504986,2025-03-04,House,"(H) 3rd Reading Passed",98,1,0,1,100
1950715,1524130,2025-03-21,Senate,"(S) Natural Resources--Be Concurred In",11,0,0,0,11
1950715,1543304,2025-04-10,Senate,"(S) 2nd Reading Concurred",50,0,0,0,50
1950715,1546198,2025-04-11,Senate,"(S) Finance and Claims--Be Concurred In",22,0,0,0,22
1950715,1546607,2025-04-12,Senate,"(S) 3rd Reading Concurred",50,0,0,0,50
1950841,1502217,2025-02-27,House,"(H) Local Government--To Table",14,3,0,0,17
1950841,1534103,2025-04-01,House,"(H) Local Government--Do Pass As Amended",14,3,0,0,17
1950841,1538790,2025-04-07,House,"(H) 2nd Reading Not Passed",32,67,0,1,100
1950882,1496631,2025-02-21,House,"(H) Human Services--Do Pass As Amended",12,9,0,0,21
1950882,1500039,2025-02-26,House,"(H) 2nd Reading Passed",59,41,0,0,100
1950882,1501394,2025-02-27,House,"(H) 3rd Reading Passed",57,41,0,2,100
1950882,1538565,2025-04-07,Senate,"(S) Public Health, Welfare and Safety--Be Concurred In As Amended",6,5,0,0,11
1950882,1544508,2025-04-10,Senate,"(S) 2nd Reading Concur Motion Failed",25,25,0,0,50
1950882,1544509,2025-04-10,Senate,"(S) 2nd Reading Indefinitely Postponed",29,20,0,1,50
1950917,1496212,2025-02-21,Senate,"(S) Taxation--Do Pass",7,1,0,0,8
1950917,1502645,2025-02-28,Senate,"(S) 2nd Reading Passed",43,7,0,0,50
1950917,1521798,2025-03-19,Senate,"(S) Finance and Claims--Do Pass As Amended",22,0,0,0,22
1950917,1522950,2025-03-20,Senate,"(S) 2nd Reading Passed",44,6,0,0,50
1950917,1524089,2025-03-21,Senate,"(S) 3rd Reading Passed",45,5,0,0,50
1950917,1543089,2025-04-09,House,"(H) Taxation--Be Concurred In",19,2,0,0,21
1950917,1549039,2025-04-15,House,"(H) 2nd Reading Concurred",77,23,0,0,100
1950917,1552078,2025-04-18,House,"(H) Appropriations--Be Concurred In As Amended",13,10,0,0,23
1950917,1556209,2025-04-23,House,"(H) 2nd Reading Concurred",57,43,0,0,100
1950917,1557445,2025-04-24,House,"(H) 3rd Reading Concurred",57,43,0,0,100
1950917,1559584,2025-04-28,Senate,"(S) 2nd Reading House Amendments Concurred",44,6,0,0,50
1950917,1559964,2025-04-29,Senate,"(S) 3rd Reading Passed as Amended by House",49,1,0,0,50
1950952,1490199,2025-02-14,House,"(H) State Administration--To Table",10,9,0,0,19
1950989,1501828,2025-02-27,House,"(H) Business and Labor--Do Pass As Amended",19,1,0,0,20
1950989,1522904,2025-03-20,House,"(H) 2nd Reading Motion to Amend Carried",57,43,0,0,100
1950989,1522905,2025-03-20,House,"(H) 2nd Reading Not Passed as Amended",44,56,0,0,100
1951024,1492247,2025-02-18,House,"(H) Business and Labor--To Table",20,0,0,0,20
1951058,1504936,2025-03-04,Senate,"(S) State Administration--To Table",9,0,0,0,9
1951058,1506741,2025-03-05,Senate,"(S) Motion Failed",22,28,0,0,50
1951093,1492853,2025-02-18,House,"(H) Fish, Wildlife and Parks--Do Pass As Amended",18,2,0,0,20
1951093,1515682,2025-03-01,House,"(H) Fish, Wildlife and Parks--Do Pass As Amended",20,0,0,0,20
1951093,1520988,2025-03-19,House,"(H) 2nd Reading Passed",88,12,0,0,100
1951093,1526671,2025-03-25,House,"(H) Appropriations--Do Pass",20,0,0,3,23
1951093,1528960,2025-03-27,House,"(H) 3rd Reading Passed",90,9,0,1,100
1951093,1549450,2025-04-15,Senate,"(S) Fish and Game--Be Concurred In",8,3,0,0,11
1951093,1551692,2025-04-17,Senate,"(S) 2nd Reading Concur Motion Failed",23,26,0,1,50
1951093,1552176,2025-04-17,Senate,"(S) 2nd Reading Indefinitely Postponed",30,19,0,1,50
1951093,1552177,2025-04-17,Senate,"(S) 2nd Reading Concur Motion Failed",23,26,0,1,50
1951093,1552178,2025-04-18,Senate,"(S) Reconsidered Previous Action; Placed on 2nd Reading",27,23,0,0,50
1951093,1554742,2025-04-22,Senate,"(S) 2nd Reading Concurred",30,20,0,0,50
1951093,1555843,2025-04-23,Senate,"(S) 3rd Reading Concurred",31,19,0,0,50
1951130,1496150,2025-02-14,House,"(H) State Administration--To Table",19,0,0,0,19
1951130,1516184,2025-02-24,House,"(H) State Administration--To Table",18,1,0,0,19
1951164,1490338,2025-02-14,House,"(H) State Administration--To Table",18,1,0,0,19
1951164,1502376,2025-02-24,House,"(H) State Administration--To Table",15,4,0,0,19
1951164,1507908,2025-03-01,House,"(H) State Administration--To Take From The Table",3,11,0,5,19
1951200,1488549,2025-02-12,House,"(H) Energy, Technology and Federal Relations--Do Pass",8,6,0,0,14
1951200,1525135,2025-03-24,House,"(H) 2nd Reading Passed",57,41,0,2,100
1951200,1526180,2025-03-25,House,"(H) 3rd Reading Passed",57,42,0,1,100
1951200,1557094,2025-02-12,House,"(H) Energy, Technology and Federal Relations--Do Pass",8,6,0,0,14
1951231,1487354,2025-02-12,House,"(H) Judiciary--Do Pass As Amended",12,8,0,0,20
1951231,1493459,2025-02-19,House,"(H) 2nd Reading Not Passed",34,66,0,0,100
1951231,1559084,2025-02-12,House,"(H) Judiciary--Do Pass As Amended",12,8,0,0,20
1951529,1499494,2025-02-25,House,"(H) Local Government--To Table",10,7,0,0,17
1951653,1489972,2025-02-14,House,"(H) State Administration--To Table",19,0,0,0,19
1951653,1502253,2025-02-24,House,"(H) State Administration--To Table",12,7,0,0,19
1951653,1502254,2025-02-28,House,"(H) State Administration--Do Pass",12,7,0,0,19
1951653,1524196,2025-03-21,House,"(H) 2nd Reading Passed",54,45,0,1,100
1951653,1524658,2025-03-24,House,"(H) 3rd Reading Failed",42,55,0,3,100
1951776,1490635,2025-02-14,Senate,"(S) Public Health, Welfare and Safety--Do Pass",7,4,0,0,11
1951776,1495283,2025-02-20,Senate,"(S) 2nd Reading Passed",31,19,0,0,50
1951776,1496702,2025-02-21,Senate,"(S) 3rd Reading Passed",27,23,0,0,50
1951776,1520083,2025-03-18,House,"(H) Human Services--Be Concurred In As Amended",21,0,0,0,21
1951776,1525349,2025-03-24,House,"(H) 2nd Reading Concurred",97,0,0,3,100
1951776,1526309,2025-03-25,House,"(H) 3rd Reading Concurred",99,0,0,1,100
1951776,1529199,2025-03-27,Senate,"(S) 2nd Reading House Amendments Concurred",47,1,0,2,50
1951776,1530255,2025-03-28,Senate,"(S) 3rd Reading Passed as Amended by House",48,0,0,2,50
1951786,1490505,2025-02-14,Senate,"(S) Public Health, Welfare and Safety--To Table",11,0,0,0,11
1951786,1516322,2025-02-14,Senate,"(S) Public Health, Welfare and Safety--To Table",11,0,0,0,11
1951786,1516323,2025-02-14,Senate,"(S) Public Health, Welfare and Safety--Do Pass As Amended",1,10,0,0,11
1951861,1489820,2025-02-13,Senate,"(S) Fish and Game--Do Pass",10,2,0,0,12
1951861,1499442,2025-02-25,Senate,"(S) 2nd Reading Passed",47,3,0,0,50
1951861,1500746,2025-02-26,Senate,"(S) 3rd Reading Passed",46,4,0,0,50
1951861,1541925,2025-04-08,House,"(H) Fish, Wildlife and Parks--Be Concurred In",19,1,0,0,20
1951861,1548247,2025-04-15,House,"(H) 2nd Reading Concurred",100,0,0,0,100
1951861,1550539,2025-04-16,House,"(H) 3rd Reading Concurred",96,2,0,2,100
1951938,1490592,2025-02-14,House,"(H) State Administration--Do Pass",19,0,0,0,19
1951938,1492893,2025-02-18,House,"(H) 2nd Reading Passed",99,0,0,1,100
1951938,1494274,2025-02-19,House,"(H) 3rd Reading Passed",100,0,0,0,100
1951938,1528347,2025-03-26,Senate,"(S) State Administration--Be Concurred In",8,1,0,0,9
1951938,1546511,2025-04-12,Senate,"(S) 2nd Reading Concurred",44,6,0,0,50
1951938,1547808,2025-04-14,Senate,"(S) 3rd Reading Concurred",43,5,0,2,50
1952018,1499408,2025-02-25,House,"(H) Human Services--Do Pass",21,0,0,0,21
1952018,1502344,2025-02-28,House,"(H) 2nd Reading Passed",98,1,0,1,100
1952018,1502974,2025-03-01,House,"(H) 3rd Reading Passed",97,0,0,3,100
1952018,1541086,2025-04-08,Senate,"(S) Education and Cultural Resources--Be Concurred In As Amended",10,4,0,0,14
1952018,1543276,2025-04-10,Senate,"(S) 2nd Reading Concurred",50,0,0,0,50
1952018,1546168,2025-04-11,Senate,"(S) 3rd Reading Concurred",48,0,0,2,50
1952018,1549779,2025-04-16,House,"(H) 2nd Reading Senate Amendments Concurred",100,0,0,0,100
1952018,1551578,2025-04-17,House,"(H) 3rd Reading Passed as Amended by Senate",99,0,0,1,100
1952018,1560209,2025-04-29,House,"(H) 2nd Reading Governor's Proposed Amendments Adopted",99,1,0,0,100
1952018,1560210,2025-04-29,Senate,"(S) 2nd Reading Governor's Proposed Amendments Adopted",48,0,0,2,50
1952018,1561739,2025-04-30,House,"(H) 3rd Reading Governor's Proposed Amendments Adopted",98,2,0,0,100
1952018,1562382,2025-04-30,Senate,"(S) 3rd Reading Governor's Proposed Amendments Adopted",50,0,0,0,50
1952177,1489875,2025-02-13,Senate,"(S) Education and Cultural Resources--Do Pass",8,6,0,0,14
1952177,1492522,2025-02-18,Senate,"(S) 2nd Reading Passed",26,24,0,0,50
1952177,1494267,2025-02-19,Senate,"(S) 3rd Reading Passed",27,22,0,1,50
1952177,1542155,2025-04-09,House,"(H) Education--To Table",8,7,0,0,15
1952177,1544388,2025-04-09,House,"(H) Education--To Table",8,7,0,0,15
1952177,1548906,2025-04-09,House,"(H) Education--To Table",8,7,0,0,15
1952177,1550244,2025-04-16,House,"(H) Education--Be Concurred In",10,5,0,0,15
1952177,1554383,2025-04-22,House,"(H) 2nd Reading Concurred",57,42,0,1,100
1952177,1555860,2025-04-23,House,"(H) 3rd Reading Concurred",59,40,0,1,100
1952177,1573187,2025-02-13,Senate,"(S) Education and Cultural Resources--Do Pass",8,6,0,0,14
1952257,1493501,2025-02-19,Senate,"(S) Judiciary--To Table",8,0,0,1,9
1952257,1499904,2025-02-26,Senate,"(S) Judiciary--Do Pass As Amended",5,3,0,0,8
1952257,1502916,2025-03-01,Senate,"(S) 2nd Reading Passed",45,5,0,0,50
1952257,1503735,2025-03-03,Senate,"(S) 3rd Reading Passed",46,4,0,0,50
1952257,1508984,2025-02-26,Senate,"(S) Judiciary--To Take From The Table",7,1,0,0,8
1952257,1515758,2025-02-26,Senate,"(S) Judiciary--Do Pass As Amended",5,3,0,0,8
1952257,1520914,2025-03-19,House,"(H) Judiciary--Be Concurred In",17,3,0,0,20
1952257,1526488,2025-03-25,House,"(H) 2nd Reading Concurred",80,20,0,0,100
1952257,1527912,2025-03-26,House,"(H) 3rd Reading Concurred",80,19,0,1,100
1952404,1491216,2025-02-17,House,"(H) Business and Labor--Do Pass As Amended",12,8,0,0,20
1952404,1501589,2025-02-27,House,"(H) 2nd Reading Not Passed",44,56,0,0,100
1952551,1529992,2025-03-28,Senate,"(S) Taxation--Do Pass As Amended",6,2,0,0,8
1952551,1537387,2025-04-04,Senate,"(S) 2nd Reading Passed",26,24,0,0,50
1952551,1537663,2025-04-05,Senate,"(S) 3rd Reading Passed",25,23,0,2,50
1952551,1548745,2025-04-15,House,"(H) Local Government--Be Concurred In As Amended",16,1,0,0,17
1952551,1554320,2025-04-22,House,"(H) 2nd Reading Motion to Amend Carried",100,0,0,0,100
1952551,1554321,2025-04-22,House,"(H) 2nd Reading Concurred as Amended",96,4,0,0,100
1952551,1557159,2025-04-24,House,"(H) 3rd Reading Concurred",98,0,0,2,100
1952551,1559007,2025-04-28,Senate,"(S) 2nd Reading House Amendments Concurred",50,0,0,0,50
1952551,1560514,2025-04-29,Senate,"(S) 3rd Reading Passed as Amended by House",48,2,0,0,50
1952700,1487971,2025-02-12,House,"(H) Energy, Technology and Federal Relations--To Table",14,0,0,0,14
1952700,1547299,2025-02-12,House,"(H) Energy, Technology and Federal Relations--To Table",14,0,0,0,14
1953974,1491566,2025-02-17,Senate,"(S) Local Government--Do Pass",9,2,0,0,11
1953974,1495673,2025-02-20,Senate,"(S) 2nd Reading Passed",36,14,0,0,50
1953974,1496351,2025-02-21,Senate,"(S) 3rd Reading Passed",39,11,0,0,50
1953974,1529993,2025-03-27,House,"(H) Local Government--Be Concurred In",10,7,0,0,17
1953974,1529994,2025-03-27,House,"(H) Local Government--Be Concurred In",10,7,0,0,17
1953974,1543706,2025-04-10,House,"(H) 2nd Reading Concurred",59,41,0,0,100
1953974,1546445,2025-04-11,House,"(H) 3rd Reading Concurred",57,42,0,1,100
1953974,1557591,2025-03-27,House,"(H) Local Government--Be Concurred In",10,7,0,0,17
1953979,1499607,2025-02-25,Senate,"(S) Energy, Technology & Federal Relations--Do Pass As Amended",13,0,0,0,13
1953979,1503407,2025-03-03,Senate,"(S) 2nd Reading Passed",45,4,0,1,50
1953979,1505461,2025-03-04,Senate,"(S) 3rd Reading Passed",44,6,0,0,50
1953979,1524185,2025-03-21,House,"(H) Energy, Technology and Federal Relations--Be Concurred In",10,4,0,0,14
1953979,1544402,2025-04-10,House,"(H) 2nd Reading Concurred",71,29,0,0,100
1953979,1546128,2025-04-11,House,"(H) 3rd Reading Concurred",70,29,0,1,100
1954235,1491301,2025-02-17,Senate,"(S) Natural Resources--Do Pass As Amended",6,5,0,0,11
1954235,1501435,2025-02-27,Senate,"(S) 2nd Reading Passed",29,21,0,0,50
1954235,1502373,2025-02-28,Senate,"(S) 3rd Reading Passed",26,23,0,1,50
1954235,1550908,2025-04-16,House,"(H) Natural Resources--To Table",12,2,0,0,14
1954235,1552038,2025-04-16,House,"(H) Natural Resources--To Table",12,2,0,0,14
1954499,1488521,2025-02-12,Senate,"(S) Highways and Transportation--Do Pass",8,0,0,0,8
1954499,1490729,2025-02-15,Senate,"(S) 2nd Reading Passed",36,14,0,0,50
1954499,1492323,2025-02-18,Senate,"(S) 3rd Reading Passed",33,17,0,0,50
1954499,1531765,2025-03-31,House,"(H) Transportation--Be Concurred In",9,5,0,0,14
1954499,1544307,2025-04-10,House,"(H) 2nd Reading Concurred",73,27,0,0,100
1954499,1546473,2025-04-11,House,"(H) 3rd Reading Concurred",52,47,0,1,100
1954767,1490127,2025-02-14,House,"(H) State Administration--To Table",19,0,0,0,19
1955126,1494446,2025-02-19,House,"(H) Education--Do Pass As Amended",13,2,0,0,15
1955126,1497664,2025-02-24,House,"(H) 2nd Reading Passed",62,37,0,1,100
1955126,1530945,2025-03-31,House,"(H) Appropriations--To Table",13,10,0,0,23
1955217,1489043,2025-02-13,House,"(H) Business and Labor--Do Pass",19,0,0,1,20
1955217,1497016,2025-02-22,House,"(H) 2nd Reading Passed",90,10,0,0,100
1955217,1498273,2025-02-24,House,"(H) 3rd Reading Passed",89,10,0,1,100
1955217,1523458,2025-03-20,Senate,"(S) Business, Labor  and Economic Affairs--Be Concurred In",12,0,0,0,12
1955217,1534092,2025-02-13,House,"(H) Business and Labor--Do Pass",19,0,1,0,20
1955217,1546543,2025-04-12,Senate,"(S) 2nd Reading Concurred",50,0,0,0,50
1955217,1546917,2025-04-14,Senate,"(S) 3rd Reading Concurred",48,0,0,2,50
1955314,1491256,2025-02-17,House,"(H) Judiciary--Do Pass",12,8,0,0,20
1955314,1495383,2025-02-20,House,"(H) 2nd Reading Passed",58,42,0,0,100
1955314,1496775,2025-02-21,House,"(H) 3rd Reading Passed",57,41,0,2,100
1955314,1536113,2025-04-03,Senate,"(S) Judiciary--Be Concurred In",5,3,0,0,8
1955314,1543280,2025-04-10,Senate,"(S) 2nd Reading Motion to Amend Carried",28,22,0,0,50
1955314,1543281,2025-04-10,Senate,"(S) 2nd Reading Concurred as Amended",34,16,0,0,50
1955314,1545568,2025-04-11,Senate,"(S) Reconsidered Previous Action; Placed on 2nd Reading",31,17,0,2,50
1955314,1546163,2025-04-11,Senate,"(S) 2nd Reading Motion to Amend Carried",29,20,0,1,50
1955314,1546164,2025-04-11,Senate,"(S) 2nd Reading Concurred as Amended",32,18,0,0,50
1955314,1546604,2025-04-12,Senate,"(S) 3rd Reading Concurred",31,19,0,0,50
1955402,1488529,2025-02-12,House,"(H) Transportation--Do Pass As Amended",14,0,0,0,14
1955402,1494359,2025-02-19,House,"(H) 2nd Reading Passed",100,0,0,0,100
1955402,1496012,2025-02-20,House,"(H) 3rd Reading Passed",99,0,0,1,100
1955402,1528183,2025-03-26,Senate,"(S) Highways and Transportation--Be Concurred In",8,0,0,0,8
1955402,1546610,2025-04-12,Senate,"(S) 2nd Reading Concurred",49,0,0,1,50
1955402,1547214,2025-04-14,Senate,"(S) 3rd Reading Concurred",48,0,0,2,50
1955492,1492398,2025-02-18,House,"(H) Human Services--Do Pass As Amended",16,5,0,0,21
1955492,1497006,2025-02-22,House,"(H) 2nd Reading Passed",53,47,0,0,100
1955492,1535769,2025-04-03,House,"(H) Appropriations--To Table",12,11,0,0,23
1955574,1498108,2025-02-24,Senate,"(S) Local Government--Do Pass As Amended",9,2,0,0,11
1955574,1502930,2025-03-01,Senate,"(S) 2nd Reading Passed",33,17,0,0,50
1955574,1503391,2025-03-03,Senate,"(S) 3rd Reading Passed",33,17,0,0,50
1955574,1541431,2025-04-08,House,"(H) Local Government--To Table",12,5,0,0,17
1955574,1543861,2025-04-08,House,"(H) Local Government--To Table",12,5,0,0,17
1956101,1502748,2025-02-28,House,"(H) Energy, Technology and Federal Relations--To Table",14,0,0,0,14
1956262,1489034,2025-02-13,House,"(H) Business and Labor--Do Pass",19,0,0,1,20
1956262,1494074,2025-02-19,House,"(H) 2nd Reading Passed",100,0,0,0,100
1956262,1495792,2025-02-20,House,"(H) 3rd Reading Passed",98,1,0,1,100
1956262,1523311,2025-03-20,Senate,"(S) Business, Labor  and Economic Affairs--Be Concurred In",12,0,0,0,12
1956262,1546613,2025-02-13,House,"(H) Business and Labor--Do Pass",19,0,1,0,20
1956262,1546614,2025-04-12,Senate,"(S) 2nd Reading Concurred",45,2,0,3,50
1956262,1547250,2025-04-14,Senate,"(S) 3rd Reading Concurred",44,4,0,2,50
1956418,1491744,2025-02-18,House,"(H) Business and Labor--To Table",12,8,0,0,20
1956669,1492851,2025-02-18,House,"(H) Local Government--Do Pass As Amended",17,0,0,0,17
1956669,1497172,2025-02-22,House,"(H) 2nd Reading Passed",100,0,0,0,100
1956669,1498096,2025-02-24,House,"(H) 3rd Reading Passed",99,0,0,1,100
1956669,1531192,2025-03-31,Senate,"(S) Local Government--Be Concurred In As Amended",11,0,0,0,11
1956669,1537703,2025-04-05,Senate,"(S) 2nd Reading Concurred",49,0,0,1,50
1956669,1538603,2025-04-07,Senate,"(S) 3rd Reading Concurred",49,0,0,1,50
1956669,1547537,2025-04-14,House,"(H) 2nd Reading Senate Amendments Concurred",100,0,0,0,100
1956669,1548426,2025-04-15,House,"(H) 3rd Reading Passed as Amended by Senate",97,0,0,3,100
1956751,1521169,2025-03-19,Senate,"(S) Taxation--To Table",8,0,0,0,8
1956834,1502869,2025-02-28,Senate,"(S) Public Health, Welfare and Safety--Do Pass As Amended",7,4,0,0,11
1956834,1504789,2025-03-04,Senate,"(S) 2nd Reading Pass Motion Failed",23,27,0,0,50
1956834,1504790,2025-03-04,Senate,"(S) 2nd Reading Indefinitely Postponed",30,20,0,0,50
1956915,1493172,2025-02-19,House,"(H) State Administration--Do Pass",11,8,0,0,19
1956915,1497010,2025-02-22,House,"(H) 2nd Reading Passed",57,43,0,0,100
1956915,1497805,2025-02-24,House,"(H) 3rd Reading Passed",54,45,0,1,100
1956915,1537340,2025-04-04,Senate,"(S) State Administration--Be Concurred In",9,0,0,0,9
1956915,1546626,2025-04-12,Senate,"(S) 2nd Reading Concur Motion Failed",20,30,0,0,50
1956915,1546627,2025-04-12,Senate,"(S) 2nd Reading Indefinitely Postponed",35,15,0,0,50
1956915,1547095,2025-04-14,Senate,"(S) Reconsidered Previous Action; Placed on 2nd Reading",28,21,0,1,50
1956915,1548101,2025-04-14,Senate,"(S) Reconsidered Previous Action; Placed on 2nd Reading",28,21,0,1,50
1956915,1548682,2025-04-15,Senate,"(S) 2nd Reading Pass Motion Failed",17,33,0,0,50
1956915,1548683,2025-04-15,Senate,"(S) 2nd Reading Indefinitely Postponed",40,10,0,0,50
1956995,1494372,2025-02-19,House,"(H) Human Services--Do Pass As Amended",21,0,0,0,21
1956995,1497007,2025-02-22,House,"(H) 2nd Reading Passed",100,0,0,0,100
1956995,1497997,2025-02-24,House,"(H) 3rd Reading Passed",99,0,0,1,100
1956995,1530259,2025-03-28,Senate,"(S) Public Health, Welfare and Safety--Be Concurred In As Amended",8,3,0,0,11
1956995,1534701,2025-04-02,Senate,"(S) 2nd Reading Concurred",50,0,0,0,50
1956995,1535932,2025-04-03,Senate,"(S) 3rd Reading Concurred",49,1,0,0,50
1956995,1547607,2025-04-14,House,"(H) 2nd Reading Senate Amendments Concurred",100,0,0,0,100
1956995,1548509,2025-04-15,House,"(H) 3rd Reading Passed as Amended by Senate",97,0,0,3,100
1957078,1500370,2025-02-26,House,"(H) Judiciary--Do Pass",12,8,0,0,20
1957078,1503280,2025-03-03,House,"(H) 2nd Reading Passed",59,39,0,2,100
1957078,1504413,2025-03-04,House,"(H) 3rd Reading Passed",60,39,0,1,100
1957078,1552061,2025-04-18,Senate,"(S) Judiciary--Be Concurred In",5,3,0,0,8
1957078,1555127,2025-04-23,Senate,"(S) 2nd Reading Concurred",32,18,0,0,50
1957078,1557490,2025-04-24,Senate,"(S) 3rd Reading Concurred",32,18,0,0,50
1957160,1489381,2025-02-13,Senate,"(S) Fish and Game--Do Pass As Amended",8,3,0,1,12
1957160,1493879,2025-02-19,Senate,"(S) 2nd Reading Motion to Amend Carried",46,4,0,0,50
1957160,1493880,2025-02-19,Senate,"(S) 2nd Reading Passed as Amended",50,0,0,0,50
1957160,1502454,2025-02-28,Senate,"(S) 3rd Reading Passed",47,2,0,1,50
1957160,1540233,2025-04-08,House,"(H) Fish, Wildlife and Parks--To Table",20,0,0,0,20
1957160,1544167,2025-04-08,House,"(H) Fish, Wildlife and Parks--To Table",20,0,0,0,20
1957241,1491219,2025-02-17,Senate,"(S) Public Health, Welfare and Safety--Do Pass",11,0,0,0,11
1957241,1496084,2025-02-20,Senate,"(S) 2nd Reading Passed",47,3,0,0,50
1957241,1499858,2025-02-26,Senate,"(S) Finance and Claims--To Table",15,7,0,0,22
1957324,1492623,2025-02-18,House,"(H) Local Government--Do Pass As Amended",15,2,0,0,17
1957324,1497015,2025-02-22,House,"(H) 2nd Reading Passed",66,34,0,0,100
1957324,1497876,2025-02-24,House,"(H) 3rd Reading Passed",69,30,0,1,100
1957324,1531654,2025-03-31,Senate,"(S) Local Government--Be Concurred In",11,0,0,0,11
1957324,1546532,2025-04-12,Senate,"(S) 2nd Reading Concurred",36,14,0,0,50
1957324,1547354,2025-04-14,Senate,"(S) 3rd Reading Concurred",37,11,0,2,50
1957405,1489810,2025-02-13,Senate,"(S) Education and Cultural Resources--Do Pass",10,4,0,0,14
1957405,1492722,2025-02-18,Senate,"(S) 2nd Reading Passed",40,10,0,0,50
1957405,1494176,2025-02-19,Senate,"(S) 3rd Reading Passed",39,10,0,1,50
1957405,1539089,2025-04-07,House,"(H) Education--Be Concurred In",15,0,0,0,15
1957405,1544336,2025-04-10,House,"(H) 2nd Reading Concurred",97,2,0,1,100
1957405,1546482,2025-04-11,House,"(H) 3rd Reading Concurred",94,5,0,1,100
1957405,1561747,2025-02-13,Senate,"(S) Education and Cultural Resources--Do Pass",10,4,0,0,14
1957481,1488383,2025-02-12,House,"(H) Energy, Technology and Federal Relations--Do Pass As Amended",14,0,0,0,14
1957481,1489761,2025-02-12,House,"(H) Energy, Technology and Federal Relations--Do Pass As Amended",14,0,0,0,14
1957481,1494998,2025-02-20,House,"(H) 2nd Reading Passed",100,0,0,0,100
1957481,1496855,2025-02-21,House,"(H) 3rd Reading Passed",98,0,0,2,100
1957481,1528370,2025-03-25,Senate,"(S) Energy, Technology & Federal Relations--Be Concurred In As Amended",12,1,0,0,13
1957481,1533759,2025-04-01,Senate,"(S) 2nd Reading Concurred",46,4,0,0,50
1957481,1535178,2025-04-02,Senate,"(S) 3rd Reading Concurred",46,4,0,0,50
1957481,1552283,2025-04-18,House,"(H) 2nd Reading Senate Amendments Concurred",99,0,0,1,100
1957481,1553323,2025-04-22,House,"(H) 3rd Reading Passed as Amended by Senate",98,0,0,2,100
1957481,1573182,2025-02-12,House,"(H) Energy, Technology and Federal Relations--Do Pass As Amended",14,0,0,0,14
1957488,1501890,2025-02-27,House,"(H) Business and Labor--Do Pass As Amended",20,0,0,0,20
1957488,1503776,2025-03-03,House,"(H) 2nd Reading Passed",92,6,0,2,100
1957488,1505327,2025-03-04,House,"(H) 3rd Reading Passed",86,13,0,1,100
1957488,1524592,2025-03-24,Senate,"(S) Business, Labor  and Economic Affairs--Be Concurred In",12,0,0,0,12
1957488,1534542,2025-04-02,Senate,"(S) 2nd Reading Concurred",43,7,0,0,50
1957488,1535825,2025-04-03,Senate,"(S) 3rd Reading Concurred",38,12,0,0,50
1957489,1501296,2025-02-27,House,"(H) Business and Labor--Do Pass As Amended",20,0,0,0,20
1957489,1521414,2025-03-19,House,"(H) 2nd Reading Passed",91,9,0,0,100
1957489,1523091,2025-03-20,House,"(H) 3rd Reading Passed",90,8,0,2,100
1957489,1529944,2025-03-28,Senate,"(S) Business, Labor  and Economic Affairs--Be Concurred In",12,0,0,0,12
1957489,1541774,2025-04-09,Senate,"(S) 2nd Reading Concurred",45,3,0,2,50
1957489,1543421,2025-04-10,Senate,"(S) 3rd Reading Concurred",47,1,0,2,50
1957489,1544349,2025-04-10,Senate,"(S) 3rd Reading Concurred",47,1,0,2,50
1957490,1490816,2025-02-17,House,"(H) Judiciary--Do Pass As Amended",12,8,0,0,20
1957490,1495520,2025-02-20,House,"(H) 2nd Reading Passed",58,42,0,0,100
1957490,1496472,2025-02-21,House,"(H) 3rd Reading Passed",56,42,0,2,100
1957490,1535918,2025-04-03,Senate,"(S) Judiciary--Be Concurred In",5,3,0,0,8
1957490,1543768,2025-04-10,Senate,"(S) 2nd Reading Concurred",28,22,0,0,50
1957490,1546074,2025-04-11,Senate,"(S) 3rd Reading Concurred",28,20,0,2,50
1957491,1493949,2025-02-19,House,"(H) State Administration--To Table",19,0,0,0,19
1957492,1499240,2025-02-25,House,"(H) Agriculture--Do Pass As Amended",10,7,0,0,17
1957492,1505197,2025-03-04,House,"(H) 2nd Reading Passed",64,35,0,1,100
1957492,1507314,2025-03-06,House,"(H) 3rd Reading Passed",64,35,0,1,100
1957492,1533312,2025-04-01,Senate,"(S) Agriculture, Livestock and Irrigation--Be Concurred In",10,1,0,0,11
1957492,1546538,2025-04-12,Senate,"(S) 2nd Reading Concurred",39,11,0,0,50
1957492,1547388,2025-04-14,Senate,"(S) 3rd Reading Concurred",34,14,0,2,50
1957497,1492212,2025-02-18,House,"(H) Human Services--Do Pass",21,0,0,0,21
1957497,1496541,2025-02-21,House,"(H) 2nd Reading Passed",94,6,0,0,100
1957497,1497017,2025-02-22,House,"(H) 3rd Reading Passed",89,9,0,2,100
1957497,1530269,2025-03-28,Senate,"(S) Public Health, Welfare and Safety--Be Concurred In",11,0,0,0,11
1957497,1541588,2025-04-09,Senate,"(S) 2nd Reading Concurred",43,7,0,0,50
1957497,1544937,2025-04-10,Senate,"(S) 3rd Reading Concurred",42,6,0,2,50
1957656,1502593,2025-02-28,House,"(H) Energy, Technology and Federal Relations--To Table",8,6,0,0,14
1957656,1503238,2025-03-03,House,"(H) Taken from Committee; Placed on 2nd Reading",44,54,0,2,100
1957656,1504218,2025-03-04,House,"(H) Energy, Technology and Federal Relations--Do Pass",8,6,0,0,14
1957656,1506206,2025-03-05,House,"(H) 2nd Reading Not Passed",41,58,0,1,100
1957656,1542353,2025-03-03,House,"(H) Taken from Committee; Placed on 2nd Reading",44,54,0,2,100
1957819,1489235,2025-02-13,Senate,"(S) Taxation--To Table",8,0,0,0,8
1957985,1494837,2025-02-20,Senate,"(S) Judiciary--Do Pass As Amended",5,3,0,0,8
1957985,1497958,2025-02-24,Senate,"(S) 2nd Reading Passed",29,21,0,0,50
1957985,1499626,2025-02-25,Senate,"(S) 3rd Reading Passed",30,19,0,1,50
1957985,1527045,2025-03-25,House,"(H) Human Services--To Table",21,0,0,0,21
1957985,1530481,2025-03-25,House,"(H) Human Services--To Table",21,0,0,0,21
1957985,1595768,2025-03-25,House,"(H) Human Services--To Table",21,0,0,0,21
1958147,1493001,2025-02-19,Senate,"(S) Judiciary--To Table",8,0,0,1,9
1958781,1487950,2025-02-12,House,"(H) Education--Do Pass",15,0,0,0,15
1958781,1495816,2025-02-20,House,"(H) 2nd Reading Passed",84,16,0,0,100
1958781,1531673,2025-03-31,House,"(H) Appropriations--To Table",13,10,0,0,23
1958781,1569691,2025-02-12,House,"(H) Education--Do Pass",15,0,0,0,15
1958933,1493566,2025-02-19,House,"(H) State Administration--Do Pass As Amended",18,1,0,0,19
1958933,1493567,2025-02-19,House,"(H) State Administration--Do Pass As Amended",18,1,0,0,19
1958933,1497174,2025-02-22,House,"(H) 2nd Reading Passed",84,16,0,0,100
1958933,1504422,2025-02-24,House,"(H) 3rd Reading Passed",72,27,0,1,100
1958933,1539725,2025-04-07,Senate,"(S) State Administration--Be Concurred In As Amended",9,0,0,0,9
1958933,1544711,2025-04-10,Senate,"(S) 2nd Reading Concurred",41,8,0,1,50
1958933,1546223,2025-04-11,Senate,"(S) 3rd Reading Concurred",43,5,0,2,50
1958933,1550383,2025-04-16,House,"(H) 2nd Reading Senate Amendments Concurred",100,0,0,0,100
1958933,1551817,2025-04-17,House,"(H) 3rd Reading Passed as Amended by Senate",97,2,0,1,100
1959079,1539597,2025-04-08,Senate,"(S) 2nd Reading Motion to Amend Carried",38,12,0,0,50
1959079,1541184,2025-04-08,Senate,"(S) Resolution Adopted",37,13,0,0,50
1959222,1490091,2025-02-13,Senate,"(S) Judiciary--Do Pass",6,0,0,3,9
1959222,1490684,2025-02-15,Senate,"(S) 2nd Reading Passed",34,16,0,0,50
1959222,1492352,2025-02-18,Senate,"(S) 3rd Reading Passed",34,16,0,0,50
1959222,1521288,2025-03-19,House,"(H) Judiciary--Be Concurred In",20,0,0,0,20
1959222,1530677,2025-03-29,House,"(H) 2nd Reading Concurred",98,2,0,0,100
1959222,1531255,2025-03-31,House,"(H) 3rd Reading Concurred",98,1,0,1,100
1959233,1493056,2025-02-19,House,"(H) Taxation--To Table",21,0,0,0,21
1959318,1491211,2025-02-17,House,"(H) Judiciary--Do Pass",15,5,0,0,20
1959318,1495862,2025-02-20,House,"(H) 2nd Reading Passed",61,39,0,0,100
1959318,1496478,2025-02-21,House,"(H) 3rd Reading Passed",63,35,0,2,100
1959318,1525961,2025-03-25,Senate,"(S) Judiciary--Be Concurred In",7,1,0,0,8
1959318,1546534,2025-04-12,Senate,"(S) 2nd Reading Concurred",45,5,0,0,50
1959318,1547363,2025-04-14,Senate,"(S) 3rd Reading Concurred",34,14,0,2,50
1959406,1491556,2025-02-17,House,"(H) Judiciary--Do Pass As Amended",12,8,0,0,20
1959406,1494313,2025-02-19,House,"(H) 2nd Reading Passed",58,42,0,0,100
1959406,1495641,2025-02-20,House,"(H) 3rd Reading Passed",57,42,0,1,100
1959406,1502814,2025-02-28,Senate,"(S) Judiciary--Be Concurred In As Amended",5,3,0,0,8
1959406,1518405,2025-03-17,Senate,"(S) 2nd Reading Concurred",32,18,0,0,50
1959406,1520593,2025-03-03,Senate,"(S) Judiciary--Be Concurred In As Amended",5,3,0,0,8
1959406,1520594,2025-03-18,Senate,"(S) 3rd Reading Concurred",31,18,0,1,50
1959406,1522706,2025-03-20,House,"(H) 2nd Reading Senate Amendments Concurred",58,42,0,0,100
1959406,1524065,2025-03-21,House,"(H) 3rd Reading Passed as Amended by Senate",58,39,0,3,100
1959496,1498267,2025-02-24,House,"(H) Judiciary--Do Pass As Amended",19,1,0,0,20
1959496,1500130,2025-02-26,House,"(H) 2nd Reading Passed",87,13,0,0,100
1959496,1501997,2025-02-27,House,"(H) 3rd Reading Passed",90,8,0,2,100
1959496,1539607,2025-04-08,Senate,"(S) Judiciary--To Table",8,0,0,0,8
1959496,1542023,2025-04-08,Senate,"(S) Judiciary--To Table",8,0,0,0,8
1959496,1555704,2025-04-23,Senate,"(S) Motion Failed",24,25,0,1,50
1959496,1557240,2025-04-24,Senate,"(S) Taken from Committee; Placed on 2nd Reading",27,23,0,0,50
1959496,1558229,2025-04-25,Senate,"(S) 2nd Reading Indefinitely Postponed",32,18,0,0,50
1959496,1558230,2025-04-25,Senate,"(S) 2nd Reading Pass Motion Failed",23,27,0,0,50
1959583,1497691,2025-02-24,House,"(H) State Administration--To Table",18,1,0,0,19
1959583,1506694,2025-03-05,House,"(H) Taken from Committee; Placed on 2nd Reading",27,71,0,2,100
1959583,1543494,2025-03-05,House,"(H) Taken from Committee; Placed on 2nd Reading",27,71,0,2,100
1959678,1534134,2025-04-02,House,"(H) Business and Labor--Do Pass As Amended",19,1,0,0,20
1959678,1536070,2025-04-03,House,"(H) Appropriations--To Table",12,11,0,0,23
1959764,1495469,2025-02-20,House,"(H) Business and Labor--Do Pass",20,0,0,0,20
1959764,1497009,2025-02-22,House,"(H) 2nd Reading Passed",99,0,0,1,100
1959764,1497854,2025-02-24,House,"(H) 3rd Reading Passed",99,0,0,1,100
1959764,1526311,2025-03-25,Senate,"(S) Business, Labor  and Economic Affairs--Be Concurred In",12,0,0,0,12
1959764,1544105,2025-04-10,Senate,"(S) 2nd Reading Concurred",48,1,0,1,50
1959764,1546007,2025-04-11,Senate,"(S) 3rd Reading Concurred",46,2,0,2,50
1959853,1493659,2025-02-19,House,"(H) Taxation--Do Pass As Amended",12,9,0,0,21
1959853,1526779,2025-03-25,House,"(H) 2nd Reading Passed",55,45,0,0,100
1959853,1528094,2025-03-26,House,"(H) 3rd Reading Passed",56,43,0,1,100
1959853,1537285,2025-04-04,Senate,"(S) Taxation--Be Concurred In",8,0,0,0,8
1959853,1552302,2025-04-18,Senate,"(S) 2nd Reading Concurred",35,14,0,1,50
1959853,1554841,2025-04-22,Senate,"(S) 3rd Reading Concurred",38,12,0,0,50
1959942,1496887,2025-02-21,House,"(H) Judiciary--Do Pass As Amended",20,0,0,0,20
1959942,1499239,2025-02-25,House,"(H) 2nd Reading Passed",60,40,0,0,100
1959942,1500714,2025-02-26,House,"(H) 3rd Reading Passed",56,44,0,0,100
1959942,1524000,2025-03-21,Senate,"(S) Judiciary--Be Concurred In",5,3,0,0,8
1959942,1548922,2025-04-15,Senate,"(S) 2nd Reading Concurred",43,6,0,1,50
1959942,1550325,2025-04-16,Senate,"(S) 3rd Reading Concurred",48,2,0,0,50
1960033,1497960,2025-02-24,House,"(H) State Administration--Do Pass",11,8,0,0,19
1960033,1500744,2025-02-26,House,"(H) 2nd Reading Motion to Amend Failed",45,54,0,1,100
1960033,1500745,2025-02-26,House,"(H) 2nd Reading Passed",55,45,0,0,100
1960033,1501539,2025-02-27,House,"(H) 3rd Reading Passed",56,42,0,2,100
1960033,1521587,2025-03-19,Senate,"(S) State Administration--Be Concurred In",5,4,0,0,9
1960033,1543534,2025-04-10,Senate,"(S) 2nd Reading Concurred",31,19,0,0,50
1960033,1545872,2025-04-11,Senate,"(S) 3rd Reading Concurred",30,18,0,2,50
1960124,1502950,2025-02-28,Senate,"(S) State Administration--Do Pass",9,0,0,0,9
1960124,1505549,2025-02-28,Senate,"(S) State Administration--Do Pass As Amended",9,0,0,0,9
1960124,1506928,2025-03-05,Senate,"(S) 2nd Reading Passed",43,6,0,1,50
1960124,1507865,2025-03-06,Senate,"(S) 3rd Reading Passed",46,4,0,0,50
1960124,1530029,2025-03-28,House,"(H) State Administration--Be Concurred In",16,3,0,0,19
1960124,1543584,2025-04-10,House,"(H) 2nd Reading Concurred",58,42,0,0,100
1960124,1546387,2025-04-11,House,"(H) 3rd Reading Concurred",57,42,0,1,100
1960212,1497689,2025-02-24,Senate,"(S) Business, Labor  and Economic Affairs--To Table",11,1,0,0,12
1960371,1498457,2025-02-24,Senate,"(S) State Administration--To Table",6,3,0,0,9
1960371,1498458,2025-02-24,Senate,"(S) State Administration--Do Pass",4,5,0,0,9
1960440,1499330,2025-02-25,Senate,"(S) Education and Cultural Resources--Do Pass As Amended",13,1,0,0,14
1960440,1502730,2025-02-28,Senate,"(S) 2nd Reading Passed",38,11,0,1,50
1960440,1503697,2025-03-03,Senate,"(S) Finance and Claims--Do Pass",18,4,0,0,22
1960440,1505542,2025-03-04,Senate,"(S) 3rd Reading Passed",38,12,0,0,50
1960440,1539176,2025-04-07,House,"(H) Education--Be Concurred In As Amended",13,2,0,0,15
1960440,1543183,2025-04-09,House,"(H) Appropriations--Be Concurred In",14,9,0,0,23
1960440,1545825,2025-04-11,House,"(H) 2nd Reading Concurred",70,30,0,0,100
1960440,1546451,2025-04-11,House,"(H) 3rd Reading Concurred",75,24,0,1,100
1960440,1550546,2025-04-16,Senate,"(S) 2nd Reading House Amendments Concurred",46,4,0,0,50
1960440,1551891,2025-04-17,Senate,"(S) 3rd Reading Passed as Amended by House",36,14,0,0,50
1960504,1490236,2025-02-14,House,"(H) Natural Resources--Do Pass",13,1,0,0,14
1960504,1494272,2025-02-19,House,"(H) 2nd Reading Passed",97,3,0,0,100
1960504,1496965,2025-02-21,House,"(H) Appropriations--Do Pass",21,2,0,0,23
1960504,1497640,2025-02-24,House,"(H) 3rd Reading Passed",92,7,0,1,100
1960504,1537488,2025-04-04,Senate,"(S) Natural Resources--Be Concurred In",9,2,0,0,11
1960504,1552080,2025-04-18,Senate,"(S) 2nd Reading Concurred",37,11,0,2,50
1960504,1555848,2025-04-23,Senate,"(S) Motion Carried",25,24,0,1,50
1960504,1557114,2025-04-24,Senate,"(S) 3rd Reading Concurred",37,13,0,0,50
1960574,1502499,2025-02-28,Senate,"(S) Judiciary--Do Pass As Amended",5,3,0,0,8
1960574,1503233,2025-03-03,Senate,"(S) 2nd Reading Passed",43,7,0,0,50
1960574,1505092,2025-03-04,Senate,"(S) 3rd Reading Passed",42,8,0,0,50
1960574,1536316,2025-04-03,House,"(H) Judiciary--Be Concurred In As Amended",20,0,0,0,20
1960574,1539536,2025-04-08,House,"(H) 2nd Reading Concurred",98,0,0,2,100
1960574,1541915,2025-04-09,House,"(H) 3rd Reading Concurred",97,0,0,3,100
1960574,1545867,2025-04-11,Senate,"(S) 2nd Reading House Amendments Concurred",50,0,0,0,50
1960574,1546670,2025-04-12,Senate,"(S) 3rd Reading Passed as Amended by House",50,0,0,0,50
1960643,1499472,2025-02-25,House,"(H) Human Services--Do Pass",14,7,0,0,21
1960643,1520579,2025-03-18,House,"(H) 2nd Reading Passed",96,3,0,1,100
1960643,1520899,2025-03-19,House,"(H) Appropriations--Do Pass",21,0,0,2,23
1960643,1522951,2025-03-20,House,"(H) 3rd Reading Passed",93,5,0,2,100
1960643,1547944,2025-04-14,Senate,"(S) Public Health, Welfare and Safety--Be Concurred In",8,3,0,0,11
1960643,1550069,2025-04-16,Senate,"(S) 2nd Reading Concurred",50,0,0,0,50
1960643,1552232,2025-04-18,Senate,"(S) Finance and Claims--Be Concurred In",22,0,0,0,22
1960643,1554132,2025-04-22,Senate,"(S) 3rd Reading Concurred",49,1,0,0,50
1960705,1494047,2025-02-19,Senate,"(S) Judiciary--Do Pass",8,0,0,1,9
1960705,1496542,2025-02-21,Senate,"(S) 2nd Reading Passed",50,0,0,0,50
1960705,1498370,2025-02-24,Senate,"(S) 3rd Reading Passed",49,0,0,1,50
1960705,1528805,2025-03-27,House,"(H) Judiciary--Be Concurred In",20,0,0,0,20
1960705,1530670,2025-03-29,House,"(H) 2nd Reading Concurred",99,1,0,0,100
1960705,1531437,2025-03-31,House,"(H) 3rd Reading Concurred",99,0,0,1,100
1960775,1499410,2025-02-25,House,"(H) Agriculture--To Table",17,0,0,0,17
1960839,1497440,2025-02-24,Senate,"(S) Business, Labor  and Economic Affairs--Do Pass",12,0,0,0,12
1960839,1500374,2025-02-26,Senate,"(S) 2nd Reading Passed",46,4,0,0,50
1960839,1501641,2025-02-27,Senate,"(S) 3rd Reading Passed",45,5,0,0,50
1960839,1521102,2025-03-19,House,"(H) Business and Labor--Be Concurred In",20,0,0,0,20
1960839,1528969,2025-03-27,House,"(H) 2nd Reading Concurred",98,1,0,1,100
1960839,1530083,2025-03-28,House,"(H) 3rd Reading Concurred",95,4,0,1,100
1960968,1501099,2025-02-27,House,"(H) Taxation--To Table",21,0,0,0,21
1961464,1491581,2025-02-17,House,"(H) Judiciary--To Table",19,1,0,0,20
1961536,1501781,2025-02-27,Senate,"(S) Energy, Technology & Federal Relations--To Table",10,3,0,0,13
1961610,1500791,2025-02-26,Senate,"(S) Judiciary--To Table",8,0,0,0,8
1961682,1497868,2025-02-24,House,"(H) State Administration--Do Pass As Amended",18,1,0,0,19
1961682,1501626,2025-02-27,House,"(H) 2nd Reading Passed",82,18,0,0,100
1961682,1502425,2025-02-28,House,"(H) 3rd Reading Passed",79,19,0,2,100
1961682,1531426,2025-03-31,Senate,"(S) State Administration--Be Concurred In",5,4,0,0,9
1961682,1546599,2025-04-12,Senate,"(S) 2nd Reading Concurred",30,19,0,1,50
1961682,1547202,2025-04-14,Senate,"(S) 3rd Reading Concurred",31,17,0,2,50
1961755,1493688,2025-02-19,House,"(H) Taxation--Do Pass As Amended",19,2,0,0,21
1961755,1524855,2025-03-24,House,"(H) 2nd Reading Motion to Amend Carried",99,0,0,1,100
1961755,1524856,2025-03-24,House,"(H) 2nd Reading Motion to Amend Carried",98,0,0,2,100
1961755,1524857,2025-03-24,House,"(H) 2nd Reading Passed as Amended",88,11,0,1,100
1961755,1527747,2025-03-26,House,"(H) 3rd Reading Passed",84,15,0,1,100
1961755,1539898,2025-04-08,Senate,"(S) Taxation--Be Concurred In",7,1,0,0,8
1961755,1552098,2025-04-18,Senate,"(S) 2nd Reading Concurred",45,5,0,0,50
1961755,1554106,2025-04-22,Senate,"(S) 3rd Reading Concurred",44,6,0,0,50
1961968,1490096,2025-02-14,House,"(H) Business and Labor--Do Pass",19,0,0,1,20
1961968,1495490,2025-02-20,House,"(H) 2nd Reading Passed",98,2,0,0,100
1961968,1496466,2025-02-21,House,"(H) 3rd Reading Passed",96,2,0,2,100
1961968,1521625,2025-03-19,Senate,"(S) Business, Labor  and Economic Affairs--Be Concurred In",11,0,0,1,12
1961968,1524153,2025-03-21,Senate,"(S) 2nd Reading Concurred",48,2,0,0,50
1961968,1524958,2025-03-24,Senate,"(S) 3rd Reading Concurred",47,3,0,0,50
1961968,1534406,2025-02-14,House,"(H) Business and Labor--Do Pass",19,0,1,0,20
1962106,1493604,2025-02-19,House,"(H) Business and Labor--Do Pass As Amended",12,8,0,0,20
1962106,1497120,2025-02-22,House,"(H) 2nd Reading Motion to Amend Failed",46,54,0,0,100
1962106,1497121,2025-02-22,House,"(H) 2nd Reading Not Passed",41,59,0,0,100
1962244,1499297,2025-02-25,House,"(H) Business and Labor--Do Pass As Amended",12,8,0,0,20
1962244,1502594,2025-02-28,House,"(H) 2nd Reading Passed",58,41,0,1,100
1962244,1503077,2025-03-01,House,"(H) 3rd Reading Passed",57,40,0,3,100
1962244,1534019,2025-04-02,Senate,"(S) Business, Labor  and Economic Affairs--Be Concurred In As Amended",8,3,0,0,11
1962244,1537852,2025-04-05,Senate,"(S) 2nd Reading Concurred",34,16,0,0,50
1962244,1538689,2025-04-07,Senate,"(S) 3rd Reading Concurred",39,10,0,1,50
1962244,1549136,2025-04-15,House,"(H) 2nd Reading Senate Amendments Concurred",97,3,0,0,100
1962244,1550413,2025-04-16,House,"(H) 3rd Reading Passed as Amended by Senate",61,37,0,2,100
1962515,1502766,2025-02-28,Senate,"(S) Public Health, Welfare and Safety--Do Pass As Amended",7,4,0,0,11
1962515,1506275,2025-03-05,Senate,"(S) 2nd Reading Pass Motion Failed",23,27,0,0,50
1962515,1506276,2025-03-05,Senate,"(S) 2nd Reading Indefinitely Postponed",28,22,0,0,50
1962660,1494256,2025-02-19,House,"(H) Business and Labor--Do Pass",20,0,0,0,20
1962660,1498235,2025-02-24,House,"(H) 2nd Reading Passed",100,0,0,0,100
1962660,1499449,2025-02-25,House,"(H) 3rd Reading Passed",100,0,0,0,100
1962660,1523352,2025-03-20,Senate,"(S) Business, Labor  and Economic Affairs--Be Concurred In",12,0,0,0,12
1962660,1544475,2025-04-10,Senate,"(S) 2nd Reading Concurred",49,0,0,1,50
1962660,1546185,2025-04-11,Senate,"(S) 3rd Reading Concurred",47,1,0,2,50
1962796,1493548,2025-02-19,Senate,"(S) Judiciary--Do Pass",5,3,0,1,9
1962796,1496260,2025-02-21,Senate,"(S) 2nd Reading Passed",26,24,0,0,50
1962796,1497753,2025-02-24,Senate,"(S) 3rd Reading Passed",25,24,0,1,50
1962796,1536600,2025-04-03,House,"(H) Judiciary--Be Concurred In",12,8,0,0,20
1962796,1543658,2025-04-10,House,"(H) 2nd Reading Concurred",58,42,0,0,100
1962796,1546433,2025-04-11,House,"(H) 3rd Reading Concurred",56,43,0,1,100
1962845,1490265,2025-02-14,House,"(H) Business and Labor--Do Pass",19,0,0,1,20
1962845,1493511,2025-02-19,House,"(H) 2nd Reading Passed",100,0,0,0,100
1962845,1496099,2025-02-20,House,"(H) 3rd Reading Passed",99,0,0,1,100
1962845,1521256,2025-03-19,Senate,"(S) Business, Labor  and Economic Affairs--Be Concurred In",11,0,0,1,12
1962845,1534577,2025-02-14,House,"(H) Business and Labor--Do Pass",19,0,1,0,20
1962845,1543715,2025-04-10,Senate,"(S) 2nd Reading Concurred",48,2,0,0,50
1962845,1546014,2025-04-11,Senate,"(S) 3rd Reading Concurred",45,3,0,2,50
1962884,1500992,2025-02-26,House,"(H) Natural Resources--Do Pass As Amended",11,3,0,0,14
1962884,1503897,2025-03-03,House,"(H) 2nd Reading Motion to Amend Failed",34,65,0,1,100
1962884,1503898,2025-03-03,House,"(H) 2nd Reading Passed",95,4,0,1,100
1962884,1504629,2025-03-04,House,"(H) 3rd Reading Passed",93,6,0,1,100
1962884,1538617,2025-04-07,Senate,"(S) Natural Resources--To Table",6,5,0,0,11
1962884,1542205,2025-04-07,Senate,"(S) Natural Resources--To Table",6,5,0,0,11
1962884,1555675,2025-04-23,Senate,"(S) Natural Resources--Be Concurred In",8,3,0,0,11
1962884,1558027,2025-04-25,Senate,"(S) 2nd Reading Concurred",45,3,0,2,50
1962884,1558945,2025-04-28,Senate,"(S) 3rd Reading Concurred",45,4,0,1,50
1962922,1495474,2025-02-20,House,"(H) Fish, Wildlife and Parks--To Table",20,0,0,0,20
1962961,1496615,2025-02-21,House,"(H) Judiciary--Do Pass",12,8,0,0,20
1962961,1504203,2025-02-21,House,"(H) Judiciary--Do Pass",12,8,0,0,20
1962961,1504204,2025-03-03,House,"(H) 2nd Reading Not Passed",13,86,0,1,100
1962961,1504205,2025-03-03,House,"(H) 2nd Reading Motion to Amend Failed",2,97,0,1,100
1962961,1576103,2025-02-21,House,"(H) Judiciary--Do Pass",12,8,0,0,20
1963001,1493617,2025-02-19,House,"(H) Business and Labor--Do Pass",20,0,0,0,20
1963001,1496573,2025-02-21,House,"(H) 2nd Reading Passed",100,0,0,0,100
1963001,1497115,2025-02-22,House,"(H) 3rd Reading Passed",98,0,0,2,100
1963001,1520721,2025-03-19,Senate,"(S) Business, Labor  and Economic Affairs--Be Concurred In",11,0,0,1,12
1963001,1524181,2025-03-21,Senate,"(S) 2nd Reading Concurred",49,1,0,0,50
1963001,1525066,2025-03-24,Senate,"(S) 3rd Reading Concurred",47,3,0,0,50
1963040,1498750,2025-02-25,House,"(H) 2nd Reading Passed",70,29,0,1,100
1963040,1500466,2025-02-26,House,"(H) 3rd Reading Failed",46,54,0,0,100
1963082,1491908,2025-02-18,House,"(H) Business and Labor--Do Pass As Amended",20,0,0,0,20
1963082,1496872,2025-02-21,House,"(H) 2nd Reading Passed",95,5,0,0,100
1963082,1497179,2025-02-22,House,"(H) 3rd Reading Passed",95,3,0,2,100
1963082,1530042,2025-03-28,Senate,"(S) Business, Labor  and Economic Affairs--Be Concurred In",12,0,0,0,12
1963082,1543553,2025-04-10,Senate,"(S) 2nd Reading Concurred",50,0,0,0,50
1963082,1545899,2025-04-11,Senate,"(S) 3rd Reading Concurred",48,0,0,2,50
1963121,1492820,2025-02-18,House,"(H) Local Government--Do Pass",10,7,0,0,17
1963121,1496902,2025-02-21,House,"(H) 2nd Reading Passed",80,20,0,0,100
1963121,1497173,2025-02-22,House,"(H) 3rd Reading Passed",75,23,0,2,100
1963121,1524238,2025-03-21,Senate,"(S) Local Government--Be Concurred In",8,0,0,3,11
1963121,1546561,2025-04-12,Senate,"(S) 2nd Reading Concurred",47,3,0,0,50
1963121,1547111,2025-04-14,Senate,"(S) 3rd Reading Concurred",46,2,0,2,50
1963160,1491429,2025-02-17,House,"(H) Judiciary--Do Pass As Amended",12,8,0,0,20
1963160,1496299,2025-02-21,House,"(H) 2nd Reading Not Passed",44,56,0,0,100
1963200,1496318,2025-02-21,House,"(H) Judiciary--Do Pass",20,0,0,0,20
1963200,1497955,2025-02-24,House,"(H) 2nd Reading Passed",100,0,0,0,100
1963200,1499290,2025-02-25,House,"(H) 3rd Reading Passed",100,0,0,0,100
1963200,1518939,2025-03-17,Senate,"(S) 2nd Reading Concurred",44,6,0,0,50
1963200,1519655,2025-03-18,Senate,"(S) 3rd Reading Concurred",43,6,0,1,50
1963200,1550695,2025-03-04,Senate,"(S) Judiciary--Be Concurred In",5,3,0,0,8
1963238,1502848,2025-02-28,Senate,"(S) State Administration--Do Pass",5,4,0,0,9
1963238,1533539,2025-04-01,Senate,"(S) Finance and Claims--Do Pass",12,10,0,0,22
1963238,1537000,2025-04-03,Senate,"(S) 2nd Reading Motion to Amend Failed",24,26,0,0,50
1963238,1537001,2025-04-03,Senate,"(S) 2nd Reading Motion to Amend Failed",23,27,0,0,50
1963238,1537002,2025-04-03,Senate,"(S) 2nd Reading Motion to Amend Failed",25,25,0,0,50
1963238,1537003,2025-04-03,Senate,"(S) 2nd Reading Passed",27,23,0,0,50
1963238,1537099,2025-04-04,Senate,"(S) 3rd Reading Passed",27,22,0,1,50
1963238,1548983,2025-04-15,House,"(H) State Administration--Be Concurred In As Amended",16,3,0,0,19
1963238,1553829,2025-04-22,House,"(H) Appropriations--Be Concurred In As Amended",16,7,0,0,23
1963238,1557370,2025-04-24,House,"(H) 2nd Reading Motion to Amend Failed",35,65,0,0,100
1963238,1557371,2025-04-24,House,"(H) 2nd Reading Motion to Amend Failed",44,56,0,0,100
1963238,1557372,2025-04-24,House,"(H) 2nd Reading Not Concurred",50,50,0,0,100
1963277,1494748,2025-02-20,House,"(H) Taxation--Do Pass",18,3,0,0,21
1963277,1497884,2025-02-24,House,"(H) 2nd Reading Motion to Amend Carried",98,2,0,0,100
1963277,1497885,2025-02-24,House,"(H) 2nd Reading Passed as Amended",59,41,0,0,100
1963277,1501830,2025-02-27,House,"(H) Appropriations--To Table",13,10,0,0,23
1963314,1491535,2025-02-17,House,"(H) Judiciary--Do Pass",12,8,0,0,20
1963314,1522791,2025-03-20,House,"(H) 2nd Reading Not Passed",45,55,0,0,100
1963465,1498083,2025-02-24,House,"(H) Natural Resources--Do Pass",14,0,0,0,14
1963465,1502507,2025-02-28,House,"(H) 2nd Reading Passed",95,4,0,1,100
1963465,1502508,2025-02-28,House,"(H) Appropriations--Do Pass",18,0,0,5,23
1963465,1503743,2025-03-03,House,"(H) 3rd Reading Passed",95,2,0,3,100
1963465,1537619,2025-04-04,Senate,"(S) Natural Resources--Be Concurred In",11,0,0,0,11
1963465,1545184,2025-04-10,Senate,"(S) 2nd Reading Concurred",50,0,0,0,50
1963465,1546155,2025-04-11,Senate,"(S) Finance and Claims--Be Concurred In",13,9,0,0,22
1963465,1546634,2025-04-12,Senate,"(S) 3rd Reading Concurred",50,0,0,0,50
1963545,1499206,2025-02-25,Senate,"(S) Energy, Technology & Federal Relations--Do Pass",13,0,0,0,13
1963545,1519545,2025-03-18,Senate,"(S) 2nd Reading Passed",42,8,0,0,50
1963545,1522180,2025-03-19,Senate,"(S) 3rd Reading Passed",42,8,0,0,50
1963545,1543208,2025-04-09,House,"(H) Energy, Technology and Federal Relations--Resolution Adopted",14,0,0,0,14
1963545,1551976,2025-04-17,House,"(H) 2nd Reading Concurred",98,2,0,0,100
1963545,1552059,2025-04-18,House,"(H) 3rd Reading Concurred",95,3,0,2,100
1963552,1494428,2025-02-19,House,"(H) Energy, Technology and Federal Relations--Do Pass",13,1,0,0,14
1963552,1519657,2025-03-18,House,"(H) 2nd Reading Passed",98,1,0,1,100
1963552,1521161,2025-03-19,House,"(H) 3rd Reading Passed",98,0,0,2,100
1963552,1537238,2025-04-03,Senate,"(S) Energy, Technology & Federal Relations--Resolution Adopted As Amended",13,0,0,0,13
1963552,1552092,2025-04-18,Senate,"(S) 2nd Reading Concurred",48,0,0,2,50
1963552,1554727,2025-04-22,Senate,"(S) 3rd Reading Concurred",50,0,0,0,50
1963552,1557675,2025-04-22,Senate,"(S) 3rd Reading Concurred",50,0,0,0,50
1963552,1557676,2025-04-24,House,"(H) 2nd Reading Senate Amendments Concurred",98,2,0,0,100
1963552,1558340,2025-04-25,House,"(H) 3rd Reading Passed as Amended by Senate",99,1,0,0,100
1963733,1499463,2025-02-25,House,"(H) Local Government--Do Pass As Amended",16,1,0,0,17
1963733,1502964,2025-03-01,House,"(H) 2nd Reading Passed",67,33,0,0,100
1963733,1503739,2025-03-03,House,"(H) 3rd Reading Passed",63,35,0,2,100
1963733,1524145,2025-03-21,Senate,"(S) Local Government--Be Concurred In",8,0,0,3,11
1963733,1546655,2025-04-12,Senate,"(S) 2nd Reading Concurred",44,6,0,0,50
1963733,1547481,2025-04-14,Senate,"(S) 3rd Reading Concurred",47,1,0,2,50
1963918,1494110,2025-02-19,House,"(H) Business and Labor--Do Pass",20,0,0,0,20
1963918,1497012,2025-02-22,House,"(H) 2nd Reading Passed",98,1,0,1,100
1963918,1498455,2025-02-24,House,"(H) 3rd Reading Passed",97,2,0,1,100
1963918,1523359,2025-03-20,Senate,"(S) Judiciary--To Table",8,0,0,0,8
1963918,1523360,2025-03-20,Senate,"(S) Judiciary--Be Concurred In",3,5,0,0,8
1963918,1530451,2025-03-20,Senate,"(S) Judiciary--To Table",8,0,0,0,8
1963918,1546549,2025-04-12,Senate,"(S) 2nd Reading Concurred",35,14,0,1,50
1963918,1546894,2025-04-14,Senate,"(S) 3rd Reading Concurred",30,18,0,2,50
1963918,1548395,2025-03-20,Senate,"(S) Judiciary--To Table",8,0,0,0,8
1963918,1550133,2025-03-20,Senate,"(S) Judiciary--To Table",8,0,0,0,8
1964228,1493857,2025-02-19,House,"(H) Education--To Table",9,6,0,0,15
1964347,1496468,2025-02-21,House,"(H) Judiciary--Do Pass As Amended",12,8,0,0,20
1964347,1501812,2025-02-21,House,"(H) Judiciary--Do Pass As Amended",12,8,0,0,20
1964347,1502595,2025-02-28,House,"(H) 2nd Reading Motion to Amend Failed",41,58,0,1,100
1964347,1502596,2025-02-28,House,"(H) 2nd Reading Passed",54,45,0,1,100
1964347,1502973,2025-03-01,House,"(H) 3rd Reading Passed",52,45,0,3,100
1964347,1536302,2025-04-03,Senate,"(S) Judiciary--Be Concurred In",5,3,0,0,8
1964347,1541744,2025-04-09,Senate,"(S) 2nd Reading Motion to Amend Carried",29,20,0,1,50
1964347,1541745,2025-04-09,Senate,"(S) 2nd Reading Concurred as Amended",27,23,0,0,50
1964347,1546649,2025-04-12,Senate,"(S) 3rd Reading Concurred",29,21,0,0,50
1964347,1552167,2025-04-18,House,"(H) 2nd Reading Senate Amendments Concurred",97,2,0,1,100
1964347,1553701,2025-04-22,House,"(H) 3rd Reading Passed as Amended by Senate",60,38,0,2,100
1964347,1559295,2025-04-28,House,"(H) 2nd Reading Governor's Proposed Amendments Adopted",53,47,0,0,100
1964347,1559296,2025-04-28,Senate,"(S) 2nd Reading Governor's Proposed Amendments Adopted",31,19,0,0,50
1964347,1560255,2025-04-29,House,"(H) 3rd Reading Governor's Proposed Amendments Adopted",50,49,0,1,100
1964347,1560256,2025-04-29,Senate,"(S) 3rd Reading Governor's Proposed Amendments Adopted",31,19,0,0,50
1964464,1497940,2025-02-24,House,"(H) Judiciary--Do Pass As Amended",20,0,0,0,20
1964464,1502760,2025-02-28,House,"(H) 2nd Reading Passed",99,0,0,1,100
1964464,1503024,2025-03-01,House,"(H) 3rd Reading Passed",97,0,0,3,100
1964464,1524667,2025-03-24,Senate,"(S) Judiciary--Be Concurred In",8,0,0,0,8
1964464,1542705,2025-04-09,Senate,"(S) 2nd Reading Motion to Amend Carried",28,22,0,0,50
1964464,1542706,2025-04-09,Senate,"(S) 2nd Reading Concurred as Amended",45,5,0,0,50
1964464,1546650,2025-04-12,Senate,"(S) 3rd Reading Concurred",50,0,0,0,50
1964464,1550515,2025-04-16,House,"(H) 2nd Reading Senate Amendments Concurred",99,1,0,0,100
1964464,1551518,2025-04-17,House,"(H) 3rd Reading Passed as Amended by Senate",93,6,0,1,100
1964782,1496897,2025-02-21,Senate,"(S) Public Health, Welfare and Safety--Do Pass",11,0,0,0,11
1964782,1502458,2025-02-28,Senate,"(S) 2nd Reading Passed",50,0,0,0,50
1964782,1502975,2025-03-01,Senate,"(S) 3rd Reading Passed",50,0,0,0,50
1964782,1528099,2025-03-26,House,"(H) Human Services--Be Concurred In As Amended",21,0,0,0,21
1964782,1539629,2025-04-08,House,"(H) 2nd Reading Concurred",98,0,0,2,100
1964782,1542037,2025-04-09,House,"(H) Appropriations--Be Concurred In",22,0,1,0,23
1964782,1543558,2025-04-10,House,"(H) 3rd Reading Concurred",98,0,0,2,100
1964782,1546529,2025-04-12,Senate,"(S) 2nd Reading House Amendments Concurred",28,22,0,0,50
1964782,1547188,2025-04-14,Senate,"(S) 3rd Reading Passed as Amended by House",42,6,0,2,50
1964794,1498053,2025-02-24,Senate,"(S) Business, Labor  and Economic Affairs--To Table",12,0,0,0,12
1964811,1491657,2025-02-17,House,"(H) Transportation--Do Pass",13,1,0,0,14
1964811,1494097,2025-02-17,House,"(H) Transportation--Do Pass",13,1,0,0,14
1964811,1503345,2025-02-21,House,"(H) 2nd Reading Passed",84,16,0,0,100
1964811,1503346,2025-02-22,House,"(H) 3rd Reading Passed",79,19,0,2,100
1964811,1525290,2025-03-24,Senate,"(S) Highways and Transportation--Be Concurred In",8,0,0,0,8
1964811,1546562,2025-04-12,Senate,"(S) 2nd Reading Concurred",46,4,0,0,50
1964811,1546920,2025-04-14,Senate,"(S) 3rd Reading Concurred",45,3,0,2,50
1964833,1494944,2025-02-20,House,"(H) Business and Labor--Do Pass",20,0,0,0,20
1964833,1497013,2025-02-22,House,"(H) 2nd Reading Passed",95,4,0,1,100
1964833,1498377,2025-02-24,House,"(H) 3rd Reading Passed",94,5,0,1,100
1964833,1529715,2025-03-27,Senate,"(S) Education and Cultural Resources--Be Concurred In",13,1,0,0,14
1964833,1546721,2025-04-12,Senate,"(S) 2nd Reading Concurred",44,5,0,1,50
1964833,1547745,2025-04-14,Senate,"(S) 3rd Reading Concurred",45,3,0,2,50
1964851,1499614,2025-02-25,House,"(H) Fish, Wildlife and Parks--Do Pass As Amended",13,7,0,0,20
1964851,1502963,2025-03-01,House,"(H) 2nd Reading Passed",96,4,0,0,100
1964851,1503794,2025-03-03,House,"(H) 3rd Reading Passed",94,3,0,3,100
1964851,1533853,2025-04-01,Senate,"(S) Fish and Game--Be Concurred In",11,0,1,0,12
1964851,1543725,2025-04-10,Senate,"(S) 2nd Reading Concurred",48,2,0,0,50
1964851,1546444,2025-04-11,Senate,"(S) 3rd Reading Concurred",47,1,0,2,50
1964868,1498308,2025-02-24,Senate,"(S) Local Government--Do Pass",11,0,0,0,11
1964868,1500797,2025-02-26,Senate,"(S) 2nd Reading Passed",50,0,0,0,50
1964868,1501996,2025-02-27,Senate,"(S) 3rd Reading Passed",50,0,0,0,50
1964868,1524186,2025-03-21,House,"(H) Taxation--Be Concurred In As Amended",21,0,0,0,21
1964868,1531390,2025-03-31,House,"(H) 2nd Reading Concurred",100,0,0,0,100
1964868,1533392,2025-04-01,House,"(H) 3rd Reading Concurred",99,0,0,1,100
1964868,1538196,2025-04-07,Senate,"(S) 2nd Reading House Amendments Concurred",50,0,0,0,50
1964868,1541168,2025-04-08,Senate,"(S) 3rd Reading Passed as Amended by House",48,0,0,2,50
1964886,1496262,2025-02-21,Senate,"(S) Judiciary--To Table",5,3,0,0,8
1964902,1493441,2025-02-19,House,"(H) Business and Labor--Do Pass As Amended",20,0,0,0,20
1964902,1497995,2025-02-24,House,"(H) 2nd Reading Passed",100,0,0,0,100
1964902,1499262,2025-02-25,House,"(H) 3rd Reading Passed",99,1,0,0,100
1964902,1522974,2025-03-20,Senate,"(S) Business, Labor  and Economic Affairs--Be Concurred In",12,0,0,0,12
1964902,1543815,2025-04-10,Senate,"(S) 2nd Reading Concurred",47,3,0,0,50
1964902,1546062,2025-04-11,Senate,"(S) 3rd Reading Concurred",40,8,0,2,50
1964929,1501910,2025-02-27,Senate,"(S) Energy, Technology & Federal Relations--To Table",8,5,0,0,13
1964947,1497895,2025-02-24,Senate,"(S) Business, Labor  and Economic Affairs--Do Pass",10,2,0,0,12
1964947,1500869,2025-02-26,Senate,"(S) 2nd Reading Pass Motion Failed",22,28,0,0,50
1964947,1500870,2025-02-26,Senate,"(S) 2nd Reading Indefinitely Postponed",37,13,0,0,50
1964962,1496473,2025-02-21,Senate,"(S) Judiciary--Do Pass",8,0,0,0,8
1964962,1498285,2025-02-24,Senate,"(S) 2nd Reading Passed",50,0,0,0,50
1964962,1499595,2025-02-25,Senate,"(S) 3rd Reading Passed",49,0,0,1,50
1964962,1525350,2025-03-24,House,"(H) Judiciary--Be Concurred In",20,0,0,0,20
1964962,1530676,2025-03-29,House,"(H) 2nd Reading Concurred",100,0,0,0,100
1964981,1493042,2025-02-19,Senate,"(S) Judiciary--Do Pass As Amended",8,0,0,1,9
1964981,1496583,2025-02-21,Senate,"(S) 2nd Reading Passed",50,0,0,0,50
1964981,1497658,2025-02-24,Senate,"(S) 3rd Reading Passed",49,0,0,1,50
1964981,1529068,2025-03-27,House,"(H) Judiciary--Be Concurred In As Amended",20,0,0,0,20
1964981,1542624,2025-04-09,House,"(H) 2nd Reading Motion to Amend Carried",98,1,0,1,100
1964981,1542625,2025-04-09,House,"(H) 2nd Reading Concurred as Amended",99,1,0,0,100
1964981,1546216,2025-04-11,House,"(H) 3rd Reading Concurred",99,0,0,1,100
1964981,1547023,2025-04-14,Senate,"(S) 2nd Reading House Amendments Concurred",50,0,0,0,50
1964981,1548535,2025-04-15,Senate,"(S) 3rd Reading Passed as Amended by House",50,0,0,0,50
1965003,1498112,2025-02-24,Senate,"(S) Business, Labor  and Economic Affairs--To Table",11,1,0,0,12
1965021,1496980,2025-02-21,Senate,"(S) Highways and Transportation--To Table",8,0,0,0,8
1965042,1496921,2025-02-21,House,"(H) Judiciary--To Table",20,0,0,0,20
1965101,1496247,2025-02-21,House,"(H) Taxation--Do Pass",21,0,0,0,21
1965101,1526788,2025-03-25,House,"(H) 2nd Reading Passed",100,0,0,0,100
1965101,1528116,2025-03-26,House,"(H) 3rd Reading Passed",94,5,0,1,100
1965101,1550338,2025-04-16,Senate,"(S) Taxation--Be Concurred In",8,0,0,0,8
1965101,1555815,2025-04-23,Senate,"(S) 2nd Reading Motion to Amend Carried",40,10,0,0,50
1965101,1555816,2025-04-23,Senate,"(S) 2nd Reading Concurred as Amended",47,3,0,0,50
1965101,1558017,2025-04-25,Senate,"(S) 3rd Reading Concurred",28,21,0,1,50
1965101,1560929,2025-04-29,House,"(H) 2nd Reading Senate Amendments Not Concurred",58,42,0,0,100
1965163,1499172,2025-02-25,Senate,"(S) Education and Cultural Resources--Do Pass As Amended",8,6,0,0,14
1965163,1503204,2025-03-03,Senate,"(S) 2nd Reading Passed",31,19,0,0,50
1965163,1505061,2025-03-04,Senate,"(S) 3rd Reading Passed",30,20,0,0,50
1965163,1538837,2025-04-07,House,"(H) Education--To Table",15,0,0,0,15
1965163,1544203,2025-04-07,House,"(H) Education--To Table",15,0,0,0,15
1965227,1502862,2025-02-28,Senate,"(S) State Administration--To Table",9,0,0,0,9
1965293,1502888,2025-02-28,Senate,"(S) Public Health, Welfare and Safety--Do Pass",10,1,0,0,11
1965293,1504330,2025-03-04,Senate,"(S) 2nd Reading Passed",48,2,0,0,50
1965293,1505649,2025-03-05,Senate,"(S) 3rd Reading Passed",47,2,0,1,50
1965293,1526812,2025-03-25,House,"(H) Human Services--Be Concurred In",21,0,0,0,21
1965293,1541183,2025-04-08,House,"(H) 2nd Reading Concurred",97,1,0,2,100
1965293,1542231,2025-04-09,House,"(H) 3rd Reading Concurred",97,0,0,3,100
1965355,1496850,2025-02-21,House,"(H) Energy, Technology and Federal Relations--To Table",8,6,0,0,14
1965469,1502874,2025-02-28,Senate,"(S) State Administration--Do Pass As Amended",9,0,0,0,9
1965469,1505386,2025-03-04,Senate,"(S) 2nd Reading Passed",49,1,0,0,50
1965469,1505656,2025-03-05,Senate,"(S) 3rd Reading Passed",47,2,0,1,50
1965469,1529878,2025-03-28,House,"(H) State Administration--Be Concurred In As Amended",19,0,0,0,19
1965469,1539745,2025-04-08,House,"(H) 2nd Reading Concurred",87,11,0,2,100
1965469,1542833,2025-04-09,House,"(H) 3rd Reading Concurred",81,16,0,3,100
1965469,1546522,2025-04-12,Senate,"(S) 2nd Reading House Amendments Concurred",50,0,0,0,50
1965469,1547079,2025-04-14,Senate,"(S) 3rd Reading Passed as Amended by House",47,1,0,2,50
1965513,1502887,2025-02-28,Senate,"(S) Natural Resources--To Table",10,1,0,0,11
1965561,1498116,2025-02-24,House,"(H) Business and Labor--Do Pass As Amended",20,0,0,0,20
1965561,1502407,2025-02-28,House,"(H) 2nd Reading Passed",99,0,0,1,100
1965561,1503009,2025-03-01,House,"(H) 3rd Reading Passed",97,0,0,3,100
1965561,1522729,2025-03-20,Senate,"(S) Business, Labor  and Economic Affairs--Be Concurred In",12,0,0,0,12
1965561,1546539,2025-04-12,Senate,"(S) 2nd Reading Concurred",42,0,0,8,50
1965561,1547376,2025-04-14,Senate,"(S) 3rd Reading Concurred",47,1,0,2,50
1965608,1502465,2025-02-27,Senate,"(S) Energy, Technology & Federal Relations--Do Pass As Amended",13,0,0,0,13
1965608,1503786,2025-03-03,Senate,"(S) 2nd Reading Passed",50,0,0,0,50
1965608,1522521,2025-03-20,Senate,"(S) Finance and Claims--Do Pass As Amended",22,0,0,0,22
1965608,1527969,2025-03-26,Senate,"(S) 2nd Reading Motion to Amend Carried",50,0,0,0,50
1965608,1527970,2025-03-26,Senate,"(S) 2nd Reading Passed as Amended",50,0,0,0,50
1965608,1529148,2025-03-27,Senate,"(S) 3rd Reading Passed",50,0,0,0,50
1965608,1543508,2025-04-09,House,"(H) Energy, Technology and Federal Relations--Be Concurred In As Amended",11,3,0,0,14
1965608,1547625,2025-04-14,House,"(H) 2nd Reading Concurred",90,10,0,0,100
1965608,1548962,2025-04-15,House,"(H) 3rd Reading Concurred",97,0,0,3,100
1965608,1551263,2025-04-17,Senate,"(S) 2nd Reading House Amendments Concurred",49,0,0,1,50
1965608,1552001,2025-04-17,Senate,"(S) 2nd Reading House Amendments Concurred",49,0,0,1,50
1965608,1552304,2025-04-18,Senate,"(S) 3rd Reading Passed as Amended by House",50,0,0,0,50
1965656,1496172,2025-02-21,House,"(H) Taxation--To Table",20,1,0,0,21
1965701,1498119,2025-02-24,House,"(H) State Administration--Do Pass",19,0,0,0,19
1965701,1501334,2025-02-27,House,"(H) 2nd Reading Passed",100,0,0,0,100
1965701,1502334,2025-02-28,House,"(H) 3rd Reading Passed",98,0,0,2,100
1965701,1528401,2025-03-26,Senate,"(S) State Administration--Be Concurred In As Amended",9,0,0,0,9
1965701,1534734,2025-04-02,Senate,"(S) 2nd Reading Concurred",50,0,0,0,50
1965701,1536580,2025-04-03,Senate,"(S) 3rd Reading Concurred",50,0,0,0,50
1965701,1547949,2025-04-14,House,"(H) 2nd Reading Senate Amendments Concurred",99,1,0,0,100
1965701,1549203,2025-04-15,House,"(H) 3rd Reading Passed as Amended by Senate",97,0,0,3,100
1965744,1496217,2025-02-21,Senate,"(S) Taxation--Do Pass",7,1,0,0,8
1965744,1497667,2025-02-24,Senate,"(S) 2nd Reading Motion to Amend Carried",45,5,0,0,50
1965744,1497668,2025-02-24,Senate,"(S) 2nd Reading Passed as Amended",39,11,0,0,50
1965744,1500755,2025-02-26,Senate,"(S) 3rd Reading Passed",46,4,0,0,50
1965744,1523266,2025-03-20,House,"(H) Taxation--Be Concurred In As Amended",21,0,0,0,21
1965744,1531496,2025-03-31,House,"(H) 2nd Reading Concurred",100,0,0,0,100
1965744,1533611,2025-04-01,House,"(H) 3rd Reading Concurred",99,0,0,1,100
1965744,1538664,2025-04-07,Senate,"(S) 2nd Reading House Amendments Concurred",41,9,0,0,50
1965744,1540583,2025-04-08,Senate,"(S) 3rd Reading Passed as Amended by House",43,5,0,2,50
1966046,1498038,2025-02-24,Senate,"(S) Business, Labor  and Economic Affairs--Do Pass",12,0,0,0,12
1966046,1500777,2025-02-26,Senate,"(S) 2nd Reading Passed",50,0,0,0,50
1966046,1501741,2025-02-27,Senate,"(S) 3rd Reading Passed",50,0,0,0,50
1966046,1524129,2025-03-21,House,"(H) Business and Labor--Be Concurred In",20,0,0,0,20
1966046,1529689,2025-03-27,House,"(H) 2nd Reading Concurred",98,1,0,1,100
1966046,1530503,2025-03-28,House,"(H) 3rd Reading Concurred",98,1,0,1,100
1966133,1496826,2025-02-21,House,"(H) Taxation--To Table",21,0,0,0,21
1966216,1496521,2025-02-21,House,"(H) Judiciary--Do Pass",11,9,0,0,20
1966216,1526629,2025-03-25,House,"(H) 2nd Reading Motion to Amend Failed",49,50,0,1,100
1966216,1526630,2025-03-25,House,"(H) 2nd Reading Not Passed",40,60,0,0,100
1966306,1493699,2025-02-19,House,"(H) Business and Labor--Do Pass As Amended",20,0,0,0,20
1966306,1501855,2025-02-27,House,"(H) 2nd Reading Passed",96,4,0,0,100
1966306,1502300,2025-02-28,House,"(H) 3rd Reading Passed",95,3,0,2,100
1966306,1524596,2025-03-24,Senate,"(S) Judiciary--Be Concurred In",5,3,0,0,8
1966306,1543517,2025-04-10,Senate,"(S) 2nd Reading Concurred",45,5,0,0,50
1966306,1545851,2025-04-11,Senate,"(S) 3rd Reading Concurred",43,5,0,2,50
1966394,1497477,2025-02-21,House,"(H) Human Services--Do Pass",12,9,0,0,21
1966394,1524250,2025-03-21,House,"(H) 2nd Reading Not Passed",44,55,0,1,100
1966394,1576008,2025-02-21,House,"(H) Human Services--Do Pass",12,9,0,0,21
1966568,1498238,2025-02-24,House,"(H) Business and Labor--Do Pass",13,7,0,0,20
1966568,1524090,2025-03-21,House,"(H) 2nd Reading Passed",61,38,0,1,100
1966568,1530137,2025-03-28,House,"(H) Appropriations--Do Pass As Amended",15,8,0,0,23
1966568,1538530,2025-04-07,House,"(H) 2nd Reading Passed",60,40,0,0,100
1966568,1539600,2025-04-08,House,"(H) 3rd Reading Passed",58,39,0,3,100
1966568,1550681,2025-04-16,Senate,"(S) Public Health, Welfare and Safety--Be Concurred In",4,7,0,0,11
1966568,1551133,2025-04-16,Senate,"(S) Public Health, Welfare and Safety--To Table",11,0,0,0,11
1966568,1552048,2025-04-16,Senate,"(S) Public Health, Welfare and Safety--To Table",11,0,0,0,11
1966568,1555462,2025-04-23,Senate,"(S) Taken from Committee; Placed on 2nd Reading",27,23,0,0,50
1966568,1557282,2025-04-24,Senate,"(S) 2nd Reading Concurred",27,23,0,0,50
1966568,1558136,2025-04-25,Senate,"(S) 3rd Reading Concurred",27,22,0,1,50
1966660,1521850,2025-03-19,Senate,"(S) Public Health, Welfare and Safety--Resolution Adopted",11,0,0,0,11
1966660,1531049,2025-03-31,Senate,"(S) 2nd Reading Passed",48,2,0,0,50
1966660,1533209,2025-04-01,Senate,"(S) 3rd Reading Passed",47,3,0,0,50
1966660,1551625,2025-04-17,House,"(H) Human Services--Resolution Adopted",20,1,0,0,21
1966660,1555489,2025-04-23,House,"(H) 2nd Reading Concurred",90,9,0,1,100
1966660,1556683,2025-04-24,House,"(H) 3rd Reading Concurred",91,8,0,1,100
1967020,1500624,2025-02-26,House,"(H) Business and Labor--Do Pass As Amended",20,0,0,0,20
1967020,1503031,2025-03-01,House,"(H) 2nd Reading Passed",100,0,0,0,100
1967020,1503742,2025-03-03,House,"(H) 3rd Reading Passed",98,0,0,2,100
1967020,1530776,2025-03-24,Senate,"(S) Judiciary--To Table",6,2,0,0,8
1967020,1537296,2025-03-24,Senate,"(S) Judiciary--To Table",6,2,0,0,8
1967059,1496366,2025-02-21,House,"(H) Judiciary--Do Pass",12,8,0,0,20
1967059,1497737,2025-02-24,House,"(H) 2nd Reading Passed",62,37,0,1,100
1967059,1499519,2025-02-25,House,"(H) 3rd Reading Passed",64,36,0,0,100
1967059,1524644,2025-03-24,Senate,"(S) Judiciary--Be Concurred In",5,3,0,0,8
1967059,1546536,2025-04-12,Senate,"(S) 2nd Reading Concurred",36,10,0,4,50
1967059,1547317,2025-04-14,Senate,"(S) 3rd Reading Concurred",38,10,0,2,50
1967102,1500995,2025-02-26,House,"(H) Natural Resources--Do Pass As Amended",14,0,0,0,14
1967102,1503456,2025-03-03,House,"(H) 2nd Reading Passed",99,0,0,1,100
1967102,1504813,2025-03-04,House,"(H) 3rd Reading Passed",94,5,0,1,100
1967102,1542942,2025-04-09,Senate,"(S) Natural Resources--Be Concurred In",9,2,0,0,11
1967102,1546747,2025-04-12,Senate,"(S) 2nd Reading Concurred",38,8,0,4,50
1967102,1546924,2025-04-14,Senate,"(S) 3rd Reading Concurred",38,10,0,2,50
1967141,1497535,2025-02-24,House,"(H) Business and Labor--Do Pass",20,0,0,0,20
1967141,1502763,2025-02-28,House,"(H) 2nd Reading Passed",99,0,0,1,100
1967141,1502979,2025-03-01,House,"(H) 3rd Reading Passed",97,0,0,3,100
1967141,1521267,2025-03-19,Senate,"(S) Business, Labor  and Economic Affairs--Be Concurred In As Amended",11,0,0,1,12
1967141,1535308,2025-04-02,Senate,"(S) 2nd Reading Concurred",50,0,0,0,50
1967141,1535802,2025-04-03,Senate,"(S) 3rd Reading Concurred",50,0,0,0,50
1967141,1547683,2025-04-14,House,"(H) 2nd Reading Senate Amendments Concurred",100,0,0,0,100
1967141,1548461,2025-04-15,House,"(H) 3rd Reading Passed as Amended by Senate",97,0,0,3,100
1967182,1496230,2025-02-21,House,"(H) Judiciary--Do Pass As Amended",11,9,0,0,20
1967182,1499386,2025-02-25,House,"(H) 2nd Reading Passed",54,46,0,0,100
1967182,1500386,2025-02-26,House,"(H) 3rd Reading Passed",56,44,0,0,100
1967182,1541497,2025-04-09,Senate,"(S) Judiciary--To Table",8,0,0,0,8
1967182,1543258,2025-04-09,Senate,"(S) Judiciary--To Table",8,0,0,0,8
1967226,1496177,2025-02-21,Senate,"(S) Taxation--Do Pass As Amended",8,0,0,0,8
1967226,1498062,2025-02-24,Senate,"(S) 2nd Reading Passed",47,2,0,1,50
1967226,1499365,2025-02-25,Senate,"(S) 3rd Reading Passed",49,0,0,1,50
1967226,1523043,2025-03-20,House,"(H) Taxation--Be Concurred In",17,4,0,0,21
1967226,1531307,2025-03-31,House,"(H) 2nd Reading Concurred",83,17,0,0,100
1967226,1532584,2025-04-01,House,"(H) 3rd Reading Concurred",86,13,0,1,100
1967272,1497760,2025-02-24,House,"(H) Business and Labor--To Table",19,1,0,0,20
1967311,1495974,2025-02-20,House,"(H) Fish, Wildlife and Parks--Do Pass",20,0,0,0,20
1967311,1498138,2025-02-24,House,"(H) 2nd Reading Passed",100,0,0,0,100
1967311,1498789,2025-02-25,House,"(H) 3rd Reading Passed",100,0,0,0,100
1967311,1533672,2025-04-01,Senate,"(S) Fish and Game--Be Concurred In",11,0,1,0,12
1967311,1546541,2025-04-12,Senate,"(S) 2nd Reading Concurred",45,0,0,5,50
1967311,1547577,2025-04-14,Senate,"(S) 3rd Reading Concurred",46,2,0,2,50
1967356,1496740,2025-02-21,House,"(H) Education--Do Pass As Amended",15,0,0,0,15
1967356,1502615,2025-02-28,House,"(H) 2nd Reading Passed",76,22,0,2,100
1967356,1502971,2025-02-28,House,"(H) Appropriations--Do Pass As Amended",18,5,0,0,23
1967356,1523110,2025-03-20,House,"(H) 2nd Reading Passed",69,31,0,0,100
1967356,1524120,2025-03-21,House,"(H) 3rd Reading Passed",69,28,0,3,100
1967356,1549353,2025-04-15,Senate,"(S) Education and Cultural Resources--Be Concurred In",8,6,0,0,14
1967356,1551574,2025-04-17,Senate,"(S) 2nd Reading Concurred",30,20,0,0,50
1967356,1557822,2025-04-24,Senate,"(S) Motion Carried",27,23,0,0,50
1967356,1558191,2025-04-25,Senate,"(S) 3rd Reading Concurred",28,21,0,1,50
1967396,1502936,2025-03-01,Senate,"(S) Business, Labor  and Economic Affairs--Do Pass As Amended",8,4,0,0,12
1967396,1505218,2025-03-04,Senate,"(S) 2nd Reading Passed",25,24,0,1,50
1967396,1522755,2025-03-20,Senate,"(S) Finance and Claims--To Table",14,8,0,0,22
1967396,1522756,2025-03-20,Senate,"(S) Finance and Claims--Do Pass",8,14,0,0,22
1967438,1496911,2025-02-21,Senate,"(S) Highways and Transportation--Do Pass",5,3,0,0,8
1967438,1502961,2025-03-01,Senate,"(S) 2nd Reading Passed",36,14,0,0,50
1967438,1503388,2025-03-03,Senate,"(S) 3rd Reading Passed",42,8,0,0,50
1967438,1518846,2025-03-17,House,"(H) Transportation--Be Concurred In",14,0,0,0,14
1967438,1524819,2025-03-24,House,"(H) 2nd Reading Concurred",97,2,0,1,100
1967438,1527081,2025-03-25,House,"(H) 3rd Reading Concurred",96,3,0,1,100
1967480,1500285,2025-02-26,House,"(H) Business and Labor--Do Pass As Amended",20,0,0,0,20
1967480,1503044,2025-03-01,House,"(H) 2nd Reading Motion to Amend Carried",100,0,0,0,100
1967480,1503045,2025-03-01,House,"(H) 2nd Reading Passed as Amended",98,1,0,1,100
1967480,1504694,2025-03-04,House,"(H) 3rd Reading Passed",99,0,0,1,100
1967480,1521672,2025-03-19,Senate,"(S) Business, Labor  and Economic Affairs--Be Concurred In",11,0,0,1,12
1967480,1541178,2025-04-08,Senate,"(S) 2nd Reading Concurred",50,0,0,0,50
1967480,1542925,2025-04-09,Senate,"(S) 3rd Reading Concurred",49,0,0,1,50
1967520,1502931,2025-03-01,Senate,"(S) Business, Labor  and Economic Affairs--Do Pass As Amended",8,4,0,0,12
1967520,1523142,2025-03-20,Senate,"(S) 2nd Reading Motion to Amend Carried",35,15,0,0,50
1967520,1523143,2025-03-20,Senate,"(S) 2nd Reading Passed as Amended",30,20,0,0,50
1967520,1532990,2025-04-01,Senate,"(S) Finance and Claims--Do Pass",11,11,0,0,22
1967559,1497992,2025-02-24,House,"(H) Judiciary--Do Pass",12,8,0,0,20
1967559,1505283,2025-03-04,House,"(H) 2nd Reading Motion to Amend Carried",75,24,0,1,100
1967559,1505284,2025-03-04,House,"(H) 2nd Reading Passed as Amended",56,43,0,1,100
1967559,1507017,2025-03-06,House,"(H) 3rd Reading Passed",56,42,0,2,100
1967559,1536625,2025-04-03,Senate,"(S) Education and Cultural Resources--Be Concurred In",8,6,0,0,14
1967559,1542091,2025-04-09,Senate,"(S) 2nd Reading Concurred",31,19,0,0,50
1967559,1543602,2025-04-10,Senate,"(S) 3rd Reading Concurred",28,20,0,2,50
1967607,1497985,2025-02-24,House,"(H) State Administration--To Table",19,0,0,0,19
1967645,1496735,2025-02-21,House,"(H) Judiciary--Do Pass",12,8,0,0,20
1967645,1501958,2025-02-27,House,"(H) 2nd Reading Passed",61,39,0,0,100
1967645,1502464,2025-02-28,House,"(H) 3rd Reading Passed",58,40,0,2,100
1967645,1536704,2025-04-03,Senate,"(S) Judiciary--Be Concurred In As Amended",5,3,0,0,8
1967645,1537844,2025-04-05,Senate,"(S) 2nd Reading Concurred",32,18,0,0,50
1967645,1538630,2025-04-07,Senate,"(S) 3rd Reading Concurred",32,17,0,1,50
1967645,1549134,2025-04-15,House,"(H) 2nd Reading Senate Amendments Concurred",55,45,0,0,100
1967645,1550008,2025-04-16,House,"(H) 3rd Reading Not Passed as Amended by Senate",48,50,0,2,100
1967645,1551944,2025-04-17,House,"(H) Reconsidered Previous Action; Remains in 3rd Reading Process",54,44,0,2,100
1967645,1552088,2025-04-18,House,"(H) 3rd Reading Passed as Amended by Senate",50,49,0,1,100
1967645,1552089,2025-04-18,House,"(H) Reconsidered Previous Action; Remains in 3rd Reading Process",45,52,0,3,100
1967684,1498122,2025-02-21,House,"(H) Human Services--Do Pass",21,0,0,0,21
1967684,1498873,2025-02-25,House,"(H) 2nd Reading Passed",100,0,0,0,100
1967684,1500749,2025-02-26,House,"(H) 3rd Reading Passed",100,0,0,0,100
1967684,1530498,2025-03-28,Senate,"(S) Public Health, Welfare and Safety--Be Concurred In",11,0,0,0,11
1967684,1546512,2025-04-12,Senate,"(S) 2nd Reading Concurred",49,0,0,1,50
1967684,1547853,2025-04-14,Senate,"(S) 3rd Reading Concurred",46,2,0,2,50
1967722,1498176,2025-02-24,House,"(H) Appropriations--Do Pass",23,0,0,0,23
1967722,1502732,2025-02-28,House,"(H) 2nd Reading Passed",99,0,0,1,100
1967722,1503016,2025-03-01,House,"(H) 3rd Reading Passed",97,0,0,3,100
1967722,1524236,2025-03-21,Senate,"(S) Finance and Claims--Be Concurred In",22,0,0,0,22
1967722,1544120,2025-04-10,Senate,"(S) 2nd Reading Concurred",48,1,0,1,50
1967722,1546188,2025-04-11,Senate,"(S) 3rd Reading Concurred",46,2,0,2,50
1967761,1502474,2025-02-28,House,"(H) Natural Resources--Do Pass As Amended",12,2,0,0,14
1967761,1524113,2025-03-21,House,"(H) 2nd Reading Motion to Amend Carried",87,12,0,1,100
1967761,1524114,2025-03-21,House,"(H) 2nd Reading Passed as Amended",56,43,0,1,100
1967761,1526270,2025-03-25,House,"(H) 3rd Reading Passed",56,41,0,3,100
1967761,1542202,2025-04-09,Senate,"(S) Natural Resources--Be Concurred In As Amended",6,5,0,0,11
1967761,1546557,2025-04-12,Senate,"(S) 2nd Reading Motion to Amend Carried",26,24,0,0,50
1967761,1546558,2025-04-12,Senate,"(S) 2nd Reading Concurred as Amended",26,24,0,0,50
1967761,1546905,2025-04-14,Senate,"(S) 3rd Reading Concurred",26,22,0,2,50
1967800,1498259,2025-02-24,House,"(H) Natural Resources--To Table",14,0,0,0,14
1967800,1515966,2025-03-03,House,"(H) Natural Resources--To Table",13,1,0,0,14
1967840,1496895,2025-02-21,House,"(H) Judiciary--To Table",20,0,0,0,20
1967840,1506754,2025-03-03,House,"(H) Judiciary--To Table",16,4,0,0,20
1967840,1506755,2025-03-05,House,"(H) Taken from Committee; Placed on 2nd Reading",39,59,0,2,100
1967840,1541533,2025-03-05,House,"(H) Taken from Committee; Placed on 2nd Reading",39,59,0,2,100
1967877,1493294,2025-02-19,House,"(H) Judiciary--To Table",20,0,0,0,20
1967917,1497484,2025-02-21,House,"(H) Human Services--Do Pass",16,5,0,0,21
1967917,1519312,2025-03-17,House,"(H) 2nd Reading Passed",88,12,0,0,100
1967917,1520054,2025-03-18,House,"(H) 3rd Reading Passed",74,24,0,2,100
1967917,1539055,2025-04-07,Senate,"(S) Public Health, Welfare and Safety--Be Concurred In",6,5,0,0,11
1967917,1546520,2025-04-12,Senate,"(S) 2nd Reading Concurred",33,16,0,1,50
1967917,1547222,2025-04-14,Senate,"(S) 3rd Reading Concurred",32,16,0,2,50
1967917,1557950,2025-02-21,House,"(H) Human Services--Do Pass",16,5,0,0,21
1967956,1496234,2025-02-21,House,"(H) Judiciary--Do Pass",18,2,0,0,20
1967956,1497739,2025-02-24,House,"(H) 2nd Reading Passed",96,4,0,0,100
1967956,1498938,2025-02-25,House,"(H) 3rd Reading Passed",100,0,0,0,100
1967956,1524127,2025-03-21,Senate,"(S) Judiciary--To Table",8,0,0,0,8
1967956,1524128,2025-03-21,Senate,"(S) Judiciary--Be Concurred In",4,4,0,0,8
1967956,1530316,2025-03-21,Senate,"(S) Judiciary--To Table",8,0,0,0,8
1967956,1538572,2025-04-07,Senate,"(S) Judiciary--To Take From The Table",5,3,0,0,8
1967956,1543609,2025-04-08,Senate,"(S) Judiciary--Be Concurred In",6,2,0,0,8
1967956,1543610,2025-04-07,Senate,"(S) Judiciary--To Take From The Table",5,3,0,0,8
1967956,1546653,2025-04-12,Senate,"(S) 2nd Reading Concurred",43,4,0,3,50
1967956,1547151,2025-04-14,Senate,"(S) 3rd Reading Concurred",46,2,0,2,50
1967994,1499353,2025-02-25,Senate,"(S) Fish and Game--Do Pass As Amended",6,6,0,0,12
1967994,1501129,2025-02-25,Senate,"(S) Fish and Game--To Table",10,2,0,0,12
1967994,1502670,2025-02-27,Senate,"(S) Fish and Game--Do Pass As Amended",8,4,0,0,12
1967994,1504665,2025-03-04,Senate,"(S) 2nd Reading Passed",34,16,0,0,50
1967994,1505816,2025-03-05,Senate,"(S) 3rd Reading Passed",32,17,0,1,50
1967994,1527128,2025-03-25,House,"(H) Fish, Wildlife and Parks--Be Concurred In",20,0,0,0,20
1967994,1528405,2025-03-25,House,"(H) Fish, Wildlife and Parks--Be Concurred In",20,0,0,0,20
1967994,1531470,2025-03-31,House,"(H) 2nd Reading Concurred",100,0,0,0,100
1967994,1532730,2025-04-01,House,"(H) 3rd Reading Concurred",99,0,0,1,100
1968030,1502618,2025-02-28,House,"(H) Taxation--Do Pass",17,4,0,0,21
1968030,1531178,2025-03-31,House,"(H) Appropriations--Do Pass As Amended",22,1,0,0,23
1968030,1536577,2025-04-03,House,"(H) 2nd Reading Passed",90,10,0,0,100
1968030,1537704,2025-04-05,House,"(H) 3rd Reading Passed",87,11,0,2,100
1968030,1549631,2025-04-16,Senate,"(S) Taxation--Be Concurred In",6,2,0,0,8
1968030,1552077,2025-04-18,Senate,"(S) 2nd Reading Concurred",49,1,0,0,50
1968030,1554014,2025-04-22,Senate,"(S) 3rd Reading Concurred",46,4,0,0,50
1968066,1498022,2025-02-24,House,"(H) State Administration--Do Pass",11,8,0,0,19
1968066,1501896,2025-02-27,House,"(H) 2nd Reading Passed",51,49,0,0,100
1968066,1502695,2025-02-28,House,"(H) 3rd Reading Failed",44,54,0,2,100
1968355,1499106,2025-02-25,House,"(H) Business and Labor--To Table",12,8,0,0,20
1968433,1498291,2025-02-24,House,"(H) Business and Labor--Do Pass As Amended",17,3,0,0,20
1968433,1502082,2025-02-27,House,"(H) 2nd Reading Passed",65,35,0,0,100
1968433,1502780,2025-02-28,House,"(H) 3rd Reading Failed",44,54,0,2,100
1968520,1492335,2025-02-18,House,"(H) Local Government--Do Pass",17,0,0,0,17
1968520,1496637,2025-02-21,House,"(H) 2nd Reading Passed",93,7,0,0,100
1968520,1497113,2025-02-22,House,"(H) 3rd Reading Passed",91,7,0,2,100
1968520,1538643,2025-04-07,Senate,"(S) Local Government--Be Concurred In",9,1,0,0,10
1968520,1546710,2025-04-12,Senate,"(S) 2nd Reading Concurred",29,20,0,1,50
1968520,1547687,2025-04-14,Senate,"(S) 3rd Reading Concurred",32,16,0,2,50
1968603,1498021,2025-02-24,House,"(H) State Administration--Do Pass",19,0,0,0,19
1968603,1501895,2025-02-27,House,"(H) 2nd Reading Passed",86,14,0,0,100
1968603,1502751,2025-02-28,House,"(H) 3rd Reading Passed",82,16,0,2,100
1968603,1535307,2025-04-02,Senate,"(S) State Administration--To Table",9,0,0,0,9
1968603,1537244,2025-04-02,Senate,"(S) State Administration--To Table",9,0,0,0,9
1968603,1552276,2025-04-18,Senate,"(S) Taken from Committee; Placed on 2nd Reading",27,22,0,1,50
1968603,1554192,2025-04-22,Senate,"(S) 2nd Reading Indefinitely Postponed",36,14,0,0,50
1968603,1554193,2025-04-22,Senate,"(S) 2nd Reading Pass Motion Failed",19,31,0,0,50
1968688,1526708,2025-03-25,House,"(H) Local Government--To Table",17,0,0,0,17
1968777,1494092,2025-02-19,House,"(H) Transportation--Do Pass",14,0,0,0,14
1968777,1497110,2025-02-22,House,"(H) 2nd Reading Passed",99,0,0,1,100
1968777,1497962,2025-02-24,House,"(H) 3rd Reading Passed",98,1,0,1,100
1968777,1524907,2025-03-19,Senate,"(S) Highways and Transportation--Be Concurred In",8,0,0,0,8
1968777,1546588,2025-04-12,Senate,"(S) 2nd Reading Concurred",48,1,0,1,50
1968777,1546951,2025-04-14,Senate,"(S) 3rd Reading Concurred",47,1,0,2,50
1968951,1500781,2025-02-26,Senate,"(S) Judiciary--Do Pass",8,0,0,0,8
1968951,1502385,2025-02-28,Senate,"(S) 2nd Reading Passed",44,6,0,0,50
1968951,1502987,2025-03-01,Senate,"(S) 3rd Reading Passed",43,7,0,0,50
1968951,1541558,2025-04-09,House,"(H) Judiciary--To Table",19,1,0,0,20
1968951,1543705,2025-04-09,House,"(H) Judiciary--To Table",19,1,0,0,20
1968951,1545466,2025-04-11,House,"(H) Taken from Committee; Placed on 2nd Reading",56,43,0,1,100
1968951,1547553,2025-04-14,House,"(H) 2nd Reading Not Concurred",50,50,0,0,100
1968951,1549343,2025-04-15,House,"(H) Reconsidered Previous Action; Placed on 2nd Reading",45,51,0,4,100
1968951,1580070,2025-04-09,House,"(H) Judiciary--To Table",19,1,0,0,20
1969029,1500582,2025-02-26,House,"(H) Business and Labor--Do Pass",20,0,0,0,20
1969029,1502988,2025-03-01,House,"(H) 2nd Reading Passed",99,0,0,1,100
1969029,1503714,2025-03-03,House,"(H) 3rd Reading Passed",95,3,0,2,100
1969029,1525985,2025-03-25,Senate,"(S) Business, Labor  and Economic Affairs--Be Concurred In",12,0,0,0,12
1969029,1543576,2025-04-10,Senate,"(S) 2nd Reading Concurred",49,0,0,1,50
1969029,1546415,2025-04-11,Senate,"(S) 3rd Reading Concurred",48,0,0,2,50
1969108,1496371,2025-02-21,House,"(H) Judiciary--Do Pass As Amended",19,1,0,0,20
1969108,1502743,2025-02-28,House,"(H) 2nd Reading Passed",59,40,0,1,100
1969108,1502984,2025-03-01,House,"(H) 3rd Reading Passed",57,40,0,3,100
1969108,1537342,2025-04-04,Senate,"(S) Judiciary--Be Concurred In As Amended",6,1,1,0,8
1969108,1543615,2025-04-10,Senate,"(S) 2nd Reading Concurred",38,11,0,1,50
1969108,1546419,2025-04-11,Senate,"(S) 3rd Reading Concurred",33,15,0,2,50
1969108,1550055,2025-04-16,House,"(H) 2nd Reading Senate Amendments Concurred",58,42,0,0,100
1969108,1551546,2025-04-17,House,"(H) 3rd Reading Passed as Amended by Senate",58,41,0,1,100
1969190,1500767,2025-02-26,House,"(H) Business and Labor--Do Pass As Amended",20,0,0,0,20
1969190,1505579,2025-03-04,House,"(H) 2nd Reading Passed",91,8,0,1,100
1969190,1507020,2025-03-06,House,"(H) 3rd Reading Passed",93,6,0,1,100
1969190,1527382,2025-03-26,Senate,"(S) Business, Labor  and Economic Affairs--Be Concurred In",9,3,0,0,12
1969190,1542399,2025-04-09,Senate,"(S) 2nd Reading Concurred",46,4,0,0,50
1969190,1544056,2025-04-10,Senate,"(S) 3rd Reading Concurred",45,3,0,2,50
1969266,1498102,2025-02-24,House,"(H) Judiciary--Do Pass As Amended",17,3,0,0,20
1969266,1502620,2025-02-28,House,"(H) 2nd Reading Passed",91,8,0,1,100
1969266,1502621,2025-02-28,House,"(H) Appropriations--Do Pass",18,5,0,0,23
1969266,1503795,2025-03-03,House,"(H) 3rd Reading Passed",88,9,0,3,100
1969266,1523182,2025-03-20,Senate,"(S) Judiciary--Be Concurred In",6,2,0,0,8
1969266,1542574,2025-04-09,Senate,"(S) 2nd Reading Concurred",46,4,0,0,50
1969266,1546243,2025-04-11,Senate,"(S) 3rd Reading Concurred",44,4,0,2,50
1969348,1505232,2025-03-04,Senate,"(S) Business, Labor  and Economic Affairs--To Table",10,2,0,0,12
1969434,1494032,2025-02-19,Senate,"(S) Business, Labor  and Economic Affairs--Do Pass",12,0,0,0,12
1969434,1496533,2025-02-21,Senate,"(S) 2nd Reading Passed",50,0,0,0,50
1969434,1498193,2025-02-24,Senate,"(S) 3rd Reading Passed",47,2,0,1,50
1969434,1528810,2025-03-27,House,"(H) State Administration--Be Concurred In As Amended",19,0,0,0,19
1969434,1544301,2025-04-10,House,"(H) 2nd Reading Concurred",99,1,0,0,100
1969434,1546091,2025-04-11,House,"(H) 3rd Reading Concurred",99,0,0,1,100
1969434,1551422,2025-04-17,Senate,"(S) 2nd Reading House Amendments Concurred",50,0,0,0,50
1969434,1552018,2025-04-17,Senate,"(S) 2nd Reading House Amendments Concurred",50,0,0,0,50
1969434,1552205,2025-04-18,Senate,"(S) 3rd Reading Passed as Amended by House",48,2,0,0,50
1969513,1503001,2025-03-01,House,"(H) Judiciary--Do Pass As Amended",16,4,0,0,20
1969513,1504454,2025-03-04,House,"(H) 2nd Reading Motion to Amend Carried",58,41,0,1,100
1969513,1504455,2025-03-04,House,"(H) 2nd Reading Passed as Amended",98,1,0,1,100
1969513,1505936,2025-03-05,House,"(H) 3rd Reading Passed",98,0,0,2,100
1969513,1538275,2025-04-07,Senate,"(S) Judiciary--Be Concurred In As Amended",6,2,0,0,8
1969513,1544081,2025-04-10,Senate,"(S) 2nd Reading Motion to Amend Failed",17,33,0,0,50
1969513,1544082,2025-04-10,Senate,"(S) 2nd Reading Concurred",44,6,0,0,50
1969513,1546189,2025-04-11,Senate,"(S) 3rd Reading Concurred",40,8,0,2,50
1969513,1550219,2025-04-16,House,"(H) 2nd Reading Senate Amendments Concurred",100,0,0,0,100
1969513,1551413,2025-04-17,House,"(H) 3rd Reading Passed as Amended by Senate",99,0,0,1,100
1969596,1498342,2025-02-24,Senate,"(S) Natural Resources--Do Pass",11,0,0,0,11
1969596,1503154,2025-03-03,Senate,"(S) 2nd Reading Passed",49,0,0,1,50
1969596,1507013,2025-03-04,Senate,"(S) Finance and Claims--Do Pass",22,0,0,0,22
1969596,1507919,2025-03-06,Senate,"(S) 3rd Reading Passed",49,0,0,1,50
1969596,1524216,2025-03-21,House,"(H) Natural Resources--Be Concurred In",14,0,0,0,14
1969596,1528017,2025-03-26,House,"(H) 2nd Reading Concurred",99,0,0,1,100
1969596,1528899,2025-03-27,House,"(H) Appropriations--Be Concurred In",21,0,0,2,23
1969596,1530727,2025-03-29,House,"(H) 3rd Reading Concurred",96,0,0,4,100
1969679,1504924,2025-03-04,Senate,"(S) Legislative Administration--Do Pass As Amended",6,0,0,0,6
1969679,1506940,2025-03-05,Senate,"(S) 2nd Reading Passed",46,4,0,0,50
1969679,1507376,2025-03-06,Senate,"(S) 3rd Reading Passed",45,5,0,0,50
1969679,1530362,2025-03-28,House,"(H) State Administration--Be Concurred In",16,3,0,0,19
1969679,1543102,2025-04-09,House,"(H) Appropriations--Be Concurred In",21,0,2,0,23
1969679,1546270,2025-04-11,House,"(H) 2nd Reading Concurred",81,19,0,0,100
1969679,1546271,2025-04-11,House,"(H) 3rd Reading Concurred",86,13,0,1,100
1969766,1503008,2025-03-01,Senate,"(S) State Administration--Do Pass",8,1,0,0,9
1969766,1508134,2025-03-06,Senate,"(S) 2nd Reading Passed",27,23,0,0,50
1969766,1508135,2025-03-06,Senate,"(S) 3rd Reading Passed",27,22,0,1,50
1969766,1530046,2025-03-28,House,"(H) State Administration--Be Concurred In",12,7,0,0,19
1969766,1544324,2025-04-10,House,"(H) 2nd Reading Not Concurred",50,50,0,0,100
1969766,1544325,2025-04-10,House,"(H) Reconsidered Previous Action; Placed on 2nd Reading",47,51,0,2,100
1969846,1497754,2025-02-24,House,"(H) State Administration--Do Pass",19,0,0,0,19
1969846,1502942,2025-03-01,House,"(H) 2nd Reading Passed",95,5,0,0,100
1969846,1503751,2025-03-03,House,"(H) 3rd Reading Passed",95,2,0,3,100
1969846,1528389,2025-03-26,Senate,"(S) State Administration--Be Concurred In",9,0,0,0,9
1969846,1545247,2025-04-10,Senate,"(S) 2nd Reading Concurred",47,3,0,0,50
1969846,1546434,2025-04-11,Senate,"(S) 3rd Reading Concurred",46,2,0,2,50
1969931,1499450,2025-02-25,House,"(H) Local Government--Do Pass As Amended",10,7,0,0,17
1969931,1503048,2025-03-01,House,"(H) 2nd Reading Passed",64,36,0,0,100
1969931,1503251,2025-03-03,House,"(H) 3rd Reading Passed",58,40,0,2,100
1969931,1539072,2025-04-07,Senate,"(S) Local Government--Be Concurred In As Amended",8,2,0,0,10
1969931,1545837,2025-04-11,Senate,"(S) 2nd Reading Concurred",43,7,0,0,50
1969931,1546664,2025-04-12,Senate,"(S) 3rd Reading Concurred",46,4,0,0,50
1969931,1549959,2025-04-16,House,"(H) 2nd Reading Senate Amendments Concurred",98,2,0,0,100
1969931,1551775,2025-04-17,House,"(H) 3rd Reading Passed as Amended by Senate",73,26,0,1,100
1970009,1498214,2025-02-21,House,"(H) Human Services--To Table",18,0,0,3,21
1970009,1558409,2025-02-21,House,"(H) Human Services--To Table",18,0,3,0,21
1970034,1499419,2025-02-25,House,"(H) Human Services--To Table",14,0,0,7,21
1970049,1497505,2025-02-24,Senate,"(S) Business, Labor  and Economic Affairs--To Table",11,1,0,0,12
1970063,1526065,2025-03-25,House,"(H) Business and Labor--Do Pass As Amended",20,0,0,0,20
1970063,1530168,2025-03-28,House,"(H) 2nd Reading Passed",100,0,0,0,100
1970063,1530671,2025-03-29,House,"(H) 3rd Reading Passed",96,0,0,4,100
1970063,1535847,2025-04-03,Senate,"(S) Business, Labor  and Economic Affairs--Be Concurred In",11,0,0,0,11
1970063,1543760,2025-04-10,Senate,"(S) 2nd Reading Concurred",50,0,0,0,50
1970063,1546031,2025-04-11,Senate,"(S) 3rd Reading Concurred",48,0,0,2,50
1970084,1499081,2025-02-25,House,"(H) Business and Labor--Do Pass As Amended",17,3,0,0,20
1970084,1503797,2025-03-03,House,"(H) 2nd Reading Passed",52,47,0,1,100
1970084,1504446,2025-03-04,House,"(H) Appropriations--Do Pass",13,10,0,0,23
1970084,1505928,2025-03-05,House,"(H) 3rd Reading Failed",48,50,0,2,100
1970084,1507286,2025-03-05,House,"(H) Reconsidered Previous Action; Remains in 3rd Reading Process",54,44,0,2,100
1970084,1508611,2025-03-07,House,"(H) 3rd Reading Failed",49,50,0,1,100
1970097,1502628,2025-02-28,Senate,"(S) Highways and Transportation--Do Pass As Amended",7,1,0,0,8
1970097,1532954,2025-04-01,Senate,"(S) 2nd Reading Pass Motion Failed",24,26,0,0,50
1970097,1536136,2025-04-03,Senate,"(S) Finance and Claims--Do Pass",13,9,0,0,22
1970097,1537078,2025-04-01,Senate,"(S) 2nd Reading Indefinitely Postponed",29,21,0,0,50
1970097,1537079,2025-04-01,Senate,"(S) 2nd Reading Pass Motion Failed",24,26,0,0,50
1970097,1537336,2025-04-04,Senate,"(S) 2nd Reading Passed",26,23,0,1,50
1970097,1537740,2025-04-05,Senate,"(S) 3rd Reading Passed",28,20,0,2,50
1970097,1551539,2025-04-17,House,"(H) Taxation--Be Concurred In As Amended",15,6,0,0,21
1970097,1553547,2025-04-22,House,"(H) 2nd Reading Concurred",53,46,0,1,100
1970097,1554983,2025-04-23,House,"(H) Appropriations--Be Concurred In",13,10,0,0,23
1970097,1557301,2025-04-24,House,"(H) 3rd Reading Concurred",51,49,0,0,100
1970097,1557302,2025-04-24,House,"(H) Reconsidered Previous Action; Remains in 3rd Reading Process",43,57,0,0,100
1970097,1558139,2025-04-24,House,"(H) 3rd Reading Concurred",51,49,0,0,100
1970097,1558140,2025-04-24,House,"(H) Reconsidered Previous Action; Remains in 3rd Reading Process",43,57,0,0,100
1970097,1559149,2025-04-28,Senate,"(S) 2nd Reading House Amendments Concur Motion Failed",21,29,0,0,50
1970097,1560800,2025-04-29,Senate,"(S) 2nd Reading Conference Committee Report Adopted",28,19,0,3,50
1970097,1561696,2025-04-30,House,"(H) 2nd Reading Conference Committee Report Adopted",67,33,0,0,100
1970097,1562306,2025-04-30,House,"(H) 3rd Reading Conference Committee Report Adopted",57,43,0,0,100
1970097,1562307,2025-04-30,Senate,"(S) 3rd Reading Conference Committee Report Rejected",25,25,0,0,50
1970111,1502878,2025-02-28,Senate,"(S) Public Health, Welfare and Safety--Do Pass As Amended",11,0,0,0,11
1970111,1504567,2025-03-04,Senate,"(S) 2nd Reading Passed",49,1,0,0,50
1970111,1505803,2025-03-05,Senate,"(S) 3rd Reading Passed",49,1,0,0,50
1970111,1539556,2025-04-08,House,"(H) Business and Labor--Be Concurred In",20,0,0,0,20
1970111,1543516,2025-04-10,House,"(H) 2nd Reading Concurred",100,0,0,0,100
1970111,1546341,2025-04-11,House,"(H) 3rd Reading Concurred",98,1,0,1,100
1970128,1533755,2025-04-01,Senate,"(S) Taxation--Do Pass As Amended",5,3,0,0,8
1970128,1536961,2025-04-03,Senate,"(S) 2nd Reading Passed",28,22,0,0,50
1970128,1537098,2025-04-04,Senate,"(S) Finance and Claims--Do Pass",12,10,0,0,22
1970128,1537848,2025-04-05,Senate,"(S) 3rd Reading Passed",29,19,0,2,50
1970128,1549615,2025-04-16,House,"(H) Taxation--Be Concurred In",13,8,0,0,21
1970128,1552114,2025-04-18,House,"(H) 2nd Reading Motion to Amend Carried",68,29,0,3,100
1970128,1552115,2025-04-18,House,"(H) 2nd Reading Concurred as Amended",58,40,0,2,100
1970128,1554971,2025-04-23,House,"(H) Appropriations--To Table",22,0,1,0,23
1970128,1555859,2025-04-23,House,"(H) Appropriations--To Table",22,0,1,0,23
1970128,1558275,2025-04-25,House,"(H) Motion Failed",46,53,0,1,100
1970150,1530483,2025-03-28,House,"(H) Education--Do Pass As Amended",10,5,0,0,15
1970150,1533736,2025-04-01,House,"(H) Appropriations--Do Pass",15,8,0,0,23
1970150,1537594,2025-04-04,House,"(H) 2nd Reading Passed",65,35,0,0,100
1970150,1537646,2025-04-05,House,"(H) 3rd Reading Passed",62,36,0,2,100
1970150,1549281,2025-04-15,Senate,"(S) Education and Cultural Resources--To Table",14,0,0,0,14
1970150,1550723,2025-04-15,Senate,"(S) Education and Cultural Resources--To Table",14,0,0,0,14
1970150,1551973,2025-04-17,Senate,"(S) Taken from Committee; Placed on 2nd Reading",27,23,0,0,50
1970150,1552169,2025-04-18,Senate,"(S) 2nd Reading Concurred",27,23,0,0,50
1970150,1553710,2025-04-22,Senate,"(S) 3rd Reading Concurred",29,21,0,0,50
1970166,1502900,2025-02-28,Senate,"(S) Public Health, Welfare and Safety--To Table",11,0,0,0,11
1970166,1505571,2025-03-04,Senate,"(S) Taken from Committee; Placed on 2nd Reading",32,18,0,0,50
1970166,1506379,2025-03-05,Senate,"(S) 2nd Reading Motion to Amend Failed",22,28,0,0,50
1970166,1506380,2025-03-05,Senate,"(S) 2nd Reading Passed",32,18,0,0,50
1970166,1524036,2025-03-21,Senate,"(S) Finance and Claims--Do Pass As Amended",12,10,0,0,22
1970166,1526653,2025-03-25,Senate,"(S) 2nd Reading Passed",30,20,0,0,50
1970166,1528029,2025-03-26,Senate,"(S) 3rd Reading Passed",31,19,0,0,50
1970166,1542485,2025-04-09,House,"(H) Human Services--Be Concurred In As Amended",14,7,0,0,21
1970166,1546139,2025-04-11,House,"(H) 2nd Reading Concurred",51,47,0,2,100
1970166,1546140,2025-04-11,House,"(H) 3rd Reading Concurred",56,43,0,1,100
1970166,1547086,2025-04-14,Senate,"(S) 2nd Reading House Amendments Not Concurred",33,17,0,0,50
1970166,1560128,2025-04-29,Senate,"(S) 2nd Reading Conference Committee Report Adopted",29,21,0,0,50
1970166,1560129,2025-04-29,House,"(H) 2nd Reading Conference Committee Report Adopted",86,14,0,0,100
1970166,1562296,2025-04-30,House,"(H) 3rd Reading Conference Committee Report Adopted",54,46,0,0,100
1970166,1562297,2025-04-30,Senate,"(S) 3rd Reading Conference Committee Report Adopted",28,22,0,0,50
1970178,1534046,2025-04-02,Senate,"(S) Taxation--To Table",8,0,0,0,8
1970178,1534721,2025-04-02,Senate,"(S) Motion Failed",18,32,0,0,50
1970199,1529968,2025-03-28,Senate,"(S) Taxation--Do Pass",7,1,0,0,8
1970199,1533767,2025-04-01,Senate,"(S) 2nd Reading Passed",39,11,0,0,50
1970199,1535147,2025-04-02,Senate,"(S) Finance and Claims--Do Pass As Amended",18,4,0,0,22
1970199,1536611,2025-04-03,Senate,"(S) 2nd Reading Passed",37,13,0,0,50
1970199,1537092,2025-04-04,Senate,"(S) 3rd Reading Passed",40,9,0,1,50
1970199,1551284,2025-04-17,House,"(H) Taxation--Be Concurred In As Amended",11,10,0,0,21
1970199,1553517,2025-04-22,House,"(H) 2nd Reading Concurred",55,44,0,1,100
1970199,1555066,2025-04-23,House,"(H) Appropriations--To Table",15,8,0,0,23
1970199,1557825,2025-04-24,House,"(H) Motion Failed",48,52,0,0,100
1970217,1499251,2025-02-25,House,"(H) Agriculture--Do Pass",17,0,0,0,17
1970217,1502999,2025-03-01,House,"(H) 2nd Reading Passed",99,1,0,0,100
1970217,1503296,2025-03-03,House,"(H) 3rd Reading Passed",98,0,0,2,100
1970217,1533796,2025-04-01,Senate,"(S) Agriculture, Livestock and Irrigation--Be Concurred In",11,0,0,0,11
1970217,1536721,2025-04-03,Senate,"(S) Agriculture, Livestock and Irrigation--Be Concurred In As Amended",11,0,0,0,11
1970217,1539031,2025-04-07,Senate,"(S) 2nd Reading Concurred",47,3,0,0,50
1970217,1541169,2025-04-08,Senate,"(S) 3rd Reading Concurred",44,4,0,2,50
1970217,1547844,2025-04-14,House,"(H) 2nd Reading Senate Amendments Concurred",97,3,0,0,100
1970217,1549257,2025-04-15,House,"(H) 3rd Reading Passed as Amended by Senate",97,0,0,3,100
1970231,1501452,2025-02-27,Senate,"(S) Judiciary--Do Pass As Amended",5,3,0,0,8
1970231,1503336,2025-03-03,Senate,"(S) 2nd Reading Passed",41,9,0,0,50
1970231,1521062,2025-03-19,Senate,"(S) Finance and Claims--Do Pass",22,0,0,0,22
1970231,1523299,2025-03-20,Senate,"(S) 3rd Reading Passed",47,3,0,0,50
1970231,1549646,2025-04-16,House,"(H) Judiciary--Be Concurred In",12,8,0,0,20
1970231,1554042,2025-04-22,House,"(H) 2nd Reading Not Concurred",46,53,0,1,100
1970231,1554043,2025-04-22,House,"(H) Reconsidered Previous Action; Placed on 2nd Reading",45,54,0,1,100
1970243,1493006,2025-02-19,Senate,"(S) Business, Labor  and Economic Affairs--Do Pass",12,0,0,0,12
1970243,1496254,2025-02-21,Senate,"(S) 2nd Reading Passed",50,0,0,0,50
1970243,1497922,2025-02-24,Senate,"(S) 3rd Reading Passed",49,0,0,1,50
1970243,1505206,2025-03-04,House,"(H) Business and Labor--Be Concurred In",19,0,0,0,19
1970243,1508378,2025-03-06,House,"(H) 2nd Reading Concurred",98,0,0,2,100
1970243,1508761,2025-03-07,House,"(H) 3rd Reading Concurred",97,2,0,1,100
1970262,1496943,2025-02-21,House,"(H) Judiciary--Do Pass",15,5,0,0,20
1970262,1497663,2025-02-24,House,"(H) 2nd Reading Passed",85,14,0,1,100
1970262,1499417,2025-02-25,House,"(H) 3rd Reading Passed",85,15,0,0,100
1970262,1537511,2025-04-04,Senate,"(S) Judiciary--Be Concurred In",8,0,0,0,8
1970262,1542603,2025-04-09,Senate,"(S) 2nd Reading Concurred",41,8,0,1,50
1970262,1544834,2025-04-10,Senate,"(S) 3rd Reading Concurred",41,7,0,2,50
1970276,1531136,2025-03-31,Senate,"(S) Taxation--Do Pass As Amended",7,1,0,0,8
1970276,1534393,2025-04-02,Senate,"(S) 2nd Reading Passed",27,23,0,0,50
1970276,1535737,2025-04-03,Senate,"(S) Finance and Claims--Do Pass",12,10,0,0,22
1970276,1537133,2025-04-04,Senate,"(S) 3rd Reading Passed",29,20,0,1,50
1970276,1549676,2025-04-16,House,"(H) Taxation--Be Concurred In",18,3,0,0,21
1970276,1551418,2025-04-16,House,"(H) Taxation--Be Concurred In As Amended",18,3,0,0,21
1970276,1552085,2025-04-18,House,"(H) 2nd Reading Not Concurred",49,50,0,1,100
1970276,1552086,2025-04-18,House,"(H) Reconsidered Previous Action; Placed on 2nd Reading",49,49,0,2,100
1970276,1552087,2025-04-18,House,"(H) Reconsidered Previous Action; Placed on 2nd Reading",48,47,0,5,100
1970276,1553356,2025-04-22,House,"(H) 2nd Reading Concurred",52,48,0,0,100
1970276,1555835,2025-04-23,House,"(H) Appropriations--Be Concurred In As Amended",14,9,0,0,23
1970276,1557024,2025-04-24,House,"(H) 2nd Reading Concurred",65,35,0,0,100
1970276,1558011,2025-04-25,House,"(H) 3rd Reading Concurred",62,38,0,0,100
1970276,1558894,2025-04-28,Senate,"(S) 2nd Reading House Amendments Concurred",44,6,0,0,50
1970276,1560389,2025-04-29,Senate,"(S) 3rd Reading Passed as Amended by House",31,19,0,0,50
1970292,1496369,2025-02-21,House,"(H) Judiciary--To Table",19,1,0,0,20
1970303,1536093,2025-04-03,House,"(H) Appropriations--Do Pass",21,2,0,0,23
1970303,1537314,2025-04-04,House,"(H) 2nd Reading Passed",88,12,0,0,100
1970303,1537724,2025-04-05,House,"(H) 3rd Reading Passed",90,8,0,2,100
1970303,1554994,2025-04-16,Senate,"(S) Finance and Claims--Be Concurred In As Amended",16,6,0,0,22
1970303,1555384,2025-04-23,Senate,"(S) 2nd Reading Motion to Amend Carried",45,5,0,0,50
1970303,1555385,2025-04-23,Senate,"(S) 2nd Reading Concurred as Amended",42,8,0,0,50
1970303,1558135,2025-04-25,Senate,"(S) 3rd Reading Concurred",44,5,0,1,50
1970303,1560045,2025-04-29,House,"(H) 2nd Reading Senate Amendments Concurred",90,8,0,2,100
1970303,1562215,2025-04-30,House,"(H) 3rd Reading Passed as Amended by Senate",96,4,0,0,100
1970586,1530187,2025-03-28,Senate,"(S) Taxation--Do Pass As Amended",7,1,0,0,8
1970586,1533103,2025-04-01,Senate,"(S) 2nd Reading Passed",50,0,0,0,50
1970586,1534212,2025-04-02,Senate,"(S) Finance and Claims--Do Pass",12,10,0,0,22
1970586,1536199,2025-04-03,Senate,"(S) 3rd Reading Passed",43,7,0,0,50
1970586,1549797,2025-04-16,House,"(H) Taxation--To Table",16,5,0,0,21
1970586,1550397,2025-04-16,House,"(H) Taxation--To Table",16,5,0,0,21
1970691,1530057,2025-03-28,House,"(H) Judiciary--To Table",11,9,0,0,20
1970798,1498012,2025-02-24,House,"(H) Education--To Table",10,5,0,0,15
1971016,1502849,2025-02-28,Senate,"(S) Public Health, Welfare and Safety--To Table",7,4,0,0,11
1971188,1498331,2025-02-24,Senate,"(S) Local Government--Do Pass",11,0,0,0,11
1971188,1503025,2025-03-01,Senate,"(S) 2nd Reading Passed",45,5,0,0,50
1971188,1503449,2025-03-03,Senate,"(S) 3rd Reading Passed",50,0,0,0,50
1971188,1524262,2025-03-21,House,"(H) Taxation--Be Concurred In",21,0,0,0,21
1971188,1530745,2025-03-29,House,"(H) 2nd Reading Concurred",100,0,0,0,100
1971188,1531459,2025-03-31,House,"(H) 3rd Reading Concurred",99,0,0,1,100
1971367,1500072,2025-02-26,Senate,"(S) Judiciary--Do Pass",6,2,0,0,8
1971367,1502959,2025-03-01,Senate,"(S) 2nd Reading Motion to Amend Carried",42,8,0,0,50
1971367,1502960,2025-03-01,Senate,"(S) 2nd Reading Passed as Amended",37,13,0,0,50
1971367,1505556,2025-03-04,Senate,"(S) 3rd Reading Passed",43,7,0,0,50
1971367,1536366,2025-04-03,House,"(H) Judiciary--Be Concurred In As Amended",12,8,0,0,20
1971367,1543708,2025-04-10,House,"(H) 2nd Reading Not Concurred",49,51,0,0,100
1971555,1503715,2025-03-03,Senate,"(S) Judiciary--Resolution Adopted",8,0,0,0,8
1971555,1519938,2025-03-18,Senate,"(S) Resolution Adopted",47,3,0,0,50
1971563,1530511,2025-03-27,House,"(H) Local Government--To Table",14,0,0,3,17
1971563,1534039,2025-04-01,House,"(H) Local Government--Do Pass As Amended",11,6,0,0,17
1971563,1537021,2025-04-03,House,"(H) Appropriations--Do Pass As Amended",16,7,0,0,23
1971563,1538688,2025-04-07,House,"(H) 2nd Reading Passed",71,29,0,0,100
1971563,1539699,2025-04-08,House,"(H) 3rd Reading Passed",66,31,0,3,100
1971563,1547463,2025-04-14,Senate,"(S) Local Government--Be Concurred In",6,4,0,0,10
1971563,1550118,2025-04-16,Senate,"(S) 2nd Reading Concurred",31,19,0,0,50
1971563,1552246,2025-04-18,Senate,"(S) Finance and Claims--Be Concurred In As Amended",22,0,0,0,22
1971563,1555286,2025-04-23,Senate,"(S) 2nd Reading Concurred",43,7,0,0,50
1971563,1557060,2025-04-01,House,"(H) Local Government--To Take From The Table",10,2,5,0,17
1971563,1557061,2025-04-24,Senate,"(S) 3rd Reading Concurred",45,5,0,0,50
1971563,1559034,2025-04-28,House,"(H) 2nd Reading Senate Amendments Concurred",69,31,0,0,100
1971563,1559887,2025-04-29,House,"(H) 3rd Reading Passed as Amended by Senate",63,36,0,1,100
1971570,1500508,2025-02-26,House,"(H) Energy, Technology and Federal Relations--To Table",14,0,0,0,14
1971578,1498518,2025-02-24,House,"(H) Education--Do Pass",13,2,0,0,15
1971578,1505095,2025-03-04,House,"(H) 2nd Reading Passed",74,25,0,1,100
1971578,1505964,2025-03-05,House,"(H) 3rd Reading Passed",67,31,0,2,100
1971578,1536947,2025-04-03,Senate,"(S) Education and Cultural Resources--Be Concurred In",11,3,0,0,14
1971578,1546560,2025-04-12,Senate,"(S) 2nd Reading Concurred",37,12,0,1,50
1971578,1546910,2025-04-14,Senate,"(S) 3rd Reading Concurred",38,10,0,2,50
1971585,1498597,2025-02-25,House,"(H) Business and Labor--Do Pass",20,0,0,0,20
1971585,1502556,2025-02-28,House,"(H) 2nd Reading Passed",97,2,0,1,100
1971585,1502557,2025-02-28,House,"(H) Appropriations--Do Pass",18,0,0,5,23
1971585,1503540,2025-03-03,House,"(H) 3rd Reading Passed",95,2,0,3,100
1971585,1523505,2025-03-20,Senate,"(S) Business, Labor  and Economic Affairs--Be Concurred In",8,4,0,0,12
1971585,1542572,2025-04-09,Senate,"(S) 2nd Reading Motion to Amend Carried",49,1,0,0,50
1971585,1542573,2025-04-09,Senate,"(S) 2nd Reading Concurred as Amended",31,19,0,0,50
1971585,1546300,2025-04-11,Senate,"(S) Finance and Claims--Be Concurred In",22,0,0,0,22
1971585,1546731,2025-04-12,Senate,"(S) 3rd Reading Concurred",39,11,0,0,50
1971585,1550195,2025-04-16,House,"(H) 2nd Reading Senate Amendments Concurred",100,0,0,0,100
1971585,1551951,2025-04-17,House,"(H) 3rd Reading Passed as Amended by Senate",98,1,0,1,100
1971592,1497954,2025-02-24,House,"(H) Judiciary--Do Pass",20,0,0,0,20
1971592,1503748,2025-03-03,House,"(H) 2nd Reading Passed",98,0,0,2,100
1971592,1503749,2025-03-03,House,"(H) Appropriations--Do Pass",21,0,0,2,23
1971592,1505349,2025-03-04,House,"(H) 3rd Reading Passed",99,0,0,1,100
1971592,1549008,2025-04-04,Senate,"(S) Judiciary--Be Concurred In",8,0,0,0,8
1971592,1549950,2025-04-16,Senate,"(S) 2nd Reading Concurred",49,0,0,1,50
1971592,1552213,2025-04-18,Senate,"(S) Finance and Claims--Be Concurred In",22,0,0,0,22
1971592,1553943,2025-04-22,Senate,"(S) 3rd Reading Concurred",50,0,0,0,50
1971607,1503305,2025-03-03,Senate,"(S) Judiciary--Resolution Adopted",8,0,0,0,8
1971607,1520243,2025-03-18,Senate,"(S) Resolution Adopted",49,1,0,0,50
1971621,1498722,2025-02-25,Senate,"(S) Judiciary--To Table",5,3,0,1,9
1971627,1500507,2025-02-26,House,"(H) Energy, Technology and Federal Relations--To Table",10,4,0,0,14
1971635,1499440,2025-02-25,Senate,"(S) Energy, Technology & Federal Relations--Do Pass",13,0,0,0,13
1971635,1502935,2025-03-01,Senate,"(S) 2nd Reading Passed",46,4,0,0,50
1971635,1504072,2025-03-03,Senate,"(S) 3rd Reading Passed",47,3,0,0,50
1971635,1525999,2025-03-25,House,"(H) Taxation--To Table",20,1,0,0,21
1971635,1530372,2025-03-25,House,"(H) Taxation--To Table",20,1,0,0,21
1971635,1552032,2025-04-17,House,"(H) Taxation--Be Concurred In As Amended",11,10,0,0,21
1971635,1554279,2025-04-22,House,"(H) 2nd Reading Concurred",56,44,0,0,100
1971635,1555684,2025-04-23,House,"(H) Appropriations--Be Concurred In",13,10,0,0,23
1971635,1557270,2025-04-24,House,"(H) 3rd Reading Concurred",58,42,0,0,100
1971635,1558959,2025-04-28,Senate,"(S) 2nd Reading House Amendments Concurred",46,3,0,1,50
1971635,1561213,2025-04-29,Senate,"(S) 3rd Reading Passed as Amended by House",42,8,0,0,50
1971640,1498011,2025-02-24,House,"(H) Judiciary--Do Pass",20,0,0,0,20
1971640,1501684,2025-02-27,House,"(H) 2nd Reading Passed",100,0,0,0,100
1971640,1502305,2025-02-28,House,"(H) 3rd Reading Passed",97,1,0,2,100
1971640,1541059,2025-04-08,Senate,"(S) Energy, Technology & Federal Relations--Be Concurred In As Amended",10,0,3,0,13
1971640,1541385,2025-04-08,Senate,"(S) Energy, Technology & Federal Relations--Be Concurred In As Amended",10,0,3,0,13
1971640,1544550,2025-04-10,Senate,"(S) 2nd Reading Motion to Amend Carried",50,0,0,0,50
1971640,1544551,2025-04-10,Senate,"(S) 2nd Reading Concurred as Amended",50,0,0,0,50
1971640,1546753,2025-04-12,Senate,"(S) 3rd Reading Concurred",50,0,0,0,50
1971640,1550067,2025-04-16,House,"(H) 2nd Reading Senate Amendments Concurred",94,6,0,0,100
1971640,1551998,2025-04-17,House,"(H) 3rd Reading Passed as Amended by Senate",99,0,0,1,100
1971640,1560049,2025-04-29,House,"(H) 2nd Reading Governor's Proposed Amendments Adopted",100,0,0,0,100
1971640,1560050,2025-04-29,Senate,"(S) 2nd Reading Conference Committee Report Adopted",48,0,0,2,50
1971640,1560781,2025-04-29,Senate,"(S) 2nd Reading Governor's Proposed Amendments Adopted",48,0,0,2,50
1971640,1562200,2025-04-30,House,"(H) 3rd Reading Governor's Proposed Amendments Adopted",100,0,0,0,100
1971640,1562201,2025-04-30,Senate,"(S) 3rd Reading Governor's Proposed Amendments Adopted",50,0,0,0,50
1971648,1531706,2025-03-31,House,"(H) Education--Do Pass As Amended",15,0,0,0,15
1971648,1536952,2025-04-03,House,"(H) 2nd Reading Passed",69,31,0,0,100
1971648,1537633,2025-04-05,House,"(H) 3rd Reading Passed",67,31,0,2,100
1971648,1549138,2025-04-15,Senate,"(S) Education and Cultural Resources--To Table",14,0,0,0,14
1971648,1550191,2025-04-15,Senate,"(S) Education and Cultural Resources--To Table",14,0,0,0,14
1971653,1531079,2025-03-31,House,"(H) Appropriations--Do Pass As Amended",16,7,0,0,23
1971653,1537104,2025-04-04,House,"(H) 2nd Reading Passed",76,24,0,0,100
1971653,1537661,2025-04-05,House,"(H) 3rd Reading Passed",73,25,0,2,100
1971653,1549364,2025-04-15,Senate,"(S) Education and Cultural Resources--To Table",14,0,0,0,14
1971653,1549883,2025-04-15,Senate,"(S) Education and Cultural Resources--To Table",14,0,0,0,14
1971653,1551138,2025-04-17,Senate,"(S) Taken from Committee; Placed on 2nd Reading",27,23,0,0,50
1971653,1552193,2025-04-18,Senate,"(S) 2nd Reading Motion to Amend Carried",37,13,0,0,50
1971653,1552194,2025-04-18,Senate,"(S) 2nd Reading Concurred as Amended",27,23,0,0,50
1971653,1553789,2025-04-22,Senate,"(S) 3rd Reading Concurred",29,21,0,0,50
1971653,1556866,2025-04-24,House,"(H) 2nd Reading Senate Amendments Concurred",90,10,0,0,100
1971653,1557972,2025-04-25,House,"(H) 3rd Reading Passed as Amended by Senate",80,20,0,0,100
1971842,1502846,2025-02-28,Senate,"(S) Public Health, Welfare and Safety--Do Pass",7,4,0,0,11
1971842,1507915,2025-03-06,Senate,"(S) 2nd Reading Pass Motion Failed",24,26,0,0,50
1971842,1507916,2025-03-06,Senate,"(S) 2nd Reading Indefinitely Postponed",29,21,0,0,50
1971843,1499488,2025-02-25,Senate,"(S) Energy, Technology & Federal Relations--Do Pass As Amended",10,3,0,0,13
1971843,1505280,2025-03-04,Senate,"(S) 2nd Reading Passed",40,10,0,0,50
1971843,1505703,2025-03-05,Senate,"(S) 3rd Reading Passed",40,10,0,0,50
1971843,1524414,2025-03-21,House,"(H) Energy, Technology and Federal Relations--Be Concurred In As Amended",8,6,0,0,14
1971843,1531645,2025-03-31,House,"(H) 2nd Reading Concurred",81,19,0,0,100
1971843,1532751,2025-04-01,House,"(H) 3rd Reading Concurred",81,18,0,1,100
1971843,1538151,2025-04-07,Senate,"(S) 2nd Reading House Amendments Concurred",43,7,0,0,50
1971843,1541173,2025-04-08,Senate,"(S) 3rd Reading Passed as Amended by House",39,9,0,2,50
1972124,1534903,2025-04-02,Senate,"(S) Public Health, Welfare and Safety--Resolution Adopted",11,0,0,0,11
1972124,1537689,2025-04-05,Senate,"(S) Resolution Adopted",49,0,0,1,50
1972159,1537090,2025-04-04,Senate,"(S) Business, Labor  and Economic Affairs--Resolution Adopted",11,0,0,0,11
1972159,1538737,2025-04-07,Senate,"(S) Resolution Adopted",50,0,0,0,50
1972195,1499957,2025-02-26,Senate,"(S) Business, Labor  and Economic Affairs--Do Pass",8,4,0,0,12
1972195,1502915,2025-03-01,Senate,"(S) 2nd Reading Passed",31,19,0,0,50
1972195,1503707,2025-03-03,Senate,"(S) 3rd Reading Passed",28,22,0,0,50
1972195,1541676,2025-04-09,House,"(H) Business and Labor--Be Concurred In As Amended",20,0,0,0,20
1972195,1545613,2025-04-11,House,"(H) 2nd Reading Concurred",99,1,0,0,100
1972195,1546211,2025-04-11,House,"(H) 3rd Reading Concurred",99,0,0,1,100
1972195,1551667,2025-04-17,Senate,"(S) 2nd Reading House Amendments Concurred",49,0,0,1,50
1972195,1552164,2025-04-18,Senate,"(S) 3rd Reading Passed as Amended by House",46,4,0,0,50
1972231,1499476,2025-02-25,House,"(H) Local Government--Do Pass",17,0,0,0,17
1972231,1502519,2025-02-28,House,"(H) 2nd Reading Passed",99,0,0,1,100
1972231,1502970,2025-03-01,House,"(H) 3rd Reading Passed",97,0,0,3,100
1972231,1524322,2025-03-21,Senate,"(S) Local Government--Be Concurred In",11,0,0,0,11
1972231,1546723,2025-04-12,Senate,"(S) 2nd Reading Concurred",48,1,0,1,50
1972231,1547572,2025-04-14,Senate,"(S) 3rd Reading Concurred",48,0,0,2,50
1972268,1499030,2025-02-25,Senate,"(S) Judiciary--To Table",8,0,0,1,9
1972303,1520947,2025-03-19,Senate,"(S) Taxation--Do Pass",7,1,0,0,8
1972303,1532890,2025-04-01,Senate,"(S) 2nd Reading Passed",50,0,0,0,50
1972303,1534773,2025-04-02,Senate,"(S) 3rd Reading Passed",50,0,0,0,50
1972303,1541616,2025-04-09,House,"(H) Taxation--Be Concurred In",21,0,0,0,21
1972303,1547176,2025-04-14,House,"(H) 2nd Reading Concurred",100,0,0,0,100
1972303,1548874,2025-04-15,House,"(H) 3rd Reading Concurred",97,0,0,3,100
1972346,1535798,2025-04-03,Senate,"(S) Business, Labor  and Economic Affairs--Resolution Adopted",11,0,0,0,11
1972346,1537739,2025-04-05,Senate,"(S) Resolution Adopted",49,0,0,1,50
1972379,1499190,2025-02-25,House,"(H) Agriculture--Do Pass",10,7,0,0,17
1972379,1505228,2025-03-04,House,"(H) 2nd Reading Not Passed",49,50,0,1,100
1972379,1506603,2025-03-05,House,"(H) Reconsidered Previous Action; Placed on 2nd Reading",47,51,0,2,100
1972416,1535522,2025-04-02,Senate,"(S) Public Health, Welfare and Safety--Resolution Adopted",11,0,0,0,11
1972416,1537723,2025-04-05,Senate,"(S) Resolution Adopted",49,0,0,1,50
1972455,1521280,2025-03-18,Senate,"(S) Education and Cultural Resources--Resolution Adopted",14,0,0,0,14
1972455,1524137,2025-03-21,Senate,"(S) Resolution Adopted",50,0,0,0,50
1972494,1535555,2025-04-02,Senate,"(S) Public Health, Welfare and Safety--Resolution Adopted",11,0,0,0,11
1972494,1537757,2025-04-05,Senate,"(S) Resolution Adopted",49,0,0,1,50
1972532,1502880,2025-02-28,Senate,"(S) Local Government--Do Pass",11,0,0,0,11
1972532,1523239,2025-03-20,Senate,"(S) 2nd Reading Motion to Amend Carried",46,3,0,1,50
1972532,1523240,2025-03-20,Senate,"(S) 2nd Reading Passed as Amended",31,19,0,0,50
1972532,1526817,2025-03-25,Senate,"(S) Finance and Claims--Do Pass",15,7,0,0,22
1972532,1529146,2025-03-27,Senate,"(S) 3rd Reading Passed",34,16,0,0,50
1972532,1542669,2025-04-09,House,"(H) Taxation--Be Concurred In",12,9,0,0,21
1972532,1546998,2025-04-14,House,"(H) 2nd Reading Concurred",56,44,0,0,100
1972532,1549754,2025-04-16,House,"(H) Appropriations--To Table",12,11,0,0,23
1972532,1554905,2025-04-17,House,"(H) Appropriations--To Take From The Table",10,8,5,0,23
1972532,1555292,2025-04-23,House,"(H) Appropriations--Be Concurred In",13,10,0,0,23
1972532,1555293,2025-04-17,House,"(H) Appropriations--To Take From The Table",10,8,5,0,23
1972532,1557751,2025-04-24,House,"(H) 3rd Reading Concurred",60,40,0,0,100
1972568,1500656,2025-02-26,Senate,"(S) Business, Labor  and Economic Affairs--Do Pass",12,0,0,0,12
1972568,1502928,2025-03-01,Senate,"(S) 2nd Reading Passed",50,0,0,0,50
1972568,1503259,2025-03-03,Senate,"(S) 3rd Reading Passed",50,0,0,0,50
1972568,1524226,2025-03-21,House,"(H) Business and Labor--Be Concurred In",20,0,0,0,20
1972568,1531473,2025-03-31,House,"(H) 2nd Reading Concurred",100,0,0,0,100
1972568,1532739,2025-04-01,House,"(H) 3rd Reading Concurred",99,0,0,1,100
1972602,1497769,2025-02-24,House,"(H) Judiciary--To Table",20,0,0,0,20
1972602,1503473,2025-03-03,House,"(H) Judiciary--Do Pass As Amended",12,8,0,0,20
1972602,1506063,2025-03-05,House,"(H) 2nd Reading Passed",55,44,0,1,100
1972602,1508658,2025-03-07,House,"(H) 3rd Reading Passed",58,41,0,1,100
1972602,1530136,2025-03-28,Senate,"(S) Judiciary--Be Concurred In",5,3,0,0,8
1972602,1546736,2025-04-12,Senate,"(S) 2nd Reading Concurred",36,13,0,1,50
1972602,1547802,2025-04-14,Senate,"(S) 3rd Reading Concurred",34,14,0,2,50
1972614,1502362,2025-02-27,House,"(H) Local Government--Do Pass As Amended",11,6,0,0,17
1972614,1505849,2025-03-05,House,"(H) 2nd Reading Passed",63,36,0,1,100
1972614,1508550,2025-03-07,House,"(H) 3rd Reading Passed",67,32,0,1,100
1972614,1531824,2025-03-31,Senate,"(S) Local Government--Be Concurred In",11,0,0,0,11
1972614,1546743,2025-04-12,Senate,"(S) 2nd Reading Concurred",45,4,0,1,50
1972614,1547892,2025-04-14,Senate,"(S) 3rd Reading Concurred",45,3,0,2,50
1972643,1502949,2025-03-01,Senate,"(S) Legislative Administration--Do Pass",6,0,0,0,6
1972643,1505831,2025-03-05,Senate,"(S) 2nd Reading Passed",44,6,0,0,50
1972643,1508083,2025-03-06,Senate,"(S) 3rd Reading Passed",48,2,0,0,50
1972643,1530829,2025-03-31,House,"(H) Legislative Administration--Be Concurred In",14,0,0,0,14
1972643,1543662,2025-04-10,House,"(H) 2nd Reading Concurred",93,7,0,0,100
1972643,1546439,2025-04-11,House,"(H) 3rd Reading Concurred",90,9,0,1,100
1972706,1501847,2025-02-27,House,"(H) Business and Labor--To Table",20,0,0,0,20
1972738,1521808,2025-03-19,Senate,"(S) Taxation--Do Pass As Amended",5,3,0,0,8
1972738,1526201,2025-03-25,Senate,"(S) 2nd Reading Passed",47,3,0,0,50
1972738,1532284,2025-04-01,Senate,"(S) Finance and Claims--Do Pass",22,0,0,0,22
1972738,1536441,2025-04-03,Senate,"(S) 3rd Reading Passed",46,4,0,0,50
1972738,1542082,2025-04-09,House,"(H) Taxation--To Table",21,0,0,0,21
1972738,1544703,2025-04-09,House,"(H) Taxation--To Table",21,0,0,0,21
1972768,1499275,2025-02-25,Senate,"(S) Judiciary--Do Pass",5,3,0,1,9
1972768,1502985,2025-03-01,Senate,"(S) 2nd Reading Passed",32,16,0,2,50
1972768,1503771,2025-03-03,Senate,"(S) 3rd Reading Passed",32,18,0,0,50
1972768,1535919,2025-04-03,House,"(H) Judiciary--Be Concurred In",12,8,0,0,20
1972768,1545046,2025-04-10,House,"(H) 2nd Reading Concurred",58,42,0,0,100
1972768,1546349,2025-04-11,House,"(H) 3rd Reading Concurred",58,41,0,1,100
1972802,1499836,2025-02-26,Senate,"(S) Business, Labor  and Economic Affairs--Do Pass As Amended",9,3,0,0,12
1972802,1502980,2025-03-01,Senate,"(S) 2nd Reading Passed",46,4,0,0,50
1972802,1503298,2025-03-03,Senate,"(S) 3rd Reading Passed",45,5,0,0,50
1972802,1518934,2025-03-17,House,"(H) Transportation--Be Concurred In",14,0,0,0,14
1972802,1530720,2025-03-29,House,"(H) 2nd Reading Concurred",99,1,0,0,100
1972802,1531207,2025-03-31,House,"(H) 3rd Reading Concurred",97,2,0,1,100
1972832,1502910,2025-03-01,Senate,"(S) Business, Labor  and Economic Affairs--Do Pass As Amended",12,0,0,0,12
1972832,1504437,2025-03-04,Senate,"(S) 2nd Reading Passed",47,3,0,0,50
1972832,1522819,2025-03-20,Senate,"(S) Finance and Claims--Do Pass",22,0,0,0,22
1972832,1524087,2025-03-21,Senate,"(S) 3rd Reading Passed",32,18,0,0,50
1972832,1552056,2025-04-18,House,"(H) Business and Labor--Be Concurred In",11,9,0,0,20
1972832,1556221,2025-04-23,House,"(H) 2nd Reading Not Concurred",43,55,0,2,100
1972864,1503159,2025-03-03,House,"(H) Business and Labor--To Table",12,8,0,0,20
1972864,1505606,2025-03-04,House,"(H) Taken from Committee; Placed on 2nd Reading",44,55,0,1,100
1972864,1541716,2025-03-04,House,"(H) Taken from Committee; Placed on 2nd Reading",44,55,0,1,100
1972895,1502806,2025-02-28,Senate,"(S) Local Government--Do Pass As Amended",11,0,0,0,11
1972895,1505119,2025-03-04,Senate,"(S) 2nd Reading Passed",36,14,0,0,50
1972895,1505888,2025-03-05,Senate,"(S) 3rd Reading Passed",36,14,0,0,50
1972895,1540614,2025-04-08,House,"(H) Local Government--To Table",11,6,0,0,17
1972895,1544365,2025-04-08,House,"(H) Local Government--To Table",11,6,0,0,17
1972895,1580145,2025-04-08,House,"(H) Local Government--To Table",11,6,0,0,17
1972927,1501434,2025-02-27,House,"(H) Taxation--Do Pass As Amended",21,0,0,0,21
1972927,1530233,2025-03-28,House,"(H) Appropriations--To Table",13,10,0,0,23
1973065,1500510,2025-02-26,Senate,"(S) Business, Labor  and Economic Affairs--Do Pass",12,0,0,0,12
1973065,1502927,2025-03-01,Senate,"(S) 2nd Reading Passed",50,0,0,0,50
1973065,1503774,2025-03-03,Senate,"(S) 3rd Reading Passed",50,0,0,0,50
1973065,1521337,2025-03-19,House,"(H) Business and Labor--Be Concurred In",20,0,0,0,20
1973065,1530666,2025-03-29,House,"(H) 2nd Reading Concurred",99,1,0,0,100
1973065,1531527,2025-03-31,House,"(H) 3rd Reading Concurred",98,1,0,1,100
1973093,1501820,2025-02-27,House,"(H) Taxation--To Table",18,3,0,0,21
1973093,1530584,2025-03-28,House,"(H) Taxation--Do Pass",17,4,0,0,21
1973093,1530585,2025-03-28,House,"(H) Taxation--To Take From The Table",11,5,0,5,21
1973093,1532253,2025-04-01,House,"(H) 2nd Reading Passed",79,21,0,0,100
1973093,1535778,2025-04-03,House,"(H) Appropriations--To Table",20,1,2,0,23
1973093,1536678,2025-04-03,House,"(H) Taken from Committee; Placed on 2nd Reading",34,58,0,8,100
1973093,1538427,2025-04-03,House,"(H) Taken from Committee; Placed on 2nd Reading",34,58,0,8,100
1973093,1543585,2025-04-03,House,"(H) Taken from Committee; Placed on 2nd Reading",34,58,0,8,100
1973093,1543586,2025-02-27,House,"(H) Taxation--To Table",18,3,0,0,21
1973093,1543587,2025-03-28,House,"(H) Taxation--To Take From The Table",11,5,5,0,21
1973093,1543588,2025-03-28,House,"(H) Taxation--Do Pass",17,4,0,0,21
1973093,1543589,2025-04-01,House,"(H) 2nd Reading Passed",79,21,0,0,100
1973093,1543590,2025-04-03,House,"(H) Appropriations--To Table",20,1,2,0,23
1973153,1501833,2025-02-27,House,"(H) Business and Labor--Do Pass As Amended",20,0,0,0,20
1973153,1505384,2025-03-04,House,"(H) 2nd Reading Passed",97,2,0,1,100
1973153,1505748,2025-03-05,House,"(H) 3rd Reading Passed",96,2,0,2,100
1973153,1521620,2025-03-19,Senate,"(S) Business, Labor  and Economic Affairs--Be Concurred In",11,0,0,1,12
1973153,1542498,2025-04-09,Senate,"(S) 2nd Reading Concurred",50,0,0,0,50
1973153,1544070,2025-04-10,Senate,"(S) 3rd Reading Concurred",48,0,0,2,50
1973184,1499478,2025-02-25,House,"(H) State Administration--Do Pass As Amended",18,1,0,0,19
1973184,1505806,2025-03-05,House,"(H) 2nd Reading Passed",91,7,0,2,100
1973184,1508811,2025-03-07,House,"(H) 3rd Reading Passed",91,8,0,1,100
1973184,1543451,2025-04-10,Senate,"(S) 2nd Reading Concurred",50,0,0,0,50
1973184,1546386,2025-04-11,Senate,"(S) 3rd Reading Concurred",48,0,0,2,50
1973184,1550320,2025-04-16,House,"(H) 2nd Reading Senate Amendments Concurred",100,0,0,0,100
1973184,1551742,2025-04-17,House,"(H) 3rd Reading Passed as Amended by Senate",99,0,0,1,100
1973217,1520873,2025-03-19,House,"(H) Judiciary--Do Pass As Amended",12,8,0,0,20
1973217,1524781,2025-03-24,House,"(H) 2nd Reading Motion to Amend Carried",72,27,0,1,100
1973217,1525381,2025-03-24,House,"(H) 2nd Reading Not Passed as Amended",49,50,0,1,100
1973217,1527022,2025-03-25,House,"(H) Motion to Reconsider Failed",43,51,0,6,100
1973244,1497659,2025-02-24,House,"(H) Judiciary--Do Pass",20,0,0,0,20
1973244,1503065,2025-03-01,House,"(H) 2nd Reading Motion to Amend Carried",100,0,0,0,100
1973244,1503066,2025-03-01,House,"(H) 2nd Reading Passed as Amended",100,0,0,0,100
1973244,1504670,2025-03-04,House,"(H) 3rd Reading Passed",99,0,0,1,100
1973244,1530077,2025-03-28,Senate,"(S) Judiciary--Be Concurred In",8,0,0,0,8
1973244,1546547,2025-04-12,Senate,"(S) 2nd Reading Concurred",50,0,0,0,50
1973244,1546888,2025-04-14,Senate,"(S) 3rd Reading Concurred",48,0,0,2,50
1973276,1501756,2025-02-27,House,"(H) Business and Labor--Do Pass As Amended",20,0,0,0,20
1973276,1505460,2025-03-04,House,"(H) 2nd Reading Passed",99,0,0,1,100
1973276,1507046,2025-03-06,House,"(H) 3rd Reading Passed",98,1,0,1,100
1973276,1529842,2025-03-28,Senate,"(S) Business, Labor  and Economic Affairs--Be Concurred In As Amended",12,0,0,0,12
1973276,1534543,2025-04-02,Senate,"(S) 2nd Reading Concurred",50,0,0,0,50
1973276,1537845,2025-04-05,Senate,"(S) 2nd Reading Concurred",50,0,0,0,50
1973276,1539127,2025-04-07,Senate,"(S) 3rd Reading Concurred",49,0,0,1,50
1973276,1549095,2025-04-15,House,"(H) 2nd Reading Senate Amendments Concurred",100,0,0,0,100
1973276,1550081,2025-04-16,House,"(H) 3rd Reading Passed as Amended by Senate",96,1,0,3,100
1973306,1499084,2025-02-25,House,"(H) Judiciary--Do Pass",18,2,0,0,20
1973306,1505371,2025-03-04,House,"(H) 2nd Reading Passed",60,39,0,1,100
1973306,1505667,2025-03-05,House,"(H) 3rd Reading Passed",62,36,0,2,100
1973306,1530091,2025-03-28,Senate,"(S) Judiciary--Be Concurred In",5,3,0,0,8
1973306,1547102,2025-04-14,Senate,"(S) 2nd Reading Concurred",33,16,0,1,50
1973306,1549180,2025-04-15,Senate,"(S) 3rd Reading Concurred",33,17,0,0,50
1973338,1498760,2025-02-25,House,"(H) Judiciary--Do Pass As Amended",12,8,0,0,20
1973338,1506698,2025-03-05,House,"(H) 2nd Reading Passed",57,42,0,1,100
1973338,1508459,2025-03-07,House,"(H) 3rd Reading Passed",59,40,0,1,100
1973338,1525165,2025-03-24,Senate,"(S) Judiciary--Be Concurred In",5,3,0,0,8
1973338,1532331,2025-03-24,Senate,"(S) Judiciary--Be Concurred In",5,3,0,0,8
1973338,1542657,2025-04-09,Senate,"(S) 2nd Reading Concurred",31,19,0,0,50
1973338,1544837,2025-04-10,Senate,"(S) 3rd Reading Concurred",29,19,0,2,50
1973366,1501921,2025-02-27,House,"(H) Taxation--Do Pass",14,7,0,0,21
1973366,1524340,2025-03-21,House,"(H) 2nd Reading Passed",90,9,0,1,100
1973366,1533785,2025-04-01,House,"(H) Appropriations--Do Pass As Amended",12,11,0,0,23
1973366,1537109,2025-04-04,House,"(H) 2nd Reading Passed",69,30,0,1,100
1973366,1537776,2025-04-05,House,"(H) 3rd Reading Passed",64,34,0,2,100
1973366,1550137,2025-04-16,Senate,"(S) Taxation--To Table",8,0,0,0,8
1973366,1551174,2025-04-17,Senate,"(S) Taken from Committee; Placed on 2nd Reading",26,24,0,0,50
1973366,1555446,2025-04-23,Senate,"(S) 2nd Reading Motion to Amend Failed",25,25,0,0,50
1973366,1555447,2025-04-23,Senate,"(S) 2nd Reading Indefinitely Postponed",36,14,0,0,50
1973366,1555448,2025-04-23,Senate,"(S) 2nd Reading Concur Motion Failed",16,34,0,0,50
1973366,1555449,2025-04-23,Senate,"(S) Motion Failed",16,33,0,1,50
1973366,1558056,2025-04-25,Senate,"(S) Motion Failed",19,30,0,1,50
1973396,1499483,2025-02-25,House,"(H) Local Government--Do Pass",17,0,0,0,17
1973396,1503755,2025-03-03,House,"(H) 2nd Reading Passed",98,1,0,1,100
1973396,1505348,2025-03-04,House,"(H) 3rd Reading Passed",95,4,0,1,100
1973396,1531751,2025-03-31,Senate,"(S) Local Government--Be Concurred In",8,3,0,0,11
1973396,1546629,2025-04-12,Senate,"(S) 2nd Reading Concurred",49,0,0,1,50
1973396,1546922,2025-04-14,Senate,"(S) 3rd Reading Concurred",47,1,0,2,50
1973458,1497581,2025-02-24,House,"(H) Business and Labor--Do Pass",20,0,0,0,20
1973458,1503733,2025-03-03,House,"(H) 2nd Reading Passed",85,14,0,1,100
1973458,1505136,2025-03-04,House,"(H) 3rd Reading Passed",88,11,0,1,100
1973458,1527047,2025-03-25,Senate,"(S) Business, Labor  and Economic Affairs--Be Concurred In",12,0,0,0,12
1973458,1543186,2025-04-09,Senate,"(S) 2nd Reading Concurred",48,0,0,2,50
1973458,1544630,2025-04-10,Senate,"(S) 3rd Reading Concurred",48,0,0,2,50
1973483,1502903,2025-02-28,Senate,"(S) Public Health, Welfare and Safety--Do Pass",7,4,0,0,11
1973483,1505663,2025-03-05,Senate,"(S) 2nd Reading Passed",31,19,0,0,50
1973483,1508071,2025-03-06,Senate,"(S) 3rd Reading Passed",27,23,0,0,50
1973483,1542434,2025-04-09,House,"(H) Human Services--To Table",14,1,6,0,21
1973483,1543689,2025-04-09,House,"(H) Human Services--To Table",14,1,6,0,21
1973483,1572946,2025-04-09,House,"(H) Human Services--To Table",14,1,6,0,21
1973483,1580122,2025-04-09,House,"(H) Human Services--To Table",14,1,6,0,21
1973505,1501893,2025-02-27,Senate,"(S) Energy, Technology & Federal Relations--Do Pass",13,0,0,0,13
1973505,1503375,2025-03-03,Senate,"(S) 2nd Reading Passed",50,0,0,0,50
1973505,1505146,2025-03-04,Senate,"(S) 3rd Reading Passed",50,0,0,0,50
1973505,1530399,2025-03-28,House,"(H) Energy, Technology and Federal Relations--Be Concurred In",13,1,0,0,14
1973505,1543629,2025-04-10,House,"(H) 2nd Reading Concurred",99,1,0,0,100
1973505,1546427,2025-04-11,House,"(H) 3rd Reading Concurred",98,1,0,1,100
1973533,1496986,2025-02-21,House,"(H) Energy, Technology and Federal Relations--Do Pass",14,0,0,0,14
1973533,1502982,2025-03-01,House,"(H) 2nd Reading Passed",99,1,0,0,100
1973533,1503272,2025-03-03,House,"(H) 3rd Reading Passed",97,0,0,3,100
1973533,1531709,2025-03-31,Senate,"(S) State Administration--Be Concurred In",9,0,0,0,9
1973533,1546903,2025-04-14,Senate,"(S) 2nd Reading Concurred",49,0,0,1,50
1973533,1548422,2025-04-15,Senate,"(S) 3rd Reading Concurred",50,0,0,0,50
1973560,1500299,2025-02-26,Senate,"(S) Business, Labor  and Economic Affairs--Do Pass",8,4,0,0,12
1973560,1502929,2025-03-01,Senate,"(S) 2nd Reading Passed",48,2,0,0,50
1973560,1503271,2025-03-03,Senate,"(S) 3rd Reading Passed",49,1,0,0,50
1973560,1529938,2025-03-28,House,"(H) Business and Labor--To Table",16,0,0,4,20
1973560,1537227,2025-03-28,House,"(H) Business and Labor--To Table",16,0,4,0,20
1973585,1499451,2025-02-25,House,"(H) Judiciary--Do Pass",17,3,0,0,20
1973585,1503574,2025-03-03,House,"(H) 2nd Reading Passed",98,1,0,1,100
1973585,1504366,2025-03-04,House,"(H) 3rd Reading Passed",98,1,0,1,100
1973585,1544596,2025-04-10,Senate,"(S) Judiciary--Be Concurred In As Amended",8,0,0,0,8
1973585,1546228,2025-04-11,Senate,"(S) 2nd Reading Concurred",49,1,0,0,50
1973585,1546703,2025-04-12,Senate,"(S) 3rd Reading Concurred",50,0,0,0,50
1973585,1552233,2025-04-18,House,"(H) 2nd Reading Senate Amendments Concurred",97,1,0,2,100
1973585,1553312,2025-04-22,House,"(H) 3rd Reading Passed as Amended by Senate",97,1,0,2,100
1973609,1500305,2025-02-26,House,"(H) Judiciary--Do Pass As Amended",12,8,0,0,20
1973609,1503758,2025-03-03,House,"(H) 2nd Reading Not Passed",33,66,0,1,100
1973635,1503793,2025-03-03,House,"(H) Business and Labor--Do Pass",20,0,0,0,20
1973635,1506138,2025-03-05,House,"(H) 2nd Reading Passed",89,8,0,3,100
1973635,1508535,2025-03-07,House,"(H) 3rd Reading Passed",93,6,0,1,100
1973635,1534886,2025-04-02,Senate,"(S) Public Health, Welfare and Safety--To Table",11,0,0,0,11
1973635,1537198,2025-04-02,Senate,"(S) Public Health, Welfare and Safety--To Table",11,0,0,0,11
1973635,1549237,2025-04-15,Senate,"(S) Taken from Committee; Placed on 2nd Reading",28,22,0,0,50
1973635,1550143,2025-04-16,Senate,"(S) 2nd Reading Concurred",31,19,0,0,50
1973635,1551129,2025-04-17,Senate,"(S) 3rd Reading Concurred",31,19,0,0,50
1973657,1502136,2025-02-27,Senate,"(S) Education and Cultural Resources--Do Pass",10,4,0,0,14
1973657,1506731,2025-03-05,Senate,"(S) 2nd Reading Motion to Amend Carried",49,0,0,1,50
1973657,1506732,2025-03-05,Senate,"(S) 2nd Reading Passed as Amended",47,3,0,0,50
1973657,1508145,2025-03-06,Senate,"(S) 3rd Reading Passed",45,4,0,1,50
1973657,1531759,2025-03-31,House,"(H) Education--Be Concurred In As Amended",14,1,0,0,15
1973657,1544363,2025-04-10,House,"(H) 2nd Reading Concurred",81,19,0,0,100
1973657,1546125,2025-04-11,House,"(H) 3rd Reading Concurred",81,18,0,1,100
1973657,1549940,2025-04-16,Senate,"(S) 2nd Reading House Amendments Concurred",47,3,0,0,50
1973657,1551954,2025-04-17,Senate,"(S) 3rd Reading Passed as Amended by House",48,2,0,0,50
1973688,1500854,2025-02-26,House,"(H) Judiciary--Do Pass As Amended",12,8,0,0,20
1973688,1502972,2025-03-01,House,"(H) 2nd Reading Passed",65,35,0,0,100
1973688,1503542,2025-03-03,House,"(H) 3rd Reading Passed",61,37,0,2,100
1973688,1530216,2025-03-28,Senate,"(S) Judiciary--Be Concurred In",2,6,0,0,8
1973688,1530217,2025-03-28,Senate,"(S) Judiciary--To Table",8,0,0,0,8
1973688,1537245,2025-03-28,Senate,"(S) Judiciary--To Table",8,0,0,0,8
1973712,1534123,2025-04-02,Senate,"(S) Taxation--To Table",8,0,0,0,8
1973737,1502897,2025-02-28,Senate,"(S) Public Health, Welfare and Safety--To Table",11,0,0,0,11
1973759,1500676,2025-02-26,House,"(H) State Administration--Do Pass As Amended",11,8,0,0,19
1973759,1506088,2025-03-05,House,"(H) 2nd Reading Passed",85,12,0,3,100
1973759,1508785,2025-03-07,House,"(H) 3rd Reading Passed",93,6,0,1,100
1973759,1543238,2025-04-09,Senate,"(S) Legislative Administration--Be Concurred In",6,0,0,0,6
1973759,1547679,2025-04-14,Senate,"(S) 2nd Reading Concurred",49,0,0,1,50
1973759,1548975,2025-04-15,Senate,"(S) 3rd Reading Concurred",50,0,0,0,50
1973787,1501308,2025-02-27,House,"(H) Legislative Administration--Do Pass",13,1,0,0,14
1973787,1504113,2025-03-03,House,"(H) 2nd Reading Passed",99,0,0,1,100
1973787,1504469,2025-03-04,House,"(H) 3rd Reading Passed",99,0,0,1,100
1973787,1542537,2025-04-09,Senate,"(S) Legislative Administration--Be Concurred In",5,1,0,0,6
1973787,1551913,2025-04-17,Senate,"(S) 2nd Reading Concur Motion Failed",4,46,0,0,50
1973787,1551914,2025-04-17,Senate,"(S) 2nd Reading Indefinitely Postponed",47,3,0,0,50
1973812,1503504,2025-03-03,Senate,"(S) Judiciary--Do Pass",5,3,0,0,8
1973812,1506141,2025-03-05,Senate,"(S) 2nd Reading Pass Motion Failed",24,26,0,0,50
1973812,1506142,2025-03-05,Senate,"(S) 2nd Reading Indefinitely Postponed",26,24,0,0,50
1973833,1501121,2025-02-27,Senate,"(S) Judiciary--Do Pass",6,2,0,0,8
1973833,1502993,2025-03-01,Senate,"(S) 2nd Reading Passed",39,11,0,0,50
1973833,1503769,2025-03-03,Senate,"(S) 3rd Reading Passed",47,3,0,0,50
1973833,1536893,2025-04-03,House,"(H) Judiciary--Be Concurred In As Amended",12,8,0,0,20
1973833,1543015,2025-04-09,House,"(H) 2nd Reading Concurred",57,43,0,0,100
1973833,1543016,2025-04-09,House,"(H) Appropriations--Be Concurred In",13,10,0,0,23
1973833,1546122,2025-04-11,House,"(H) 3rd Reading Concurred",58,40,0,2,100
1973833,1550727,2025-04-16,Senate,"(S) 2nd Reading House Amendments Concurred",36,14,0,0,50
1973833,1551159,2025-04-17,Senate,"(S) 3rd Reading Passed as Amended by House",33,17,0,0,50
1973857,1500866,2025-02-26,House,"(H) Judiciary--To Table",20,0,0,0,20
1973878,1502728,2025-02-28,Senate,"(S) Natural Resources--To Table",10,1,0,0,11
1973898,1527946,2025-03-25,Senate,"(S) Energy, Technology & Federal Relations--Resolution Adopted As Amended",13,0,0,0,13
1973898,1534116,2025-04-02,Senate,"(S) 2nd Reading Passed",47,2,0,1,50
1973898,1536692,2025-04-03,Senate,"(S) 3rd Reading Passed",44,6,0,0,50
1973898,1547713,2025-04-14,House,"(H) Transportation--Be Concurred In",14,0,0,0,14
1973898,1555642,2025-04-23,House,"(H) 2nd Reading Concurred",94,6,0,0,100
1973898,1556794,2025-04-24,House,"(H) 3rd Reading Concurred",93,7,0,0,100
1973904,1533694,2025-04-01,Senate,"(S) Energy, Technology & Federal Relations--To Table",9,4,0,0,13
1973910,1528420,2025-03-26,House,"(H) Education--Do Pass",12,3,0,0,15
1973910,1530645,2025-03-29,House,"(H) 2nd Reading Passed",69,31,0,0,100
1973910,1531088,2025-03-31,House,"(H) Appropriations--Do Pass As Amended",16,7,0,0,23
1973910,1537094,2025-04-04,House,"(H) 2nd Reading Passed",69,31,0,0,100
1973910,1537632,2025-04-05,House,"(H) 3rd Reading Passed",68,30,0,2,100
1973910,1549169,2025-04-15,Senate,"(S) Education and Cultural Resources--To Table",14,0,0,0,14
1973910,1549919,2025-04-16,Senate,"(S) Motion Failed",25,25,0,0,50
1973910,1549920,2025-04-15,Senate,"(S) Education and Cultural Resources--To Table",14,0,0,0,14
1973910,1551173,2025-04-17,Senate,"(S) Taken from Committee; Placed on 2nd Reading",27,23,0,0,50
1973910,1552180,2025-04-18,Senate,"(S) 2nd Reading Concurred",27,23,0,0,50
1973910,1554663,2025-04-22,Senate,"(S) 3rd Reading Concurred",28,22,0,0,50
1973921,1501803,2025-02-27,House,"(H) Fish, Wildlife and Parks--Do Pass",12,8,0,0,20
1973921,1504996,2025-03-04,House,"(H) 2nd Reading Passed",53,44,0,3,100
1973921,1507155,2025-03-06,House,"(H) 3rd Reading Passed",57,42,0,1,100
1973921,1540278,2025-04-08,Senate,"(S) Fish and Game--Be Concurred In",7,4,0,0,11
1973921,1546977,2025-04-14,Senate,"(S) 2nd Reading Concurred",34,15,0,1,50
1973921,1548525,2025-04-15,Senate,"(S) 3rd Reading Concurred",29,21,0,0,50
1973927,1499361,2025-02-25,House,"(H) State Administration--Do Pass As Amended",18,1,0,0,19
1973927,1506084,2025-03-05,House,"(H) 2nd Reading Passed",88,11,0,1,100
1973927,1508532,2025-03-07,House,"(H) 3rd Reading Passed",89,10,0,1,100
1973927,1546476,2025-04-11,Senate,"(S) State Administration--Be Concurred In",5,4,0,0,9
1973927,1546896,2025-04-14,Senate,"(S) 2nd Reading Concurred",29,20,0,1,50
1973927,1548387,2025-04-15,Senate,"(S) 3rd Reading Concurred",29,21,0,0,50
1973940,1500146,2025-02-26,House,"(H) Judiciary--To Table",12,8,0,0,20
1973947,1502870,2025-02-28,House,"(H) Transportation--To Table",14,0,0,0,14
1973958,1499491,2025-02-25,House,"(H) Fish, Wildlife and Parks--Do Pass",19,1,0,0,20
1973958,1519568,2025-03-18,House,"(H) 2nd Reading Passed",79,20,0,1,100
1973958,1521791,2025-03-19,House,"(H) 3rd Reading Passed",75,23,0,2,100
1973958,1526643,2025-03-25,Senate,"(S) Finance and Claims--To Table",14,8,0,0,22
1973958,1529943,2025-03-25,Senate,"(S) Finance and Claims--To Table",14,8,0,0,22
1973977,1503012,2025-03-01,House,"(H) State Administration--Do Pass As Amended",11,8,0,0,19
1973977,1505102,2025-03-04,House,"(H) 2nd Reading Passed",56,43,0,1,100
1973977,1507244,2025-03-06,House,"(H) 3rd Reading Passed",56,43,0,1,100
1973977,1549278,2025-04-15,Senate,"(S) Education and Cultural Resources--Be Concurred In",9,5,0,0,14
1973977,1551912,2025-04-17,Senate,"(S) 2nd Reading Concurred",26,24,0,0,50
1973977,1552271,2025-04-18,Senate,"(S) 3rd Reading Failed",24,26,0,0,50
1973987,1530243,2025-03-28,Senate,"(S) Natural Resources--Do Pass As Amended",9,2,0,0,11
1973987,1534487,2025-04-02,Senate,"(S) 2nd Reading Pass Motion Failed",14,36,0,0,50
1973994,1502825,2025-02-28,Senate,"(S) Natural Resources--Do Pass As Amended",11,0,0,0,11
1973994,1506235,2025-03-05,Senate,"(S) 2nd Reading Passed",50,0,0,0,50
1973994,1507645,2025-03-06,Senate,"(S) 3rd Reading Passed",50,0,0,0,50
1973994,1524279,2025-03-21,House,"(H) Natural Resources--Be Concurred In",14,0,0,0,14
1973994,1530699,2025-03-29,House,"(H) 2nd Reading Concurred",99,0,0,1,100
1973994,1531418,2025-03-31,House,"(H) 3rd Reading Concurred",99,0,0,1,100
1974001,1502463,2025-02-28,House,"(H) Business and Labor--Do Pass",20,0,0,0,20
1974001,1505397,2025-03-04,House,"(H) 2nd Reading Passed",99,0,0,1,100
1974001,1507062,2025-03-06,House,"(H) 3rd Reading Passed",97,2,0,1,100
1974001,1535281,2025-04-02,Senate,"(S) Public Health, Welfare and Safety--To Table",11,0,0,0,11
1974001,1537240,2025-04-02,Senate,"(S) Public Health, Welfare and Safety--To Table",11,0,0,0,11
1974016,1502449,2025-02-28,House,"(H) Business and Labor--Do Pass",20,0,0,0,20
1974016,1505706,2025-03-05,House,"(H) 2nd Reading Passed",92,6,0,2,100
1974016,1508446,2025-03-07,House,"(H) 3rd Reading Passed",90,9,0,1,100
1974016,1527701,2025-03-26,Senate,"(S) Business, Labor  and Economic Affairs--Be Concurred In",10,2,0,0,12
1974016,1544822,2025-04-10,Senate,"(S) 2nd Reading Concurred",46,4,0,0,50
1974016,1546313,2025-04-11,Senate,"(S) 3rd Reading Concurred",46,2,0,2,50
1974026,1502837,2025-02-28,House,"(H) Education--Do Pass As Amended",15,0,0,0,15
1974026,1506350,2025-03-05,House,"(H) 2nd Reading Passed",98,0,0,2,100
1974026,1508754,2025-03-07,House,"(H) 3rd Reading Passed",98,0,0,2,100
1974026,1540636,2025-04-08,Senate,"(S) Education and Cultural Resources--Be Concurred In",11,3,0,0,14
1974026,1547793,2025-04-14,Senate,"(S) 2nd Reading Concurred",45,4,0,1,50
1974026,1549231,2025-04-15,Senate,"(S) 3rd Reading Concurred",48,2,0,0,50
1974033,1502939,2025-03-01,House,"(H) Business and Labor--To Table",20,0,0,0,20
1974042,1504416,2025-03-04,House,"(H) Energy, Technology and Federal Relations--Do Pass",8,6,0,0,14
1974042,1521114,2025-03-19,House,"(H) 2nd Reading Motion to Amend Carried",58,42,0,0,100
1974042,1521115,2025-03-19,House,"(H) 2nd Reading Passed as Amended",58,42,0,0,100
1974042,1524194,2025-03-21,House,"(H) 3rd Reading Passed",58,38,0,4,100
1974042,1549034,2025-04-15,Senate,"(S) Energy, Technology & Federal Relations--Resolution Adopted As Amended",8,5,0,0,13
1974042,1551782,2025-04-17,Senate,"(S) 2nd Reading Concurred",31,18,0,1,50
1974042,1552222,2025-04-18,Senate,"(S) 3rd Reading Concurred",35,15,0,0,50
1974042,1556997,2025-04-24,House,"(H) 2nd Reading Senate Amendments Concurred",90,10,0,0,100
1974042,1558032,2025-04-25,House,"(H) 3rd Reading Passed as Amended by Senate",63,37,0,0,100
1974055,1499409,2025-02-25,House,"(H) Local Government--Do Pass",17,0,0,0,17
1974055,1503815,2025-03-03,House,"(H) 2nd Reading Passed",95,4,0,1,100
1974055,1504611,2025-03-04,House,"(H) 3rd Reading Passed",97,2,0,1,100
1974055,1531804,2025-03-31,Senate,"(S) Local Government--Be Concurred In",11,0,0,0,11
1974055,1544808,2025-04-10,Senate,"(S) 2nd Reading Concurred",49,1,0,0,50
1974055,1546314,2025-04-11,Senate,"(S) 3rd Reading Concurred",48,0,0,2,50
1974062,1502274,2025-02-27,House,"(H) Local Government--Do Pass As Amended",11,6,0,0,17
1974062,1505029,2025-03-04,House,"(H) 2nd Reading Passed",75,24,0,1,100
1974062,1505801,2025-03-05,House,"(H) 3rd Reading Passed",72,26,0,2,100
1974062,1538848,2025-04-07,Senate,"(S) Local Government--Be Concurred In As Amended",6,4,0,0,10
1974062,1542533,2025-04-09,Senate,"(S) 2nd Reading Concurred",32,18,0,0,50
1974062,1543983,2025-04-10,Senate,"(S) 3rd Reading Concurred",32,16,0,2,50
1974062,1548477,2025-04-15,House,"(H) 2nd Reading Senate Amendments Concurred",75,25,0,0,100
1974062,1550198,2025-04-16,House,"(H) 3rd Reading Passed as Amended by Senate",62,36,0,2,100
1974071,1500663,2025-02-26,House,"(H) Judiciary--To Table",20,0,0,0,20
1974083,1503289,2025-03-03,Senate,"(S) Judiciary--To Table",6,2,0,0,8
1974092,1501824,2025-02-27,House,"(H) Business and Labor--Do Pass",20,0,0,0,20
1974092,1506875,2025-03-05,House,"(H) 2nd Reading Passed",99,0,0,1,100
1974092,1508741,2025-03-07,House,"(H) 3rd Reading Passed",99,0,0,1,100
1974092,1529879,2025-03-28,Senate,"(S) Business, Labor  and Economic Affairs--Be Concurred In",12,0,0,0,12
1974092,1544625,2025-04-10,Senate,"(S) 2nd Reading Concurred",50,0,0,0,50
1974092,1546252,2025-04-11,Senate,"(S) 3rd Reading Concurred",48,0,0,2,50
1974101,1500665,2025-02-26,Senate,"(S) Highways and Transportation--Do Pass As Amended",8,0,0,0,8
1974101,1502947,2025-03-01,Senate,"(S) 2nd Reading Passed",33,17,0,0,50
1974101,1503476,2025-03-03,Senate,"(S) 3rd Reading Passed",34,16,0,0,50
1974101,1539405,2025-04-08,House,"(H) Judiciary--To Table",18,2,0,0,20
1974101,1544461,2025-04-10,House,"(H) Taken from Committee; Placed on 2nd Reading",54,45,0,1,100
1974101,1544462,2025-04-08,House,"(H) Judiciary--To Table",18,2,0,0,20
1974101,1551746,2025-04-17,House,"(H) Taken from Committee; Placed on 2nd Reading",51,47,0,2,100
1974101,1580659,2025-04-08,House,"(H) Judiciary--To Table",18,2,0,0,20
1974107,1502213,2025-02-28,House,"(H) Business and Labor--Do Pass As Amended",15,5,0,0,20
1974107,1503568,2025-03-03,House,"(H) 2nd Reading Passed",56,43,0,1,100
1974107,1503569,2025-03-03,House,"(H) Appropriations--To Table",13,10,0,0,23
1974107,1503978,2025-03-03,House,"(H) Motion Failed",51,47,0,2,100
1974677,1501731,2025-02-27,House,"(H) Fish, Wildlife and Parks--Do Pass As Amended",18,2,0,0,20
1974677,1505048,2025-03-04,House,"(H) 2nd Reading Passed",97,2,0,1,100
1974677,1506027,2025-03-05,House,"(H) 3rd Reading Passed",97,1,0,2,100
1974677,1533016,2025-04-01,Senate,"(S) Fish and Game--Be Concurred In As Amended",10,1,1,0,12
1974677,1537837,2025-04-05,Senate,"(S) 2nd Reading Concurred",49,1,0,0,50
1974677,1538612,2025-04-07,Senate,"(S) 3rd Reading Concurred",48,1,0,1,50
1974677,1549348,2025-04-15,House,"(H) 2nd Reading Senate Amendments Concurred",99,1,0,0,100
1974677,1550777,2025-04-16,House,"(H) 3rd Reading Passed as Amended by Senate",97,1,0,2,100
1974714,1502643,2025-02-28,House,"(H) Education--Do Pass",15,0,0,0,15
1974714,1505009,2025-03-04,House,"(H) 2nd Reading Passed",87,11,0,2,100
1974714,1505010,2025-03-04,House,"(H) Appropriations--Do Pass",22,0,0,1,23
1974714,1507170,2025-03-06,House,"(H) 3rd Reading Passed",88,11,0,1,100
1974714,1534101,2025-04-01,Senate,"(S) Education and Cultural Resources--Be Concurred In As Amended",10,4,0,0,14
1974714,1537725,2025-04-05,Senate,"(S) 2nd Reading Concurred",43,7,0,0,50
1974714,1541446,2025-04-09,Senate,"(S) Finance and Claims--Be Concurred In",18,4,0,0,22
1974714,1543931,2025-04-10,Senate,"(S) 3rd Reading Concurred",42,6,0,2,50
1974714,1548513,2025-04-15,House,"(H) 2nd Reading Senate Amendments Concurred",100,0,0,0,100
1974714,1550222,2025-04-16,House,"(H) 3rd Reading Passed as Amended by Senate",95,2,0,3,100
1974749,1500987,2025-02-26,House,"(H) Transportation--Do Pass",9,5,0,0,14
1974749,1505490,2025-03-04,House,"(H) 2nd Reading Passed",56,43,0,1,100
1974749,1507137,2025-03-06,House,"(H) 3rd Reading Passed",60,39,0,1,100
1974749,1533210,2025-04-01,Senate,"(S) Energy, Technology & Federal Relations--Be Concurred In As Amended",7,6,0,0,13
1974749,1538174,2025-04-07,Senate,"(S) 2nd Reading Concurred",31,18,0,1,50
1974749,1541164,2025-04-08,Senate,"(S) 3rd Reading Concurred",30,18,0,2,50
1974749,1548374,2025-04-15,House,"(H) 2nd Reading Senate Amendments Concurred",97,3,0,0,100
1974749,1550784,2025-04-16,House,"(H) 3rd Reading Passed as Amended by Senate",66,32,0,2,100
1974788,1502444,2025-02-28,House,"(H) Appropriations--Do Pass As Amended",18,0,0,5,23
1974788,1505047,2025-03-04,House,"(H) 2nd Reading Passed",98,1,0,1,100
1974788,1507201,2025-03-06,House,"(H) 3rd Reading Passed",98,1,0,1,100
1974788,1522416,2025-03-20,Senate,"(S) Finance and Claims--Be Concurred In",21,1,0,0,22
1974788,1547164,2025-04-14,Senate,"(S) 2nd Reading Concurred",46,4,0,0,50
1974788,1548783,2025-04-15,Senate,"(S) 3rd Reading Concurred",42,8,0,0,50
1974827,1502793,2025-02-28,Senate,"(S) Local Government--Do Pass",11,0,0,0,11
1974827,1506182,2025-03-05,Senate,"(S) 2nd Reading Passed",40,10,0,0,50
1974827,1507599,2025-03-06,Senate,"(S) 3rd Reading Passed",44,6,0,0,50
1974827,1541016,2025-04-08,House,"(H) Local Government--To Table",12,5,0,0,17
1974827,1543877,2025-04-08,House,"(H) Local Government--To Table",12,5,0,0,17
1974827,1580208,2025-04-08,House,"(H) Local Government--To Table",12,5,0,0,17
1974864,1499162,2025-02-25,House,"(H) Human Services--Do Pass",12,9,0,0,21
1974864,1505498,2025-03-04,House,"(H) 2nd Reading Not Passed",47,52,0,1,100
1974864,1506952,2025-03-05,House,"(H) Reconsidered Previous Action; Placed on 2nd Reading",42,55,0,3,100
1974903,1502292,2025-02-28,House,"(H) State Administration--Do Pass",19,0,0,0,19
1974903,1506091,2025-03-05,House,"(H) 2nd Reading Passed",99,0,0,1,100
1974903,1508817,2025-03-07,House,"(H) 3rd Reading Passed",99,0,0,1,100
1974903,1547973,2025-04-14,Senate,"(S) State Administration--Be Concurred In",9,0,0,0,9
1974903,1549799,2025-04-16,Senate,"(S) 2nd Reading Concurred",49,0,0,1,50
1974903,1551336,2025-04-17,Senate,"(S) 3rd Reading Concurred",50,0,0,0,50
1974942,1505071,2025-03-04,Senate,"(S) Business, Labor  and Economic Affairs--Do Pass",12,0,0,0,12
1974942,1505960,2025-03-05,Senate,"(S) 2nd Reading Passed",48,0,0,2,50
1974942,1507927,2025-03-06,Senate,"(S) 3rd Reading Passed",50,0,0,0,50
1974942,1525998,2025-03-25,House,"(H) Business and Labor--Be Concurred In",20,0,0,0,20
1974942,1530974,2025-03-31,House,"(H) 2nd Reading Concurred",99,0,0,1,100
1974942,1532738,2025-04-01,House,"(H) 3rd Reading Concurred",99,0,0,1,100
1974977,1502891,2025-02-28,House,"(H) Education--Do Pass",15,0,0,0,15
1974977,1506848,2025-03-05,House,"(H) 2nd Reading Passed",96,3,0,1,100
1974977,1508771,2025-03-07,House,"(H) 3rd Reading Passed",92,7,0,1,100
1974977,1529731,2025-03-27,Senate,"(S) Education and Cultural Resources--Be Concurred In",12,2,0,0,14
1974977,1547529,2025-04-14,Senate,"(S) 2nd Reading Concurred",33,16,0,1,50
1974977,1548715,2025-04-15,Senate,"(S) 3rd Reading Concurred",30,20,0,0,50
1975015,1502724,2025-02-27,Senate,"(S) Energy, Technology & Federal Relations--Do Pass As Amended",13,0,0,0,13
1975015,1506292,2025-03-05,Senate,"(S) 2nd Reading Passed as Amended",50,0,0,0,50
1975015,1506293,2025-03-05,Senate,"(S) 2nd Reading Motion to Amend Carried",49,1,0,0,50
1975015,1508163,2025-03-06,Senate,"(S) 3rd Reading Passed",49,0,0,1,50
1975015,1530235,2025-03-28,House,"(H) Energy, Technology and Federal Relations--Be Concurred In As Amended",14,0,0,0,14
1975015,1542489,2025-04-09,House,"(H) 2nd Reading Motion to Amend Carried",98,2,0,0,100
1975015,1542490,2025-04-09,House,"(H) 2nd Reading Concurred as Amended",99,1,0,0,100
1975015,1543274,2025-04-09,House,"(H) 2nd Reading Concurred as Amended",99,1,0,0,100
1975015,1543275,2025-04-09,House,"(H) 2nd Reading Motion to Amend Carried",98,2,0,0,100
1975015,1546183,2025-04-11,House,"(H) 3rd Reading Concurred",99,0,0,1,100
1975015,1547106,2025-04-14,Senate,"(S) 2nd Reading House Amendments Concurred",49,0,0,1,50
1975015,1548640,2025-04-15,Senate,"(S) 3rd Reading Passed as Amended by House",50,0,0,0,50
1975052,1502738,2025-02-28,Senate,"(S) State Administration--Do Pass",9,0,0,0,9
1975052,1505759,2025-03-05,Senate,"(S) 2nd Reading Passed",50,0,0,0,50
1975052,1507539,2025-03-06,Senate,"(S) 3rd Reading Passed",50,0,0,0,50
1975052,1530392,2025-03-28,House,"(H) State Administration--Be Concurred In",19,0,0,0,19
1975052,1545172,2025-04-10,House,"(H) 2nd Reading Concurred",100,0,0,0,100
1975052,1546195,2025-04-11,House,"(H) 3rd Reading Concurred",99,0,0,1,100
1975129,1500693,2025-02-26,House,"(H) Judiciary--Do Pass As Amended",14,6,0,0,20
1975129,1502419,2025-02-28,House,"(H) 2nd Reading Passed",71,28,0,1,100
1975129,1502969,2025-03-01,House,"(H) 3rd Reading Passed",61,36,0,3,100
1975129,1543711,2025-04-10,Senate,"(S) Judiciary--To Table",8,0,0,0,8
1975129,1543712,2025-04-10,Senate,"(S) Motion Failed",23,24,0,3,50
1975129,1546308,2025-04-11,Senate,"(S) Judiciary--To Take From The Table",5,3,0,0,8
1975129,1548060,2025-04-14,Senate,"(S) 2nd Reading Indefinitely Postponed",33,17,0,0,50
1975129,1548061,2025-04-11,Senate,"(S) Judiciary--Be Concurred In",7,1,0,0,8
1975129,1548062,2025-04-14,Senate,"(S) 2nd Reading Pass Motion Failed",24,26,0,0,50
1975166,1502737,2025-02-28,Senate,"(S) Local Government--Do Pass",11,0,0,0,11
1975166,1505727,2025-03-05,Senate,"(S) 2nd Reading Passed",47,3,0,0,50
1975166,1507181,2025-03-06,Senate,"(S) 3rd Reading Passed",43,7,0,0,50
1975166,1540704,2025-04-08,House,"(H) Local Government--Be Concurred In",17,0,0,0,17
1975166,1544275,2025-04-10,House,"(H) 2nd Reading Concurred",95,5,0,0,100
1975166,1546136,2025-04-11,House,"(H) 3rd Reading Concurred",99,0,0,1,100
1975203,1501793,2025-02-27,House,"(H) Fish, Wildlife and Parks--To Table",11,9,0,0,20
1975238,1502095,2025-02-27,House,"(H) Human Services--Do Pass",21,0,0,0,21
1975238,1503736,2025-03-03,House,"(H) 2nd Reading Passed",99,0,0,1,100
1975238,1505083,2025-03-04,House,"(H) Appropriations--Do Pass",21,0,0,2,23
1975238,1505724,2025-03-05,House,"(H) 3rd Reading Passed",98,0,0,2,100
1975238,1530599,2025-03-28,Senate,"(S) Public Health, Welfare and Safety--Be Concurred In",11,0,0,0,11
1975238,1546264,2025-04-11,Senate,"(S) 2nd Reading Concurred",44,6,0,0,50
1975238,1548923,2025-04-12,Senate,"(S) 3rd Reading Concurred",48,2,0,0,50
1975249,1502493,2025-02-28,House,"(H) Human Services--Do Pass As Amended",21,0,0,0,21
1975249,1504122,2025-03-03,House,"(H) 2nd Reading Passed",98,0,0,2,100
1975249,1504682,2025-03-04,House,"(H) 3rd Reading Passed",99,0,0,1,100
1975249,1530444,2025-03-28,Senate,"(S) Public Health, Welfare and Safety--Be Concurred In",10,1,0,0,11
1975249,1546537,2025-04-12,Senate,"(S) 2nd Reading Concurred",48,2,0,0,50
1975249,1547369,2025-04-14,Senate,"(S) 3rd Reading Concurred",47,1,0,2,50
1975265,1502744,2025-02-28,Senate,"(S) Public Health, Welfare and Safety--To Table",11,0,0,0,11
1975284,1502145,2025-02-27,Senate,"(S) Education and Cultural Resources--Do Pass",10,4,0,0,14
1975284,1506097,2025-03-05,Senate,"(S) 2nd Reading Passed",46,4,0,0,50
1975284,1507718,2025-03-06,Senate,"(S) 3rd Reading Passed",46,4,0,0,50
1975284,1531762,2025-03-31,House,"(H) Education--Be Concurred In As Amended",15,0,0,0,15
1975284,1543168,2025-04-09,House,"(H) 2nd Reading Concurred",98,2,0,0,100
1975284,1543310,2025-04-10,House,"(H) 3rd Reading Concurred",98,0,0,2,100
1975284,1546206,2025-04-11,Senate,"(S) 2nd Reading House Amendments Concurred",50,0,0,0,50
1975284,1546698,2025-04-12,Senate,"(S) 3rd Reading Passed as Amended by House",50,0,0,0,50
1975311,1502898,2025-02-28,Senate,"(S) Natural Resources--Do Pass As Amended",11,0,0,0,11
1975311,1505720,2025-03-05,Senate,"(S) 2nd Reading Passed",48,2,0,0,50
1975311,1507608,2025-03-06,Senate,"(S) 3rd Reading Passed",47,3,0,0,50
1975311,1524243,2025-03-21,House,"(H) Natural Resources--Be Concurred In",14,0,0,0,14
1975311,1530684,2025-03-29,House,"(H) 2nd Reading Concurred",100,0,0,0,100
1975311,1531324,2025-03-31,House,"(H) 3rd Reading Concurred",99,0,0,1,100
1975331,1504692,2025-02-28,Senate,"(S) Natural Resources--Do Pass As Amended",11,0,0,0,11
1975331,1505862,2025-03-05,Senate,"(S) 2nd Reading Passed",47,3,0,0,50
1975331,1507652,2025-03-06,Senate,"(S) 3rd Reading Passed",47,3,0,0,50
1975331,1524314,2025-03-21,House,"(H) Natural Resources--Be Concurred In",14,0,0,0,14
1975331,1530646,2025-03-29,House,"(H) 2nd Reading Concurred",100,0,0,0,100
1975331,1531652,2025-03-31,House,"(H) 3rd Reading Concurred",99,0,0,1,100
1975356,1532510,2025-04-01,House,"(H) Business and Labor--Do Pass As Amended",20,0,0,0,20
1975356,1536642,2025-04-03,House,"(H) 2nd Reading Passed",100,0,0,0,100
1975356,1537708,2025-04-05,House,"(H) 3rd Reading Passed",97,0,0,3,100
1975356,1550015,2025-04-16,Senate,"(S) Business, Labor  and Economic Affairs--Be Concurred In",11,0,0,0,11
1975356,1552071,2025-04-18,Senate,"(S) 2nd Reading Concurred",40,9,0,1,50
1975356,1552228,2025-04-18,Senate,"(S) 2nd Reading Concurred",40,9,0,1,50
1975356,1553882,2025-04-22,Senate,"(S) 3rd Reading Concurred",41,8,0,1,50
1975377,1502333,2025-02-28,House,"(H) Business and Labor--Do Pass",18,2,0,0,20
1975377,1503315,2025-03-03,House,"(H) 2nd Reading Passed",91,7,0,2,100
1975377,1503792,2025-03-03,House,"(H) Appropriations--Do Pass",21,0,0,2,23
1975377,1504467,2025-03-04,House,"(H) 3rd Reading Passed",94,5,0,1,100
1975377,1529847,2025-03-28,Senate,"(S) Business, Labor  and Economic Affairs--Be Concurred In As Amended",12,0,0,0,12
1975377,1534337,2025-04-02,Senate,"(S) 2nd Reading Concurred",31,19,0,0,50
1975377,1541878,2025-04-09,Senate,"(S) Finance and Claims--Be Concurred In",12,10,0,0,22
1975377,1543515,2025-04-10,Senate,"(S) 3rd Reading Concurred",34,14,0,2,50
1975377,1548996,2025-04-15,House,"(H) 2nd Reading Senate Amendments Concurred",92,8,0,0,100
1975377,1549915,2025-04-16,House,"(H) 3rd Reading Passed as Amended by Senate",82,15,0,3,100
1975403,1500569,2025-02-26,Senate,"(S) State Administration--Do Pass",9,0,0,0,9
1975403,1502965,2025-03-01,Senate,"(S) 2nd Reading Passed",49,1,0,0,50
1975403,1503422,2025-03-03,Senate,"(S) 3rd Reading Passed",49,1,0,0,50
1975403,1529463,2025-03-27,House,"(H) State Administration--Be Concurred In",19,0,0,0,19
1975403,1530623,2025-03-29,House,"(H) 2nd Reading Concurred",100,0,0,0,100
1975403,1531270,2025-03-31,House,"(H) 3rd Reading Concurred",99,0,0,1,100
1975424,1500021,2025-02-26,House,"(H) Judiciary--Do Pass",12,8,0,0,20
1975424,1506923,2025-03-05,House,"(H) 2nd Reading Passed",58,40,0,2,100
1975424,1508516,2025-03-07,House,"(H) 3rd Reading Passed",59,40,0,1,100
1975424,1537247,2025-04-04,Senate,"(S) Judiciary--Be Concurred In As Amended",6,2,0,0,8
1975424,1538624,2025-04-07,Senate,"(S) 2nd Reading Concurred",31,18,0,1,50
1975424,1539790,2025-04-08,Senate,"(S) 3rd Reading Concurred",31,17,0,2,50
1975424,1548467,2025-04-15,House,"(H) 2nd Reading Senate Amendments Concurred",58,42,0,0,100
1975424,1550192,2025-04-16,House,"(H) 3rd Reading Passed as Amended by Senate",59,39,0,2,100
1975446,1498668,2025-02-25,House,"(H) Judiciary--To Table",20,0,0,0,20
1975471,1498634,2025-02-25,House,"(H) Judiciary--Do Pass",20,0,0,0,20
1975471,1502441,2025-02-28,House,"(H) 2nd Reading Passed",57,42,0,1,100
1975471,1503051,2025-03-01,House,"(H) 3rd Reading Passed",68,29,0,3,100
1975471,1541595,2025-04-09,Senate,"(S) Judiciary--To Table",5,3,0,0,8
1975471,1543308,2025-04-09,Senate,"(S) Judiciary--To Table",5,3,0,0,8
1975471,1557271,2025-04-24,Senate,"(S) Taken from Committee; Placed on 2nd Reading",27,23,0,0,50
1975471,1558143,2025-04-25,Senate,"(S) 2nd Reading Concurred",27,23,0,0,50
1975471,1559166,2025-04-28,Senate,"(S) 3rd Reading Concurred",25,24,0,1,50
1975495,1500125,2025-02-26,Senate,"(S) Judiciary--Do Pass As Amended",8,0,0,0,8
1975495,1503090,2025-02-26,Senate,"(S) Judiciary--Do Pass As Amended",8,0,0,0,8
1975495,1518550,2025-03-17,Senate,"(S) 2nd Reading Passed",43,7,0,0,50
1975495,1532183,2025-04-01,Senate,"(S) Finance and Claims--Do Pass As Amended",12,10,0,0,22
1975495,1535925,2025-04-03,Senate,"(S) 2nd Reading Passed",46,4,0,0,50
1975495,1537441,2025-04-04,Senate,"(S) 3rd Reading Passed",45,4,0,1,50
1975495,1550537,2025-04-16,House,"(H) Judiciary--Be Concurred In",20,0,0,0,20
1975495,1552101,2025-04-18,House,"(H) 2nd Reading Concurred",93,6,0,1,100
1975495,1554865,2025-04-22,House,"(H) Appropriations--To Table",14,9,0,0,23
1975495,1555431,2025-04-22,House,"(H) Appropriations--To Table",14,9,0,0,23
1975514,1500875,2025-02-26,House,"(H) Natural Resources--Do Pass As Amended",14,0,0,0,14
1975514,1506093,2025-03-05,House,"(H) 2nd Reading Passed",97,0,0,3,100
1975514,1508767,2025-03-07,House,"(H) 3rd Reading Passed",98,1,0,1,100
1975514,1537621,2025-04-04,Senate,"(S) Natural Resources--Be Concurred In As Amended",11,0,0,0,11
1975514,1540280,2025-04-08,Senate,"(S) 2nd Reading Concurred",49,1,0,0,50
1975514,1541489,2025-04-09,Senate,"(S) 3rd Reading Concurred",49,0,0,1,50
1975514,1549055,2025-04-15,House,"(H) 2nd Reading Senate Amendments Concurred",99,1,0,0,100
1975514,1549983,2025-04-16,House,"(H) 3rd Reading Passed as Amended by Senate",97,1,0,2,100
1975540,1523980,2025-03-20,Senate,"(S) Fish and Game--Do Pass As Amended",7,5,0,0,12
1975540,1531330,2025-03-31,Senate,"(S) 2nd Reading Passed",30,20,0,0,50
1975540,1532677,2025-04-01,Senate,"(S) 3rd Reading Failed",25,25,0,0,50
1975540,1535274,2025-04-02,Senate,"(S) Motion Failed",25,25,0,0,50
1975563,1506022,2025-02-27,House,"(H) Local Government--To Table",16,1,0,0,17
1975584,1500763,2025-02-26,House,"(H) Judiciary--Do Pass",12,8,0,0,20
1975584,1505569,2025-03-04,House,"(H) 2nd Reading Passed",56,43,0,1,100
1975584,1507053,2025-03-06,House,"(H) 3rd Reading Passed",58,41,0,1,100
1975584,1530195,2025-03-28,Senate,"(S) Judiciary--Be Concurred In",5,3,0,0,8
1975584,1549157,2025-04-15,Senate,"(S) 2nd Reading Concurred",30,20,0,0,50
1975584,1550003,2025-04-16,Senate,"(S) 3rd Reading Concurred",31,19,0,0,50
1975608,1501631,2025-02-27,House,"(H) Judiciary--Do Pass As Amended",20,0,0,0,20
1975608,1505945,2025-03-05,House,"(H) 2nd Reading Passed",97,2,0,1,100
1975608,1508826,2025-03-07,House,"(H) 3rd Reading Passed",99,0,0,1,100
1975608,1530415,2025-03-28,Senate,"(S) Judiciary--To Table",6,2,0,0,8
1975608,1537287,2025-03-28,Senate,"(S) Judiciary--To Table",6,2,0,0,8
1975627,1501704,2025-02-27,House,"(H) Business and Labor--Do Pass",15,5,0,0,20
1975627,1506860,2025-03-05,House,"(H) 2nd Reading Passed",62,36,0,2,100
1975627,1508519,2025-03-07,House,"(H) 3rd Reading Failed",48,51,0,1,100
1975660,1502854,2025-02-28,House,"(H) Transportation--Do Pass As Amended",12,2,0,0,14
1975660,1506162,2025-03-05,House,"(H) 2nd Reading Passed",80,19,0,1,100
1975660,1508827,2025-03-07,House,"(H) 3rd Reading Passed",84,14,0,2,100
1975660,1522213,2025-03-19,Senate,"(S) Highways and Transportation--Be Concurred In",8,0,0,0,8
1975660,1525572,2025-03-24,Senate,"(S) Highways and Transportation--Be Concurred In As Amended",7,1,0,0,8
1975660,1534270,2025-04-02,Senate,"(S) 2nd Reading Concurred",28,22,0,0,50
1975660,1536708,2025-04-03,Senate,"(S) 3rd Reading Concurred",30,20,0,0,50
1975660,1550165,2025-04-16,House,"(H) 2nd Reading Senate Amendments Concurred",63,37,0,0,100
1975660,1551665,2025-04-17,House,"(H) 3rd Reading Passed as Amended by Senate",73,26,0,1,100
1975712,1500658,2025-02-26,House,"(H) Transportation--Do Pass",14,0,0,0,14
1975712,1504801,2025-03-04,House,"(H) 2nd Reading Passed",60,39,0,1,100
1975712,1506095,2025-03-05,House,"(H) 3rd Reading Passed",56,42,0,2,100
1975712,1524164,2025-03-21,Senate,"(S) Highways and Transportation--Be Concurred In As Amended",8,0,0,0,8
1975712,1534462,2025-04-02,Senate,"(S) 2nd Reading Concurred",39,10,0,1,50
1975712,1536513,2025-04-03,Senate,"(S) 3rd Reading Concurred",37,13,0,0,50
1975712,1549961,2025-04-16,House,"(H) 2nd Reading Senate Amendments Concurred",100,0,0,0,100
1975712,1551757,2025-04-17,House,"(H) 3rd Reading Passed as Amended by Senate",89,10,0,1,100
1975744,1505131,2025-03-04,House,"(H) Energy, Technology and Federal Relations--To Table",8,6,0,0,14
1975770,1502951,2025-03-01,House,"(H) Business and Labor--Do Pass As Amended",19,1,0,0,20
1975770,1507085,2025-03-06,House,"(H) 2nd Reading Passed",96,1,0,3,100
1975770,1508542,2025-03-07,House,"(H) 3rd Reading Passed",98,1,0,1,100
1975770,1534025,2025-04-02,Senate,"(S) Business, Labor  and Economic Affairs--Be Concurred In As Amended",11,0,0,0,11
1975770,1537706,2025-04-05,Senate,"(S) 2nd Reading Concurred",45,5,0,0,50
1975770,1538605,2025-04-07,Senate,"(S) 3rd Reading Concurred",43,6,0,1,50
1975770,1550109,2025-04-16,House,"(H) 2nd Reading Senate Amendments Concurred",100,0,0,0,100
1975770,1551851,2025-04-17,House,"(H) 3rd Reading Passed as Amended by Senate",99,0,0,1,100
1975800,1503062,2025-03-01,Senate,"(S) Energy, Technology & Federal Relations--Do Pass",13,0,0,0,13
1975800,1519556,2025-03-18,Senate,"(S) Resolution Adopted",45,5,0,0,50
1975832,1501427,2025-02-27,House,"(H) Business and Labor--Do Pass As Amended",19,1,0,0,20
1975832,1505768,2025-03-05,House,"(H) 2nd Reading Passed",96,3,0,1,100
1975832,1508685,2025-03-07,House,"(H) 3rd Reading Passed",98,1,0,1,100
1975832,1537396,2025-04-04,Senate,"(S) Business, Labor  and Economic Affairs--Be Concurred In As Amended",11,0,0,0,11
1975832,1541159,2025-04-08,Senate,"(S) 2nd Reading Concurred",48,1,0,1,50
1975832,1541538,2025-04-09,Senate,"(S) 3rd Reading Concurred",47,2,0,1,50
1975832,1550409,2025-04-16,House,"(H) 2nd Reading Senate Amendments Concurred",100,0,0,0,100
1975832,1551849,2025-04-17,House,"(H) 3rd Reading Passed as Amended by Senate",99,0,0,1,100
1975862,1504693,2025-03-04,Senate,"(S) Business, Labor  and Economic Affairs--Do Pass",7,5,0,0,12
1975862,1506014,2025-03-05,Senate,"(S) 2nd Reading Pass Motion Failed",22,28,0,0,50
1975862,1506015,2025-03-05,Senate,"(S) 2nd Reading Indefinitely Postponed",29,21,0,0,50
1975890,1530197,2025-03-28,Senate,"(S) Taxation--To Table",8,0,0,0,8
1975921,1502852,2025-02-28,Senate,"(S) Public Health, Welfare and Safety--To Table",7,4,0,0,11
1975948,1500632,2025-02-26,House,"(H) Judiciary--Do Pass",12,8,0,0,20
1975948,1507422,2025-03-06,House,"(H) 2nd Reading Passed",62,37,0,1,100
1975948,1508565,2025-03-07,House,"(H) 3rd Reading Passed",61,38,0,1,100
1975948,1530145,2025-03-28,Senate,"(S) Judiciary--Be Concurred In",6,2,0,0,8
1975948,1547716,2025-04-14,Senate,"(S) 2nd Reading Concurred",37,13,0,0,50
1975948,1549093,2025-04-15,Senate,"(S) 3rd Reading Concurred",37,13,0,0,50
1975986,1502922,2025-03-01,Senate,"(S) Business, Labor  and Economic Affairs--To Table",12,0,0,0,12
1976013,1503703,2025-03-03,House,"(H) Natural Resources--Do Pass",8,6,0,0,14
1976013,1506358,2025-03-05,House,"(H) 2nd Reading Passed",56,43,0,1,100
1976013,1508574,2025-03-07,House,"(H) 3rd Reading Passed",55,44,0,1,100
1976013,1546322,2025-04-11,Senate,"(S) Natural Resources--Be Concurred In",8,3,0,0,11
1976013,1548987,2025-04-15,Senate,"(S) 2nd Reading Concurred",30,20,0,0,50
1976013,1549929,2025-04-16,Senate,"(S) 3rd Reading Concurred",32,18,0,0,50
1976044,1502827,2025-02-28,House,"(H) Education--Do Pass As Amended",10,5,0,0,15
1976044,1504998,2025-03-04,House,"(H) 2nd Reading Passed",66,33,0,1,100
1976044,1507052,2025-03-06,House,"(H) 3rd Reading Passed",65,34,0,1,100
1976044,1541221,2025-04-08,Senate,"(S) Education and Cultural Resources--Be Concurred In",9,5,0,0,14
1976044,1546956,2025-04-14,Senate,"(S) 2nd Reading Concurred",36,14,0,0,50
1976044,1549210,2025-04-15,Senate,"(S) 3rd Reading Concurred",37,13,0,0,50
1976072,1502469,2025-02-28,Senate,"(S) Judiciary--Do Pass",5,3,0,0,8
1976072,1506430,2025-03-05,Senate,"(S) 2nd Reading Pass Motion Failed",24,26,0,0,50
1976072,1506431,2025-03-05,Senate,"(S) 2nd Reading Indefinitely Postponed",28,22,0,0,50
1976103,1500133,2025-02-26,Senate,"(S) Business, Labor  and Economic Affairs--Do Pass",11,1,0,0,12
1976103,1502962,2025-03-01,Senate,"(S) 2nd Reading Passed",39,11,0,0,50
1976103,1503577,2025-03-03,Senate,"(S) 3rd Reading Passed",43,7,0,0,50
1976103,1529475,2025-03-27,House,"(H) Business and Labor--Be Concurred In",20,0,0,0,20
1976103,1544956,2025-04-10,House,"(H) 2nd Reading Concurred",94,4,0,2,100
1976103,1546345,2025-04-11,House,"(H) 3rd Reading Concurred",97,2,0,1,100
1976134,1502902,2025-02-28,Senate,"(S) Public Health, Welfare and Safety--Do Pass As Amended",11,0,0,0,11
1976134,1505691,2025-03-05,Senate,"(S) 2nd Reading Passed",45,5,0,0,50
1976134,1508034,2025-03-06,Senate,"(S) 3rd Reading Passed",43,7,0,0,50
1976134,1536194,2025-04-03,House,"(H) Judiciary--Be Concurred In As Amended",18,2,0,0,20
1976134,1544371,2025-04-10,House,"(H) 2nd Reading Concurred",96,4,0,0,100
1976134,1546426,2025-04-11,House,"(H) 3rd Reading Concurred",93,6,0,1,100
1976134,1549936,2025-04-16,Senate,"(S) 2nd Reading House Amendments Concurred",40,9,0,1,50
1976134,1551149,2025-04-17,Senate,"(S) 3rd Reading Passed as Amended by House",34,16,0,0,50
1976164,1501787,2025-02-27,House,"(H) Judiciary--Do Pass",20,0,0,0,20
1976164,1506861,2025-03-05,House,"(H) 2nd Reading Passed",98,1,0,1,100
1976164,1508458,2025-03-07,House,"(H) 3rd Reading Passed",99,0,0,1,100
1976164,1530044,2025-03-28,Senate,"(S) Judiciary--Be Concurred In",8,0,0,0,8
1976164,1546644,2025-04-12,Senate,"(S) 2nd Reading Concurred",50,0,0,0,50
1976164,1547307,2025-04-14,Senate,"(S) 3rd Reading Concurred",48,0,0,2,50
1976194,1500494,2025-02-26,House,"(H) Judiciary--Do Pass As Amended",18,2,0,0,20
1976194,1506348,2025-03-05,House,"(H) 2nd Reading Passed",95,4,0,1,100
1976194,1508507,2025-03-07,House,"(H) 3rd Reading Passed",99,0,0,1,100
1976194,1542274,2025-04-09,Senate,"(S) Judiciary--To Table",7,1,0,0,8
1976194,1543652,2025-04-09,Senate,"(S) Judiciary--To Table",7,1,0,0,8
1976223,1502248,2025-02-27,House,"(H) Local Government--Do Pass As Amended",11,6,0,0,17
1976223,1504922,2025-03-04,House,"(H) 2nd Reading Passed",57,42,0,1,100
1976223,1505741,2025-03-05,House,"(H) 3rd Reading Passed",58,40,0,2,100
1976223,1539153,2025-04-07,Senate,"(S) Local Government--Be Concurred In As Amended",9,1,0,0,10
1976223,1544717,2025-04-10,Senate,"(S) 2nd Reading Motion to Amend Failed",17,33,0,0,50
1976223,1544718,2025-04-10,Senate,"(S) 2nd Reading Concur Motion Failed",10,40,0,0,50
1976223,1544719,2025-04-10,Senate,"(S) 2nd Reading Indefinitely Postponed",47,3,0,0,50
1976626,1500788,2025-02-26,House,"(H) State Administration--To Table",18,1,0,0,19
1976645,1501649,2025-02-27,House,"(H) Human Services--Do Pass",18,3,0,0,21
1976645,1503158,2025-03-03,House,"(H) 2nd Reading Passed",81,18,0,1,100
1976645,1503800,2025-03-03,House,"(H) Appropriations--Do Pass",21,0,0,2,23
1976645,1504363,2025-03-04,House,"(H) 3rd Reading Passed",81,17,0,2,100
1976645,1530593,2025-03-28,Senate,"(S) Public Health, Welfare and Safety--Be Concurred In",8,3,0,0,11
1976645,1544549,2025-04-10,Senate,"(S) 2nd Reading Concurred",32,18,0,0,50
1976645,1545712,2025-04-11,Senate,"(S) Finance and Claims--Be Concurred In",12,10,0,0,22
1976645,1546559,2025-04-12,Senate,"(S) 3rd Reading Concurred",28,22,0,0,50
1976672,1501677,2025-02-27,House,"(H) Judiciary--Do Pass As Amended",12,8,0,0,20
1976672,1505477,2025-03-04,House,"(H) 2nd Reading Passed",66,33,0,1,100
1976672,1507044,2025-03-06,House,"(H) 3rd Reading Passed",68,31,0,1,100
1976672,1530203,2025-03-28,Senate,"(S) Judiciary--Be Concurred In",5,3,0,0,8
1976672,1547789,2025-04-14,Senate,"(S) 2nd Reading Concurred",33,17,0,0,50
1976672,1549207,2025-04-15,Senate,"(S) 3rd Reading Concurred",36,14,0,0,50
1976706,1502571,2025-02-28,House,"(H) Education--Do Pass",15,0,0,0,15
1976706,1507255,2025-03-06,House,"(H) 2nd Reading Passed",88,11,0,1,100
1976706,1508606,2025-03-07,House,"(H) 3rd Reading Passed",84,15,0,1,100
1976706,1536320,2025-04-03,Senate,"(S) Education and Cultural Resources--Be Concurred In",8,6,0,0,14
1976706,1547320,2025-04-14,Senate,"(S) 2nd Reading Concurred",48,2,0,0,50
1976706,1549026,2025-04-15,Senate,"(S) 3rd Reading Concurred",48,2,0,0,50
1976730,1501460,2025-02-27,House,"(H) Judiciary--Do Pass As Amended",15,5,0,0,20
1976730,1505567,2025-03-04,House,"(H) 2nd Reading Passed",58,41,0,1,100
1976730,1507065,2025-03-06,House,"(H) 3rd Reading Passed",57,42,0,1,100
1976730,1530441,2025-03-28,Senate,"(S) Judiciary--Be Concurred In",3,5,0,0,8
1976730,1530442,2025-03-28,Senate,"(S) Judiciary--To Table",8,0,0,0,8
1976730,1537348,2025-03-28,Senate,"(S) Judiciary--To Table",8,0,0,0,8
1976730,1544028,2025-04-10,Senate,"(S) Judiciary--To Take From The Table",5,1,2,0,8
1976730,1548286,2025-03-28,Senate,"(S) Judiciary--To Table",8,0,0,0,8
1976730,1549541,2025-04-11,Senate,"(S) Judiciary--To Take From The Table",8,0,0,0,8
1976730,1549542,2025-04-16,Senate,"(S) Judiciary--Be Concurred In As Amended",8,0,0,0,8
1976730,1550091,2025-03-28,Senate,"(S) Judiciary--To Table",8,0,0,0,8
1976730,1552277,2025-04-18,Senate,"(S) 2nd Reading Concurred",35,15,0,0,50
1976730,1553784,2025-04-22,Senate,"(S) 3rd Reading Concurred",34,16,0,0,50
1976730,1557265,2025-04-24,House,"(H) 2nd Reading Senate Amendments Concurred",65,35,0,0,100
1976730,1558279,2025-04-25,House,"(H) 3rd Reading Passed as Amended by Senate",62,38,0,0,100
1976760,1501401,2025-02-27,House,"(H) Business and Labor--Do Pass",20,0,0,0,20
1976760,1505758,2025-03-05,House,"(H) 2nd Reading Passed",98,1,0,1,100
1976760,1508745,2025-03-07,House,"(H) 3rd Reading Passed",95,4,0,1,100
1976760,1546492,2025-04-11,Senate,"(S) State Administration--Be Concurred In",9,0,0,0,9
1976760,1547453,2025-04-14,Senate,"(S) 2nd Reading Concurred",43,7,0,0,50
1976760,1549226,2025-04-15,Senate,"(S) 3rd Reading Concurred",32,18,0,0,50
1976785,1502284,2025-02-28,House,"(H) Business and Labor--Do Pass As Amended",20,0,0,0,20
1976785,1507251,2025-03-06,House,"(H) 2nd Reading Passed",95,2,0,3,100
1976785,1507837,2025-03-06,House,"(H) Appropriations--Do Pass",20,3,0,0,23
1976785,1508605,2025-03-07,House,"(H) 3rd Reading Passed",96,3,0,1,100
1976785,1538730,2025-04-07,Senate,"(S) Public Health, Welfare and Safety--Be Concurred In",10,1,0,0,11
1976785,1545470,2025-04-11,Senate,"(S) 2nd Reading Concurred",48,1,0,1,50
1976785,1546579,2025-04-12,Senate,"(S) 3rd Reading Concurred",50,0,0,0,50
1976816,1500691,2025-02-26,House,"(H) State Administration--To Table",19,0,0,0,19
1976849,1502394,2025-02-27,House,"(H) Local Government--To Table",9,8,0,0,17
1976849,1506561,2025-03-05,House,"(H) Taken from Committee; Placed on 2nd Reading",45,53,0,2,100
1976849,1543432,2025-03-05,House,"(H) Taken from Committee; Placed on 2nd Reading",45,53,0,2,100
1976880,1502998,2025-03-01,House,"(H) Business and Labor--Do Pass",11,9,0,0,20
1976880,1503480,2025-03-03,House,"(H) 2nd Reading Passed",67,32,0,1,100
1976880,1504878,2025-03-04,House,"(H) Appropriations--Do Pass",18,5,0,0,23
1976880,1505939,2025-03-05,House,"(H) 3rd Reading Passed",69,29,0,2,100
1976880,1530008,2025-03-28,Senate,"(S) Business, Labor  and Economic Affairs--Be Concurred In",8,4,0,0,12
1976880,1542006,2025-04-09,Senate,"(S) 2nd Reading Concurred",28,22,0,0,50
1976880,1545881,2025-04-11,Senate,"(S) Finance and Claims--Be Concurred In",12,10,0,0,22
1976880,1546669,2025-04-12,Senate,"(S) 3rd Reading Failed",25,25,0,0,50
1976880,1547314,2025-04-14,Senate,"(S) Reconsidered Previous Action; Remains in 3rd Reading Process",25,24,0,1,50
1976880,1549012,2025-04-15,Senate,"(S) 3rd Reading Concurred",26,24,0,0,50
1976902,1501625,2025-02-27,House,"(H) Judiciary--To Table",16,4,0,0,20
1976930,1505576,2025-03-04,Senate,"(S) State Administration--Do Pass",5,4,0,0,9
1976930,1506943,2025-03-05,Senate,"(S) 2nd Reading Passed",29,21,0,0,50
1976930,1532218,2025-04-01,Senate,"(S) Finance and Claims--Do Pass As Amended",12,10,0,0,22
1976930,1536972,2025-04-03,Senate,"(S) 2nd Reading Pass Motion Failed",25,25,0,0,50
1976930,1536973,2025-04-03,Senate,"(S) 2nd Reading Indefinitely Postponed",27,23,0,0,50
1976930,1536974,2025-04-03,Senate,"(S) Reconsidered Previous Action; Placed on 2nd Reading",25,24,0,1,50
1976930,1537513,2025-04-04,Senate,"(S) 2nd Reading Passed",27,23,0,0,50
1976930,1537644,2025-04-05,Senate,"(S) 3rd Reading Passed",27,21,0,2,50
1976930,1548364,2025-04-15,House,"(H) State Administration--Be Concurred In As Amended",9,10,0,0,19
1976930,1555332,2025-04-22,House,"(H) State Administration--Be Concurred In As Amended",17,2,0,0,19
1976930,1555333,2025-04-15,House,"(H) State Administration--To Table",12,7,0,0,19
1976958,1500912,2025-02-26,Senate,"(S) Public Health, Welfare and Safety--To Table",11,0,0,0,11
1976991,1502819,2025-02-28,House,"(H) Education--Do Pass",14,1,0,0,15
1976991,1505892,2025-03-05,House,"(H) 2nd Reading Passed",98,0,0,2,100
1976991,1508602,2025-03-07,House,"(H) 3rd Reading Passed",99,0,0,1,100
1976991,1534117,2025-04-01,Senate,"(S) Education and Cultural Resources--Be Concurred In",10,4,0,0,14
1976991,1547027,2025-04-14,Senate,"(S) 2nd Reading Concurred",44,6,0,0,50
1976991,1548557,2025-04-15,Senate,"(S) 3rd Reading Concurred",45,5,0,0,50
1977049,1524260,2025-03-21,House,"(H) Energy, Technology and Federal Relations--Do Pass As Amended",10,4,0,0,14
1977049,1557101,2025-04-24,House,"(H) Resolution Adopted",59,41,0,0,100
1977081,1502861,2025-02-28,House,"(H) Education--Do Pass As Amended",11,4,0,0,15
1977081,1506710,2025-03-05,House,"(H) 2nd Reading Passed",93,6,0,1,100
1977081,1508812,2025-03-07,House,"(H) 3rd Reading Passed",89,10,0,1,100
1977081,1549351,2025-04-15,Senate,"(S) Education and Cultural Resources--Be Concurred In",9,5,0,0,14
1977081,1551927,2025-04-17,Senate,"(S) 2nd Reading Concurred",31,19,0,0,50
1977081,1552335,2025-04-18,Senate,"(S) 3rd Reading Concurred",28,22,0,0,50
1977112,1502892,2025-02-28,House,"(H) Education--Do Pass As Amended",12,3,0,0,15
1977112,1506702,2025-03-05,House,"(H) 2nd Reading Passed",67,32,0,1,100
1977112,1508673,2025-03-07,House,"(H) 3rd Reading Passed",74,25,0,1,100
1977112,1549440,2025-04-15,Senate,"(S) Education and Cultural Resources--To Table",14,0,0,0,14
1977112,1549887,2025-04-15,Senate,"(S) Education and Cultural Resources--To Table",14,0,0,0,14
1977112,1551866,2025-04-17,Senate,"(S) Taken from Committee; Placed on 2nd Reading",27,23,0,0,50
1977112,1552182,2025-04-18,Senate,"(S) 2nd Reading Motion to Amend Failed",24,26,0,0,50
1977112,1552183,2025-04-18,Senate,"(S) 2nd Reading Concurred",27,23,0,0,50
1977112,1553709,2025-04-22,Senate,"(S) 3rd Reading Concurred",29,21,0,0,50
1977151,1502797,2025-02-28,Senate,"(S) Public Health, Welfare and Safety--To Table",11,0,0,0,11
1977175,1505589,2025-03-04,Senate,"(S) Agriculture, Livestock and Irrigation--To Table",11,0,0,0,11
1977211,1534915,2025-04-02,Senate,"(S) Natural Resources--Resolution Adopted",11,0,0,0,11
1977211,1537436,2025-04-04,Senate,"(S) 2nd Reading Passed",48,1,0,1,50
1977211,1537665,2025-04-05,Senate,"(S) 3rd Reading Passed",46,4,0,0,50
1977211,1549996,2025-04-16,House,"(H) Natural Resources--Be Concurred In",10,4,0,0,14
1977211,1555242,2025-04-23,House,"(H) 2nd Reading Concurred",56,44,0,0,100
1977211,1556805,2025-04-24,House,"(H) 3rd Reading Concurred",56,44,0,0,100
1977246,1499443,2025-02-25,House,"(H) Local Government--Do Pass",17,0,0,0,17
1977246,1506039,2025-03-05,House,"(H) 2nd Reading Passed",94,4,0,2,100
1977246,1508710,2025-03-07,House,"(H) 3rd Reading Passed",80,19,0,1,100
1977246,1531655,2025-03-31,Senate,"(S) Local Government--Be Concurred In",11,0,0,0,11
1977246,1542046,2025-04-09,Senate,"(S) 2nd Reading Motion to Amend Failed",18,31,0,1,50
1977246,1542047,2025-04-09,Senate,"(S) 2nd Reading Concurred",38,12,0,0,50
1977246,1543596,2025-04-10,Senate,"(S) 3rd Reading Concurred",38,10,0,2,50
1977277,1502772,2025-02-28,Senate,"(S) Highways and Transportation--Do Pass As Amended",7,1,0,0,8
1977277,1507022,2025-03-06,Senate,"(S) 2nd Reading Passed",48,2,0,0,50
1977277,1507994,2025-03-06,Senate,"(S) 3rd Reading Passed",45,4,0,1,50
1977277,1538299,2025-04-07,House,"(H) Transportation--Be Concurred In",14,0,0,0,14
1977277,1543318,2025-04-10,House,"(H) 2nd Reading Concurred",97,3,0,0,100
1977277,1546266,2025-04-11,House,"(H) 3rd Reading Concurred",97,2,0,1,100
1977310,1502630,2025-02-28,House,"(H) Natural Resources--Do Pass",12,2,0,0,14
1977310,1507750,2025-03-06,House,"(H) 2nd Reading Passed",84,15,0,1,100
1977310,1508588,2025-03-07,House,"(H) 3rd Reading Passed",90,9,0,1,100
1977310,1546368,2025-04-11,Senate,"(S) Natural Resources--Be Concurred In",11,0,0,0,11
1977310,1547291,2025-04-14,Senate,"(S) 2nd Reading Concurred",50,0,0,0,50
1977310,1548986,2025-04-15,Senate,"(S) 3rd Reading Concurred",49,1,0,0,50
1977345,1502860,2025-02-28,Senate,"(S) Natural Resources--To Table",8,3,0,0,11
1977381,1502608,2025-02-28,Senate,"(S) Highways and Transportation--Do Pass",5,3,0,0,8
1977381,1504358,2025-02-28,Senate,"(S) Highways and Transportation--Do Pass As Amended",5,3,0,0,8
1977381,1505853,2025-03-05,Senate,"(S) 2nd Reading Motion to Amend Failed",19,31,0,0,50
1977381,1505854,2025-03-05,Senate,"(S) 2nd Reading Passed",29,21,0,0,50
1977381,1507238,2025-03-06,Senate,"(S) 3rd Reading Failed",24,26,0,0,50
1977381,1553684,2025-02-28,Senate,"(S) Highways and Transportation--Do Pass",5,3,0,0,8
1977418,1501261,2025-02-27,House,"(H) State Administration--To Table",17,2,0,0,19
1977447,1502673,2025-02-28,Senate,"(S) Judiciary--To Table",0,8,0,0,8
1977447,1502674,2025-02-28,Senate,"(S) Judiciary--Do Pass",3,5,0,0,8
1977488,1502622,2025-02-28,Senate,"(S) Judiciary--To Table",0,8,0,0,8
1977488,1502623,2025-02-28,Senate,"(S) Judiciary--Do Pass",3,5,0,0,8
1977524,1502877,2025-02-28,Senate,"(S) Public Health, Welfare and Safety--Do Pass",10,1,0,0,11
1977524,1507478,2025-03-06,Senate,"(S) 2nd Reading Passed",38,12,0,0,50
1977524,1508318,2025-03-06,Senate,"(S) 3rd Reading Passed",37,12,0,1,50
1977524,1530474,2025-03-28,House,"(H) Human Services--To Table",15,0,0,6,21
1977524,1537263,2025-03-28,House,"(H) Human Services--To Table",15,0,6,0,21
1977524,1543234,2025-04-09,House,"(H) Human Services--To Take From The Table",10,5,6,0,21
1977524,1543481,2025-04-09,House,"(H) Human Services--Be Concurred In As Amended",11,10,0,0,21
1977524,1544429,2025-04-09,House,"(H) Human Services--To Take From The Table",10,5,6,0,21
1977524,1545783,2025-04-11,House,"(H) 2nd Reading Concurred",59,40,0,1,100
1977524,1546310,2025-04-11,House,"(H) 3rd Reading Concurred",64,35,0,1,100
1977524,1547413,2025-04-14,Senate,"(S) 2nd Reading Concurred",31,19,0,0,50
1977524,1549344,2025-04-15,Senate,"(S) 3rd Reading Passed as Amended by House",34,16,0,0,50
1977524,1579474,2025-04-09,House,"(H) Human Services--To Take From The Table",10,5,6,0,21
1977556,1502834,2025-02-28,Senate,"(S) Public Health, Welfare and Safety--To Table",11,0,0,0,11
1977598,1502314,2025-02-28,House,"(H) Taxation--To Table",21,0,0,0,21
1977628,1502802,2025-02-28,Senate,"(S) Natural Resources--To Table",11,0,0,0,11
1977663,1502337,2025-02-28,Senate,"(S) Judiciary--Do Pass As Amended",5,3,0,0,8
1977663,1506932,2025-03-05,Senate,"(S) 2nd Reading Passed",28,22,0,0,50
1977663,1524027,2025-03-21,Senate,"(S) Finance and Claims--Do Pass",11,11,0,0,22
1977699,1501737,2025-02-27,House,"(H) Judiciary--Do Pass",13,7,0,0,20
1977699,1506883,2025-03-05,House,"(H) 2nd Reading Passed",59,40,0,1,100
1977699,1508758,2025-03-07,House,"(H) 3rd Reading Passed",59,40,0,1,100
1977699,1530110,2025-03-28,Senate,"(S) Judiciary--Be Concurred In",5,3,0,0,8
1977699,1547475,2025-04-14,Senate,"(S) 2nd Reading Concurred",27,23,0,0,50
1977699,1548399,2025-04-15,Senate,"(S) 3rd Reading Concurred",30,20,0,0,50
1977737,1501685,2025-02-27,Senate,"(S) Judiciary--To Table",8,0,0,0,8
1977737,1501686,2025-02-27,Senate,"(S) Judiciary--Do Pass",4,4,0,0,8
1977814,1500705,2025-02-26,House,"(H) Judiciary--To Table",20,0,0,0,20
1977850,1502234,2025-02-27,House,"(H) Local Government--Do Pass As Amended",17,0,0,0,17
1977850,1506911,2025-03-05,House,"(H) 2nd Reading Passed",98,0,0,2,100
1977850,1508627,2025-03-07,House,"(H) 3rd Reading Passed",99,0,0,1,100
1977850,1531660,2025-03-31,Senate,"(S) Local Government--Be Concurred In As Amended",11,0,0,0,11
1977850,1537702,2025-04-05,Senate,"(S) 2nd Reading Concurred",38,12,0,0,50
1977850,1538792,2025-04-07,Senate,"(S) 3rd Reading Concurred",37,12,0,1,50
1977850,1550017,2025-04-16,House,"(H) 2nd Reading Senate Amendments Concurred",100,0,0,0,100
1977850,1551525,2025-04-17,House,"(H) 3rd Reading Passed as Amended by Senate",99,0,0,1,100
1977884,1516383,2025-02-27,Senate,"(S) Finance and Claims--Do Pass",16,6,0,0,22
1977884,1518093,2025-03-14,Senate,"(S) 2nd Reading Passed",44,6,0,0,50
1977884,1518263,2025-03-15,Senate,"(S) 3rd Reading Passed",44,6,0,0,50
1977884,1551398,2025-04-17,House,"(H) Appropriations--Be Concurred In As Amended",21,2,0,0,23
1977884,1554408,2025-04-22,House,"(H) 2nd Reading Concurred",98,2,0,0,100
1977884,1555826,2025-04-23,House,"(H) 3rd Reading Concurred",96,3,0,1,100
1977884,1557995,2025-04-25,Senate,"(S) 2nd Reading House Amendments Concurred",34,16,0,0,50
1977884,1559130,2025-04-28,Senate,"(S) 3rd Reading Passed as Amended by House",39,10,0,1,50
1977920,1502055,2025-02-27,House,"(H) Judiciary--To Table",12,8,0,0,20
1977954,1504786,2025-03-04,Senate,"(S) Business, Labor  and Economic Affairs--Do Pass",7,5,0,0,12
1977954,1506080,2025-03-05,Senate,"(S) 2nd Reading Motion to Amend Carried",50,0,0,0,50
1977954,1506081,2025-03-05,Senate,"(S) 2nd Reading Passed as Amended",31,19,0,0,50
1977954,1532359,2025-04-01,Senate,"(S) Finance and Claims--Do Pass As Amended",12,10,0,0,22
1977954,1536541,2025-04-03,Senate,"(S) 2nd Reading Passed",30,20,0,0,50
1977954,1537218,2025-04-04,Senate,"(S) 3rd Reading Passed",29,20,0,1,50
1977954,1552062,2025-04-18,House,"(H) Business and Labor--Be Concurred In",12,8,0,0,20
1977954,1555214,2025-04-23,House,"(H) 2nd Reading Concurred",58,41,0,1,100
1977954,1555703,2025-04-23,House,"(H) Appropriations--Be Concurred In",14,9,0,0,23
1977954,1558069,2025-04-25,House,"(H) 3rd Reading Concurred",58,42,0,0,100
1977991,1501917,2025-02-27,House,"(H) Human Services--Resolution Adopted",20,1,0,0,21
1977991,1529266,2025-03-27,House,"(H) 2nd Reading Passed",76,24,0,0,100
1977991,1530281,2025-03-28,House,"(H) 3rd Reading Passed",78,21,0,1,100
1977991,1535415,2025-04-02,Senate,"(S) State Administration--Resolution Adopted",6,3,0,0,9
1977991,1552179,2025-04-18,Senate,"(S) 2nd Reading Concurred",38,10,0,2,50
1977991,1554751,2025-04-22,Senate,"(S) 3rd Reading Concurred",34,16,0,0,50
1977991,1560848,2025-02-27,House,"(H) Human Services--Do Pass",20,1,0,0,21
1978026,1500239,2025-02-26,House,"(H) Business and Labor--Do Pass",20,0,0,0,20
1978026,1506903,2025-03-05,House,"(H) 2nd Reading Passed",98,0,0,2,100
1978026,1508623,2025-03-07,House,"(H) 3rd Reading Passed",99,0,0,1,100
1978026,1540535,2025-04-08,Senate,"(S) Business, Labor  and Economic Affairs--Be Concurred In As Amended",11,0,0,0,11
1978026,1543546,2025-04-10,Senate,"(S) 2nd Reading Concurred",50,0,0,0,50
1978026,1546410,2025-04-11,Senate,"(S) 3rd Reading Concurred",48,0,0,2,50
1978026,1550692,2025-04-16,House,"(H) 2nd Reading Senate Amendments Concurred",100,0,0,0,100
1978026,1551955,2025-04-17,House,"(H) 3rd Reading Passed as Amended by Senate",99,0,0,1,100
1978062,1500898,2025-02-26,Senate,"(S) Highways and Transportation--Do Pass As Amended",8,0,0,0,8
1978062,1502995,2025-03-01,Senate,"(S) 2nd Reading Passed",50,0,0,0,50
1978062,1503729,2025-03-03,Senate,"(S) 3rd Reading Passed",50,0,0,0,50
1978062,1530440,2025-03-28,House,"(H) Transportation--Be Concurred In",14,0,0,0,14
1978062,1543417,2025-04-10,House,"(H) 2nd Reading Concurred",99,1,0,0,100
1978062,1546293,2025-04-11,House,"(H) 3rd Reading Concurred",98,0,0,2,100
1978096,1503055,2025-03-01,House,"(H) State Administration--To Table",18,1,0,0,19
1978128,1502808,2025-02-28,House,"(H) Energy, Technology and Federal Relations--Do Pass As Amended",12,2,0,0,14
1978128,1505883,2025-03-05,House,"(H) 2nd Reading Motion to Amend Carried",52,47,0,1,100
1978128,1505884,2025-03-05,House,"(H) 2nd Reading Passed as Amended",85,14,0,1,100
1978128,1508612,2025-03-07,House,"(H) 3rd Reading Passed",86,13,0,1,100
1978128,1533039,2025-04-01,Senate,"(S) Energy, Technology & Federal Relations--Be Concurred In As Amended",10,3,0,0,13
1978128,1537755,2025-04-05,Senate,"(S) 2nd Reading Motion to Amend Failed",21,29,0,0,50
1978128,1537756,2025-04-05,Senate,"(S) 2nd Reading Concurred",42,8,0,0,50
1978128,1538316,2025-04-07,Senate,"(S) 3rd Reading Concurred",40,9,0,1,50
1978128,1549885,2025-04-16,House,"(H) 2nd Reading Senate Amendments Concurred",58,42,0,0,100
1978128,1551603,2025-04-17,House,"(H) 3rd Reading Passed as Amended by Senate",64,35,0,1,100
1978160,1503064,2025-03-01,House,"(H) Judiciary--To Table",20,0,0,0,20
1978913,1502489,2025-02-28,House,"(H) Judiciary--Do Pass As Amended",16,4,0,0,20
1978913,1505585,2025-03-04,House,"(H) 2nd Reading Passed",60,39,0,1,100
1978913,1507045,2025-03-06,House,"(H) 3rd Reading Passed",63,36,0,1,100
1978913,1537427,2025-04-04,Senate,"(S) Judiciary--Be Concurred In",5,3,0,0,8
1978913,1547742,2025-04-14,Senate,"(S) 2nd Reading Concurred",32,18,0,0,50
1978913,1549184,2025-04-15,Senate,"(S) 3rd Reading Concurred",30,20,0,0,50
1978988,1502774,2025-02-28,House,"(H) State Administration--Do Pass As Amended",19,0,0,0,19
1978988,1507028,2025-03-06,House,"(H) 2nd Reading Passed",99,0,0,1,100
1978988,1508718,2025-03-07,House,"(H) 3rd Reading Passed",99,0,0,1,100
1978988,1550608,2025-04-16,Senate,"(S) State Administration--Be Concurred In",9,0,0,0,9
1978988,1555181,2025-04-23,Senate,"(S) 2nd Reading Concurred",49,0,0,1,50
1978988,1557818,2025-04-24,Senate,"(S) 3rd Reading Concurred",50,0,0,0,50
1979066,1502276,2025-02-28,House,"(H) Judiciary--Do Pass As Amended",17,3,0,0,20
1979066,1505509,2025-03-04,House,"(H) 2nd Reading Passed",86,12,0,2,100
1979066,1507076,2025-03-06,House,"(H) 3rd Reading Passed",88,11,0,1,100
1979066,1537219,2025-04-04,Senate,"(S) Judiciary--Be Concurred In As Amended",6,2,0,0,8
1979066,1538597,2025-04-07,Senate,"(S) 2nd Reading Concurred",41,9,0,0,50
1979066,1539702,2025-04-08,Senate,"(S) 3rd Reading Concurred",38,10,0,2,50
1979066,1550018,2025-04-16,House,"(H) 2nd Reading Senate Amendments Concurred",94,6,0,0,100
1979066,1551824,2025-04-17,House,"(H) 3rd Reading Passed as Amended by Senate",81,18,0,1,100
1979145,1501699,2025-02-27,House,"(H) Agriculture--Do Pass",17,0,0,0,17
1979145,1506126,2025-03-05,House,"(H) 2nd Reading Passed",98,0,0,2,100
1979145,1508702,2025-03-07,House,"(H) 3rd Reading Passed",99,0,0,1,100
1979145,1533492,2025-04-01,Senate,"(S) Agriculture, Livestock and Irrigation--Be Concurred In As Amended",11,0,0,0,11
1979145,1537697,2025-04-05,Senate,"(S) 2nd Reading Concurred",48,0,0,2,50
1979145,1539086,2025-04-07,Senate,"(S) 3rd Reading Concurred",49,0,0,1,50
1979145,1549897,2025-04-16,House,"(H) 2nd Reading Senate Amendments Concurred",99,1,0,0,100
1979145,1551370,2025-04-17,House,"(H) 3rd Reading Passed as Amended by Senate",98,1,0,1,100
1979255,1502901,2025-02-28,Senate,"(S) Public Health, Welfare and Safety--Do Pass",6,5,0,0,11
1979255,1506105,2025-03-05,Senate,"(S) 2nd Reading Passed",44,5,0,1,50
1979255,1507876,2025-03-06,Senate,"(S) 3rd Reading Passed",43,7,0,0,50
1979255,1540009,2025-04-08,House,"(H) Judiciary--Be Concurred In",15,5,0,0,20
1979255,1545244,2025-04-10,House,"(H) 2nd Reading Concurred",94,6,0,0,100
1979255,1546425,2025-04-11,House,"(H) 3rd Reading Concurred",90,9,0,1,100
1979278,1502149,2025-02-27,Senate,"(S) Education and Cultural Resources--To Table",13,1,0,0,14
1979300,1502239,2025-02-28,Senate,"(S) Taxation--To Table",8,0,0,0,8
1979323,1501587,2025-02-27,Senate,"(S) Fish and Game--To Table",12,0,0,0,12
1979341,1502391,2025-02-28,Senate,"(S) Judiciary--Do Pass",5,3,0,0,8
1979341,1503491,2025-03-03,Senate,"(S) 2nd Reading Passed",29,20,0,1,50
1979341,1504781,2025-03-04,Senate,"(S) 3rd Reading Passed",29,21,0,0,50
1979341,1539632,2025-04-08,House,"(H) Judiciary--Be Concurred In",12,8,0,0,20
1979341,1544675,2025-04-10,House,"(H) 2nd Reading Not Concurred",46,54,0,0,100
1979364,1500148,2025-02-26,House,"(H) Business and Labor--To Table",20,0,0,0,20
1979388,1502868,2025-02-28,House,"(H) Education--Do Pass",15,0,0,0,15
1979388,1506956,2025-03-05,House,"(H) 2nd Reading Passed",99,0,0,1,100
1979388,1508528,2025-03-07,House,"(H) 3rd Reading Passed",99,0,0,1,100
1979388,1541179,2025-04-08,Senate,"(S) Education and Cultural Resources--Be Concurred In",14,0,0,0,14
1979388,1547948,2025-04-14,Senate,"(S) 2nd Reading Concurred",35,14,0,1,50
1979388,1549255,2025-04-15,Senate,"(S) 3rd Reading Concurred",50,0,0,0,50
1979408,1505531,2025-03-04,Senate,"(S) State Administration--To Table",9,0,0,0,9
1979431,1502158,2025-02-27,Senate,"(S) Energy, Technology & Federal Relations--Do Pass",13,0,0,0,13
1979431,1506094,2025-03-05,Senate,"(S) 2nd Reading Passed",50,0,0,0,50
1979431,1507564,2025-03-06,Senate,"(S) 3rd Reading Passed",50,0,0,0,50
1979431,1530357,2025-03-28,House,"(H) Energy, Technology and Federal Relations--Be Concurred In As Amended",14,0,0,0,14
1979431,1541725,2025-04-09,House,"(H) 2nd Reading Motion to Amend Carried",99,1,0,0,100
1979431,1541726,2025-04-09,House,"(H) 2nd Reading Concurred as Amended",98,1,0,1,100
1979431,1546238,2025-04-11,House,"(H) 3rd Reading Concurred",95,3,0,2,100
1979431,1549867,2025-04-16,Senate,"(S) 2nd Reading House Amendments Concurred",50,0,0,0,50
1979431,1551669,2025-04-17,Senate,"(S) 3rd Reading Passed as Amended by House",50,0,0,0,50
1979451,1502850,2025-02-28,Senate,"(S) Local Government--Do Pass As Amended",10,1,0,0,11
1979451,1505761,2025-03-05,Senate,"(S) 2nd Reading Passed",48,2,0,0,50
1979451,1507680,2025-03-06,Senate,"(S) 3rd Reading Passed",47,3,0,0,50
1979451,1541114,2025-04-08,House,"(H) Local Government--To Table",16,1,0,0,17
1979451,1544114,2025-04-08,House,"(H) Local Government--To Table",16,1,0,0,17
1979451,1580223,2025-04-08,House,"(H) Local Government--To Table",16,1,0,0,17
1979473,1502358,2025-02-28,House,"(H) Judiciary--Do Pass As Amended",12,8,0,0,20
1979473,1506823,2025-03-05,House,"(H) 2nd Reading Passed",52,47,0,1,100
1979473,1508584,2025-03-07,House,"(H) 3rd Reading Failed",41,58,0,1,100
1979497,1498714,2025-02-25,House,"(H) Business and Labor--Do Pass",20,0,0,0,20
1979497,1507369,2025-03-06,House,"(H) 2nd Reading Passed",96,3,0,1,100
1979497,1508668,2025-03-07,House,"(H) 3rd Reading Passed",98,1,0,1,100
1979497,1530143,2025-03-28,Senate,"(S) Business, Labor  and Economic Affairs--Be Concurred In",11,1,0,0,12
1979497,1548112,2025-04-14,Senate,"(S) 2nd Reading Concurred",43,7,0,0,50
1979497,1549221,2025-04-15,Senate,"(S) 3rd Reading Concurred",41,9,0,0,50
1979517,1502161,2025-02-27,Senate,"(S) Energy, Technology & Federal Relations--To Table",12,1,0,0,13
1979541,1504868,2025-03-04,Senate,"(S) Business, Labor  and Economic Affairs--Do Pass",8,4,0,0,12
1979541,1506146,2025-03-05,Senate,"(S) 2nd Reading Passed",32,18,0,0,50
1979541,1532747,2025-04-01,Senate,"(S) Finance and Claims--Do Pass",12,10,0,0,22
1979541,1535983,2025-04-03,Senate,"(S) 3rd Reading Passed",30,20,0,0,50
1979541,1552117,2025-04-18,House,"(H) Business and Labor--To Table",15,0,5,0,20
1979541,1555344,2025-04-18,House,"(H) Business and Labor--To Table",15,0,5,0,20
1979562,1502380,2025-02-28,Senate,"(S) Judiciary--Do Pass",6,2,0,0,8
1979562,1503328,2025-03-03,Senate,"(S) 2nd Reading Passed",34,15,0,1,50
1979562,1504626,2025-03-04,Senate,"(S) 3rd Reading Passed",35,15,0,0,50
1979562,1542478,2025-04-09,House,"(H) Judiciary--Be Concurred In As Amended",15,5,0,0,20
1979562,1545936,2025-04-11,House,"(H) 2nd Reading Not Concurred",34,66,0,0,100
1979585,1521816,2025-03-19,Senate,"(S) Taxation--Do Pass As Amended",8,0,0,0,8
1979585,1526393,2025-03-25,Senate,"(S) 2nd Reading Passed",37,13,0,0,50
1979585,1534077,2025-04-02,Senate,"(S) Finance and Claims--Do Pass",19,3,0,0,22
1979585,1536615,2025-04-03,Senate,"(S) 3rd Reading Passed",48,2,0,0,50
1979585,1542665,2025-04-09,House,"(H) Taxation--Be Concurred In As Amended",21,0,0,0,21
1979585,1547854,2025-04-14,House,"(H) 2nd Reading Concurred",100,0,0,0,100
1979585,1550406,2025-04-16,House,"(H) Appropriations--Be Concurred In",14,9,0,0,23
1979585,1551791,2025-04-17,House,"(H) 3rd Reading Concurred",93,5,0,2,100
1979585,1553740,2025-04-22,Senate,"(S) 2nd Reading House Amendments Concurred",48,2,0,0,50
1979585,1555582,2025-04-23,Senate,"(S) 3rd Reading Passed as Amended by House",48,2,0,0,50
1979607,1503431,2025-03-03,House,"(H) Natural Resources--Do Pass",14,0,0,0,14
1979607,1505975,2025-03-05,House,"(H) 2nd Reading Passed",91,7,0,2,100
1979607,1508525,2025-03-07,House,"(H) 3rd Reading Passed",94,5,0,1,100
1979607,1546481,2025-04-11,Senate,"(S) Natural Resources--Be Concurred In",11,0,0,0,11
1979607,1547042,2025-04-14,Senate,"(S) 2nd Reading Concurred",45,5,0,0,50
1979607,1549235,2025-04-15,Senate,"(S) 3rd Reading Concurred",50,0,0,0,50
1979630,1501647,2025-02-27,Senate,"(S) Judiciary--Do Pass",8,0,0,0,8
1979630,1503000,2025-03-01,Senate,"(S) 2nd Reading Passed",50,0,0,0,50
1979630,1503501,2025-03-03,Senate,"(S) 3rd Reading Passed",50,0,0,0,50
1979630,1539941,2025-04-08,House,"(H) Judiciary--Be Concurred In",20,0,0,0,20
1979630,1545293,2025-04-10,House,"(H) 2nd Reading Concurred",99,0,0,1,100
1979630,1546361,2025-04-11,House,"(H) 3rd Reading Concurred",99,0,0,1,100
1979651,1502605,2025-02-28,Senate,"(S) Local Government--Do Pass As Amended",10,1,0,0,11
1979651,1506763,2025-03-05,Senate,"(S) 2nd Reading Passed",40,10,0,0,50
1979651,1507549,2025-03-06,Senate,"(S) 3rd Reading Passed",39,11,0,0,50
1979651,1537215,2025-04-03,House,"(H) Local Government--Be Concurred In As Amended",17,0,0,0,17
1979651,1542153,2025-04-09,House,"(H) 2nd Reading Concurred",97,3,0,0,100
1979651,1543633,2025-04-10,House,"(H) 3rd Reading Concurred",98,0,0,2,100
1979651,1546303,2025-04-11,Senate,"(S) 2nd Reading House Amendments Concurred",50,0,0,0,50
1979651,1546735,2025-04-12,Senate,"(S) 3rd Reading Passed as Amended by House",48,2,0,0,50
1979671,1502022,2025-02-27,Senate,"(S) Education and Cultural Resources--To Table",9,5,0,0,14
1979693,1503056,2025-03-01,Senate,"(S) Legislative Administration--Do Pass",6,0,0,0,6
1979693,1506161,2025-03-05,Senate,"(S) 2nd Reading Passed",49,1,0,0,50
1979693,1506941,2025-03-05,Senate,"(S) Motion Failed",23,27,0,0,50
1979693,1507589,2025-03-06,Senate,"(S) Reconsidered Previous Action; Placed on 2nd Reading",27,23,0,0,50
1979693,1507590,2025-03-06,Senate,"(S) 2nd Reading Indefinitely Postponed",35,15,0,0,50
1979693,1507591,2025-03-06,Senate,"(S) 2nd Reading Pass Motion Failed",18,32,0,0,50
1979717,1502921,2025-02-28,Senate,"(S) Judiciary--Do Pass",8,0,0,0,8
1979717,1518535,2025-03-17,Senate,"(S) 2nd Reading Passed",50,0,0,0,50
1979717,1519736,2025-03-18,Senate,"(S) 3rd Reading Passed",49,0,0,1,50
1979717,1538355,2025-04-07,House,"(H) Human Services--Be Concurred In",21,0,0,0,21
1979717,1546401,2025-04-11,House,"(H) 2nd Reading Concurred",99,0,0,1,100
1979717,1546402,2025-04-11,House,"(H) 3rd Reading Concurred",99,0,0,1,100
1979736,1505587,2025-03-04,Senate,"(S) State Administration--To Table",8,1,0,0,9
1979759,1502756,2025-02-28,House,"(H) Education--Do Pass As Amended",15,0,0,0,15
1979759,1503780,2025-03-03,House,"(H) 2nd Reading Passed",74,25,0,1,100
1979759,1504592,2025-03-04,House,"(H) Appropriations--Do Pass",17,6,0,0,23
1979759,1506055,2025-03-05,House,"(H) 3rd Reading Passed",77,21,0,2,100
1979759,1526829,2025-03-25,Senate,"(S) Education and Cultural Resources--Be Concurred In As Amended",8,6,0,0,14
1979759,1537752,2025-04-05,Senate,"(S) 2nd Reading Concurred",33,17,0,0,50
1979759,1541590,2025-04-09,Senate,"(S) Finance and Claims--Be Concurred In",13,9,0,0,22
1979759,1544154,2025-04-10,Senate,"(S) 3rd Reading Concurred",35,13,0,2,50
1979759,1549781,2025-04-16,House,"(H) 2nd Reading Senate Amendments Concurred",97,3,0,0,100
1979759,1551579,2025-04-17,House,"(H) 3rd Reading Passed as Amended by Senate",79,20,0,1,100
1979780,1502396,2025-02-28,Senate,"(S) Judiciary--Do Pass As Amended",8,0,0,0,8
1979780,1506259,2025-03-05,Senate,"(S) 2nd Reading Passed",50,0,0,0,50
1979780,1533454,2025-04-01,Senate,"(S) Finance and Claims--Do Pass",22,0,0,0,22
1979780,1536700,2025-04-03,Senate,"(S) 3rd Reading Passed",50,0,0,0,50
1979780,1549601,2025-04-16,House,"(H) Judiciary--Be Concurred In As Amended",20,0,0,0,20
1979780,1553591,2025-04-22,House,"(H) 2nd Reading Motion to Amend Carried",99,1,0,0,100
1979780,1553592,2025-04-22,House,"(H) 2nd Reading Concurred as Amended",100,0,0,0,100
1979780,1556689,2025-04-24,House,"(H) 3rd Reading Concurred",99,0,0,1,100
1979803,1502599,2025-02-28,House,"(H) Natural Resources--Do Pass",8,6,0,0,14
1979803,1506489,2025-03-05,House,"(H) 2nd Reading Passed",98,1,0,1,100
1979803,1508527,2025-03-07,House,"(H) 3rd Reading Passed",99,0,0,1,100
1979803,1539236,2025-04-07,Senate,"(S) Natural Resources--Be Concurred In As Amended",11,0,0,0,11
1979803,1543348,2025-04-10,Senate,"(S) 2nd Reading Concurred",50,0,0,0,50
1979803,1546338,2025-04-11,Senate,"(S) 3rd Reading Concurred",48,0,0,2,50
1979803,1550146,2025-04-16,House,"(H) 2nd Reading Senate Amendments Concurred",99,1,0,0,100
1979803,1551648,2025-04-17,House,"(H) 3rd Reading Passed as Amended by Senate",98,1,0,1,100
1979818,1504107,2025-03-03,House,"(H) Natural Resources--To Table",9,5,0,0,14
1979834,1502941,2025-03-01,House,"(H) Judiciary--Do Pass As Amended",12,8,0,0,20
1979834,1507040,2025-03-06,House,"(H) 2nd Reading Passed",57,42,0,1,100
1979834,1508506,2025-03-07,House,"(H) 3rd Reading Passed",57,42,0,1,100
1979834,1529907,2025-03-28,Senate,"(S) Judiciary--Be Concurred In",5,3,0,0,8
1979834,1547491,2025-04-14,Senate,"(S) 2nd Reading Concurred",33,17,0,0,50
1979834,1548408,2025-04-15,Senate,"(S) 3rd Reading Concurred",34,16,0,0,50
1979836,1504115,2025-03-03,Senate,"(S) Public Health, Welfare and Safety--To Table",11,0,0,0,11
1979836,1504116,2025-03-03,Senate,"(S) Public Health, Welfare and Safety--Do Pass",4,7,0,0,11
1979836,1506991,2025-03-05,Senate,"(S) Motion Failed",17,33,0,0,50
1979838,1502566,2025-02-28,House,"(H) Taxation--To Table",21,0,0,0,21
1979844,1503067,2025-03-01,House,"(H) Judiciary--Do Pass",12,8,0,0,20
1979844,1506056,2025-03-05,House,"(H) 2nd Reading Motion to Amend Failed",3,96,0,1,100
1979844,1506057,2025-03-05,House,"(H) 2nd Reading Passed",56,42,0,2,100
1979844,1508716,2025-03-07,House,"(H) 3rd Reading Passed",57,41,0,2,100
1979844,1537233,2025-04-04,Senate,"(S) Judiciary--Be Concurred In",5,3,0,0,8
1979844,1547504,2025-04-14,Senate,"(S) 2nd Reading Motion to Amend Failed",18,31,0,1,50
1979844,1547505,2025-04-14,Senate,"(S) 2nd Reading Concurred",31,19,0,0,50
1979844,1548414,2025-04-15,Senate,"(S) 3rd Reading Concurred",31,19,0,0,50
1979848,1502576,2025-02-28,House,"(H) Judiciary--Do Pass",12,8,0,0,20
1979848,1506018,2025-03-05,House,"(H) 2nd Reading Not Passed",32,67,0,1,100
1979850,1501973,2025-02-27,House,"(H) State Administration--Do Pass",19,0,0,0,19
1979850,1508046,2025-03-06,House,"(H) 2nd Reading Passed",97,2,0,1,100
1979850,1508816,2025-03-07,House,"(H) 3rd Reading Passed",96,3,0,1,100
1979850,1528450,2025-03-26,Senate,"(S) State Administration--Be Concurred In",9,0,0,0,9
1979850,1547602,2025-04-14,Senate,"(S) 2nd Reading Concurred",50,0,0,0,50
1979850,1549040,2025-04-15,Senate,"(S) 3rd Reading Concurred",50,0,0,0,50
1979852,1501693,2025-02-26,House,"(H) State Administration--Do Pass",19,0,0,0,19
1979852,1503586,2025-03-03,House,"(H) 2nd Reading Passed",79,20,0,1,100
1979852,1504901,2025-03-04,House,"(H) Appropriations--To Table",13,10,0,0,23
1979852,1507071,2025-03-05,House,"(H) Motion Failed",50,48,0,2,100
1979852,1507072,2025-03-04,House,"(H) Appropriations--To Table",13,10,0,0,23
1979858,1501110,2025-02-27,Senate,"(S) Judiciary--To Table",5,3,0,0,8
1979860,1502715,2025-02-28,Senate,"(S) Local Government--Do Pass",10,1,0,0,11
1979860,1507395,2025-03-06,Senate,"(S) 2nd Reading Passed",46,3,0,1,50
1979860,1507962,2025-03-06,Senate,"(S) 3rd Reading Passed",47,2,0,1,50
1979860,1540351,2025-04-08,House,"(H) Local Government--To Table",10,7,0,0,17
1979860,1544322,2025-04-08,House,"(H) Local Government--To Table",10,7,0,0,17
1979862,1504308,2025-02-28,Senate,"(S) Public Health, Welfare and Safety--To Table",11,0,0,0,11
1979869,1503046,2025-03-01,House,"(H) Judiciary--Do Pass As Amended",20,0,0,0,20
1979869,1503737,2025-03-03,House,"(H) 2nd Reading Passed",93,5,0,2,100
1979869,1504955,2025-03-04,House,"(H) Appropriations--Do Pass",15,8,0,0,23
1979869,1506120,2025-03-05,House,"(H) 3rd Reading Passed",94,4,0,2,100
1979869,1541509,2025-04-09,Senate,"(S) Judiciary--Be Concurred In As Amended",8,0,0,0,8
1979869,1546603,2025-04-12,Senate,"(S) 2nd Reading Concurred",45,5,0,0,50
1979869,1551001,2025-04-16,Senate,"(S) Finance and Claims--Be Concurred In As Amended",22,0,0,0,22
1979869,1553580,2025-04-22,Senate,"(S) 2nd Reading Concurred",48,2,0,0,50
1979869,1555390,2025-04-23,Senate,"(S) 3rd Reading Concurred",48,2,0,0,50
1979869,1558151,2025-04-25,House,"(H) 2nd Reading Senate Amendments Concurred",100,0,0,0,100
1979869,1558778,2025-04-28,House,"(H) 3rd Reading Passed as Amended by Senate",99,1,0,0,100
1979871,1502328,2025-02-27,House,"(H) Local Government--To Table",16,1,0,0,17
1979873,1502424,2025-02-28,House,"(H) Judiciary--To Table",18,2,0,0,20
1979874,1502881,2025-02-28,House,"(H) Energy, Technology and Federal Relations--To Table",14,0,0,0,14
1979874,1504164,2025-03-04,House,"(H) Energy, Technology and Federal Relations--Do Pass",12,2,0,0,14
1979874,1506723,2025-03-05,House,"(H) 2nd Reading Passed",66,32,0,2,100
1979874,1508645,2025-03-07,House,"(H) 3rd Reading Passed",60,39,0,1,100
1979874,1541234,2025-04-08,Senate,"(S) Energy, Technology & Federal Relations--Be Concurred In As Amended",13,0,0,0,13
1979874,1545278,2025-04-10,Senate,"(S) 2nd Reading Concurred",46,2,0,2,50
1979874,1546459,2025-04-11,Senate,"(S) 3rd Reading Concurred",42,6,0,2,50
1979874,1549697,2025-04-16,House,"(H) 2nd Reading Senate Amendments Concurred",97,3,0,0,100
1979874,1551989,2025-04-17,House,"(H) 3rd Reading Passed as Amended by Senate",61,38,0,1,100
1979882,1524713,2025-03-24,Senate,"(S) Taxation--Do Pass",8,0,0,0,8
1979882,1533433,2025-04-01,Senate,"(S) 2nd Reading Passed",50,0,0,0,50
1979882,1534832,2025-04-02,Senate,"(S) Finance and Claims--Do Pass",22,0,0,0,22
1979882,1536672,2025-04-03,Senate,"(S) 3rd Reading Passed",50,0,0,0,50
1979882,1551090,2025-04-17,House,"(H) Taxation--To Table",20,1,0,0,21
1979882,1552104,2025-04-17,House,"(H) Taxation--To Table",20,1,0,0,21
1979882,1552105,2025-04-18,House,"(H) Taxation--Be Concurred In As Amended",14,7,0,0,21
1979882,1555130,2025-04-23,House,"(H) 2nd Reading Concurred",90,9,0,1,100
1979882,1555847,2025-04-23,House,"(H) Appropriations--Be Concurred In",17,6,0,0,23
1979882,1558105,2025-04-25,House,"(H) 3rd Reading Concurred",82,18,0,0,100
1979882,1559580,2025-04-28,Senate,"(S) 2nd Reading House Amendments Concurred",48,1,0,1,50
1979882,1559953,2025-04-29,Senate,"(S) 3rd Reading Passed as Amended by House",50,0,0,0,50
1979886,1502028,2025-02-27,House,"(H) Business and Labor--Do Pass As Amended",20,0,0,0,20
1979886,1506949,2025-03-05,House,"(H) 2nd Reading Passed",97,2,0,1,100
1979886,1508515,2025-03-07,House,"(H) 3rd Reading Passed",98,1,0,1,100
1979886,1527974,2025-03-26,Senate,"(S) Business, Labor  and Economic Affairs--Be Concurred In",12,0,0,0,12
1979886,1547593,2025-04-14,Senate,"(S) 2nd Reading Concurred",50,0,0,0,50
1979886,1549027,2025-04-15,Senate,"(S) 3rd Reading Concurred",50,0,0,0,50
1979888,1530536,2025-03-28,House,"(H) Education--To Table",9,6,0,0,15
1979893,1503641,2025-03-03,House,"(H) Natural Resources--To Table",9,5,0,0,14
1979896,1502858,2025-02-28,Senate,"(S) Highways and Transportation--To Table",6,2,0,0,8
1979900,1519255,2025-03-17,House,"(H) Transportation--Do Pass",14,0,0,0,14
1979900,1526159,2025-03-25,House,"(H) 2nd Reading Passed",95,5,0,0,100
1979900,1528224,2025-03-26,House,"(H) 3rd Reading Passed",93,6,0,1,100
1979900,1531211,2025-03-31,Senate,"(S) Highways and Transportation--Be Concurred In",7,1,0,0,8
1979900,1552166,2025-04-18,Senate,"(S) 2nd Reading Concurred",47,2,0,1,50
1979900,1553933,2025-04-22,Senate,"(S) 3rd Reading Concurred",44,6,0,0,50
1979901,1503529,2025-03-03,House,"(H) Natural Resources--To Table",8,6,0,0,14
1979907,1502611,2025-02-28,Senate,"(S) Local Government--Do Pass As Amended",10,1,0,0,11
1979907,1506926,2025-03-05,Senate,"(S) 2nd Reading Passed",49,1,0,0,50
1979907,1507547,2025-03-06,Senate,"(S) 3rd Reading Passed",48,2,0,0,50
1979907,1541324,2025-04-08,House,"(H) Local Government--To Table",17,0,0,0,17
1979907,1544927,2025-04-08,House,"(H) Local Government--To Table",17,0,0,0,17
1979909,1502948,2025-03-01,House,"(H) Judiciary--Do Pass",12,8,0,0,20
1979909,1506745,2025-03-05,House,"(H) 2nd Reading Passed",57,42,0,1,100
1979909,1508732,2025-03-07,House,"(H) 3rd Reading Passed",59,40,0,1,100
1979909,1537222,2025-04-04,Senate,"(S) Judiciary--Be Concurred In As Amended",5,3,0,0,8
1979909,1548836,2025-04-04,Senate,"(S) Judiciary--Be Concurred In",5,3,0,0,8
1979909,1548837,2025-04-07,Senate,"(S) 2nd Reading Motion to Amend Failed",22,28,0,0,50
1979909,1548838,2025-04-07,Senate,"(S) 2nd Reading Concurred",29,21,0,0,50
1979909,1548839,2025-04-08,Senate,"(S) 3rd Reading Concurred",29,19,0,2,50
1979911,1521380,2025-03-19,Senate,"(S) Highways and Transportation--Resolution Adopted",8,0,0,0,8
1979911,1531477,2025-03-31,Senate,"(S) 2nd Reading Passed",33,17,0,0,50
1979911,1533561,2025-04-01,Senate,"(S) 3rd Reading Passed",30,20,0,0,50
1979911,1543127,2025-04-09,House,"(H) Transportation--Be Concurred In",9,5,0,0,14
1979911,1555399,2025-04-23,House,"(H) 2nd Reading Concurred",51,49,0,0,100
1979911,1556814,2025-04-24,House,"(H) 3rd Reading Concurred",54,46,0,0,100
1979919,1504371,2025-03-04,Senate,"(S) Business, Labor  and Economic Affairs--Do Pass",12,0,0,0,12
1979919,1506522,2025-03-05,Senate,"(S) 2nd Reading Passed",34,15,0,1,50
1979919,1507863,2025-03-06,Senate,"(S) 3rd Reading Passed",36,14,0,0,50
1979919,1525952,2025-03-25,House,"(H) Business and Labor--Be Concurred In",20,0,0,0,20
1979919,1529714,2025-03-27,House,"(H) 2nd Reading Concurred",88,12,0,0,100
1979919,1529998,2025-03-28,House,"(H) 3rd Reading Concurred",87,12,0,1,100
1979923,1502955,2025-03-01,House,"(H) Fish, Wildlife and Parks--Do Pass As Amended",20,0,0,0,20
1979923,1506818,2025-03-05,House,"(H) 2nd Reading Passed",98,1,0,1,100
1979923,1508526,2025-03-07,House,"(H) 3rd Reading Passed",97,2,0,1,100
1979923,1541211,2025-04-08,Senate,"(S) Fish and Game--Be Concurred In",11,0,0,0,11
1979923,1547248,2025-04-14,Senate,"(S) 2nd Reading Concurred",50,0,0,0,50
1979923,1548597,2025-04-15,Senate,"(S) 3rd Reading Concurred",46,4,0,0,50
1979924,1503868,2025-02-26,House,"(H) State Administration--To Table",18,1,0,0,19
1979926,1502316,2025-02-28,House,"(H) Judiciary--Do Pass",11,9,0,0,20
1979926,1506481,2025-03-05,House,"(H) 2nd Reading Not Passed",48,51,0,1,100
1979932,1502183,2025-02-27,House,"(H) Local Government--Do Pass",10,7,0,0,17
1979932,1506919,2025-03-05,House,"(H) 2nd Reading Passed",57,42,0,1,100
1979932,1508521,2025-03-07,House,"(H) 3rd Reading Passed",57,42,0,1,100
1979932,1538988,2025-04-07,Senate,"(S) Local Government--To Table",8,2,0,0,10
1979932,1543312,2025-04-07,Senate,"(S) Local Government--To Table",8,2,0,0,10
1979935,1501880,2025-02-27,House,"(H) Agriculture--Do Pass As Amended",11,6,0,0,17
1979935,1520161,2025-03-18,House,"(H) 2nd Reading Not Passed",48,51,0,1,100
1979935,1521153,2025-03-19,House,"(H) Reconsidered Previous Action; Placed on 2nd Reading",45,54,0,1,100
1979935,1523355,2025-03-19,House,"(H) Motion to Reconsider Failed",45,54,0,1,100
1979935,1523356,2025-02-27,House,"(H) Agriculture--Do Pass As Amended",11,6,0,0,17
1979935,1523357,2025-03-18,House,"(H) 2nd Reading Not Passed",48,51,0,1,100
1979937,1502049,2025-02-27,House,"(H) Fish, Wildlife and Parks--To Table",12,8,0,0,20
1979944,1499495,2025-02-25,House,"(H) Business and Labor--Do Pass",17,3,0,0,20
1979944,1506933,2025-03-05,House,"(H) 2nd Reading Passed",82,17,0,1,100
1979944,1508730,2025-03-07,House,"(H) 3rd Reading Failed",42,57,0,1,100
1979945,1502953,2025-03-01,House,"(H) State Administration--Do Pass As Amended",11,8,0,0,19
1979945,1506803,2025-03-05,House,"(H) 2nd Reading Not Passed",47,52,0,1,100
1979947,1505583,2025-03-04,Senate,"(S) State Administration--To Table",9,0,0,0,9
1979952,1502642,2025-02-28,House,"(H) Taxation--To Table",20,1,0,0,21
1979957,1502956,2025-03-01,House,"(H) Business and Labor--Do Pass As Amended",14,6,0,0,20
1979957,1507692,2025-03-06,House,"(H) 2nd Reading Passed",93,6,0,1,100
1979957,1508554,2025-03-07,House,"(H) 3rd Reading Passed",84,15,0,1,100
1979957,1527868,2025-03-26,Senate,"(S) Business, Labor  and Economic Affairs--Be Concurred In",9,3,0,0,12
1979957,1544280,2025-04-10,Senate,"(S) 2nd Reading Concurred",37,12,0,1,50
1979957,1546218,2025-04-11,Senate,"(S) 3rd Reading Concurred",35,13,0,2,50
1979960,1502986,2025-03-01,Senate,"(S) Business, Labor  and Economic Affairs--To Table",11,1,0,0,12
1979960,1503413,2025-03-03,Senate,"(S) 2nd Reading Passed",32,17,0,1,50
1979960,1503414,2025-03-03,Senate,"(S) Reconsidered Previous Action; Placed on 2nd Reading",50,0,0,0,50
1979960,1505480,2025-03-04,Senate,"(S) 2nd Reading Motion to Amend Carried",49,1,0,0,50
1979960,1505481,2025-03-04,Senate,"(S) 2nd Reading Passed as Amended",36,14,0,0,50
1979960,1505855,2025-03-05,Senate,"(S) 3rd Reading Passed",32,17,0,1,50
1979960,1542480,2025-04-09,House,"(H) Business and Labor--Be Concurred In As Amended",20,0,0,0,20
1979960,1544186,2025-04-10,House,"(H) Appropriations--Be Concurred In",17,6,0,0,23
1979960,1546037,2025-04-11,House,"(H) 2nd Reading Concurred",61,38,0,1,100
1979960,1546490,2025-04-11,House,"(H) 3rd Reading Concurred",64,35,0,1,100
1979960,1550226,2025-04-16,Senate,"(S) 2nd Reading House Amendments Concurred",39,11,0,0,50
1979960,1551161,2025-04-17,Senate,"(S) 3rd Reading Passed as Amended by House",37,13,0,0,50
1979962,1501977,2025-02-27,Senate,"(S) Agriculture, Livestock and Irrigation--Do Pass As Amended",8,0,0,3,11
1979962,1507018,2025-03-06,Senate,"(S) 2nd Reading Passed",41,9,0,0,50
1979962,1508329,2025-03-06,Senate,"(S) 3rd Reading Passed",40,9,0,1,50
1979962,1529748,2025-03-27,House,"(H) Agriculture--Be Concurred In",17,0,0,0,17
1979962,1545218,2025-04-10,House,"(H) 2nd Reading Concurred",99,1,0,0,100
1979962,1546414,2025-04-11,House,"(H) 3rd Reading Concurred",97,2,0,1,100
1979964,1503057,2025-03-01,Senate,"(S) Business, Labor  and Economic Affairs--To Table",11,1,0,0,12
1980591,1502895,2025-02-28,House,"(H) Education--Do Pass",15,0,0,0,15
1980591,1506969,2025-03-05,House,"(H) 2nd Reading Passed",99,0,0,1,100
1980591,1508815,2025-03-07,House,"(H) 3rd Reading Passed",99,0,0,1,100
1980591,1540763,2025-04-08,Senate,"(S) Education and Cultural Resources--To Table",14,0,0,0,14
1980591,1543560,2025-04-08,Senate,"(S) Education and Cultural Resources--To Table",14,0,0,0,14
1980591,1549460,2025-04-15,Senate,"(S) Education and Cultural Resources--To Take From The Table",5,6,3,0,14
1980591,1549804,2025-04-16,Senate,"(S) Motion Failed",25,25,0,0,50
1980591,1550812,2025-04-15,Senate,"(S) Education and Cultural Resources--To Take From The Table",5,6,3,0,14
1980591,1551338,2025-04-17,Senate,"(S) Taken from Committee; Placed on 2nd Reading",26,23,0,1,50
1980591,1554712,2025-04-22,Senate,"(S) 2nd Reading Concurred",28,21,0,1,50
1980591,1578753,2025-04-08,Senate,"(S) Education and Cultural Resources--To Table",14,0,0,0,14
1980591,1578754,2025-04-23,Senate,"(S) 3rd Reading Concurred",33,17,0,0,50
1980601,1502548,2025-02-28,House,"(H) Energy, Technology and Federal Relations--To Table",14,0,0,0,14
1980612,1502749,2025-02-28,House,"(H) Education--Do Pass As Amended",8,7,0,0,15
1980612,1506574,2025-03-05,House,"(H) 2nd Reading Passed",56,43,0,1,100
1980612,1508660,2025-03-07,House,"(H) 3rd Reading Passed",58,41,0,1,100
1980612,1541100,2025-04-08,Senate,"(S) Education and Cultural Resources--To Table",14,0,0,0,14
1980612,1544018,2025-04-08,Senate,"(S) Education and Cultural Resources--To Table",14,0,0,0,14
1980612,1583034,2025-04-08,Senate,"(S) Education and Cultural Resources--To Table",14,0,0,0,14
1980622,1503027,2025-03-01,House,"(H) Judiciary--Do Pass As Amended",20,0,0,0,20
1980622,1506058,2025-03-05,House,"(H) 2nd Reading Passed",99,0,0,1,100
1980622,1508631,2025-03-07,House,"(H) 3rd Reading Passed",99,0,0,1,100
1980622,1537475,2025-04-04,Senate,"(S) Judiciary--Be Concurred In",5,3,0,0,8
1980622,1549146,2025-04-15,Senate,"(S) 2nd Reading Concurred",38,12,0,0,50
1980622,1550431,2025-04-16,Senate,"(S) 3rd Reading Concurred",36,14,0,0,50
1980633,1502944,2025-03-01,House,"(H) Judiciary--Do Pass",20,0,0,0,20
1980633,1508077,2025-03-06,House,"(H) 2nd Reading Passed",99,0,0,1,100
1980633,1508640,2025-03-07,House,"(H) 3rd Reading Passed",98,1,0,1,100
1980633,1541599,2025-04-09,Senate,"(S) Judiciary--To Table",5,3,0,0,8
1980633,1543305,2025-04-09,Senate,"(S) Judiciary--To Table",5,3,0,0,8
1980633,1545151,2025-04-10,Senate,"(S) Motion Failed",23,25,0,2,50
1980633,1545604,2025-04-11,Senate,"(S) Judiciary--To Take From The Table",2,3,3,0,8
1980633,1548137,2025-04-11,Senate,"(S) Judiciary--To Take From The Table",2,3,3,0,8
1980644,1502811,2025-02-28,House,"(H) Natural Resources--Do Pass",13,1,0,0,14
1980644,1507310,2025-03-06,House,"(H) 2nd Reading Passed",70,29,0,1,100
1980644,1508647,2025-03-07,House,"(H) 3rd Reading Passed",69,30,0,1,100
1980644,1542550,2025-04-09,Senate,"(S) Natural Resources--Be Concurred In",7,4,0,0,11
1980644,1547184,2025-04-14,Senate,"(S) 2nd Reading Concurred",34,16,0,0,50
1980644,1548853,2025-04-15,Senate,"(S) 3rd Reading Concurred",34,16,0,0,50
1980654,1501759,2025-02-27,House,"(H) Business and Labor--Do Pass",20,0,0,0,20
1980654,1506916,2025-03-05,House,"(H) 2nd Reading Passed",95,4,0,1,100
1980654,1508510,2025-03-07,House,"(H) 3rd Reading Passed",97,2,0,1,100
1980654,1534669,2025-04-02,Senate,"(S) Business, Labor  and Economic Affairs--Be Concurred In As Amended",9,2,0,0,11
1980654,1537707,2025-04-05,Senate,"(S) 2nd Reading Concurred",32,18,0,0,50
1980654,1538595,2025-04-07,Senate,"(S) 3rd Reading Concurred",32,17,0,1,50
1980654,1550002,2025-04-16,House,"(H) 2nd Reading Senate Amendments Concurred",99,1,0,0,100
1980654,1551964,2025-04-17,House,"(H) 3rd Reading Passed as Amended by Senate",90,9,0,1,100
1980665,1502024,2025-02-27,House,"(H) Business and Labor--Do Pass",20,0,0,0,20
1980665,1508040,2025-03-06,House,"(H) 2nd Reading Passed",93,6,0,1,100
1980665,1508514,2025-03-07,House,"(H) 3rd Reading Passed",91,8,0,1,100
1980665,1527848,2025-03-26,Senate,"(S) Business, Labor  and Economic Affairs--Be Concurred In",11,1,0,0,12
1980665,1543450,2025-04-10,Senate,"(S) 2nd Reading Concurred",31,18,0,1,50
1980665,1546383,2025-04-11,Senate,"(S) 3rd Reading Concurred",33,15,0,2,50
1980676,1502482,2025-02-28,House,"(H) Taxation--Do Pass",20,1,0,0,21
1980676,1506830,2025-03-05,House,"(H) 2nd Reading Passed",98,0,0,2,100
1980676,1508711,2025-03-07,House,"(H) 3rd Reading Passed",99,0,0,1,100
1980676,1537349,2025-04-04,Senate,"(S) Taxation--Be Concurred In",8,0,0,0,8
1980676,1547720,2025-04-14,Senate,"(S) 2nd Reading Concurred",49,1,0,0,50
1980676,1548706,2025-04-15,Senate,"(S) 3rd Reading Concurred",49,1,0,0,50
1980677,1502545,2025-02-28,House,"(H) Transportation--Do Pass",14,0,0,0,14
1980677,1507922,2025-03-06,House,"(H) 2nd Reading Passed",99,0,0,1,100
1980677,1508722,2025-03-07,House,"(H) 3rd Reading Passed",99,0,0,1,100
1980677,1531294,2025-03-27,Senate,"(S) Energy, Technology & Federal Relations--Be Concurred In",8,0,0,5,13
1980677,1549301,2025-04-15,Senate,"(S) 2nd Reading Concurred",49,0,0,1,50
1980677,1550048,2025-04-16,Senate,"(S) 3rd Reading Concurred",50,0,0,0,50
1980696,1501834,2025-02-27,House,"(H) State Administration--To Table",19,0,0,0,19
1980716,1503547,2025-03-03,House,"(H) Judiciary--Do Pass As Amended",11,9,0,0,20
1980716,1505698,2025-03-05,House,"(H) 2nd Reading Passed",53,46,0,1,100
1980716,1507580,2025-03-06,House,"(H) Appropriations--Do Pass",12,11,0,0,23
1980716,1508511,2025-03-07,House,"(H) 3rd Reading Passed",56,43,0,1,100
1980716,1529910,2025-03-28,Senate,"(S) Judiciary--Be Concurred In As Amended",5,3,0,0,8
1980716,1546583,2025-04-12,Senate,"(S) 2nd Reading Concurred",33,17,0,0,50
1980716,1546584,2025-04-12,Senate,"(S) 3rd Reading Concurred",31,19,0,0,50
1980716,1546724,2025-04-12,Senate,"(S) 3rd Reading Concurred",31,19,0,0,50
1980716,1550094,2025-04-16,House,"(H) 2nd Reading Senate Amendments Concurred",97,3,0,0,100
1980716,1551812,2025-04-17,House,"(H) 3rd Reading Passed as Amended by Senate",52,47,0,1,100
1980739,1501551,2025-02-27,House,"(H) State Administration--Do Pass",10,9,0,0,19
1980739,1506770,2025-03-05,House,"(H) 2nd Reading Passed",74,25,0,1,100
1980739,1508513,2025-03-07,House,"(H) 3rd Reading Passed",65,34,0,1,100
1980739,1536348,2025-04-03,Senate,"(S) Legislative Administration--To Table",4,2,0,0,6
1980739,1537338,2025-04-03,Senate,"(S) Legislative Administration--To Table",4,2,0,0,6
1980739,1558044,2025-04-25,Senate,"(S) Motion Failed",21,28,0,1,50
1980739,1559208,2025-04-28,Senate,"(S) Motion Failed",19,30,0,1,50
1980763,1536018,2025-04-02,Senate,"(S) Judiciary--Do Pass As Amended",8,1,0,0,9
1980763,1537555,2025-04-04,Senate,"(S) 2nd Reading Passed",50,0,0,0,50
1980763,1537732,2025-04-05,Senate,"(S) 3rd Reading Passed",48,0,0,2,50
1980763,1549740,2025-04-16,House,"(H) Judiciary--Be Concurred In",16,4,0,0,20
1980763,1554395,2025-04-22,House,"(H) 2nd Reading Concurred",81,19,0,0,100
1980763,1555403,2025-04-23,House,"(H) 3rd Reading Concurred",78,21,0,1,100
1980788,1503035,2025-03-01,House,"(H) Judiciary--Do Pass As Amended",12,8,0,0,20
1980788,1508070,2025-03-06,House,"(H) 2nd Reading Not Passed",37,62,0,1,100
1980811,1502992,2025-03-01,House,"(H) Business and Labor--Do Pass",17,3,0,0,20
1980811,1506713,2025-03-05,House,"(H) 2nd Reading Passed",98,1,0,1,100
1980811,1508534,2025-03-07,House,"(H) 3rd Reading Passed",99,0,0,1,100
1980811,1530050,2025-03-28,Senate,"(S) Business, Labor  and Economic Affairs--Be Concurred In As Amended",12,0,0,0,12
1980811,1537745,2025-04-05,Senate,"(S) 2nd Reading Concurred",49,1,0,0,50
1980811,1538873,2025-04-07,Senate,"(S) 3rd Reading Concurred",47,2,0,1,50
1980811,1549751,2025-04-16,House,"(H) 2nd Reading Senate Amendments Concurred",95,5,0,0,100
1980811,1551552,2025-04-17,House,"(H) 3rd Reading Passed as Amended by Senate",94,5,0,1,100
1980835,1501832,2025-02-27,House,"(H) State Administration--Do Pass",16,3,0,0,19
1980835,1506073,2025-03-05,House,"(H) 2nd Reading Passed",94,4,0,2,100
1980835,1508546,2025-03-07,House,"(H) 3rd Reading Passed",96,3,0,1,100
1980835,1555574,2025-04-23,Senate,"(S) State Administration--Be Concurred In",9,0,0,0,9
1980835,1558308,2025-04-25,Senate,"(S) 2nd Reading Concurred",42,6,0,2,50
1980835,1559237,2025-04-28,Senate,"(S) 3rd Reading Concurred",45,4,0,1,50
1980860,1502122,2025-02-27,Senate,"(S) Fish and Game--Do Pass As Amended",11,1,0,0,12
1980860,1508143,2025-03-06,Senate,"(S) 2nd Reading Passed",30,20,0,0,50
1980860,1508144,2025-03-06,Senate,"(S) 3rd Reading Passed",32,17,0,1,50
1980860,1540995,2025-04-08,House,"(H) Fish, Wildlife and Parks--To Table",12,8,0,0,20
1980860,1543863,2025-04-08,House,"(H) Fish, Wildlife and Parks--To Table",12,8,0,0,20
1980886,1501246,2025-02-27,House,"(H) State Administration--Do Pass",19,0,0,0,19
1980886,1504599,2025-03-04,House,"(H) 2nd Reading Passed",78,21,0,1,100
1980886,1505713,2025-03-05,House,"(H) 3rd Reading Passed",71,27,0,2,100
1980886,1533100,2025-03-26,Senate,"(S) State Administration--Be Concurred In",8,1,0,0,9
1980886,1549176,2025-04-15,Senate,"(S) 2nd Reading Concurred",49,0,0,1,50
1980886,1550105,2025-04-16,Senate,"(S) 3rd Reading Concurred",50,0,0,0,50
1980908,1500594,2025-02-26,House,"(H) State Administration--To Table",19,0,0,0,19
1980934,1503370,2025-03-03,House,"(H) Judiciary--Do Pass As Amended",12,8,0,0,20
1980934,1506533,2025-03-05,House,"(H) 2nd Reading Motion to Amend Carried",55,41,0,4,100
1980934,1506534,2025-03-05,House,"(H) 2nd Reading Passed as Amended",57,41,0,2,100
1980934,1508614,2025-03-07,House,"(H) 3rd Reading Passed",57,42,0,1,100
1980934,1538685,2025-04-07,Senate,"(S) Judiciary--Be Concurred In As Amended",5,3,0,0,8
1980934,1544781,2025-04-10,Senate,"(S) 2nd Reading Concurred",30,18,0,2,50
1980934,1545984,2025-04-11,Senate,"(S) 3rd Reading Concurred",30,18,0,2,50
1980934,1550021,2025-04-16,House,"(H) 2nd Reading Senate Amendments Not Concurred",49,51,0,0,100
1980934,1560162,2025-04-29,Senate,"(S) 2nd Reading Free Conference Committee Report Adopted",44,6,0,0,50
1980934,1560163,2025-04-29,House,"(H) 2nd Reading Free Conference Committee Report Adopted",98,2,0,0,100
1980934,1562328,2025-04-30,House,"(H) 3rd Reading Free Conference Committee Report Adopted",57,43,0,0,100
1980934,1562329,2025-04-30,Senate,"(S) 3rd Reading Free Conference Committee Report Adopted",32,18,0,0,50
1980959,1536073,2025-04-02,Senate,"(S) Judiciary--Do Pass As Amended",8,1,0,0,9
1980959,1537556,2025-04-04,Senate,"(S) 2nd Reading Passed",46,2,0,2,50
1980959,1537728,2025-04-05,Senate,"(S) 3rd Reading Passed",48,0,0,2,50
1980959,1549766,2025-04-16,House,"(H) Judiciary--Be Concurred In",16,4,0,0,20
1980959,1552113,2025-04-18,House,"(H) 2nd Reading Concurred",83,16,0,1,100
1980959,1554360,2025-04-22,House,"(H) Appropriations--Be Concurred In",22,0,1,0,23
1980959,1557239,2025-04-24,House,"(H) 3rd Reading Concurred",80,20,0,0,100
1980983,1502209,2025-02-27,House,"(H) Local Government--Do Pass",14,3,0,0,17
1980983,1506800,2025-03-05,House,"(H) 2nd Reading Passed",92,7,0,1,100
1980983,1508549,2025-03-07,House,"(H) 3rd Reading Passed",88,11,0,1,100
1980983,1539232,2025-04-07,Senate,"(S) Natural Resources--Be Concurred In As Amended",11,0,0,0,11
1980983,1544102,2025-04-10,Senate,"(S) 2nd Reading Concurred",49,0,0,1,50
1980983,1546337,2025-04-11,Senate,"(S) 3rd Reading Concurred",46,2,0,2,50
1980983,1550645,2025-04-16,House,"(H) 2nd Reading Senate Amendments Concurred",93,7,0,0,100
1980983,1551932,2025-04-17,House,"(H) 3rd Reading Passed as Amended by Senate",95,4,0,1,100
1981006,1502182,2025-02-27,House,"(H) Local Government--Do Pass As Amended",17,0,0,0,17
1981006,1503629,2025-03-03,House,"(H) 2nd Reading Passed",93,6,0,1,100
1981006,1504968,2025-03-04,House,"(H) Appropriations--Do Pass",18,5,0,0,23
1981006,1507100,2025-03-06,House,"(H) 3rd Reading Passed",87,12,0,1,100
1981006,1540426,2025-04-07,Senate,"(S) Local Government--Be Concurred In As Amended",6,4,0,0,10
1981006,1544609,2025-04-10,Senate,"(S) 2nd Reading Motion to Amend Carried",38,12,0,0,50
1981006,1544610,2025-04-10,Senate,"(S) 2nd Reading Concurred as Amended",43,7,0,0,50
1981006,1545831,2025-04-11,Senate,"(S) Finance and Claims--Be Concurred In",16,6,0,0,22
1981006,1546757,2025-04-12,Senate,"(S) 3rd Reading Concurred",49,1,0,0,50
1981006,1551968,2025-04-17,House,"(H) 2nd Reading Senate Amendments Concurred",100,0,0,0,100
1981006,1552140,2025-04-18,House,"(H) 3rd Reading Passed as Amended by Senate",94,3,0,3,100
1981029,1502952,2025-03-01,House,"(H) Judiciary--Do Pass As Amended",11,9,0,0,20
1981029,1507211,2025-03-06,House,"(H) 2nd Reading Not Passed",44,55,0,1,100
1981054,1504087,2025-03-03,House,"(H) Natural Resources--Do Pass",13,1,0,0,14
1981054,1507552,2025-03-06,House,"(H) 2nd Reading Passed",58,38,0,4,100
1981054,1508646,2025-03-07,House,"(H) 3rd Reading Passed",64,35,0,1,100
1981054,1537562,2025-04-04,Senate,"(S) Natural Resources--Be Concurred In As Amended",11,0,0,0,11
1981054,1542911,2025-04-09,Senate,"(S) 2nd Reading Concurred",42,5,0,3,50
1981054,1545002,2025-04-10,Senate,"(S) 3rd Reading Concurred",42,6,0,2,50
1981054,1550084,2025-04-16,House,"(H) 2nd Reading Senate Amendments Concurred",99,1,0,0,100
1981054,1551561,2025-04-17,House,"(H) 3rd Reading Passed as Amended by Senate",95,3,0,2,100
1981079,1502538,2025-02-28,Senate,"(S) Local Government--Do Pass",8,3,0,0,11
1981079,1508010,2025-03-06,Senate,"(S) 2nd Reading Passed",32,18,0,0,50
1981079,1508011,2025-03-06,Senate,"(S) 3rd Reading Passed",31,18,0,1,50
1981079,1530524,2025-03-28,House,"(H) Transportation--Be Concurred In",14,0,0,0,14
1981079,1544219,2025-04-10,House,"(H) 2nd Reading Concurred",79,21,0,0,100
1981079,1546030,2025-04-11,House,"(H) 3rd Reading Concurred",72,27,0,1,100
1981102,1503859,2025-03-03,House,"(H) Natural Resources--Do Pass",8,6,0,0,14
1981102,1506857,2025-03-05,House,"(H) 2nd Reading Passed",56,43,0,1,100
1981102,1508453,2025-03-07,House,"(H) 3rd Reading Passed",56,43,0,1,100
1981102,1546477,2025-04-11,Senate,"(S) Natural Resources--Be Concurred In",6,5,0,0,11
1981102,1551711,2025-04-17,Senate,"(S) 2nd Reading Concurred",33,17,0,0,50
1981102,1552308,2025-04-18,Senate,"(S) 3rd Reading Concurred",33,17,0,0,50
1981140,1503039,2025-03-01,House,"(H) Judiciary--To Table",20,0,0,0,20
1981149,1502768,2025-02-28,House,"(H) Energy, Technology and Federal Relations--Do Pass As Amended",8,6,0,0,14
1981149,1506627,2025-03-05,House,"(H) 2nd Reading Motion to Amend Failed",48,50,0,2,100
1981149,1506628,2025-03-05,House,"(H) 2nd Reading Passed",64,34,0,2,100
1981149,1508522,2025-03-07,House,"(H) 3rd Reading Passed",63,36,0,1,100
1981149,1533643,2025-04-01,Senate,"(S) Energy, Technology & Federal Relations--Be Concurred In",10,3,0,0,13
1981149,1544906,2025-04-10,Senate,"(S) 2nd Reading Motion to Amend Failed",21,29,0,0,50
1981149,1544907,2025-04-10,Senate,"(S) 2nd Reading Concurred",38,9,0,3,50
1981149,1546060,2025-04-11,Senate,"(S) 3rd Reading Concurred",37,11,0,2,50
1981163,1502440,2025-02-28,House,"(H) State Administration--Do Pass",11,8,0,0,19
1981163,1506833,2025-03-05,House,"(H) 2nd Reading Passed",60,39,0,1,100
1981163,1508587,2025-03-07,House,"(H) 3rd Reading Passed",59,40,0,1,100
1981163,1542970,2025-04-09,Senate,"(S) Local Government--To Table",10,0,0,0,10
1981163,1543484,2025-04-09,Senate,"(S) Local Government--To Table",10,0,0,0,10
1981179,1503053,2025-03-01,Senate,"(S) Energy, Technology & Federal Relations--To Table",11,2,0,0,13
1981179,1505554,2025-03-04,Senate,"(S) Motion Failed",24,26,0,0,50
1981179,1506938,2025-03-05,Senate,"(S) Motion Failed",25,25,0,0,50
1981193,1504136,2025-03-03,Senate,"(S) Public Health, Welfare and Safety--To Table",11,0,0,0,11
1981209,1501972,2025-02-27,House,"(H) Human Services--To Table",17,0,0,4,21
1981222,1502842,2025-02-28,Senate,"(S) State Administration--To Table",9,0,0,0,9
1981222,1504967,2025-03-04,Senate,"(S) Taken from Committee; Placed on 2nd Reading",30,20,0,0,50
1981222,1506767,2025-03-05,Senate,"(S) 2nd Reading Motion to Amend Carried",44,5,0,1,50
1981222,1506768,2025-03-05,Senate,"(S) 2nd Reading Passed as Amended",32,18,0,0,50
1981222,1508129,2025-03-06,Senate,"(S) 3rd Reading Passed",31,18,0,1,50
1981222,1529930,2025-03-28,House,"(H) State Administration--Be Concurred In As Amended",13,6,0,0,19
1981222,1544019,2025-04-10,House,"(H) 2nd Reading Concurred",58,41,0,1,100
1981222,1546096,2025-04-11,House,"(H) 3rd Reading Concurred",58,41,0,1,100
1981222,1549758,2025-04-16,Senate,"(S) 2nd Reading House Amendments Concurred",45,4,0,1,50
1981222,1551538,2025-04-17,Senate,"(S) 3rd Reading Passed as Amended by House",48,2,0,0,50
1981236,1524272,2025-03-21,House,"(H) Energy, Technology and Federal Relations--Do Pass",14,0,0,0,14
1981236,1529011,2025-03-27,House,"(H) 2nd Reading Passed",98,2,0,0,100
1981236,1530454,2025-03-28,House,"(H) 3rd Reading Passed",97,2,0,1,100
1981236,1552342,2025-04-18,Senate,"(S) Highways and Transportation--Resolution Adopted",8,0,0,0,8
1981236,1556748,2025-04-24,Senate,"(S) 2nd Reading Concurred",45,5,0,0,50
1981236,1558063,2025-04-25,Senate,"(S) 3rd Reading Concurred",46,3,0,1,50
1981266,1504526,2025-03-04,Senate,"(S) Business, Labor  and Economic Affairs--To Table",11,1,0,0,12
1981283,1502933,2025-03-01,Senate,"(S) Business, Labor  and Economic Affairs--To Table",11,1,0,0,12
1981298,1501846,2025-02-27,Senate,"(S) Fish and Game--Do Pass",12,0,0,0,12
1981298,1506958,2025-03-05,Senate,"(S) 2nd Reading Passed",49,1,0,0,50
1981298,1508068,2025-03-06,Senate,"(S) 3rd Reading Passed",49,1,0,0,50
1981298,1541012,2025-04-08,House,"(H) Fish, Wildlife and Parks--Be Concurred In",20,0,0,0,20
1981298,1544306,2025-04-10,House,"(H) 2nd Reading Concurred",99,1,0,0,100
1981298,1546411,2025-04-11,House,"(H) 3rd Reading Concurred",98,1,0,1,100
1981314,1503014,2025-03-01,House,"(H) Judiciary--Do Pass",20,0,0,0,20
1981314,1508341,2025-03-06,House,"(H) 2nd Reading Passed",96,0,0,4,100
1981314,1508626,2025-03-07,House,"(H) 3rd Reading Passed",99,0,0,1,100
1981314,1530149,2025-03-28,Senate,"(S) Judiciary--Be Concurred In",7,1,0,0,8
1981314,1544362,2025-04-10,Senate,"(S) 2nd Reading Concurred",39,4,0,7,50
1981314,1546107,2025-04-11,Senate,"(S) 3rd Reading Concurred",47,1,0,2,50
1981327,1502355,2025-02-28,House,"(H) State Administration--To Table",18,1,0,0,19
1981341,1503430,2025-03-03,House,"(H) Natural Resources--Do Pass",8,6,0,0,14
1981341,1508057,2025-03-06,House,"(H) 2nd Reading Passed",57,42,0,1,100
1981341,1508518,2025-03-07,House,"(H) 3rd Reading Passed",58,41,0,1,100
1981341,1539235,2025-04-07,Senate,"(S) Natural Resources--Be Concurred In As Amended",8,3,0,0,11
1981341,1543613,2025-04-10,Senate,"(S) 2nd Reading Concurred",36,12,0,2,50
1981341,1546422,2025-04-11,Senate,"(S) 3rd Reading Concurred",36,12,0,2,50
1981341,1551840,2025-04-17,House,"(H) 2nd Reading Senate Amendments Concurred",98,2,0,0,100
1981341,1552315,2025-04-18,House,"(H) 3rd Reading Passed as Amended by Senate",61,37,0,2,100
1981360,1506583,2025-03-04,House,"(H) Energy, Technology and Federal Relations--To Table",14,0,0,0,14
1981372,1502222,2025-02-28,House,"(H) State Administration--Do Pass As Amended",17,2,0,0,19
1981372,1508058,2025-03-06,House,"(H) 2nd Reading Passed",98,1,0,1,100
1981372,1508814,2025-03-07,House,"(H) 3rd Reading Passed",98,1,0,1,100
1981372,1550855,2025-04-16,Senate,"(S) State Administration--Be Concurred In",9,0,0,0,9
1981372,1555630,2025-04-23,Senate,"(S) 2nd Reading Concurred",43,6,0,1,50
1981372,1557836,2025-04-24,Senate,"(S) 3rd Reading Concurred",50,0,0,0,50
1981386,1502978,2025-03-01,House,"(H) Judiciary--Do Pass",20,0,0,0,20
1981386,1507906,2025-03-06,House,"(H) 2nd Reading Passed",95,3,0,2,100
1981386,1508618,2025-03-07,House,"(H) 3rd Reading Passed",95,4,0,1,100
1981386,1542390,2025-04-09,Senate,"(S) Judiciary--Be Concurred In",8,0,0,0,8
1981386,1546577,2025-04-12,Senate,"(S) 2nd Reading Concurred",48,1,0,1,50
1981386,1546962,2025-04-14,Senate,"(S) 3rd Reading Concurred",46,2,0,2,50
1981403,1502838,2025-02-28,Senate,"(S) Highways and Transportation--Do Pass",7,1,0,0,8
1981403,1506537,2025-03-05,Senate,"(S) 2nd Reading Motion to Amend Carried",50,0,0,0,50
1981403,1506538,2025-03-05,Senate,"(S) 2nd Reading Passed as Amended",48,2,0,0,50
1981403,1508065,2025-03-06,Senate,"(S) 3rd Reading Passed",48,1,0,1,50
1981403,1530299,2025-03-28,House,"(H) Transportation--Be Concurred In",13,1,0,0,14
1981403,1544155,2025-04-10,House,"(H) 2nd Reading Concurred",100,0,0,0,100
1981403,1546257,2025-04-11,House,"(H) 3rd Reading Concurred",98,1,0,1,100
1981414,1503006,2025-03-01,House,"(H) Human Services--Do Pass As Amended",12,9,0,0,21
1981414,1506547,2025-03-05,House,"(H) 2nd Reading Passed",57,42,0,1,100
1981414,1508810,2025-03-07,House,"(H) 3rd Reading Passed",57,42,0,1,100
1981414,1538852,2025-04-07,Senate,"(S) Public Health, Welfare and Safety--Be Concurred In",10,1,0,0,11
1981414,1543110,2025-04-09,Senate,"(S) 2nd Reading Motion to Amend Failed",4,44,0,2,50
1981414,1543111,2025-04-09,Senate,"(S) 2nd Reading Concurred",36,14,0,0,50
1981414,1545064,2025-04-10,Senate,"(S) 3rd Reading Concurred",30,18,0,2,50
1981436,1503002,2025-03-01,House,"(H) Judiciary--Do Pass As Amended",12,8,0,0,20
1981436,1506070,2025-03-05,House,"(H) 2nd Reading Passed",61,38,0,1,100
1981436,1508520,2025-03-07,House,"(H) 3rd Reading Passed",60,39,0,1,100
1981436,1529960,2025-03-28,Senate,"(S) Judiciary--To Table",8,0,0,0,8
1981436,1537069,2025-03-28,Senate,"(S) Judiciary--To Table",8,0,0,0,8
1981451,1502413,2025-02-28,House,"(H) State Administration--Do Pass",11,8,0,0,19
1981451,1507593,2025-03-06,House,"(H) 2nd Reading Passed",58,41,0,1,100
1981451,1508570,2025-03-07,House,"(H) 3rd Reading Passed",57,42,0,1,100
1981451,1542861,2025-04-09,Senate,"(S) Local Government--To Table",10,0,0,0,10
1981451,1543319,2025-04-09,Senate,"(S) Local Government--To Table",10,0,0,0,10
1981467,1505391,2025-03-04,Senate,"(S) Business, Labor  and Economic Affairs--Do Pass",12,0,0,0,12
1981467,1507540,2025-03-06,Senate,"(S) 2nd Reading Passed",50,0,0,0,50
1981467,1508334,2025-03-06,Senate,"(S) 3rd Reading Passed",49,0,0,1,50
1981467,1529908,2025-03-28,House,"(H) Business and Labor--Be Concurred In",20,0,0,0,20
1981467,1545096,2025-04-10,House,"(H) 2nd Reading Concurred",100,0,0,0,100
1981467,1546369,2025-04-11,House,"(H) 3rd Reading Concurred",99,0,0,1,100
1981479,1503004,2025-03-01,House,"(H) Judiciary--Do Pass",12,8,0,0,20
1981479,1503612,2025-03-03,House,"(H) 2nd Reading Passed",63,36,0,1,100
1981479,1504578,2025-03-04,House,"(H) Appropriations--Do Pass",14,9,0,0,23
1981479,1506109,2025-03-05,House,"(H) 3rd Reading Passed",62,36,0,2,100
1981479,1542084,2025-04-09,Senate,"(S) Judiciary--To Table",8,0,0,0,8
1981479,1543598,2025-04-09,Senate,"(S) Judiciary--To Table",8,0,0,0,8
1981497,1502660,2025-02-28,Senate,"(S) State Administration--To Table",9,0,0,0,9
1981513,1502940,2025-03-01,House,"(H) Judiciary--To Table",19,1,0,0,20
1981527,1503043,2025-03-01,Senate,"(S) Energy, Technology & Federal Relations--To Table",13,0,0,0,13
1981543,1502976,2025-03-01,House,"(H) Judiciary--Do Pass",11,9,0,0,20
1981543,1508151,2025-03-06,House,"(H) 2nd Reading Not Passed",40,59,0,1,100
1981558,1502402,2025-02-28,House,"(H) Judiciary--Do Pass",12,8,0,0,20
1981558,1507512,2025-03-06,House,"(H) 2nd Reading Passed",57,42,0,1,100
1981558,1508728,2025-03-07,House,"(H) 3rd Reading Passed",57,42,0,1,100
1981558,1537080,2025-04-04,Senate,"(S) Judiciary--Be Concurred In",5,3,0,0,8
1981558,1551550,2025-04-17,Senate,"(S) 2nd Reading Concurred",31,19,0,0,50
1981558,1552295,2025-04-18,Senate,"(S) 3rd Reading Concurred",34,16,0,0,50
1981576,1502851,2025-02-28,Senate,"(S) Public Health, Welfare and Safety--Do Pass",10,1,0,0,11
1981576,1506168,2025-03-05,Senate,"(S) 2nd Reading Passed",50,0,0,0,50
1981576,1508179,2025-03-06,Senate,"(S) 3rd Reading Passed",50,0,0,0,50
1981576,1528394,2025-03-26,House,"(H) Human Services--Be Concurred In As Amended",13,8,0,0,21
1981576,1543535,2025-04-10,House,"(H) 2nd Reading Motion to Amend Carried",84,15,0,1,100
1981576,1543536,2025-04-10,House,"(H) 2nd Reading Concurred as Amended",98,2,0,0,100
1981576,1546354,2025-04-11,House,"(H) 3rd Reading Concurred",98,1,0,1,100
1981576,1549992,2025-04-16,Senate,"(S) 2nd Reading House Amendments Concurred",49,0,0,1,50
1981576,1551246,2025-04-17,Senate,"(S) 3rd Reading Passed as Amended by House",49,1,0,0,50
1981593,1504138,2025-03-03,Senate,"(S) Natural Resources--Do Pass",7,4,0,0,11
1981593,1506220,2025-03-05,Senate,"(S) 2nd Reading Motion to Amend Carried",50,0,0,0,50
1981593,1506221,2025-03-05,Senate,"(S) 2nd Reading Passed as Amended",30,20,0,0,50
1981593,1508080,2025-03-06,Senate,"(S) 3rd Reading Passed",27,22,0,1,50
1981593,1550916,2025-04-16,House,"(H) Natural Resources--To Table",9,5,0,0,14
1981593,1552139,2025-04-16,House,"(H) Natural Resources--To Table",9,5,0,0,14
1981608,1530189,2025-03-28,Senate,"(S) Taxation--Do Pass",8,0,0,0,8
1981608,1530834,2025-03-31,Senate,"(S) 2nd Reading Passed",50,0,0,0,50
1981608,1534007,2025-04-02,Senate,"(S) Finance and Claims--Do Pass",22,0,0,0,22
1981608,1536000,2025-04-03,Senate,"(S) 3rd Reading Passed",50,0,0,0,50
1981608,1551884,2025-04-17,House,"(H) Taxation--To Table",19,2,0,0,21
1981608,1552067,2025-04-17,House,"(H) Taxation--To Table",19,2,0,0,21
1981621,1501877,2025-02-27,House,"(H) State Administration--Do Pass As Amended",19,0,0,0,19
1981621,1506955,2025-03-05,House,"(H) 2nd Reading Passed",98,0,0,2,100
1981621,1508537,2025-03-07,House,"(H) 3rd Reading Passed",99,0,0,1,100
1981621,1538809,2025-04-07,Senate,"(S) State Administration--To Table",9,0,0,0,9
1981621,1543703,2025-04-07,Senate,"(S) State Administration--To Table",9,0,0,0,9
1981634,1501718,2025-02-27,House,"(H) Human Services--Do Pass",12,9,0,0,21
1981634,1503342,2025-03-03,House,"(H) 2nd Reading Passed",58,41,0,1,100
1981634,1503879,2025-03-03,House,"(H) Appropriations--Do Pass",14,9,0,0,23
1981634,1504595,2025-03-04,House,"(H) 3rd Reading Passed",57,42,0,1,100
1981634,1535599,2025-04-02,Senate,"(S) Public Health, Welfare and Safety--Be Concurred In",7,4,0,0,11
1981634,1545122,2025-04-10,Senate,"(S) 2nd Reading Concurred",32,17,0,1,50
1981634,1546373,2025-04-11,Senate,"(S) Finance and Claims--Be Concurred In",15,7,0,0,22
1981634,1546748,2025-04-12,Senate,"(S) 3rd Reading Concurred",32,18,0,0,50
1981650,1503564,2025-03-03,House,"(H) Natural Resources--Do Pass",14,0,0,0,14
1981650,1505782,2025-03-05,House,"(H) 2nd Reading Passed",98,1,0,1,100
1981650,1508569,2025-03-07,House,"(H) 3rd Reading Passed",99,0,0,1,100
1981650,1539185,2025-04-07,Senate,"(S) Natural Resources--Be Concurred In As Amended",11,0,0,0,11
1981650,1543503,2025-04-10,Senate,"(S) 2nd Reading Concurred",50,0,0,0,50
1981650,1546207,2025-04-11,Senate,"(S) 3rd Reading Concurred",48,0,0,2,50
1981650,1551956,2025-04-17,House,"(H) 2nd Reading Senate Amendments Concurred",100,0,0,0,100
1981650,1552313,2025-04-18,House,"(H) 3rd Reading Passed as Amended by Senate",98,0,0,2,100
1981663,1504351,2025-03-04,Senate,"(S) Judiciary--Do Pass",5,3,0,0,8
1981663,1505828,2025-03-04,Senate,"(S) Judiciary--Do Pass",5,3,0,0,8
1981663,1506836,2025-03-05,Senate,"(S) 2nd Reading Motion to Amend Carried",30,18,0,2,50
1981663,1506837,2025-03-05,Senate,"(S) 2nd Reading Passed as Amended",32,18,0,0,50
1981663,1508187,2025-03-06,Senate,"(S) 3rd Reading Passed",31,18,0,1,50
1981663,1542204,2025-04-09,House,"(H) Judiciary--Be Concurred In",12,8,0,0,20
1981663,1545989,2025-04-11,House,"(H) 2nd Reading Concurred",56,44,0,0,100
1981663,1546395,2025-04-11,House,"(H) 3rd Reading Concurred",55,44,0,1,100
1981663,1548282,2025-03-04,Senate,"(S) Judiciary--Do Pass",5,3,0,0,8
1981681,1504707,2025-03-04,House,"(H) Judiciary--Do Pass",11,9,0,0,20
1981681,1505675,2025-03-05,House,"(H) 2nd Reading Not Passed",44,55,0,1,100
1981693,1506892,2025-03-04,Senate,"(S) Judiciary--Do Pass",6,2,0,0,8
1981693,1507317,2025-03-06,Senate,"(S) 2nd Reading Passed",46,4,0,0,50
1981693,1507941,2025-03-06,Senate,"(S) 3rd Reading Passed",47,2,0,1,50
1981693,1542950,2025-04-09,House,"(H) Judiciary--Be Concurred In",20,0,0,0,20
1981693,1544778,2025-04-10,House,"(H) 2nd Reading Concurred",100,0,0,0,100
1981693,1546471,2025-04-11,House,"(H) 3rd Reading Concurred",99,0,0,1,100
1981727,1503160,2025-03-03,Senate,"(S) Judiciary--To Table",8,0,0,0,8
1981733,1538558,2025-04-07,Senate,"(S) Judiciary--Resolution Adopted As Amended",8,0,0,0,8
1981733,1545256,2025-04-10,Senate,"(S) Resolution Adopted",50,0,0,0,50
1981737,1502203,2025-02-27,House,"(H) Local Government--Do Pass",17,0,0,0,17
1981737,1506025,2025-03-05,House,"(H) 2nd Reading Passed",97,2,0,1,100
1981737,1508552,2025-03-07,House,"(H) 3rd Reading Passed",96,3,0,1,100
1981737,1539179,2025-04-07,Senate,"(S) Local Government--Be Concurred In",10,0,0,0,10
1981737,1550761,2025-04-16,Senate,"(S) 2nd Reading Concurred",49,1,0,0,50
1981737,1551172,2025-04-17,Senate,"(S) 3rd Reading Concurred",48,2,0,0,50
1981747,1503174,2025-03-03,House,"(H) Judiciary--Do Pass",12,8,0,0,20
1981747,1506642,2025-03-05,House,"(H) 2nd Reading Passed",57,42,0,1,100
1981747,1508677,2025-03-07,House,"(H) 3rd Reading Passed",58,40,0,2,100
1981747,1537491,2025-04-04,Senate,"(S) Judiciary--Be Concurred In As Amended",5,3,0,0,8
1981747,1538748,2025-04-07,Senate,"(S) 2nd Reading Concurred",32,18,0,0,50
1981747,1540637,2025-04-08,Senate,"(S) 3rd Reading Concurred",30,18,0,2,50
1981747,1551565,2025-04-17,House,"(H) 2nd Reading Senate Amendments Concurred",98,2,0,0,100
1981747,1552100,2025-04-18,House,"(H) 3rd Reading Passed as Amended by Senate",64,34,0,2,100
1981760,1503063,2025-03-01,House,"(H) Judiciary--Do Pass As Amended",20,0,0,0,20
1981760,1506590,2025-03-05,House,"(H) 2nd Reading Passed",98,0,0,2,100
1981760,1508666,2025-03-07,House,"(H) 3rd Reading Passed",99,0,0,1,100
1981760,1541811,2025-04-09,Senate,"(S) Judiciary--Be Concurred In",5,3,0,0,8
1981760,1552141,2025-04-18,Senate,"(S) 2nd Reading Concurred",44,6,0,0,50
1981760,1553597,2025-04-22,Senate,"(S) 3rd Reading Concurred",32,18,0,0,50
1981765,1503041,2025-03-01,House,"(H) Business and Labor--Do Pass",16,4,0,0,20
1981765,1507579,2025-03-06,House,"(H) 2nd Reading Passed",96,3,0,1,100
1981765,1508726,2025-03-07,House,"(H) 3rd Reading Passed",96,3,0,1,100
1981765,1529884,2025-03-28,Senate,"(S) Business, Labor  and Economic Affairs--Be Concurred In",10,2,0,0,12
1981765,1543763,2025-04-10,Senate,"(S) 2nd Reading Concurred",47,3,0,0,50
1981765,1546026,2025-04-11,Senate,"(S) 3rd Reading Concurred",44,4,0,2,50
1981773,1502919,2025-03-01,Senate,"(S) Business, Labor  and Economic Affairs--Do Pass",8,4,0,0,12
1981773,1507193,2025-03-06,Senate,"(S) 2nd Reading Passed",50,0,0,0,50
1981773,1508194,2025-03-06,Senate,"(S) 3rd Reading Passed",49,0,0,1,50
1981773,1542038,2025-04-09,House,"(H) Business and Labor--Be Concurred In As Amended",20,0,0,0,20
1981773,1545886,2025-04-11,House,"(H) 2nd Reading Concurred",100,0,0,0,100
1981773,1546350,2025-04-11,House,"(H) 3rd Reading Concurred",99,0,0,1,100
1981773,1547359,2025-04-14,Senate,"(S) 2nd Reading House Amendments Concurred",50,0,0,0,50
1981788,1504118,2025-03-03,Senate,"(S) Highways and Transportation--To Table",8,0,0,0,8
1981788,1504119,2025-03-03,Senate,"(S) Highways and Transportation--Do Pass",4,4,0,0,8
1981795,1504589,2025-03-04,Senate,"(S) Business, Labor  and Economic Affairs--To Table",11,1,0,0,12
1981795,1504590,2025-03-04,Senate,"(S) Taken from Committee; Placed on 2nd Reading",44,6,0,0,50
1981795,1506604,2025-03-05,Senate,"(S) 2nd Reading Motion to Amend Carried",50,0,0,0,50
1981795,1506605,2025-03-05,Senate,"(S) 2nd Reading Passed as Amended",41,9,0,0,50
1981795,1507942,2025-03-06,Senate,"(S) 3rd Reading Passed",41,8,0,1,50
1981795,1541759,2025-04-09,House,"(H) Business and Labor--Be Concurred In As Amended",20,0,0,0,20
1981795,1545787,2025-04-11,House,"(H) 2nd Reading Concurred",100,0,0,0,100
1981795,1546288,2025-04-11,House,"(H) 3rd Reading Concurred",99,0,0,1,100
1981795,1551662,2025-04-17,Senate,"(S) 2nd Reading House Amendments Concurred",48,0,0,2,50
1981795,1552147,2025-04-18,Senate,"(S) 3rd Reading Passed as Amended by House",50,0,0,0,50
1981799,1503639,2025-03-03,Senate,"(S) Judiciary--Do Pass",5,3,0,0,8
1981799,1506915,2025-03-05,Senate,"(S) 2nd Reading Passed",30,20,0,0,50
1981799,1508107,2025-03-06,Senate,"(S) 3rd Reading Passed",31,19,0,0,50
1981799,1542955,2025-04-09,House,"(H) Judiciary--Be Concurred In",12,8,0,0,20
1981799,1544492,2025-04-10,House,"(H) 2nd Reading Concurred",55,45,0,0,100
1981799,1546193,2025-04-11,House,"(H) 3rd Reading Concurred",55,44,0,1,100
1981813,1502625,2025-02-28,House,"(H) Transportation--Do Pass",14,0,0,0,14
1981813,1506672,2025-03-05,House,"(H) 2nd Reading Motion to Amend Carried",99,0,0,1,100
1981813,1506673,2025-03-05,House,"(H) 2nd Reading Passed as Amended",99,0,0,1,100
1981813,1508530,2025-03-07,House,"(H) 3rd Reading Passed",99,0,0,1,100
1981813,1530549,2025-03-28,Senate,"(S) Highways and Transportation--Be Concurred In",8,0,0,0,8
1981813,1550083,2025-04-16,Senate,"(S) 2nd Reading Concurred",49,0,0,1,50
1981813,1551946,2025-04-17,Senate,"(S) 3rd Reading Concurred",50,0,0,0,50
1981823,1503442,2025-03-03,House,"(H) Natural Resources--Do Pass",12,2,0,0,14
1981823,1507002,2025-03-06,House,"(H) 2nd Reading Passed",95,3,0,2,100
1981823,1508622,2025-03-07,House,"(H) 3rd Reading Passed",97,2,0,1,100
1981823,1546472,2025-04-11,Senate,"(S) Natural Resources--Be Concurred In",11,0,0,0,11
1981823,1550116,2025-04-16,Senate,"(S) 2nd Reading Concurred",50,0,0,0,50
1981823,1551449,2025-04-17,Senate,"(S) 3rd Reading Concurred",45,5,0,0,50
1981825,1502798,2025-02-28,Senate,"(S) Highways and Transportation--Do Pass",8,0,0,0,8
1981825,1507377,2025-03-06,Senate,"(S) 2nd Reading Passed",48,2,0,0,50
1981825,1507950,2025-03-06,Senate,"(S) 3rd Reading Passed",47,2,0,1,50
1981825,1531677,2025-03-31,House,"(H) Transportation--To Table",9,5,0,0,14
1981825,1537324,2025-03-31,House,"(H) Transportation--To Table",9,5,0,0,14
1981825,1577995,2025-03-31,House,"(H) Transportation--To Table",9,5,0,0,14
1981844,1503019,2025-03-01,House,"(H) Judiciary--Do Pass",12,8,0,0,20
1981844,1506169,2025-03-05,House,"(H) 2nd Reading Motion to Amend Carried",62,37,0,1,100
1981844,1506170,2025-03-05,House,"(H) 2nd Reading Not Passed as Amended",47,52,0,1,100
1981849,1503050,2025-03-01,Senate,"(S) Energy, Technology & Federal Relations--To Table",13,0,0,0,13
1981853,1503562,2025-03-03,House,"(H) Judiciary--Do Pass",20,0,0,0,20
1981853,1508085,2025-03-06,House,"(H) 2nd Reading Passed",99,0,0,1,100
1981853,1508819,2025-03-07,House,"(H) 3rd Reading Passed",99,0,0,1,100
1981853,1523245,2025-03-20,Senate,"(S) Judiciary--Be Concurred In",8,0,0,0,8
1981853,1550797,2025-04-16,Senate,"(S) 2nd Reading Concurred",48,1,0,1,50
1981853,1551253,2025-04-17,Senate,"(S) 3rd Reading Concurred",45,5,0,0,50
1981866,1503745,2025-03-03,Senate,"(S) Highways and Transportation--To Table",6,2,0,0,8
1981866,1505194,2025-03-04,Senate,"(S) Taken from Committee; Placed on 2nd Reading",43,7,0,0,50
1981866,1506622,2025-03-05,Senate,"(S) 2nd Reading Motion to Amend Carried",48,2,0,0,50
1981866,1506623,2025-03-05,Senate,"(S) 2nd Reading Pass Motion Failed",21,29,0,0,50
1981866,1506624,2025-03-05,Senate,"(S) 2nd Reading Indefinitely Postponed",41,9,0,0,50
1981882,1502191,2025-02-27,House,"(H) Local Government--Do Pass",10,7,0,0,17
1981882,1507295,2025-03-06,House,"(H) 2nd Reading Passed",61,37,0,2,100
1981882,1508746,2025-03-07,House,"(H) 3rd Reading Passed",56,43,0,1,100
1981882,1540253,2025-04-07,Senate,"(S) Local Government--Be Concurred In As Amended",10,0,0,0,10
1981882,1543611,2025-04-10,Senate,"(S) 2nd Reading Concurred",45,3,0,2,50
1981882,1546449,2025-04-11,Senate,"(S) 3rd Reading Concurred",45,3,0,2,50
1981882,1551288,2025-04-17,House,"(H) 2nd Reading Senate Amendments Concurred",62,38,0,0,100
1981882,1552095,2025-04-18,House,"(H) 3rd Reading Passed as Amended by Senate",57,41,0,2,100
1981889,1538547,2025-04-07,Senate,"(S) Judiciary--Resolution Adopted",8,0,0,0,8
1981889,1545199,2025-04-10,Senate,"(S) Resolution Adopted",48,0,0,2,50
1981892,1501881,2025-02-27,House,"(H) State Administration--Do Pass",10,9,0,0,19
1981892,1508322,2025-03-06,House,"(H) 2nd Reading Passed",56,42,0,2,100
1981892,1508609,2025-03-07,House,"(H) 3rd Reading Passed",57,42,0,1,100
1981892,1546418,2025-04-11,Senate,"(S) State Administration--Be Concurred In",6,3,0,0,9
1981892,1552241,2025-04-18,Senate,"(S) 2nd Reading Concurred",31,19,0,0,50
1981892,1554827,2025-04-22,Senate,"(S) 3rd Reading Concurred",32,18,0,0,50
1981908,1504309,2025-03-04,Senate,"(S) Business, Labor  and Economic Affairs--Do Pass",7,5,0,0,12
1981908,1506286,2025-03-05,Senate,"(S) 2nd Reading Motion to Amend Carried",47,3,0,0,50
1981908,1506287,2025-03-05,Senate,"(S) 2nd Reading Passed as Amended",40,10,0,0,50
1981908,1508167,2025-03-06,Senate,"(S) 3rd Reading Passed",41,8,0,1,50
1981908,1541638,2025-04-09,House,"(H) Business and Labor--Be Concurred In As Amended",18,2,0,0,20
1981908,1545618,2025-04-11,House,"(H) 2nd Reading Not Concurred",39,61,0,0,100
1981913,1502981,2025-03-01,Senate,"(S) Business, Labor  and Economic Affairs--Do Pass",12,0,0,0,12
1981913,1506495,2025-03-05,Senate,"(S) 2nd Reading Passed",46,4,0,0,50
1981913,1508104,2025-03-06,Senate,"(S) 3rd Reading Passed",49,1,0,0,50
1981913,1524864,2025-03-24,House,"(H) Business and Labor--Be Concurred In",20,0,0,0,20
1981913,1528380,2025-03-26,House,"(H) 2nd Reading Concurred",99,0,0,1,100
1981913,1529700,2025-03-27,House,"(H) 3rd Reading Concurred",99,0,0,1,100
1981920,1502002,2025-02-27,Senate,"(S) Education and Cultural Resources--To Table",8,6,0,0,14
1981934,1503993,2025-03-03,Senate,"(S) Natural Resources--To Table",8,3,0,0,11
1981934,1503994,2025-03-03,Senate,"(S) Natural Resources--Do Pass",4,7,0,0,11
1981943,1503010,2025-03-01,Senate,"(S) Energy, Technology & Federal Relations--To Table",13,0,0,0,13
1981951,1504568,2025-03-04,Senate,"(S) Business, Labor  and Economic Affairs--To Table",11,1,0,0,12
1981951,1505226,2025-03-04,Senate,"(S) Taken from Committee; Placed on 2nd Reading",46,4,0,0,50
1981951,1506579,2025-03-05,Senate,"(S) 2nd Reading Motion to Amend Carried",50,0,0,0,50
1981951,1506580,2025-03-05,Senate,"(S) 2nd Reading Passed as Amended",43,7,0,0,50
1981951,1507925,2025-03-06,Senate,"(S) 3rd Reading Passed",46,3,0,1,50
1981951,1541845,2025-04-09,House,"(H) Business and Labor--Be Concurred In As Amended",20,0,0,0,20
1981951,1545810,2025-04-11,House,"(H) 2nd Reading Concurred",100,0,0,0,100
1981951,1546307,2025-04-11,House,"(H) 3rd Reading Concurred",99,0,0,1,100
1981951,1547238,2025-04-14,Senate,"(S) 2nd Reading House Amendments Not Concurred",34,16,0,0,50
1981951,1560346,2025-04-29,Senate,"(S) 2nd Reading Free Conference Committee Report Adopted",48,1,0,1,50
1981951,1560347,2025-04-29,House,"(H) 2nd Reading Free Conference Committee Report Adopted",98,2,0,0,100
1981951,1561842,2025-04-30,House,"(H) 3rd Reading Free Conference Committee Report Adopted",100,0,0,0,100
1981951,1562459,2025-04-30,Senate,"(S) 3rd Reading Free Conference Committee Report Adopted",50,0,0,0,50
1981966,1502920,2025-03-01,Senate,"(S) Business, Labor  and Economic Affairs--To Table",12,0,0,0,12
1981973,1502966,2025-03-01,House,"(H) Judiciary--Do Pass",12,8,0,0,20
1981973,1507585,2025-03-06,House,"(H) 2nd Reading Passed",57,42,0,1,100
1981973,1508630,2025-03-07,House,"(H) 3rd Reading Passed",57,42,0,1,100
1981973,1537504,2025-04-04,Senate,"(S) Judiciary--Be Concurred In",5,3,0,0,8
1981973,1546714,2025-04-12,Senate,"(S) 2nd Reading Concurred",30,20,0,0,50
1981973,1547715,2025-04-14,Senate,"(S) 3rd Reading Concurred",29,19,0,2,50
1981982,1504715,2025-03-04,Senate,"(S) Business, Labor  and Economic Affairs--To Table",12,0,0,0,12
1981993,1502205,2025-02-27,House,"(H) Local Government--Do Pass",17,0,0,0,17
1981993,1506087,2025-03-05,House,"(H) 2nd Reading Passed",92,7,0,1,100
1981993,1508533,2025-03-07,House,"(H) 3rd Reading Passed",95,4,0,1,100
1981993,1538678,2025-04-07,Senate,"(S) Local Government--Be Concurred In",10,0,0,0,10
1981993,1544725,2025-04-10,Senate,"(S) 2nd Reading Concurred",42,5,0,3,50
1981993,1546460,2025-04-11,Senate,"(S) 3rd Reading Concurred",48,0,0,2,50
1981998,1503017,2025-03-01,Senate,"(S) Energy, Technology & Federal Relations--Do Pass",13,0,0,0,13
1981998,1505890,2025-03-05,Senate,"(S) 2nd Reading Passed",50,0,0,0,50
1981998,1508100,2025-03-06,Senate,"(S) 3rd Reading Passed",49,1,0,0,50
1981998,1536866,2025-04-03,House,"(H) Local Government--Be Concurred In",17,0,0,0,17
1981998,1544559,2025-04-10,House,"(H) 2nd Reading Concurred",99,1,0,0,100
1981998,1546458,2025-04-11,House,"(H) 3rd Reading Concurred",97,2,0,1,100
1982004,1502997,2025-03-01,House,"(H) Business and Labor--Do Pass",20,0,0,0,20
1982004,1505572,2025-03-04,House,"(H) 2nd Reading Passed",99,0,0,1,100
1982004,1507853,2025-03-06,House,"(H) Appropriations--Do Pass",23,0,0,0,23
1982004,1508509,2025-03-07,House,"(H) 3rd Reading Passed",99,0,0,1,100
1982004,1527854,2025-03-26,Senate,"(S) Business, Labor  and Economic Affairs--Be Concurred In",12,0,0,0,12
1982004,1542538,2025-04-09,Senate,"(S) 2nd Reading Motion to Amend Carried",49,1,0,0,50
1982004,1542539,2025-04-09,Senate,"(S) 2nd Reading Concurred as Amended",50,0,0,0,50
1982004,1546123,2025-04-11,Senate,"(S) Finance and Claims--Be Concurred In",22,0,0,0,22
1982004,1546594,2025-04-12,Senate,"(S) 3rd Reading Concurred",50,0,0,0,50
1982004,1551467,2025-04-17,House,"(H) 2nd Reading Senate Amendments Concurred",100,0,0,0,100
1982004,1552103,2025-04-18,House,"(H) 3rd Reading Passed as Amended by Senate",97,1,0,2,100
1982261,1502735,2025-02-28,Senate,"(S) Public Health, Welfare and Safety--To Table",11,0,0,0,11
1982265,1504098,2025-03-03,Senate,"(S) Public Health, Welfare and Safety--To Table",11,0,0,0,11
1982277,1504207,2025-03-03,Senate,"(S) Natural Resources--Do Pass",6,5,0,0,11
1982277,1506499,2025-03-05,Senate,"(S) 2nd Reading Motion to Amend Carried",44,6,0,0,50
1982277,1506500,2025-03-05,Senate,"(S) 2nd Reading Passed as Amended",41,9,0,0,50
1982277,1508073,2025-03-06,Senate,"(S) 3rd Reading Passed",37,12,0,1,50
1982277,1531601,2025-03-31,House,"(H) Natural Resources--Be Concurred In As Amended",13,1,0,0,14
1982277,1545241,2025-04-10,House,"(H) 2nd Reading Concurred",97,3,0,0,100
1982277,1546421,2025-04-11,House,"(H) 3rd Reading Concurred",96,3,0,1,100
1982277,1551522,2025-04-17,Senate,"(S) 2nd Reading House Amendments Concur Motion Failed",20,30,0,0,50
1982277,1560875,2025-04-29,Senate,"(S) 2nd Reading Free Conference Committee Report Adopted",33,17,0,0,50
1982277,1560876,2025-04-29,House,"(H) 2nd Reading Free Conference Committee Report Adopted",96,4,0,0,100
1982277,1562587,2025-04-30,House,"(H) 3rd Reading Free Conference Committee Report Adopted",98,2,0,0,100
1982277,1562588,2025-04-30,Senate,"(S) 3rd Reading Free Conference Committee Report Adopted",42,8,0,0,50
1982286,1503585,2025-03-03,House,"(H) Judiciary--Do Pass",12,8,0,0,20
1982286,1506260,2025-03-05,House,"(H) 2nd Reading Not Passed",22,77,0,1,100
1982309,1503208,2025-03-03,House,"(H) Judiciary--Do Pass",12,8,0,0,20
1982309,1505843,2025-03-05,House,"(H) 2nd Reading Passed",57,42,0,1,100
1982309,1508592,2025-03-07,House,"(H) 3rd Reading Passed",57,42,0,1,100
1982309,1541474,2025-04-09,Senate,"(S) Judiciary--Be Concurred In As Amended",5,3,0,0,8
1982309,1546101,2025-04-11,Senate,"(S) 2nd Reading Concurred",29,21,0,0,50
1982309,1546591,2025-04-12,Senate,"(S) 3rd Reading Concurred",31,19,0,0,50
1982309,1551463,2025-04-17,House,"(H) 2nd Reading Senate Amendments Concurred",61,39,0,0,100
1982309,1552116,2025-04-18,House,"(H) 3rd Reading Passed as Amended by Senate",58,41,0,1,100
1982310,1503052,2025-03-01,House,"(H) Business and Labor--Do Pass As Amended",19,1,0,0,20
1982310,1505682,2025-03-05,House,"(H) 2nd Reading Motion to Amend Carried",89,9,0,2,100
1982310,1505683,2025-03-05,House,"(H) 2nd Reading Passed as Amended",98,1,0,1,100
1982310,1508737,2025-03-07,House,"(H) 3rd Reading Passed",98,1,0,1,100
1982310,1539649,2025-04-08,Senate,"(S) Judiciary--Be Concurred In As Amended",5,3,0,0,8
1982310,1544456,2025-04-10,Senate,"(S) 2nd Reading Motion to Amend Carried",50,0,0,0,50
1982310,1544457,2025-04-10,Senate,"(S) 2nd Reading Concurred as Amended",28,22,0,0,50
1982310,1545736,2025-04-11,Senate,"(S) Finance and Claims--Be Concurred In",12,10,0,0,22
1982310,1546636,2025-04-12,Senate,"(S) 3rd Reading Concurred",39,11,0,0,50
1982310,1551534,2025-04-17,House,"(H) 2nd Reading Senate Amendments Concurred",92,8,0,0,100
1982310,1552120,2025-04-18,House,"(H) 3rd Reading Passed as Amended by Senate",63,35,0,2,100
1982329,1502945,2025-03-01,House,"(H) Business and Labor--Do Pass",18,2,0,0,20
1982329,1507042,2025-03-06,House,"(H) 2nd Reading Passed",50,49,0,1,100
1982329,1508497,2025-03-07,House,"(H) 3rd Reading Passed",52,47,0,1,100
1982329,1529923,2025-03-28,Senate,"(S) Business, Labor  and Economic Affairs--Be Concurred In",7,5,0,0,12
1982329,1546564,2025-04-12,Senate,"(S) 2nd Reading Concurred",36,13,0,1,50
1982329,1546901,2025-04-14,Senate,"(S) 3rd Reading Concurred",34,14,0,2,50
1982344,1503561,2025-03-03,House,"(H) Judiciary--To Table",15,5,0,0,20
1982352,1503441,2025-03-03,House,"(H) Natural Resources--Do Pass",11,3,0,0,14
1982352,1506422,2025-03-05,House,"(H) 2nd Reading Passed",82,17,0,1,100
1982352,1508548,2025-03-07,House,"(H) 3rd Reading Passed",82,17,0,1,100
1982352,1539234,2025-04-07,Senate,"(S) Natural Resources--Be Concurred In As Amended",11,0,0,0,11
1982352,1546294,2025-04-11,Senate,"(S) 2nd Reading Concurred",38,12,0,0,50
1982352,1546729,2025-04-12,Senate,"(S) 3rd Reading Concurred",45,5,0,0,50
1982352,1551728,2025-04-17,House,"(H) 2nd Reading Senate Amendments Concurred",59,41,0,0,100
1982352,1552294,2025-04-18,House,"(H) 3rd Reading Passed as Amended by Senate",69,30,0,1,100
1982363,1503013,2025-03-01,House,"(H) Business and Labor--To Table",20,0,0,0,20
1982377,1501994,2025-02-27,Senate,"(S) Education and Cultural Resources--Do Pass As Amended",8,6,0,0,14
1982377,1506229,2025-03-05,Senate,"(S) 2nd Reading Motion to Amend Carried",35,15,0,0,50
1982377,1506230,2025-03-05,Senate,"(S) 2nd Reading Motion to Amend Failed",22,28,0,0,50
1982377,1506231,2025-03-05,Senate,"(S) 2nd Reading Passed as Amended",29,21,0,0,50
1982377,1507972,2025-03-06,Senate,"(S) 3rd Reading Passed",28,21,0,1,50
1982377,1541893,2025-04-09,House,"(H) Judiciary--Be Concurred In As Amended",12,8,0,0,20
1982377,1544434,2025-04-10,House,"(H) Appropriations--To Table",16,7,0,0,23
1982377,1545784,2025-04-11,House,"(H) Taken from Committee; Placed on 2nd Reading",42,55,0,3,100
1982389,1502448,2025-02-27,House,"(H) Local Government--To Table",13,4,0,0,17
1982402,1502855,2025-02-28,House,"(H) Education--To Table",15,0,0,0,15
1982419,1500802,2025-02-26,House,"(H) Transportation--To Table",14,0,0,0,14
1982419,1502924,2025-02-28,House,"(H) Transportation--Do Pass As Amended",13,1,0,0,14
1982419,1506986,2025-03-05,House,"(H) 2nd Reading Motion to Amend Carried",86,13,0,1,100
1982419,1506987,2025-03-05,House,"(H) 2nd Reading Passed as Amended",63,36,0,1,100
1982419,1508818,2025-03-07,House,"(H) 3rd Reading Passed",65,34,0,1,100
1982419,1531566,2025-03-31,Senate,"(S) Highways and Transportation--To Table",8,0,0,0,8
1982419,1537351,2025-03-31,Senate,"(S) Highways and Transportation--To Table",8,0,0,0,8
1982426,1502710,2025-02-28,Senate,"(S) Public Health, Welfare and Safety--To Table",11,0,0,0,11
1982439,1502872,2025-02-28,Senate,"(S) Public Health, Welfare and Safety--Do Pass",6,5,0,0,11
1982439,1505880,2025-03-05,Senate,"(S) 2nd Reading Motion to Amend Carried",50,0,0,0,50
1982439,1505881,2025-03-05,Senate,"(S) 2nd Reading Passed as Amended",47,3,0,0,50
1982439,1508184,2025-03-06,Senate,"(S) 3rd Reading Passed",40,9,0,1,50
1982439,1530270,2025-03-28,House,"(H) Human Services--Be Concurred In As Amended",18,3,0,0,21
1982439,1543997,2025-04-10,House,"(H) 2nd Reading Concurred",89,11,0,0,100
1982439,1546124,2025-04-11,House,"(H) 3rd Reading Concurred",90,9,0,1,100
1982439,1547083,2025-04-14,Senate,"(S) 2nd Reading House Amendments Concurred",48,1,0,1,50
1982439,1548651,2025-04-15,Senate,"(S) 3rd Reading Passed as Amended by House",48,2,0,0,50
1982449,1502466,2025-02-28,House,"(H) Business and Labor--Do Pass",20,0,0,0,20
1982449,1508121,2025-03-06,House,"(H) 2nd Reading Passed",98,1,0,1,100
1982449,1508586,2025-03-07,House,"(H) 3rd Reading Passed",96,3,0,1,100
1982449,1529932,2025-03-28,Senate,"(S) Business, Labor  and Economic Affairs--Be Concurred In",12,0,0,0,12
1982449,1546530,2025-04-12,Senate,"(S) 2nd Reading Concurred",48,2,0,0,50
1982449,1546907,2025-04-14,Senate,"(S) 3rd Reading Concurred",44,4,0,2,50
1982467,1502799,2025-02-28,House,"(H) Education--Do Pass",15,0,0,0,15
1982467,1505329,2025-03-04,House,"(H) 2nd Reading Passed",97,1,0,2,100
1982467,1505723,2025-03-05,House,"(H) 3rd Reading Passed",98,0,0,2,100
1982467,1526845,2025-03-25,Senate,"(S) Education and Cultural Resources--Be Concurred In",13,1,0,0,14
1982467,1552322,2025-04-18,Senate,"(S) 2nd Reading Concurred",50,0,0,0,50
1982467,1554860,2025-04-22,Senate,"(S) 3rd Reading Concurred",50,0,0,0,50
1982470,1501826,2025-02-27,House,"(H) State Administration--Do Pass",15,4,0,0,19
1982470,1505574,2025-03-04,House,"(H) 2nd Reading Passed",97,1,0,2,100
1982470,1507024,2025-03-06,House,"(H) 3rd Reading Passed",99,0,0,1,100
1982470,1546222,2025-04-11,Senate,"(S) State Administration--To Table",9,0,0,0,9
1982470,1548040,2025-04-11,Senate,"(S) State Administration--To Table",9,0,0,0,9
1982470,1548041,2025-04-14,Senate,"(S) State Administration--To Take From The Table",2,5,2,0,9
1982487,1502722,2025-02-28,Senate,"(S) Judiciary--Do Pass",5,3,0,0,8
1982487,1506236,2025-03-05,Senate,"(S) 2nd Reading Pass Motion Failed",23,27,0,0,50
1982487,1506237,2025-03-05,Senate,"(S) 2nd Reading Motion to Amend Failed",19,31,0,0,50
1982487,1506238,2025-03-05,Senate,"(S) 2nd Reading Indefinitely Postponed",28,22,0,0,50
1982503,1504928,2025-03-04,Senate,"(S) State Administration--Do Pass",6,3,0,0,9
1982503,1507542,2025-03-06,Senate,"(S) 2nd Reading Pass Motion Failed",17,33,0,0,50
1982503,1507543,2025-03-06,Senate,"(S) 2nd Reading Indefinitely Postponed",40,10,0,0,50
1982515,1502946,2025-03-01,House,"(H) Business and Labor--Do Pass As Amended",20,0,0,0,20
1982515,1507846,2025-03-06,House,"(H) 2nd Reading Passed",98,1,0,1,100
1982515,1508617,2025-03-07,House,"(H) 3rd Reading Passed",98,1,0,1,100
1982515,1534269,2025-04-02,Senate,"(S) Business, Labor  and Economic Affairs--Be Concurred In",11,0,0,0,11
1982515,1549787,2025-04-16,Senate,"(S) 2nd Reading Concurred",50,0,0,0,50
1982515,1551572,2025-04-17,Senate,"(S) 3rd Reading Concurred",49,1,0,0,50
1982527,1503824,2025-03-03,Senate,"(S) Natural Resources--Do Pass",9,2,0,0,11
1982527,1506045,2025-03-05,Senate,"(S) 2nd Reading Motion to Amend Carried",30,20,0,0,50
1982527,1506046,2025-03-05,Senate,"(S) 2nd Reading Indefinitely Postponed",27,23,0,0,50
1982527,1506047,2025-03-05,Senate,"(S) 2nd Reading Pass Motion Failed",24,26,0,0,50
1982527,1506643,2025-03-05,Senate,"(S) Reconsidered Previous Action; Placed on 2nd Reading",29,21,0,0,50
1982527,1507805,2025-03-06,Senate,"(S) 2nd Reading Passed",34,16,0,0,50
1982527,1507806,2025-03-06,Senate,"(S) 3rd Reading Passed",34,15,0,1,50
1982527,1538999,2025-04-07,House,"(H) Natural Resources--Be Concurred In As Amended",8,6,0,0,14
1982527,1544094,2025-04-10,House,"(H) 2nd Reading Not Concurred",45,55,0,0,100
1982535,1503920,2025-03-03,Senate,"(S) Public Health, Welfare and Safety--Do Pass",6,5,0,0,11
1982535,1506040,2025-03-05,Senate,"(S) 2nd Reading Motion to Amend Carried",48,0,0,2,50
1982535,1506041,2025-03-05,Senate,"(S) 2nd Reading Passed as Amended",44,6,0,0,50
1982535,1507988,2025-03-06,Senate,"(S) 3rd Reading Passed",47,2,0,1,50
1982535,1530094,2025-03-28,House,"(H) Human Services--Be Concurred In As Amended",20,1,0,0,21
1982535,1544714,2025-04-10,House,"(H) 2nd Reading Concurred",100,0,0,0,100
1982535,1546392,2025-04-11,House,"(H) 3rd Reading Concurred",99,0,0,1,100
1982535,1550129,2025-04-16,Senate,"(S) 2nd Reading House Amendments Concurred",50,0,0,0,50
1982535,1551346,2025-04-17,Senate,"(S) 3rd Reading Passed as Amended by House",50,0,0,0,50
1982548,1502225,2025-02-28,House,"(H) State Administration--Do Pass",15,4,0,0,19
1982548,1506891,2025-03-05,House,"(H) 2nd Reading Passed",76,23,0,1,100
1982548,1508671,2025-03-07,House,"(H) 3rd Reading Passed",81,18,0,1,100
1982548,1537360,2025-04-04,Senate,"(S) State Administration--Be Concurred In",9,0,0,0,9
1982548,1551906,2025-04-17,Senate,"(S) 2nd Reading Concurred",41,8,0,1,50
1982548,1552280,2025-04-18,Senate,"(S) 3rd Reading Concurred",46,4,0,0,50
1982567,1502692,2025-02-28,Senate,"(S) Public Health, Welfare and Safety--To Table",10,1,0,0,11
1982579,1502672,2025-02-28,Senate,"(S) Highways and Transportation--Do Pass As Amended",8,0,0,0,8
1982579,1507527,2025-03-06,Senate,"(S) 2nd Reading Passed",34,14,0,2,50
1982579,1523193,2025-03-20,Senate,"(S) Finance and Claims--Do Pass",12,10,0,0,22
1982579,1524172,2025-03-21,Senate,"(S) 3rd Reading Passed",34,16,0,0,50
1982579,1538513,2025-04-07,House,"(H) Transportation--Be Concurred In",13,1,0,0,14
1982579,1547800,2025-04-14,House,"(H) 2nd Reading Concurred",83,17,0,0,100
1982579,1549133,2025-04-15,House,"(H) 3rd Reading Concurred",80,17,0,3,100
1982586,1503007,2025-03-01,House,"(H) State Administration--To Table",17,2,0,0,19
1982586,1583090,2025-03-01,House,"(H) State Administration--To Table",17,2,0,0,19
1982599,1504117,2025-03-03,Senate,"(S) Public Health, Welfare and Safety--Do Pass",11,0,0,0,11
1982599,1507544,2025-03-06,Senate,"(S) 2nd Reading Passed",50,0,0,0,50
1982599,1508193,2025-03-06,Senate,"(S) 3rd Reading Passed",49,0,0,1,50
1982599,1527091,2025-03-25,House,"(H) Human Services--Be Concurred In",21,0,0,0,21
1982599,1544059,2025-04-10,House,"(H) 2nd Reading Concurred",100,0,0,0,100
1982599,1546478,2025-04-11,House,"(H) 3rd Reading Concurred",99,0,0,1,100
1982610,1502212,2025-02-27,House,"(H) Local Government--Do Pass",14,3,0,0,17
1982610,1507338,2025-03-06,House,"(H) 2nd Reading Passed",88,11,0,1,100
1982610,1508661,2025-03-07,House,"(H) 3rd Reading Passed",89,10,0,1,100
1982610,1539103,2025-04-07,Senate,"(S) Local Government--To Table",10,0,0,0,10
1982610,1543526,2025-04-07,Senate,"(S) Local Government--To Table",10,0,0,0,10
1982624,1502308,2025-02-28,House,"(H) Business and Labor--Do Pass",20,0,0,0,20
1982624,1508304,2025-03-06,House,"(H) 2nd Reading Passed",97,2,0,1,100
1982624,1508578,2025-03-07,House,"(H) 3rd Reading Passed",99,0,0,1,100
1982624,1530011,2025-03-28,Senate,"(S) Business, Labor  and Economic Affairs--Be Concurred In",12,0,0,0,12
1982624,1545121,2025-04-10,Senate,"(S) 2nd Reading Concurred",50,0,0,0,50
1982624,1546359,2025-04-11,Senate,"(S) 3rd Reading Concurred",48,0,0,2,50
1982642,1502907,2025-02-28,Senate,"(S) Public Health, Welfare and Safety--To Table",11,0,0,0,11
1982647,1502487,2025-02-28,House,"(H) Human Services--Do Pass As Amended",21,0,0,0,21
1982647,1505937,2025-03-05,House,"(H) 2nd Reading Passed",99,0,0,1,100
1982647,1508774,2025-03-07,House,"(H) 3rd Reading Passed",99,0,0,1,100
1982647,1535581,2025-04-02,Senate,"(S) Public Health, Welfare and Safety--Be Concurred In As Amended",11,0,0,0,11
1982647,1537726,2025-04-05,Senate,"(S) 2nd Reading Concurred",47,3,0,0,50
1982647,1541162,2025-04-08,Senate,"(S) 3rd Reading Concurred",48,0,0,2,50
1982647,1551355,2025-04-17,House,"(H) 2nd Reading Senate Amendments Concurred",69,31,0,0,100
1982647,1552317,2025-04-18,House,"(H) 3rd Reading Passed as Amended by Senate",98,1,0,1,100
1982660,1502560,2025-02-28,House,"(H) Transportation--Do Pass As Amended",14,0,0,0,14
1982660,1508324,2025-03-06,House,"(H) 2nd Reading Passed",97,2,0,1,100
1982660,1508589,2025-03-07,House,"(H) 3rd Reading Passed",98,1,0,1,100
1982660,1530567,2025-03-28,Senate,"(S) Highways and Transportation--Be Concurred In",8,0,0,0,8
1982660,1546592,2025-04-12,Senate,"(S) 2nd Reading Concurred",50,0,0,0,50
1982660,1547786,2025-04-14,Senate,"(S) 3rd Reading Concurred",48,0,0,2,50
1982660,1564239,2025-02-28,House,"(H) Transportation--Do Pass As Amended",14,0,0,0,14
1982678,1502492,2025-02-28,House,"(H) State Administration--To Table",18,1,0,0,19
1982689,1503363,2025-03-03,House,"(H) Judiciary--Do Pass As Amended",19,1,0,0,20
1982689,1507920,2025-03-06,House,"(H) 2nd Reading Passed",99,0,0,1,100
1982689,1508655,2025-03-07,House,"(H) 3rd Reading Passed",99,0,0,1,100
1982689,1537231,2025-04-04,Senate,"(S) Judiciary--Be Concurred In As Amended",6,2,0,0,8
1982689,1543638,2025-04-10,Senate,"(S) 2nd Reading Concurred",45,1,0,4,50
1982689,1545987,2025-04-11,Senate,"(S) 3rd Reading Concurred",44,4,0,2,50
1982689,1551352,2025-04-17,House,"(H) 2nd Reading Senate Amendments Concurred",100,0,0,0,100
1982689,1552082,2025-04-18,House,"(H) 3rd Reading Passed as Amended by Senate",99,0,0,1,100
1982698,1503195,2025-03-03,House,"(H) Judiciary--To Table",18,2,0,0,20
1982713,1502486,2025-02-27,House,"(H) Local Government--Do Pass",16,1,0,0,17
1982713,1508240,2025-03-06,House,"(H) 2nd Reading Passed",79,20,0,1,100
1982713,1508813,2025-03-07,House,"(H) 3rd Reading Passed",69,30,0,1,100
1982713,1531678,2025-03-31,Senate,"(S) Local Government--Be Concurred In As Amended",11,0,0,0,11
1982713,1539208,2025-04-07,Senate,"(S) 2nd Reading Concurred",26,24,0,0,50
1982713,1541092,2025-04-08,Senate,"(S) 3rd Reading Concurred",30,18,0,2,50
1982713,1551545,2025-04-17,House,"(H) 2nd Reading Senate Amendments Concurred",100,0,0,0,100
1982713,1552225,2025-04-18,House,"(H) 3rd Reading Passed as Amended by Senate",64,35,0,1,100
1982725,1503018,2025-03-01,House,"(H) Business and Labor--Do Pass",18,2,0,0,20
1982725,1506455,2025-03-05,House,"(H) 2nd Reading Passed",79,20,0,1,100
1982725,1508610,2025-03-07,House,"(H) 3rd Reading Passed",62,37,0,1,100
1982725,1534388,2025-04-02,Senate,"(S) Business, Labor  and Economic Affairs--Be Concurred In As Amended",10,1,0,0,11
1982725,1537783,2025-04-05,Senate,"(S) 2nd Reading Concurred",50,0,0,0,50
1982725,1538419,2025-04-07,Senate,"(S) 3rd Reading Concurred",47,2,0,1,50
1982725,1545890,2025-04-11,House,"(H) 2nd Reading Senate Amendments Not Concur Motion Failed",41,58,0,1,100
1982725,1546357,2025-04-11,House,"(H) 3rd Reading Passed as Amended by Senate",56,43,0,1,100
1982736,1502518,2025-02-28,House,"(H) State Administration--To Table",17,2,0,0,19
1982756,1505457,2025-03-04,Senate,"(S) State Administration--Do Pass",6,3,0,0,9
1982756,1508233,2025-03-06,Senate,"(S) 2nd Reading Passed",32,18,0,0,50
1982756,1508234,2025-03-06,Senate,"(S) 3rd Reading Passed",30,19,0,1,50
1982756,1530303,2025-03-28,House,"(H) State Administration--Be Concurred In",19,0,0,0,19
1982756,1545465,2025-04-11,House,"(H) 2nd Reading Concurred",83,17,0,0,100
1982756,1546363,2025-04-11,House,"(H) 3rd Reading Concurred",88,11,0,1,100
1982763,1505354,2025-03-04,House,"(H) Local Government--Do Pass",17,0,0,0,17
1982763,1508099,2025-03-06,House,"(H) 2nd Reading Passed",78,17,0,5,100
1982763,1508686,2025-03-07,House,"(H) 3rd Reading Passed",83,16,0,1,100
1982763,1541120,2025-04-07,Senate,"(S) Local Government--Be Concurred In As Amended",8,2,0,0,10
1982763,1541790,2025-04-09,Senate,"(S) 2nd Reading Motion to Amend Carried",34,16,0,0,50
1982763,1541791,2025-04-09,Senate,"(S) 2nd Reading Motion to Amend Failed",20,30,0,0,50
1982763,1541792,2025-04-09,Senate,"(S) 2nd Reading Concurred as Amended",35,15,0,0,50
1982763,1545902,2025-04-11,Senate,"(S) 3rd Reading Concurred",34,14,0,2,50
1982763,1551416,2025-04-17,House,"(H) 2nd Reading Senate Amendments Concurred",100,0,0,0,100
1982763,1552190,2025-04-18,House,"(H) 3rd Reading Passed as Amended by Senate",80,18,0,2,100
1982776,1502321,2025-02-28,House,"(H) State Administration--Do Pass",11,8,0,0,19
1982776,1507032,2025-03-06,House,"(H) 2nd Reading Passed",55,43,0,2,100
1982776,1508724,2025-03-07,House,"(H) 3rd Reading Passed",56,43,0,1,100
1982776,1538490,2025-04-07,Senate,"(S) State Administration--Be Concurred In",9,0,0,0,9
1982776,1552159,2025-04-18,Senate,"(S) 2nd Reading Concurred",42,5,0,3,50
1982776,1554495,2025-04-22,Senate,"(S) 3rd Reading Concurred",48,2,0,0,50
1982787,1502663,2025-02-28,House,"(H) Transportation--To Table",14,0,0,0,14
1982805,1504310,2025-03-04,House,"(H) Judiciary--To Table",20,0,0,0,20
1982820,1502007,2025-02-27,House,"(H) Appropriations--Do Pass",15,8,0,0,23
1982820,1507968,2025-03-06,House,"(H) 2nd Reading Passed",66,33,0,1,100
1982820,1508564,2025-03-07,House,"(H) 3rd Reading Passed",67,32,0,1,100
1982820,1542689,2025-04-09,Senate,"(S) Finance and Claims--Be Concurred In",22,0,0,0,22
1982820,1552185,2025-04-18,Senate,"(S) 2nd Reading Concurred",45,4,0,1,50
1982820,1553744,2025-04-22,Senate,"(S) 3rd Reading Concurred",44,6,0,0,50
1982834,1502102,2025-02-27,Senate,"(S) Fish and Game--To Table",12,0,0,0,12
1982844,1506408,2025-03-04,Senate,"(S) Judiciary--Do Pass",5,3,0,0,8
1982844,1507879,2025-03-06,Senate,"(S) 2nd Reading Passed",42,8,0,0,50
1982844,1533455,2025-04-01,Senate,"(S) Finance and Claims--Do Pass",22,0,0,0,22
1982844,1536891,2025-04-03,Senate,"(S) 3rd Reading Passed",50,0,0,0,50
1982844,1548726,2025-04-15,House,"(H) Judiciary--Be Concurred In As Amended",20,0,0,0,20
1982844,1551137,2025-04-17,House,"(H) 2nd Reading Concurred",100,0,0,0,100
1982844,1551974,2025-03-04,Senate,"(S) Judiciary--Do Pass",5,3,0,0,8
1982844,1554542,2025-04-22,House,"(H) Appropriations--To Table",12,11,0,0,23
1982844,1556213,2025-04-22,House,"(H) Appropriations--To Table",12,11,0,0,23
1982864,1505415,2025-03-04,Senate,"(S) State Administration--Do Pass",9,0,0,0,9
1982864,1508078,2025-03-06,Senate,"(S) 2nd Reading Passed",48,2,0,0,50
1982864,1508079,2025-03-06,Senate,"(S) 3rd Reading Passed",49,0,0,1,50
1982864,1536137,2025-04-03,House,"(H) State Administration--Be Concurred In As Amended",11,8,0,0,19
1982864,1543617,2025-04-10,House,"(H) 2nd Reading Concurred",57,43,0,0,100
1982864,1546285,2025-04-11,House,"(H) 3rd Reading Concurred",56,43,0,1,100
1982864,1551559,2025-04-17,Senate,"(S) 2nd Reading House Amendments Concurred",49,0,0,1,50
1982864,1552346,2025-04-18,Senate,"(S) 3rd Reading Passed as Amended by House",44,6,0,0,50
1982883,1502089,2025-02-27,House,"(H) Fish, Wildlife and Parks--Do Pass",18,2,0,0,20
1982883,1508331,2025-03-06,House,"(H) 2nd Reading Passed",88,11,0,1,100
1982883,1508657,2025-03-07,House,"(H) 3rd Reading Passed",92,7,0,1,100
1982883,1541025,2025-04-08,Senate,"(S) Fish and Game--Be Concurred In As Amended",11,0,0,0,11
1982883,1545734,2025-04-11,Senate,"(S) 2nd Reading Concurred",48,1,0,1,50
1982883,1546741,2025-04-12,Senate,"(S) 3rd Reading Concurred",48,2,0,0,50
1982883,1551722,2025-04-17,House,"(H) 2nd Reading Senate Amendments Concurred",99,1,0,0,100
1982883,1552083,2025-04-18,House,"(H) 3rd Reading Passed as Amended by Senate",97,1,0,2,100
1982893,1505285,2025-03-04,Senate,"(S) Business, Labor  and Economic Affairs--Do Pass",10,2,0,0,12
1982893,1507959,2025-03-06,Senate,"(S) 2nd Reading Passed",45,5,0,0,50
1982893,1507960,2025-03-06,Senate,"(S) 3rd Reading Passed",39,10,0,1,50
1982893,1529460,2025-03-27,House,"(H) Business and Labor--Be Concurred In",20,0,0,0,20
1982893,1530953,2025-03-31,House,"(H) 2nd Reading Concurred",95,5,0,0,100
1982893,1533642,2025-04-01,House,"(H) 3rd Reading Concurred",93,6,0,1,100
1982911,1505135,2025-03-04,House,"(H) Judiciary--Do Pass",11,9,0,0,20
1982911,1507342,2025-03-06,House,"(H) 2nd Reading Not Passed",14,85,0,1,100
1982920,1506112,2025-03-04,Senate,"(S) Judiciary--Do Pass",7,1,0,0,8
1982920,1507933,2025-03-06,Senate,"(S) 2nd Reading Passed",50,0,0,0,50
1982920,1507934,2025-03-06,Senate,"(S) 3rd Reading Passed",47,2,0,1,50
1982920,1528839,2025-03-27,House,"(H) Judiciary--Be Concurred In",20,0,0,0,20
1982920,1531285,2025-03-31,House,"(H) 2nd Reading Concurred",98,2,0,0,100
1982920,1533270,2025-04-01,House,"(H) 3rd Reading Concurred",97,2,0,1,100
1982920,1549209,2025-03-04,Senate,"(S) Judiciary--Do Pass",7,1,0,0,8
1982941,1504418,2025-03-04,House,"(H) Judiciary--Do Pass",12,8,0,0,20
1982941,1507279,2025-03-06,House,"(H) 2nd Reading Not Passed",27,71,0,2,100
1982950,1503068,2025-03-01,House,"(H) Business and Labor--To Table",18,0,0,2,20
1982950,1515968,2025-03-04,House,"(H) Business and Labor--To Table",16,1,0,2,19
1982972,1501871,2025-02-27,House,"(H) Fish, Wildlife and Parks--Do Pass As Amended",16,4,0,0,20
1982972,1520034,2025-03-18,House,"(H) 2nd Reading Motion to Amend Carried",95,4,0,1,100
1982972,1520035,2025-03-18,House,"(H) 2nd Reading Passed as Amended",67,32,0,1,100
1982972,1529338,2025-03-27,House,"(H) Appropriations--Do Pass",21,2,0,0,23
1982972,1531042,2025-03-31,House,"(H) 3rd Reading Passed",73,26,0,1,100
1982972,1549378,2025-04-15,Senate,"(S) Fish and Game--Be Concurred In",8,3,0,0,11
1982972,1551963,2025-04-17,Senate,"(S) 2nd Reading Concurred",34,16,0,0,50
1982972,1557817,2025-04-24,Senate,"(S) Motion Carried",27,23,0,0,50
1982972,1558116,2025-04-25,Senate,"(S) 3rd Reading Concurred",29,20,0,1,50
1982987,1504318,2025-03-04,Senate,"(S) Business, Labor  and Economic Affairs--To Table",11,1,0,0,12
1983000,1506011,2025-03-01,Senate,"(S) State Administration--To Table",9,0,0,0,9
1983023,1501885,2025-02-27,Senate,"(S) Education and Cultural Resources--Do Pass",13,1,0,0,14
1983023,1508062,2025-03-06,Senate,"(S) 2nd Reading Passed",50,0,0,0,50
1983023,1508063,2025-03-06,Senate,"(S) 3rd Reading Passed",49,0,0,1,50
1983023,1542134,2025-04-09,House,"(H) Education--Be Concurred In",15,0,0,0,15
1983023,1545980,2025-04-11,House,"(H) 2nd Reading Concurred",94,6,0,0,100
1983023,1546480,2025-04-11,House,"(H) 3rd Reading Concurred",99,0,0,1,100
1983033,1505052,2025-03-04,Senate,"(S) Judiciary--Do Pass",7,1,0,0,8
1983033,1506920,2025-03-05,Senate,"(S) 2nd Reading Motion to Amend Carried",50,0,0,0,50
1983033,1506921,2025-03-05,Senate,"(S) 2nd Reading Passed as Amended",45,5,0,0,50
1983033,1508064,2025-03-06,Senate,"(S) 3rd Reading Passed",44,5,0,1,50
1983033,1543138,2025-04-09,House,"(H) Judiciary--Be Concurred In",12,8,0,0,20
1983033,1545048,2025-04-10,House,"(H) 2nd Reading Concurred",80,20,0,0,100
1983033,1546453,2025-04-11,House,"(H) 3rd Reading Concurred",72,27,0,1,100
1983033,1548360,2025-03-04,Senate,"(S) Judiciary--Do Pass",7,1,0,0,8
1983049,1504753,2025-03-04,House,"(H) Judiciary--Do Pass",12,8,0,0,20
1983049,1507068,2025-03-06,House,"(H) 2nd Reading Not Passed",44,55,0,1,100
1983066,1504639,2025-03-04,House,"(H) Agriculture--Do Pass",17,0,0,0,17
1983066,1507516,2025-03-06,House,"(H) 2nd Reading Passed",99,0,0,1,100
1983066,1508665,2025-03-07,House,"(H) 3rd Reading Passed",98,1,0,1,100
1983066,1533658,2025-04-01,Senate,"(S) Agriculture, Livestock and Irrigation--Be Concurred In As Amended",11,0,0,0,11
1983066,1537818,2025-04-05,Senate,"(S) 2nd Reading Concurred",46,4,0,0,50
1983066,1538561,2025-04-07,Senate,"(S) 3rd Reading Concurred",44,5,0,1,50
1983066,1551388,2025-04-17,House,"(H) 2nd Reading Senate Amendments Concurred",99,1,0,0,100
1983066,1552099,2025-04-18,House,"(H) 3rd Reading Passed as Amended by Senate",97,1,0,2,100
1983080,1502633,2025-02-28,House,"(H) Business and Labor--Do Pass",20,0,0,0,20
1983080,1507565,2025-03-06,House,"(H) 2nd Reading Passed",96,3,0,1,100
1983080,1508543,2025-03-07,House,"(H) 3rd Reading Passed",95,4,0,1,100
1983080,1527507,2025-03-26,Senate,"(S) Business, Labor  and Economic Affairs--Be Concurred In",12,0,0,0,12
1983080,1551975,2025-04-17,Senate,"(S) 2nd Reading Concurred",46,2,0,2,50
1983080,1552340,2025-04-18,Senate,"(S) 3rd Reading Concurred",47,3,0,0,50
1983101,1504432,2025-03-04,Senate,"(S) Business, Labor  and Economic Affairs--Do Pass",9,3,0,0,12
1983101,1507262,2025-03-06,Senate,"(S) 2nd Reading Passed",30,20,0,0,50
1983101,1507844,2025-03-06,Senate,"(S) 3rd Reading Passed",28,21,0,1,50
1983101,1530035,2025-03-28,House,"(H) Business and Labor--Be Concurred In As Amended",20,0,0,0,20
1983101,1543991,2025-04-10,House,"(H) 2nd Reading Concurred",84,15,0,1,100
1983101,1546134,2025-04-11,House,"(H) 3rd Reading Concurred",77,22,0,1,100
1983101,1551500,2025-04-17,Senate,"(S) 2nd Reading House Amendments Concurred",34,16,0,0,50
1983101,1552290,2025-04-18,Senate,"(S) 3rd Reading Passed as Amended by House",30,20,0,0,50
1983110,1503767,2025-03-03,Senate,"(S) Local Government--To Table",11,0,0,0,11
1983134,1534012,2025-04-01,Senate,"(S) Education and Cultural Resources--Resolution Adopted As Amended",14,0,0,0,14
1983134,1536943,2025-04-03,Senate,"(S) 2nd Reading Passed",49,0,0,1,50
1983134,1537510,2025-04-04,Senate,"(S) 3rd Reading Passed",49,0,0,1,50
1983134,1550783,2025-04-16,House,"(H) Energy, Technology and Federal Relations--Be Concurred In",14,0,0,0,14
1983134,1556985,2025-04-24,House,"(H) 2nd Reading Concurred",100,0,0,0,100
1983134,1558065,2025-04-25,House,"(H) 3rd Reading Concurred",100,0,0,0,100
1983143,1502104,2025-02-27,Senate,"(S) Fish and Game--To Table",12,0,0,0,12
1983161,1504935,2025-03-04,House,"(H) Judiciary--Do Pass",12,8,0,0,20
1983161,1507969,2025-03-06,House,"(H) 2nd Reading Not Passed",40,59,0,1,100
1983173,1505130,2025-03-04,House,"(H) Judiciary--Do Pass",12,8,0,0,20
1983173,1508101,2025-03-06,House,"(H) 2nd Reading Passed",80,19,0,1,100
1983173,1508763,2025-03-07,House,"(H) 3rd Reading Passed",77,22,0,1,100
1983173,1539069,2025-04-07,Senate,"(S) Judiciary--To Table",8,0,0,0,8
1983173,1543483,2025-04-07,Senate,"(S) Judiciary--To Table",8,0,0,0,8
1983192,1502875,2025-02-28,House,"(H) Human Services--To Table",12,3,0,6,21
1983206,1502967,2025-03-01,House,"(H) Human Services--Do Pass As Amended",11,10,0,0,21
1983206,1506572,2025-03-05,House,"(H) 2nd Reading Motion to Amend Carried",95,4,0,1,100
1983206,1506573,2025-03-05,House,"(H) 2nd Reading Passed as Amended",64,35,0,1,100
1983206,1508679,2025-03-07,House,"(H) 3rd Reading Passed",78,21,0,1,100
1983206,1538803,2025-04-07,Senate,"(S) Public Health, Welfare and Safety--To Table",11,0,0,0,11
1983206,1544000,2025-04-07,Senate,"(S) Public Health, Welfare and Safety--To Table",11,0,0,0,11
1983222,1503732,2025-03-03,Senate,"(S) Local Government--To Table",11,0,0,0,11
1983239,1503650,2025-03-01,Senate,"(S) State Administration--Do Pass As Amended",6,3,0,0,9
1983239,1505699,2025-03-05,Senate,"(S) 2nd Reading Motion to Amend Carried",49,1,0,0,50
1983239,1505700,2025-03-05,Senate,"(S) 2nd Reading Passed as Amended",33,17,0,0,50
1983239,1508105,2025-03-06,Senate,"(S) 3rd Reading Passed",33,16,0,1,50
1983239,1529861,2025-03-28,House,"(H) State Administration--Be Concurred In",11,8,0,0,19
1983239,1543762,2025-04-10,House,"(H) 2nd Reading Concurred",58,42,0,0,100
1983239,1546023,2025-04-11,House,"(H) 3rd Reading Concurred",58,41,0,1,100
1983254,1503528,2025-03-03,House,"(H) Judiciary--Do Pass As Amended",12,8,0,0,20
1983254,1506163,2025-03-05,House,"(H) 2nd Reading Passed",51,47,0,2,100
1983254,1508656,2025-03-07,House,"(H) 3rd Reading Passed",59,40,0,1,100
1983254,1537259,2025-04-04,Senate,"(S) Judiciary--Be Concurred In As Amended",8,0,0,0,8
1983254,1542223,2025-04-09,Senate,"(S) 2nd Reading Concurred",50,0,0,0,50
1983254,1543667,2025-04-10,Senate,"(S) 3rd Reading Concurred",48,0,0,2,50
1983254,1551262,2025-04-17,House,"(H) 2nd Reading Senate Amendments Concurred",100,0,0,0,100
1983254,1552070,2025-04-18,House,"(H) 3rd Reading Passed as Amended by Senate",82,16,0,2,100
1983268,1502791,2025-02-28,House,"(H) Education--To Table",15,0,0,0,15
1983284,1502027,2025-02-27,House,"(H) Appropriations--Do Pass",17,6,0,0,23
1983284,1507676,2025-03-06,House,"(H) 2nd Reading Passed",58,41,0,1,100
1983284,1508576,2025-03-07,House,"(H) 3rd Reading Passed",62,37,0,1,100
1983284,1534756,2025-04-02,Senate,"(S) Finance and Claims--Be Concurred In",22,0,0,0,22
1983284,1552091,2025-04-18,Senate,"(S) 2nd Reading Concurred",40,6,0,4,50
1983284,1553823,2025-04-22,Senate,"(S) 3rd Reading Concurred",40,10,0,0,50
1983304,1503376,2025-03-03,Senate,"(S) Judiciary--Do Pass",8,0,0,0,8
1983304,1508097,2025-03-06,Senate,"(S) 2nd Reading Passed",50,0,0,0,50
1983304,1508098,2025-03-06,Senate,"(S) 3rd Reading Passed",49,0,0,1,50
1983304,1528793,2025-03-27,House,"(H) Judiciary--Be Concurred In As Amended",20,0,0,0,20
1983304,1531432,2025-03-31,House,"(H) 2nd Reading Concurred",100,0,0,0,100
1983304,1532609,2025-04-01,House,"(H) 3rd Reading Concurred",99,0,0,1,100
1983304,1537583,2025-04-04,Senate,"(S) 2nd Reading House Amendments Concurred",48,0,0,2,50
1983304,1537744,2025-04-05,Senate,"(S) 3rd Reading Passed as Amended by House",48,0,0,2,50
1983313,1503581,2025-03-03,House,"(H) Judiciary--Do Pass",20,0,0,0,20
1983313,1506769,2025-03-05,House,"(H) 2nd Reading Passed",98,0,0,2,100
1983313,1508829,2025-03-07,House,"(H) 3rd Reading Passed",99,0,0,1,100
1983313,1538325,2025-04-07,Senate,"(S) Judiciary--Be Concurred In",8,0,0,0,8
1983313,1552135,2025-04-18,Senate,"(S) 2nd Reading Concurred",43,5,0,2,50
1983313,1554560,2025-04-22,Senate,"(S) 3rd Reading Concurred",38,12,0,0,50
1983333,1504951,2025-03-04,Senate,"(S) Education and Cultural Resources--To Table",11,3,0,0,14
1983354,1505476,2025-03-04,Senate,"(S) State Administration--To Table",9,0,0,0,9
1983367,1502865,2025-02-28,Senate,"(S) State Administration--Do Pass As Amended",5,4,0,0,9
1983367,1507794,2025-03-06,Senate,"(S) 2nd Reading Indefinitely Postponed",32,18,0,0,50
1983367,1507795,2025-03-06,Senate,"(S) 2nd Reading Pass Motion Failed",21,29,0,0,50
1983381,1504579,2025-03-04,Senate,"(S) Business, Labor  and Economic Affairs--Do Pass",12,0,0,0,12
1983381,1505895,2025-03-04,Senate,"(S) Business, Labor  and Economic Affairs--To Table",12,0,0,0,12
1983392,1504020,2025-03-03,House,"(H) Judiciary--Do Pass",18,2,0,0,20
1983392,1507537,2025-03-06,House,"(H) 2nd Reading Not Passed",48,51,0,1,100
1983415,1502479,2025-02-28,House,"(H) Human Services--To Table",15,0,0,6,21
1983423,1503071,2025-03-01,House,"(H) Business and Labor--Do Pass As Amended",14,4,0,2,20
1983423,1508005,2025-03-06,House,"(H) 2nd Reading Passed",83,16,0,1,100
1983423,1508727,2025-03-07,House,"(H) 3rd Reading Passed",81,18,0,1,100
1983423,1541562,2025-04-09,Senate,"(S) Business, Labor  and Economic Affairs--To Table",10,1,0,0,11
1983423,1543303,2025-04-09,Senate,"(S) Business, Labor  and Economic Affairs--To Table",10,1,0,0,11
1983442,1502228,2025-02-28,House,"(H) State Administration--Do Pass",19,0,0,0,19
1983442,1507613,2025-03-06,House,"(H) 2nd Reading Passed",96,3,0,1,100
1983442,1508641,2025-03-07,House,"(H) 3rd Reading Passed",95,4,0,1,100
1983442,1547972,2025-04-14,Senate,"(S) State Administration--Be Concurred In",9,0,0,0,9
1983442,1552106,2025-04-18,Senate,"(S) 2nd Reading Concurred",46,1,0,3,50
1983442,1554073,2025-04-22,Senate,"(S) 3rd Reading Concurred",46,4,0,0,50
1983464,1505023,2025-03-04,Senate,"(S) Business, Labor  and Economic Affairs--To Table",9,3,0,0,12
1983472,1504334,2025-03-04,House,"(H) Energy, Technology and Federal Relations--Do Pass",14,0,0,0,14
1983472,1506845,2025-03-05,House,"(H) 2nd Reading Passed",97,0,0,3,100
1983472,1508580,2025-03-07,House,"(H) 3rd Reading Passed",99,0,0,1,100
1983472,1540244,2025-04-08,Senate,"(S) Energy, Technology & Federal Relations--Be Concurred In",13,0,0,0,13
1983472,1552129,2025-04-18,Senate,"(S) 2nd Reading Concurred",46,2,0,2,50
1983472,1553554,2025-04-22,Senate,"(S) 3rd Reading Concurred",49,1,0,0,50
1983493,1502099,2025-02-27,Senate,"(S) Education and Cultural Resources--Do Pass",14,0,0,0,14
1983493,1508059,2025-03-06,Senate,"(S) 2nd Reading Passed",48,2,0,0,50
1983493,1508060,2025-03-06,Senate,"(S) 3rd Reading Passed",47,2,0,1,50
1983493,1539211,2025-04-07,House,"(H) Education--Be Concurred In",15,0,0,0,15
1983493,1544849,2025-04-10,House,"(H) 2nd Reading Concurred",99,1,0,0,100
1983493,1546327,2025-04-11,House,"(H) 3rd Reading Concurred",97,2,0,1,100
1983523,1504684,2025-03-04,House,"(H) Judiciary--To Table",18,2,0,0,20
1983534,1506406,2025-03-04,Senate,"(S) Judiciary--Do Pass",5,3,0,0,8
1983534,1507223,2025-03-06,Senate,"(S) 2nd Reading Indefinitely Postponed",29,20,0,1,50
1983534,1507224,2025-03-06,Senate,"(S) 2nd Reading Pass Motion Failed",25,25,0,0,50
1983534,1507225,2025-03-06,Senate,"(S) Motion to Reconsider Failed",23,27,0,0,50
1983534,1548582,2025-03-04,Senate,"(S) Judiciary--Do Pass",5,3,0,0,8
1983550,1502347,2025-02-28,House,"(H) State Administration--Do Pass",10,9,0,0,19
1983550,1506954,2025-03-05,House,"(H) 2nd Reading Passed",53,46,0,1,100
1983550,1508536,2025-03-07,House,"(H) 3rd Reading Passed",56,43,0,1,100
1983550,1537298,2025-04-04,Senate,"(S) State Administration--Be Concurred In",0,0,9,0,9
1983550,1537299,2025-04-04,Senate,"(S) State Administration--Be Concurred In As Amended",9,0,0,0,9
1983550,1543724,2025-04-10,Senate,"(S) 2nd Reading Concur Motion Failed",20,29,0,1,50
1983550,1545175,2025-04-10,Senate,"(S) 2nd Reading Indefinitely Postponed",40,9,0,1,50
1983550,1546093,2025-04-11,Senate,"(S) Reconsidered Previous Action; Placed on 2nd Reading",30,18,0,2,50
1983550,1546094,2025-04-11,Senate,"(S) 2nd Reading Concurred",42,8,0,0,50
1983550,1546667,2025-04-12,Senate,"(S) 3rd Reading Concurred",40,10,0,0,50
1983550,1551623,2025-04-17,House,"(H) 2nd Reading Senate Amendments Concurred",99,1,0,0,100
1983550,1552229,2025-04-18,House,"(H) 3rd Reading Passed as Amended by Senate",59,39,0,2,100
1983583,1502513,2025-02-28,House,"(H) State Administration--To Table",16,3,0,0,19
1983584,1502640,2025-02-28,Senate,"(S) Judiciary--To Table",5,3,0,0,8
1983591,1505325,2025-03-04,House,"(H) Judiciary--Do Pass",20,0,0,0,20
1983591,1508090,2025-03-06,House,"(H) 2nd Reading Passed",97,2,0,1,100
1983591,1508538,2025-03-07,House,"(H) 3rd Reading Passed",97,2,0,1,100
1983591,1542034,2025-04-09,Senate,"(S) Judiciary--To Table",8,0,0,0,8
1983591,1543580,2025-04-09,Senate,"(S) Judiciary--To Table",8,0,0,0,8
1983599,1503747,2025-03-03,Senate,"(S) Public Health, Welfare and Safety--Do Pass",9,2,0,0,11
1983599,1507523,2025-03-06,Senate,"(S) 2nd Reading Passed",44,6,0,0,50
1983599,1508319,2025-03-06,Senate,"(S) 3rd Reading Passed",42,7,0,1,50
1983599,1527101,2025-03-25,House,"(H) Human Services--Be Concurred In",21,0,0,0,21
1983599,1546365,2025-04-11,House,"(H) 2nd Reading Concurred",93,7,0,0,100
1983599,1546366,2025-04-11,House,"(H) 3rd Reading Concurred",94,5,0,1,100
1983611,1504112,2025-03-03,Senate,"(S) Highways and Transportation--Do Pass",8,0,0,0,8
1983611,1507530,2025-03-06,Senate,"(S) 2nd Reading Passed",44,6,0,0,50
1983611,1508317,2025-03-06,Senate,"(S) 3rd Reading Passed",42,7,0,1,50
1983611,1541563,2025-04-09,House,"(H) Judiciary--Be Concurred In",14,6,0,0,20
1983611,1546323,2025-04-11,House,"(H) 2nd Reading Concurred",61,39,0,0,100
1983611,1546324,2025-04-11,House,"(H) 3rd Reading Concurred",62,37,0,1,100
1983613,1503791,2025-03-03,House,"(H) Business and Labor--To Table",17,3,0,0,20
1983624,1504714,2025-03-04,House,"(H) Judiciary--To Table",18,2,0,0,20
1983624,1506609,2025-03-05,House,"(H) Taken from Committee; Placed on 2nd Reading",48,50,0,2,100
1983624,1541908,2025-03-05,House,"(H) Taken from Committee; Placed on 2nd Reading",48,50,0,2,100
1983634,1504014,2025-03-03,Senate,"(S) Natural Resources--Do Pass",10,1,0,0,11
1983634,1508031,2025-03-06,Senate,"(S) 2nd Reading Passed",40,10,0,0,50
1983634,1508032,2025-03-06,Senate,"(S) 3rd Reading Passed",37,12,0,1,50
1983634,1528799,2025-03-26,House,"(H) Natural Resources--To Table",14,0,0,0,14
1983634,1537086,2025-03-26,House,"(H) Natural Resources--To Table",14,0,0,0,14
1983636,1503763,2025-03-03,Senate,"(S) Public Health, Welfare and Safety--To Table",10,1,0,0,11
1983651,1502536,2025-02-28,Senate,"(S) Taxation--To Table",8,0,0,0,8
1983659,1504370,2025-03-04,Senate,"(S) Business, Labor  and Economic Affairs--To Table",11,1,0,0,12
1983668,1501657,2025-02-27,Senate,"(S) Fish and Game--Do Pass As Amended",12,0,0,0,12
1983668,1507498,2025-03-06,Senate,"(S) 2nd Reading Passed",46,4,0,0,50
1983668,1508320,2025-03-06,Senate,"(S) 3rd Reading Passed",40,9,0,1,50
1983668,1541176,2025-04-08,House,"(H) Fish, Wildlife and Parks--To Table",12,8,0,0,20
1983668,1542597,2025-04-08,House,"(H) Fish, Wildlife and Parks--To Table",12,8,0,0,20
1983668,1551601,2025-04-17,House,"(H) Fish, Wildlife and Parks--Be Concurred In",16,4,0,0,20
1983668,1556250,2025-04-23,House,"(H) 2nd Reading Concurred",96,4,0,0,100
1983668,1556793,2025-04-24,House,"(H) 3rd Reading Concurred",97,2,0,1,100
1983679,1502991,2025-03-01,Senate,"(S) Energy, Technology & Federal Relations--To Table",13,0,0,0,13
1983685,1503634,2025-03-03,House,"(H) Business and Labor--To Table",16,0,0,4,20
1983693,1504088,2025-03-03,Senate,"(S) Local Government--To Table",11,0,0,0,11
1983697,1502742,2025-02-28,House,"(H) Education--Do Pass",15,0,0,0,15
1983697,1508310,2025-03-06,House,"(H) 2nd Reading Passed",98,1,0,1,100
1983697,1508740,2025-03-07,House,"(H) 3rd Reading Passed",99,0,0,1,100
1983697,1540992,2025-04-08,Senate,"(S) Education and Cultural Resources--Be Concurred In",12,2,0,0,14
1983697,1552245,2025-04-18,Senate,"(S) 2nd Reading Concurred",47,1,0,2,50
1983697,1553993,2025-04-22,Senate,"(S) 3rd Reading Concurred",50,0,0,0,50
1983714,1504654,2025-03-04,House,"(H) Judiciary--To Table",19,1,0,0,20
1983722,1504961,2025-03-04,Senate,"(S) Agriculture, Livestock and Irrigation--To Table",7,4,0,0,11
1983727,1504559,2025-03-04,House,"(H) Judiciary--To Table",20,0,0,0,20
1983735,1502488,2025-02-28,House,"(H) State Administration--To Table",19,0,0,0,19
1983745,1504863,2025-03-03,House,"(H) Human Services--To Table",17,0,0,3,20
1983745,1527173,2025-03-25,House,"(H) Human Services--Do Pass As Amended",20,1,0,0,21
1983745,1530261,2025-03-28,House,"(H) 2nd Reading Not Passed",50,50,0,0,100
1983745,1530710,2025-03-29,House,"(H) Reconsidered Previous Action; Placed on 2nd Reading",56,40,0,4,100
1983745,1537087,2025-04-03,House,"(H) Appropriations--Do Pass As Amended",14,9,0,0,23
1983745,1538306,2025-04-07,House,"(H) 2nd Reading Not Passed",49,51,0,0,100
1983750,1502983,2025-03-01,Senate,"(S) Legislative Administration--To Table",6,0,0,0,6
1983759,1505065,2025-03-04,Senate,"(S) Business, Labor  and Economic Affairs--Do Pass",12,0,0,0,12
1983759,1508136,2025-03-06,Senate,"(S) 2nd Reading Passed",43,7,0,0,50
1983759,1508137,2025-03-06,Senate,"(S) 3rd Reading Passed",34,15,0,1,50
1983759,1530315,2025-03-28,House,"(H) Business and Labor--Be Concurred In",17,3,0,0,20
1983759,1546249,2025-04-11,House,"(H) 2nd Reading Concurred",84,16,0,0,100
1983759,1546250,2025-04-11,House,"(H) 3rd Reading Concurred",77,22,0,1,100
1983763,1505074,2025-03-04,House,"(H) Local Government--To Table",14,3,0,0,17
1983779,1502510,2025-02-28,House,"(H) State Administration--To Table",18,1,0,0,19
1983783,1502661,2025-02-28,Senate,"(S) Judiciary--To Table",5,3,0,0,8
1983795,1502144,2025-02-27,Senate,"(S) Education and Cultural Resources--To Table",9,5,0,0,14
1983807,1502650,2025-02-28,House,"(H) Taxation--Do Pass",21,0,0,0,21
1983807,1505053,2025-03-04,House,"(H) 2nd Reading Passed",99,0,0,1,100
1983807,1505651,2025-03-05,House,"(H) 3rd Reading Passed",98,0,0,2,100
1983807,1534601,2025-04-02,Senate,"(S) Taxation--Be Concurred In As Amended",8,0,0,0,8
1983807,1537854,2025-04-05,Senate,"(S) 2nd Reading Concurred",50,0,0,0,50
1983807,1538657,2025-04-07,Senate,"(S) 3rd Reading Concurred",49,0,0,1,50
1983807,1551938,2025-04-17,House,"(H) 2nd Reading Senate Amendments Concurred",100,0,0,0,100
1983807,1552125,2025-04-18,House,"(H) 3rd Reading Passed as Amended by Senate",98,0,0,2,100
1983808,1502517,2025-02-28,House,"(H) State Administration--Do Pass",19,0,0,0,19
1983808,1507583,2025-03-06,House,"(H) 2nd Reading Passed",99,0,0,1,100
1983808,1508662,2025-03-07,House,"(H) 3rd Reading Passed",99,0,0,1,100
1983808,1536904,2025-04-03,Senate,"(S) Education and Cultural Resources--Be Concurred In",14,0,0,0,14
1983808,1552152,2025-04-18,Senate,"(S) 2nd Reading Concurred",48,0,0,2,50
1983808,1554687,2025-04-22,Senate,"(S) 3rd Reading Concurred",47,3,0,0,50
1983818,1505437,2025-03-04,House,"(H) Local Government--To Table",17,0,0,0,17
1983916,1504918,2025-03-04,Senate,"(S) Business, Labor  and Economic Affairs--Do Pass",12,0,0,0,12
1983916,1507620,2025-03-06,Senate,"(S) 2nd Reading Passed",49,1,0,0,50
1983916,1508111,2025-03-06,Senate,"(S) 3rd Reading Passed",42,7,0,1,50
1983916,1529882,2025-03-28,House,"(H) Business and Labor--Be Concurred In",20,0,0,0,20
1983916,1546082,2025-04-11,House,"(H) 2nd Reading Concurred",84,16,0,0,100
1983916,1546083,2025-04-11,House,"(H) 3rd Reading Concurred",85,14,0,1,100
1983934,1504603,2025-03-04,House,"(H) Judiciary--Do Pass",12,8,0,0,20
1983934,1507681,2025-03-06,House,"(H) 2nd Reading Passed",60,39,0,1,100
1983934,1508577,2025-03-07,House,"(H) 3rd Reading Passed",59,40,0,1,100
1983934,1536373,2025-04-03,Senate,"(S) Judiciary--Be Concurred In",5,3,0,0,8
1983934,1552334,2025-04-18,Senate,"(S) 2nd Reading Concurred",37,11,0,2,50
1983934,1554386,2025-04-22,Senate,"(S) 3rd Reading Concurred",37,13,0,0,50
1983956,1505193,2025-03-04,Senate,"(S) Agriculture, Livestock and Irrigation--To Table",10,1,0,0,11
1983979,1504588,2025-03-04,House,"(H) Judiciary--Do Pass",12,8,0,0,20
1983979,1507514,2025-03-06,House,"(H) 2nd Reading Passed",57,42,0,1,100
1983979,1508729,2025-03-07,House,"(H) 3rd Reading Passed",57,42,0,1,100
1983979,1542061,2025-04-09,Senate,"(S) Judiciary--Be Concurred In As Amended",5,3,0,0,8
1983979,1545940,2025-04-11,Senate,"(S) 2nd Reading Motion to Amend Failed",22,27,0,1,50
1983979,1545941,2025-04-11,Senate,"(S) 2nd Reading Concurred",26,23,0,1,50
1983979,1546675,2025-04-12,Senate,"(S) 3rd Reading Concurred",32,18,0,0,50
1983979,1551773,2025-04-17,House,"(H) 2nd Reading Senate Amendments Concurred",75,25,0,0,100
1983979,1552218,2025-04-18,House,"(H) 3rd Reading Passed as Amended by Senate",58,41,0,1,100
1984005,1502739,2025-02-28,Senate,"(S) Public Health, Welfare and Safety--Do Pass",11,0,0,0,11
1984005,1507557,2025-03-06,Senate,"(S) 2nd Reading Passed",49,1,0,0,50
1984005,1508237,2025-03-06,Senate,"(S) 3rd Reading Passed",49,0,0,1,50
1984005,1527024,2025-03-25,House,"(H) Human Services--Be Concurred In",21,0,0,0,21
1984005,1545802,2025-04-11,House,"(H) 2nd Reading Concurred",100,0,0,0,100
1984005,1546295,2025-04-11,House,"(H) 3rd Reading Concurred",99,0,0,1,100
1984029,1502326,2025-02-28,House,"(H) State Administration--Do Pass",13,6,0,0,19
1984029,1507697,2025-03-06,House,"(H) 2nd Reading Passed",91,7,0,2,100
1984029,1508719,2025-03-07,House,"(H) 3rd Reading Passed",92,7,0,1,100
1984029,1538552,2025-04-07,Senate,"(S) State Administration--Be Concurred In As Amended",8,1,0,0,9
1984029,1543747,2025-04-10,Senate,"(S) 2nd Reading Concurred",39,9,0,2,50
1984029,1546151,2025-04-11,Senate,"(S) 3rd Reading Concurred",35,13,0,2,50
1984029,1551389,2025-04-17,House,"(H) 2nd Reading Senate Amendments Concurred",59,41,0,0,100
1984029,1552186,2025-04-18,House,"(H) 3rd Reading Passed as Amended by Senate",56,42,0,2,100
1984053,1503789,2025-03-03,House,"(H) Business and Labor--Do Pass",20,0,0,0,20
1984053,1507581,2025-03-06,House,"(H) 2nd Reading Passed",98,0,0,2,100
1984053,1508463,2025-03-07,House,"(H) 3rd Reading Passed",99,0,0,1,100
1984053,1530132,2025-03-28,Senate,"(S) Business, Labor  and Economic Affairs--Be Concurred In",12,0,0,0,12
1984053,1552029,2025-04-17,Senate,"(S) 2nd Reading Concurred",47,0,0,3,50
1984053,1552196,2025-04-18,Senate,"(S) 3rd Reading Concurred",50,0,0,0,50
1984072,1524833,2025-03-24,House,"(H) Judiciary--To Table",12,8,0,0,20
1984102,1505352,2025-03-04,Senate,"(S) Business, Labor  and Economic Affairs--To Table",10,2,0,0,12
1984122,1504321,2025-03-04,House,"(H) Judiciary--Do Pass",12,8,0,0,20
1984122,1507202,2025-03-06,House,"(H) 2nd Reading Not Passed",46,53,0,1,100
1984122,1507754,2025-03-06,House,"(H) Reconsidered Previous Action; Placed on 2nd Reading",44,52,0,4,100
1984148,1503034,2025-03-01,House,"(H) Human Services--Do Pass",21,0,0,0,21
1984148,1508089,2025-03-06,House,"(H) 2nd Reading Passed",99,0,0,1,100
1984148,1508825,2025-03-07,House,"(H) 3rd Reading Passed",99,0,0,1,100
1984148,1530352,2025-03-28,Senate,"(S) Public Health, Welfare and Safety--Be Concurred In",9,2,0,0,11
1984148,1545094,2025-04-10,Senate,"(S) 2nd Reading Concurred",45,4,0,1,50
1984148,1546362,2025-04-11,Senate,"(S) 3rd Reading Concurred",45,3,0,2,50
1984177,1503015,2025-03-01,House,"(H) Human Services--Do Pass",12,9,0,0,21
1984177,1507740,2025-03-06,House,"(H) 2nd Reading Passed",57,42,0,1,100
1984177,1508582,2025-03-07,House,"(H) 3rd Reading Passed",57,42,0,1,100
1984177,1530471,2025-03-28,Senate,"(S) Public Health, Welfare and Safety--Be Concurred In",7,4,0,0,11
1984177,1552307,2025-04-18,Senate,"(S) 2nd Reading Concurred",30,18,0,2,50
1984177,1554328,2025-04-22,Senate,"(S) 3rd Reading Concurred",32,18,0,0,50
1984202,1502562,2025-02-28,House,"(H) Taxation--To Table",16,5,0,0,21
1984222,1504574,2025-03-04,House,"(H) Judiciary--Do Pass",20,0,0,0,20
1984222,1508094,2025-03-06,House,"(H) 2nd Reading Passed",98,0,0,2,100
1984222,1508531,2025-03-07,House,"(H) 3rd Reading Passed",97,2,0,1,100
1984222,1541589,2025-04-09,Senate,"(S) Judiciary--Be Concurred In As Amended",8,0,0,0,8
1984222,1546409,2025-04-11,Senate,"(S) 2nd Reading Concurred",49,0,0,1,50
1984222,1546756,2025-04-12,Senate,"(S) 3rd Reading Concurred",50,0,0,0,50
1984222,1551761,2025-04-17,House,"(H) 2nd Reading Senate Amendments Concurred",100,0,0,0,100
1984222,1552297,2025-04-18,House,"(H) 3rd Reading Passed as Amended by Senate",99,0,0,1,100
1984244,1503190,2025-03-03,House,"(H) Judiciary--Do Pass",11,9,0,0,20
1984244,1507779,2025-03-06,House,"(H) 2nd Reading Passed",52,46,0,2,100
1984244,1508599,2025-03-07,House,"(H) 3rd Reading Passed",51,48,0,1,100
1984244,1541962,2025-04-09,Senate,"(S) Judiciary--To Table",8,0,0,0,8
1984244,1541963,2025-04-09,Senate,"(S) Taken from Committee; Placed on 2nd Reading",29,19,0,2,50
1984244,1543537,2025-04-09,Senate,"(S) Taken from Committee; Placed on 2nd Reading",29,19,0,2,50
1984244,1543538,2025-04-09,Senate,"(S) Judiciary--To Table",8,0,0,0,8
1984272,1505272,2025-03-04,House,"(H) Judiciary--To Table",18,2,0,0,20
1984296,1503816,2025-03-03,House,"(H) Business and Labor--Do Pass",12,8,0,0,20
1984296,1506210,2025-03-05,House,"(H) 2nd Reading Motion to Amend Carried",99,0,0,1,100
1984296,1508753,2025-03-07,House,"(H) 3rd Reading Passed",94,5,0,1,100
1984296,1534094,2025-04-02,Senate,"(S) Business, Labor  and Economic Affairs--Be Concurred In As Amended",6,5,0,0,11
1984296,1537749,2025-04-05,Senate,"(S) 2nd Reading Concurred",42,7,0,1,50
1984296,1538633,2025-04-07,Senate,"(S) 3rd Reading Concurred",46,3,0,1,50
1984296,1551748,2025-04-17,House,"(H) 2nd Reading Senate Amendments Concurred",99,1,0,0,100
1984296,1552192,2025-04-18,House,"(H) 3rd Reading Passed as Amended by Senate",99,0,0,1,100
1984320,1504981,2025-03-04,House,"(H) Local Government--To Table",14,3,0,0,17
1984340,1503047,2025-03-01,House,"(H) Business and Labor--Do Pass As Amended",20,0,0,0,20
1984340,1508074,2025-03-06,House,"(H) 2nd Reading Passed",98,1,0,1,100
1984340,1508524,2025-03-07,House,"(H) 3rd Reading Passed",98,1,0,1,100
1984340,1529948,2025-03-28,Senate,"(S) Business, Labor  and Economic Affairs--Be Concurred In As Amended",12,0,0,0,12
1984340,1537714,2025-04-05,Senate,"(S) 2nd Reading Concurred",50,0,0,0,50
1984340,1538662,2025-04-07,Senate,"(S) 3rd Reading Concurred",48,0,0,2,50
1984340,1551356,2025-04-17,House,"(H) 2nd Reading Senate Amendments Concurred",100,0,0,0,100
1984340,1552081,2025-04-18,House,"(H) 3rd Reading Passed as Amended by Senate",97,1,0,2,100
1984366,1503206,2025-03-03,House,"(H) Business and Labor--To Table",17,3,0,0,20
1984388,1503575,2025-03-03,House,"(H) Business and Labor--To Table",20,0,0,0,20
1984521,1502610,2025-02-28,Senate,"(S) Taxation--To Table",8,0,0,0,8
1984629,1504104,2025-03-03,Senate,"(S) Natural Resources--Do Pass",8,3,0,0,11
1984629,1507664,2025-03-06,Senate,"(S) 2nd Reading Passed",41,9,0,0,50
1984629,1508186,2025-03-06,Senate,"(S) 3rd Reading Passed",36,13,0,1,50
1984629,1531463,2025-03-31,House,"(H) Natural Resources--Be Concurred In As Amended",8,6,0,0,14
1984629,1544510,2025-04-10,House,"(H) 2nd Reading Concurred",61,39,0,0,100
1984629,1546443,2025-04-11,House,"(H) 3rd Reading Concurred",61,38,0,1,100
1984629,1551568,2025-04-17,Senate,"(S) 2nd Reading House Amendments Concurred",49,1,0,0,50
1984629,1552321,2025-04-18,Senate,"(S) 3rd Reading Passed as Amended by House",46,4,0,0,50
1984735,1504093,2025-03-03,House,"(H) Natural Resources--To Table",14,0,0,0,14
1984735,1524234,2025-03-21,House,"(H) Natural Resources--Do Pass As Amended",14,0,0,0,14
1984735,1527604,2025-03-26,House,"(H) 2nd Reading Motion to Amend Carried",74,26,0,0,100
1984735,1527605,2025-03-26,House,"(H) 2nd Reading Passed as Amended",58,42,0,0,100
1984735,1530181,2025-03-28,House,"(H) 3rd Reading Passed",60,39,0,1,100
1984735,1546376,2025-04-11,Senate,"(S) Natural Resources--Be Concurred In",11,0,0,0,11
1984735,1548335,2025-04-15,Senate,"(S) 2nd Reading Concurred",48,1,0,1,50
1984735,1549988,2025-04-16,Senate,"(S) 3rd Reading Concurred",49,1,0,0,50
1984846,1525147,2025-03-24,House,"(H) Business and Labor--To Table",14,0,0,6,20
1984957,1505580,2025-03-04,Senate,"(S) Education and Cultural Resources--To Table",13,1,0,0,14
1985064,1504137,2025-03-03,Senate,"(S) Public Health, Welfare and Safety--Do Pass",11,0,0,0,11
1985064,1508271,2025-03-06,Senate,"(S) 2nd Reading Passed",49,1,0,0,50
1985064,1508272,2025-03-06,Senate,"(S) 3rd Reading Passed",49,0,0,1,50
1985064,1528386,2025-03-26,House,"(H) Human Services--Be Concurred In",21,0,0,0,21
1985064,1541557,2025-04-09,House,"(H) 2nd Reading Concurred",88,12,0,0,100
1985064,1543178,2025-04-09,House,"(H) Appropriations--Be Concurred In As Amended",14,9,0,0,23
1985064,1546240,2025-04-11,House,"(H) 2nd Reading Concurred",88,12,0,0,100
1985064,1546241,2025-04-11,House,"(H) 3rd Reading Concurred",91,7,0,2,100
1985064,1551814,2025-04-17,Senate,"(S) 2nd Reading House Amendments Not Concurred",46,4,0,0,50
1985064,1560469,2025-04-29,Senate,"(S) 2nd Reading Conference Committee Report Adopted",41,6,0,3,50
1985064,1560470,2025-04-29,House,"(H) 2nd Reading Conference Committee Report Adopted",95,5,0,0,100
1985064,1561969,2025-04-30,House,"(H) 3rd Reading Conference Committee Report Adopted",93,7,0,0,100
1985064,1563241,2025-04-30,Senate,"(S) 3rd Reading Conference Committee Report Adopted",45,5,0,0,50
1985174,1504962,2025-03-04,Senate,"(S) Education and Cultural Resources--Do Pass",8,6,0,0,14
1985174,1507660,2025-03-06,Senate,"(S) 2nd Reading Passed",32,18,0,0,50
1985174,1508147,2025-03-06,Senate,"(S) 3rd Reading Passed",32,17,0,1,50
1985174,1542210,2025-04-09,House,"(H) Education--To Table",11,4,0,0,15
1985174,1543634,2025-04-09,House,"(H) Education--To Table",11,4,0,0,15
1985283,1504108,2025-03-03,Senate,"(S) Public Health, Welfare and Safety--To Table",11,0,0,0,11
1985392,1503827,2025-03-03,Senate,"(S) Public Health, Welfare and Safety--To Table",11,0,0,0,11
1985392,1580362,2025-03-03,Senate,"(S) Public Health, Welfare and Safety--To Table",11,0,0,0,11
1985498,1504316,2025-03-04,House,"(H) Judiciary--Do Pass",12,8,0,0,20
1985498,1507385,2025-03-06,House,"(H) 2nd Reading Passed",54,45,0,1,100
1985498,1508824,2025-03-07,House,"(H) 3rd Reading Passed",55,44,0,1,100
1985498,1538602,2025-04-07,Senate,"(S) Judiciary--Be Concurred In",5,3,0,0,8
1985498,1546695,2025-04-12,Senate,"(S) 2nd Reading Concurred",29,21,0,0,50
1985498,1547433,2025-04-14,Senate,"(S) 3rd Reading Concurred",29,19,0,2,50
1985510,1503033,2025-03-01,House,"(H) State Administration--To Table",13,6,0,0,19
1985524,1502989,2025-03-01,House,"(H) Fish, Wildlife and Parks--Do Pass",20,0,0,0,20
1985524,1508049,2025-03-06,House,"(H) 2nd Reading Passed",99,0,0,1,100
1985524,1508508,2025-03-07,House,"(H) 3rd Reading Passed",99,0,0,1,100
1985524,1540679,2025-04-08,Senate,"(S) Fish and Game--Be Concurred In",11,0,0,0,11
1985524,1552251,2025-04-18,Senate,"(S) 2nd Reading Concurred",48,0,0,2,50
1985524,1554815,2025-04-22,Senate,"(S) 3rd Reading Concurred",50,0,0,0,50
1985541,1505584,2025-03-04,Senate,"(S) Education and Cultural Resources--To Table",14,0,0,0,14
1985541,1506960,2025-03-05,Senate,"(S) Motion Failed",23,27,0,0,50
1985561,1502841,2025-02-28,House,"(H) Education--To Table",15,0,0,0,15
1985579,1505106,2025-03-04,House,"(H) Business and Labor--To Table",11,8,0,0,19
1985596,1504604,2025-03-04,House,"(H) Judiciary--Do Pass",20,0,0,0,20
1985596,1508082,2025-03-06,House,"(H) 2nd Reading Passed",99,0,0,1,100
1985596,1508780,2025-03-07,House,"(H) 3rd Reading Passed",99,0,0,1,100
1985596,1543246,2025-04-10,Senate,"(S) Judiciary--Be Concurred In As Amended",5,3,0,0,8
1985596,1545811,2025-04-11,Senate,"(S) 2nd Reading Concurred",35,14,0,1,50
1985596,1546585,2025-04-12,Senate,"(S) 3rd Reading Concurred",38,12,0,0,50
1985596,1551247,2025-04-17,House,"(H) 2nd Reading Senate Amendments Concurred",100,0,0,0,100
1985596,1552309,2025-04-18,House,"(H) 3rd Reading Passed as Amended by Senate",91,7,0,2,100
1985613,1502990,2025-03-01,House,"(H) State Administration--To Table",11,8,0,0,19
1985632,1504829,2025-03-04,House,"(H) Judiciary--Do Pass",12,8,0,0,20
1985632,1507051,2025-03-06,House,"(H) 2nd Reading Passed",57,42,0,1,100
1985632,1507577,2025-03-06,House,"(H) Appropriations--Do Pass",12,11,0,0,23
1985632,1508784,2025-03-07,House,"(H) 3rd Reading Passed",58,41,0,1,100
1985632,1547194,2025-04-07,Senate,"(S) Judiciary--To Table",8,0,0,0,8
1985632,1548196,2025-04-07,Senate,"(S) Judiciary--To Table",8,0,0,0,8
1985671,1504441,2025-03-04,House,"(H) Judiciary--Do Pass",12,8,0,0,20
1985671,1507604,2025-03-06,House,"(H) 2nd Reading Passed",57,41,0,2,100
1985671,1508523,2025-03-07,House,"(H) 3rd Reading Passed",57,42,0,1,100
1985671,1534707,2025-04-02,Senate,"(S) State Administration--Be Concurred In",5,4,0,0,9
1985671,1552230,2025-04-18,Senate,"(S) 2nd Reading Concurred",31,17,0,2,50
1985671,1553969,2025-04-22,Senate,"(S) 3rd Reading Concurred",32,18,0,0,50
1985687,1504162,2025-03-04,House,"(H) Energy, Technology and Federal Relations--To Table",13,1,0,0,14
1985704,1505333,2025-03-04,Senate,"(S) State Administration--To Table",9,0,0,0,9
1985723,1503049,2025-03-01,House,"(H) State Administration--Do Pass",11,8,0,0,19
1985723,1507782,2025-03-06,House,"(H) 2nd Reading Passed",57,42,0,1,100
1985723,1508545,2025-03-07,House,"(H) 3rd Reading Passed",57,42,0,1,100
1985723,1541586,2025-04-09,Senate,"(S) Judiciary--Be Concurred In As Amended",5,3,0,0,8
1985723,1545187,2025-04-10,Senate,"(S) 2nd Reading Motion to Amend Carried",49,1,0,0,50
1985723,1545188,2025-04-10,Senate,"(S) 2nd Reading Concurred as Amended",36,14,0,0,50
1985723,1546630,2025-04-12,Senate,"(S) 3rd Reading Concurred",38,12,0,0,50
1985723,1551610,2025-04-17,House,"(H) 2nd Reading Senate Amendments Not Concurred",46,54,0,0,100
1985723,1560302,2025-04-29,House,"(H) 2nd Reading Conference Committee Report Adopted",57,43,0,0,100
1985723,1560303,2025-04-29,Senate,"(S) 2nd Reading Conference Committee Report Adopted",39,11,0,0,50
1985723,1561832,2025-04-30,House,"(H) 3rd Reading Conference Committee Report Adopted",56,44,0,0,100
1985723,1562447,2025-04-30,Senate,"(S) 3rd Reading Conference Committee Report Adopted",37,13,0,0,50
1985742,1504937,2025-03-04,Senate,"(S) Business, Labor  and Economic Affairs--To Table",8,4,0,0,12
1985758,1506795,2025-03-01,Senate,"(S) State Administration--To Table",9,0,0,0,9
1985784,1506621,2025-03-04,Senate,"(S) Business, Labor  and Economic Affairs--Do Pass",7,5,0,0,12
1985784,1507073,2025-03-06,Senate,"(S) 2nd Reading Passed",29,21,0,0,50
1985784,1508093,2025-03-06,Senate,"(S) 3rd Reading Passed",26,23,0,1,50
1985784,1540137,2025-04-08,House,"(H) Business and Labor--Be Concurred In As Amended",20,0,0,0,20
1985784,1545075,2025-04-10,House,"(H) 2nd Reading Concurred",95,5,0,0,100
1985784,1546302,2025-04-11,House,"(H) 3rd Reading Concurred",88,11,0,1,100
1985784,1551436,2025-04-17,Senate,"(S) 2nd Reading House Amendments Not Concurred",33,16,0,1,50
1985784,1552019,2025-04-17,Senate,"(S) 2nd Reading House Amendments Not Concurred",33,16,0,1,50
1985834,1528763,2025-03-27,House,"(H) State Administration--Do Pass",11,8,0,0,19
1985834,1537054,2025-04-04,House,"(H) 2nd Reading Passed",58,42,0,0,100
1985834,1537654,2025-04-05,House,"(H) 3rd Reading Passed",55,42,0,3,100
1985834,1555867,2025-04-23,Senate,"(S) State Administration--Be Concurred In",6,3,0,0,9
1985834,1558220,2025-04-25,Senate,"(S) 2nd Reading Concurred",31,19,0,0,50
1985834,1559144,2025-04-28,Senate,"(S) 3rd Reading Failed",30,19,0,1,50
1985834,1576296,2025-04-28,Senate,"(S) 3rd Reading Failed; 2nd House Vote Required",30,19,0,1,50
1985884,1504449,2025-03-04,House,"(H) Business and Labor--To Table",13,6,0,0,19
1985934,1502994,2025-03-01,House,"(H) Human Services--Do Pass",21,0,0,0,21
1985934,1507706,2025-03-06,House,"(H) 2nd Reading Passed",84,14,0,2,100
1985934,1508721,2025-03-07,House,"(H) 3rd Reading Passed",83,16,0,1,100
1985934,1538772,2025-04-07,Senate,"(S) Public Health, Welfare and Safety--Be Concurred In As Amended",6,5,0,0,11
1985934,1543989,2025-04-10,Senate,"(S) 2nd Reading Concurred",30,20,0,0,50
1985934,1546138,2025-04-11,Senate,"(S) 3rd Reading Concurred",27,21,0,2,50
1985934,1551502,2025-04-17,House,"(H) 2nd Reading Senate Amendments Concurred",96,4,0,0,100
1985934,1552122,2025-04-18,House,"(H) 3rd Reading Passed as Amended by Senate",79,19,0,2,100
1985983,1529911,2025-03-28,House,"(H) Taxation--Do Pass",13,8,0,0,21
1985983,1533751,2025-04-01,House,"(H) Appropriations--To Table",12,11,0,0,23
1986033,1530031,2025-03-28,House,"(H) Taxation--Do Pass",12,9,0,0,21
1986033,1531083,2025-03-31,House,"(H) 2nd Reading Not Passed",50,50,0,0,100
1986033,1533748,2025-04-01,House,"(H) Reconsidered Previous Action; Placed on 2nd Reading",58,40,0,2,100
1986033,1534940,2025-04-02,House,"(H) Appropriations--Do Pass",17,6,0,0,23
1986033,1537533,2025-04-04,House,"(H) 2nd Reading Passed",78,21,0,1,100
1986033,1537864,2025-04-05,House,"(H) 3rd Reading Passed",79,19,0,2,100
1986033,1550183,2025-04-16,Senate,"(S) Taxation--Be Concurred In As Amended",5,3,0,0,8
1986033,1552269,2025-04-18,Senate,"(S) 2nd Reading Indefinitely Postponed",20,30,0,0,50
1986033,1554910,2025-04-22,Senate,"(S) 2nd Reading Concurred",27,23,0,0,50
1986033,1556316,2025-04-23,Senate,"(S) 3rd Reading Failed",25,25,0,0,50
1986033,1557798,2025-04-24,Senate,"(S) Motion to Reconsider Failed",21,29,0,0,50
1986082,1528772,2025-03-27,House,"(H) State Administration--Do Pass",11,8,0,0,19
1986082,1537032,2025-04-04,House,"(H) 2nd Reading Passed",58,42,0,0,100
1986082,1537849,2025-04-05,House,"(H) 3rd Reading Passed",56,42,0,2,100
1986082,1555432,2025-04-23,Senate,"(S) State Administration--Be Concurred In",6,3,0,0,9
1986082,1557991,2025-04-25,Senate,"(S) 2nd Reading Concurred",30,20,0,0,50
1986082,1559609,2025-04-28,Senate,"(S) 3rd Reading Failed",30,19,0,1,50
1986082,1576621,2025-04-28,Senate,"(S) 3rd Reading Failed; 2nd House Vote Required",30,19,0,1,50
1986132,1502765,2025-02-28,House,"(H) Education--Do Pass",15,0,0,0,15
1986132,1506110,2025-03-05,House,"(H) 2nd Reading Motion to Amend Carried",99,0,0,1,100
1986132,1506111,2025-03-05,House,"(H) 2nd Reading Passed as Amended",99,0,0,1,100
1986132,1508539,2025-03-07,House,"(H) 3rd Reading Passed",99,0,0,1,100
1986132,1536680,2025-04-03,Senate,"(S) Education and Cultural Resources--Be Concurred In",14,0,0,0,14
1986132,1545045,2025-04-10,Senate,"(S) 2nd Reading Concurred",47,3,0,0,50
1986132,1546346,2025-04-11,Senate,"(S) 3rd Reading Concurred",44,4,0,2,50
1986186,1502626,2025-02-28,House,"(H) Transportation--To Table",14,0,0,0,14
1987613,1530170,2025-03-28,Senate,"(S) Taxation--To Table",8,0,0,0,8
1989010,1526506,2025-03-25,House,"(H) Fish, Wildlife and Parks--To Table",17,3,0,0,20
1989318,1530028,2025-03-27,House,"(H) Local Government--To Table",13,0,0,4,17
1992970,1524187,2025-03-21,House,"(H) Taxation--Do Pass",21,0,0,0,21
1992970,1526792,2025-03-25,House,"(H) 2nd Reading Passed",87,13,0,0,100
1992970,1530350,2025-03-28,House,"(H) Appropriations--Do Pass",15,8,0,0,23
1992970,1531132,2025-03-31,House,"(H) 3rd Reading Passed",78,21,0,1,100
1992970,1542651,2025-04-09,Senate,"(S) Taxation--Be Concurred In As Amended",7,1,0,0,8
1992970,1546716,2025-04-12,Senate,"(S) 2nd Reading Concurred",41,9,0,0,50
1992970,1551096,2025-04-16,Senate,"(S) Finance and Claims--Be Concurred In",19,3,0,0,22
1992970,1552285,2025-04-18,Senate,"(S) 3rd Reading Concurred",45,5,0,0,50
1992970,1557235,2025-04-24,House,"(H) 2nd Reading Senate Amendments Concurred",97,3,0,0,100
1992970,1558209,2025-04-25,House,"(H) 3rd Reading Passed as Amended by Senate",81,19,0,0,100
1992972,1528694,2025-03-27,House,"(H) Judiciary--To Table",17,3,0,0,20
1992972,1537350,2025-04-04,House,"(H) Taken from Committee; Placed on 2nd Reading",7,85,0,8,100
1992972,1543381,2025-04-04,House,"(H) Taken from Committee; Placed on 2nd Reading",7,85,0,8,100
2008299,1535436,2025-04-02,Senate,"(S) Natural Resources--Resolution Adopted",11,0,0,0,11
2008299,1537791,2025-04-05,Senate,"(S) Resolution Adopted",50,0,0,0,50
2008315,1537217,2025-04-04,Senate,"(S) Business, Labor  and Economic Affairs--Resolution Adopted",11,0,0,0,11
2008315,1538326,2025-04-07,Senate,"(S) Resolution Adopted",50,0,0,0,50
2008331,1548192,2025-04-15,Senate,"(S) Judiciary--Resolution Adopted",8,0,0,0,8
2008331,1550123,2025-04-16,Senate,"(S) Resolution Adopted",50,0,0,0,50
2008347,1538794,2025-04-07,Senate,"(S) Public Health, Welfare and Safety--Resolution Adopted",11,0,0,0,11
2008347,1544948,2025-04-10,Senate,"(S) Resolution Adopted",49,0,0,1,50
2008364,1549000,2025-04-15,Senate,"(S) Judiciary--Resolution Adopted",8,0,0,0,8
2008364,1550096,2025-04-16,Senate,"(S) Resolution Adopted",50,0,0,0,50
2008381,1529273,2025-03-27,Senate,"(S) Agriculture, Livestock and Irrigation--Resolution Adopted",11,0,0,0,11
2008381,1532293,2025-04-01,Senate,"(S) Resolution Adopted",48,0,0,2,50
2008398,1536314,2025-04-03,Senate,"(S) Business, Labor  and Economic Affairs--Resolution Adopted",11,0,0,0,11
2008398,1537761,2025-04-05,Senate,"(S) Resolution Adopted",48,0,0,2,50
2008415,1538743,2025-04-07,Senate,"(S) Public Health, Welfare and Safety--Resolution Adopted",11,0,0,0,11
2008415,1545010,2025-04-10,Senate,"(S) Resolution Adopted",50,0,0,0,50
2008431,1541604,2025-04-09,Senate,"(S) Business, Labor  and Economic Affairs--Resolution Adopted",11,0,0,0,11
2008431,1544933,2025-04-10,Senate,"(S) Resolution Adopted",49,0,0,1,50
2008448,1552258,2025-04-18,Senate,"(S) Judiciary--Resolution Adopted",8,0,0,0,8
2008448,1554967,2025-04-23,Senate,"(S) Resolution Adopted",48,0,0,2,50
2008464,1538734,2025-04-07,Senate,"(S) Public Health, Welfare and Safety--Resolution Adopted",11,0,0,0,11
2008464,1545210,2025-04-10,Senate,"(S) Resolution Adopted",47,0,0,3,50
2008481,1529701,2025-03-27,Senate,"(S) Education and Cultural Resources--Resolution Adopted",14,0,0,0,14
2008481,1532339,2025-04-01,Senate,"(S) Resolution Adopted",50,0,0,0,50
2008497,1549376,2025-04-15,Senate,"(S) Fish and Game--Resolution Adopted",11,0,0,0,11
2008497,1551957,2025-04-17,Senate,"(S) Resolution Adopted",46,3,0,1,50
2008644,1535258,2025-04-02,Senate,"(S) Natural Resources--Resolution Adopted",11,0,0,0,11
2008644,1537733,2025-04-05,Senate,"(S) Resolution Adopted",49,0,0,1,50
2008645,1536707,2025-04-03,Senate,"(S) Business, Labor  and Economic Affairs--Resolution Adopted",11,0,0,0,11
2008645,1537853,2025-04-05,Senate,"(S) Resolution Adopted",50,0,0,0,50
2008646,1550150,2025-04-16,Senate,"(S) State Administration--Resolution Adopted",9,0,0,0,9
2008646,1554813,2025-04-22,Senate,"(S) 2nd Reading Passed",50,0,0,0,50
2008647,1538631,2025-04-07,Senate,"(S) Public Health, Welfare and Safety--Resolution Adopted",11,0,0,0,11
2008647,1544723,2025-04-10,Senate,"(S) Resolution Adopted",49,0,0,1,50
2008648,1541555,2025-04-09,Senate,"(S) Business, Labor  and Economic Affairs--Resolution Adopted",11,0,0,0,11
2008648,1545254,2025-04-10,Senate,"(S) Resolution Adopted",49,0,0,1,50
2008649,1531695,2025-03-31,Senate,"(S) Local Government--Resolution Adopted",11,0,0,0,11
2008649,1534258,2025-03-31,Senate,"(S) Local Government--Resolution Adopted",11,0,0,0,11
2008649,1537775,2025-04-05,Senate,"(S) Resolution Adopted",50,0,0,0,50
2008650,1549213,2025-04-15,Senate,"(S) Fish and Game--Resolution Adopted",11,0,0,0,11
2008650,1551915,2025-04-17,Senate,"(S) Resolution Adopted",47,2,0,1,50
2008651,1524376,2025-03-21,Senate,"(S) Highways and Transportation--Do Pass As Amended",8,0,0,0,8
2008651,1529096,2025-03-27,Senate,"(S) Resolution Adopted",49,0,0,1,50
2008652,1529492,2025-03-27,Senate,"(S) Education and Cultural Resources--Resolution Adopted",14,0,0,0,14
2008652,1532921,2025-04-01,Senate,"(S) Resolution Adopted",50,0,0,0,50
2008653,1536186,2025-04-03,Senate,"(S) Business, Labor  and Economic Affairs--Resolution Adopted",11,0,0,0,11
2008653,1537780,2025-04-05,Senate,"(S) Resolution Adopted",50,0,0,0,50
2008654,1529730,2025-03-27,Senate,"(S) Agriculture, Livestock and Irrigation--Resolution Adopted",11,0,0,0,11
2008654,1533711,2025-04-01,Senate,"(S) Resolution Adopted",50,0,0,0,50
2008655,1548485,2025-04-15,Senate,"(S) Judiciary--Resolution Adopted",8,0,0,0,8
2008655,1550644,2025-04-16,Senate,"(S) Resolution Adopted",50,0,0,0,50
2008656,1539578,2025-04-08,Senate,"(S) Business, Labor  and Economic Affairs--Resolution Adopted",11,0,0,0,11
2008656,1545104,2025-04-10,Senate,"(S) Resolution Adopted",48,0,0,2,50
2008657,1529187,2025-03-27,Senate,"(S) Agriculture, Livestock and Irrigation--Resolution Adopted",11,0,0,0,11
2008657,1532801,2025-04-01,Senate,"(S) Resolution Adopted",50,0,0,0,50
2008658,1539023,2025-04-07,Senate,"(S) Public Health, Welfare and Safety--Resolution Adopted",11,0,0,0,11
2008658,1544931,2025-04-10,Senate,"(S) Resolution Adopted",49,0,0,1,50
2008659,1529765,2025-03-27,Senate,"(S) Agriculture, Livestock and Irrigation--Resolution Adopted",11,0,0,0,11
2008659,1532865,2025-04-01,Senate,"(S) Resolution Adopted",50,0,0,0,50
2008660,1541465,2025-04-09,Senate,"(S) Business, Labor  and Economic Affairs--Resolution Adopted",11,0,0,0,11
2008660,1545071,2025-04-10,Senate,"(S) Resolution Adopted",49,0,0,1,50
2008661,1538807,2025-04-07,Senate,"(S) Public Health, Welfare and Safety--Resolution Adopted",11,0,0,0,11
2008661,1545270,2025-04-10,Senate,"(S) Resolution Adopted",48,0,0,2,50
2008662,1529694,2025-03-27,Senate,"(S) Education and Cultural Resources--Resolution Adopted",14,0,0,0,14
2008662,1533007,2025-04-01,Senate,"(S) Resolution Adopted",50,0,0,0,50
2008663,1538975,2025-04-07,Senate,"(S) Public Health, Welfare and Safety--Resolution Adopted",11,0,0,0,11
2008663,1544993,2025-04-10,Senate,"(S) Resolution Adopted",48,0,0,2,50
2008664,1536508,2025-04-03,Senate,"(S) Business, Labor  and Economic Affairs--Resolution Adopted",11,0,0,0,11
2008664,1537857,2025-04-05,Senate,"(S) Resolution Adopted",49,0,0,1,50
2008665,1539189,2025-04-07,Senate,"(S) Public Health, Welfare and Safety--Resolution Adopted",11,0,0,0,11
2008665,1544952,2025-04-10,Senate,"(S) Resolution Adopted",49,0,0,1,50
2008668,1526325,2025-03-25,House,"(H) Business and Labor--Do Pass",20,0,0,0,20
2008668,1530913,2025-03-31,House,"(H) 2nd Reading Passed",95,5,0,0,100
2008668,1535157,2025-03-31,House,"(H) Appropriations--Do Pass",19,0,4,0,23
2008668,1535158,2025-04-02,House,"(H) 3rd Reading Passed",90,4,0,6,100
2008668,1550007,2025-04-16,Senate,"(S) Business, Labor  and Economic Affairs--Be Concurred In",11,0,0,0,11
2008668,1551972,2025-04-17,Senate,"(S) 2nd Reading Concurred",41,8,0,1,50
2008668,1555869,2025-04-23,Senate,"(S) Motion Carried",34,16,0,0,50
2008668,1557785,2025-04-24,Senate,"(S) 3rd Reading Concurred",43,7,0,0,50
2009172,1530009,2025-03-28,House,"(H) State Administration--Do Pass",11,8,0,0,19
2009172,1530848,2025-03-31,House,"(H) 2nd Reading Passed",65,34,0,1,100
2009172,1533572,2025-04-01,House,"(H) 3rd Reading Passed",59,40,0,1,100
2009172,1547573,2025-04-14,Senate,"(S) State Administration--Be Concurred In As Amended",7,2,0,0,9
2009172,1551378,2025-04-17,Senate,"(S) 2nd Reading Concurred",42,8,0,0,50
2009172,1552303,2025-04-18,Senate,"(S) 3rd Reading Concurred",40,10,0,0,50
2009172,1557741,2025-04-24,House,"(H) 2nd Reading Senate Amendments Concurred",92,8,0,0,100
2009172,1558078,2025-04-25,House,"(H) 3rd Reading Passed as Amended by Senate",65,35,0,0,100
2009391,1529540,2025-03-27,House,"(H) Appropriations--Do Pass As Amended",22,1,0,0,23
2009391,1536307,2025-04-03,House,"(H) 2nd Reading Passed",91,9,0,0,100
2009391,1537657,2025-04-05,House,"(H) 3rd Reading Passed",86,12,0,2,100
2009391,1551237,2025-04-16,Senate,"(S) Finance and Claims--Be Concurred In",21,1,0,0,22
2009391,1553871,2025-04-22,Senate,"(S) 2nd Reading Concurred",42,8,0,0,50
2009391,1555693,2025-04-23,Senate,"(S) 3rd Reading Concurred",46,4,0,0,50
2009402,1535680,2025-04-03,Senate,"(S) Business, Labor  and Economic Affairs--Resolution Adopted",11,0,0,0,11
2009402,1537711,2025-04-05,Senate,"(S) Resolution Adopted",50,0,0,0,50
2009420,1549470,2025-04-15,Senate,"(S) Energy, Technology & Federal Relations--Resolution Adopted",13,0,0,0,13
2009420,1551457,2025-04-17,Senate,"(S) Resolution Adopted",45,2,0,3,50
2009441,1536092,2025-04-03,Senate,"(S) Business, Labor  and Economic Affairs--Resolution Adopted",11,0,0,0,11
2009441,1537803,2025-04-05,Senate,"(S) Resolution Adopted",50,0,0,0,50
2009460,1532161,2025-04-01,House,"(H) Judiciary--Do Pass As Amended",20,0,0,0,20
2009460,1548332,2025-04-15,House,"(H) 2nd Reading Passed",95,5,0,0,100
2009460,1549838,2025-04-16,House,"(H) 3rd Reading Passed",74,24,0,2,100
2009460,1556542,2025-04-24,Senate,"(S) Judiciary--Resolution Adopted",8,0,0,0,8
2009460,1559096,2025-04-28,Senate,"(S) 2nd Reading Concurred",37,13,0,0,50
2009460,1560247,2025-04-29,Senate,"(S) 3rd Reading Concurred",34,16,0,0,50
2009482,1536384,2025-04-03,Senate,"(S) Business, Labor  and Economic Affairs--Resolution Adopted As Amended",11,0,0,0,11
2009482,1537836,2025-04-05,Senate,"(S) Resolution Adopted",50,0,0,0,50
2009506,1555617,2025-04-23,Senate,"(S) Taken from Committee; Placed on 2nd Reading",32,17,0,1,50
2009506,1558910,2025-04-23,Senate,"(S) Taken from Committee; Placed on 2nd Reading",32,17,0,1,50
2009526,1535877,2025-04-03,Senate,"(S) Business, Labor  and Economic Affairs--Resolution Adopted",11,0,0,0,11
2009526,1537800,2025-04-05,Senate,"(S) Resolution Adopted",50,0,0,0,50
2009547,1529771,2025-03-27,Senate,"(S) Education and Cultural Resources--Resolution Adopted",14,0,0,0,14
2009547,1532886,2025-04-01,Senate,"(S) Resolution Adopted",50,0,0,0,50
2009568,1534249,2025-04-02,Senate,"(S) Business, Labor  and Economic Affairs--Resolution Adopted",11,0,0,0,11
2009568,1537829,2025-04-05,Senate,"(S) Resolution Adopted",41,8,0,1,50
2009797,1535657,2025-04-02,Senate,"(S) Local Government--Do Pass As Amended",9,1,0,0,10
2009797,1537252,2025-04-04,Senate,"(S) 2nd Reading Passed",38,11,0,1,50
2009797,1537801,2025-04-05,Senate,"(S) 3rd Reading Passed",41,7,0,2,50
2009797,1549297,2025-04-15,House,"(H) Local Government--Be Concurred In As Amended",16,1,0,0,17
2009797,1554896,2025-04-22,House,"(H) 2nd Reading Concurred",76,24,0,0,100
2009797,1556216,2025-04-23,House,"(H) 3rd Reading Concurred",75,24,0,1,100
2009797,1558238,2025-04-25,Senate,"(S) 2nd Reading House Amendments Concurred",45,4,0,1,50
2009797,1559212,2025-04-28,Senate,"(S) 3rd Reading Passed as Amended by House",47,2,0,1,50
2009926,1533758,2025-04-01,House,"(H) Human Services--To Table",17,0,4,0,21
2010061,1530169,2025-03-28,House,"(H) Energy, Technology and Federal Relations--Do Pass",8,6,0,0,14
2010061,1532862,2025-04-01,House,"(H) 2nd Reading Not Passed",39,61,0,0,100
2010201,1530323,2025-03-28,House,"(H) Energy, Technology and Federal Relations--Do Pass",8,6,0,0,14
2010201,1532760,2025-04-01,House,"(H) 2nd Reading Not Passed",34,66,0,0,100
2010335,1528080,2025-03-26,House,"(H) Taxation--Do Pass",11,10,0,0,21
2010335,1530041,2025-03-28,House,"(H) 2nd Reading Passed",60,40,0,0,100
2010335,1533272,2025-04-01,House,"(H) Appropriations--Do Pass As Amended",18,5,0,0,23
2010335,1538394,2025-04-07,House,"(H) 2nd Reading Passed",55,45,0,0,100
2010335,1539524,2025-04-08,House,"(H) 3rd Reading Passed",50,47,0,3,100
2010335,1549924,2025-04-16,Senate,"(S) Taxation--To Table",8,0,0,0,8
2010348,1530179,2025-03-28,House,"(H) Taxation--To Table",21,0,0,0,21
2010352,1552234,2025-04-18,Senate,"(S) State Administration--Resolution Adopted",9,0,0,0,9
2010352,1557171,2025-04-24,Senate,"(S) Resolution Adopted",50,0,0,0,50
2010362,1533954,2025-04-02,Senate,"(S) Business, Labor  and Economic Affairs--Resolution Adopted",11,0,0,0,11
2010362,1537827,2025-04-05,Senate,"(S) Resolution Adopted",41,8,0,1,50
2010369,1534008,2025-04-02,Senate,"(S) Business, Labor  and Economic Affairs--Resolution Adopted",11,0,0,0,11
2010369,1537804,2025-04-05,Senate,"(S) Resolution Adopted",38,10,0,2,50
2010380,1534420,2025-04-01,Senate,"(S) Education and Cultural Resources--Resolution Adopted",14,0,0,0,14
2010380,1537765,2025-04-05,Senate,"(S) Resolution Adopted",50,0,0,0,50
2010384,1552248,2025-04-18,Senate,"(S) State Administration--Resolution Adopted",9,0,0,0,9
2010384,1557008,2025-04-24,Senate,"(S) Resolution Adopted",48,0,0,2,50
2010395,1534494,2025-04-01,Senate,"(S) Education and Cultural Resources--Resolution Adopted",14,0,0,0,14
2010395,1537764,2025-04-05,Senate,"(S) Resolution Adopted",47,2,0,1,50
2010404,1552323,2025-04-18,Senate,"(S) State Administration--Resolution Adopted",9,0,0,0,9
2010404,1557023,2025-04-24,Senate,"(S) Resolution Adopted",50,0,0,0,50
2010411,1534000,2025-04-01,Senate,"(S) Education and Cultural Resources--Resolution Adopted",14,0,0,0,14
2010411,1537823,2025-04-05,Senate,"(S) Resolution Adopted",49,0,0,1,50
2010419,1552349,2025-04-18,Senate,"(S) State Administration--Resolution Adopted",9,0,0,0,9
2010419,1557263,2025-04-24,Senate,"(S) Resolution Adopted",50,0,0,0,50
2010429,1530256,2025-03-28,House,"(H) Taxation--To Table",21,0,0,0,21
2010436,1530248,2025-03-28,House,"(H) Judiciary--Do Pass",12,8,0,0,20
2010436,1538718,2025-04-07,House,"(H) 2nd Reading Not Passed",46,54,0,0,100
2010447,1530043,2025-03-28,House,"(H) Judiciary--Do Pass",12,8,0,0,20
2010447,1533762,2025-04-01,House,"(H) 2nd Reading Motion to Amend Failed",22,77,0,1,100
2010447,1533763,2025-04-01,House,"(H) 2nd Reading Not Passed",39,61,0,0,100
2010454,1530547,2025-03-28,House,"(H) Education--To Table",15,0,0,0,15
2010465,1527565,2025-03-26,House,"(H) Taxation--To Table",21,0,0,0,21
2010470,1552239,2025-04-18,Senate,"(S) State Administration--Resolution Adopted",9,0,0,0,9
2010470,1557325,2025-04-24,Senate,"(S) Resolution Adopted",50,0,0,0,50
2010481,1538747,2025-04-07,Senate,"(S) Public Health, Welfare and Safety--To Table",11,0,0,0,11
2010489,1538782,2025-04-01,Senate,"(S) Fish and Game--To Table",9,2,1,0,12
2010499,1534274,2025-04-02,Senate,"(S) Business, Labor  and Economic Affairs--Resolution Adopted",11,0,0,0,11
2010499,1537727,2025-04-05,Senate,"(S) Resolution Adopted",39,9,0,2,50
2010504,1534263,2025-04-02,Senate,"(S) Business, Labor  and Economic Affairs--Resolution Adopted",11,0,0,0,11
2010504,1537721,2025-04-05,Senate,"(S) Resolution Adopted",39,10,0,1,50
2010513,1552274,2025-04-18,Senate,"(S) State Administration--Resolution Adopted",9,0,0,0,9
2010513,1557113,2025-04-24,Senate,"(S) Resolution Adopted",45,5,0,0,50
2010705,1533417,2025-04-01,House,"(H) Human Services--To Table",14,3,4,0,21
2010798,1528081,2025-03-26,House,"(H) Taxation--To Table",20,1,0,0,21
2010798,1532200,2025-04-01,House,"(H) Taxation--Do Pass As Amended",12,9,0,0,21
2010798,1536621,2025-04-03,House,"(H) Appropriations--To Table",12,11,0,0,23
2010898,1530369,2025-03-28,House,"(H) Human Services--Do Pass",21,0,0,0,21
2010898,1550174,2025-04-16,House,"(H) 2nd Reading Passed",73,27,0,0,100
2010898,1551384,2025-04-17,House,"(H) 3rd Reading Passed",70,29,0,1,100
2010898,1555866,2025-04-23,Senate,"(S) Public Health, Welfare and Safety--Resolution Adopted",7,4,0,0,11
2010898,1559036,2025-04-28,Senate,"(S) 2nd Reading Concurred",26,24,0,0,50
2010898,1559905,2025-04-29,Senate,"(S) 3rd Reading Failed",24,26,0,0,50
2010898,1560612,2025-04-29,Senate,"(S) 3rd Reading Failed",24,26,0,0,50
2010898,1562101,2025-04-30,Senate,"(S) 3rd Reading Concurred",29,21,0,0,50
2011119,1533605,2025-04-01,House,"(H) Fish, Wildlife and Parks--To Table",15,5,0,0,20
2011177,1530328,2025-03-28,House,"(H) Transportation--Do Pass As Amended",8,6,0,0,14
2011177,1533766,2025-04-01,House,"(H) Appropriations--Do Pass As Amended",12,11,0,0,23
2011177,1537279,2025-04-04,House,"(H) 2nd Reading Passed",61,39,0,0,100
2011177,1537810,2025-04-05,House,"(H) 3rd Reading Passed",63,35,0,2,100
2011177,1546306,2025-04-11,Senate,"(S) Highways and Transportation--Be Concurred In",6,2,0,0,8
2011177,1548313,2025-04-15,Senate,"(S) 2nd Reading Motion to Amend Failed",24,26,0,0,50
2011177,1549370,2025-04-15,Senate,"(S) 2nd Reading Concur Motion Failed",23,27,0,0,50
2011177,1549371,2025-04-15,Senate,"(S) 2nd Reading Indefinitely Postponed",32,17,0,1,50
2011177,1550057,2025-04-16,Senate,"(S) Motion Failed",23,27,0,0,50
2011241,1530062,2025-03-28,House,"(H) Taxation--Do Pass As Amended",17,4,0,0,21
2011241,1532252,2025-04-01,House,"(H) 2nd Reading Passed",97,3,0,0,100
2011241,1534752,2025-04-02,House,"(H) 3rd Reading Passed",93,2,0,5,100
2011241,1541816,2025-04-09,Senate,"(S) Taxation--Be Concurred In",8,0,0,0,8
2011241,1552170,2025-04-18,Senate,"(S) 2nd Reading Concurred",44,4,0,2,50
2011241,1554792,2025-04-22,Senate,"(S) 3rd Reading Concurred",48,2,0,0,50
2011303,1530929,2025-03-31,House,"(H) Business and Labor--Resolution Adopted",20,0,0,0,20
2011303,1550671,2025-04-16,House,"(H) 2nd Reading Passed",60,40,0,0,100
2011303,1551942,2025-04-17,House,"(H) 3rd Reading Passed",57,42,0,1,100
2011303,1553465,2025-04-22,Senate,"(S) Business, Labor  and Economic Affairs--Be Concurred In",11,0,0,0,11
2011303,1557234,2025-04-24,Senate,"(S) 2nd Reading Concurred",34,15,0,1,50
2011303,1558255,2025-04-25,Senate,"(S) 3rd Reading Concurred",30,19,0,1,50
2011365,1530560,2025-03-28,House,"(H) Education--Do Pass",15,0,0,0,15
2011365,1533686,2025-04-01,House,"(H) 2nd Reading Passed",100,0,0,0,100
2011365,1535317,2025-04-02,House,"(H) 3rd Reading Passed",94,0,0,6,100
2011365,1549045,2025-04-15,Senate,"(S) Education and Cultural Resources--Be Concurred In As Amended",14,0,0,0,14
2011365,1551557,2025-04-17,Senate,"(S) 2nd Reading Concurred",49,0,0,1,50
2011365,1552146,2025-04-18,Senate,"(S) 3rd Reading Concurred",50,0,0,0,50
2011365,1557055,2025-04-24,House,"(H) 2nd Reading Senate Amendments Concurred",99,1,0,0,100
2011365,1558224,2025-04-25,House,"(H) 3rd Reading Passed as Amended by Senate",70,30,0,0,100
2011645,1531243,2025-03-31,House,"(H) Business and Labor--Resolution Adopted",12,8,0,0,20
2011645,1550204,2025-04-16,House,"(H) 2nd Reading Passed",55,45,0,0,100
2011645,1551677,2025-04-17,House,"(H) 3rd Reading Passed",59,40,0,1,100
2011645,1557866,2025-04-24,Senate,"(S) Energy, Technology & Federal Relations--Resolution Adopted",13,0,0,0,13
2011645,1558898,2025-04-28,Senate,"(S) 2nd Reading Concurred",26,24,0,0,50
2011645,1560243,2025-04-29,Senate,"(S) 3rd Reading Concurred",29,21,0,0,50
2011649,1530416,2025-03-28,House,"(H) Transportation--Do Pass As Amended",13,1,0,0,14
2011649,1532481,2025-04-01,House,"(H) Appropriations--Do Pass",22,0,1,0,23
2011649,1537037,2025-04-04,House,"(H) 2nd Reading Passed",97,3,0,0,100
2011649,1537855,2025-04-05,House,"(H) 3rd Reading Passed",93,5,0,2,100
2011649,1546286,2025-04-11,Senate,"(S) Highways and Transportation--Be Concurred In",8,0,0,0,8
2011649,1552216,2025-04-18,Senate,"(S) 2nd Reading Concurred",35,14,0,1,50
2011649,1554394,2025-04-22,Senate,"(S) 3rd Reading Concurred",36,14,0,0,50
2012061,1532213,2025-04-01,House,"(H) Business and Labor--Do Pass As Amended",20,0,0,0,20
2012061,1533268,2025-04-01,House,"(H) Appropriations--Do Pass",15,8,0,0,23
2012061,1537100,2025-04-04,House,"(H) 2nd Reading Passed",82,18,0,0,100
2012061,1537662,2025-04-05,House,"(H) 3rd Reading Passed",77,20,0,3,100
2012061,1549918,2025-04-16,Senate,"(S) Business, Labor  and Economic Affairs--Be Concurred In As Amended",11,0,0,0,11
2012061,1552189,2025-04-18,Senate,"(S) 2nd Reading Concurred",30,20,0,0,50
2012061,1557442,2025-04-24,Senate,"(S) Motion Carried",27,23,0,0,50
2012061,1558226,2025-04-25,Senate,"(S) 3rd Reading Concurred",28,21,0,1,50
2012061,1560296,2025-04-29,House,"(H) 2nd Reading Senate Amendments Concurred",99,1,0,0,100
2012061,1561827,2025-04-30,House,"(H) 3rd Reading Passed as Amended by Senate",82,18,0,0,100
2012122,1536982,2025-04-03,Senate,"(S) Energy, Technology & Federal Relations--Resolution Adopted",9,0,4,0,13
2012122,1539064,2025-04-07,Senate,"(S) 2nd Reading Passed",46,4,0,0,50
2012122,1541075,2025-04-08,Senate,"(S) 3rd Reading Passed",46,2,0,2,50
2012122,1550188,2025-04-16,House,"(H) Energy, Technology and Federal Relations--Be Concurred In",14,0,0,0,14
2012122,1555700,2025-04-23,House,"(H) 2nd Reading Concurred",96,4,0,0,100
2012122,1556803,2025-04-24,House,"(H) 3rd Reading Concurred",94,6,0,0,100
2012179,1530162,2025-03-28,Senate,"(S) Taxation--Do Pass",7,1,0,0,8
2012179,1533769,2025-04-01,Senate,"(S) 2nd Reading Passed",38,12,0,0,50
2012179,1534154,2025-04-02,Senate,"(S) Finance and Claims--Do Pass",22,0,0,0,22
2012179,1536907,2025-04-03,Senate,"(S) 3rd Reading Passed",40,10,0,0,50
2012179,1551802,2025-04-17,House,"(H) Taxation--Be Concurred In",15,6,0,0,21
2012179,1553331,2025-04-22,House,"(H) 2nd Reading Concurred",66,33,0,1,100
2012179,1555662,2025-04-23,House,"(H) Appropriations--Be Concurred In",14,9,0,0,23
2012179,1557670,2025-04-24,House,"(H) 3rd Reading Concurred",65,35,0,0,100
2012255,1532217,2025-04-01,House,"(H) State Administration--Do Pass",15,4,0,0,19
2012255,1536942,2025-04-03,House,"(H) Appropriations--Do Pass",20,3,0,0,23
2012255,1538347,2025-04-07,House,"(H) 2nd Reading Passed",86,14,0,0,100
2012255,1540341,2025-04-08,House,"(H) 3rd Reading Passed",82,15,0,3,100
2012255,1547611,2025-04-14,Senate,"(S) Public Health, Welfare and Safety--Be Concurred In",11,0,0,0,11
2012255,1547612,2025-04-14,Senate,"(S) Public Health, Welfare and Safety--To Table",11,0,0,0,11
2012255,1548055,2025-04-14,Senate,"(S) Public Health, Welfare and Safety--To Table",11,0,0,0,11
2012288,1535262,2025-04-02,Senate,"(S) Public Health, Welfare and Safety--Do Pass As Amended",9,2,0,0,11
2012288,1537422,2025-04-04,Senate,"(S) 2nd Reading Passed",41,9,0,0,50
2012288,1537690,2025-04-05,Senate,"(S) 3rd Reading Passed",39,9,0,2,50
2012288,1553576,2025-04-22,House,"(H) Human Services--Be Concurred In As Amended",12,9,0,0,21
2012288,1557313,2025-04-24,House,"(H) 2nd Reading Concurred",57,43,0,0,100
2012288,1558163,2025-04-25,House,"(H) 3rd Reading Failed",50,50,0,0,100
2012288,1558164,2025-04-25,House,"(H) Reconsidered Previous Action; Remains in 3rd Reading Process",50,48,0,2,100
2012288,1558165,2025-04-25,House,"(H) 3rd Reading Concurred",49,48,0,3,100
2012288,1558767,2025-04-25,House,"(H) Reconsidered Previous Action; Remains in 3rd Reading Process",50,48,0,2,100
2012288,1559140,2025-04-28,Senate,"(S) 2nd Reading House Amendments Concurred",26,24,0,0,50
2012288,1559961,2025-04-29,Senate,"(S) 3rd Reading Passed as Amended by House",29,21,0,0,50
2012323,1533906,2025-04-02,House,"(H) Business and Labor--Do Pass As Amended",11,9,0,0,20
2012323,1537361,2025-04-04,House,"(H) 2nd Reading Motion to Amend Carried",62,38,0,0,100
2012323,1537362,2025-04-04,House,"(H) 2nd Reading Not Passed as Amended",35,65,0,0,100
2012448,1532247,2025-04-01,House,"(H) Business and Labor--Do Pass",20,0,0,0,20
2012448,1535172,2025-04-02,House,"(H) Appropriations--Do Pass",21,2,0,0,23
2012448,1537429,2025-04-04,House,"(H) 2nd Reading Passed",81,17,0,2,100
2012448,1537651,2025-04-05,House,"(H) 3rd Reading Passed",85,13,0,2,100
2012448,1548257,2025-04-15,Senate,"(S) Business, Labor  and Economic Affairs--To Table",11,0,0,0,11
2012448,1549967,2025-04-16,Senate,"(S) Business, Labor  and Economic Affairs--Be Concurred In As Amended",7,4,0,0,11
2012448,1549968,2025-04-15,Senate,"(S) Business, Labor  and Economic Affairs--To Table",11,0,0,0,11
2012448,1552344,2025-04-18,Senate,"(S) 2nd Reading Motion to Amend Failed",24,26,0,0,50
2012448,1553394,2025-04-18,Senate,"(S) 2nd Reading Concurred",29,21,0,0,50
2012448,1554398,2025-04-18,Senate,"(S) 2nd Reading Concurred",29,21,0,0,50
2012448,1559581,2025-04-15,Senate,"(S) Business, Labor  and Economic Affairs--To Table",11,0,0,0,11
2012448,1559582,2025-04-23,Senate,"(S) Motion Carried",29,21,0,0,50
2012448,1559583,2025-04-24,Senate,"(S) 3rd Reading Concurred",29,21,0,0,50
2012448,1560867,2025-04-29,House,"(H) 2nd Reading Senate Amendments Concurred",94,5,0,1,100
2012448,1562003,2025-04-30,House,"(H) 3rd Reading Passed as Amended by Senate",86,14,0,0,100
2012538,1533728,2025-04-01,Senate,"(S) Taxation--Do Pass As Amended",7,1,0,0,8
2012538,1536662,2025-04-03,Senate,"(S) 2nd Reading Passed",42,7,0,1,50
2012538,1537107,2025-04-04,Senate,"(S) Finance and Claims--Do Pass",20,2,0,0,22
2012538,1537856,2025-04-05,Senate,"(S) 3rd Reading Passed",42,6,0,2,50
2012538,1550272,2025-04-16,House,"(H) Taxation--Be Concurred In As Amended",21,0,0,0,21
2012538,1552298,2025-04-18,House,"(H) 2nd Reading Concurred",71,28,0,1,100
2012538,1554945,2025-04-22,House,"(H) Appropriations--Be Concurred In",22,0,1,0,23
2012538,1557086,2025-04-24,House,"(H) 3rd Reading Concurred",88,12,0,0,100
2012538,1559247,2025-04-28,Senate,"(S) 2nd Reading House Amendments Concurred",41,9,0,0,50
2012538,1560824,2025-04-29,Senate,"(S) 3rd Reading Passed as Amended by House",45,5,0,0,50
2012621,1530811,2025-03-31,House,"(H) Taxation--To Table",21,0,0,0,21
2012764,1530430,2025-03-28,House,"(H) Transportation--Do Pass",14,0,0,0,14
2012764,1532973,2025-04-01,House,"(H) 2nd Reading Passed",97,3,0,0,100
2012764,1534882,2025-04-02,House,"(H) 3rd Reading Passed",89,6,0,5,100
2012764,1539015,2025-04-07,Senate,"(S) Highways and Transportation--Be Concurred In",8,0,0,0,8
2012764,1549865,2025-04-16,Senate,"(S) 2nd Reading Concurred",40,8,0,2,50
2012764,1551687,2025-04-17,Senate,"(S) 3rd Reading Concurred",38,12,0,0,50
2013005,1533730,2025-04-01,House,"(H) Fish, Wildlife and Parks--To Table",20,0,0,0,20
2013120,1532132,2025-04-01,House,"(H) State Administration--Do Pass As Amended",19,0,0,0,19
2013120,1537464,2025-04-04,House,"(H) 2nd Reading Passed",57,43,0,0,100
2013120,1537641,2025-04-05,House,"(H) 3rd Reading Passed",56,42,0,2,100
2013120,1555991,2025-04-23,Senate,"(S) State Administration--Be Concurred In",8,1,0,0,9
2013120,1558287,2025-04-25,Senate,"(S) 2nd Reading Concurred",28,22,0,0,50
2013120,1558915,2025-04-28,Senate,"(S) 3rd Reading Concurred",22,27,0,1,50
2013120,1559611,2025-04-28,Senate,"(S) 3rd Reading Failed",22,27,0,1,50
2013287,1533002,2025-04-01,House,"(H) Business and Labor--Resolution Adopted",20,0,0,0,20
2013287,1537070,2025-04-03,House,"(H) 2nd Reading Passed",100,0,0,0,100
2013287,1537718,2025-04-05,House,"(H) 3rd Reading Passed",98,0,0,2,100
2013287,1540199,2025-04-08,Senate,"(S) Business, Labor  and Economic Affairs--Be Concurred In",11,0,0,0,11
2013287,1552154,2025-04-18,Senate,"(S) 2nd Reading Concurred",46,1,0,3,50
2013287,1554214,2025-04-22,Senate,"(S) 3rd Reading Concurred",49,1,0,0,50
2013448,1530822,2025-03-31,House,"(H) Taxation--Do Pass",12,9,0,0,21
2013448,1533667,2025-04-01,House,"(H) Appropriations--To Table",14,8,1,0,23
2013606,1536254,2025-04-03,Senate,"(S) Judiciary--Do Pass",8,0,0,0,8
2013606,1537575,2025-04-04,Senate,"(S) 2nd Reading Passed",46,4,0,0,50
2013606,1537631,2025-04-05,Senate,"(S) Finance and Claims--Do Pass",22,0,0,0,22
2013606,1537869,2025-04-05,Senate,"(S) 3rd Reading Passed",45,0,0,5,50
2013606,1551223,2025-04-17,House,"(H) Taxation--Be Concurred In As Amended",15,6,0,0,21
2013606,1553867,2025-04-22,House,"(H) 2nd Reading Concurred",79,20,0,1,100
2013606,1555882,2025-04-23,House,"(H) Appropriations--Be Concurred In",17,6,0,0,23
2013606,1558134,2025-04-25,House,"(H) 3rd Reading Concurred",74,26,0,0,100
2013606,1559283,2025-04-28,Senate,"(S) 2nd Reading House Amendments Concurred",35,15,0,0,50
2013606,1560199,2025-04-29,Senate,"(S) 3rd Reading Passed as Amended by House",42,8,0,0,50
2013615,1533729,2025-04-01,Senate,"(S) Taxation--To Table",8,0,0,0,8
2013656,1530820,2025-03-31,House,"(H) Taxation--To Table",20,1,0,0,21
2013698,1530859,2025-03-31,Senate,"(S) Taxation--Do Pass",6,2,0,0,8
2013698,1534563,2025-04-02,Senate,"(S) 2nd Reading Passed",28,21,0,1,50
2013698,1536949,2025-04-03,Senate,"(S) 3rd Reading Passed",31,19,0,0,50
2013698,1550260,2025-04-16,House,"(H) Taxation--To Table",12,9,0,0,21
2013834,1530975,2025-03-31,Senate,"(S) Taxation--Do Pass As Amended",6,2,0,0,8
2013834,1534482,2025-04-02,Senate,"(S) 2nd Reading Passed",42,7,0,1,50
2013834,1535819,2025-04-03,Senate,"(S) 3rd Reading Passed",41,9,0,0,50
2013834,1551580,2025-04-17,House,"(H) Taxation--Be Concurred In As Amended",12,9,0,0,21
2013834,1553918,2025-04-22,House,"(H) 2nd Reading Not Concurred",36,64,0,0,100
2013891,1530155,2025-03-28,House,"(H) Appropriations--Do Pass As Amended",20,3,0,0,23
2013891,1536963,2025-04-03,House,"(H) 2nd Reading Passed",81,19,0,0,100
2013891,1537866,2025-04-05,House,"(H) 3rd Reading Passed",74,24,0,2,100
2013891,1551675,2025-04-16,Senate,"(S) Finance and Claims--Be Concurred In",12,10,0,0,22
2013891,1553467,2025-04-22,Senate,"(S) 2nd Reading Concurred",30,20,0,0,50
2013891,1555819,2025-04-23,Senate,"(S) 3rd Reading Concurred",27,23,0,0,50
2013946,1535762,2025-04-03,Senate,"(S) Legislative Administration--Resolution Adopted",4,2,0,0,6
2013946,1537566,2025-04-04,Senate,"(S) 2nd Reading Passed",32,18,0,0,50
2013946,1537696,2025-04-05,Senate,"(S) 3rd Reading Passed",29,19,0,2,50
2013946,1550208,2025-04-16,House,"(H) Energy, Technology and Federal Relations--Be Concurred In",8,6,0,0,14
2013946,1557032,2025-04-24,House,"(H) 2nd Reading Not Concurred",35,64,0,1,100
2013998,1531683,2025-03-31,House,"(H) Education--Do Pass As Amended",15,0,0,0,15
2013998,1537016,2025-04-03,House,"(H) Appropriations--Do Pass As Amended",19,4,0,0,23
2013998,1539233,2025-04-07,House,"(H) 2nd Reading Passed",76,24,0,0,100
2013998,1541158,2025-04-08,House,"(H) 3rd Reading Passed",75,22,0,3,100
2013998,1548802,2025-04-15,Senate,"(S) Agriculture, Livestock and Irrigation--Be Concurred In",11,0,0,0,11
2013998,1551451,2025-04-17,Senate,"(S) 2nd Reading Concurred",41,9,0,0,50
2013998,1552084,2025-04-15,Senate,"(S) Agriculture, Livestock and Irrigation--Be Concurred In",11,0,0,0,11
2013998,1555870,2025-04-23,Senate,"(S) Taken from Committee; Placed on 2nd Reading",43,7,0,0,50
2013998,1555871,2025-04-23,Senate,"(S) Motion Carried",41,9,0,0,50
2013998,1557833,2025-04-24,Senate,"(S) 3rd Reading Concurred",43,7,0,0,50
2014108,1535815,2025-04-03,Senate,"(S) Judiciary--Do Pass",5,3,0,0,8
2014108,1537354,2025-04-04,Senate,"(S) 2nd Reading Passed",22,27,0,1,50
2014108,1537355,2025-04-04,Senate,"(S) 2nd Reading Indefinitely Postponed",27,22,0,1,50
2014153,1541191,2025-04-08,House,"(H) Local Government--Do Pass",17,0,0,0,17
2014153,1548405,2025-04-15,House,"(H) 2nd Reading Passed",95,5,0,0,100
2014153,1550110,2025-04-16,House,"(H) 3rd Reading Passed",88,10,0,2,100
2014153,1556082,2025-04-23,Senate,"(S) Local Government--Be Concurred In",8,2,0,0,10
2014153,1559120,2025-04-28,Senate,"(S) 2nd Reading Concurred",40,10,0,0,50
2014153,1560236,2025-04-29,Senate,"(S) 3rd Reading Concurred",37,12,0,1,50
2014207,1532238,2025-04-01,Senate,"(S) Taxation--Do Pass",7,1,0,0,8
2014207,1536701,2025-04-03,Senate,"(S) 2nd Reading Passed",43,7,0,0,50
2014207,1537106,2025-04-04,Senate,"(S) Finance and Claims--Do Pass",19,3,0,0,22
2014207,1537635,2025-04-05,Senate,"(S) 3rd Reading Passed",36,12,0,2,50
2014207,1552064,2025-04-18,House,"(H) Taxation--Be Concurred In As Amended",21,0,0,0,21
2014207,1554290,2025-04-22,House,"(H) 2nd Reading Motion to Amend Failed",29,71,0,0,100
2014207,1554291,2025-04-22,House,"(H) 2nd Reading Motion to Amend Carried",99,0,0,1,100
2014207,1554292,2025-04-22,House,"(H) 2nd Reading Motion to Amend Failed",33,67,0,0,100
2014207,1554293,2025-04-22,House,"(H) 2nd Reading Motion to Amend Failed",41,59,0,0,100
2014207,1554294,2025-04-22,House,"(H) 2nd Reading Motion to Amend Failed",17,83,0,0,100
2014207,1554295,2025-04-22,House,"(H) 2nd Reading Motion to Amend Failed",27,73,0,0,100
2014207,1554296,2025-04-22,House,"(H) 2nd Reading Concurred as Amended",80,20,0,0,100
2014207,1556679,2025-04-24,House,"(H) 3rd Reading Concurred",73,26,0,1,100
2014207,1559222,2025-04-28,Senate,"(S) 2nd Reading House Amendments Not Concurred",48,1,0,1,50
2014207,1561218,2025-04-29,Senate,"(S) 2nd Reading Conference Committee Report Adopted",29,21,0,0,50
2014207,1562501,2025-04-30,Senate,"(S) 3rd Reading Conference Committee Report Adopted",28,22,0,0,50
2014257,1530225,2025-03-28,House,"(H) Education--Do Pass",15,0,0,0,15
2014257,1533226,2025-04-01,House,"(H) 2nd Reading Passed",84,16,0,0,100
2014257,1534810,2025-04-02,House,"(H) 3rd Reading Passed",74,21,0,5,100
2014257,1549283,2025-04-15,Senate,"(S) Education and Cultural Resources--Be Concurred In",10,4,0,0,14
2014257,1552265,2025-04-18,Senate,"(S) 2nd Reading Concurred",45,2,0,3,50
2014257,1554771,2025-04-22,Senate,"(S) 3rd Reading Concurred",47,3,0,0,50
2014305,1528750,2025-03-27,House,"(H) Appropriations--Do Pass",19,4,0,0,23
2014305,1530744,2025-03-29,House,"(H) 2nd Reading Passed",79,21,0,0,100
2014305,1530986,2025-03-31,House,"(H) 3rd Reading Passed",78,21,0,1,100
2014305,1551163,2025-04-17,Senate,"(S) Taken from Committee; Placed on 2nd Reading",26,24,0,0,50
2014305,1556237,2025-04-23,Senate,"(S) 2nd Reading Motion to Amend Failed",19,31,0,0,50
2014305,1556238,2025-04-23,Senate,"(S) 2nd Reading Motion to Amend Failed",18,32,0,0,50
2014305,1556239,2025-04-23,Senate,"(S) 2nd Reading Motion to Amend Carried",50,0,0,0,50
2014305,1556240,2025-04-23,Senate,"(S) 2nd Reading Motion to Amend Carried",29,21,0,0,50
2014305,1556241,2025-04-23,Senate,"(S) 2nd Reading Concurred as Amended",28,22,0,0,50
2014305,1556242,2025-04-23,Senate,"(S) Motion Failed",21,29,0,0,50
2014305,1558142,2025-04-25,Senate,"(S) 3rd Reading Concurred",28,21,0,1,50
2014305,1560755,2025-04-29,House,"(H) 2nd Reading Senate Amendments Not Concurred",38,62,0,0,100
2014305,1560756,2025-04-29,House,"(H) Reconsidered Previous Action; Placed on 2nd Reading",58,39,0,3,100
2014305,1562597,2025-04-30,House,"(H) 2nd Reading Senate Amendments Concurred",59,41,0,0,100
2014305,1562598,2025-04-30,House,"(H) 3rd Reading Passed as Amended by Senate",55,45,0,0,100
2014356,1536835,2025-04-03,House,"(H) Appropriations--To Table",20,0,3,0,23
2014404,1536997,2025-04-03,Senate,"(S) Agriculture, Livestock and Irrigation--Resolution Adopted",6,5,0,0,11
2014404,1539092,2025-04-07,Senate,"(S) 2nd Reading Pass Motion Failed",24,26,0,0,50
2014404,1539093,2025-04-07,Senate,"(S) 2nd Reading Indefinitely Postponed",32,17,0,1,50
2014445,1530351,2025-03-28,House,"(H) Education--Do Pass",15,0,0,0,15
2014445,1533442,2025-04-01,House,"(H) 2nd Reading Passed",61,39,0,0,100
2014445,1534587,2025-04-02,House,"(H) 3rd Reading Passed",60,35,0,5,100
2014445,1549042,2025-04-15,Senate,"(S) Education and Cultural Resources--Be Concurred In",11,3,0,0,14
2014445,1552004,2025-04-17,Senate,"(S) 2nd Reading Concurred",36,14,0,0,50
2014445,1552247,2025-04-18,Senate,"(S) 3rd Reading Concurred",29,21,0,0,50
2014464,1531664,2025-03-31,House,"(H) Education--Do Pass As Amended",15,0,0,0,15
2014464,1537047,2025-04-04,House,"(H) 2nd Reading Passed",82,16,0,2,100
2014464,1537648,2025-04-05,House,"(H) 3rd Reading Passed",75,23,0,2,100
2014464,1549369,2025-04-15,Senate,"(S) Education and Cultural Resources--Be Concurred In",10,4,0,0,14
2014464,1552026,2025-04-17,Senate,"(S) 2nd Reading Concurred",45,3,0,2,50
2014464,1552257,2025-04-18,Senate,"(S) 3rd Reading Concurred",45,5,0,0,50
2014499,1549102,2025-04-15,House,"(H) Judiciary--Resolution Adopted",20,0,0,0,20
2014499,1551516,2025-04-17,House,"(H) 2nd Reading Passed",97,3,0,0,100
2014499,1552060,2025-04-18,House,"(H) 3rd Reading Passed",94,4,0,2,100
2014499,1557087,2025-04-24,Senate,"(S) Judiciary--Resolution Adopted",5,3,0,0,8
2014499,1559178,2025-04-28,Senate,"(S) 2nd Reading Concurred",37,9,0,4,50
2014499,1560267,2025-04-29,Senate,"(S) 3rd Reading Concurred",37,13,0,0,50
2014515,1535709,2025-04-03,House,"(H) Appropriations--To Table",20,0,3,0,23
2014536,1534155,2025-04-02,Senate,"(S) Taxation--To Table",8,0,0,0,8
2014536,1535383,2025-04-02,Senate,"(S) Motion Carried",27,23,0,0,50
2014536,1536666,2025-04-03,Senate,"(S) 2nd Reading Motion to Amend Carried",49,0,0,1,50
2014536,1536667,2025-04-03,Senate,"(S) 2nd Reading Passed as Amended",28,21,0,1,50
2014536,1537414,2025-04-04,Senate,"(S) Finance and Claims--Do Pass",18,4,0,0,22
2014536,1537639,2025-04-05,Senate,"(S) 3rd Reading Passed",31,17,0,2,50
2014536,1550267,2025-04-16,House,"(H) Taxation--To Table",21,0,0,0,21
2014548,1534896,2025-04-02,Senate,"(S) Highways and Transportation--Do Pass",8,0,0,0,8
2014548,1537437,2025-04-04,Senate,"(S) 2nd Reading Motion to Amend Carried",48,0,0,2,50
2014548,1537438,2025-04-04,Senate,"(S) 2nd Reading Passed as Amended",47,0,0,3,50
2014548,1537840,2025-04-05,Senate,"(S) 3rd Reading Passed",48,0,0,2,50
2014548,1547946,2025-04-14,House,"(H) Transportation--Be Concurred In",14,0,0,0,14
2014548,1553778,2025-04-22,House,"(H) 2nd Reading Motion to Amend Carried",97,3,0,0,100
2014548,1553779,2025-04-22,House,"(H) 2nd Reading Concurred as Amended",98,1,0,1,100
2014548,1557460,2025-04-24,House,"(H) 3rd Reading Concurred",98,1,0,1,100
2014548,1559531,2025-04-28,Senate,"(S) 2nd Reading House Amendments Concurred",49,0,0,1,50
2014548,1561289,2025-04-29,Senate,"(S) 3rd Reading Passed as Amended by House",50,0,0,0,50
2014565,1532689,2025-04-01,House,"(H) Appropriations--Do Pass As Amended",21,0,2,0,23
2014565,1536937,2025-04-03,House,"(H) 2nd Reading Passed",91,9,0,0,100
2014565,1537846,2025-04-05,House,"(H) 3rd Reading Passed",89,9,0,2,100
2014565,1551345,2025-04-16,Senate,"(S) Finance and Claims--Be Concurred In As Amended",12,10,0,0,22
2014565,1554142,2025-04-22,Senate,"(S) 2nd Reading Concurred",29,21,0,0,50
2014565,1555701,2025-04-23,Senate,"(S) 3rd Reading Concurred",30,20,0,0,50
2014565,1558109,2025-04-25,House,"(H) 2nd Reading Senate Amendments Concurred",97,3,0,0,100
2014565,1559325,2025-04-28,House,"(H) 3rd Reading Passed as Amended by Senate",85,15,0,0,100
2014586,1537571,2025-04-04,Senate,"(S) Highways and Transportation--To Table",6,0,2,0,8
2014602,1531086,2025-03-31,House,"(H) Taxation--To Table",11,10,0,0,21
2014602,1533731,2025-04-01,House,"(H) Taxation--To Take From The Table",16,3,2,0,21
2014602,1535619,2025-04-01,House,"(H) Taxation--To Take From The Table",16,3,2,0,21
2014602,1535620,2025-04-01,House,"(H) Taxation--Do Pass",15,6,0,0,21
2014602,1536638,2025-04-03,House,"(H) Appropriations--To Table",12,11,0,0,23
2014621,1532237,2025-04-01,House,"(H) Business and Labor--Do Pass",20,0,0,0,20
2014621,1536391,2025-04-03,House,"(H) 2nd Reading Passed",97,2,0,1,100
2014621,1537649,2025-04-05,House,"(H) 3rd Reading Passed",98,0,0,2,100
2014621,1549022,2025-04-15,Senate,"(S) Business, Labor  and Economic Affairs--Be Concurred In",11,0,0,0,11
2014621,1552305,2025-04-18,Senate,"(S) 2nd Reading Concurred",29,19,0,2,50
2014621,1554807,2025-04-22,Senate,"(S) 3rd Reading Concurred",29,21,0,0,50
2014635,1535028,2025-04-02,Senate,"(S) Taxation--Do Pass",8,0,0,0,8
2014635,1537385,2025-04-04,Senate,"(S) 2nd Reading Passed",48,0,0,2,50
2014635,1537637,2025-04-05,Senate,"(S) 3rd Reading Passed",48,0,0,2,50
2014635,1550281,2025-04-16,House,"(H) Taxation--Be Concurred In",21,0,0,0,21
2014635,1552292,2025-04-18,House,"(H) 2nd Reading Concurred",97,1,0,2,100
2014635,1553723,2025-04-22,House,"(H) 3rd Reading Concurred",97,1,0,2,100
2014644,1534881,2025-04-02,Senate,"(S) Taxation--Do Pass As Amended",6,2,0,0,8
2014644,1536149,2025-04-03,Senate,"(S) 2nd Reading Motion to Amend Carried",31,19,0,0,50
2014644,1536150,2025-04-03,Senate,"(S) 2nd Reading Passed as Amended",31,19,0,0,50
2014644,1537187,2025-04-04,Senate,"(S) Finance and Claims--To Table",22,0,0,0,22
2014796,1533770,2025-04-01,House,"(H) Appropriations--To Table",22,0,1,0,23
2014818,1531220,2025-03-31,House,"(H) Energy, Technology and Federal Relations--To Table",8,6,0,0,14
2014818,1537439,2025-04-04,House,"(H) Energy, Technology and Federal Relations--To Take From The Table",5,6,3,0,14
2014865,1535124,2025-04-02,Senate,"(S) Taxation--Do Pass",7,1,0,0,8
2014865,1536903,2025-04-03,Senate,"(S) 2nd Reading Passed",45,5,0,0,50
2014865,1537516,2025-04-04,Senate,"(S) 3rd Reading Passed",44,5,0,1,50
2014865,1550390,2025-04-16,House,"(H) Taxation--Be Concurred In",16,5,0,0,21
2014865,1553796,2025-04-22,House,"(H) 2nd Reading Concurred",99,0,0,1,100
2014865,1555401,2025-04-23,House,"(H) 3rd Reading Concurred",99,0,0,1,100
2014892,1533359,2025-04-01,House,"(H) Business and Labor--To Table",13,1,6,0,20
2014913,1534214,2025-04-02,Senate,"(S) Business, Labor  and Economic Affairs--To Table",11,0,0,0,11
2014913,1537542,2025-04-04,Senate,"(S) Motion Failed",23,25,0,2,50
2014940,1537005,2025-04-04,House,"(H) Business and Labor--Do Pass As Amended",20,0,0,0,20
2014940,1538777,2025-04-07,House,"(H) 2nd Reading Passed",100,0,0,0,100
2014940,1540150,2025-04-08,House,"(H) 3rd Reading Passed",95,2,0,3,100
2014940,1549737,2025-04-16,Senate,"(S) Business, Labor  and Economic Affairs--Be Concurred In",11,0,0,0,11
2014940,1551859,2025-04-17,Senate,"(S) 2nd Reading Concurred",48,1,0,1,50
2014940,1552318,2025-04-18,Senate,"(S) 3rd Reading Concurred",49,1,0,0,50
2014961,1534325,2025-04-01,House,"(H) Local Government--Do Pass",9,8,0,0,17
2014961,1537173,2025-04-04,House,"(H) 2nd Reading Motion to Amend Carried",78,22,0,0,100
2014961,1537174,2025-04-04,House,"(H) 2nd Reading Passed as Amended",57,43,0,0,100
2014961,1538249,2025-04-07,House,"(H) 3rd Reading Failed",47,52,0,1,100
2014976,1530239,2025-03-28,House,"(H) Appropriations--Do Pass As Amended",20,1,0,2,23
2014976,1537056,2025-04-04,House,"(H) 2nd Reading Passed",99,1,0,0,100
2014976,1537652,2025-04-05,House,"(H) 3rd Reading Passed",97,1,0,2,100
2014976,1551511,2025-04-16,Senate,"(S) Finance and Claims--Be Concurred In As Amended",17,5,0,0,22
2014976,1554168,2025-04-22,Senate,"(S) 2nd Reading Concurred",28,22,0,0,50
2014976,1556328,2025-04-23,Senate,"(S) 3rd Reading Concurred",29,21,0,0,50
2014976,1558122,2025-04-25,House,"(H) 2nd Reading Senate Amendments Concurred",100,0,0,0,100
2014976,1559351,2025-04-28,House,"(H) 3rd Reading Passed as Amended by Senate",100,0,0,0,100
2015021,1532139,2025-04-01,House,"(H) Business and Labor--Resolution Adopted",20,0,0,0,20
2015021,1536284,2025-04-03,House,"(H) Resolution Adopted",100,0,0,0,100
2015021,1537371,2025-04-03,House,"(H) 2nd Reading Passed",100,0,0,0,100
2015021,1537658,2025-04-05,House,"(H) 3rd Reading Passed",97,0,0,3,100
2015021,1548747,2025-04-15,Senate,"(S) Business, Labor  and Economic Affairs--Be Concurred In",11,0,0,0,11
2015021,1552143,2025-04-18,Senate,"(S) 2nd Reading Concurred",45,3,0,2,50
2015021,1553676,2025-04-22,Senate,"(S) 3rd Reading Concurred",47,3,0,0,50
2015052,1535813,2025-04-03,House,"(H) Appropriations--Do Pass As Amended",16,7,0,0,23
2015052,1537536,2025-04-04,House,"(H) 2nd Reading Passed",53,47,0,0,100
2015052,1537645,2025-04-05,House,"(H) 3rd Reading Passed",57,41,0,2,100
2015052,1550151,2025-04-16,Senate,"(S) Finance and Claims--To Table",22,0,0,0,22
2015052,1558087,2025-04-16,Senate,"(S) Finance and Claims--To Table",22,0,0,0,22
2015052,1558088,2025-04-23,Senate,"(S) Taken from Committee; Placed on 2nd Reading",28,22,0,0,50
2015052,1558089,2025-04-24,Senate,"(S) 2nd Reading Concurred",43,7,0,0,50
2015052,1558090,2025-04-25,Senate,"(S) 3rd Reading Concurred",31,18,0,1,50
2015079,1533742,2025-04-01,House,"(H) Agriculture--Do Pass",17,0,0,0,17
2015079,1537514,2025-04-04,House,"(H) 2nd Reading Passed",95,4,0,1,100
2015079,1537824,2025-04-05,House,"(H) 3rd Reading Passed",94,4,0,2,100
2015079,1554160,2025-04-22,Senate,"(S) Agriculture, Livestock and Irrigation--Resolution Adopted As Amended",10,0,0,0,10
2015079,1557617,2025-04-24,Senate,"(S) 2nd Reading Motion to Amend Failed",11,38,0,1,50
2015079,1557618,2025-04-24,Senate,"(S) 2nd Reading Concurred",48,1,0,1,50
2015079,1558282,2025-04-25,Senate,"(S) 3rd Reading Concurred",48,1,0,1,50
2015079,1560926,2025-04-29,House,"(H) 2nd Reading Senate Amendments Concurred",90,7,0,3,100
2015079,1562718,2025-04-30,House,"(H) 3rd Reading Passed as Amended by Senate",98,2,0,0,100
2015112,1534742,2025-04-02,House,"(H) Business and Labor--Do Pass As Amended",20,0,0,0,20
2015112,1537018,2025-04-04,House,"(H) 2nd Reading Passed",95,5,0,0,100
2015112,1537841,2025-04-05,House,"(H) 3rd Reading Passed",91,7,0,2,100
2015112,1550206,2025-04-16,Senate,"(S) Business, Labor  and Economic Affairs--Be Concurred In",11,0,0,0,11
2015112,1552286,2025-04-18,Senate,"(S) 2nd Reading Concurred",32,18,0,0,50
2015112,1554231,2025-04-22,Senate,"(S) 3rd Reading Concurred",31,19,0,0,50
2015151,1530215,2025-03-28,House,"(H) Appropriations--To Table",19,0,0,4,23
2015179,1532199,2025-04-01,House,"(H) State Administration--To Table",19,0,0,0,19
2015179,1534837,2025-04-02,House,"(H) Taken from Committee; Placed on 2nd Reading",42,51,0,7,100
2015212,1532822,2025-04-01,House,"(H) Taxation--Do Pass",17,4,0,0,21
2015212,1538787,2025-04-07,House,"(H) 2nd Reading Not Passed",46,52,0,2,100
2015235,1533303,2025-04-01,House,"(H) Human Services--Do Pass",17,4,0,0,21
2015235,1536995,2025-04-03,House,"(H) Appropriations--Do Pass",19,4,0,0,23
2015235,1538811,2025-04-07,House,"(H) 2nd Reading Passed",64,36,0,0,100
2015235,1540010,2025-04-08,House,"(H) 3rd Reading Passed",60,37,0,3,100
2015235,1550878,2025-04-16,Senate,"(S) Public Health, Welfare and Safety--Be Concurred In",8,3,0,0,11
2015235,1553499,2025-04-22,Senate,"(S) 2nd Reading Concurred",32,16,0,2,50
2015235,1555868,2025-04-23,Senate,"(S) 3rd Reading Concurred",30,20,0,0,50
2015248,1533269,2025-04-01,House,"(H) Human Services--Do Pass As Amended",21,0,0,0,21
2015248,1537010,2025-04-03,House,"(H) Appropriations--To Table",13,10,0,0,23
2015248,1537376,2025-04-04,House,"(H) Taken from Committee; Placed on 2nd Reading",45,49,0,6,100
2015286,1535797,2025-04-03,Senate,"(S) Judiciary--Do Pass",7,1,0,0,8
2015286,1537587,2025-04-04,Senate,"(S) 2nd Reading Passed",48,0,0,2,50
2015286,1537650,2025-04-05,Senate,"(S) 3rd Reading Passed",46,2,0,2,50
2015286,1549904,2025-04-16,House,"(H) Judiciary--Be Concurred In",17,3,0,0,20
2015286,1554786,2025-04-22,House,"(H) 2nd Reading Concurred",92,7,0,1,100
2015286,1556287,2025-04-23,House,"(H) 3rd Reading Concurred",91,8,0,1,100
2015326,1533949,2025-04-02,Senate,"(S) Business, Labor  and Economic Affairs--Resolution Adopted",11,0,0,0,11
2015326,1537858,2025-04-05,Senate,"(S) Resolution Adopted",47,2,0,1,50
2015366,1530238,2025-03-28,House,"(H) Motion Carried",64,35,0,1,100
2015366,1530652,2025-03-28,House,"(H) Motion Carried",64,35,0,1,100
2015366,1533220,2025-04-01,House,"(H) Taken from Committee; Placed on 2nd Reading",59,39,0,2,100
2015366,1536695,2025-04-03,House,"(H) 2nd Reading Motion to Amend Carried",73,27,0,0,100
2015366,1536696,2025-04-03,House,"(H) 2nd Reading Not Passed as Amended",50,50,0,0,100
2015366,1543148,2025-04-01,House,"(H) Taken from Committee; Placed on 2nd Reading",59,39,0,2,100
2015366,1547520,2025-03-31,House,"(H) Natural Resources--To Table",7,7,0,0,14
2015410,1534139,2025-04-02,Senate,"(S) Business, Labor  and Economic Affairs--Do Pass",11,0,0,0,11
2015410,1537579,2025-04-04,Senate,"(S) 2nd Reading Passed",47,1,0,2,50
2015410,1537630,2025-04-05,Senate,"(S) 3rd Reading Passed",48,0,0,2,50
2015410,1552300,2025-04-18,House,"(H) Business and Labor--Be Concurred In As Amended",18,2,0,0,20
2015410,1554883,2025-04-22,House,"(H) 2nd Reading Not Concurred",32,68,0,0,100
2015410,1555104,2025-04-23,House,"(H) Reconsidered Previous Action; Placed on 2nd Reading",70,30,0,0,100
2015410,1556086,2025-04-23,House,"(H) 2nd Reading Motion to Amend Carried",97,3,0,0,100
2015410,1556088,2025-04-23,House,"(H) 2nd Reading Concurred as Amended",65,35,0,0,100
2015410,1556778,2025-04-23,House,"(H) Appropriations--Be Concurred In",16,7,0,0,23
2015410,1558071,2025-04-25,House,"(H) 3rd Reading Concurred",62,38,0,0,100
2015410,1558072,2025-04-23,House,"(H) Appropriations--Be Concurred In",16,7,0,0,23
2015410,1558845,2025-04-28,Senate,"(S) 2nd Reading House Amendments Concurred",43,6,0,1,50
2015410,1560858,2025-04-29,Senate,"(S) 3rd Reading Passed as Amended by House",30,20,0,0,50
2015452,1533666,2025-04-01,House,"(H) Human Services--To Table",11,6,4,0,21
2015498,1535536,2025-04-02,Senate,"(S) State Administration--To Table",9,0,0,0,9
2015539,1533765,2025-04-01,House,"(H) Human Services--Do Pass",11,10,0,0,21
2015539,1537290,2025-04-04,House,"(H) 2nd Reading Passed",64,36,0,0,100
2015539,1537815,2025-04-05,House,"(H) 3rd Reading Passed",57,41,0,2,100
2015539,1547452,2025-04-14,Senate,"(S) Public Health, Welfare and Safety--Be Concurred In",7,4,0,0,11
2015539,1551423,2025-04-17,Senate,"(S) 2nd Reading Concurred",31,18,0,1,50
2015539,1552333,2025-04-18,Senate,"(S) 3rd Reading Concurred",32,18,0,0,50
2015568,1534767,2025-04-01,House,"(H) Local Government--To Table",17,0,0,0,17
2015603,1534278,2025-04-01,House,"(H) Local Government--Do Pass As Amended",10,7,0,0,17
2015603,1537075,2025-04-04,House,"(H) 2nd Reading Passed",58,42,0,0,100
2015603,1537748,2025-04-05,House,"(H) 3rd Reading Passed",56,42,0,2,100
2015603,1547658,2025-04-14,Senate,"(S) Local Government--Be Concurred In",6,4,0,0,10
2015603,1551432,2025-04-17,Senate,"(S) 2nd Reading Motion to Amend Carried",30,19,0,1,50
2015603,1551433,2025-04-17,Senate,"(S) 2nd Reading Concurred as Amended",27,22,0,1,50
2015603,1552278,2025-04-18,Senate,"(S) 3rd Reading Concurred",30,20,0,0,50
2015603,1557213,2025-04-24,House,"(H) 2nd Reading Senate Amendments Concurred",57,43,0,0,100
2015603,1558107,2025-04-25,House,"(H) 3rd Reading Passed as Amended by Senate",59,41,0,0,100
2015639,1533910,2025-04-01,House,"(H) Local Government--Do Pass",9,8,0,0,17
2015639,1537367,2025-04-04,House,"(H) 2nd Reading Motion to Amend Carried",71,28,0,1,100
2015639,1537368,2025-04-04,House,"(H) 2nd Reading Passed as Amended",55,44,0,1,100
2015639,1538359,2025-04-07,House,"(H) 3rd Reading Failed",41,58,0,1,100
2015677,1533366,2025-04-01,House,"(H) Judiciary--Do Pass",12,8,0,0,20
2015677,1538311,2025-04-07,House,"(H) 2nd Reading Passed",59,40,0,1,100
2015677,1539532,2025-04-08,House,"(H) 3rd Reading Passed",59,38,0,3,100
2015677,1549768,2025-04-16,Senate,"(S) Judiciary--To Table",8,0,0,0,8
2015677,1550803,2025-04-16,Senate,"(S) Judiciary--To Table",8,0,0,0,8
2015779,1531404,2025-03-31,Senate,"(S) Public Health, Welfare and Safety--Do Pass",7,4,0,0,11
2015779,1536887,2025-04-03,Senate,"(S) 2nd Reading Pass Motion Failed",24,26,0,0,50
2015779,1536888,2025-04-03,Senate,"(S) 2nd Reading Indefinitely Postponed",26,24,0,0,50
2015831,1533674,2025-04-01,House,"(H) Taxation--To Table",21,0,0,0,21
2015881,1545771,2025-04-11,Senate,"(S) Judiciary--Resolution Adopted",8,0,0,0,8
2015881,1546567,2025-04-12,Senate,"(S) Resolution Adopted",48,0,0,2,50
2015934,1533637,2025-04-01,House,"(H) Taxation--Do Pass As Amended",12,9,0,0,21
2015934,1535141,2025-04-02,House,"(H) Appropriations--To Table",22,1,0,0,23
2015986,1532778,2025-04-01,House,"(H) Business and Labor--Do Pass",18,2,0,0,20
2015986,1536996,2025-04-03,House,"(H) Appropriations--To Table",23,0,0,0,23
2015996,1533750,2025-04-01,House,"(H) Fish, Wildlife and Parks--Do Pass",13,7,0,0,20
2015996,1537013,2025-04-04,House,"(H) 2nd Reading Passed",52,48,0,0,100
2015996,1537710,2025-04-05,House,"(H) 3rd Reading Passed",60,38,0,2,100
2015996,1549256,2025-04-15,Senate,"(S) Fish and Game--Be Concurred In",11,0,0,0,11
2015996,1552253,2025-04-18,Senate,"(S) 2nd Reading Concurred",49,1,0,0,50
2015996,1554055,2025-04-22,Senate,"(S) 3rd Reading Concurred",50,0,0,0,50
2016001,1532250,2025-04-01,House,"(H) Taxation--To Table",21,0,0,0,21
2016007,1535763,2025-04-03,Senate,"(S) Business, Labor  and Economic Affairs--Do Pass As Amended",11,0,0,0,11
2016007,1537498,2025-04-04,Senate,"(S) 2nd Reading Passed",48,2,0,0,50
2016007,1537643,2025-04-05,Senate,"(S) 3rd Reading Passed",40,8,0,2,50
2016007,1551409,2025-04-15,House,"(H) Business and Labor--Be Concurred In",20,0,0,0,20
2016007,1554287,2025-04-22,House,"(H) 2nd Reading Concurred",93,6,0,1,100
2016007,1555299,2025-04-23,House,"(H) 3rd Reading Concurred",88,11,0,1,100
2016014,1532194,2025-04-01,House,"(H) Judiciary--Do Pass",12,8,0,0,20
2016014,1537225,2025-04-04,House,"(H) 2nd Reading Not Passed",39,61,0,0,100
2016025,1533688,2025-04-01,House,"(H) Taxation--To Table",21,0,0,0,21
2016033,1534071,2025-04-01,House,"(H) Local Government--Do Pass",16,1,0,0,17
2016033,1537082,2025-04-04,House,"(H) 2nd Reading Passed",85,15,0,0,100
2016033,1537839,2025-04-05,House,"(H) 3rd Reading Passed",79,19,0,2,100
2016033,1546452,2025-04-11,Senate,"(S) Local Government--Be Concurred In",10,0,0,0,10
2016033,1552204,2025-04-18,Senate,"(S) 2nd Reading Concurred",45,5,0,0,50
2016033,1554179,2025-04-22,Senate,"(S) 3rd Reading Concurred",48,2,0,0,50
2016039,1533745,2025-04-01,House,"(H) Human Services--Do Pass",11,10,0,0,21
2016039,1536870,2025-04-03,House,"(H) Appropriations--To Table",17,6,0,0,23
2016052,1535791,2025-04-03,House,"(H) Business and Labor--Do Pass",12,8,0,0,20
2016052,1537568,2025-04-04,House,"(H) 2nd Reading Passed",60,39,0,1,100
2016052,1537655,2025-04-05,House,"(H) 3rd Reading Passed",66,32,0,2,100
2016052,1548214,2025-04-15,Senate,"(S) Business, Labor  and Economic Affairs--Be Concurred In As Amended",11,0,0,0,11
2016052,1552011,2025-04-17,Senate,"(S) 2nd Reading Concurred",46,2,0,2,50
2016052,1552289,2025-04-18,Senate,"(S) 3rd Reading Concurred",50,0,0,0,50
2016052,1557257,2025-04-24,House,"(H) 2nd Reading Senate Amendments Concurred",97,1,0,2,100
2016052,1558283,2025-04-25,House,"(H) 3rd Reading Passed as Amended by Senate",81,19,0,0,100
2016058,1536651,2025-04-03,House,"(H) Business and Labor--Do Pass As Amended",12,8,0,0,20
2016058,1539148,2025-04-07,House,"(H) 2nd Reading Passed",57,42,0,1,100
2016058,1539776,2025-04-08,House,"(H) 3rd Reading Passed",58,39,0,3,100
2016058,1549354,2025-04-15,Senate,"(S) Fish and Game--Be Concurred In As Amended",7,4,0,0,11
2016058,1551456,2025-04-17,Senate,"(S) 2nd Reading Concurred",39,11,0,0,50
2016058,1552332,2025-04-18,Senate,"(S) 3rd Reading Concurred",37,13,0,0,50
2016058,1557256,2025-04-24,House,"(H) 2nd Reading Senate Amendments Concurred",61,39,0,0,100
2016058,1558178,2025-04-25,House,"(H) 3rd Reading Passed as Amended by Senate",58,42,0,0,100
2016243,1540989,2025-04-08,Senate,"(S) Agriculture, Livestock and Irrigation--Resolution Adopted",11,0,0,0,11
2016243,1545097,2025-04-10,Senate,"(S) Resolution Adopted",49,0,0,1,50
2016246,1533723,2025-04-01,House,"(H) Taxation--To Table",21,0,0,0,21
2016248,1546130,2025-04-11,Senate,"(S) Judiciary--Resolution Adopted",8,0,0,0,8
2016248,1546681,2025-04-12,Senate,"(S) Resolution Adopted",48,1,0,1,50
2016251,1537413,2025-04-04,Senate,"(S) Highways and Transportation--Resolution Adopted",8,0,0,0,8
2016251,1539842,2025-04-08,Senate,"(S) Resolution Adopted",48,1,0,1,50
2016259,1539518,2025-04-08,Senate,"(S) Business, Labor  and Economic Affairs--Resolution Adopted",11,0,0,0,11
2016259,1545107,2025-04-10,Senate,"(S) Resolution Adopted",50,0,0,0,50
2016260,1549269,2025-04-15,Senate,"(S) Agriculture, Livestock and Irrigation--Resolution Adopted",11,0,0,0,11
2016260,1551695,2025-04-17,Senate,"(S) Resolution Adopted",45,3,0,2,50
2016264,1538851,2025-04-07,Senate,"(S) Natural Resources--Resolution Adopted",11,0,0,0,11
2016264,1545086,2025-04-10,Senate,"(S) Resolution Adopted",50,0,0,0,50
2016267,1532262,2025-04-01,House,"(H) Taxation--To Table",21,0,0,0,21
2016274,1542165,2025-04-09,Senate,"(S) Local Government--Resolution Adopted",10,0,0,0,10
2016274,1545754,2025-04-11,Senate,"(S) Resolution Adopted",50,0,0,0,50
2016278,1541174,2025-04-08,Senate,"(S) Agriculture, Livestock and Irrigation--Resolution Adopted",11,0,0,0,11
2016278,1545129,2025-04-10,Senate,"(S) Resolution Adopted",49,0,0,1,50
2016281,1546329,2025-04-11,Senate,"(S) State Administration--Resolution Adopted",9,0,0,0,9
2016281,1547574,2025-04-14,Senate,"(S) Resolution Adopted",46,3,0,1,50
2016286,1540520,2025-04-08,Senate,"(S) Business, Labor  and Economic Affairs--Resolution Adopted As Amended",11,0,0,0,11
2016286,1544701,2025-04-10,Senate,"(S) Resolution Adopted",48,0,0,2,50
2016289,1537183,2025-04-04,Senate,"(S) Taxation--Do Pass",8,0,0,0,8
2016289,1538652,2025-04-07,Senate,"(S) Resolution Adopted",50,0,0,0,50
2016292,1537435,2025-04-04,Senate,"(S) Business, Labor  and Economic Affairs--Resolution Adopted",11,0,0,0,11
2016292,1538341,2025-04-07,Senate,"(S) Resolution Adopted",50,0,0,0,50
2016296,1546432,2025-04-11,Senate,"(S) Natural Resources--Resolution Adopted",11,0,0,0,11
2016296,1547085,2025-04-14,Senate,"(S) Resolution Adopted",49,0,0,1,50
2016301,1549456,2025-04-15,Senate,"(S) Fish and Game--Resolution Adopted",11,0,0,0,11
2016301,1551958,2025-04-17,Senate,"(S) Resolution Adopted",39,10,0,1,50
2016304,1533652,2025-04-01,House,"(H) Taxation--To Table",21,0,0,0,21
2016306,1538942,2025-04-07,Senate,"(S) Public Health, Welfare and Safety--Resolution Adopted",11,0,0,0,11
2016306,1545026,2025-04-10,Senate,"(S) Resolution Adopted",49,0,0,1,50
2016309,1532254,2025-04-01,House,"(H) Taxation--To Table",21,0,0,0,21
2016311,1538314,2025-04-07,Senate,"(S) Judiciary--Resolution Adopted",8,0,0,0,8
2016311,1544782,2025-04-10,Senate,"(S) Resolution Adopted",49,0,0,1,50
2016323,1542588,2025-04-09,Senate,"(S) Taxation--Do Pass",8,0,0,0,8
2016323,1544824,2025-04-10,Senate,"(S) Resolution Adopted",50,0,0,0,50
2016330,1549028,2025-04-15,Senate,"(S) Energy, Technology & Federal Relations--Resolution Adopted",13,0,0,0,13
2016330,1551217,2025-04-17,Senate,"(S) Resolution Adopted",48,0,0,2,50
2016338,1549345,2025-04-15,Senate,"(S) Energy, Technology & Federal Relations--Resolution Adopted",13,0,0,0,13
2016338,1551981,2025-04-17,Senate,"(S) Resolution Adopted",49,0,0,1,50
2016345,1548690,2025-04-15,Senate,"(S) Energy, Technology & Federal Relations--Resolution Adopted",13,0,0,0,13
2016345,1551215,2025-04-17,Senate,"(S) Resolution Adopted",48,0,0,2,50
2016356,1532245,2025-04-01,House,"(H) Business and Labor--Do Pass As Amended",20,0,0,0,20
2016356,1533761,2025-04-01,House,"(H) Appropriations--To Table",16,7,0,0,23
2016356,1535755,2025-04-03,House,"(H) Appropriations--To Take From The Table",14,7,2,0,23
2016356,1535756,2025-04-03,House,"(H) Appropriations--Do Pass",16,7,0,0,23
2016356,1537538,2025-04-04,House,"(H) 2nd Reading Passed",90,10,0,0,100
2016356,1537860,2025-04-05,House,"(H) 3rd Reading Passed",85,13,0,2,100
2016356,1550000,2025-04-16,Senate,"(S) Taxation--Be Concurred In",8,0,0,0,8
2016356,1552224,2025-04-18,Senate,"(S) 2nd Reading Concurred",32,18,0,0,50
2016356,1553664,2025-04-22,Senate,"(S) 3rd Reading Concurred",30,20,0,0,50
2016370,1533848,2025-04-01,House,"(H) Fish, Wildlife and Parks--Do Pass",13,7,0,0,20
2016370,1537110,2025-04-04,House,"(H) 2nd Reading Passed",46,54,0,0,100
2016370,1537828,2025-04-05,House,"(H) 3rd Reading Passed",74,24,0,2,100
2016370,1549500,2025-04-15,Senate,"(S) Fish and Game--To Table",6,5,0,0,11
2016370,1550342,2025-04-15,Senate,"(S) Fish and Game--To Table",6,5,0,0,11
2016370,1564799,2025-04-24,Senate,"(S) Motion Failed",13,37,0,0,50
2016370,1564800,2025-04-15,Senate,"(S) Fish and Game--To Table",6,5,0,0,11
2016377,1533673,2025-04-01,House,"(H) Human Services--Do Pass As Amended",17,4,0,0,21
2016377,1536993,2025-04-03,House,"(H) Appropriations--Do Pass As Amended",14,9,0,0,23
2016377,1537572,2025-04-04,House,"(H) 2nd Reading Motion to Amend Carried",97,2,0,1,100
2016377,1537573,2025-04-04,House,"(H) 2nd Reading Passed as Amended",71,29,0,0,100
2016377,1538653,2025-04-07,House,"(H) 3rd Reading Passed",76,22,0,2,100
2016377,1548000,2025-04-14,Senate,"(S) Public Health, Welfare and Safety--Be Concurred In",11,0,0,0,11
2016377,1551543,2025-04-17,Senate,"(S) 2nd Reading Concurred",36,14,0,0,50
2016390,1533249,2025-04-01,House,"(H) Taxation--To Table",21,0,0,0,21
2016401,1549352,2025-04-15,Senate,"(S) Energy, Technology & Federal Relations--Resolution Adopted",13,0,0,0,13
2016401,1551202,2025-04-17,Senate,"(S) Resolution Adopted",49,0,0,1,50
2016408,1537337,2025-04-04,Senate,"(S) Business, Labor  and Economic Affairs--Resolution Adopted",11,0,0,0,11
2016408,1538680,2025-04-07,Senate,"(S) Resolution Adopted",50,0,0,0,50
2016419,1534963,2025-03-31,House,"(H) Appropriations--Do Pass As Amended",19,0,4,0,23
2016419,1536913,2025-04-03,House,"(H) 2nd Reading Motion to Amend Carried",71,29,0,0,100
2016419,1536914,2025-04-03,House,"(H) 2nd Reading Motion to Amend Carried",96,4,0,0,100
2016419,1536915,2025-04-03,House,"(H) 2nd Reading Passed as Amended",98,2,0,0,100
2016419,1537642,2025-04-05,House,"(H) 3rd Reading Passed",94,4,0,2,100
2016419,1552035,2025-04-18,Senate,"(S) Judiciary--Be Concurred In",8,0,0,0,8
2016419,1555452,2025-04-23,Senate,"(S) 2nd Reading Motion to Amend Carried",26,24,0,0,50
2016419,1555453,2025-04-23,Senate,"(S) 2nd Reading Concurred as Amended",31,19,0,0,50
2016419,1555454,2025-04-23,Senate,"(S) 2nd Reading Motion to Amend Carried",49,1,0,0,50
2016419,1558159,2025-04-25,Senate,"(S) 3rd Reading Concurred",33,16,0,1,50
2016419,1560057,2025-04-29,House,"(H) 2nd Reading Senate Amendments Concurred",58,42,0,0,100
2016419,1562253,2025-04-30,House,"(H) 3rd Reading Passed as Amended by Senate",91,9,0,0,100
2016438,1533738,2025-04-01,House,"(H) Taxation--To Table",21,0,0,0,21
2016456,1535132,2025-04-02,Senate,"(S) State Administration--To Table",9,0,0,0,9
2016467,1536559,2025-04-03,Senate,"(S) Business, Labor  and Economic Affairs--To Table",9,2,0,0,11
2016477,1548200,2025-04-15,Senate,"(S) Judiciary--Resolution Adopted",8,0,0,0,8
2016477,1550062,2025-04-16,Senate,"(S) Resolution Adopted",49,1,0,0,50
2016486,1532188,2025-04-01,House,"(H) Taxation--Do Pass As Amended",17,4,0,0,21
2016486,1535854,2025-04-03,House,"(H) Appropriations--To Table",20,0,3,0,23
2016499,1531111,2025-03-31,House,"(H) Energy, Technology and Federal Relations--Do Pass As Amended",8,6,0,0,14
2016499,1538179,2025-04-07,House,"(H) 2nd Reading Passed",60,40,0,0,100
2016499,1540127,2025-04-08,House,"(H) 3rd Reading Passed",61,36,0,3,100
2016499,1557192,2025-04-24,Senate,"(S) Energy, Technology & Federal Relations--To Table",11,1,1,0,13
2016499,1559999,2025-04-24,Senate,"(S) Energy, Technology & Federal Relations--To Table",11,1,1,0,13
2016509,1531635,2025-03-31,House,"(H) Education--Resolution Adopted",14,1,0,0,15
2016509,1537050,2025-04-03,House,"(H) 2nd Reading Passed",81,19,0,0,100
2016509,1537850,2025-04-05,House,"(H) 3rd Reading Passed",77,21,0,2,100
2016509,1549447,2025-04-15,Senate,"(S) Education and Cultural Resources--To Table",14,0,0,0,14
2016509,1549903,2025-04-15,Senate,"(S) Education and Cultural Resources--To Table",14,0,0,0,14
2016519,1531717,2025-03-31,House,"(H) Natural Resources--Do Pass As Amended",8,6,0,0,14
2016519,1536919,2025-04-03,House,"(H) 2nd Reading Passed",58,42,0,0,100
2016519,1537666,2025-04-05,House,"(H) 3rd Reading Passed",56,42,0,2,100
2016519,1547838,2025-04-14,Senate,"(S) Natural Resources--Resolution Adopted",7,4,0,0,11
2016519,1552211,2025-04-18,Senate,"(S) 2nd Reading Concurred",32,18,0,0,50
2016519,1553727,2025-04-22,Senate,"(S) 3rd Reading Concurred",32,18,0,0,50
2016532,1536275,2025-04-03,Senate,"(S) Agriculture, Livestock and Irrigation--Resolution Adopted",6,5,0,0,11
2016532,1537196,2025-04-04,Senate,"(S) 2nd Reading Passed",35,15,0,0,50
2016532,1537694,2025-04-05,Senate,"(S) 3rd Reading Passed",40,8,0,2,50
2016532,1549160,2025-04-15,House,"(H) Agriculture--Be Concurred In",11,6,0,0,17
2016532,1557038,2025-04-24,House,"(H) 2nd Reading Concurred",84,16,0,0,100
2016543,1536860,2025-04-03,Senate,"(S) Energy, Technology & Federal Relations--Resolution Adopted",10,0,3,0,13
2016543,1537486,2025-04-04,Senate,"(S) 2nd Reading Passed",44,5,0,1,50
2016543,1537843,2025-04-05,Senate,"(S) 3rd Reading Passed",45,3,0,2,50
2016543,1541559,2025-04-03,Senate,"(S) Energy, Technology & Federal Relations--Resolution Adopted",10,0,3,0,13
2016543,1541560,2025-04-04,Senate,"(S) 2nd Reading Passed",44,5,0,1,50
2016543,1541561,2025-04-05,Senate,"(S) 3rd Reading Passed",45,3,0,2,50
2016543,1550677,2025-04-16,House,"(H) Energy, Technology and Federal Relations--Resolution Adopted",14,0,0,0,14
2016543,1551945,2025-04-16,House,"(H) Energy, Technology and Federal Relations--Be Concurred In",14,0,0,0,14
2016543,1556981,2025-04-24,House,"(H) 2nd Reading Concurred",97,3,0,0,100
2016543,1558058,2025-04-25,House,"(H) 3rd Reading Concurred",99,1,0,0,100
2016554,1549452,2025-04-15,Senate,"(S) Energy, Technology & Federal Relations--Resolution Adopted",13,0,0,0,13
2016554,1551226,2025-04-17,Senate,"(S) Resolution Adopted",48,0,0,2,50
2016563,1539891,2025-04-08,Senate,"(S) Business, Labor  and Economic Affairs--Resolution Adopted",11,0,0,0,11
2016563,1544489,2025-04-10,Senate,"(S) Resolution Adopted",50,0,0,0,50
2016581,1533995,2025-04-01,House,"(H) Appropriations--Do Pass As Amended",22,1,0,0,23
2016581,1538430,2025-04-07,House,"(H) 2nd Reading Passed",58,42,0,0,100
2016581,1539564,2025-04-08,House,"(H) 3rd Reading Passed",64,33,0,3,100
2016581,1547718,2025-04-14,Senate,"(S) State Administration--To Table",9,0,0,0,9
2016581,1548064,2025-04-14,Senate,"(S) State Administration--To Table",9,0,0,0,9
2016583,1532258,2025-04-01,House,"(H) State Administration--Do Pass",16,3,0,0,19
2016583,1539224,2025-04-07,House,"(H) 2nd Reading Passed",57,43,0,0,100
2016583,1539540,2025-04-08,House,"(H) 3rd Reading Passed",59,38,0,3,100
2016583,1556169,2025-04-23,Senate,"(S) State Administration--Be Concurred In",9,0,0,0,9
2016583,1558285,2025-04-25,Senate,"(S) 2nd Reading Concurred",49,0,0,1,50
2016583,1559164,2025-04-28,Senate,"(S) 3rd Reading Concurred",49,0,0,1,50
2016585,1534728,2025-04-02,House,"(H) Natural Resources--To Table",11,0,3,0,14
2016585,1534729,2025-04-02,House,"(H) Taken from Committee; Placed on 2nd Reading",44,48,0,8,100
2016585,1544530,2025-04-02,House,"(H) Taken from Committee; Placed on 2nd Reading",44,48,0,8,100
2016587,1534772,2025-03-31,House,"(H) Appropriations--Do Pass",19,0,4,0,23
2016587,1536617,2025-04-03,House,"(H) 2nd Reading Passed",96,4,0,0,100
2016587,1537847,2025-04-05,House,"(H) 3rd Reading Passed",93,5,0,2,100
2016587,1551602,2025-04-16,Senate,"(S) Finance and Claims--Be Concurred In",22,0,0,0,22
2016587,1554349,2025-04-22,Senate,"(S) 2nd Reading Concurred",48,1,0,1,50
2016587,1555841,2025-04-23,Senate,"(S) 3rd Reading Concurred",48,2,0,0,50
2016589,1541493,2025-04-09,House,"(H) Business and Labor--To Table",19,1,0,0,20
2016593,1532995,2025-04-01,House,"(H) Judiciary--Do Pass",12,8,0,0,20
2016593,1537366,2025-04-04,House,"(H) 2nd Reading Passed",56,44,0,0,100
2016593,1537851,2025-04-05,House,"(H) 3rd Reading Passed",54,44,0,2,100
2016593,1549995,2025-04-16,Senate,"(S) Judiciary--Be Concurred In As Amended",5,3,0,0,8
2016593,1551473,2025-04-17,Senate,"(S) 2nd Reading Concurred",31,19,0,0,50
2016593,1552217,2025-04-18,Senate,"(S) 3rd Reading Failed; 2nd House Vote Required",32,18,0,0,50
2016593,1556510,2025-04-18,Senate,"(S) 3rd Reading Concurred",32,18,0,0,50
2016593,1557967,2025-04-25,House,"(H) 2nd Reading Senate Amendments Concurred",58,42,0,0,100
2016593,1559281,2025-04-28,House,"(H) 3rd Reading Failed; 2nd House Vote Required",56,44,0,0,100
2016594,1532228,2025-04-01,House,"(H) Taxation--Do Pass",19,2,0,0,21
2016594,1535306,2025-04-02,House,"(H) Appropriations--Do Pass",23,0,0,0,23
2016594,1537275,2025-04-04,House,"(H) 2nd Reading Passed",99,0,0,1,100
2016594,1537720,2025-04-05,House,"(H) 3rd Reading Passed",94,4,0,2,100
2016594,1549630,2025-04-16,Senate,"(S) Taxation--Be Concurred In",8,0,0,0,8
2016594,1552249,2025-04-18,Senate,"(S) 2nd Reading Concurred",43,7,0,0,50
2016594,1554094,2025-04-22,Senate,"(S) 3rd Reading Concurred",43,7,0,0,50
2016596,1532263,2025-04-01,House,"(H) Taxation--To Table",21,0,0,0,21
2016598,1540665,2025-04-08,House,"(H) State Administration--Do Pass",19,0,0,0,19
2016598,1551631,2025-04-17,House,"(H) 2nd Reading Passed",63,37,0,0,100
2016598,1552261,2025-04-18,House,"(H) 3rd Reading Passed",64,34,0,2,100
2016598,1557359,2025-04-24,Senate,"(S) Legislative Administration--To Table",5,1,0,0,6
2016598,1560473,2025-04-24,Senate,"(S) Legislative Administration--To Table",5,1,0,0,6
2016661,1536474,2025-04-03,House,"(H) Appropriations--Do Pass As Amended",13,10,0,0,23
2016661,1538381,2025-04-07,House,"(H) 2nd Reading Passed",55,45,0,0,100
2016661,1539547,2025-04-08,House,"(H) 3rd Reading Passed",53,44,0,3,100
2016661,1552337,2025-04-18,Senate,"(S) Taken from Committee; Placed on 2nd Reading",27,23,0,0,50
2016661,1554890,2025-04-22,Senate,"(S) 2nd Reading Motion to Amend Carried",26,23,0,1,50
2016661,1554891,2025-04-22,Senate,"(S) 2nd Reading Motion to Amend Failed",22,28,0,0,50
2016661,1554892,2025-04-22,Senate,"(S) 2nd Reading Motion to Amend Carried",28,22,0,0,50
2016661,1554893,2025-04-22,Senate,"(S) 2nd Reading Motion to Amend Failed",23,27,0,0,50
2016661,1554894,2025-04-22,Senate,"(S) 2nd Reading Motion to Amend Failed",25,25,0,0,50
2016661,1554895,2025-04-22,Senate,"(S) 2nd Reading Concurred as Amended",27,23,0,0,50
2016661,1557457,2025-04-24,Senate,"(S) 3rd Reading Concurred",27,23,0,0,50
2016661,1559220,2025-04-28,House,"(H) 2nd Reading Senate Amendments Concurred",63,37,0,0,100
2016661,1560196,2025-04-29,House,"(H) 3rd Reading Passed as Amended by Senate",60,39,0,1,100
2016663,1531829,2025-03-31,House,"(H) Education--To Table",15,0,0,0,15
2016666,1531763,2025-03-31,House,"(H) Natural Resources--Do Pass As Amended",14,0,0,0,14
2016666,1537574,2025-04-04,House,"(H) 2nd Reading Passed",99,0,0,1,100
2016666,1537647,2025-04-05,House,"(H) 3rd Reading Passed",98,0,0,2,100
2016666,1546485,2025-04-11,Senate,"(S) Natural Resources--Be Concurred In",11,0,0,0,11
2016666,1552010,2025-04-17,Senate,"(S) 2nd Reading Concurred",46,1,0,3,50
2016666,1552153,2025-04-18,Senate,"(S) 3rd Reading Concurred",49,1,0,0,50
2016670,1539462,2025-04-08,House,"(H) Legislative Administration--Do Pass",14,0,0,0,14
2016670,1551632,2025-04-17,House,"(H) 2nd Reading Passed",88,12,0,0,100
2016670,1552162,2025-04-18,House,"(H) 3rd Reading Passed",88,10,0,2,100
2016670,1556661,2025-04-24,Senate,"(S) Legislative Administration--Resolution Adopted",6,0,0,0,6
2016670,1558873,2025-04-28,Senate,"(S) 2nd Reading Concurred",34,14,0,2,50
2016670,1560170,2025-04-29,Senate,"(S) 3rd Reading Concurred",37,13,0,0,50
2016712,1533434,2025-04-01,House,"(H) Agriculture--To Table",17,0,0,0,17
2016750,1535880,2025-04-03,House,"(H) Judiciary--Do Pass",12,8,0,0,20
2016750,1538467,2025-04-07,House,"(H) 2nd Reading Not Passed",23,76,0,1,100
2016788,1533696,2025-04-01,House,"(H) Taxation--To Table",21,0,0,0,21
2016825,1536379,2025-04-03,House,"(H) Judiciary--Do Pass",12,8,0,0,20
2016825,1537117,2025-04-04,House,"(H) 2nd Reading Passed",57,43,0,0,100
2016825,1537664,2025-04-05,House,"(H) 3rd Reading Passed",54,44,0,2,100
2016825,1557136,2025-04-24,Senate,"(S) Energy, Technology & Federal Relations--To Table",11,1,1,0,13
2016825,1559938,2025-04-24,Senate,"(S) Energy, Technology & Federal Relations--To Table",11,1,1,0,13
2016882,1534377,2025-04-02,Senate,"(S) Taxation--To Table",7,1,0,0,8
2016906,1531814,2025-03-31,House,"(H) Natural Resources--Do Pass As Amended",14,0,0,0,14
2016906,1537105,2025-04-04,House,"(H) 2nd Reading Passed",100,0,0,0,100
2016906,1537638,2025-04-05,House,"(H) 3rd Reading Passed",98,0,0,2,100
2016906,1547956,2025-04-14,Senate,"(S) Natural Resources--Be Concurred In",11,0,0,0,11
2016906,1558331,2025-04-14,Senate,"(S) Natural Resources--Be Concurred In As Amended",11,0,0,0,11
2016906,1558332,2025-04-23,Senate,"(S) 2nd Reading Motion to Amend Carried",38,11,0,1,50
2016906,1558333,2025-04-23,Senate,"(S) 2nd Reading Concurred as Amended",46,4,0,0,50
2016906,1558334,2025-04-25,Senate,"(S) 3rd Reading Concurred",41,8,0,1,50
2016906,1559896,2025-04-29,House,"(H) 2nd Reading Senate Amendments Concurred",100,0,0,0,100
2016906,1562630,2025-04-30,House,"(H) 3rd Reading Passed as Amended by Senate",100,0,0,0,100
2016935,1533654,2025-04-01,House,"(H) Appropriations--Do Pass",16,7,0,0,23
2016935,1537228,2025-04-04,House,"(H) 2nd Reading Passed",70,30,0,0,100
2016935,1537699,2025-04-05,House,"(H) 3rd Reading Passed",71,27,0,2,100
2016935,1549195,2025-04-15,Senate,"(S) Fish and Game--Be Concurred In",11,0,0,0,11
2016935,1555307,2025-04-23,Senate,"(S) 2nd Reading Motion to Amend Carried",33,16,0,1,50
2016935,1555308,2025-04-23,Senate,"(S) 2nd Reading Motion to Amend Carried",47,3,0,0,50
2016935,1555309,2025-04-23,Senate,"(S) 2nd Reading Concurred as Amended",36,14,0,0,50
2016935,1558095,2025-04-25,Senate,"(S) 3rd Reading Concurred",38,11,0,1,50
2016935,1559931,2025-04-29,House,"(H) 2nd Reading Senate Amendments Concurred",89,11,0,0,100
2016935,1562076,2025-04-30,House,"(H) 3rd Reading Passed as Amended by Senate",88,12,0,0,100
2016958,1532328,2025-04-01,House,"(H) Business and Labor--Do Pass",17,3,0,0,20
2016958,1535333,2025-04-02,House,"(H) Appropriations--Do Pass",23,0,0,0,23
2016958,1537203,2025-04-04,House,"(H) 2nd Reading Passed",57,42,0,1,100
2016958,1537695,2025-04-05,House,"(H) 3rd Reading Passed",54,44,0,2,100
2016958,1548614,2025-04-15,Senate,"(S) Business, Labor  and Economic Affairs--To Table",11,0,0,0,11
2016958,1550236,2025-04-15,Senate,"(S) Business, Labor  and Economic Affairs--To Table",11,0,0,0,11
2016958,1586528,2025-04-01,House,"(H) Business and Labor--Do Pass",17,3,0,0,20
2016958,1586529,2025-04-02,House,"(H) Appropriations--Do Pass",23,0,0,0,23
2016958,1586530,2025-04-04,House,"(H) 2nd Reading Passed",57,42,0,1,100
2016958,1586531,2025-04-05,House,"(H) 3rd Reading Passed",54,44,0,2,100
2016981,1533756,2025-04-01,House,"(H) Fish, Wildlife and Parks--To Table",19,1,0,0,20
2016981,1536616,2025-04-03,House,"(H) Taken from Committee; Placed on 2nd Reading",43,49,0,8,100
2017003,1532235,2025-04-01,House,"(H) Business and Labor--Do Pass",12,8,0,0,20
2017003,1533394,2025-04-01,House,"(H) Appropriations--Do Pass",13,10,0,0,23
2017003,1537271,2025-04-04,House,"(H) 2nd Reading Not Passed",50,50,0,0,100
2017003,1537272,2025-04-04,House,"(H) Reconsidered Previous Action; Placed on 2nd Reading",50,49,0,1,100
2017003,1537273,2025-04-04,House,"(H) 2nd Reading Passed",55,45,0,0,100
2017003,1537719,2025-04-05,House,"(H) 3rd Reading Passed",55,43,0,2,100
2017003,1547594,2025-04-14,Senate,"(S) Natural Resources--Be Concurred In",7,4,0,0,11
2017003,1552279,2025-04-18,Senate,"(S) 2nd Reading Concurred",41,9,0,0,50
2017003,1554135,2025-04-22,Senate,"(S) 3rd Reading Concurred",33,17,0,0,50
2017027,1531767,2025-03-31,House,"(H) Transportation--Do Pass",9,5,0,0,14
2017027,1537101,2025-04-04,House,"(H) 2nd Reading Not Passed",100,0,0,0,100
2017085,1535424,2025-04-02,Senate,"(S) Natural Resources--To Table",11,0,0,0,11
2017105,1532792,2025-04-01,House,"(H) Taxation--Do Pass",14,7,0,0,21
2017105,1534941,2025-04-02,House,"(H) Appropriations--To Table",13,10,0,0,23
2017125,1531681,2025-03-31,House,"(H) Energy, Technology and Federal Relations--Do Pass",13,1,0,0,14
2017125,1537404,2025-04-04,House,"(H) 2nd Reading Passed",98,2,0,0,100
2017125,1537838,2025-04-05,House,"(H) 3rd Reading Passed",97,1,0,2,100
2017125,1548658,2025-04-15,Senate,"(S) Energy, Technology & Federal Relations--Be Concurred In As Amended",13,0,0,0,13
2017125,1551904,2025-04-17,Senate,"(S) 2nd Reading Concurred",41,8,0,1,50
2017125,1551905,2025-04-17,Senate,"(S) Reconsidered Previous Action; Placed on 2nd Reading",45,2,0,3,50
2017125,1552272,2025-04-18,Senate,"(S) 2nd Reading Motion to Amend Carried",46,4,0,0,50
2017125,1552273,2025-04-18,Senate,"(S) 2nd Reading Concurred as Amended",39,11,0,0,50
2017125,1555369,2025-04-23,Senate,"(S) 3rd Reading Concurred",38,12,0,0,50
2017125,1558153,2025-04-25,House,"(H) 2nd Reading Senate Amendments Concurred",100,0,0,0,100
2017125,1559145,2025-04-28,House,"(H) 3rd Reading Passed as Amended by Senate",98,2,0,0,100
2017146,1537423,2025-04-04,House,"(H) 2nd Reading Motion to Amend Carried",98,1,0,1,100
2017146,1537424,2025-04-04,House,"(H) 2nd Reading Passed as Amended",100,0,0,0,100
2017146,1538725,2025-04-07,House,"(H) 3rd Reading Passed",99,0,0,1,100
2017167,1550625,2025-04-16,Senate,"(S) State Administration--Resolution Adopted",9,0,0,0,9
2017167,1557340,2025-04-24,Senate,"(S) Taken from Committee; Placed on 2nd Reading",49,1,0,0,50
2017167,1558260,2025-04-25,Senate,"(S) Resolution Adopted",49,0,0,1,50
2017188,1535265,2025-04-02,Senate,"(S) Public Health, Welfare and Safety--Do Pass As Amended",7,4,0,0,11
2017188,1537543,2025-04-04,Senate,"(S) 2nd Reading Passed",34,14,0,2,50
2017188,1537628,2025-04-05,Senate,"(S) 3rd Reading Passed",27,21,0,2,50
2017188,1551991,2025-04-17,House,"(H) Human Services--To Table",14,0,7,0,21
2017188,1552121,2025-04-17,House,"(H) Human Services--To Table",14,0,7,0,21
2017188,1595564,2025-04-17,House,"(H) Human Services--To Table",15,0,6,0,21
2017206,1536955,2025-04-03,House,"(H) Human Services--Do Pass",16,5,0,0,21
2017206,1538795,2025-04-07,House,"(H) 2nd Reading Passed",70,30,0,0,100
2017206,1540757,2025-04-08,House,"(H) 3rd Reading Passed",63,34,0,3,100
2017206,1547603,2025-04-14,Senate,"(S) Public Health, Welfare and Safety--Be Concurred In",7,4,0,0,11
2017206,1551931,2025-04-17,Senate,"(S) 2nd Reading Concurred",34,16,0,0,50
2017206,1560329,2025-04-18,Senate,"(S) 3rd Reading Concurred",35,15,0,0,50
2017229,1534974,2025-04-02,Senate,"(S) State Administration--To Table",9,0,0,0,9
2017253,1547994,2025-04-14,Senate,"(S) Public Health, Welfare and Safety--Resolution Adopted",8,3,0,0,11
2017253,1549981,2025-04-16,Senate,"(S) Resolution Adopted",43,7,0,0,50
2017273,1531687,2025-03-31,House,"(H) Transportation--Do Pass",13,1,0,0,14
2017273,1538781,2025-04-07,House,"(H) 2nd Reading Passed",90,9,0,1,100
2017273,1540775,2025-04-08,House,"(H) 3rd Reading Passed",88,9,0,3,100
2017273,1550107,2025-04-16,Senate,"(S) Highways and Transportation--Be Concurred In",6,2,0,0,8
2017273,1554673,2025-04-22,Senate,"(S) 2nd Reading Concurred",38,12,0,0,50
2017273,1556312,2025-04-23,Senate,"(S) 3rd Reading Concurred",37,13,0,0,50
2017295,1534900,2025-04-02,Senate,"(S) Public Health, Welfare and Safety--Do Pass",7,4,0,0,11
2017295,1537365,2025-04-04,Senate,"(S) 2nd Reading Passed",31,17,0,2,50
2017295,1537842,2025-04-05,Senate,"(S) 3rd Reading Passed",30,18,0,2,50
2017295,1551564,2025-04-17,House,"(H) Human Services--Be Concurred In As Amended",13,8,0,0,21
2017295,1552112,2025-04-17,House,"(H) Human Services--To Table",21,0,0,0,21
2017295,1555249,2025-04-23,House,"(H) 2nd Reading Concurred",67,33,0,0,100
2017295,1557635,2025-04-24,House,"(H) 3rd Reading Concurred",72,28,0,0,100
2017295,1559421,2025-04-28,Senate,"(S) 2nd Reading House Amendments Concurred",49,0,0,1,50
2017295,1560651,2025-04-29,Senate,"(S) 3rd Reading Passed as Amended by House",50,0,0,0,50
2017315,1533682,2025-04-01,House,"(H) Appropriations--Do Pass",0,0,23,0,23
2017315,1534005,2025-04-01,House,"(H) Appropriations--Do Pass As Amended",22,1,0,0,23
2017315,1539590,2025-04-07,House,"(H) 2nd Reading Passed",96,4,0,0,100
2017315,1539591,2025-04-08,House,"(H) 3rd Reading Passed",89,8,0,3,100
2017315,1551707,2025-04-16,Senate,"(S) Finance and Claims--Be Concurred In As Amended",21,1,0,0,22
2017315,1556251,2025-04-23,Senate,"(S) 2nd Reading Motion to Amend Carried",50,0,0,0,50
2017315,1556252,2025-04-23,Senate,"(S) 2nd Reading Concurred as Amended",49,1,0,0,50
2017315,1558146,2025-04-25,Senate,"(S) 3rd Reading Concurred",45,4,0,1,50
2017315,1559836,2025-04-29,House,"(H) 2nd Reading Senate Amendments Concurred",85,13,0,2,100
2017315,1561879,2025-04-30,House,"(H) 3rd Reading Passed as Amended by Senate",90,9,0,1,100
2017338,1536737,2025-04-03,Senate,"(S) Agriculture, Livestock and Irrigation--Resolution Adopted",11,0,0,0,11
2017338,1537457,2025-04-04,Senate,"(S) 2nd Reading Passed",48,1,0,1,50
2017338,1537691,2025-04-05,Senate,"(S) 3rd Reading Passed",47,1,0,2,50
2017338,1549363,2025-04-15,House,"(H) Agriculture--Be Concurred In",17,0,0,0,17
2017338,1557184,2025-04-24,House,"(H) 2nd Reading Concurred",96,4,0,0,100
2017338,1558057,2025-04-25,House,"(H) 3rd Reading Concurred",90,10,0,0,100
2017361,1535518,2025-04-02,Senate,"(S) State Administration--Do Pass",9,0,0,0,9
2017361,1537553,2025-04-04,Senate,"(S) 2nd Reading Passed",49,0,0,1,50
2017361,1537634,2025-04-05,Senate,"(S) 3rd Reading Passed",48,0,0,2,50
2017361,1542246,2025-04-09,House,"(H) State Administration--Be Concurred In As Amended",18,0,1,0,19
2017361,1546953,2025-04-14,House,"(H) 2nd Reading Concurred",100,0,0,0,100
2017361,1549347,2025-04-15,House,"(H) 3rd Reading Concurred",97,0,0,3,100
2017361,1551553,2025-04-17,Senate,"(S) 2nd Reading House Amendments Concurred",49,0,0,1,50
2017361,1552243,2025-04-18,Senate,"(S) 3rd Reading Passed as Amended by House",50,0,0,0,50
2017381,1542812,2025-04-09,Senate,"(S) Natural Resources--Resolution Adopted",11,0,0,0,11
2017381,1545414,2025-04-11,Senate,"(S) Resolution Adopted",50,0,0,0,50
2017401,1532177,2025-04-01,House,"(H) State Administration--To Table",18,1,0,0,19
2017422,1540503,2025-04-08,Senate,"(S) Agriculture, Livestock and Irrigation--Resolution Adopted",11,0,0,0,11
2017422,1544663,2025-04-10,Senate,"(S) Resolution Adopted",50,0,0,0,50
2017445,1537095,2025-04-04,House,"(H) Business and Labor--To Table",16,0,4,0,20
2017445,1537567,2025-04-04,House,"(H) Taken from Committee; Placed on 2nd Reading",42,51,0,7,100
2017465,1533847,2025-04-01,Senate,"(S) Energy, Technology & Federal Relations--Do Pass",9,4,0,0,13
2017465,1537462,2025-04-04,Senate,"(S) 2nd Reading Motion to Amend Failed",18,32,0,0,50
2017465,1537463,2025-04-04,Senate,"(S) 2nd Reading Passed",32,18,0,0,50
2017465,1537701,2025-04-05,Senate,"(S) 3rd Reading Passed",34,14,0,2,50
2017465,1548472,2025-04-15,House,"(H) State Administration--To Table",18,1,0,0,19
2017465,1550190,2025-04-15,House,"(H) State Administration--To Table",18,1,0,0,19
2017484,1533692,2025-04-01,House,"(H) Appropriations--To Table",14,9,0,0,23
2017501,1537071,2025-04-04,House,"(H) Business and Labor--To Table",16,0,4,0,20
2017517,1536683,2025-04-03,House,"(H) Judiciary--To Table",20,0,0,0,20
2017524,1536605,2025-04-03,House,"(H) Appropriations--To Table",13,10,0,0,23
2017524,1537014,2025-04-03,House,"(H) Appropriations--To Take From The Table",15,8,0,0,23
2017524,1539352,2025-04-03,House,"(H) Appropriations--Do Pass",15,8,0,0,23
2017524,1539353,2025-04-07,House,"(H) 2nd Reading Not Passed",44,56,0,0,100
2017535,1537570,2025-04-04,House,"(H) Energy, Technology and Federal Relations--Do Pass",10,4,0,0,14
2017535,1538569,2025-04-07,House,"(H) 2nd Reading Passed",59,41,0,0,100
2017535,1539538,2025-04-08,House,"(H) 3rd Reading Passed",57,40,0,3,100
2017535,1550085,2025-04-15,Senate,"(S) Energy, Technology & Federal Relations--Be Concurred In",9,4,0,0,13
2017535,1551833,2025-04-17,Senate,"(S) 2nd Reading Concurred",34,16,0,0,50
2017535,1552287,2025-04-18,Senate,"(S) 3rd Reading Concurred",32,18,0,0,50
2017541,1536352,2025-04-03,House,"(H) Human Services--Do Pass",20,1,0,0,21
2017541,1538434,2025-04-07,House,"(H) 2nd Reading Passed",82,18,0,0,100
2017541,1539527,2025-04-08,House,"(H) 3rd Reading Passed",76,21,0,3,100
2017541,1547995,2025-04-14,Senate,"(S) Public Health, Welfare and Safety--Be Concurred In",8,3,0,0,11
2017541,1552006,2025-04-17,Senate,"(S) 2nd Reading Concurred",37,11,0,2,50
2017541,1552347,2025-04-18,Senate,"(S) 3rd Reading Concurred",33,17,0,0,50
2017546,1535393,2025-04-02,Senate,"(S) Public Health, Welfare and Safety--To Table",11,0,0,0,11
2017555,1535784,2025-04-03,House,"(H) Business and Labor--Do Pass",12,8,0,0,20
2017555,1537004,2025-04-03,House,"(H) Appropriations--Do Pass",17,6,0,0,23
2017555,1537380,2025-04-04,House,"(H) 2nd Reading Not Passed",42,58,0,0,100
2017563,1535136,2025-04-02,Senate,"(S) Public Health, Welfare and Safety--To Table",11,0,0,0,11
2017563,1536596,2025-04-03,Senate,"(S) Taken from Committee; Placed on 2nd Reading",28,21,0,1,50
2017563,1537379,2025-04-04,Senate,"(S) 2nd Reading Passed",30,20,0,0,50
2017563,1537627,2025-04-05,Senate,"(S) Finance and Claims--Do Pass",12,10,0,0,22
2017563,1537758,2025-04-05,Senate,"(S) 3rd Reading Passed",26,20,0,4,50
2017563,1553795,2025-04-17,House,"(H) Human Services--To Table",9,7,5,0,21
2017563,1555387,2025-04-17,House,"(H) Human Services--To Table",9,7,5,0,21
2017563,1579832,2025-04-17,House,"(H) Human Services--To Table",8,7,6,0,21
2017570,1534815,2025-04-02,House,"(H) Taxation--To Table",19,2,0,0,21
2017575,1536614,2025-04-03,House,"(H) Business and Labor--Do Pass",20,0,0,0,20
2017575,1538549,2025-04-07,House,"(H) 2nd Reading Passed",81,19,0,0,100
2017575,1539567,2025-04-08,House,"(H) 3rd Reading Passed",72,25,0,3,100
2017575,1548704,2025-04-15,Senate,"(S) Business, Labor  and Economic Affairs--Be Concurred In",11,0,0,0,11
2017575,1551495,2025-04-17,Senate,"(S) 2nd Reading Concurred",27,23,0,0,50
2017581,1551660,2025-04-17,House,"(H) Judiciary--To Table",12,8,0,0,20
2017625,1536533,2025-04-03,House,"(H) Human Services--Do Pass As Amended",18,3,0,0,21
2017625,1538703,2025-04-07,House,"(H) 2nd Reading Passed",78,22,0,0,100
2017625,1539751,2025-04-08,House,"(H) 3rd Reading Passed",73,24,0,3,100
2017625,1550200,2025-04-16,Senate,"(S) Public Health, Welfare and Safety--Be Concurred In",5,6,0,0,11
2017625,1550922,2025-04-16,Senate,"(S) Public Health, Welfare and Safety--To Table",11,0,0,0,11
2017625,1552090,2025-04-16,Senate,"(S) Public Health, Welfare and Safety--To Table",11,0,0,0,11
2017625,1555285,2025-04-23,Senate,"(S) 2nd Reading Concurred",31,19,0,0,50
2017625,1557130,2025-04-24,Senate,"(S) 3rd Reading Concurred",28,22,0,0,50
2017954,1539342,2025-04-08,House,"(H) State Administration--Do Pass As Amended",18,1,0,0,19
2017954,1553734,2025-04-22,House,"(H) 2nd Reading Passed",76,23,0,1,100
2017954,1556315,2025-04-23,House,"(H) 3rd Reading Passed",70,29,0,1,100
2017954,1558018,2025-04-25,Senate,"(S) State Administration--Resolution Adopted",6,3,0,0,9
2017954,1560803,2025-04-29,Senate,"(S) 2nd Reading Concurred",29,21,0,0,50
2017954,1563222,2025-04-30,Senate,"(S) 3rd Reading Concurred",27,23,0,0,50
2018875,1551841,2025-04-17,House,"(H) Human Services--Resolution Adopted As Amended",20,1,0,0,21
2018875,1555663,2025-04-23,House,"(H) 2nd Reading Passed",63,36,0,1,100
2018875,1556968,2025-04-24,House,"(H) 3rd Reading Passed",58,42,0,0,100
2018875,1559354,2025-04-28,Senate,"(S) Public Health, Welfare and Safety--Resolution Adopted",7,4,0,0,11
2019237,1547941,2025-04-14,House,"(H) Natural Resources--Do Pass As Amended",13,1,0,0,14
2019237,1554850,2025-04-22,House,"(H) 2nd Reading Passed",94,6,0,0,100
2019237,1556234,2025-04-23,House,"(H) 3rd Reading Passed",88,11,0,1,100
2019237,1559586,2025-04-28,Senate,"(S) Natural Resources--Resolution Adopted",6,3,2,0,11
2019237,1561199,2025-04-29,Senate,"(S) 2nd Reading Concurred",41,9,0,0,50
2019237,1563223,2025-04-30,Senate,"(S) 3rd Reading Concurred",40,9,0,1,50
2019381,1541413,2025-04-09,Senate,"(S) Legislative Administration--Resolution Adopted",6,0,0,0,6
2019381,1552102,2025-04-18,Senate,"(S) 2nd Reading Passed",40,8,0,2,50
2019381,1553791,2025-04-22,Senate,"(S) 3rd Reading Passed",41,9,0,0,50
2019381,1557636,2025-04-24,House,"(H) Legislative Administration--Resolution Adopted",10,0,4,0,14
2019381,1559336,2025-04-28,House,"(H) 2nd Reading Concurred",66,34,0,0,100
2019381,1560989,2025-04-29,House,"(H) 3rd Reading Concurred",61,38,0,1,100
2020295,1548249,2025-04-15,House,"(H) Judiciary--Resolution Adopted",20,0,0,0,20
2020295,1551229,2025-04-17,House,"(H) 2nd Reading Passed",94,5,0,1,100
2020295,1552288,2025-04-18,House,"(H) 3rd Reading Passed",95,3,0,2,100
2020295,1556751,2025-04-24,Senate,"(S) Judiciary--Resolution Adopted",5,3,0,0,8
2020295,1559211,2025-04-28,Senate,"(S) 2nd Reading Concurred",36,14,0,0,50
2020295,1560134,2025-04-29,Senate,"(S) 3rd Reading Concurred",31,19,0,0,50
2020412,1543048,2025-04-09,House,"(H) Energy, Technology and Federal Relations--Do Pass",14,0,0,0,14
2020412,1549306,2025-04-15,House,"(H) 2nd Reading Passed",93,7,0,0,100
2020412,1550602,2025-04-16,House,"(H) 3rd Reading Passed",91,7,0,2,100
2020412,1557290,2025-04-24,Senate,"(S) Energy, Technology & Federal Relations--To Table",13,0,0,0,13
2020412,1560916,2025-04-24,Senate,"(S) Energy, Technology & Federal Relations--To Table",13,0,0,0,13
2021039,1547756,2025-04-14,Senate,"(S) Public Health, Welfare and Safety--Resolution Adopted",11,0,0,0,11
2021039,1550144,2025-04-16,Senate,"(S) Resolution Adopted",49,0,0,1,50
2021102,1549457,2025-04-15,House,"(H) Local Government--Resolution Adopted",17,0,0,0,17
2021102,1553726,2025-04-22,House,"(H) 2nd Reading Passed",89,10,0,1,100
2021102,1555621,2025-04-23,House,"(H) 3rd Reading Passed",91,8,0,1,100
2021102,1559261,2025-04-28,Senate,"(S) Local Government--Be Concurred In",10,0,0,0,10
2021102,1560828,2025-04-29,Senate,"(S) 2nd Reading Concurred",32,17,0,1,50
2021102,1562687,2025-04-30,Senate,"(S) 3rd Reading Concurred",33,16,0,1,50
2021167,1548216,2025-04-15,Senate,"(S) Business, Labor  and Economic Affairs--Resolution Adopted",11,0,0,0,11
2021167,1550061,2025-04-16,Senate,"(S) Resolution Adopted",49,0,0,1,50
2021240,1547976,2025-04-14,Senate,"(S) Public Health, Welfare and Safety--Resolution Adopted",11,0,0,0,11
2021240,1552145,2025-04-18,Senate,"(S) 2nd Reading Passed",47,3,0,0,50
2021240,1554196,2025-04-22,Senate,"(S) 3rd Reading Passed",49,1,0,0,50
2021240,1555667,2025-04-23,House,"(H) Human Services--Resolution Adopted",21,0,0,0,21
2021240,1558199,2025-04-25,House,"(H) 2nd Reading Concurred",61,39,0,0,100
2021240,1558775,2025-04-28,House,"(H) 3rd Reading Concurred",60,40,0,0,100
2021413,1548393,2025-04-15,House,"(H) State Administration--Resolution Adopted",19,0,0,0,19
2021413,1551225,2025-04-17,House,"(H) 2nd Reading Passed",85,15,0,0,100
2021413,1552058,2025-04-18,House,"(H) 3rd Reading Passed",86,12,0,2,100
2021413,1558232,2025-04-25,Senate,"(S) State Administration--Resolution Adopted",9,0,0,0,9
2021413,1560613,2025-04-29,Senate,"(S) 2nd Reading Concurred",31,19,0,0,50
2021413,1563232,2025-04-30,Senate,"(S) 3rd Reading Concurred",28,22,0,0,50
2021514,1550811,2025-04-16,Senate,"(S) Public Health, Welfare and Safety--Resolution Adopted As Amended",7,4,0,0,11
2021514,1554978,2025-04-23,Senate,"(S) 2nd Reading Passed",32,17,0,1,50
2021514,1557388,2025-04-24,Senate,"(S) 3rd Reading Passed",32,18,0,0,50
2021514,1559361,2025-04-28,House,"(H) Human Services--To Table",14,0,7,0,21
2021610,1547982,2025-04-14,House,"(H) Transportation--Do Pass",9,5,0,0,14
2021610,1554087,2025-04-22,House,"(H) 2nd Reading Passed",63,37,0,0,100
2021610,1556332,2025-04-23,House,"(H) 3rd Reading Passed",57,42,0,1,100
2021610,1559286,2025-04-28,Senate,"(S) Highways and Transportation--Be Concurred In",3,5,0,0,8
2021957,1551170,2025-04-17,House,"(H) Judiciary--Do Pass",12,8,0,0,20
2021957,1551171,2025-04-17,House,"(H) Judiciary--Resolution Adopted",12,8,0,0,20
2022092,1551529,2025-04-17,House,"(H) Local Government--Resolution Adopted",16,1,0,0,17
2022092,1555244,2025-04-23,House,"(H) 2nd Reading Passed",72,28,0,0,100
2022092,1557718,2025-04-24,House,"(H) 3rd Reading Passed",71,29,0,0,100
2022092,1559277,2025-04-28,Senate,"(S) Local Government--Be Concurred In",10,0,0,0,10
2022092,1560844,2025-04-29,Senate,"(S) 2nd Reading Concurred",27,21,0,2,50
2022092,1562683,2025-04-30,Senate,"(S) 3rd Reading Concurred",31,19,0,0,50
2022190,1549997,2025-04-16,House,"(H) Education--Do Pass",15,0,0,0,15
2022190,1553584,2025-04-22,House,"(H) 2nd Reading Passed",73,26,0,1,100
2022190,1555598,2025-04-23,House,"(H) 3rd Reading Passed",66,33,0,1,100
2022190,1559613,2025-04-28,Senate,"(S) Education and Cultural Resources--Be Concurred In",13,1,0,0,14
2022190,1560353,2025-04-29,Senate,"(S) 2nd Reading Concurred",27,22,0,1,50
2022190,1563240,2025-04-30,Senate,"(S) 3rd Reading Failed",25,25,0,0,50
2022280,1551992,2025-04-17,House,"(H) Agriculture--Do Pass",17,0,0,0,17
2022280,1555652,2025-04-23,House,"(H) 2nd Reading Passed",77,21,0,2,100
2022280,1557349,2025-04-24,House,"(H) 3rd Reading Passed",83,17,0,0,100
2022280,1559267,2025-04-28,Senate,"(S) Agriculture, Livestock and Irrigation--Be Concurred In",11,0,0,0,11
2022280,1560291,2025-04-29,Senate,"(S) 2nd Reading Concurred",35,15,0,0,50
2022280,1563238,2025-04-30,Senate,"(S) 3rd Reading Concurred",36,14,0,0,50
2022647,1550847,2025-04-16,Senate,"(S) Public Health, Welfare and Safety--Resolution Adopted",11,0,0,0,11
2022647,1555424,2025-04-23,Senate,"(S) 2nd Reading Passed",37,11,0,2,50
2022647,1557542,2025-04-24,Senate,"(S) 3rd Reading Passed",36,14,0,0,50
2022647,1558788,2025-04-28,House,"(H) Human Services--To Table",14,0,7,0,21
2022789,1550620,2025-04-16,Senate,"(S) Public Health, Welfare and Safety--Resolution Adopted",7,4,0,0,11
2022789,1555483,2025-04-23,Senate,"(S) 2nd Reading Passed",37,11,0,2,50
2022789,1557839,2025-04-24,Senate,"(S) 3rd Reading Passed",31,19,0,0,50
2022789,1559119,2025-04-28,House,"(H) Human Services--To Table",14,0,7,0,21
2023117,1550245,2025-04-16,Senate,"(S) Public Health, Welfare and Safety--Resolution Adopted",7,4,0,0,11
2023117,1555492,2025-04-23,Senate,"(S) 2nd Reading Passed",30,18,0,2,50
2023117,1557182,2025-04-24,Senate,"(S) 3rd Reading Passed",26,24,0,0,50
2023117,1559256,2025-04-28,House,"(H) Human Services--Resolution Adopted",11,10,0,0,21
2023117,1560284,2025-04-29,House,"(H) 2nd Reading Not Concurred",33,67,0,0,100
2023202,1549872,2025-04-16,Senate,"(S) Business, Labor  and Economic Affairs--Resolution Adopted",10,1,0,0,11
2023202,1552160,2025-04-18,Senate,"(S) 2nd Reading Passed",47,0,0,3,50
2023202,1553738,2025-04-22,Senate,"(S) 3rd Reading Passed",50,0,0,0,50
2023202,1556837,2025-04-24,House,"(H) Business and Labor--Be Concurred In",20,0,0,0,20
2023202,1558847,2025-04-28,House,"(H) 2nd Reading Concurred",99,1,0,0,100
2023202,1560295,2025-04-29,House,"(H) 3rd Reading Concurred",99,0,0,1,100
2023284,1551022,2025-04-17,House,"(H) Judiciary--Do Pass",14,6,0,0,20
2023284,1551023,2025-04-17,House,"(H) Judiciary--Resolution Adopted",14,6,0,0,20
2023284,1552076,2025-04-18,House,"(H) Resolution Adopted",84,15,0,1,100
2023410,1550825,2025-04-16,Senate,"(S) Public Health, Welfare and Safety--Resolution Adopted",11,0,0,0,11
2023410,1555237,2025-04-23,Senate,"(S) 2nd Reading Passed",39,9,0,2,50
2023410,1557688,2025-04-24,Senate,"(S) 3rd Reading Passed",35,14,0,1,50
2023410,1559255,2025-04-28,House,"(H) Human Services--Resolution Adopted",21,0,0,0,21
2023410,1560298,2025-04-29,House,"(H) 2nd Reading Concurred",80,19,0,1,100
2023410,1561804,2025-04-30,House,"(H) 3rd Reading Concurred",82,18,0,0,100
2023523,1552259,2025-04-18,Senate,"(S) State Administration--Resolution Adopted",9,0,0,0,9
2023523,1557634,2025-04-24,Senate,"(S) 2nd Reading Passed",35,15,0,0,50
2023523,1557997,2025-04-25,Senate,"(S) 3rd Reading Passed",31,18,0,1,50
2023523,1559952,2025-04-29,House,"(H) State Administration--Be Concurred In",19,0,0,0,19
2023523,1561677,2025-04-30,House,"(H) 2nd Reading Concurred",81,18,0,1,100
2023523,1562741,2025-04-30,House,"(H) 3rd Reading Concurred",60,39,0,1,100
2023527,1549477,2025-04-15,Senate,"(S) Education and Cultural Resources--Do Pass",10,4,0,0,14
2023527,1551567,2025-04-17,Senate,"(S) Resolution Adopted",44,6,0,0,50
2023540,1550120,2025-04-16,House,"(H) Education--Do Pass",15,0,0,0,15
2023540,1554856,2025-04-22,House,"(H) 2nd Reading Passed",94,6,0,0,100
2023540,1556329,2025-04-23,House,"(H) 3rd Reading Passed",93,6,0,1,100
2023540,1558000,2025-04-25,Senate,"(S) Judiciary--Resolution Adopted",5,3,0,0,8
2023540,1559574,2025-04-28,Senate,"(S) 2nd Reading Concurred",30,20,0,0,50
2023540,1560993,2025-04-29,Senate,"(S) 3rd Reading Concurred",29,21,0,0,50
2023561,1551110,2025-04-17,House,"(H) Judiciary--Do Pass",15,5,0,0,20
2023561,1554389,2025-04-22,House,"(H) 2nd Reading Passed",78,22,0,0,100
2023561,1556334,2025-04-23,House,"(H) 3rd Reading Passed",73,26,0,1,100
2023561,1557934,2025-04-25,Senate,"(S) Business, Labor  and Economic Affairs--Be Concurred In",11,0,0,0,11
2023561,1560615,2025-04-29,Senate,"(S) 2nd Reading Motion to Amend Failed",24,26,0,0,50
2023561,1560616,2025-04-29,Senate,"(S) 2nd Reading Concurred",37,13,0,0,50
2023561,1563237,2025-04-30,Senate,"(S) 3rd Reading Concurred",34,16,0,0,50
2023562,1550480,2025-04-16,House,"(H) Energy, Technology and Federal Relations--Do Pass",8,6,0,0,14
2023562,1554344,2025-04-22,House,"(H) 2nd Reading Passed",60,39,0,1,100
2023562,1555827,2025-04-23,House,"(H) 3rd Reading Passed",56,43,0,1,100
2023562,1557881,2025-04-24,Senate,"(S) Energy, Technology & Federal Relations--Resolution Adopted",11,2,0,0,13
2023562,1559579,2025-04-28,Senate,"(S) 2nd Reading Indefinitely Postponed",21,27,0,2,50
2023563,1550881,2025-04-16,Senate,"(S) Public Health, Welfare and Safety--Resolution Adopted",11,0,0,0,11
2023563,1555231,2025-04-23,Senate,"(S) 2nd Reading Passed",38,10,0,2,50
2023563,1557849,2025-04-24,Senate,"(S) 3rd Reading Passed",38,11,0,1,50
2023563,1559014,2025-04-28,House,"(H) Human Services--Resolution Adopted",18,3,0,0,21
2023563,1560283,2025-04-29,House,"(H) 2nd Reading Concurred",80,19,0,1,100
2023563,1561789,2025-04-30,House,"(H) 3rd Reading Concurred",78,22,0,0,100
2023571,1552127,2025-04-18,Senate,"(S) Judiciary--Resolution Adopted",8,0,0,0,8
2023571,1555036,2025-04-23,Senate,"(S) Resolution Adopted",45,5,0,0,50
2023583,1552097,2025-04-18,Senate,"(S) Judiciary--Resolution Adopted",8,0,0,0,8
2023583,1555396,2025-04-23,Senate,"(S) Resolution Adopted",50,0,0,0,50
2023599,1551230,2025-04-17,House,"(H) Judiciary--Do Pass",20,0,0,0,20
2023599,1554775,2025-04-22,House,"(H) 2nd Reading Passed",96,4,0,0,100
2023599,1556327,2025-04-23,House,"(H) 3rd Reading Passed",96,3,0,1,100
2023599,1558001,2025-04-25,Senate,"(S) Judiciary--Resolution Adopted",8,0,0,0,8
2023599,1559347,2025-04-28,Senate,"(S) 2nd Reading Concurred",35,13,0,2,50
2023599,1560981,2025-04-29,Senate,"(S) 3rd Reading Concurred",33,17,0,0,50
2023664,1556762,2025-04-24,Senate,"(S) Judiciary--Resolution Adopted",5,3,0,0,8
2023664,1558112,2025-04-25,Senate,"(S) 2nd Reading Passed",30,17,0,3,50
2023664,1559565,2025-04-28,Senate,"(S) 3rd Reading Passed",29,20,0,1,50
2023664,1559872,2025-04-29,House,"(H) Judiciary--To Table",18,0,2,0,20
2023708,1550020,2025-04-16,House,"(H) Energy, Technology and Federal Relations--Do Pass",14,0,0,0,14
2023708,1555460,2025-04-23,House,"(H) 2nd Reading Passed",89,11,0,0,100
2023708,1557311,2025-04-24,House,"(H) 3rd Reading Passed",92,8,0,0,100
2023754,1552050,2025-04-18,Senate,"(S) Taxation--Do Pass As Amended",7,0,1,0,8
2023754,1555227,2025-04-23,Senate,"(S) 2nd Reading Passed",32,16,0,2,50
2023754,1557673,2025-04-24,Senate,"(S) 3rd Reading Passed",31,18,0,1,50
2023785,1550772,2025-04-16,House,"(H) Education--Do Pass",15,0,0,0,15
2023785,1556311,2025-04-23,House,"(H) 2nd Reading Passed",59,41,0,0,100
2023785,1557187,2025-04-24,House,"(H) 3rd Reading Passed",59,41,0,0,100
2023785,1559177,2025-04-28,Senate,"(S) Education and Cultural Resources--Be Concurred In",13,1,0,0,14
2023785,1560714,2025-04-29,Senate,"(S) 2nd Reading Indefinitely Postponed",36,14,0,0,50
2023785,1560715,2025-04-29,Senate,"(S) 2nd Reading Pass Motion Failed",22,27,0,1,50
2023813,1550715,2025-04-16,House,"(H) Education--Do Pass",15,0,0,0,15
2023813,1555822,2025-04-23,House,"(H) 2nd Reading Passed",54,45,0,1,100
2023813,1557277,2025-04-24,House,"(H) 3rd Reading Passed",52,48,0,0,100
2023813,1559018,2025-04-28,Senate,"(S) Education and Cultural Resources--Be Concurred In",12,2,0,0,14
2023813,1560452,2025-04-29,Senate,"(S) 2nd Reading Pass Motion Failed",24,24,0,2,50
2023813,1560453,2025-04-29,Senate,"(S) 2nd Reading Indefinitely Postponed",31,18,0,1,50
2023836,1556269,2025-04-23,Senate,"(S) State Administration--Do Pass",9,0,0,0,9
2023836,1559235,2025-04-28,Senate,"(S) 2nd Reading Passed",43,7,0,0,50
2023836,1560787,2025-04-29,Senate,"(S) 3rd Reading Passed",43,7,0,0,50
2023865,1550869,2025-04-16,Senate,"(S) Public Health, Welfare and Safety--Resolution Adopted",7,4,0,0,11
2023865,1555654,2025-04-23,Senate,"(S) 2nd Reading Passed",27,23,0,0,50
2023865,1557381,2025-04-24,Senate,"(S) 3rd Reading Failed",20,30,0,0,50
2023912,1555322,2025-04-23,Senate,"(S) Natural Resources--Resolution Adopted",10,1,0,0,11
2023912,1558033,2025-04-25,Senate,"(S) 2nd Reading Passed",47,3,0,0,50
2023912,1559568,2025-04-28,Senate,"(S) 3rd Reading Passed",43,6,0,1,50
2023912,1559883,2025-04-29,House,"(H) Judiciary--Be Concurred In",16,2,2,0,20
2023912,1562606,2025-04-30,House,"(H) 2nd Reading Concurred",90,10,0,0,100
2023912,1562607,2025-04-30,House,"(H) 3rd Reading Concurred",89,10,0,1,100
2023975,1551070,2025-04-17,House,"(H) Business and Labor--Do Pass As Amended",20,0,0,0,20
2023975,1555382,2025-04-23,House,"(H) 2nd Reading Passed",81,18,0,1,100
2023975,1557243,2025-04-24,House,"(H) 3rd Reading Passed",84,16,0,0,100
2023975,1559160,2025-04-28,Senate,"(S) Business, Labor  and Economic Affairs--Be Concurred In",9,2,0,0,11
2023975,1560065,2025-04-29,Senate,"(S) 2nd Reading Concurred",34,15,0,1,50
2023975,1562182,2025-04-30,Senate,"(S) 3rd Reading Failed",24,26,0,0,50
2024011,1556525,2025-04-24,Senate,"(S) Judiciary--Resolution Adopted",7,0,1,0,8
2024011,1559524,2025-04-28,Senate,"(S) 2nd Reading Passed",41,8,0,1,50
2024011,1561003,2025-04-29,Senate,"(S) 3rd Reading Passed",41,9,0,0,50
2024049,1554354,2025-04-22,House,"(H) Business and Labor--Do Pass",20,0,0,0,20
2024049,1557175,2025-04-24,House,"(H) 2nd Reading Passed",85,15,0,0,100
2024049,1558103,2025-04-25,House,"(H) 3rd Reading Passed",78,22,0,0,100
2024049,1559118,2025-04-28,Senate,"(S) Business, Labor  and Economic Affairs--Be Concurred In",10,1,0,0,11
2024049,1559973,2025-04-29,Senate,"(S) 2nd Reading Concurred",42,7,0,1,50
2024049,1562176,2025-04-30,Senate,"(S) 3rd Reading Concurred",38,12,0,0,50
2024096,1551609,2025-04-17,House,"(H) Fish, Wildlife and Parks--Resolution Adopted As Amended",19,1,0,0,20
2024096,1557348,2025-04-24,House,"(H) Resolution Adopted",90,10,0,0,100
2024178,1551661,2025-04-17,House,"(H) State Administration--Resolution Adopted",13,6,0,0,19
2024178,1556952,2025-04-24,House,"(H) Resolution Failed",43,57,0,0,100
2024207,1550327,2025-04-16,House,"(H) Natural Resources--Do Pass",10,4,0,0,14
2024207,1555509,2025-04-23,House,"(H) 2nd Reading Passed",67,33,0,0,100
2024207,1557212,2025-04-24,House,"(H) 3rd Reading Passed",66,34,0,0,100
2024207,1559569,2025-04-28,Senate,"(S) Natural Resources--Resolution Adopted",6,3,2,0,11
2024207,1561353,2025-04-29,Senate,"(S) 2nd Reading Concurred",28,22,0,0,50
2024207,1562189,2025-04-30,Senate,"(S) 3rd Reading Concurred",34,16,0,0,50
2024444,1552041,2025-04-18,Senate,"(S) Taxation--Do Pass",6,0,2,0,8
2024444,1555643,2025-04-23,Senate,"(S) 2nd Reading Passed",46,4,0,0,50
2024444,1557278,2025-04-24,Senate,"(S) 3rd Reading Passed",46,3,0,1,50
2024536,1556364,2025-04-23,Senate,"(S) State Administration--Do Pass",6,3,0,0,9
2024536,1559154,2025-04-28,Senate,"(S) 2nd Reading Pass Motion Failed",23,27,0,0,50
2024536,1559155,2025-04-28,Senate,"(S) 2nd Reading Indefinitely Postponed",32,18,0,0,50
2024633,1555631,2025-04-23,House,"(H) Education--Do Pass",15,0,0,0,15
2024633,1558160,2025-04-25,House,"(H) 2nd Reading Passed",78,22,0,0,100
2024633,1558781,2025-04-28,House,"(H) 3rd Reading Passed",70,30,0,0,100
2024633,1559555,2025-04-28,Senate,"(S) Education and Cultural Resources--Be Concurred In",12,2,0,0,14
2024633,1561005,2025-04-29,Senate,"(S) 2nd Reading Pass Motion Failed",21,28,0,1,50
2024633,1561006,2025-04-29,Senate,"(S) 2nd Reading Indefinitely Postponed",33,15,0,2,50
2024639,1553413,2025-04-22,Senate,"(S) Agriculture, Livestock and Irrigation--Resolution Adopted",10,0,0,0,10
2024639,1556681,2025-04-24,Senate,"(S) 2nd Reading Passed",32,18,0,0,50
2024639,1558318,2025-04-25,Senate,"(S) 3rd Reading Passed",26,23,0,1,50
2024639,1560269,2025-04-29,House,"(H) Business and Labor--Be Concurred In",11,9,0,0,20
2024639,1562205,2025-04-30,House,"(H) 2nd Reading Not Concurred",49,51,0,0,100
2024694,1556342,2025-04-23,Senate,"(S) Local Government--Do Pass",10,0,0,0,10
2024694,1559173,2025-04-28,Senate,"(S) 2nd Reading Passed",45,5,0,0,50
2024694,1560687,2025-04-29,Senate,"(S) 3rd Reading Passed",43,7,0,0,50
2024822,1555354,2025-04-23,Senate,"(S) Natural Resources--Resolution Adopted",10,1,0,0,11
2024822,1558053,2025-04-25,Senate,"(S) Resolution Adopted",49,0,0,1,50
2025032,1554936,2025-04-22,House,"(H) Appropriations--Do Pass",22,0,1,0,23
2025032,1555373,2025-04-23,House,"(H) 2nd Reading Passed",98,2,0,0,100
2025032,1555374,2025-04-23,House,"(H) 3rd Reading Passed",94,5,0,1,100
2025032,1557713,2025-04-24,Senate,"(S) Energy, Technology & Federal Relations--Be Concurred In",12,0,1,0,13
2025032,1559334,2025-04-28,Senate,"(S) 2nd Reading Concurred",49,1,0,0,50
2025032,1560979,2025-04-29,Senate,"(S) 3rd Reading Concurred",46,4,0,0,50
2025046,1555464,2025-04-23,Senate,"(S) Public Health, Welfare and Safety--Resolution Adopted",8,3,0,0,11
2025046,1557983,2025-04-25,Senate,"(S) 2nd Reading Passed",41,8,0,1,50
2025046,1559559,2025-04-28,Senate,"(S) 3rd Reading Passed",41,8,0,1,50
2025046,1559847,2025-04-29,House,"(H) Judiciary--Be Concurred In",18,0,2,0,20
2025046,1562236,2025-04-30,House,"(H) 2nd Reading Concurred",63,37,0,0,100
2025046,1562237,2025-04-30,House,"(H) 3rd Reading Concurred",68,30,0,2,100
2025057,1555412,2025-04-23,Senate,"(S) Public Health, Welfare and Safety--Resolution Adopted",8,3,0,0,11
2025057,1558049,2025-04-25,Senate,"(S) 2nd Reading Passed",42,4,0,4,50
2025057,1559610,2025-04-28,Senate,"(S) 3rd Reading Passed",42,7,0,1,50
2025057,1560238,2025-04-29,House,"(H) Judiciary--Be Concurred In",15,3,2,0,20
2025057,1562187,2025-04-30,House,"(H) 2nd Reading Concurred",73,26,0,1,100
2025057,1562188,2025-04-30,House,"(H) 3rd Reading Concurred",73,26,0,1,100
2025068,1553315,2025-04-22,House,"(H) State Administration--To Table",19,0,0,0,19
2025079,1553645,2025-04-22,House,"(H) Judiciary--Do Pass",20,0,0,0,20
2025079,1557044,2025-04-24,House,"(H) 2nd Reading Passed",91,7,0,2,100
2025079,1558066,2025-04-25,House,"(H) 3rd Reading Passed",87,13,0,0,100
2025079,1559526,2025-04-28,Senate,"(S) Judiciary--Resolution Adopted",5,3,0,0,8
2025079,1561001,2025-04-29,Senate,"(S) 2nd Reading Concurred",27,22,0,1,50
2025079,1562992,2025-04-30,Senate,"(S) 3rd Reading Failed",24,26,0,0,50
2025090,1555637,2025-04-23,House,"(H) Education--Do Pass",11,4,0,0,15
2025090,1558182,2025-04-25,House,"(H) 2nd Reading Not Passed",50,50,0,0,100
2025098,1553652,2025-04-22,House,"(H) Human Services--Resolution Adopted",21,0,0,0,21
2025098,1557733,2025-04-24,House,"(H) 2nd Reading Passed",53,47,0,0,100
2025098,1558059,2025-04-25,House,"(H) 3rd Reading Passed",58,42,0,0,100
2025098,1559597,2025-04-28,Senate,"(S) Public Health, Welfare and Safety--To Table",11,0,0,0,11
2025098,1583132,2025-04-28,Senate,"(S) Public Health, Welfare and Safety--To Table",11,0,0,0,11
2025099,1556220,2025-04-23,House,"(H) Transportation--Do Pass",11,3,0,0,14
2025099,1559575,2025-04-28,House,"(H) 2nd Reading Passed",53,47,0,0,100
2025099,1560982,2025-04-29,House,"(H) 3rd Reading Passed",53,46,0,1,100
2025116,1556354,2025-04-23,House,"(H) Natural Resources--Resolution Adopted",14,0,0,0,14
2025116,1558021,2025-04-25,House,"(H) 2nd Reading Passed",57,43,0,0,100
2025116,1559327,2025-04-28,House,"(H) 3rd Reading Passed",54,45,0,1,100
2025116,1559328,2025-04-28,Senate,"(S) Natural Resources--Resolution Adopted",5,4,2,0,11
2025116,1560972,2025-04-29,Senate,"(S) 2nd Reading Indefinitely Postponed",33,17,0,0,50
2025116,1560973,2025-04-29,Senate,"(S) 2nd Reading Pass Motion Failed",25,25,0,0,50
2025124,1555034,2025-04-23,House,"(H) State Administration--Do Pass",19,0,0,0,19
2025124,1558863,2025-04-28,House,"(H) 2nd Reading Passed",57,43,0,0,100
2025124,1560992,2025-04-29,House,"(H) 3rd Reading Passed",58,41,0,1,100
2025132,1555834,2025-04-23,House,"(H) Business and Labor--To Table",11,9,0,0,20
2025132,1557296,2025-04-24,House,"(H) Business and Labor--Do Pass As Amended",11,9,0,0,20
2025132,1559181,2025-04-28,House,"(H) 2nd Reading Not Passed",13,87,0,0,100
2025600,1557387,2025-04-24,House,"(H) Fish, Wildlife and Parks--Resolution Adopted",17,3,0,0,20
2025600,1558960,2025-04-28,House,"(H) 2nd Reading Passed",53,47,0,0,100
2025600,1560338,2025-04-29,House,"(H) 3rd Reading Passed",59,40,0,1,100
2025678,1556503,2025-04-24,House,"(H) Judiciary--Do Pass",19,1,0,0,20
2025678,1559056,2025-04-28,House,"(H) 2nd Reading Passed",89,11,0,0,100
2025678,1559910,2025-04-29,House,"(H) 3rd Reading Passed",81,18,0,1,100
2025684,1556339,2025-04-23,Senate,"(S) Public Health, Welfare and Safety--To Table",11,0,0,0,11
2025684,1557737,2025-04-24,Senate,"(S) Motion Failed",20,30,0,0,50
2025775,1556324,2025-04-23,House,"(H) Natural Resources--Resolution Adopted",14,0,0,0,14
2025775,1558300,2025-04-25,House,"(H) 2nd Reading Passed",65,35,0,0,100
2025775,1558777,2025-04-28,House,"(H) 3rd Reading Passed",63,37,0,0,100
2025775,1559553,2025-04-28,Senate,"(S) Natural Resources--Resolution Adopted",6,4,1,0,11
2025775,1561331,2025-04-29,Senate,"(S) 2nd Reading Concurred",35,15,0,0,50
2025775,1562664,2025-04-30,Senate,"(S) 3rd Reading Concurred",33,17,0,0,50
2025869,1555694,2025-04-23,House,"(H) Human Services--Resolution Adopted",21,0,0,0,21
2025869,1557955,2025-04-25,House,"(H) 2nd Reading Passed",66,34,0,0,100
2025869,1559339,2025-04-28,House,"(H) 3rd Reading Passed",63,37,0,0,100
2025869,1559340,2025-04-28,Senate,"(S) Public Health, Welfare and Safety--Resolution Adopted",7,4,0,0,11
2025869,1561074,2025-04-29,Senate,"(S) 2nd Reading Indefinitely Postponed",34,16,0,0,50
2025869,1561075,2025-04-29,Senate,"(S) 2nd Reading Pass Motion Failed",20,30,0,0,50
2026747,1561015,2025-04-29,House,"(H) Taken from Committee; Placed on 2nd Reading",11,86,0,3,100
