bill_id,roll_call_id,date,chamber,description,yea,nay,nv,absent,total
1897822,1509774,2025-01-24,House,"House Comm - Favorable Recommendation",10,0,0,4,14
1897822,1509775,2025-02-04,House,"House/ passed 3rd reading",71,0,0,4,75
1897822,1509776,2025-02-10,Senate,"Senate Comm - Favorable Recommendation",3,0,0,4,7
1897822,1509777,2025-02-19,Senate,"Senate/ passed 2nd reading",23,0,0,6,29
1897822,1509778,2025-02-20,Senate,"Senate/ passed 3rd reading",23,0,0,6,29
1897826,1509779,2025-01-21,Senate,"Senate/ passed 2nd & 3rd readings/ suspension",23,2,0,4,29
1897826,1509780,2025-01-30,House,"House Comm - Substitute Recommendation",7,0,0,3,10
1897826,1509781,2025-01-30,House,"House Comm - Favorable Recommendation",8,0,0,2,10
1897826,1509782,2025-02-05,House,"House/ passed 3rd reading",68,0,0,7,75
1897826,1509783,2025-02-10,Senate,"Senate/ concurs with House amendment",22,4,0,3,29
1897830,1509784,2025-01-21,Senate,"Senate/ passed 2nd & 3rd readings/ suspension",24,0,0,5,29
1897830,1509785,2025-02-10,House,"House Comm - Favorable Recommendation",10,0,0,6,16
1897830,1509786,2025-02-19,House,"House/ passed 3rd reading",67,0,0,8,75
1897830,1509787,2025-02-20,Senate,"Senate/ concurs with House amendment",24,0,0,5,29
1897834,1511432,2025-01-29,Senate,"Senate Comm - Substitute Recommendation",5,0,0,2,7
1897834,1511433,2025-01-29,Senate,"Senate Comm - Favorable Recommendation",5,0,0,2,7
1897834,1511434,2025-02-04,Senate,"Senate/ passed 2nd reading",24,0,0,5,29
1897834,1511435,2025-02-05,Senate,"Senate/ passed 3rd reading",28,0,0,1,29
1897834,1511436,2025-02-14,House,"House Comm - Amendment Recommendation",10,0,0,1,11
1897834,1511437,2025-02-14,House,"House Comm - Favorable Recommendation",10,0,0,1,11
1897834,1511438,2025-02-26,House,"House/ passed 3rd reading",66,0,0,9,75
1897834,1511439,2025-02-27,Senate,"Senate/ concurs with House amendment",26,0,0,3,29
1897838,1509788,2025-01-21,Senate,"Senate/ passed 2nd & 3rd readings/ suspension",25,0,0,4,29
1897838,1509789,2025-01-27,House,"House Comm - Favorable Recommendation",11,0,0,2,13
1897838,1509790,2025-01-31,House,"House/ passed 3rd reading",73,0,0,2,75
1897847,1512302,2025-02-18,House,"House Comm - Amendment Recommendation",7,0,0,4,11
1897847,1512303,2025-02-18,House,"House Comm - Favorable Recommendation",7,0,0,4,11
1897847,1512304,2025-02-25,House,"House/ passed 3rd reading",61,0,0,14,75
1897847,1512305,2025-03-04,Senate,"Senate Comm - Favorable Recommendation",4,1,0,2,7
1897852,1509791,2025-01-28,House,"House Comm - Substitute Recommendation",12,0,0,4,16
1897852,1509792,2025-01-28,House,"House Comm - Favorable Recommendation",12,0,0,4,16
1897852,1509793,2025-02-06,House,"House/ passed 3rd reading",71,0,0,4,75
1897852,1509794,2025-02-13,Senate,"Senate Comm - Favorable Recommendation",4,0,0,3,7
1897852,1509795,2025-02-19,Senate,"Senate/ passed 2nd reading",23,0,0,6,29
1897852,1509796,2025-03-04,Senate,"Senate/ passed 2nd & 3rd readings/ suspension",27,0,0,2,29
1897856,1509797,2025-01-23,House,"House/ passed 3rd reading",72,0,0,3,75
1897856,1509798,2025-01-28,Senate,"Senate Comm - Substitute Recommendation",7,0,0,1,8
1897856,1509799,2025-01-28,Senate,"Senate Comm - Favorable Recommendation",7,0,0,1,8
1897856,1509800,2025-02-13,Senate,"Senate/ passed 2nd reading",26,0,0,3,29
1897856,1509801,2025-02-14,Senate,"Senate/ passed 3rd reading",21,1,0,7,29
1897856,1509802,2025-02-19,House,"House/ concurs with Senate amendment",69,0,0,6,75
1897860,1509803,2025-01-23,Senate,"Senate Comm - Favorable Recommendation",6,0,0,2,8
1897860,1509804,2025-01-27,Senate,"Senate/ passed 2nd reading",29,0,0,0,29
1897860,1509805,2025-01-28,Senate,"Senate/ passed 3rd reading",28,0,0,1,29
1897860,1509806,2025-02-07,House,"House Comm - Favorable Recommendation",7,0,0,6,13
1897860,1509807,2025-02-13,House,"House/ passed 3rd reading",70,0,0,5,75
1897865,1509808,2025-01-21,Senate,"Senate/ passed 2nd & 3rd readings/ suspension",24,0,0,5,29
1897865,1509809,2025-01-27,House,"House Comm - Favorable Recommendation",11,1,0,1,13
1897865,1509810,2025-01-31,House,"House/ passed 3rd reading",70,0,0,5,75
1897865,1509811,2025-02-04,Senate,"Senate/ concurs with House amendment",29,0,0,0,29
1897868,1515018,2025-02-13,House,"House Comm - Substitute Recommendation",6,0,0,4,10
1897868,1515019,2025-02-13,House,"House Comm - Favorable Recommendation",6,0,0,4,10
1897868,1515020,2025-02-20,House,"House/ passed 3rd reading",58,9,0,8,75
1897868,1515021,2025-02-27,Senate,"Senate Comm - Substitute Recommendation",5,0,0,2,7
1897868,1515022,2025-02-27,Senate,"Senate Comm - Favorable Recommendation",4,0,0,3,7
1897868,1515023,2025-03-07,Senate,"Senate/ passed 2nd & 3rd readings/ suspension",22,6,0,1,29
1897868,1515024,2025-03-07,House,"House/ concurs with Senate amendment",39,30,0,6,75
1897874,1509812,2025-01-28,House,"House Comm - Substitute Recommendation",13,0,0,3,16
1897874,1509813,2025-01-28,House,"House Comm - Favorable Recommendation",9,2,0,5,16
1897874,1509814,2025-02-05,House,"House/ passed 3rd reading",71,0,0,4,75
1897874,1509815,2025-02-13,Senate,"Senate Comm - Favorable Recommendation",8,0,0,0,8
1897874,1509816,2025-02-19,Senate,"Senate/ passed 2nd reading",22,0,0,7,29
1897874,1509817,2025-02-20,Senate,"Senate/ passed 3rd reading",22,0,0,7,29
1897879,1509818,2025-01-21,Senate,"Senate/ passed 2nd & 3rd readings/ suspension",25,0,0,4,29
1897879,1509819,2025-02-04,House,"House Comm - Favorable Recommendation",10,0,0,3,13
1897879,1509820,2025-02-12,House,"House/ passed 3rd reading",73,0,0,2,75
1897883,1509821,2025-01-21,House,"House/ passed 3rd reading",74,0,0,1,75
1897883,1509822,2025-01-27,Senate,"Senate Comm - Favorable Recommendation",5,0,0,2,7
1897883,1509823,2025-01-29,Senate,"Senate/ passed 2nd reading",28,0,0,1,29
1897883,1509824,2025-01-30,Senate,"Senate/ passed 3rd reading",26,0,0,3,29
1897887,1509825,2025-01-21,Senate,"Senate/ passed 2nd & 3rd readings/ suspension",24,0,0,5,29
1897887,1509826,2025-01-30,House,"House Comm - Favorable Recommendation",9,0,0,4,13
1897887,1509827,2025-02-05,House,"House/ passed 3rd reading",71,0,0,4,75
1897890,1512106,2025-01-24,Senate,"Senate Comm - Substitute Recommendation",5,0,0,1,6
1897890,1512107,2025-01-24,Senate,"Senate Comm - Favorable Recommendation",4,0,0,2,6
1897890,1512108,2025-02-04,Senate,"Senate/ passed 2nd reading",28,0,0,1,29
1897890,1512109,2025-02-05,Senate,"Senate/ passed 3rd reading",28,0,0,1,29
1897890,1512110,2025-02-19,House,"House Comm - Favorable Recommendation",8,0,0,2,10
1897890,1512111,2025-03-04,House,"House/ passed 3rd reading",67,7,0,1,75
1897895,1509828,2025-01-21,Senate,"Senate/ passed 2nd & 3rd readings/ suspension",24,0,0,5,29
1897895,1509829,2025-01-29,House,"House Comm - Favorable Recommendation",10,0,0,4,14
1897895,1509830,2025-02-05,House,"House/ passed 3rd reading",73,0,0,2,75
1897901,1511975,2025-01-21,House,"House/ passed 3rd reading",74,0,0,1,75
1897901,1511976,2025-01-28,Senate,"Senate Comm - Favorable Recommendation",6,0,0,3,9
1897901,1511977,2025-02-05,Senate,"Senate/ passed 2nd reading",27,0,0,2,29
1897901,1511978,2025-03-05,Senate,"Senate/ passed 2nd & 3rd readings/ suspension",29,0,0,0,29
1897901,1511979,2025-03-06,House,"House/ concurs with Senate amendment",74,0,0,1,75
1897905,1512911,2025-02-07,Senate,"Senate Comm - Favorable Recommendation",4,0,0,3,7
1897905,1512912,2025-02-18,Senate,"Senate/ passed 2nd reading",21,2,0,6,29
1897905,1512913,2025-02-19,Senate,"Senate/ passed 3rd reading",19,8,0,2,29
1897905,1512914,2025-02-28,House,"House Comm - Favorable Recommendation",9,0,0,7,16
1897910,1509831,2025-01-21,House,"House/ passed 3rd reading",74,0,0,1,75
1897910,1509832,2025-01-28,Senate,"Senate Comm - Favorable Recommendation",5,0,0,4,9
1897910,1509833,2025-02-13,Senate,"Senate/ passed 2nd reading",26,0,0,3,29
1897910,1509834,2025-02-14,Senate,"Senate/ passed 3rd reading",22,0,0,7,29
1897913,1509835,2025-01-27,House,"House/ passed 3rd reading",73,0,0,2,75
1897913,1509836,2025-02-03,Senate,"Senate Comm - Favorable Recommendation",6,0,0,1,7
1897913,1509837,2025-02-06,Senate,"Senate/ passed 2nd reading",20,0,0,9,29
1897913,1509838,2025-02-07,Senate,"Senate/ passed 3rd reading",27,0,0,2,29
1897915,1512707,2025-01-21,Senate,"Senate/ passed 2nd reading",25,0,0,4,29
1897915,1512708,2025-01-22,Senate,"Senate/ passed 3rd reading",25,0,0,4,29
1897915,1512709,2025-01-28,House,"House Comm - Favorable Recommendation",8,0,0,2,10
1897915,1512710,2025-01-28,House,"House Comm - Consent Calendar Recommendation",8,0,0,2,10
1897915,1512711,2025-03-05,House,"House/ passed 3rd reading",51,21,0,3,75
1897921,1512915,2025-01-21,Senate,"Senate/ passed 2nd & 3rd readings/ suspension",24,0,0,5,29
1897921,1512916,2025-02-25,House,"House Comm - Substitute Recommendation",13,0,0,3,16
1897921,1512917,2025-02-25,House,"House Comm - Favorable Recommendation",13,0,0,3,16
1897921,1512918,2025-03-05,House,"House/ passed 3rd reading",70,0,0,5,75
1897921,1512919,2025-03-06,Senate,"Senate/ concurs with House amendment",23,0,0,6,29
1897925,1514328,2025-01-21,House,"House/ passed 3rd reading",74,0,0,1,75
1897925,1514329,2025-02-03,Senate,"Senate Comm - Substitute Recommendation",3,0,0,4,7
1897925,1514330,2025-02-03,Senate,"Senate Comm - Favorable Recommendation",3,0,0,4,7
1897925,1514331,2025-02-13,Senate,"Senate/ passed 2nd reading",25,0,0,4,29
1897925,1514332,2025-03-03,Senate,"Senate/ passed 3rd reading",27,0,0,2,29
1897925,1514333,2025-03-05,House,"House/ concurs with Senate amendment",73,0,0,2,75
1897929,1509839,2025-01-21,Senate,"Senate/ passed 2nd & 3rd readings/ suspension",22,0,0,7,29
1897929,1509840,2025-02-03,House,"House Comm - Favorable Recommendation",9,0,0,5,14
1897929,1509841,2025-02-05,House,"House/ passed 3rd reading",73,0,0,2,75
1897934,1512958,2025-01-21,Senate,"Senate/ passed 2nd & 3rd readings/ suspension",25,0,0,4,29
1897934,1512959,2025-01-27,House,"House Comm - Favorable Recommendation",10,0,0,1,11
1897934,1512960,2025-03-06,House,"House/ passed 3rd reading",73,0,0,2,75
1897934,1512961,2025-03-06,Senate,"Senate/ concurs with House amendment",21,0,0,8,29
1897940,1509842,2025-01-21,House,"House/ passed 3rd reading",73,0,0,2,75
1897940,1509843,2025-01-29,Senate,"Senate Comm - Substitute Recommendation",4,0,0,3,7
1897940,1509844,2025-01-29,Senate,"Senate Comm - Favorable Recommendation",4,0,0,3,7
1897940,1509845,2025-02-05,Senate,"Senate/ passed 2nd reading",26,0,0,3,29
1897940,1509846,2025-02-06,Senate,"Senate/ passed 3rd reading",28,0,0,1,29
1897940,1509847,2025-02-07,House,"House/ concurs with Senate amendment",70,0,0,5,75
1897944,1509848,2025-01-21,House,"House/ passed 3rd reading",74,0,0,1,75
1897944,1509849,2025-01-27,Senate,"Senate Comm - Substitute Recommendation",3,0,0,4,7
1897944,1509850,2025-01-27,Senate,"Senate Comm - Favorable Recommendation",4,0,0,3,7
1897944,1509851,2025-01-29,Senate,"Senate/ passed 2nd reading",28,0,0,1,29
1897944,1509852,2025-02-04,Senate,"Senate/ passed 3rd reading",29,0,0,0,29
1897944,1509853,2025-02-05,House,"House/ concurs with Senate amendment",67,0,0,8,75
1897948,1509854,2025-01-21,Senate,"Senate/ passed 2nd & 3rd readings/ suspension",25,0,0,4,29
1897948,1509855,2025-02-06,House,"House Comm - Favorable Recommendation",9,0,0,5,14
1897948,1509856,2025-02-13,House,"House/ passed 3rd reading",70,0,0,5,75
1897952,1509857,2025-01-22,House,"House/ passed 3rd reading",72,0,0,3,75
1897952,1509858,2025-01-28,Senate,"Senate Comm - Favorable Recommendation",7,0,0,1,8
1897952,1509859,2025-02-13,Senate,"Senate/ passed 2nd & 3rd readings/ suspension",26,0,0,3,29
1897956,1514253,2025-02-12,Senate,"Senate Comm - Favorable Recommendation",4,0,0,3,7
1897962,1509860,2025-01-21,House,"House/ passed 3rd reading",75,0,0,0,75
1897962,1509861,2025-01-24,Senate,"Senate Comm - Favorable Recommendation",5,0,0,1,6
1897962,1509862,2025-01-29,Senate,"Senate/ passed 2nd reading",28,0,0,1,29
1897962,1509863,2025-01-30,Senate,"Senate/ passed 3rd reading",24,0,0,5,29
1897966,1509864,2025-01-22,House,"House/ passed 3rd reading",71,0,0,4,75
1897966,1509865,2025-01-28,Senate,"Senate Comm - Favorable Recommendation",5,0,0,3,8
1897966,1509866,2025-02-13,Senate,"Senate/ passed 2nd reading",26,0,0,3,29
1897966,1509867,2025-02-14,Senate,"Senate/ passed 3rd reading",24,0,0,5,29
1897970,1509868,2025-02-04,House,"House/ passed 3rd reading",45,25,0,5,75
1897970,1509869,2025-02-13,Senate,"Senate Comm - Favorable Recommendation",6,2,0,1,9
1897970,1509870,2025-02-19,Senate,"Senate/ passed 2nd reading",15,4,0,10,29
1897970,1509871,2025-02-20,Senate,"Senate/ passed 3rd reading",16,5,0,8,29
1897974,1515164,2025-01-22,Senate,"Senate Comm - Substitute Recommendation",5,0,0,3,8
1897974,1515165,2025-01-22,Senate,"Senate Comm - Favorable Recommendation",5,0,0,3,8
1897974,1515166,2025-01-23,Senate,"Senate/ passed 2nd reading",27,0,0,2,29
1897974,1515167,2025-01-24,Senate,"Senate/ passed 3rd reading",25,0,0,4,29
1897974,1515168,2025-02-13,House,"House Comm - Amendment Recommendation",10,0,0,3,13
1897974,1515169,2025-02-13,House,"House Comm - Favorable Recommendation",10,0,0,3,13
1897974,1515170,2025-03-05,House,"House/ passed 3rd reading",69,0,0,6,75
1897974,1515171,2025-03-06,Senate,"Senate/ concurs with House amendment",24,0,0,5,29
1897976,1514615,2025-02-13,House,"House Comm - Substitute Recommendation",8,0,0,2,10
1897976,1514616,2025-02-13,House,"House Comm - Favorable Recommendation",8,0,0,2,10
1897976,1514617,2025-02-20,House,"House/ passed 3rd reading",70,0,0,5,75
1897976,1514618,2025-02-27,Senate,"Senate Comm - Favorable Recommendation",5,0,0,2,7
1897976,1514619,2025-03-06,Senate,"Senate/ passed 2nd & 3rd readings/ suspension",20,3,0,6,29
1897982,1509872,2025-01-21,House,"House/ passed 3rd reading",73,0,0,2,75
1897982,1509873,2025-01-28,Senate,"Senate Comm - Favorable Recommendation",4,0,0,3,7
1897982,1509874,2025-01-28,Senate,"Senate Comm - Consent Calendar Recommendation",4,0,0,3,7
1897982,1509875,2025-02-05,Senate,"Senate/ passed 3rd reading",29,0,0,0,29
1897986,1511763,2025-01-21,Senate,"Senate/ passed 2nd & 3rd readings/ suspension",22,3,0,4,29
1897986,1511764,2025-02-25,House,"House Comm - Substitute Recommendation",7,0,0,3,10
1897986,1511765,2025-02-25,House,"House Comm - Motion to Recommend Failed",2,6,0,2,10
1897986,1511766,2025-02-25,House,"House Comm - Held",8,0,0,2,10
1897986,1511767,2025-02-26,House,"House Comm - Substitute Recommendation",8,0,0,2,10
1897986,1511768,2025-02-26,House,"House Comm - Favorable Recommendation",8,0,0,2,10
1897986,1511769,2025-03-07,House,"House/ passed 3rd reading",64,5,0,6,75
1897986,1511770,2025-03-07,Senate,"Senate/ concurs with House amendment",21,5,0,3,29
1897990,1509876,2025-01-31,House,"House Comm - Substitute Recommendation",10,0,0,6,16
1897990,1509877,2025-01-31,House,"House Comm - Favorable Recommendation",10,0,0,6,16
1897990,1509878,2025-02-10,House,"House/ passed 3rd reading",75,0,0,0,75
1897990,1509879,2025-02-18,Senate,"Senate Comm - Substitute Recommendation",4,0,0,3,7
1897990,1509880,2025-02-18,Senate,"Senate Comm - Favorable Recommendation",4,0,0,3,7
1897990,1509881,2025-02-20,Senate,"Senate/ passed 2nd reading",23,0,0,6,29
1897990,1509882,2025-03-05,Senate,"Senate/ passed 2nd & 3rd readings/ suspension",24,0,0,5,29
1897990,1509883,2025-03-05,House,"House/ concurs with Senate amendment",73,0,0,2,75
1897995,1509884,2025-01-24,House,"House Comm - Substitute Recommendation",11,0,0,3,14
1897995,1509885,2025-01-24,House,"House Comm - Favorable Recommendation",11,0,0,3,14
1897995,1509886,2025-02-04,House,"House/ passed 3rd reading",72,0,0,3,75
1897995,1509887,2025-02-10,Senate,"Senate Comm - Favorable Recommendation",3,0,0,4,7
1897995,1509888,2025-02-13,Senate,"Senate/ passed 2nd reading",23,0,0,6,29
1897995,1509889,2025-02-14,Senate,"Senate/ passed 3rd reading",23,0,0,6,29
1898000,1511891,2025-01-23,Senate,"Senate Comm - Favorable Recommendation",6,0,0,3,9
1898000,1511892,2025-02-07,Senate,"Senate/ passed 2nd reading",25,1,0,3,29
1898000,1511893,2025-02-10,Senate,"Senate/ passed 3rd reading",25,0,0,4,29
1898000,1511894,2025-02-12,House,"House Comm - Favorable Recommendation",10,0,0,1,11
1898000,1511895,2025-03-04,House,"House/ passed 3rd reading",69,2,0,4,75
1898004,1509890,2025-01-24,House,"House Comm - Favorable Recommendation",9,0,0,2,11
1898004,1509891,2025-01-31,House,"House/ passed 3rd reading",74,0,0,1,75
1898004,1509892,2025-02-13,Senate,"Senate Comm - Favorable Recommendation",3,0,0,4,7
1898004,1509893,2025-02-19,Senate,"Senate/ passed 2nd reading",20,0,0,9,29
1898004,1509894,2025-02-20,Senate,"Senate/ passed 3rd reading",24,0,0,5,29
1898009,1509895,2025-01-23,House,"House Comm - Amendment Recommendation",12,0,0,2,14
1898009,1509896,2025-01-23,House,"House Comm - Favorable Recommendation",12,0,0,2,14
1898009,1509897,2025-01-31,House,"House/ passed 3rd reading",71,0,0,4,75
1898009,1509898,2025-02-06,Senate,"Senate Comm - Favorable Recommendation",4,0,0,3,7
1898009,1509899,2025-02-06,Senate,"Senate Comm - Consent Calendar Recommendation",4,0,0,3,7
1898009,1509900,2025-02-12,Senate,"Senate/ passed 3rd reading",24,0,0,5,29
1898011,1512223,2025-01-22,House,"House/ passed 3rd reading",72,0,0,3,75
1898011,1512224,2025-01-31,Senate,"Senate Comm - Substitute Recommendation",6,0,0,3,9
1898011,1512225,2025-01-31,Senate,"Senate Comm - Favorable Recommendation",6,0,0,3,9
1898011,1512226,2025-02-05,Senate,"Senate/ passed 2nd reading",25,0,0,4,29
1898011,1512227,2025-02-06,Senate,"Senate/ passed 3rd reading",27,0,0,2,29
1898011,1512228,2025-02-10,House,"House/ concurs with Senate amendment",71,0,0,4,75
1898015,1513008,2025-01-24,House,"House Comm - Substitute Recommendation",11,0,0,3,14
1898015,1513009,2025-01-24,House,"House Comm - Held",11,0,0,3,14
1898021,1509901,2025-01-23,Senate,"Senate/ passed 2nd & 3rd readings/ suspension",25,0,0,4,29
1898021,1509902,2025-02-03,House,"House Comm - Favorable Recommendation",10,0,0,1,11
1898021,1509903,2025-02-03,House,"House Comm - Consent Calendar Recommendation",10,0,0,1,11
1898021,1509904,2025-02-06,House,"House/ passed 3rd reading",71,0,0,4,75
1898025,1514121,2025-02-10,House,"House Comm - Substitute Recommendation",10,0,0,4,14
1898025,1514122,2025-02-10,House,"House Comm - Favorable Recommendation",10,0,0,4,14
1898025,1514123,2025-02-21,House,"House/ passed 3rd reading",68,0,0,7,75
1898025,1514124,2025-02-28,Senate,"Senate Comm - Favorable Recommendation",5,0,0,2,7
1898025,1514125,2025-03-05,Senate,"Senate/ passed 2nd & 3rd readings/ suspension",26,0,0,3,29
1898025,1514126,2025-03-06,House,"House/ concurs with Senate amendment",72,0,0,3,75
1898029,1511499,2025-01-23,House,"House/ failed",27,41,0,7,75
1898033,1512167,2025-01-24,Senate,"Senate Comm - Favorable Recommendation",4,0,0,3,7
1898037,1509905,2025-01-21,Senate,"Senate/ passed 2nd & 3rd readings/ suspension",23,0,0,6,29
1898037,1509906,2025-02-03,House,"House Comm - Favorable Recommendation",10,0,0,4,14
1898037,1509907,2025-02-06,House,"House/ passed 3rd reading",73,0,0,2,75
1898043,1511669,2025-01-29,House,"House Comm - Substitute Recommendation",10,0,0,1,11
1898043,1511670,2025-01-29,House,"House Comm - Favorable Recommendation",10,0,0,1,11
1898043,1511671,2025-02-18,House,"House/ passed 3rd reading",69,2,0,4,75
1898043,1511672,2025-02-26,Senate,"Senate Comm - Substitute Recommendation",6,0,0,1,7
1898043,1511673,2025-02-26,Senate,"Senate Comm - Favorable Recommendation",4,2,0,1,7
1898043,1511674,2025-03-05,Senate,"Senate/ passed 2nd & 3rd readings/ suspension",25,0,0,4,29
1898043,1511675,2025-03-07,Senate,"Senate Conference Committee - Final Passage",25,0,0,4,29
1898043,1511676,2025-03-07,House,"House Conference Committee - Final Passage",67,3,0,5,75
1898048,1512678,2025-01-22,House,"House/ passed 3rd reading",69,3,0,3,75
1898048,1512679,2025-01-28,Senate,"Senate Comm - Favorable Recommendation",4,0,0,3,7
1898048,1512680,2025-02-05,Senate,"Senate/ passed 2nd reading",28,0,0,1,29
1898048,1512681,2025-02-06,Senate,"Senate/ passed 3rd reading",28,0,0,1,29
1898052,1509908,2025-01-22,House,"House/ passed 3rd reading",73,0,0,2,75
1898052,1509909,2025-01-29,Senate,"Senate Comm - Favorable Recommendation",6,0,0,1,7
1898052,1509910,2025-02-13,Senate,"Senate/ passed 2nd reading",25,0,0,4,29
1898052,1509911,2025-02-14,Senate,"Senate/ passed 3rd reading",23,0,0,6,29
1898052,1509912,2025-02-19,House,"House/ concurs with Senate amendment",71,0,0,4,75
1898057,1509913,2025-01-29,Senate,"Senate Comm - Favorable Recommendation",4,0,0,3,7
1898057,1509914,2025-02-06,Senate,"Senate/ passed 2nd reading",18,6,0,5,29
1898057,1509915,2025-02-07,Senate,"Senate/ passed 3rd reading",19,8,0,2,29
1898057,1509916,2025-02-13,House,"House Comm - Amendment Recommendation",10,0,0,1,11
1898057,1509917,2025-02-13,House,"House Comm - Favorable Recommendation",10,0,0,1,11
1898057,1509918,2025-02-19,House,"House/ passed 3rd reading",41,27,0,7,75
1898057,1509919,2025-02-20,Senate,"Senate/ concurs with House amendment",20,8,0,1,29
1898061,1512635,2025-02-03,Senate,"Senate/ passed 2nd reading",27,0,0,2,29
1898061,1512636,2025-02-04,Senate,"Senate/ passed 3rd reading",29,0,0,0,29
1898061,1512637,2025-02-12,House,"House Comm - Favorable Recommendation",8,0,0,6,14
1898061,1512638,2025-02-19,House,"House/ passed 3rd reading",63,0,0,12,75
1898066,1509920,2025-01-21,Senate,"Senate/ passed 2nd & 3rd readings/ suspension",25,0,0,4,29
1898066,1509921,2025-01-28,House,"House Comm - Favorable Recommendation",8,0,0,2,10
1898066,1509922,2025-01-28,House,"House Comm - Consent Calendar Recommendation",8,0,0,2,10
1898066,1509923,2025-02-05,House,"House/ passed 3rd reading",55,15,0,5,75
1898070,1509924,2025-01-29,House,"House Comm - Substitute Recommendation",11,0,0,0,11
1898070,1509925,2025-01-29,House,"House Comm - Favorable Recommendation",11,0,0,0,11
1898070,1509926,2025-02-06,House,"House/ passed 3rd reading",72,0,0,3,75
1898070,1509927,2025-02-14,Senate,"Senate Comm - Favorable Recommendation",7,0,0,1,8
1898070,1509928,2025-02-20,Senate,"Senate/ passed 2nd reading",22,0,0,7,29
1898070,1509929,2025-02-21,Senate,"Senate/ passed 3rd reading",24,0,0,5,29
1898074,1509930,2025-01-22,House,"House/ passed 3rd reading",73,0,0,2,75
1898074,1509931,2025-01-31,Senate,"Senate Comm - Favorable Recommendation",5,0,0,4,9
1898074,1509932,2025-02-26,Senate,"Senate/ passed 2nd reading",22,0,0,7,29
1898074,1509933,2025-03-05,Senate,"Senate/ passed 2nd & 3rd readings/ suspension",26,0,0,3,29
1898079,1509934,2025-01-31,House,"House Comm - Substitute Recommendation",11,0,0,5,16
1898079,1509935,2025-01-31,House,"House Comm - Favorable Recommendation",10,1,0,5,16
1898079,1509936,2025-02-10,House,"House/ passed 3rd reading",74,0,0,1,75
1898079,1509937,2025-02-14,Senate,"Senate Comm - Substitute Recommendation",7,0,0,1,8
1898079,1509938,2025-02-14,Senate,"Senate Comm - Favorable Recommendation",7,0,0,1,8
1898079,1509939,2025-02-20,Senate,"Senate/ passed 2nd reading",21,2,0,6,29
1898079,1509940,2025-02-27,Senate,"Senate/ passed 3rd reading",21,2,0,6,29
1898079,1509941,2025-02-28,House,"House/ concurs with Senate amendment",65,0,0,10,75
1898084,1509942,2025-01-28,House,"House Comm - Substitute Recommendation",9,0,0,7,16
1898084,1509943,2025-01-28,House,"House Comm - Favorable Recommendation",9,0,0,7,16
1898084,1509944,2025-02-05,House,"House/ passed 3rd reading",71,0,0,4,75
1898084,1509945,2025-02-13,Senate,"Senate Comm - Favorable Recommendation",5,0,0,3,8
1898084,1509946,2025-02-19,Senate,"Senate/ passed 2nd reading",21,0,0,8,29
1898084,1509947,2025-02-20,Senate,"Senate/ passed 3rd reading",24,0,0,5,29
1898088,1512624,2025-01-24,House,"House Comm - Favorable Recommendation",10,0,0,1,11
1898088,1512625,2025-01-31,House,"House/ passed 3rd reading",70,0,0,5,75
1898088,1512626,2025-02-19,Senate,"Senate Comm - Amendment Recommendation",4,2,0,3,9
1898088,1512627,2025-02-21,Senate,"Senate Comm - Substitute Recommendation",5,1,0,3,9
1898088,1512628,2025-02-21,Senate,"Senate Comm - Favorable Recommendation",5,2,0,2,9
1898092,1509948,2025-01-22,House,"House/ passed 3rd reading",73,0,0,2,75
1898092,1509949,2025-01-31,Senate,"Senate Comm - Favorable Recommendation",4,0,0,5,9
1898092,1509950,2025-02-06,Senate,"Senate/ passed 2nd reading",18,0,0,11,29
1898092,1509951,2025-02-07,Senate,"Senate/ passed 3rd reading",25,0,0,4,29
1898096,1509952,2025-01-22,House,"House Comm - Substitute Recommendation",9,0,0,2,11
1898096,1509953,2025-01-22,House,"House Comm - Amendment Recommendation",9,0,0,2,11
1898096,1509954,2025-01-22,House,"House Comm - Favorable Recommendation",10,0,0,1,11
1898096,1509955,2025-01-30,House,"House/ passed 3rd reading",71,0,0,4,75
1898096,1509956,2025-02-05,Senate,"Senate Comm - Favorable Recommendation",3,0,0,4,7
1898096,1509957,2025-02-05,Senate,"Senate Comm - Consent Calendar Recommendation",3,0,0,4,7
1898096,1509958,2025-02-11,Senate,"Senate/ passed 3rd reading",22,0,0,7,29
1898100,1511802,2025-01-23,House,"House/ passed 3rd reading",71,0,0,4,75
1898100,1511803,2025-01-28,Senate,"Senate Comm - Favorable Recommendation",4,0,0,3,7
1898100,1511804,2025-02-05,Senate,"Senate/ passed 2nd reading",26,0,0,3,29
1898100,1511805,2025-02-06,Senate,"Senate/ passed 3rd reading",25,0,0,4,29
1898106,1512747,2025-02-03,House,"House Comm - Substitute Recommendation",10,0,0,1,11
1898106,1512748,2025-02-03,House,"House Comm - Favorable Recommendation",10,0,0,1,11
1898106,1512749,2025-02-12,House,"House/ passed 3rd reading",69,0,0,6,75
1898106,1512750,2025-02-28,Senate,"Senate Comm - Substitute Recommendation",4,0,0,5,9
1898106,1512751,2025-02-28,Senate,"Senate Comm - Favorable Recommendation",4,0,0,5,9
1898106,1512752,2025-03-05,Senate,"Senate/ passed 2nd & 3rd readings/ suspension",25,0,0,4,29
1898106,1512753,2025-03-05,House,"House/ concurs with Senate amendment",68,0,0,7,75
1898110,1509959,2025-01-24,House,"House Comm - Amendment Recommendation",11,0,0,3,14
1898110,1509960,2025-01-24,House,"House Comm - Favorable Recommendation",11,0,0,3,14
1898110,1509961,2025-02-04,House,"House/ passed 3rd reading",66,1,0,8,75
1898110,1509962,2025-02-10,Senate,"Senate Comm - Favorable Recommendation",3,0,0,4,7
1898110,1509963,2025-02-13,Senate,"Senate/ passed 2nd reading",22,0,0,7,29
1898110,1509964,2025-02-14,Senate,"Senate/ passed 3rd reading",22,0,0,7,29
1898114,1509965,2025-01-21,Senate,"Senate/ passed 2nd & 3rd readings/ suspension",26,0,0,3,29
1898114,1509966,2025-01-27,House,"House Comm - Favorable Recommendation",10,0,0,1,11
1898114,1509967,2025-01-31,House,"House/ passed 3rd reading",71,0,0,4,75
1898114,1509968,2025-02-04,Senate,"Senate/ concurs with House amendment",29,0,0,0,29
1898117,1509969,2025-01-23,House,"House/ passed 3rd reading",74,0,0,1,75
1898117,1509970,2025-01-27,Senate,"Senate Comm - Favorable Recommendation",6,0,0,1,7
1898117,1509971,2025-01-29,Senate,"Senate/ passed 2nd reading",28,0,0,1,29
1898117,1509972,2025-02-04,Senate,"Senate/ passed 3rd reading",29,0,0,0,29
1898246,1509973,2025-02-28,Senate,"Senate Comm - Favorable Recommendation",3,0,0,4,7
1898246,1509974,2025-03-03,Senate,"Senate/ passed 2nd reading",24,0,0,5,29
1898246,1509975,2025-03-04,Senate,"Senate/ passed 3rd reading",25,1,0,3,29
1898246,1509976,2025-03-05,House,"House/ passed 3rd reading",72,0,0,3,75
1898316,1511881,2025-01-22,Senate,"Senate Comm - Amendment Recommendation",5,0,0,2,7
1898316,1511882,2025-01-22,Senate,"Senate Comm - Favorable Recommendation",6,0,0,1,7
1898316,1511883,2025-01-27,Senate,"Senate/ passed 2nd reading",26,0,0,3,29
1898316,1511884,2025-02-25,Senate,"Senate/ passed 3rd reading",25,0,0,4,29
1898316,1511885,2025-02-28,House,"House Comm - Amendment Recommendation",9,0,0,7,16
1898316,1511886,2025-02-28,House,"House Comm - Amendment Recommendation",9,0,0,7,16
1898316,1511887,2025-02-28,House,"House Comm - Favorable Recommendation",9,0,0,7,16
1898316,1511888,2025-03-04,House,"House/ passed 3rd reading",74,0,0,1,75
1898316,1511889,2025-03-05,Senate,"Senate/ concurs with House amendment",27,0,0,2,29
1898320,1512054,2025-01-21,Senate,"Senate/ passed 2nd & 3rd readings/ suspension",25,0,0,4,29
1898320,1512055,2025-02-28,House,"House Comm - Substitute Recommendation",10,0,0,1,11
1898320,1512056,2025-02-28,House,"House Comm - Favorable Recommendation",10,0,0,1,11
1898320,1512057,2025-03-07,House,"House/ passed 3rd reading",70,0,0,5,75
1898320,1512058,2025-03-07,Senate,"Senate/ concurs with House amendment",24,0,0,5,29
1898322,1511839,2025-01-23,Senate,"Senate/ passed 2nd & 3rd readings/ suspension",27,0,0,2,29
1898322,1511840,2025-02-03,House,"House Comm - Substitute Recommendation",9,0,0,2,11
1898322,1511841,2025-02-03,House,"House Comm - Favorable Recommendation",9,0,0,2,11
1898322,1511842,2025-02-03,House,"House Comm - Consent Calendar Recommendation",9,0,0,2,11
1898322,1511843,2025-02-06,House,"House/ passed 3rd reading",74,0,0,1,75
1898322,1511844,2025-02-10,Senate,"Senate/ concurs with House amendment",25,0,0,4,29
1898326,1509977,2025-01-23,House,"House/ passed 3rd reading",74,0,0,1,75
1898326,1509978,2025-01-27,Senate,"Senate Comm - Favorable Recommendation",6,0,0,1,7
1898326,1509979,2025-01-27,Senate,"Senate Comm - Consent Calendar Recommendation",6,0,0,1,7
1898326,1509980,2025-02-05,Senate,"Senate/ passed 2nd reading",28,0,0,1,29
1898326,1509981,2025-02-06,Senate,"Senate/ passed 3rd reading",28,0,0,1,29
1898326,1509982,2025-02-10,House,"House/ concurs with Senate amendment",71,0,0,4,75
1898331,1509983,2025-01-28,House,"House/ passed 3rd reading",72,0,0,3,75
1898331,1509984,2025-02-03,Senate,"Senate Comm - Substitute Recommendation",4,0,0,2,6
1898331,1509985,2025-02-03,Senate,"Senate Comm - Favorable Recommendation",4,0,0,2,6
1898331,1509986,2025-02-03,Senate,"Senate Comm - Consent Calendar Recommendation",4,0,0,2,6
1898331,1509987,2025-02-07,Senate,"Senate/ passed 3rd reading",23,0,0,6,29
1898331,1509988,2025-02-10,House,"House/ concurs with Senate amendment",71,0,0,4,75
1898333,1509989,2025-01-24,House,"House Comm - Substitute Recommendation",9,0,0,3,12
1898333,1509990,2025-01-24,House,"House Comm - Favorable Recommendation",7,2,0,3,12
1898333,1509991,2025-02-04,House,"House/ passed 3rd reading",68,1,0,6,75
1898333,1509992,2025-02-10,Senate,"Senate Comm - Substitute Recommendation",6,0,0,2,8
1898333,1509993,2025-02-10,Senate,"Senate Comm - Favorable Recommendation",6,0,0,2,8
1898333,1509994,2025-02-27,Senate,"Senate/ passed 2nd reading",19,8,0,2,29
1898333,1509995,2025-02-28,Senate,"Senate/ passed 3rd reading",25,0,0,4,29
1898333,1509996,2025-03-03,House,"House/ concurs with Senate amendment",69,0,0,6,75
1898337,1512472,2025-01-24,House,"House/ passed 3rd reading",70,0,0,5,75
1898337,1512473,2025-02-03,Senate,"Senate Comm - Favorable Recommendation",3,0,0,4,7
1898337,1512474,2025-02-13,Senate,"Senate/ passed 2nd reading",27,0,0,2,29
1898340,1512592,2025-02-10,House,"House Comm - Substitute Recommendation",10,0,0,4,14
1898340,1512593,2025-02-10,House,"House Comm - Favorable Recommendation",12,0,0,2,14
1898340,1512594,2025-02-21,House,"House/ passed 3rd reading",68,0,0,7,75
1898340,1512595,2025-02-26,Senate,"Senate Comm - Favorable Recommendation",3,0,0,4,7
1898344,1509997,2025-01-22,Senate,"Senate/ passed 2nd & 3rd readings/ suspension",26,0,0,3,29
1898344,1509998,2025-02-14,House,"House Comm - Favorable Recommendation",8,0,0,3,11
1898344,1509999,2025-02-20,House,"House/ passed 3rd reading",69,0,0,6,75
1898347,1512886,2025-01-24,House,"House Comm - Substitute Recommendation",10,0,0,4,14
1898347,1512887,2025-01-24,House,"House Comm - Favorable Recommendation",11,0,0,3,14
1898347,1512888,2025-02-04,House,"House/ passed 3rd reading",68,3,0,4,75
1898347,1512889,2025-02-13,Senate,"Senate Comm - Motion to Recommend Failed",1,5,0,1,7
1898347,1512890,2025-02-25,Senate,"Senate Comm - Amendment Recommendation",4,0,0,3,7
1898347,1512891,2025-02-25,Senate,"Senate Comm - Favorable Recommendation",4,0,0,3,7
1898347,1512892,2025-03-07,Senate,"Senate/ passed 2nd & 3rd readings/ suspension",25,0,0,4,29
1898347,1512893,2025-03-07,House,"House/ concurs with Senate amendment",67,0,0,8,75
1898350,1512375,2025-02-19,House,"House Comm - Substitute Recommendation",9,0,0,4,13
1898350,1512376,2025-02-19,House,"House Comm - Favorable Recommendation",9,0,0,4,13
1898350,1512377,2025-02-27,House,"House/ passed 3rd reading",72,0,0,3,75
1898350,1512378,2025-03-04,Senate,"Senate Comm - Favorable Recommendation",5,0,0,3,8
1898350,1512379,2025-03-05,Senate,"Senate/ passed 2nd & 3rd readings/ suspension",21,5,0,3,29
1898352,1510000,2025-01-28,House,"House/ passed 3rd reading",70,0,0,5,75
1898352,1510001,2025-02-03,Senate,"Senate Comm - Substitute Recommendation",4,0,0,3,7
1898352,1510002,2025-02-03,Senate,"Senate Comm - Favorable Recommendation",5,0,0,2,7
1898352,1510003,2025-02-13,Senate,"Senate/ passed 2nd reading",26,0,0,3,29
1898352,1510004,2025-03-03,Senate,"Senate/ passed 3rd reading",26,0,0,3,29
1898352,1510005,2025-03-05,House,"House/ concurs with Senate amendment",69,0,0,6,75
1898355,1510006,2025-01-27,House,"House/ passed 3rd reading",72,0,0,3,75
1898355,1510007,2025-02-03,Senate,"Senate Comm - Favorable Recommendation",6,0,0,1,7
1898355,1510008,2025-02-13,Senate,"Senate/ passed 2nd reading",25,0,0,4,29
1898355,1510009,2025-02-14,Senate,"Senate/ passed 3rd reading",24,0,0,5,29
1898358,1510010,2025-01-23,House,"House/ passed 3rd reading",74,0,0,1,75
1898358,1510011,2025-01-27,Senate,"Senate Comm - Substitute Recommendation",5,0,0,2,7
1898358,1510012,2025-01-27,Senate,"Senate Comm - Favorable Recommendation",5,0,0,2,7
1898358,1510013,2025-02-05,Senate,"Senate/ passed 2nd reading",26,0,0,3,29
1898358,1510014,2025-02-06,Senate,"Senate/ passed 3rd reading",27,0,0,2,29
1898358,1510015,2025-02-10,House,"House/ concurs with Senate amendment",72,0,0,3,75
1898361,1510016,2025-01-29,House,"House/ passed 3rd reading",71,0,0,4,75
1898361,1510017,2025-02-03,Senate,"Senate Comm - Favorable Recommendation",4,0,0,3,7
1898361,1510018,2025-02-13,Senate,"Senate/ passed 2nd reading",27,0,0,2,29
1898361,1510019,2025-02-14,Senate,"Senate/ passed 3rd reading",23,0,0,6,29
1898362,1511516,2025-01-28,House,"House Comm - Favorable Recommendation",8,2,0,6,16
1898362,1511517,2025-02-20,House,"House/ passed 3rd reading",66,0,0,9,75
1898362,1511518,2025-02-26,Senate,"Senate Comm - Substitute Recommendation",5,0,0,3,8
1898362,1511519,2025-02-26,Senate,"Senate Comm - Favorable Recommendation",4,0,0,4,8
1898362,1511520,2025-03-05,Senate,"Senate/ passed 2nd & 3rd readings/ suspension",27,0,0,2,29
1898362,1511521,2025-03-05,House,"House/ concurs with Senate amendment",72,0,0,3,75
1898437,1511387,2025-02-06,House,"House Comm - Substitute Recommendation",7,0,0,4,11
1898437,1511388,2025-02-06,House,"House Comm - Favorable Recommendation",8,0,0,3,11
1898437,1511389,2025-02-18,House,"House/ passed 3rd reading",66,0,0,9,75
1898437,1511390,2025-02-25,Senate,"Senate Comm - Substitute Recommendation",4,0,0,3,7
1898437,1511391,2025-02-25,Senate,"Senate Comm - Favorable Recommendation",3,0,0,4,7
1898437,1511392,2025-03-05,Senate,"Senate/ passed 2nd & 3rd readings/ suspension",25,0,0,4,29
1898437,1511393,2025-03-05,House,"House/ concurs with Senate amendment",74,0,0,1,75
1898529,1510020,2025-01-22,Senate,"Senate Comm - Favorable Recommendation",6,0,0,2,8
1898529,1510021,2025-01-23,Senate,"Senate/ passed 2nd reading",28,0,0,1,29
1898529,1510022,2025-01-24,Senate,"Senate/ passed 3rd reading",26,0,0,3,29
1898529,1510023,2025-01-31,House,"House Comm - Favorable Recommendation",12,0,0,4,16
1898529,1510024,2025-02-05,House,"House/ passed 3rd reading",70,0,0,5,75
1898622,1512397,2025-01-24,House,"House Comm - Substitute Recommendation",9,0,0,2,11
1898622,1512398,2025-01-24,House,"House Comm - Favorable Recommendation",9,0,0,2,11
1898622,1512399,2025-01-31,House,"House/ passed 3rd reading",73,0,0,2,75
1898622,1512400,2025-02-10,Senate,"Senate Comm - Favorable Recommendation",6,0,0,3,9
1898622,1512401,2025-02-13,Senate,"Senate/ passed 2nd reading",21,0,0,8,29
1898622,1512402,2025-02-14,Senate,"Senate/ passed 3rd reading",23,0,0,6,29
1898712,1514894,2025-01-28,House,"House/ passed 3rd reading",68,0,0,7,75
1898712,1514895,2025-02-03,Senate,"Senate Comm - Favorable Recommendation",6,0,0,1,7
1898712,1514896,2025-02-13,Senate,"Senate/ passed 2nd reading",27,0,0,2,29
1898712,1514897,2025-02-14,Senate,"Senate/ passed 3rd reading",21,0,0,8,29
1899722,1514507,2025-02-10,House,"House Comm - Substitute Recommendation",10,0,0,6,16
1899722,1514508,2025-02-10,House,"House Comm - Favorable Recommendation",10,0,0,6,16
1899722,1514509,2025-02-10,House,"House Comm - Consent Calendar Recommendation",10,0,0,6,16
1899722,1514510,2025-02-13,House,"House/ passed 3rd reading",66,1,0,8,75
1899722,1514511,2025-02-20,Senate,"Senate Comm - Favorable Recommendation",4,0,0,4,8
1899722,1514512,2025-02-27,Senate,"Senate/ passed 2nd reading",22,0,0,7,29
1899722,1514513,2025-02-28,Senate,"Senate/ passed 3rd reading",23,0,0,6,29
1899722,1514514,2025-03-03,House,"House/ concurs with Senate amendment",73,0,0,2,75
1899728,1510025,2025-01-28,House,"House/ passed 3rd reading",73,0,0,2,75
1899728,1510026,2025-01-31,Senate,"Senate Comm - Favorable Recommendation",4,0,0,4,8
1899728,1510027,2025-02-05,Senate,"Senate/ passed 2nd reading",25,0,0,4,29
1899728,1510028,2025-02-06,Senate,"Senate/ passed 3rd reading",23,0,0,6,29
1899734,1512368,2025-02-07,House,"House Comm - Substitute Recommendation",10,0,0,3,13
1899734,1512369,2025-02-07,House,"House Comm - Favorable Recommendation",10,0,0,3,13
1899734,1512370,2025-02-27,House,"House/ passed 3rd reading",69,1,0,5,75
1899734,1512371,2025-03-04,Senate,"Senate Comm - Amendment Recommendation",7,0,0,1,8
1899734,1512372,2025-03-04,Senate,"Senate Comm - Favorable Recommendation",5,1,0,2,8
1899734,1512373,2025-03-05,Senate,"Senate/ passed 2nd & 3rd readings/ suspension",22,1,0,6,29
1899734,1512374,2025-03-05,House,"House/ concurs with Senate amendment",65,2,0,8,75
1899741,1510029,2025-01-21,Senate,"Senate/ passed 2nd & 3rd readings/ suspension",25,0,0,4,29
1899741,1510030,2025-01-28,House,"House Comm - Favorable Recommendation",13,0,0,1,14
1899741,1510031,2025-02-05,House,"House/ passed 3rd reading",72,0,0,3,75
1899741,1510032,2025-02-07,Senate,"Senate/ concurs with House amendment",23,0,0,6,29
1899745,1513602,2025-01-22,House,"House Comm - Substitute Recommendation",10,0,0,3,13
1899745,1513603,2025-01-22,House,"House Comm - Favorable Recommendation",10,0,0,3,13
1899745,1513604,2025-01-29,House,"House/ passed 3rd reading",72,0,0,3,75
1899745,1513605,2025-02-03,Senate,"Senate Comm - Favorable Recommendation",4,0,0,3,7
1899745,1513606,2025-02-13,Senate,"Senate/ passed 2nd reading",27,0,0,2,29
1899745,1513607,2025-02-18,Senate,"Senate/ passed 3rd reading",27,0,0,2,29
1899745,1513608,2025-02-19,House,"House/ concurs with Senate amendment",54,18,0,3,75
1899751,1510033,2025-01-24,House,"House/ passed 3rd reading",70,0,0,5,75
1899751,1510034,2025-02-03,Senate,"Senate Comm - Favorable Recommendation",4,0,0,3,7
1899751,1510035,2025-02-13,Senate,"Senate/ passed 2nd reading",26,1,0,2,29
1899751,1510036,2025-03-03,Senate,"Senate/ passed 3rd reading",19,6,0,4,29
1899757,1510037,2025-01-22,Senate,"Senate Comm - Favorable Recommendation",6,0,0,2,8
1899757,1510038,2025-01-23,Senate,"Senate/ passed 2nd reading",28,0,0,1,29
1899757,1510039,2025-01-24,Senate,"Senate/ passed 3rd reading",25,0,0,4,29
1899757,1510040,2025-02-05,House,"House Comm - Substitute Recommendation",9,0,0,1,10
1899757,1510041,2025-02-05,House,"House Comm - Favorable Recommendation",9,0,0,1,10
1899757,1510042,2025-02-19,House,"House/ passed 3rd reading",68,0,0,7,75
1899757,1510043,2025-02-20,Senate,"Senate/ concurs with House amendment",25,0,0,4,29
1899763,1510044,2025-01-21,Senate,"Senate/ passed 2nd & 3rd readings/ suspension",26,0,0,3,29
1899763,1510045,2025-02-12,House,"House Comm - Favorable Recommendation",10,0,0,1,11
1899763,1510046,2025-02-20,House,"House/ passed 3rd reading",67,0,0,8,75
1899770,1514157,2025-01-29,Senate,"Senate Comm - Favorable Recommendation",5,0,0,2,7
1899770,1514158,2025-02-05,Senate,"Senate/ passed 2nd reading",27,0,0,2,29
1899770,1514159,2025-02-06,Senate,"Senate/ passed 3rd reading",27,1,0,1,29
1899770,1514160,2025-02-13,House,"House Comm - Favorable Recommendation",10,0,0,1,11
1899770,1514161,2025-03-05,House,"House/ failed",12,45,0,18,75
1899770,1514162,2025-03-05,House,"House/ passed 3rd reading",71,0,0,4,75
1899770,1514163,2025-03-06,Senate,"Senate/ concurs with House amendment",26,0,0,3,29
1899776,1510047,2025-01-28,House,"House/ passed 3rd reading",72,0,0,3,75
1899776,1510048,2025-02-06,Senate,"Senate Comm - Favorable Recommendation",3,0,0,4,7
1899776,1510049,2025-02-27,Senate,"Senate/ passed 2nd reading",22,0,0,7,29
1899776,1510050,2025-02-28,Senate,"Senate/ passed 3rd reading",25,0,0,4,29
1899781,1510051,2025-01-29,House,"House/ passed 3rd reading",71,0,0,4,75
1899781,1510052,2025-02-10,Senate,"Senate Comm - Favorable Recommendation",6,0,0,3,9
1899781,1510053,2025-02-19,Senate,"Senate/ passed 2nd reading",18,0,0,11,29
1899781,1510054,2025-02-20,Senate,"Senate/ passed 3rd reading",21,0,0,8,29
1899787,1510055,2025-01-21,Senate,"Senate/ passed 2nd & 3rd readings/ suspension",26,0,0,3,29
1899787,1510056,2025-01-27,House,"House Comm - Substitute Recommendation",11,0,0,0,11
1899787,1510057,2025-01-27,House,"House Comm - Favorable Recommendation",11,0,0,0,11
1899787,1510058,2025-02-19,House,"House/ passed 3rd reading",67,0,0,8,75
1899787,1510059,2025-02-20,Senate,"Senate/ concurs with House amendment",25,0,0,4,29
1899792,1510060,2025-01-27,Senate,"Senate Comm - Favorable Recommendation",4,0,0,3,7
1899792,1510061,2025-02-06,Senate,"Senate/ passed 2nd reading",23,0,0,6,29
1899792,1510062,2025-02-07,Senate,"Senate/ passed 3rd reading",26,0,0,3,29
1899792,1510063,2025-02-13,House,"House Comm - Favorable Recommendation",9,0,0,7,16
1899792,1510064,2025-02-20,House,"House/ passed 3rd reading",68,0,0,7,75
1899798,1510065,2025-02-28,House,"House Comm - Substitute Recommendation",9,0,0,4,13
1899798,1510066,2025-02-28,House,"House Comm - Favorable Recommendation",10,0,0,3,13
1899798,1510067,2025-03-03,House,"House/ passed 3rd reading",71,0,0,4,75
1899798,1510068,2025-03-05,Senate,"Senate/ passed 2nd & 3rd readings/ suspension",27,0,0,2,29
1899798,1510069,2025-03-06,House,"House/ concurs with Senate amendment",72,0,0,3,75
1899804,1512251,2025-01-22,House,"House Comm - Favorable Recommendation",9,1,0,3,13
1899804,1512252,2025-01-29,House,"House/ passed 3rd reading",67,0,0,8,75
1899977,1510070,2025-01-22,Senate,"Senate Comm - Amendment Recommendation",5,0,0,3,8
1899977,1510071,2025-01-22,Senate,"Senate Comm - Favorable Recommendation",5,0,0,3,8
1899977,1510072,2025-01-23,Senate,"Senate/ passed 2nd reading",28,0,0,1,29
1899977,1510073,2025-01-27,Senate,"Senate/ passed 3rd reading",25,0,0,4,29
1899977,1510074,2025-02-05,House,"House Comm - Favorable Recommendation",14,0,0,2,16
1899977,1510075,2025-02-12,House,"House/ passed 3rd reading",71,0,0,4,75
1900943,1510076,2025-01-24,Senate,"Senate Comm - Favorable Recommendation",4,0,0,3,7
1900943,1510077,2025-01-31,Senate,"Senate/ passed 2nd reading",26,0,0,3,29
1900943,1510078,2025-02-03,Senate,"Senate/ passed 3rd reading",27,0,0,2,29
1900943,1510079,2025-02-07,House,"House Comm - Favorable Recommendation",5,0,0,5,10
1900943,1510080,2025-02-19,House,"House/ passed 3rd reading",69,0,0,6,75
1901067,1513743,2025-02-14,House,"House Comm - Held",8,0,0,3,11
1901069,1510081,2025-02-13,House,"House Comm - Substitute Recommendation",12,2,0,2,16
1901069,1510082,2025-02-13,House,"House Comm - Amendment Recommendation",14,0,0,2,16
1901069,1510083,2025-02-13,House,"House Comm - Amendment Recommendation",14,0,0,2,16
1901069,1510084,2025-02-13,House,"House Comm - Favorable Recommendation",11,2,0,3,16
1901069,1510085,2025-02-21,House,"House/ passed 3rd reading",49,20,0,6,75
1901069,1510086,2025-02-28,Senate,"Senate Comm - Amendment Recommendation",3,0,0,4,7
1901069,1510087,2025-02-28,Senate,"Senate Comm - Favorable Recommendation",4,1,0,2,7
1901069,1510088,2025-03-06,Senate,"Senate/ passed 2nd & 3rd readings/ suspension",21,8,0,0,29
1901069,1510089,2025-03-06,House,"House/ concurs with Senate amendment",53,20,0,2,75
1901072,1510090,2025-02-04,House,"House Comm - Favorable Recommendation",11,0,0,0,11
1901072,1510091,2025-02-13,House,"House/ passed 3rd reading",70,0,0,5,75
1901072,1510092,2025-02-20,Senate,"Senate Comm - Favorable Recommendation",3,0,0,4,7
1901072,1510093,2025-02-26,Senate,"Senate/ passed 2nd reading",20,0,0,9,29
1901072,1510094,2025-03-05,Senate,"Senate/ passed 2nd & 3rd readings/ suspension",24,0,0,5,29
1901076,1510095,2025-02-05,House,"House Comm - Amendment Recommendation",12,0,0,4,16
1901076,1510096,2025-02-05,House,"House Comm - Favorable Recommendation",12,0,0,4,16
1901076,1510097,2025-02-14,House,"House/ passed 3rd reading",71,0,0,4,75
1901076,1510098,2025-02-20,Senate,"Senate Comm - Favorable Recommendation",5,0,0,2,7
1901076,1510099,2025-02-27,Senate,"Senate/ passed 2nd reading",26,0,0,3,29
1901076,1510100,2025-02-28,Senate,"Senate/ passed 3rd reading",23,0,0,6,29
1901076,1510101,2025-03-03,House,"House/ concurs with Senate amendment",71,0,0,4,75
1901080,1510102,2025-02-20,House,"House Comm - Substitute Recommendation",7,0,0,3,10
1901080,1510103,2025-02-20,House,"House Comm - Motion to Recommend Failed",2,5,0,3,10
1901080,1510104,2025-02-28,House,"House Comm - Substitute Recommendation",7,0,0,3,10
1901080,1510105,2025-02-28,House,"House Comm - Favorable Recommendation",7,0,0,3,10
1901080,1510106,2025-03-03,House,"House/ passed 3rd reading",72,0,0,3,75
1901080,1510107,2025-03-07,Senate,"Senate/ passed 2nd & 3rd readings/ suspension",24,0,0,5,29
1901082,1512000,2025-01-24,House,"House Comm - Favorable Recommendation",10,0,0,2,12
1901082,1512001,2025-02-04,House,"House/ passed 3rd reading",64,1,0,10,75
1901082,1512002,2025-02-25,Senate,"Senate Comm - Amendment Recommendation",6,0,0,3,9
1901082,1512003,2025-02-25,Senate,"Senate Comm - Favorable Recommendation",5,0,0,4,9
1901082,1512004,2025-03-07,Senate,"Senate/ passed 2nd & 3rd readings/ suspension",25,0,0,4,29
1901082,1512005,2025-03-07,House,"House/ concurs with Senate amendment",65,0,0,10,75
1901087,1510108,2025-01-29,House,"House Comm - Substitute Recommendation",13,0,0,1,14
1901087,1510109,2025-01-29,House,"House Comm - Favorable Recommendation",10,3,0,1,14
1901087,1510110,2025-02-07,House,"House/ passed 3rd reading",51,19,0,5,75
1901087,1510111,2025-02-13,Senate,"Senate Comm - Favorable Recommendation",5,1,0,1,7
1901087,1510112,2025-02-20,Senate,"Senate/ passed 2nd reading",20,5,0,4,29
1901087,1510113,2025-02-21,Senate,"Senate/ passed 3rd reading",18,8,0,3,29
1901090,1511251,2025-02-06,Senate,"Senate Comm - Substitute Recommendation",4,0,0,3,7
1901090,1511252,2025-02-06,Senate,"Senate Comm - Favorable Recommendation",5,0,0,2,7
1901090,1511253,2025-02-18,Senate,"Senate/ passed 2nd reading",20,2,0,7,29
1901090,1511254,2025-02-19,Senate,"Senate/ passed 3rd reading",23,1,0,5,29
1901090,1511255,2025-02-26,House,"House Comm - Favorable Recommendation",9,0,0,3,12
1901090,1511256,2025-03-06,House,"House/ passed 3rd reading",66,6,0,3,75
1901092,1510114,2025-02-03,House,"House Comm - Favorable Recommendation",9,0,0,2,11
1901092,1510115,2025-02-11,House,"House/ passed 3rd reading",73,0,0,2,75
1901092,1510116,2025-02-21,Senate,"Senate Comm - Amendment Recommendation",5,0,0,4,9
1901092,1510117,2025-02-21,Senate,"Senate Comm - Favorable Recommendation",4,0,0,5,9
1901092,1510118,2025-03-05,Senate,"Senate/ passed 2nd & 3rd readings/ suspension",20,0,0,9,29
1901092,1510119,2025-03-05,House,"House/ concurs with Senate amendment",72,0,0,3,75
1901100,1510120,2025-02-07,Senate,"Senate Comm - Substitute Recommendation",3,0,0,4,7
1901100,1510121,2025-02-07,Senate,"Senate Comm - Favorable Recommendation",4,0,0,3,7
1901100,1510122,2025-02-18,Senate,"Senate/ passed 2nd reading",24,0,0,5,29
1901100,1510123,2025-02-19,Senate,"Senate/ passed 3rd reading",25,0,0,4,29
1901100,1510124,2025-02-28,House,"House Comm - Favorable Recommendation",10,0,0,4,14
1901100,1510125,2025-03-05,House,"House/ passed 3rd reading",72,0,0,3,75
1901102,1512459,2025-01-21,Senate,"Senate/ passed 2nd & 3rd readings/ suspension",25,1,0,3,29
1901102,1512460,2025-01-30,House,"House Comm - Favorable Recommendation",11,0,0,2,13
1901102,1512461,2025-02-05,House,"House/ passed 3rd reading",67,0,0,8,75
1901106,1510126,2025-01-24,House,"House Comm - Amendment Recommendation",9,0,0,2,11
1901106,1510127,2025-01-24,House,"House Comm - Favorable Recommendation",9,0,0,2,11
1901106,1510128,2025-01-31,House,"House/ passed 3rd reading",72,0,0,3,75
1901106,1510129,2025-02-13,Senate,"Senate Comm - Favorable Recommendation",7,0,0,2,9
1901106,1510130,2025-02-26,Senate,"Senate/ passed 2nd reading",22,0,0,7,29
1901106,1510131,2025-02-27,Senate,"Senate/ passed 3rd reading",22,0,0,7,29
1901108,1515119,2025-01-24,House,"House Comm - Substitute Recommendation",12,0,0,2,14
1901108,1515120,2025-01-24,House,"House Comm - Favorable Recommendation",10,2,0,2,14
1901108,1515121,2025-02-04,House,"House/ passed 3rd reading",64,9,0,2,75
1901108,1515122,2025-02-18,Senate,"Senate Comm - Favorable Recommendation",2,1,0,4,7
1901108,1515123,2025-02-19,Senate,"Senate/ passed 2nd reading",17,4,0,8,29
1901108,1515124,2025-03-05,Senate,"Senate/ passed 2nd & 3rd readings/ suspension",23,1,0,5,29
1901111,1511457,2025-01-21,Senate,"Senate/ passed 2nd & 3rd readings/ suspension",25,0,0,4,29
1901111,1511458,2025-02-06,House,"House Comm - Favorable Recommendation",9,0,0,5,14
1901111,1511459,2025-02-13,House,"House/ passed 3rd reading",69,0,0,6,75
1901117,1510132,2025-01-31,House,"House Comm - Substitute Recommendation",12,0,0,2,14
1901117,1510133,2025-01-31,House,"House Comm - Favorable Recommendation",13,0,0,1,14
1901117,1510134,2025-02-10,House,"House/ passed 3rd reading",73,0,0,2,75
1901117,1510135,2025-02-19,Senate,"Senate Comm - Amendment Recommendation",4,0,0,3,7
1901117,1510136,2025-02-19,Senate,"Senate Comm - Favorable Recommendation",3,2,0,2,7
1901117,1510137,2025-02-26,Senate,"Senate/ passed 2nd reading",17,4,0,8,29
1901117,1510138,2025-02-27,Senate,"Senate/ passed 3rd reading",19,5,0,5,29
1901117,1510139,2025-02-28,House,"House/ concurs with Senate amendment",65,2,0,8,75
1901120,1510140,2025-01-22,Senate,"Senate Comm - Substitute Recommendation",6,0,0,2,8
1901120,1510141,2025-01-22,Senate,"Senate Comm - Favorable Recommendation",6,0,0,2,8
1901120,1510142,2025-01-23,Senate,"Senate/ passed 2nd reading",26,0,0,3,29
1901120,1510143,2025-02-03,Senate,"Senate/ passed 3rd reading",27,0,0,2,29
1901120,1510144,2025-02-12,House,"House Comm - Favorable Recommendation",10,1,0,0,11
1901120,1510145,2025-02-19,House,"House/ passed 3rd reading",63,2,0,10,75
1901121,1512495,2025-01-30,Senate,"Senate Comm - Substitute Recommendation",4,0,0,4,8
1901121,1512496,2025-01-30,Senate,"Senate Comm - Favorable Recommendation",4,0,0,4,8
1901123,1514831,2025-01-24,Senate,"Senate Comm - Favorable Recommendation",6,0,0,1,7
1901123,1514832,2025-02-06,Senate,"Senate/ passed 2nd reading",20,0,0,9,29
1901123,1514833,2025-02-07,Senate,"Senate/ passed 3rd reading",22,3,0,4,29
1901123,1514834,2025-02-13,House,"House Comm - Favorable Recommendation",9,0,0,4,13
1901123,1514835,2025-02-19,House,"House/ passed 3rd reading",65,2,0,8,75
1901261,1510146,2025-01-23,Senate,"Senate Comm - Favorable Recommendation",6,0,0,2,8
1901261,1510147,2025-01-27,Senate,"Senate/ passed 2nd reading",29,0,0,0,29
1901261,1510148,2025-01-28,Senate,"Senate/ passed 3rd reading",28,0,0,1,29
1901261,1510149,2025-02-03,House,"House Comm - Favorable Recommendation",12,0,0,0,12
1901261,1510150,2025-02-06,House,"House/ passed 3rd reading",73,0,0,2,75
1901510,1510151,2025-01-23,House,"House Comm - Substitute Recommendation",13,0,0,3,16
1901510,1510152,2025-01-23,House,"House Comm - Favorable Recommendation",13,0,0,3,16
1901510,1510153,2025-01-30,House,"House/ passed 3rd reading",73,0,0,2,75
1901510,1510154,2025-02-04,Senate,"Senate Comm - Favorable Recommendation",5,0,0,2,7
1901510,1510155,2025-02-04,Senate,"Senate Comm - Consent Calendar Recommendation",5,0,0,2,7
1901510,1510156,2025-02-10,Senate,"Senate/ passed 3rd reading",24,0,0,5,29
1901518,1510157,2025-01-28,House,"House Comm - Favorable Recommendation",8,0,0,2,10
1901518,1510158,2025-02-06,House,"House/ passed 3rd reading",72,0,0,3,75
1901518,1510159,2025-02-14,Senate,"Senate Comm - Favorable Recommendation",3,0,0,3,6
1901518,1510160,2025-02-14,Senate,"Senate Comm - Consent Calendar Recommendation",3,0,0,3,6
1901518,1510161,2025-02-20,Senate,"Senate/ passed 3rd reading",23,0,0,6,29
1901525,1512476,2025-01-27,Senate,"Senate Comm - Favorable Recommendation",3,0,0,4,7
1901525,1512477,2025-02-10,Senate,"Senate/ passed 2nd reading",22,4,0,3,29
1901525,1512478,2025-02-11,Senate,"Senate/ passed 3rd reading",19,7,0,3,29
1901532,1510162,2025-01-29,House,"House Comm - Substitute Recommendation",9,0,0,2,11
1901532,1510163,2025-01-29,House,"House Comm - Amendment Recommendation",9,0,0,2,11
1901532,1510164,2025-01-29,House,"House Comm - Favorable Recommendation",9,0,0,2,11
1901532,1510165,2025-02-07,House,"House/ passed 3rd reading",71,0,0,4,75
1901532,1510166,2025-02-21,Senate,"Senate Comm - Favorable Recommendation",5,0,0,4,9
1901532,1510167,2025-03-04,Senate,"Senate/ passed 2nd & 3rd readings/ suspension",26,0,0,3,29
1901541,1512803,2025-02-06,House,"House Comm - Substitute Recommendation",8,0,0,3,11
1901541,1512804,2025-02-06,House,"House Comm - Favorable Recommendation",8,0,0,3,11
1901541,1512805,2025-02-18,House,"House/ passed 3rd reading",69,0,0,6,75
1901541,1512806,2025-02-25,Senate,"Senate Comm - Favorable Recommendation",6,0,0,3,9
1901541,1512807,2025-03-06,Senate,"Senate/ passed 2nd & 3rd readings/ suspension",24,0,0,5,29
1901548,1510168,2025-01-23,House,"House Comm - Favorable Recommendation",13,0,0,3,16
1901548,1510169,2025-01-30,House,"House/ passed 3rd reading",72,0,0,3,75
1901548,1510170,2025-02-04,Senate,"Senate Comm - Favorable Recommendation",5,0,0,2,7
1901548,1510171,2025-02-13,Senate,"Senate/ passed 2nd reading",28,0,0,1,29
1901548,1510172,2025-02-14,Senate,"Senate/ passed 3rd reading",22,0,0,7,29
1901556,1510173,2025-01-29,House,"House Comm - Substitute Recommendation",12,0,0,2,14
1901556,1510174,2025-01-29,House,"House Comm - Favorable Recommendation",13,0,0,1,14
1901556,1510175,2025-02-07,House,"House/ passed 3rd reading",71,0,0,4,75
1901556,1510176,2025-02-13,Senate,"Senate Comm - Favorable Recommendation",3,0,0,4,7
1901556,1510177,2025-02-27,Senate,"Senate/ passed 2nd reading",24,0,0,5,29
1901556,1510178,2025-02-28,Senate,"Senate/ passed 3rd reading",23,0,0,6,29
1901563,1513943,2025-01-28,Senate,"Senate Comm - Substitute Recommendation",7,0,0,1,8
1901563,1513944,2025-01-28,Senate,"Senate Comm - Favorable Recommendation",7,0,0,1,8
1901563,1513945,2025-02-07,Senate,"Senate/ passed 2nd reading",23,2,0,4,29
1901563,1513946,2025-02-10,Senate,"Senate/ passed 3rd reading",24,0,0,5,29
1901563,1513947,2025-02-20,House,"House Comm - Favorable Recommendation",8,1,0,4,13
1901563,1513948,2025-02-26,House,"House/ passed 3rd reading",63,6,0,6,75
1901563,1513949,2025-02-28,Senate,"Senate/ concurs with House amendment",25,0,0,4,29
1901569,1510179,2025-01-27,Senate,"Senate Comm - Amendment Recommendation",5,0,0,2,7
1901569,1510180,2025-01-27,Senate,"Senate Comm - Favorable Recommendation",5,0,0,2,7
1901569,1510181,2025-02-04,Senate,"Senate/ passed 2nd reading",25,0,0,4,29
1901569,1510182,2025-02-24,Senate,"Senate/ passed 3rd reading",23,0,0,6,29
1901569,1510183,2025-02-28,House,"House Comm - Favorable Recommendation",11,0,0,3,14
1901569,1510184,2025-02-28,House,"House Comm - Consent Calendar Recommendation",11,0,0,3,14
1901569,1510185,2025-03-05,House,"House/ passed 3rd reading",66,3,0,6,75
1901578,1510186,2025-01-29,House,"House Comm - Favorable Recommendation",10,0,0,4,14
1901578,1510187,2025-02-07,House,"House/ passed 3rd reading",72,0,0,3,75
1901578,1510188,2025-02-13,Senate,"Senate Comm - Favorable Recommendation",3,0,0,4,7
1901578,1510189,2025-02-19,Senate,"Senate/ passed 2nd reading",19,0,0,10,29
1901578,1510190,2025-02-20,Senate,"Senate/ passed 3rd reading",23,0,0,6,29
1901586,1512502,2025-01-31,Senate,"Senate Comm - Favorable Recommendation",6,0,0,1,7
1901586,1512503,2025-02-10,Senate,"Senate/ passed 2nd reading",25,0,0,4,29
1901586,1512504,2025-02-19,Senate,"Senate/ passed 3rd reading",24,0,0,5,29
1901593,1510191,2025-01-28,House,"House Comm - Favorable Recommendation",13,0,0,1,14
1901593,1510192,2025-02-06,House,"House/ passed 3rd reading",70,0,0,5,75
1901593,1510193,2025-02-19,Senate,"Senate Comm - Favorable Recommendation",4,0,0,3,7
1901593,1510194,2025-02-26,Senate,"Senate/ passed 2nd reading",20,0,0,9,29
1901593,1510195,2025-02-27,Senate,"Senate/ passed 3rd reading",22,0,0,7,29
1901601,1512017,2025-02-07,House,"House Comm - Held",6,1,0,3,10
1901608,1513494,2025-01-30,Senate,"Senate Comm - Substitute Recommendation",4,0,0,3,7
1901608,1513495,2025-01-30,Senate,"Senate Comm - Favorable Recommendation",4,0,0,3,7
1901608,1513496,2025-02-10,Senate,"Senate/ passed 2nd reading",23,2,0,4,29
1901608,1513497,2025-02-11,Senate,"Senate/ passed 3rd reading",21,6,0,2,29
1901608,1513498,2025-02-18,House,"House Comm - Substitute Recommendation",11,0,0,3,14
1901608,1513499,2025-02-18,House,"House Comm - Favorable Recommendation",11,0,0,3,14
1901608,1513500,2025-02-26,House,"House/ passed 3rd reading",69,0,0,6,75
1901608,1513501,2025-02-28,Senate,"Senate/ concurs with House amendment",24,1,0,4,29
1901617,1513362,2025-01-23,Senate,"Senate Comm - Substitute Recommendation",3,0,0,5,8
1901617,1513363,2025-01-23,Senate,"Senate Comm - Favorable Recommendation",6,0,0,2,8
1901617,1513364,2025-01-27,Senate,"Senate/ passed 2nd reading",28,0,0,1,29
1901617,1513365,2025-01-28,Senate,"Senate/ passed 3rd reading",27,1,0,1,29
1901617,1513366,2025-02-06,House,"House Comm - Favorable Recommendation",11,0,0,1,12
1901617,1513367,2025-03-07,House,"House/ passed 3rd reading",63,8,0,4,75
1901617,1513368,2025-03-07,Senate,"Senate/ concurs with House amendment",25,1,0,3,29
1901623,1510196,2025-01-27,House,"House Comm - Substitute Recommendation",11,0,0,2,13
1901623,1510197,2025-01-27,House,"House Comm - Favorable Recommendation",10,1,0,2,13
1901623,1510198,2025-02-10,House,"House/ passed 3rd reading",74,0,0,1,75
1901623,1510199,2025-02-18,Senate,"Senate Comm - Favorable Recommendation",3,0,0,4,7
1901623,1510200,2025-02-20,Senate,"Senate/ passed 2nd reading",21,0,0,8,29
1901623,1510201,2025-02-21,Senate,"Senate/ passed 3rd reading",25,0,0,4,29
1901631,1510202,2025-01-28,House,"House Comm - Favorable Recommendation",10,0,0,6,16
1901631,1510203,2025-02-06,House,"House/ passed 3rd reading",73,0,0,2,75
1901631,1510204,2025-02-14,Senate,"Senate Comm - Favorable Recommendation",4,0,0,2,6
1901631,1510205,2025-02-19,Senate,"Senate/ passed 2nd reading",22,0,0,7,29
1901631,1510206,2025-02-28,Senate,"Senate/ passed 3rd reading",26,0,0,3,29
1901639,1511954,2025-02-07,House,"House Comm - Held",7,1,0,2,10
1901645,1512797,2025-01-29,House,"House Comm - Favorable Recommendation",10,0,0,1,11
1901645,1512798,2025-02-07,House,"House/ passed 3rd reading",46,24,0,5,75
1901645,1512799,2025-02-21,Senate,"Senate Comm - Substitute Recommendation",4,0,0,5,9
1901645,1512800,2025-02-21,Senate,"Senate Comm - Favorable Recommendation",4,0,0,5,9
1901645,1512801,2025-03-07,Senate,"Senate/ passed 2nd & 3rd readings/ suspension",26,1,0,2,29
1901645,1512802,2025-03-07,House,"House/ concurs with Senate amendment",63,11,0,1,75
1902444,1515056,2025-02-14,House,"House Comm - Substitute Recommendation",9,0,0,1,10
1902444,1515057,2025-02-14,House,"House Comm - Favorable Recommendation",9,0,0,1,10
1902444,1515058,2025-02-24,House,"House/ passed 3rd reading",61,8,0,6,75
1902444,1515059,2025-03-04,Senate,"Senate Comm - Favorable Recommendation",5,1,0,2,8
1902444,1515060,2025-03-06,Senate,"Senate/ passed 2nd & 3rd readings/ suspension",24,1,0,4,29
1902532,1510207,2025-02-18,House,"House Comm - Substitute Recommendation",11,0,0,5,16
1902532,1510208,2025-02-18,House,"House Comm - Amendment Recommendation",11,0,0,5,16
1902532,1510209,2025-02-18,House,"House Comm - Favorable Recommendation",8,3,0,5,16
1902532,1510210,2025-02-24,House,"House/ passed 3rd reading",53,14,0,8,75
1902532,1510211,2025-03-03,Senate,"Senate Comm - Substitute Recommendation",5,0,0,2,7
1902532,1510212,2025-03-03,Senate,"Senate Comm - Favorable Recommendation",5,0,0,2,7
1902532,1510213,2025-03-05,Senate,"Senate/ passed 2nd & 3rd readings/ suspension",26,0,0,3,29
1902532,1510214,2025-03-06,House,"House/ concurs with Senate amendment",47,24,0,4,75
1902634,1513065,2025-01-24,House,"House Comm - Substitute Recommendation",9,0,0,2,11
1902634,1513066,2025-01-24,House,"House Comm - Favorable Recommendation",9,0,0,2,11
1902634,1513067,2025-02-03,House,"House/ passed 3rd reading",74,0,0,1,75
1902634,1513068,2025-02-13,Senate,"Senate Comm - Held",7,0,0,2,9
1902634,1513069,2025-02-21,Senate,"Senate Comm - Favorable Recommendation",5,0,0,4,9
1902634,1513070,2025-03-05,Senate,"Senate/ passed 2nd & 3rd readings/ suspension",27,0,0,2,29
1902831,1514058,2025-01-23,House,"House Comm - Held",11,2,0,3,16
1902831,1514059,2025-02-05,House,"House Comm - Substitute Recommendation",10,0,0,6,16
1902831,1514060,2025-02-05,House,"House Comm - Amendment Recommendation",10,0,0,6,16
1902831,1514061,2025-02-05,House,"House Comm - Amendment Recommendation",6,5,0,5,16
1902831,1514062,2025-02-05,House,"House Comm - Favorable Recommendation",9,2,0,5,16
1902831,1514063,2025-02-14,House,"House/ passed 3rd reading",59,10,0,6,75
1902831,1514064,2025-02-26,Senate,"Senate Comm - Favorable Recommendation",4,1,0,2,7
1902831,1514065,2025-03-07,Senate,"Senate/ passed 2nd & 3rd readings/ suspension",18,1,0,10,29
1902831,1514066,2025-03-07,Senate,"Senate Conference Committee - Final Passage",19,6,0,4,29
1902831,1514067,2025-03-07,House,"House Conference Committee - Final Passage",63,8,0,4,75
1902936,1513699,2025-01-31,House,"House Comm - Held",4,3,0,0,7
1902936,1513700,2025-02-12,House,"House Comm - Substitute Recommendation",7,0,0,0,7
1902936,1513701,2025-02-12,House,"House Comm - Favorable Recommendation",7,0,0,0,7
1902936,1513702,2025-02-19,House,"House/ passed 3rd reading",71,0,0,4,75
1902936,1513703,2025-02-21,Senate,"Senate Comm - Amendment Recommendation",6,0,0,3,9
1902936,1513704,2025-02-21,Senate,"Senate Comm - Motion to Recommend Failed",4,5,0,0,9
1902963,1513320,2025-01-29,Senate,"Senate Comm - Substitute Recommendation",5,0,0,2,7
1902963,1513321,2025-01-29,Senate,"Senate Comm - Favorable Recommendation",5,0,0,2,7
1902963,1513322,2025-02-04,Senate,"Senate/ passed 2nd reading",23,0,0,6,29
1902963,1513323,2025-02-05,Senate,"Senate/ passed 3rd reading",26,0,0,3,29
1902963,1513324,2025-03-03,House,"House Comm - Amendment Recommendation",11,0,0,0,11
1902963,1513325,2025-03-03,House,"House Comm - Favorable Recommendation",11,0,0,0,11
1902963,1513326,2025-03-07,House,"House/ passed 3rd reading",66,4,0,5,75
1902984,1510215,2025-01-24,House,"House Comm - Substitute Recommendation",9,0,0,3,12
1902984,1510216,2025-01-24,House,"House Comm - Favorable Recommendation",9,0,0,3,12
1902984,1510217,2025-02-05,House,"House/ passed 3rd reading",69,1,0,5,75
1902984,1510218,2025-02-25,Senate,"Senate Comm - Favorable Recommendation",5,0,0,3,8
1902984,1510219,2025-02-25,Senate,"Senate Comm - Consent Calendar Recommendation",5,0,0,3,8
1902984,1510220,2025-03-03,Senate,"Senate/ passed 3rd reading",26,0,0,3,29
1903004,1512906,2025-01-31,House,"House Comm - Favorable Recommendation",7,0,0,0,7
1903004,1512907,2025-01-31,House,"House Comm - Consent Calendar Recommendation",7,0,0,0,7
1903004,1512908,2025-02-05,House,"House/ passed 3rd reading",71,0,0,4,75
1903004,1512909,2025-02-21,Senate,"Senate Comm - Held",9,0,0,0,9
1903028,1514182,2025-01-27,House,"House Comm - Held",8,2,0,0,10
1903052,1510221,2025-01-22,House,"House Comm - Favorable Recommendation",7,0,0,3,10
1903052,1510222,2025-01-29,House,"House/ passed 3rd reading",70,0,0,5,75
1903052,1510223,2025-02-06,Senate,"Senate Comm - Favorable Recommendation",3,0,0,4,7
1903052,1510224,2025-02-13,Senate,"Senate/ passed 2nd reading",23,0,0,6,29
1903052,1510225,2025-02-14,Senate,"Senate/ passed 3rd reading",15,8,0,6,29
1903076,1510226,2025-02-25,House,"House Comm - Substitute Recommendation",10,0,0,1,11
1903076,1510227,2025-02-25,House,"House Comm - Favorable Recommendation",8,2,0,1,11
1903076,1510228,2025-02-27,House,"House/ passed 3rd reading",61,11,0,3,75
1903076,1510229,2025-03-04,Senate,"Senate Comm - Substitute Recommendation",4,0,0,3,7
1903076,1510230,2025-03-04,Senate,"Senate Comm - Favorable Recommendation",4,0,0,3,7
1903076,1510231,2025-03-05,Senate,"Senate/ passed 2nd & 3rd readings/ suspension",23,6,0,0,29
1903076,1510232,2025-03-05,House,"House/ concurs with Senate amendment",58,13,0,4,75
1903098,1512996,2025-02-07,House,"House Comm - Amendment Recommendation",11,0,0,0,11
1903098,1512997,2025-02-07,House,"House Comm - Held",11,0,0,0,11
1903119,1512851,2025-02-19,House,"House Comm - Substitute Recommendation",11,0,0,0,11
1903119,1512852,2025-02-19,House,"House Comm - Favorable Recommendation",7,4,0,0,11
1903119,1512853,2025-02-25,House,"House/ passed 3rd reading",50,18,0,7,75
1903119,1512854,2025-03-03,Senate,"Senate Comm - Favorable Recommendation",4,1,0,2,7
1903119,1512855,2025-03-07,Senate,"Senate/ passed 2nd & 3rd readings/ suspension",21,5,0,3,29
1903142,1510233,2025-02-04,House,"House Comm - Favorable Recommendation",8,0,0,2,10
1903142,1510234,2025-02-11,House,"House/ passed 3rd reading",42,31,0,2,75
1903142,1510235,2025-02-26,Senate,"Senate Comm - Favorable Recommendation",5,0,0,3,8
1903142,1510236,2025-02-26,Senate,"Senate Comm - Consent Calendar Recommendation",5,0,0,3,8
1903142,1510237,2025-03-04,Senate,"Senate/ passed 3rd reading",19,10,0,0,29
1903164,1513130,2025-01-29,House,"House Comm - Favorable Recommendation",11,0,0,3,14
1903164,1513131,2025-02-07,House,"House/ passed 3rd reading",73,0,0,2,75
1903164,1513132,2025-02-19,Senate,"Senate Comm - Favorable Recommendation",5,0,0,2,7
1903164,1513133,2025-02-27,Senate,"Senate/ passed 2nd reading",24,0,0,5,29
1903164,1513134,2025-03-03,Senate,"Senate/ passed 3rd reading",25,0,0,4,29
1903189,1510238,2025-01-22,House,"House Comm - Favorable Recommendation",7,0,0,3,10
1903189,1510239,2025-01-29,House,"House/ passed 3rd reading",68,0,0,7,75
1903189,1510240,2025-02-04,Senate,"Senate Comm - Favorable Recommendation",5,0,0,3,8
1903189,1510241,2025-02-13,Senate,"Senate/ passed 2nd reading",27,0,0,2,29
1903189,1510242,2025-02-14,Senate,"Senate/ passed 3rd reading",21,0,0,8,29
1903260,1510243,2025-01-22,Senate,"Senate Comm - Favorable Recommendation",5,0,0,2,7
1903260,1510244,2025-01-27,Senate,"Senate/ passed 2nd reading",24,0,0,5,29
1903260,1510245,2025-01-28,Senate,"Senate/ passed 3rd reading",26,0,0,3,29
1903260,1510246,2025-02-10,House,"House Comm - Favorable Recommendation",10,0,0,6,16
1903260,1510247,2025-02-19,House,"House/ passed 3rd reading",65,0,0,10,75
1903280,1514885,2025-01-29,House,"House Comm - Amendment Recommendation",9,0,0,2,11
1903280,1514886,2025-01-29,House,"House Comm - Favorable Recommendation",9,0,0,2,11
1903280,1514887,2025-02-06,House,"House/ passed 3rd reading",70,0,0,5,75
1903280,1514888,2025-02-13,Senate,"Senate Comm - Amendment Recommendation",6,0,0,3,9
1903280,1514889,2025-02-13,Senate,"Senate Comm - Motion to Recommend Failed",3,3,0,3,9
1903304,1510248,2025-01-31,House,"House Comm - Favorable Recommendation",8,0,0,2,10
1903304,1510249,2025-02-10,House,"House/ passed 3rd reading",73,0,0,2,75
1903304,1510250,2025-02-19,Senate,"Senate Comm - Favorable Recommendation",5,0,0,3,8
1903304,1510251,2025-02-20,Senate,"Senate/ passed 2nd reading",23,0,0,6,29
1903304,1510252,2025-02-21,Senate,"Senate/ passed 3rd reading",23,0,0,6,29
1903323,1510253,2025-01-28,House,"House Comm - Favorable Recommendation",8,2,0,6,16
1903323,1510254,2025-02-06,House,"House/ passed 3rd reading",74,0,0,1,75
1903323,1510255,2025-02-19,Senate,"Senate Comm - Favorable Recommendation",6,0,0,2,8
1903323,1510256,2025-02-26,Senate,"Senate/ passed 2nd reading",20,0,0,9,29
1903323,1510257,2025-02-27,Senate,"Senate/ passed 3rd reading",22,0,0,7,29
1904329,1511972,2025-01-23,House,"House Comm - Substitute Recommendation",14,0,0,0,14
1904329,1511973,2025-01-23,House,"House Comm - Held",14,0,0,0,14
1904352,1510258,2025-01-27,Senate,"Senate Comm - Favorable Recommendation",6,0,0,2,8
1904352,1510259,2025-02-06,Senate,"Senate/ passed 2nd reading",22,0,0,7,29
1904352,1510260,2025-02-07,Senate,"Senate/ passed 3rd reading",25,0,0,4,29
1904352,1510261,2025-02-25,House,"House Comm - Favorable Recommendation",13,0,0,3,16
1904352,1510262,2025-02-25,House,"House Comm - Consent Calendar Recommendation",13,0,0,3,16
1904352,1510263,2025-02-28,House,"House/ passed 3rd reading",68,0,0,7,75
1904403,1510264,2025-01-29,House,"House Comm - Favorable Recommendation",9,1,0,1,11
1904403,1510265,2025-02-07,House,"House/ passed 3rd reading",72,0,0,3,75
1904403,1510266,2025-02-13,Senate,"Senate Comm - Substitute Recommendation",4,0,0,3,7
1904403,1510267,2025-02-13,Senate,"Senate Comm - Favorable Recommendation",4,0,0,3,7
1904403,1510268,2025-02-19,Senate,"Senate/ passed 2nd reading",19,0,0,10,29
1904403,1510269,2025-02-20,Senate,"Senate/ passed 3rd reading",24,0,0,5,29
1904403,1510270,2025-02-21,House,"House/ concurs with Senate amendment",65,1,0,9,75
1904426,1510272,2025-01-28,House,"House Comm - Favorable Recommendation",7,0,0,3,10
1904426,1510273,2025-02-06,House,"House/ passed 3rd reading",72,0,0,3,75
1904426,1510274,2025-02-19,Senate,"Senate Comm - Favorable Recommendation",5,0,0,3,8
1904426,1510275,2025-02-27,Senate,"Senate/ passed 2nd reading",22,1,0,6,29
1904426,1510276,2025-02-28,Senate,"Senate/ passed 3rd reading",26,0,0,3,29
1904452,1511211,2025-01-22,House,"House Comm - Substitute Recommendation",12,0,0,1,13
1904452,1511212,2025-01-22,House,"House Comm - Amendment Recommendation",12,0,0,1,13
1904452,1511213,2025-01-22,House,"House Comm - Favorable Recommendation",12,0,0,1,13
1904452,1511214,2025-02-18,House,"House/ passed 3rd reading",70,0,0,5,75
1904452,1511215,2025-02-24,Senate,"Senate Comm - Favorable Recommendation",3,0,0,3,6
1904452,1511216,2025-03-07,Senate,"Senate/ passed 2nd & 3rd readings/ suspension",21,2,0,6,29
1904477,1512394,2025-01-22,House,"House Comm - Favorable Recommendation",13,0,0,0,13
1904477,1512395,2025-02-05,House,"House/ passed 3rd reading",52,23,0,0,75
1904477,1512396,2025-02-19,Senate,"Senate Comm - Tabled",7,1,0,0,8
1904553,1510277,2025-02-05,Senate,"Senate Comm - Favorable Recommendation",4,0,0,5,9
1904553,1510278,2025-02-11,Senate,"Senate/ passed 2nd reading",24,0,0,5,29
1904553,1510279,2025-02-13,Senate,"Senate/ passed 3rd reading",26,0,0,3,29
1904553,1510280,2025-02-26,House,"House Comm - Favorable Recommendation",8,0,0,2,10
1904553,1510281,2025-03-04,House,"House/ passed 3rd reading",72,0,0,3,75
1904600,1511955,2025-02-13,Senate,"Senate Comm - Substitute Recommendation",7,0,0,1,8
1904600,1511956,2025-02-13,Senate,"Senate Comm - Motion to Recommend Failed",4,4,0,0,8
1904600,1511957,2025-02-28,Senate,"Senate Comm - Substitute Recommendation",7,0,0,1,8
1904600,1511958,2025-02-28,Senate,"Senate Comm - Amendment Recommendation",7,0,0,1,8
1904600,1511959,2025-02-28,Senate,"Senate Comm - Motion to Recommend Failed",4,4,0,0,8
1904600,1511960,2025-03-04,Senate,"Senate/ passed 2nd & 3rd readings/ suspension",26,1,0,2,29
1904600,1511961,2025-03-05,House,"House/ passed 3rd reading",71,0,0,4,75
1904625,1513482,2025-02-12,House,"House Comm - Held",6,4,0,1,11
1904625,1513483,2025-02-14,House,"House Comm - Amendment Recommendation",8,0,0,3,11
1904625,1513484,2025-02-14,House,"House Comm - Motion to Recommend Failed",4,4,0,3,11
1904648,1513002,2025-01-29,House,"House Comm - Favorable Recommendation",9,0,0,2,11
1904648,1513003,2025-02-07,House,"House/ passed 3rd reading",70,0,0,5,75
1904648,1513004,2025-02-26,Senate,"Senate Comm - Substitute Recommendation",5,0,0,2,7
1904648,1513005,2025-02-26,Senate,"Senate Comm - Favorable Recommendation",5,0,0,2,7
1904648,1513006,2025-03-06,Senate,"Senate/ passed 2nd & 3rd readings/ suspension",25,0,0,4,29
1904648,1513007,2025-03-06,House,"House/ concurs with Senate amendment",67,0,0,8,75
1904672,1510282,2025-01-23,House,"House Comm - Favorable Recommendation",10,0,0,0,10
1904672,1510283,2025-01-30,House,"House/ passed 3rd reading",71,0,0,4,75
1904672,1510284,2025-02-06,Senate,"Senate Comm - Favorable Recommendation",3,0,0,3,6
1904672,1510285,2025-02-06,Senate,"Senate Comm - Consent Calendar Recommendation",3,0,0,3,6
1904672,1510286,2025-02-12,Senate,"Senate/ passed 3rd reading",21,0,0,8,29
1904694,1510287,2025-01-23,House,"House Comm - Substitute Recommendation",11,0,0,5,16
1904694,1510288,2025-01-23,House,"House Comm - Amendment Recommendation",12,0,0,4,16
1904694,1510289,2025-01-23,House,"House Comm - Favorable Recommendation",12,0,0,4,16
1904694,1510290,2025-01-31,House,"House/ passed 3rd reading",69,1,0,5,75
1904694,1510291,2025-02-07,Senate,"Senate Comm - Amendment Recommendation",4,0,0,3,7
1904694,1510292,2025-02-07,Senate,"Senate Comm - Favorable Recommendation",3,1,0,3,7
1904694,1510293,2025-02-13,Senate,"Senate/ passed 2nd reading",18,4,0,7,29
1904694,1510294,2025-02-14,Senate,"Senate/ passed 3rd reading",16,5,0,8,29
1904694,1510295,2025-02-19,House,"House/ concurs with Senate amendment",62,10,0,3,75
1904718,1515098,2025-01-24,House,"House Comm - Amendment Recommendation",9,0,0,2,11
1904718,1515099,2025-01-24,House,"House Comm - Favorable Recommendation",9,0,0,2,11
1904718,1515100,2025-02-03,House,"House/ passed 3rd reading",72,0,0,3,75
1904718,1515101,2025-02-21,Senate,"Senate Comm - Favorable Recommendation",4,0,0,5,9
1904718,1515102,2025-03-05,Senate,"Senate/ passed 2nd & 3rd readings/ suspension",28,0,0,1,29
1904718,1515103,2025-03-06,House,"House/ concurs with Senate amendment",73,0,0,2,75
1904743,1514517,2025-01-24,House,"House Comm - Amendment Recommendation",9,0,0,2,11
1904743,1514518,2025-01-24,House,"House Comm - Favorable Recommendation",8,1,0,2,11
1904743,1514519,2025-02-04,House,"House/ passed 3rd reading",56,13,0,6,75
1904743,1514520,2025-02-26,Senate,"Senate Comm - Substitute Recommendation",5,0,0,2,7
1904743,1514521,2025-02-26,Senate,"Senate Comm - Motion to Recommend Failed",2,4,0,1,7
1904769,1510296,2025-01-23,Senate,"Senate Comm - Favorable Recommendation",5,0,0,4,9
1904769,1510297,2025-01-28,Senate,"Senate/ passed 2nd reading",27,0,0,2,29
1904769,1510298,2025-01-29,Senate,"Senate/ passed 3rd reading",28,0,0,1,29
1904769,1510299,2025-02-06,House,"House Comm - Favorable Recommendation",9,0,0,2,11
1904769,1510300,2025-02-12,House,"House/ passed 3rd reading",70,0,0,5,75
1904769,1510301,2025-02-14,Senate,"Senate/ concurs with House amendment",23,0,0,6,29
1904790,1510302,2025-03-03,Senate,"Senate Comm - Favorable Recommendation",4,2,0,1,7
1904790,1510303,2025-03-03,Senate,"Senate/ passed 2nd reading",25,1,0,3,29
1904790,1510304,2025-03-04,Senate,"Senate/ passed 3rd reading",26,0,0,3,29
1904790,1510305,2025-03-05,House,"House/ passed 3rd reading",71,0,0,4,75
1907563,1512931,2025-01-22,Senate,"Senate Comm - Substitute Recommendation",6,0,0,2,8
1907563,1512932,2025-01-22,Senate,"Senate Comm - Favorable Recommendation",5,1,0,2,8
1907563,1512933,2025-01-23,Senate,"Senate/ passed 2nd reading",20,7,0,2,29
1907563,1512934,2025-01-24,Senate,"Senate/ passed 3rd reading",21,7,0,1,29
1907563,1512935,2025-02-26,House,"House Comm - Substitute Recommendation",9,0,0,4,13
1907563,1512936,2025-02-26,House,"House Comm - Favorable Recommendation",6,3,0,4,13
1907563,1512937,2025-03-06,House,"House/ passed 3rd reading",50,19,0,6,75
1907563,1512938,2025-03-06,Senate,"Senate/ concurs with House amendment",21,6,0,2,29
1907584,1510306,2025-01-23,House,"House Comm - Amendment Recommendation",13,0,0,3,16
1907584,1510307,2025-01-23,House,"House Comm - Favorable Recommendation",13,0,0,3,16
1907584,1510308,2025-01-31,House,"House/ passed 3rd reading",72,0,0,3,75
1907584,1510309,2025-02-07,Senate,"Senate Comm - Favorable Recommendation",2,0,0,5,7
1907584,1510310,2025-02-13,Senate,"Senate/ passed 2nd reading",22,0,0,7,29
1907584,1510311,2025-02-14,Senate,"Senate/ failed",12,9,0,8,29
1907584,1510312,2025-02-27,Senate,"Senate/ passed 3rd reading",25,0,0,4,29
1907605,1510313,2025-02-03,House,"House Comm - Favorable Recommendation",9,0,0,2,11
1907605,1510314,2025-02-03,House,"House Comm - Consent Calendar Recommendation",10,0,0,1,11
1907605,1510315,2025-02-06,House,"House/ passed 3rd reading",75,0,0,0,75
1907605,1510316,2025-02-13,Senate,"Senate Comm - Favorable Recommendation",5,0,0,2,7
1907605,1510317,2025-02-19,Senate,"Senate/ passed 2nd reading",24,0,0,5,29
1907605,1510318,2025-02-20,Senate,"Senate/ passed 3rd reading",24,0,0,5,29
1907649,1512259,2025-02-03,House,"House Comm - Favorable Recommendation",7,0,0,4,11
1907649,1512260,2025-02-11,House,"House/ passed 3rd reading",54,17,0,4,75
1907649,1512261,2025-03-04,Senate,"Senate Comm - Motion to Recommend Failed",2,2,0,5,9
1907649,1512262,2025-03-04,Senate,"Senate Comm - Reconsider actions",5,2,0,2,9
1907649,1512263,2025-03-04,Senate,"Senate Comm - Favorable Recommendation",5,3,0,1,9
1907691,1511367,2025-02-12,House,"House Comm - Favorable Recommendation",8,0,0,6,14
1907691,1511368,2025-02-20,House,"House/ passed 3rd reading",67,0,0,8,75
1907691,1511369,2025-02-25,Senate,"Senate Comm - Favorable Recommendation",5,0,0,3,8
1907715,1510319,2025-01-27,Senate,"Senate Comm - Favorable Recommendation",5,0,0,2,7
1907715,1510320,2025-02-04,Senate,"Senate/ passed 2nd reading",25,0,0,4,29
1907715,1510321,2025-02-05,Senate,"Senate/ passed 3rd reading",25,0,0,4,29
1907715,1510322,2025-02-14,House,"House Comm - Favorable Recommendation",8,0,0,3,11
1907715,1510323,2025-02-20,House,"House/ passed 3rd reading",70,0,0,5,75
1907736,1510324,2025-01-23,House,"House Comm - Favorable Recommendation",12,0,0,2,14
1907736,1510325,2025-01-31,House,"House/ passed 3rd reading",72,0,0,3,75
1907736,1510326,2025-02-07,Senate,"Senate Comm - Favorable Recommendation",4,0,0,3,7
1907736,1510327,2025-02-07,Senate,"Senate Comm - Consent Calendar Recommendation",4,0,0,3,7
1907736,1510328,2025-02-13,Senate,"Senate/ passed 3rd reading",26,0,0,3,29
1907759,1510329,2025-01-28,Senate,"Senate Comm - Substitute Recommendation",5,0,0,4,9
1907759,1510330,2025-01-28,Senate,"Senate Comm - Amendment Recommendation",5,0,0,4,9
1907759,1510331,2025-01-28,Senate,"Senate Comm - Favorable Recommendation",5,0,0,4,9
1907759,1510332,2025-02-07,Senate,"Senate/ passed 2nd reading",27,0,0,2,29
1907759,1510333,2025-02-10,Senate,"Senate/ passed 3rd reading",26,0,0,3,29
1907759,1510334,2025-02-14,House,"House Comm - Amendment Recommendation",12,0,0,1,13
1907759,1510335,2025-02-14,House,"House Comm - Favorable Recommendation",12,0,0,1,13
1907759,1510336,2025-02-26,House,"House/ passed 3rd reading",67,0,0,8,75
1907759,1510337,2025-02-27,Senate,"Senate/ concurs with House amendment",25,0,0,4,29
1907802,1510338,2025-01-29,House,"House Comm - Amendment Recommendation",8,0,0,6,14
1907802,1510339,2025-01-29,House,"House Comm - Favorable Recommendation",8,0,0,6,14
1907802,1510340,2025-02-07,House,"House/ passed 3rd reading",75,0,0,0,75
1907802,1510341,2025-02-19,Senate,"Senate Comm - Favorable Recommendation",4,0,0,4,8
1907802,1510342,2025-02-26,Senate,"Senate/ passed 2nd reading",22,0,0,7,29
1907802,1510343,2025-02-27,Senate,"Senate/ passed 3rd reading",23,0,0,6,29
1907844,1510344,2025-01-22,Senate,"Senate Comm - Favorable Recommendation",5,0,0,2,7
1907844,1510345,2025-01-27,Senate,"Senate/ passed 2nd reading",28,0,0,1,29
1907844,1510346,2025-01-28,Senate,"Senate/ passed 3rd reading",28,0,0,1,29
1907844,1510347,2025-02-18,House,"House Comm - Favorable Recommendation",9,0,0,1,10
1907844,1510348,2025-02-20,House,"House/ passed 3rd reading",71,0,0,4,75
1907868,1510349,2025-02-25,House,"House Comm - Substitute Recommendation",6,0,0,4,10
1907868,1510350,2025-02-25,House,"House Comm - Favorable Recommendation",6,0,0,4,10
1907868,1510351,2025-02-27,House,"House/ passed 3rd reading",72,0,0,3,75
1907868,1510352,2025-03-03,Senate,"Senate Comm - Favorable Recommendation",7,0,0,0,7
1907868,1510353,2025-03-06,Senate,"Senate/ passed 2nd & 3rd readings/ suspension",23,0,0,6,29
1907890,1512009,2025-01-23,Senate,"Senate Comm - Substitute Recommendation",4,0,0,5,9
1907890,1512010,2025-01-23,Senate,"Senate Comm - Favorable Recommendation",4,0,0,5,9
1907890,1512011,2025-01-31,Senate,"Senate/ passed 2nd reading",25,0,0,4,29
1907890,1512012,2025-02-03,Senate,"Senate/ passed 3rd reading",28,0,0,1,29
1907890,1512013,2025-02-12,House,"House Comm - Favorable Recommendation",11,0,0,0,11
1907890,1512014,2025-02-20,House,"House/ passed 3rd reading",67,0,0,8,75
1907910,1510354,2025-02-13,House,"House Comm - Favorable Recommendation",9,0,0,1,10
1907910,1510355,2025-02-13,House,"House Comm - Consent Calendar Recommendation",9,0,0,1,10
1907910,1510356,2025-02-18,House,"House/ passed 3rd reading",73,0,0,2,75
1907910,1510357,2025-02-25,Senate,"Senate Comm - Favorable Recommendation",3,0,0,4,7
1907910,1510358,2025-02-25,Senate,"Senate Comm - Consent Calendar Recommendation",3,0,0,4,7
1907910,1510359,2025-02-28,Senate,"Senate/ passed 3rd reading",23,0,0,6,29
1907932,1513462,2025-02-14,House,"House Comm - Substitute Recommendation",10,0,0,1,11
1907932,1513463,2025-02-14,House,"House Comm - Favorable Recommendation",10,0,0,1,11
1907932,1513464,2025-02-24,House,"House/ passed 3rd reading",69,0,0,6,75
1907932,1513465,2025-03-03,Senate,"Senate Comm - Motion to Recommend Failed",1,2,0,4,7
1907977,1514632,2025-02-03,House,"House Comm - Favorable Recommendation",8,0,0,3,11
1907977,1514633,2025-02-11,House,"House/ passed 3rd reading",73,0,0,2,75
1907977,1514634,2025-02-25,Senate,"Senate Comm - Favorable Recommendation",5,0,0,4,9
1907977,1514635,2025-03-07,Senate,"Senate/ passed 2nd & 3rd readings/ suspension",27,0,0,2,29
1907997,1512984,2025-02-06,House,"House Comm - Favorable Recommendation",8,0,0,3,11
1907997,1512985,2025-02-18,House,"House/ passed 3rd reading",64,0,0,11,75
1907997,1512986,2025-02-27,Senate,"Senate Comm - Favorable Recommendation",5,0,0,4,9
1908723,1514420,2025-01-24,Senate,"Senate Comm - Amendment Recommendation",6,0,0,1,7
1908723,1514421,2025-01-24,Senate,"Senate Comm - Favorable Recommendation",6,0,0,1,7
1908723,1514422,2025-02-03,Senate,"Senate/ passed 2nd reading",26,0,0,3,29
1908723,1514423,2025-02-04,Senate,"Senate/ passed 3rd reading",29,0,0,0,29
1908723,1514424,2025-02-07,House,"House Comm - Substitute Recommendation",11,0,0,0,11
1908723,1514425,2025-02-07,House,"House Comm - Favorable Recommendation",11,0,0,0,11
1908723,1514426,2025-02-13,House,"House/ passed 3rd reading",71,0,0,4,75
1908723,1514427,2025-02-18,Senate,"Senate/ concurs with House amendment",26,0,0,3,29
1908840,1512216,2025-02-06,House,"House Comm - Favorable Recommendation",9,1,0,4,14
1908840,1512217,2025-02-18,House,"House/ passed 3rd reading",50,22,0,3,75
1908840,1512218,2025-02-27,Senate,"Senate Comm - Held",4,1,0,2,7
1908840,1512219,2025-03-04,Senate,"Senate Comm - Substitute Recommendation",5,0,0,2,7
1908840,1512220,2025-03-04,Senate,"Senate Comm - Favorable Recommendation",3,2,0,2,7
1908963,1512818,2025-02-25,House,"House Comm - Held",5,2,0,3,10
1909083,1510360,2025-01-30,House,"House Comm - Substitute Recommendation",9,0,0,2,11
1909083,1510361,2025-01-30,House,"House Comm - Favorable Recommendation",9,0,0,2,11
1909083,1510362,2025-01-30,House,"House Comm - Consent Calendar Recommendation",9,0,0,2,11
1909083,1510363,2025-02-03,House,"House/ passed 3rd reading",73,0,0,2,75
1909083,1510364,2025-02-19,Senate,"Senate Comm - Favorable Recommendation",4,0,0,5,9
1909083,1510365,2025-02-27,Senate,"Senate/ passed 2nd reading",24,0,0,5,29
1909083,1510366,2025-02-28,Senate,"Senate/ passed 3rd reading",25,0,0,4,29
1909207,1511596,2025-01-28,House,"House Comm - Substitute Recommendation",13,0,0,1,14
1909207,1511597,2025-01-28,House,"House Comm - Favorable Recommendation",13,0,0,1,14
1909207,1511598,2025-02-06,House,"House/ passed 3rd reading",71,0,0,4,75
1909207,1511599,2025-02-20,Senate,"Senate Comm - Amendment Recommendation",4,0,0,3,7
1909207,1511600,2025-02-20,Senate,"Senate Comm - Favorable Recommendation",4,0,0,3,7
1909207,1511601,2025-03-03,Senate,"Senate/ passed 2nd reading",26,0,0,3,29
1909207,1511602,2025-03-04,Senate,"Senate/ passed 3rd reading",25,1,0,3,29
1909207,1511603,2025-03-05,House,"House/ concurs with Senate amendment",74,0,0,1,75
1909329,1513964,2025-02-03,Senate,"Senate Comm - Favorable Recommendation",5,0,0,2,7
1909329,1513965,2025-02-11,Senate,"Senate/ passed 2nd reading",21,1,0,7,29
1909329,1513966,2025-02-12,Senate,"Senate/ passed 3rd reading",18,8,0,3,29
1909329,1513967,2025-02-25,House,"House Comm - Favorable Recommendation",11,0,0,3,14
1909329,1513968,2025-03-05,House,"House/ failed",35,40,0,0,75
1909329,1513969,2025-03-06,House,"House/ motion to reconsider",51,22,0,2,75
1909329,1513970,2025-03-06,House,"House/ passed 3rd reading",43,28,0,4,75
1909532,1512865,2025-02-13,House,"House Comm - Amendment Recommendation",9,0,0,2,11
1909532,1512866,2025-02-13,House,"House Comm - Favorable Recommendation",10,0,0,1,11
1909532,1512867,2025-02-21,House,"House/ passed 3rd reading",66,0,0,9,75
1909532,1512868,2025-02-28,Senate,"Senate Comm - Motion to Recommend Failed",1,6,0,1,8
1909547,1510367,2025-01-23,Senate,"Senate Comm - Favorable Recommendation",5,0,0,4,9
1909547,1510368,2025-01-31,Senate,"Senate/ passed 2nd reading",27,0,0,2,29
1909547,1510369,2025-02-03,Senate,"Senate/ passed 3rd reading",28,0,0,1,29
1909547,1510370,2025-02-06,House,"House Comm - Favorable Recommendation",10,0,0,2,12
1909547,1510371,2025-02-13,House,"House/ passed 3rd reading",70,0,0,5,75
1909594,1510372,2025-01-30,House,"House Comm - Favorable Recommendation",11,0,0,2,13
1909594,1510373,2025-02-10,House,"House/ passed 3rd reading",74,0,0,1,75
1909594,1510374,2025-02-13,Senate,"Senate Comm - Favorable Recommendation",5,0,0,4,9
1909594,1510375,2025-02-19,Senate,"Senate/ passed 2nd reading",19,0,0,10,29
1909594,1510376,2025-02-20,Senate,"Senate/ passed 3rd reading",21,0,0,8,29
1909609,1513157,2025-01-29,Senate,"Senate Comm - Favorable Recommendation",4,1,0,2,7
1909609,1513158,2025-02-04,Senate,"Senate/ passed 2nd reading",18,7,0,4,29
1909609,1513159,2025-02-05,Senate,"Senate/ passed 3rd reading",21,8,0,0,29
1909609,1513160,2025-02-26,House,"House Comm - Favorable Recommendation",7,3,0,3,13
1909609,1513161,2025-03-06,House,"House/ passed 3rd reading",55,17,0,3,75
1909626,1510377,2025-02-03,House,"House Comm - Favorable Recommendation",9,0,0,2,11
1909626,1510378,2025-02-03,House,"House Comm - Consent Calendar Recommendation",9,0,0,2,11
1909626,1510379,2025-02-06,House,"House/ passed 3rd reading",73,0,0,2,75
1909626,1510380,2025-02-13,Senate,"Senate Comm - Favorable Recommendation",6,0,0,3,9
1909626,1510381,2025-02-13,Senate,"Senate Comm - Consent Calendar Recommendation",6,0,0,3,9
1909626,1510382,2025-02-20,Senate,"Senate/ passed 3rd reading",24,0,0,5,29
1909641,1512786,2025-02-21,House,"House Comm - Substitute Recommendation",10,0,0,6,16
1909641,1512787,2025-02-21,House,"House Comm - Favorable Recommendation",10,0,0,6,16
1909641,1512788,2025-02-27,House,"House/ passed 3rd reading",68,0,0,7,75
1909641,1512789,2025-03-03,Senate,"Senate Comm - Held",3,1,0,3,7
1909656,1513164,2025-01-31,House,"House Comm - Substitute Recommendation",11,0,0,5,16
1909656,1513165,2025-01-31,House,"House Comm - Favorable Recommendation",11,0,0,5,16
1909656,1513166,2025-02-10,House,"House/ passed 3rd reading",73,0,0,2,75
1909656,1513167,2025-03-03,Senate,"Senate Comm - Substitute Recommendation",5,0,0,3,8
1909656,1513168,2025-03-03,Senate,"Senate Comm - Favorable Recommendation",6,0,0,2,8
1909656,1513169,2025-03-03,Senate,"Senate Comm - Consent Calendar Recommendation",5,0,0,3,8
1909656,1513170,2025-03-07,Senate,"Senate/ passed 3rd reading",21,0,0,8,29
1909656,1513171,2025-03-07,House,"House/ concurs with Senate amendment",68,0,0,7,75
1909673,1515152,2025-01-28,Senate,"Senate Comm - Favorable Recommendation",5,0,0,2,7
1909673,1515153,2025-02-04,Senate,"Senate/ passed 2nd reading",23,0,0,6,29
1909673,1515154,2025-02-05,Senate,"Senate/ passed 3rd reading",26,0,0,3,29
1909673,1515155,2025-02-07,House,"House Comm - Substitute Recommendation",10,0,0,1,11
1909673,1515156,2025-02-07,House,"House Comm - Favorable Recommendation",10,0,0,1,11
1909673,1515157,2025-02-26,House,"House/ passed 3rd reading",62,7,0,6,75
1909673,1515158,2025-03-04,House,"House Conference Committee - Final Passage",60,10,0,5,75
1909673,1515159,2025-03-04,Senate,"Senate Conference Committee - Final Passage",21,0,0,8,29
1909688,1512042,2025-01-23,House,"House Comm - Favorable Recommendation",13,0,0,3,16
1909688,1512043,2025-02-03,House,"House/ passed 3rd reading",73,0,0,2,75
1909688,1512044,2025-02-25,Senate,"Senate Comm - Favorable Recommendation",4,0,0,3,7
1909688,1512045,2025-03-06,Senate,"Senate/ passed 2nd & 3rd readings/ suspension",23,2,0,4,29
1909719,1514039,2025-02-12,House,"House Comm - Favorable Recommendation",10,0,0,1,11
1909719,1514040,2025-02-12,House,"House Comm - Consent Calendar Recommendation",10,0,0,1,11
1909719,1514041,2025-02-18,House,"House/ passed 3rd reading",72,0,0,3,75
1909719,1514042,2025-02-24,Senate,"Senate Comm - Favorable Recommendation",3,0,0,4,7
1909719,1514043,2025-03-06,Senate,"Senate/ passed 2nd & 3rd readings/ suspension",27,0,0,2,29
1909737,1515033,2025-01-24,House,"House Comm - Favorable Recommendation",9,1,0,1,11
1909737,1515034,2025-01-31,House,"House/ passed 3rd reading",43,29,0,3,75
1909737,1515035,2025-02-27,Senate,"Senate Comm - Substitute Recommendation",3,0,0,4,7
1909737,1515036,2025-02-27,Senate,"Senate Comm - Favorable Recommendation",2,1,0,4,7
1909737,1515037,2025-03-07,Senate,"Senate/ passed 2nd & 3rd readings/ suspension",20,6,0,3,29
1909737,1515038,2025-03-07,House,"House/ concurs with Senate amendment",49,15,0,11,75
1909752,1510383,2025-01-24,House,"House Comm - Favorable Recommendation",9,0,0,3,12
1909752,1510384,2025-02-04,House,"House/ passed 3rd reading",68,0,0,7,75
1909752,1510385,2025-02-14,Senate,"Senate Comm - Favorable Recommendation",6,0,0,1,7
1909752,1510386,2025-02-20,Senate,"Senate/ passed 2nd reading",25,0,0,4,29
1909752,1510387,2025-02-21,Senate,"Senate/ passed 3rd reading",26,0,0,3,29
1909784,1513407,2025-01-24,House,"House Comm - Favorable Recommendation",10,0,0,2,12
1909784,1513408,2025-02-04,House,"House/ passed 3rd reading",66,1,0,8,75
1909784,1513409,2025-03-04,Senate,"Senate Comm - Motion to Recommend Failed",2,4,0,2,8
1909800,1513432,2025-02-04,Senate,"Senate Comm - Substitute Recommendation",6,0,0,2,8
1909800,1513433,2025-02-04,Senate,"Senate Comm - Amendment Recommendation",6,0,0,2,8
1909800,1513434,2025-02-04,Senate,"Senate Comm - Favorable Recommendation",6,0,0,2,8
1909800,1513435,2025-02-11,Senate,"Senate/ passed 2nd reading",25,0,0,4,29
1909800,1513436,2025-02-12,Senate,"Senate/ passed 3rd reading",25,0,0,4,29
1909800,1513437,2025-03-04,House,"House Comm - Favorable Recommendation",7,0,0,3,10
1909800,1513438,2025-03-07,House,"House/ passed 3rd reading",50,15,0,10,75
1909816,1510388,2025-02-05,Senate,"Senate Comm - Substitute Recommendation",4,0,0,5,9
1909816,1510389,2025-02-05,Senate,"Senate Comm - Favorable Recommendation",5,0,0,4,9
1909816,1510390,2025-02-18,Senate,"Senate/ passed 2nd reading",20,4,0,5,29
1909816,1510391,2025-02-19,Senate,"Senate/ passed 3rd reading",25,1,0,3,29
1909816,1510392,2025-02-24,House,"House Comm - Favorable Recommendation",9,0,0,2,11
1909816,1510393,2025-02-26,House,"House/ passed 3rd reading",64,0,0,11,75
1909832,1512901,2025-01-30,House,"House Comm - Substitute Recommendation",13,0,0,0,13
1909832,1512902,2025-01-30,House,"House Comm - Favorable Recommendation",10,3,0,0,13
1909832,1512903,2025-02-10,House,"House/ passed 3rd reading",59,13,0,3,75
1909832,1512904,2025-03-03,Senate,"Senate Comm - Favorable Recommendation",4,2,0,1,7
1909848,1512939,2025-01-28,Senate,"Senate Comm - Favorable Recommendation",6,0,0,3,9
1909848,1512940,2025-02-07,Senate,"Senate/ passed 2nd reading",26,0,0,3,29
1909848,1512941,2025-02-10,Senate,"Senate/ passed 3rd reading",25,0,0,4,29
1909848,1512942,2025-02-24,House,"House Comm - Favorable Recommendation",9,0,0,2,11
1909848,1512943,2025-02-26,House,"House/ passed 3rd reading",61,0,0,14,75
1909862,1512740,2025-01-23,Senate,"Senate Comm - Substitute Recommendation",4,0,0,5,9
1909862,1512741,2025-01-23,Senate,"Senate Comm - Amendment Recommendation",4,0,0,5,9
1909862,1512742,2025-01-23,Senate,"Senate Comm - Favorable Recommendation",4,0,0,5,9
1909862,1512743,2025-01-31,Senate,"Senate/ passed 2nd reading",26,0,0,3,29
1909862,1512744,2025-02-03,Senate,"Senate/ passed 3rd reading",21,7,0,1,29
1909862,1512745,2025-02-14,House,"House Comm - Favorable Recommendation",7,2,0,2,11
1910744,1512549,2025-02-03,Senate,"Senate Comm - Substitute Recommendation",5,0,0,2,7
1910744,1512550,2025-02-03,Senate,"Senate Comm - Favorable Recommendation",5,0,0,2,7
1910744,1512551,2025-02-11,Senate,"Senate/ passed 2nd reading",25,0,0,4,29
1910744,1512552,2025-02-12,Senate,"Senate/ passed 3rd reading",28,0,0,1,29
1910744,1512553,2025-03-03,House,"House Comm - Favorable Recommendation",10,1,0,0,11
1910744,1512554,2025-03-07,House,"House/ passed 3rd reading",41,30,0,4,75
1910966,1510394,2025-01-24,Senate,"Senate Comm - Favorable Recommendation",6,0,0,1,7
1910966,1510395,2025-02-03,Senate,"Senate/ passed 2nd reading",26,0,0,3,29
1910966,1510396,2025-02-04,Senate,"Senate/ passed 3rd reading",29,0,0,0,29
1910966,1510397,2025-02-07,House,"House Comm - Favorable Recommendation",10,0,0,1,11
1910966,1510398,2025-02-19,House,"House/ passed 3rd reading",69,0,0,6,75
1911041,1511656,2025-02-18,House,"House Comm - Amendment Recommendation",8,0,0,8,16
1911041,1511657,2025-02-18,House,"House Comm - Favorable Recommendation",8,0,0,8,16
1911041,1511658,2025-02-24,House,"House/ passed 3rd reading",68,0,0,7,75
1911041,1511659,2025-03-03,Senate,"Senate Comm - Favorable Recommendation",4,0,0,3,7
1911116,1512605,2025-01-24,Senate,"Senate Comm - Favorable Recommendation",5,1,0,1,7
1911116,1512606,2025-02-03,Senate,"Senate/ passed 2nd reading",15,12,0,2,29
1911190,1512585,2025-01-22,Senate,"Senate Comm - Favorable Recommendation",6,0,0,1,7
1911190,1512586,2025-01-27,Senate,"Senate/ passed 2nd reading",25,0,0,4,29
1911190,1512587,2025-01-28,Senate,"Senate/ passed 3rd reading",27,0,0,2,29
1911190,1512588,2025-02-07,House,"House Comm - Favorable Recommendation",11,0,0,2,13
1911265,1512737,2025-01-27,Senate,"Senate Comm - Favorable Recommendation",7,0,0,1,8
1911265,1512738,2025-02-04,Senate,"Senate/ passed 2nd reading",23,1,0,5,29
1911265,1512739,2025-02-05,Senate,"Senate/ passed 3rd reading",22,4,0,3,29
1911338,1510399,2025-01-24,House,"House Comm - Substitute Recommendation",9,0,0,2,11
1911338,1510400,2025-01-24,House,"House Comm - Favorable Recommendation",9,0,0,2,11
1911338,1510401,2025-02-04,House,"House/ passed 3rd reading",71,0,0,4,75
1911338,1510402,2025-02-13,Senate,"Senate Comm - Substitute Recommendation",6,0,0,3,9
1911338,1510403,2025-02-13,Senate,"Senate Comm - Favorable Recommendation",7,0,0,2,9
1911338,1510404,2025-02-19,Senate,"Senate/ passed 2nd reading",19,0,0,10,29
1911338,1510405,2025-02-20,Senate,"Senate/ passed 3rd reading",21,0,0,8,29
1911338,1510406,2025-02-21,House,"House/ concurs with Senate amendment",68,0,0,7,75
1911411,1511472,2025-02-20,House,"House Comm - Amendment Recommendation",9,0,0,4,13
1911411,1511473,2025-02-20,House,"House Comm - Favorable Recommendation",7,3,0,3,13
1911411,1511474,2025-02-25,House,"House/ failed",25,43,0,7,75
1911486,1511257,2025-02-19,House,"House Comm - Substitute Recommendation",11,0,0,5,16
1911486,1511258,2025-02-19,House,"House Comm - Favorable Recommendation",11,0,0,5,16
1911486,1511259,2025-02-25,House,"House/ passed 3rd reading",64,0,0,11,75
1911486,1511260,2025-03-03,Senate,"Senate Comm - Favorable Recommendation",4,0,0,3,7
1911561,1512825,2025-02-07,Senate,"Senate Comm - Favorable Recommendation",2,0,0,5,7
1911561,1512826,2025-02-18,Senate,"Senate/ passed 2nd reading",23,0,0,6,29
1911561,1512827,2025-02-19,Senate,"Senate/ passed 3rd reading",23,0,0,6,29
1911561,1512828,2025-02-27,House,"House Comm - Favorable Recommendation",6,0,0,5,11
1911708,1512350,2025-02-18,Senate,"Senate Comm - Substitute Recommendation",5,0,0,4,9
1911708,1512351,2025-02-18,Senate,"Senate Comm - Favorable Recommendation",4,2,0,3,9
1911708,1512352,2025-02-21,Senate,"Senate/ passed 2nd reading",21,0,0,8,29
1911708,1512353,2025-02-24,Senate,"Senate/ passed 3rd reading",22,0,0,7,29
1911708,1512354,2025-02-27,House,"House Comm - Substitute Recommendation",6,0,0,5,11
1911708,1512355,2025-02-27,House,"House Comm - Favorable Recommendation",6,0,0,5,11
1911708,1512356,2025-03-06,House,"House/ passed 3rd reading",64,2,0,9,75
1911708,1512357,2025-03-07,Senate,"Senate/ concurs with House amendment",23,1,0,5,29
1911782,1510407,2025-01-23,Senate,"Senate Comm - Favorable Recommendation",6,0,0,2,8
1911782,1510408,2025-01-27,Senate,"Senate/ passed 2nd reading",28,0,0,1,29
1911782,1510409,2025-01-28,Senate,"Senate/ passed 3rd reading",25,0,0,4,29
1911782,1510410,2025-02-12,House,"House Comm - Favorable Recommendation",12,0,0,0,12
1911782,1510411,2025-02-19,House,"House/ passed 3rd reading",62,1,0,12,75
1911853,1510412,2025-02-03,House,"House Comm - Favorable Recommendation",11,1,0,0,12
1911853,1510413,2025-02-11,House,"House/ passed 3rd reading",72,0,0,3,75
1911853,1510414,2025-02-11,House,"House/ passed 3rd reading",74,1,0,0,75
1911853,1510415,2025-02-18,Senate,"Senate Comm - Favorable Recommendation",5,0,0,3,8
1911853,1510416,2025-02-18,Senate,"Senate Comm - Consent Calendar Recommendation",5,0,0,3,8
1911853,1510417,2025-02-21,Senate,"Senate/ passed 3rd reading",26,0,0,3,29
1911909,1511313,2025-02-13,House,"House Comm - Substitute Recommendation",7,0,0,3,10
1911909,1511314,2025-02-13,House,"House Comm - Favorable Recommendation",7,0,0,3,10
1911909,1511315,2025-02-26,House,"House/ passed 3rd reading",68,2,0,5,75
1911909,1511316,2025-03-03,Senate,"Senate Comm - Favorable Recommendation",5,1,0,1,7
1911909,1511317,2025-03-06,Senate,"Senate/ passed 2nd & 3rd readings/ suspension",21,2,0,6,29
1911939,1510418,2025-01-30,Senate,"Senate Comm - Amendment Recommendation",5,0,0,2,7
1911939,1510419,2025-01-30,Senate,"Senate Comm - Favorable Recommendation",6,0,0,1,7
1911939,1510420,2025-02-07,Senate,"Senate/ passed 2nd reading",23,0,0,6,29
1911939,1510421,2025-02-10,Senate,"Senate/ passed 3rd reading",26,2,0,1,29
1911939,1510422,2025-02-25,House,"House Comm - Favorable Recommendation",10,0,0,6,16
1911939,1510423,2025-02-27,House,"House/ passed 3rd reading",70,0,0,5,75
1911972,1510424,2025-01-31,House,"House Comm - Amendment Recommendation",8,0,0,2,10
1911972,1510425,2025-01-31,House,"House Comm - Favorable Recommendation",8,0,0,2,10
1911972,1510426,2025-02-10,House,"House/ passed 3rd reading",71,1,0,3,75
1911972,1510427,2025-02-14,Senate,"Senate Comm - Favorable Recommendation",3,0,0,3,6
1911972,1510428,2025-02-14,Senate,"Senate Comm - Consent Calendar Recommendation",3,0,0,3,6
1911972,1510429,2025-02-20,Senate,"Senate/ passed 3rd reading",22,0,0,7,29
1912034,1510430,2025-01-31,House,"House Comm - Favorable Recommendation",10,0,0,4,14
1912034,1510431,2025-02-10,House,"House/ passed 3rd reading",74,0,0,1,75
1912034,1510432,2025-02-19,Senate,"Senate Comm - Favorable Recommendation",6,0,0,1,7
1912034,1510433,2025-02-26,Senate,"Senate/ passed 2nd reading",23,0,0,6,29
1912034,1510434,2025-02-27,Senate,"Senate/ passed 3rd reading",26,0,0,3,29
1912099,1511589,2025-01-23,Senate,"Senate Comm - Favorable Recommendation",6,0,0,3,9
1912099,1511590,2025-01-31,Senate,"Senate/ passed 2nd reading",26,0,0,3,29
1912099,1511591,2025-02-04,Senate,"Senate/ passed 3rd reading",24,0,0,5,29
1912099,1511592,2025-02-14,House,"House Comm - Favorable Recommendation",8,0,0,3,11
1912099,1511593,2025-02-20,House,"House/ passed 3rd reading",69,0,0,6,75
1912099,1511594,2025-02-21,Senate,"Senate/ concurs with House amendment",23,0,0,6,29
1912129,1510435,2025-02-03,House,"House Comm - Favorable Recommendation",11,0,0,3,14
1912129,1510436,2025-02-11,House,"House/ passed 3rd reading",68,0,0,7,75
1912129,1510437,2025-02-19,Senate,"Senate Comm - Favorable Recommendation",5,0,0,2,7
1912129,1510438,2025-02-19,Senate,"Senate Comm - Consent Calendar Recommendation",5,0,0,2,7
1912129,1510439,2025-02-25,Senate,"Senate/ passed 3rd reading",24,0,0,5,29
1912161,1512819,2025-02-14,House,"House Comm - Held",12,0,0,1,13
1912194,1510440,2025-01-22,Senate,"Senate Comm - Substitute Recommendation",6,0,0,1,7
1912194,1510441,2025-01-22,Senate,"Senate Comm - Favorable Recommendation",4,1,0,2,7
1912194,1510442,2025-01-27,Senate,"Senate/ passed 2nd reading",24,5,0,0,29
1912194,1510443,2025-01-28,Senate,"Senate/ passed 3rd reading",20,8,0,1,29
1912194,1510444,2025-02-21,House,"House Comm - Substitute Recommendation",8,0,0,8,16
1912194,1510445,2025-02-21,House,"House Comm - Favorable Recommendation",8,0,0,8,16
1912194,1510446,2025-03-05,House,"House/ passed 3rd reading",58,11,0,6,75
1912194,1510447,2025-03-05,Senate,"Senate/ concurs with House amendment",22,0,0,7,29
1912226,1511510,2025-02-03,House,"House Comm - Substitute Recommendation",8,0,0,6,14
1912226,1511511,2025-02-03,House,"House Comm - Favorable Recommendation",8,0,0,6,14
1912226,1511512,2025-02-11,House,"House/ passed 3rd reading",72,0,0,3,75
1912226,1511513,2025-02-18,Senate,"Senate Comm - Favorable Recommendation",4,0,0,3,7
1912226,1511514,2025-02-20,Senate,"Senate/ passed 2nd reading",20,0,0,9,29
1912226,1511515,2025-02-21,Senate,"Senate/ passed 3rd reading",22,0,0,7,29
1912288,1514149,2025-02-10,House,"House Comm - Favorable Recommendation",9,1,0,6,16
1912321,1514108,2025-02-14,House,"House Comm - Substitute Recommendation",9,0,0,2,11
1912321,1514109,2025-02-14,House,"House Comm - Favorable Recommendation",9,0,0,2,11
1912321,1514110,2025-02-21,House,"House/ passed 3rd reading",68,0,0,7,75
1912321,1514111,2025-02-27,Senate,"Senate Comm - Substitute Recommendation",4,0,0,5,9
1912321,1514112,2025-02-27,Senate,"Senate Comm - Favorable Recommendation",3,1,0,5,9
1915931,1510448,2025-02-06,Senate,"Senate Comm - Substitute Recommendation",3,0,0,4,7
1915931,1510449,2025-02-06,Senate,"Senate Comm - Favorable Recommendation",3,0,0,4,7
1915931,1510450,2025-02-18,Senate,"Senate/ passed 2nd reading",21,0,0,8,29
1915931,1510451,2025-02-19,Senate,"Senate/ passed 3rd reading",24,0,0,5,29
1915931,1510452,2025-02-25,House,"House Comm - Favorable Recommendation",8,0,0,2,10
1915931,1510453,2025-02-27,House,"House/ passed 3rd reading",70,0,0,5,75
1915963,1511692,2025-02-06,House,"House Comm - Favorable Recommendation",6,0,0,5,11
1915963,1511693,2025-02-18,House,"House/ passed 3rd reading",68,0,0,7,75
1915963,1511694,2025-02-25,Senate,"Senate Comm - Favorable Recommendation",6,0,0,1,7
1915963,1511695,2025-03-06,Senate,"Senate/ passed 2nd & 3rd readings/ suspension",22,0,0,7,29
1915994,1514345,2025-02-06,House,"House Comm - Substitute Recommendation",10,0,0,1,11
1915994,1514346,2025-02-06,House,"House Comm - Motion to Recommend Failed",5,5,0,1,11
1915994,1514347,2025-02-06,House,"House Comm - Held",10,0,0,1,11
1915994,1514348,2025-02-12,House,"House Comm - Substitute Recommendation",7,0,0,4,11
1915994,1514349,2025-02-12,House,"House Comm - Amendment Recommendation",7,0,0,4,11
1915994,1514350,2025-02-12,House,"House Comm - Favorable Recommendation",8,0,0,3,11
1915994,1514351,2025-02-20,House,"House/ passed 3rd reading",57,11,0,7,75
1915994,1514352,2025-03-04,Senate,"Senate Comm - Favorable Recommendation",3,0,0,4,7
1916027,1510454,2025-01-31,House,"House Comm - Favorable Recommendation",12,1,0,3,16
1916027,1510455,2025-02-10,House,"House/ passed 3rd reading",70,1,0,4,75
1916027,1510456,2025-02-19,Senate,"Senate Comm - Favorable Recommendation",4,0,0,3,7
1916027,1510457,2025-02-19,Senate,"Senate Comm - Consent Calendar Recommendation",4,0,0,3,7
1916027,1510458,2025-02-24,Senate,"Senate/ passed 3rd reading",25,0,0,4,29
1916059,1510459,2025-02-13,Senate,"Senate Comm - Substitute Recommendation",6,0,0,2,8
1916059,1510460,2025-02-13,Senate,"Senate Comm - Favorable Recommendation",4,2,0,2,8
1916059,1510461,2025-02-21,Senate,"Senate/ passed 2nd reading",18,5,0,6,29
1916059,1510462,2025-02-24,Senate,"Senate/ passed 3rd reading",17,5,0,7,29
1916059,1510463,2025-02-28,House,"House Comm - Substitute Recommendation",9,0,0,4,13
1916059,1510464,2025-02-28,House,"House Comm - Favorable Recommendation",9,0,0,4,13
1916059,1510465,2025-03-07,House,"House/ passed 3rd reading",60,3,0,12,75
1916059,1510466,2025-03-07,Senate,"Senate/ concurs with House amendment",21,6,0,2,29
1916091,1513636,2025-02-10,House,"House Comm - Substitute Recommendation",14,0,0,2,16
1916091,1513637,2025-02-10,House,"House Comm - Favorable Recommendation",14,0,0,2,16
1916091,1513638,2025-02-19,House,"House/ passed 3rd reading",66,6,0,3,75
1916091,1513639,2025-02-25,Senate,"Senate Comm - Substitute Recommendation",3,0,0,4,7
1916091,1513640,2025-02-25,Senate,"Senate Comm - Favorable Recommendation",3,0,0,4,7
1916091,1513641,2025-03-06,Senate,"Senate/ passed 2nd & 3rd readings/ suspension",17,10,0,2,29
1916091,1513642,2025-03-06,House,"House/ concurs with Senate amendment",64,4,0,7,75
1916123,1513542,2025-01-24,Senate,"Senate Comm - Favorable Recommendation",4,0,0,2,6
1916123,1513543,2025-02-04,Senate,"Senate/ passed 2nd reading",29,0,0,0,29
1916123,1513544,2025-02-05,Senate,"Senate/ passed 3rd reading",28,0,0,1,29
1916123,1513545,2025-02-12,House,"House Comm - Favorable Recommendation",8,0,0,3,11
1916123,1513546,2025-02-19,House,"House/ passed 3rd reading",62,0,0,13,75
1916155,1512713,2025-01-31,House,"House Comm - Motion to Recommend Failed",6,6,0,4,16
1916188,1512968,2025-02-03,House,"House Comm - Substitute Recommendation",9,0,0,2,11
1916188,1512969,2025-02-03,House,"House Comm - Amendment Recommendation",9,0,0,2,11
1916188,1512970,2025-02-03,House,"House Comm - Favorable Recommendation",7,2,0,2,11
1916188,1512971,2025-02-11,House,"House/ passed 3rd reading",72,0,0,3,75
1916188,1512972,2025-02-19,Senate,"Senate Comm - Favorable Recommendation",4,2,0,3,9
1916188,1512973,2025-02-26,Senate,"Senate/ passed 2nd reading",16,6,0,7,29
1916188,1512974,2025-03-03,Senate,"Senate/ passed 3rd reading",20,6,0,3,29
1916188,1512975,2025-03-03,Senate,"Senate/ passed 3rd reading",21,6,0,2,29
1916188,1512976,2025-03-05,House,"House/ concurs with Senate amendment",65,5,0,5,75
1916251,1510467,2025-02-14,Senate,"Senate Comm - Favorable Recommendation",4,0,0,3,7
1916251,1510468,2025-02-21,Senate,"Senate/ passed 2nd reading",22,0,0,7,29
1916251,1510469,2025-02-24,Senate,"Senate/ passed 3rd reading",20,0,0,9,29
1916251,1510470,2025-03-04,House,"House Comm - Favorable Recommendation",11,0,0,5,16
1916251,1510471,2025-03-07,House,"House/ passed 3rd reading",65,4,0,6,75
1916316,1512065,2025-02-13,House,"House Comm - Substitute Recommendation",9,0,0,7,16
1916316,1512066,2025-02-13,House,"House Comm - Amendment Recommendation",9,0,0,7,16
1916316,1512067,2025-02-13,House,"House Comm - Favorable Recommendation",9,0,0,7,16
1916316,1512068,2025-02-21,House,"House/ passed 3rd reading",68,0,0,7,75
1916316,1512069,2025-02-28,Senate,"Senate Comm - Motion to Recommend Failed",3,3,0,2,8
1916349,1510472,2025-02-10,House,"House Comm - Favorable Recommendation",7,0,0,3,10
1916349,1510473,2025-02-10,House,"House Comm - Consent Calendar Recommendation",7,0,0,3,10
1916349,1510474,2025-02-13,House,"House/ passed 3rd reading",67,0,0,8,75
1916349,1510475,2025-02-19,Senate,"Senate Comm - Favorable Recommendation",5,0,0,2,7
1916349,1510476,2025-02-19,Senate,"Senate Comm - Consent Calendar Recommendation",5,0,0,2,7
1916349,1510477,2025-02-26,Senate,"Senate/ passed 3rd reading",24,0,0,5,29
1916381,1511605,2025-02-10,House,"House Comm - Substitute Recommendation",12,0,0,4,16
1916381,1511606,2025-02-10,House,"House Comm - Favorable Recommendation",12,0,0,4,16
1916381,1511607,2025-02-18,House,"House/ passed 3rd reading",73,0,0,2,75
1916381,1511608,2025-02-26,Senate,"Senate Comm - Favorable Recommendation",6,0,0,2,8
1916381,1511609,2025-03-07,Senate,"Senate/ passed 2nd & 3rd readings/ suspension",25,0,0,4,29
1916413,1510478,2025-01-29,House,"House Comm - Substitute Recommendation",10,0,0,2,12
1916413,1510479,2025-01-29,House,"House Comm - Favorable Recommendation",10,0,0,2,12
1916413,1510480,2025-02-10,House,"House/ passed 3rd reading",70,2,0,3,75
1916413,1510481,2025-02-19,Senate,"Senate Comm - Amendment Recommendation",6,0,0,2,8
1916413,1510482,2025-02-19,Senate,"Senate Comm - Favorable Recommendation",6,0,0,2,8
1916413,1510483,2025-02-26,Senate,"Senate/ failed",13,5,0,11,29
1916413,1510484,2025-02-27,Senate,"Senate/ passed 2nd reading",23,0,0,6,29
1916413,1510485,2025-02-28,Senate,"Senate/ passed 3rd reading",24,0,0,5,29
1916413,1510486,2025-03-03,House,"House/ concurs with Senate amendment",56,12,0,7,75
1916445,1514226,2025-02-12,Senate,"Senate Comm - Substitute Recommendation",4,0,0,2,6
1916445,1514227,2025-02-12,Senate,"Senate Comm - Favorable Recommendation",4,0,0,2,6
1916445,1514228,2025-02-19,Senate,"Senate/ passed 2nd reading",20,0,0,9,29
1916445,1514229,2025-02-20,Senate,"Senate/ passed 3rd reading",22,0,0,7,29
1916445,1514230,2025-02-27,House,"House Comm - Favorable Recommendation",10,0,0,2,12
1916445,1514231,2025-03-04,House,"House/ failed",35,40,0,0,75
1916445,1514232,2025-03-04,House,"House/ passed 3rd reading",63,11,0,1,75
1916445,1514233,2025-03-05,Senate,"Senate/ concurs with House amendment",27,0,0,2,29
1916541,1513238,2025-01-27,Senate,"Senate Comm - Substitute Recommendation",4,1,0,2,7
1916541,1513239,2025-01-27,Senate,"Senate Comm - Favorable Recommendation",4,1,0,2,7
1916541,1513240,2025-02-18,Senate,"Senate/ passed 2nd reading",21,3,0,5,29
1916541,1513241,2025-02-19,Senate,"Senate/ passed 3rd reading",19,6,0,4,29
1916541,1513242,2025-02-28,House,"House Comm - Favorable Recommendation",10,0,0,6,16
1916541,1513243,2025-03-07,House,"House/ passed 3rd reading",55,12,0,8,75
1917747,1510487,2025-01-28,Senate,"Senate Comm - Substitute Recommendation",5,0,0,4,9
1917747,1510488,2025-01-28,Senate,"Senate Comm - Favorable Recommendation",7,0,0,2,9
1917747,1510489,2025-02-07,Senate,"Senate/ passed 2nd reading",25,0,0,4,29
1917747,1510490,2025-02-10,Senate,"Senate/ passed 3rd reading",26,0,0,3,29
1917747,1510491,2025-02-18,House,"House Comm - Favorable Recommendation",6,0,0,5,11
1917747,1510492,2025-02-26,House,"House/ passed 3rd reading",64,0,0,11,75
1917795,1510493,2025-01-31,House,"House Comm - Amendment Recommendation",12,0,0,4,16
1917795,1510494,2025-01-31,House,"House Comm - Favorable Recommendation",12,0,0,4,16
1917795,1510495,2025-02-10,House,"House/ passed 3rd reading",73,0,0,2,75
1917795,1510496,2025-02-14,Senate,"Senate Comm - Favorable Recommendation",6,0,0,1,7
1917795,1510497,2025-02-20,Senate,"Senate/ passed 2nd reading",22,0,0,7,29
1917795,1510499,2025-03-04,Senate,"Senate/ passed 2nd & 3rd readings/ suspension",26,0,0,3,29
1917847,1514611,2025-02-25,Senate,"Senate Comm - Motion to Recommend Failed",3,3,0,3,9
1917847,1514612,2025-02-25,Senate,"Senate Comm - Reconsider actions",5,3,0,1,9
1917847,1514613,2025-02-25,Senate,"Senate Comm - Favorable Recommendation",5,3,0,1,9
1917895,1511370,2025-02-14,House,"House Comm - Substitute Recommendation",11,0,0,1,12
1917895,1511371,2025-02-14,House,"House Comm - Favorable Recommendation",10,1,0,1,12
1917895,1511372,2025-02-28,House,"House/ passed 3rd reading",56,12,0,7,75
1917895,1511373,2025-02-28,House,"House/ passed 3rd reading",56,11,0,8,75
1917895,1511374,2025-03-04,Senate,"Senate Comm - Favorable Recommendation",5,0,0,1,6
1917895,1511375,2025-03-07,Senate,"Senate/ passed 2nd & 3rd readings/ suspension",25,1,0,3,29
1917996,1512081,2025-02-05,House,"House Comm - Substitute Recommendation",14,0,0,0,14
1917996,1512082,2025-02-05,House,"House Comm - Favorable Recommendation",14,0,0,0,14
1917996,1512083,2025-02-14,House,"House/ passed 3rd reading",70,0,0,5,75
1917996,1512084,2025-02-25,Senate,"Senate Comm - Favorable Recommendation",4,0,0,3,7
1917996,1512085,2025-03-06,Senate,"Senate/ passed 2nd & 3rd readings/ suspension",24,0,0,5,29
1918046,1514916,2025-01-29,House,"House Comm - Substitute Recommendation",13,0,0,1,14
1918046,1514917,2025-01-29,House,"House Comm - Favorable Recommendation",8,5,0,1,14
1918046,1514918,2025-02-07,House,"House/ passed 3rd reading",57,15,0,3,75
1918046,1514919,2025-02-13,Senate,"Senate Comm - Substitute Recommendation",3,0,0,4,7
1918046,1514920,2025-02-13,Senate,"Senate Comm - Held",5,2,0,0,7
1918046,1514921,2025-02-25,Senate,"Senate Comm - Substitute Recommendation",4,0,0,3,7
1918046,1514922,2025-02-25,Senate,"Senate Comm - Favorable Recommendation",6,0,0,1,7
1918093,1514410,2025-02-04,House,"House Comm - Substitute Recommendation",10,0,0,3,13
1918093,1514411,2025-02-04,House,"House Comm - Favorable Recommendation",9,1,0,3,13
1918093,1514412,2025-02-11,House,"House/ passed 3rd reading",65,8,0,2,75
1918093,1514413,2025-02-18,Senate,"Senate Comm - Substitute Recommendation",4,0,0,3,7
1918093,1514414,2025-02-18,Senate,"Senate Comm - Favorable Recommendation",3,1,0,3,7
1918093,1514415,2025-02-19,Senate,"Senate/ passed 2nd reading",26,1,0,2,29
1918093,1514416,2025-02-20,Senate,"Senate/ passed 3rd reading",21,6,0,2,29
1918093,1514417,2025-02-21,House,"House/ concurs with Senate amendment",57,10,0,8,75
1918143,1511536,2025-01-24,House,"House Comm - Amendment Recommendation",10,1,0,1,12
1918143,1511537,2025-01-24,House,"House Comm - Favorable Recommendation",7,4,0,1,12
1918143,1511538,2025-02-05,House,"House/ failed",34,37,0,4,75
1918143,1511539,2025-02-06,House,"House/ passed 3rd reading",48,24,0,3,75
1918143,1511540,2025-02-13,Senate,"Senate Comm - Favorable Recommendation",6,0,0,2,8
1918143,1511541,2025-02-26,Senate,"Senate/ passed 2nd reading",19,2,0,8,29
1918143,1511542,2025-02-28,Senate,"Senate/ passed 3rd reading",20,5,0,4,29
1918243,1511923,2025-01-24,House,"House Comm - Substitute Recommendation",9,0,0,2,11
1918243,1511924,2025-01-24,House,"House Comm - Favorable Recommendation",9,0,0,2,11
1918243,1511925,2025-02-04,House,"House/ passed 3rd reading",74,0,0,1,75
1918243,1511926,2025-02-13,Senate,"Senate Comm - Favorable Recommendation",6,0,0,3,9
1918243,1511927,2025-02-19,Senate,"Senate/ passed 2nd reading",20,0,0,9,29
1918243,1511928,2025-02-20,Senate,"Senate/ passed 3rd reading",25,0,0,4,29
1918291,1513001,2025-01-29,Senate,"Senate Comm - Held",6,1,0,0,7
1918343,1511680,2025-02-12,House,"House Comm - Substitute Recommendation",12,0,0,2,14
1918343,1511681,2025-02-12,House,"House Comm - Favorable Recommendation",12,0,0,2,14
1918343,1511682,2025-02-21,House,"House/ passed 3rd reading",59,6,0,10,75
1918343,1511683,2025-02-27,Senate,"Senate Comm - Substitute Recommendation",5,0,0,2,7
1918343,1511684,2025-02-27,Senate,"Senate Comm - Favorable Recommendation",3,1,0,3,7
1918343,1511685,2025-03-07,Senate,"Senate/ passed 2nd & 3rd readings/ suspension",17,8,0,4,29
1918343,1511686,2025-03-07,House,"House/ concurs with Senate amendment",57,10,0,8,75
1918390,1510501,2025-02-05,Senate,"Senate Comm - Substitute Recommendation",6,0,0,2,8
1918390,1510502,2025-02-05,Senate,"Senate Comm - Favorable Recommendation",6,0,0,2,8
1918390,1510503,2025-02-14,Senate,"Senate/ passed 2nd reading",21,0,0,8,29
1918390,1510504,2025-02-18,Senate,"Senate/ passed 3rd reading",24,2,0,3,29
1918390,1510505,2025-02-24,House,"House Comm - Favorable Recommendation",10,0,0,2,12
1918390,1510506,2025-02-26,House,"House/ passed 3rd reading",66,0,0,9,75
1918440,1513722,2025-01-23,House,"House Comm - Favorable Recommendation",10,0,0,0,10
1918440,1513723,2025-01-30,House,"House/ passed 3rd reading",73,0,0,2,75
1918440,1513724,2025-02-05,Senate,"Senate Comm - Favorable Recommendation",3,0,0,4,7
1918440,1513725,2025-02-13,Senate,"Senate/ passed 2nd reading",23,0,0,6,29
1918440,1513726,2025-02-14,Senate,"Senate/ passed 3rd reading",23,0,0,6,29
1918484,1514151,2025-02-05,House,"House Comm - Held",11,0,0,5,16
1918521,1512443,2025-01-24,Senate,"Senate Comm - Substitute Recommendation",5,0,0,1,6
1918521,1512444,2025-01-24,Senate,"Senate Comm - Favorable Recommendation",5,0,0,1,6
1918521,1512445,2025-02-04,Senate,"Senate/ passed 2nd reading",15,14,0,0,29
1918521,1512446,2025-02-05,Senate,"Senate/ failed",13,15,0,1,29
1918521,1512447,2025-02-06,Senate,"Senate/ passed 3rd reading",17,12,0,0,29
1918521,1512448,2025-02-12,House,"House Comm - Favorable Recommendation",9,0,0,5,14
1918545,1510507,2025-02-03,House,"House Comm - Substitute Recommendation",6,1,0,4,11
1918545,1510508,2025-02-03,House,"House Comm - Favorable Recommendation",6,1,0,4,11
1918545,1510509,2025-02-11,House,"House/ passed 3rd reading",73,1,0,1,75
1918545,1510510,2025-02-19,Senate,"Senate Comm - Favorable Recommendation",6,0,0,2,8
1918545,1510511,2025-02-26,Senate,"Senate/ passed 2nd reading",20,0,0,9,29
1918545,1510512,2025-02-27,Senate,"Senate/ passed 3rd reading",25,0,0,4,29
1918569,1513572,2025-02-10,House,"House Comm - Substitute Recommendation",11,0,0,5,16
1918569,1513573,2025-02-10,House,"House Comm - Favorable Recommendation",11,0,0,5,16
1918569,1513574,2025-02-19,House,"House/ passed 3rd reading",73,0,0,2,75
1918569,1513575,2025-02-26,Senate,"Senate Comm - Motion to Recommend Failed",0,6,0,2,8
1918598,1512555,2025-02-03,House,"House Comm - Held",7,1,0,3,11
1918623,1513529,2025-01-30,House,"House Comm - Substitute Recommendation",11,0,0,2,13
1918623,1513530,2025-01-30,House,"House Comm - Favorable Recommendation",11,0,0,2,13
1918623,1513531,2025-02-10,House,"House/ passed 3rd reading",74,0,0,1,75
1918623,1513532,2025-02-18,Senate,"Senate Comm - Favorable Recommendation",5,0,0,3,8
1918623,1513533,2025-02-18,Senate,"Senate Comm - Consent Calendar Recommendation",5,0,0,3,8
1918623,1513534,2025-02-21,Senate,"Senate/ passed 3rd reading",26,0,0,3,29
1918648,1513057,2025-02-19,House,"House Comm - Substitute Recommendation",12,0,0,4,16
1918648,1513058,2025-02-19,House,"House Comm - Amendment Recommendation",13,0,0,3,16
1918648,1513059,2025-02-19,House,"House Comm - Held",7,6,0,3,16
1918673,1513667,2025-01-27,House,"House Comm - Favorable Recommendation",11,0,0,0,11
1918673,1513668,2025-02-05,House,"House/ passed 3rd reading",72,0,0,3,75
1918673,1513669,2025-02-12,Senate,"Senate Comm - Favorable Recommendation",4,0,0,3,7
1918673,1513670,2025-03-03,Senate,"Senate/ passed 2nd reading",27,0,0,2,29
1918673,1513671,2025-03-04,Senate,"Senate/ passed 3rd reading",26,0,0,3,29
1918702,1511871,2025-01-28,House,"House Comm - Substitute Recommendation",14,0,0,2,16
1918702,1511872,2025-01-28,House,"House Comm - Favorable Recommendation",14,0,0,2,16
1918702,1511873,2025-02-06,House,"House/ passed 3rd reading",69,1,0,5,75
1918702,1511874,2025-02-19,Senate,"Senate Comm - Substitute Recommendation",5,0,0,4,9
1918702,1511875,2025-02-19,Senate,"Senate Comm - Amendment Recommendation",4,0,0,5,9
1918702,1511876,2025-02-19,Senate,"Senate Comm - Favorable Recommendation",7,0,0,2,9
1918702,1511877,2025-02-26,Senate,"Senate/ passed 2nd reading",22,3,0,4,29
1918702,1511878,2025-03-03,Senate,"Senate/ passed 3rd reading",20,5,0,4,29
1918702,1511879,2025-03-05,House,"House/ concurs with Senate amendment",62,13,0,0,75
1918728,1510513,2025-02-05,House,"House Comm - Substitute Recommendation",10,0,0,6,16
1918728,1510514,2025-02-05,House,"House Comm - Favorable Recommendation",10,0,0,6,16
1918728,1510515,2025-02-14,House,"House/ passed 3rd reading",70,0,0,5,75
1918728,1510516,2025-02-20,Senate,"Senate Comm - Favorable Recommendation",6,0,0,1,7
1918728,1510517,2025-03-03,Senate,"Senate/ passed 2nd reading",25,0,0,4,29
1918728,1510518,2025-03-04,Senate,"Senate/ passed 2nd & 3rd readings/ suspension",25,0,0,4,29
1918752,1514287,2025-02-13,House,"House Comm - Substitute Recommendation",6,0,0,4,10
1918752,1514288,2025-02-13,House,"House Comm - Held",6,0,0,4,10
1918752,1514289,2025-02-14,House,"House Comm - Favorable Recommendation",6,0,0,4,10
1918752,1514290,2025-02-24,House,"House/ passed 3rd reading",66,0,0,9,75
1918752,1514291,2025-02-27,Senate,"Senate Comm - Favorable Recommendation",3,0,0,3,6
1918752,1514292,2025-03-07,Senate,"Senate/ passed 2nd & 3rd readings/ suspension",27,0,0,2,29
1918752,1514293,2025-03-07,House,"House/ concurs with Senate amendment",67,0,0,8,75
1918807,1510519,2025-01-28,Senate,"Senate Comm - Favorable Recommendation",5,0,0,4,9
1918807,1510520,2025-02-07,Senate,"Senate/ passed 2nd reading",25,0,0,4,29
1918807,1510521,2025-02-10,Senate,"Senate/ passed 3rd reading",25,0,0,4,29
1918807,1510522,2025-02-18,House,"House Comm - Amendment Recommendation",8,0,0,3,11
1918807,1510523,2025-02-18,House,"House Comm - Favorable Recommendation",7,1,0,3,11
1918807,1510524,2025-02-26,House,"House/ passed 3rd reading",61,8,0,6,75
1918807,1510525,2025-02-27,Senate,"Senate/ concurs with House amendment",25,0,0,4,29
1918830,1510526,2025-01-24,Senate,"Senate Comm - Favorable Recommendation",5,0,0,1,6
1918830,1510527,2025-02-04,Senate,"Senate/ passed 2nd reading",26,0,0,3,29
1918830,1510528,2025-02-05,Senate,"Senate/ passed 3rd reading",28,0,0,1,29
1918830,1510529,2025-02-18,House,"House Comm - Favorable Recommendation",9,0,0,2,11
1918830,1510530,2025-02-18,House,"House Comm - Consent Calendar Recommendation",9,0,0,2,11
1918830,1510531,2025-02-21,House,"House/ passed 3rd reading",67,0,0,8,75
1918935,1512978,2025-02-03,House,"House Comm - Substitute Recommendation",7,0,0,4,11
1918935,1512979,2025-02-03,House,"House Comm - Favorable Recommendation",7,0,0,4,11
1918935,1512980,2025-02-11,House,"House/ passed 3rd reading",71,0,0,4,75
1918935,1512981,2025-02-28,Senate,"Senate Comm - Favorable Recommendation",5,4,0,0,9
1918935,1512982,2025-03-05,Senate,"Senate/ passed 2nd & 3rd readings/ suspension",16,10,0,3,29
1918935,1512983,2025-03-05,House,"House/ concurs with Senate amendment",64,5,0,6,75
1918989,1511860,2025-02-07,House,"House Comm - Substitute Recommendation",9,0,0,4,13
1918989,1511861,2025-02-07,House,"House Comm - Favorable Recommendation",9,0,0,4,13
1918989,1511862,2025-02-18,House,"House/ passed 3rd reading",68,0,0,7,75
1918989,1511863,2025-02-24,Senate,"Senate Comm - Favorable Recommendation",4,0,0,3,7
1919013,1510532,2025-02-04,House,"House Comm - Favorable Recommendation",11,0,0,0,11
1919013,1510533,2025-02-13,House,"House/ passed 3rd reading",71,1,0,3,75
1919013,1510534,2025-02-20,Senate,"Senate Comm - Favorable Recommendation",3,0,0,4,7
1919013,1510535,2025-02-26,Senate,"Senate/ passed 2nd reading",19,0,0,10,29
1919013,1510536,2025-03-03,Senate,"Senate/ passed 3rd reading",26,0,0,3,29
1919037,1510537,2025-01-29,House,"House/ passed 3rd reading",72,0,0,3,75
1919037,1510538,2025-01-30,Senate,"Senate/ passed 2nd & 3rd readings/ suspension",27,0,0,2,29
1919060,1510539,2025-01-28,House,"House Comm - Favorable Recommendation",8,0,0,2,10
1919060,1510540,2025-02-06,House,"House/ passed 3rd reading",69,1,0,5,75
1919060,1510541,2025-02-13,Senate,"Senate Comm - Favorable Recommendation",3,0,0,4,7
1919060,1510542,2025-02-20,Senate,"Senate/ passed 2nd reading",22,0,0,7,29
1919060,1510543,2025-02-21,Senate,"Senate/ passed 3rd reading",23,0,0,6,29
1919984,1510544,2025-01-22,Senate,"Senate/ passed 2nd & 3rd readings/ suspension",27,0,0,2,29
1920374,1510545,2025-01-21,House,"House/ passed 3rd reading",74,0,0,1,75
1920374,1510546,2025-01-29,Senate,"Senate Comm - Favorable Recommendation",5,0,0,2,7
1920374,1510547,2025-01-29,Senate,"Senate Comm - Consent Calendar Recommendation",5,0,0,2,7
1920374,1510548,2025-02-05,Senate,"Senate/ passed 3rd reading",29,0,0,0,29
1920848,1514557,2025-02-12,Senate,"Senate Comm - Substitute Recommendation",5,0,0,1,6
1920848,1514558,2025-02-12,Senate,"Senate Comm - Favorable Recommendation",4,1,0,1,6
1920848,1514559,2025-02-18,Senate,"Senate/ passed 2nd reading",15,7,0,7,29
1920848,1514560,2025-03-03,Senate,"Senate/ passed 3rd reading",23,5,0,1,29
1920848,1514561,2025-03-04,House,"House Comm - Favorable Recommendation",8,0,0,3,11
1920848,1514562,2025-03-07,House,"House/ passed 3rd reading",64,3,0,8,75
1920907,1510549,2025-01-27,House,"House Comm - Substitute Recommendation",10,0,0,0,10
1920907,1510550,2025-01-27,House,"House Comm - Favorable Recommendation",10,0,0,0,10
1920907,1510551,2025-02-05,House,"House/ passed 3rd reading",74,0,0,1,75
1920907,1510552,2025-02-12,Senate,"Senate Comm - Favorable Recommendation",5,0,0,2,7
1920907,1510553,2025-02-19,Senate,"Senate/ passed 2nd reading",23,0,0,6,29
1920907,1510554,2025-02-20,Senate,"Senate/ passed 3rd reading",20,3,0,6,29
1920969,1511963,2025-01-28,House,"House Comm - Substitute Recommendation",9,0,0,1,10
1920969,1511964,2025-01-28,House,"House Comm - Favorable Recommendation",8,1,0,1,10
1920969,1511965,2025-02-06,House,"House/ passed 3rd reading",38,34,0,3,75
1920969,1511966,2025-02-20,Senate,"Senate Comm - Favorable Recommendation",4,2,0,1,7
1920969,1511967,2025-03-07,Senate,"Senate/ passed 2nd & 3rd readings/ suspension",19,7,0,3,29
1920969,1511968,2025-03-07,House,"House/ concurs with Senate amendment",52,19,0,4,75
1921032,1510555,2025-01-27,House,"House Comm - Favorable Recommendation",13,0,0,0,13
1921032,1510556,2025-02-05,House,"House/ passed 3rd reading",75,0,0,0,75
1921032,1510557,2025-02-14,Senate,"Senate Comm - Favorable Recommendation",4,0,0,3,7
1921032,1510558,2025-02-19,Senate,"Senate/ passed 2nd reading",24,0,0,5,29
1921032,1510559,2025-02-20,Senate,"Senate/ passed 3rd reading",22,0,0,7,29
1921093,1510560,2025-01-21,House,"House/ passed 3rd reading",73,1,0,1,75
1921157,1510561,2025-01-28,House,"House Comm - Favorable Recommendation",13,0,0,3,16
1921157,1510562,2025-02-06,House,"House/ passed 3rd reading",70,0,0,5,75
1921157,1510563,2025-02-19,Senate,"Senate Comm - Favorable Recommendation",6,0,0,1,7
1921157,1510564,2025-02-27,Senate,"Senate/ passed 2nd reading",26,0,0,3,29
1921157,1510565,2025-02-28,Senate,"Senate/ passed 3rd reading",24,0,0,5,29
1921219,1510566,2025-02-06,House,"House Comm - Favorable Recommendation",8,0,0,3,11
1921219,1510567,2025-02-18,House,"House/ passed 3rd reading",69,0,0,6,75
1921219,1510568,2025-02-25,Senate,"Senate Comm - Favorable Recommendation",4,0,0,5,9
1921219,1510569,2025-03-05,Senate,"Senate/ passed 2nd & 3rd readings/ suspension",26,0,0,3,29
1921280,1510570,2025-01-30,Senate,"Senate Comm - Favorable Recommendation",6,0,0,1,7
1921280,1510571,2025-01-30,Senate,"Senate Comm - Consent Calendar Recommendation",6,0,0,1,7
1921280,1510572,2025-02-05,Senate,"Senate/ passed 3rd reading",28,0,0,1,29
1921280,1510573,2025-02-14,House,"House Comm - Favorable Recommendation",8,0,0,2,10
1921280,1510574,2025-02-14,House,"House Comm - Consent Calendar Recommendation",8,0,0,2,10
1921280,1510575,2025-02-20,House,"House/ passed 3rd reading",68,0,0,7,75
1921342,1510576,2025-01-28,Senate,"Senate Comm - Favorable Recommendation",7,0,0,2,9
1921342,1510577,2025-02-10,Senate,"Senate/ passed 2nd reading",27,0,0,2,29
1921342,1510578,2025-02-11,Senate,"Senate/ passed 3rd reading",28,0,0,1,29
1921342,1510579,2025-02-18,House,"House Comm - Favorable Recommendation",7,0,0,4,11
1921342,1510580,2025-02-26,House,"House/ passed 3rd reading",68,0,0,7,75
1921407,1511904,2025-01-28,Senate,"Senate Comm - Favorable Recommendation",6,0,0,3,9
1921407,1511905,2025-02-11,Senate,"Senate/ passed 2nd reading",24,0,0,5,29
1921407,1511906,2025-02-12,Senate,"Senate/ passed 3rd reading",26,0,0,3,29
1921407,1511907,2025-02-20,House,"House Comm - Amendment Recommendation",9,0,0,2,11
1921407,1511908,2025-02-20,House,"House Comm - Favorable Recommendation",9,0,0,2,11
1921407,1511909,2025-02-20,House,"House Comm - Consent Calendar Recommendation",10,0,0,1,11
1921407,1511910,2025-02-27,House,"House/ passed 3rd reading",67,0,0,8,75
1921407,1511911,2025-02-28,Senate,"Senate/ concurs with House amendment",25,0,0,4,29
1921468,1514179,2025-02-26,House,"House Comm - Held",8,0,0,2,10
1921535,1510581,2025-01-29,House,"House Comm - Favorable Recommendation",10,0,0,2,12
1921535,1510582,2025-02-10,House,"House/ passed 3rd reading",73,1,0,1,75
1921535,1510583,2025-02-18,Senate,"Senate Comm - Favorable Recommendation",5,1,0,2,8
1921535,1510584,2025-02-20,Senate,"Senate/ passed 2nd reading",22,1,0,6,29
1921535,1510585,2025-02-21,Senate,"Senate/ passed 3rd reading",17,10,0,2,29
1921661,1512840,2025-02-12,House,"House Comm - Favorable Recommendation",8,0,0,3,11
1921661,1512841,2025-02-19,House,"House/ passed 3rd reading",45,26,0,4,75
1921661,1512842,2025-02-25,Senate,"Senate Comm - Amendment Recommendation",5,0,0,4,9
1921661,1512843,2025-02-25,Senate,"Senate Comm - Favorable Recommendation",7,0,0,2,9
1921721,1511503,2025-02-13,House,"House Comm - Substitute Recommendation",12,2,0,2,16
1921721,1511504,2025-02-13,House,"House Comm - Favorable Recommendation",12,2,0,2,16
1921721,1511505,2025-02-21,House,"House/ passed 3rd reading",51,14,0,10,75
1921721,1511506,2025-03-03,Senate,"Senate Comm - Favorable Recommendation",4,3,0,0,7
1921721,1511507,2025-03-07,Senate,"Senate/ passed 2nd & 3rd readings/ suspension",18,8,0,3,29
1921721,1511508,2025-03-07,House,"House/ concurs with Senate amendment",52,13,0,10,75
1921785,1510586,2025-01-31,Senate,"Senate Comm - Substitute Recommendation",6,0,0,1,7
1921785,1510587,2025-01-31,Senate,"Senate Comm - Favorable Recommendation",6,0,0,1,7
1921785,1510588,2025-01-31,Senate,"Senate Comm - Consent Calendar Recommendation",6,0,0,1,7
1921785,1510589,2025-02-06,Senate,"Senate/ passed 3rd reading",27,0,0,2,29
1921785,1510590,2025-02-13,House,"House Comm - Favorable Recommendation",12,0,0,2,14
1921785,1510591,2025-02-20,House,"House/ passed 3rd reading",70,0,0,5,75
1921847,1513925,2025-02-06,House,"House Comm - Held",10,0,0,1,11
1921847,1513926,2025-02-18,House,"House Comm - Favorable Recommendation",7,0,0,4,11
1921847,1513927,2025-02-25,House,"House/ passed 3rd reading",44,20,0,11,75
1921847,1513928,2025-03-04,Senate,"Senate Comm - Favorable Recommendation",3,0,0,4,7
1921911,1514199,2025-02-03,House,"House Comm - Substitute Recommendation",10,0,0,1,11
1921911,1514200,2025-02-03,House,"House Comm - Favorable Recommendation",9,1,0,1,11
1921911,1514201,2025-02-12,House,"House/ passed 3rd reading",62,9,0,4,75
1921911,1514202,2025-02-25,Senate,"Senate Comm - Substitute Recommendation",8,0,0,1,9
1921911,1514203,2025-02-25,Senate,"Senate Comm - Amendment Recommendation",7,0,0,2,9
1921911,1514204,2025-02-25,Senate,"Senate Comm - Motion to Recommend Failed",3,4,0,2,9
1921911,1514205,2025-02-28,Senate,"Senate Comm - Substitute Recommendation",3,0,0,6,9
1921911,1514206,2025-02-28,Senate,"Senate Comm - Favorable Recommendation",6,3,0,0,9
1921911,1514207,2025-03-06,Senate,"Senate/ passed 2nd & 3rd readings/ suspension",21,8,0,0,29
1921911,1514208,2025-03-06,House,"House/ concurs with Senate amendment",56,11,0,8,75
1921972,1512047,2025-01-30,House,"House Comm - Favorable Recommendation",9,4,0,0,13
1921972,1512048,2025-03-04,House,"House/ passed 3rd reading",50,20,0,5,75
1922035,1510592,2025-01-29,House,"House Comm - Favorable Recommendation",8,0,0,4,12
1922035,1510593,2025-02-10,House,"House/ passed 3rd reading",71,0,0,4,75
1922035,1510594,2025-02-18,Senate,"Senate Comm - Favorable Recommendation",5,0,0,3,8
1922035,1510595,2025-02-18,Senate,"Senate Comm - Consent Calendar Recommendation",5,0,0,3,8
1922035,1510596,2025-02-21,Senate,"Senate/ passed 3rd reading",27,0,0,2,29
1923347,1512557,2025-02-05,Senate,"Senate Comm - Substitute Recommendation",6,0,0,2,8
1923347,1512558,2025-02-05,Senate,"Senate Comm - Favorable Recommendation",4,2,0,2,8
1923347,1512559,2025-02-21,Senate,"Senate/ passed 2nd reading",19,3,0,7,29
1923347,1512560,2025-02-24,Senate,"Senate/ passed 3rd reading",19,4,0,6,29
1923347,1512561,2025-02-27,House,"House Comm - Substitute Recommendation",8,1,0,5,14
1923347,1512562,2025-02-27,House,"House Comm - Favorable Recommendation",8,1,0,5,14
1923471,1510597,2025-01-22,House,"House Comm - Substitute Recommendation",11,0,0,0,11
1923471,1510598,2025-01-22,House,"House Comm - Favorable Recommendation",11,0,0,0,11
1923471,1510599,2025-01-30,House,"House/ passed 3rd reading",71,0,0,4,75
1923471,1510600,2025-02-12,Senate,"Senate Comm - Amendment Recommendation",3,0,0,4,7
1923471,1510601,2025-02-12,Senate,"Senate Comm - Favorable Recommendation",5,0,0,2,7
1923471,1510602,2025-02-26,Senate,"Senate/ failed",13,12,0,4,29
1923471,1510603,2025-02-27,Senate,"Senate/ passed 2nd reading",20,5,0,4,29
1923471,1510604,2025-02-28,Senate,"Senate/ passed 3rd reading",20,5,0,4,29
1923471,1510605,2025-03-03,House,"House/ concurs with Senate amendment",68,0,0,7,75
1923594,1511288,2025-01-24,Senate,"Senate Comm - Substitute Recommendation",5,0,0,2,7
1923594,1511289,2025-01-24,Senate,"Senate Comm - Held",7,0,0,0,7
1923594,1511290,2025-02-12,Senate,"Senate Comm - Substitute Recommendation",6,0,0,1,7
1923594,1511291,2025-02-12,Senate,"Senate Comm - Favorable Recommendation",6,0,0,1,7
1923594,1511292,2025-02-21,Senate,"Senate/ failed",13,9,0,7,29
1923594,1511293,2025-02-28,Senate,"Senate/ passed 2nd reading",15,12,0,2,29
1923594,1511294,2025-03-03,Senate,"Senate/ passed 3rd reading",17,10,0,2,29
1923594,1511295,2025-03-04,House,"House Comm - Favorable Recommendation",6,4,0,4,14
1923718,1512120,2025-01-29,Senate,"Senate Comm - Held",6,0,0,1,7
1923844,1510606,2025-02-03,House,"House Comm - Favorable Recommendation",11,0,0,3,14
1923844,1510607,2025-02-11,House,"House/ passed 3rd reading",73,0,0,2,75
1923844,1510608,2025-02-18,Senate,"Senate Comm - Favorable Recommendation",3,0,0,4,7
1923844,1510609,2025-02-26,Senate,"Senate/ passed 2nd reading",20,0,0,9,29
1923844,1510610,2025-02-27,Senate,"Senate/ passed 3rd reading",26,0,0,3,29
1923968,1511412,2025-02-14,House,"House Comm - Substitute Recommendation",9,0,0,4,13
1923968,1511413,2025-02-14,House,"House Comm - Favorable Recommendation",9,1,0,3,13
1923968,1511414,2025-02-24,House,"House/ passed 3rd reading",54,12,0,9,75
1923968,1511415,2025-02-28,Senate,"Senate Comm - Favorable Recommendation",3,1,0,4,8
1924090,1513061,2025-01-31,House,"House Comm - Favorable Recommendation",12,0,0,2,14
1924090,1513062,2025-02-11,House,"House/ passed 3rd reading",73,0,0,2,75
1924090,1513063,2025-02-19,Senate,"Senate Comm - Favorable Recommendation",6,0,0,1,7
1924090,1513064,2025-02-26,Senate,"Senate/ passed 2nd reading",22,0,0,7,29
1924213,1513012,2025-02-06,House,"House Comm - Substitute Recommendation",11,0,0,3,14
1924213,1513013,2025-02-06,House,"House Comm - Motion to Recommend Failed",4,7,0,3,14
1924213,1513014,2025-02-06,House,"House Comm - Held",11,0,0,3,14
1924213,1513015,2025-02-12,House,"House Comm - Substitute Recommendation",7,0,0,7,14
1924213,1513016,2025-02-12,House,"House Comm - Favorable Recommendation",7,0,0,7,14
1924213,1513017,2025-02-20,House,"House/ passed 3rd reading",67,0,0,8,75
1924213,1513018,2025-02-26,Senate,"Senate Comm - Favorable Recommendation",5,0,0,2,7
1924213,1513019,2025-03-07,Senate,"Senate/ passed 2nd & 3rd readings/ suspension",27,0,0,2,29
1924335,1512505,2025-02-06,Senate,"Senate Comm - Substitute Recommendation",5,0,0,2,7
1924335,1512506,2025-02-06,Senate,"Senate Comm - Motion to Recommend Failed",1,5,0,1,7
1924419,1514814,2025-01-31,Senate,"Senate Comm - Motion to Recommend Failed",1,5,0,1,7
1924495,1512168,2025-02-05,Senate,"Senate Comm - Substitute Recommendation",4,0,0,3,7
1924495,1512169,2025-02-05,Senate,"Senate Comm - Favorable Recommendation",4,0,0,3,7
1924495,1512170,2025-02-14,Senate,"Senate/ passed 2nd reading",22,1,0,6,29
1924495,1512171,2025-03-03,Senate,"Senate/ passed 3rd reading",28,1,0,0,29
1924495,1512172,2025-03-04,House,"House Comm - Substitute Recommendation",10,0,0,4,14
1924495,1512173,2025-03-04,House,"House Comm - Favorable Recommendation",10,0,0,4,14
1924495,1512174,2025-03-07,House,"House/ passed 3rd reading",71,0,0,4,75
1924495,1512175,2025-03-07,Senate,"Senate/ concurs with House amendment",27,0,0,2,29
1924570,1511362,2025-02-03,House,"House Comm - Favorable Recommendation",9,0,0,5,14
1924570,1511363,2025-02-11,House,"House/ passed 3rd reading",52,21,0,2,75
1924570,1511364,2025-02-19,Senate,"Senate Comm - Favorable Recommendation",5,0,0,2,7
1924570,1511365,2025-02-26,Senate,"Senate/ passed 2nd reading",19,0,0,10,29
1924570,1511366,2025-03-05,Senate,"Senate/ passed 2nd & 3rd readings/ suspension",25,0,0,4,29
1924648,1512101,2025-02-06,House,"House Comm - Substitute Recommendation",10,0,0,4,14
1924648,1512102,2025-02-06,House,"House Comm - Favorable Recommendation",10,0,0,4,14
1924648,1512103,2025-02-18,House,"House/ passed 3rd reading",67,0,0,8,75
1924648,1512104,2025-02-25,Senate,"Senate Comm - Favorable Recommendation",5,0,0,2,7
1924648,1512105,2025-03-07,Senate,"Senate/ passed 2nd & 3rd readings/ suspension",27,0,0,2,29
1924722,1514852,2025-02-13,Senate,"Senate Comm - Substitute Recommendation",4,0,0,3,7
1924722,1514853,2025-02-13,Senate,"Senate Comm - Favorable Recommendation",6,0,0,1,7
1924722,1514854,2025-02-21,Senate,"Senate/ passed 2nd reading",21,0,0,8,29
1924722,1514855,2025-02-25,Senate,"Senate/ passed 3rd reading",25,0,0,4,29
1924722,1514856,2025-02-26,House,"House Comm - Substitute Recommendation",8,0,0,2,10
1924722,1514857,2025-02-26,House,"House Comm - Amendment Recommendation",8,0,0,2,10
1924722,1514858,2025-02-26,House,"House Comm - Amendment Recommendation",8,0,0,2,10
1924722,1514859,2025-02-26,House,"House Comm - Favorable Recommendation",8,0,0,2,10
1924722,1514860,2025-03-06,House,"House/ passed 3rd reading",70,1,0,4,75
1924722,1514861,2025-03-06,Senate,"Senate/ concurs with House amendment",27,0,0,2,29
1924798,1510611,2025-02-18,House,"House Comm - Favorable Recommendation",7,3,0,6,16
1924798,1510612,2025-02-24,House,"House/ passed 3rd reading",64,3,0,8,75
1924798,1510613,2025-03-03,Senate,"Senate Comm - Substitute Recommendation",4,0,0,3,7
1924798,1510614,2025-03-03,Senate,"Senate Comm - Favorable Recommendation",4,0,0,3,7
1924798,1510615,2025-03-05,Senate,"Senate/ passed 2nd & 3rd readings/ suspension",26,0,0,3,29
1924798,1510616,2025-03-05,House,"House/ concurs with Senate amendment",70,2,0,3,75
1924875,1510617,2025-01-24,House,"House Comm - Substitute Recommendation",10,0,0,1,11
1924875,1510618,2025-01-24,House,"House Comm - Favorable Recommendation",8,2,0,1,11
1924875,1510619,2025-02-03,House,"House/ passed 3rd reading",60,14,0,1,75
1924875,1510620,2025-02-10,Senate,"Senate Comm - Favorable Recommendation",5,1,0,3,9
1924875,1510621,2025-02-19,Senate,"Senate/ passed 2nd reading",16,7,0,6,29
1924875,1510622,2025-02-20,Senate,"Senate/ passed 3rd reading",19,6,0,4,29
1924950,1510623,2025-01-27,Senate,"Senate Comm - Amendment Recommendation",3,0,0,4,7
1924950,1510624,2025-01-27,Senate,"Senate Comm - Favorable Recommendation",3,0,0,4,7
1924950,1510625,2025-02-06,Senate,"Senate/ passed 2nd reading",24,1,0,4,29
1924950,1510626,2025-02-07,Senate,"Senate/ passed 3rd reading",23,1,0,5,29
1924950,1510627,2025-02-13,House,"House Comm - Substitute Recommendation",11,0,0,3,14
1924950,1510628,2025-02-13,House,"House Comm - Favorable Recommendation",12,0,0,2,14
1924950,1510629,2025-02-26,House,"House/ passed 3rd reading",69,0,0,6,75
1924950,1510630,2025-02-27,Senate,"Senate/ concurs with House amendment",24,1,0,4,29
1925026,1512230,2025-02-13,House,"House Comm - Amendment Recommendation",13,0,0,3,16
1925026,1512231,2025-02-13,House,"House Comm - Favorable Recommendation",12,1,0,3,16
1925026,1512232,2025-02-21,House,"House/ passed 3rd reading",51,13,0,11,75
1925026,1512233,2025-03-04,Senate,"Senate Comm - Motion to Recommend Failed",2,3,0,2,7
1925105,1512463,2025-01-28,Senate,"Senate Comm - Favorable Recommendation",6,0,0,1,7
1925105,1512464,2025-02-04,Senate,"Senate/ passed 2nd reading",25,0,0,4,29
1925105,1512465,2025-02-05,Senate,"Senate/ passed 3rd reading",26,0,0,3,29
1925181,1510631,2025-01-28,House,"House Comm - Favorable Recommendation",12,0,0,2,14
1925181,1510632,2025-02-06,House,"House/ passed 3rd reading",72,0,0,3,75
1925181,1510633,2025-02-18,Senate,"Senate Comm - Favorable Recommendation",4,0,0,3,7
1925181,1510634,2025-02-19,Senate,"Senate/ passed 2nd reading",24,0,0,5,29
1925181,1510635,2025-02-20,Senate,"Senate/ passed 3rd reading",26,0,0,3,29
1925256,1513864,2025-02-12,House,"House Comm - Favorable Recommendation",11,0,0,3,14
1925256,1513865,2025-02-20,House,"House/ passed 3rd reading",66,0,0,9,75
1925256,1513866,2025-02-27,Senate,"Senate Comm - Favorable Recommendation",3,0,0,4,7
1925256,1513867,2025-03-06,Senate,"Senate/ passed 2nd & 3rd readings/ suspension",25,0,0,4,29
1925333,1513473,2025-02-19,House,"House Comm - Amendment Recommendation",8,0,0,8,16
1925333,1513474,2025-02-19,House,"House Comm - Favorable Recommendation",6,3,0,7,16
1925333,1513475,2025-02-26,House,"House/ passed 3rd reading",38,37,0,0,75
1925333,1513476,2025-03-03,Senate,"Senate Comm - Motion to Recommend Failed",2,2,0,3,7
1925484,1513119,2025-01-27,House,"House Comm - Substitute Recommendation",10,0,0,3,13
1925484,1513120,2025-01-27,House,"House Comm - Favorable Recommendation",10,0,0,3,13
1925484,1513121,2025-02-05,House,"House/ passed 3rd reading",72,0,0,3,75
1925484,1513122,2025-02-13,Senate,"Senate Comm - Substitute Recommendation",6,0,0,2,8
1925484,1513123,2025-02-13,Senate,"Senate Comm - Amendment Recommendation",6,0,0,2,8
1925484,1513124,2025-02-13,Senate,"Senate Comm - Favorable Recommendation",6,0,0,2,8
1925484,1513125,2025-03-05,Senate,"Senate/ passed 2nd & 3rd readings/ suspension",22,6,0,1,29
1925484,1513126,2025-03-06,Senate,"Senate Conference Committee - Final Passage",22,4,0,3,29
1925484,1513127,2025-03-06,House,"House Conference Committee - Final Passage",56,10,0,9,75
1925561,1511623,2025-02-13,Senate,"Senate Comm - Amendment Recommendation",4,0,0,3,7
1925561,1511624,2025-02-13,Senate,"Senate Comm - Favorable Recommendation",5,0,0,2,7
1925561,1511625,2025-02-24,Senate,"Senate/ passed 2nd reading",22,0,0,7,29
1925561,1511626,2025-02-25,Senate,"Senate/ passed 3rd reading",22,0,0,7,29
1925561,1511627,2025-02-28,House,"House Comm - Favorable Recommendation",11,0,0,3,14
1925561,1511628,2025-03-07,House,"House/ passed 3rd reading",66,0,0,9,75
1925636,1513086,2025-01-28,Senate,"Senate Comm - Substitute Recommendation",5,0,0,4,9
1925636,1513087,2025-01-28,Senate,"Senate Comm - Favorable Recommendation",6,0,0,3,9
1925636,1513088,2025-02-07,Senate,"Senate/ passed 2nd reading",24,0,0,5,29
1925636,1513089,2025-02-21,Senate,"Senate/ passed 3rd reading",25,1,0,3,29
1925636,1513090,2025-02-27,House,"House Comm - Favorable Recommendation",7,0,0,4,11
1925636,1513091,2025-03-06,House,"House/ passed 3rd reading",70,0,0,5,75
1925712,1513355,2025-02-05,House,"House Comm - Favorable Recommendation",14,0,0,2,16
1925712,1513356,2025-02-13,House,"House/ passed 3rd reading",72,0,0,3,75
1925712,1513357,2025-02-20,Senate,"Senate Comm - Favorable Recommendation",4,0,0,3,7
1925712,1513358,2025-03-06,Senate,"Senate/ passed 2nd & 3rd readings/ suspension",26,0,0,3,29
1927183,1512962,2025-01-30,House,"House Comm - Favorable Recommendation",10,1,0,2,13
1927183,1512963,2025-02-10,House,"House/ passed 3rd reading",58,14,0,3,75
1927183,1512964,2025-02-18,Senate,"Senate Comm - Favorable Recommendation",3,0,0,4,7
1927183,1512965,2025-02-20,Senate,"Senate/ passed 2nd reading",15,6,0,8,29
1927183,1512966,2025-02-24,Senate,"Senate/ passed 3rd reading",20,4,0,5,29
1927243,1514142,2025-02-07,Senate,"Senate Comm - Held",2,1,0,4,7
1927302,1512129,2025-01-30,Senate,"Senate Comm - Favorable Recommendation",5,1,0,1,7
1927302,1512130,2025-02-18,Senate,"Senate/ failed",12,13,0,4,29
1927302,1512131,2025-02-27,Senate,"Senate/ passed 2nd reading",23,2,0,4,29
1927302,1512132,2025-02-28,Senate,"Senate/ passed 3rd reading",23,3,0,3,29
1927302,1512133,2025-03-04,House,"House Comm - Amendment Recommendation",12,0,0,4,16
1927302,1512134,2025-03-04,House,"House Comm - Favorable Recommendation",8,4,0,4,16
1927302,1512135,2025-03-07,House,"House/ passed 3rd reading",46,23,0,6,75
1927302,1512136,2025-03-07,Senate,"Senate/ concurs with House amendment",22,4,0,3,29
1927363,1510636,2025-01-28,House,"House Comm - Substitute Recommendation",13,0,0,3,16
1927363,1510637,2025-01-28,House,"House Comm - Favorable Recommendation",13,0,0,3,16
1927363,1510638,2025-02-06,House,"House/ passed 3rd reading",71,0,0,4,75
1927363,1510639,2025-02-14,Senate,"Senate Comm - Substitute Recommendation",5,0,0,2,7
1927363,1510640,2025-02-14,Senate,"Senate Comm - Favorable Recommendation",6,0,0,1,7
1927363,1510641,2025-02-20,Senate,"Senate/ passed 2nd reading",22,0,0,7,29
1927363,1510642,2025-03-05,Senate,"Senate/ passed 2nd & 3rd readings/ suspension",20,5,0,4,29
1927363,1510643,2025-03-05,House,"House/ concurs with Senate amendment",68,0,0,7,75
1927483,1512297,2025-02-05,House,"House Comm - Substitute Recommendation",12,0,0,4,16
1927483,1512298,2025-02-05,House,"House Comm - Favorable Recommendation",12,0,0,4,16
1927483,1512299,2025-02-13,House,"House/ passed 3rd reading",72,0,0,3,75
1927483,1512300,2025-02-20,Senate,"Senate Comm - Favorable Recommendation",4,0,0,3,7
1927483,1512301,2025-03-06,Senate,"Senate/ passed 2nd & 3rd readings/ suspension",23,0,0,6,29
1927544,1513973,2025-01-30,House,"House Comm - Favorable Recommendation",8,0,0,2,10
1927544,1513974,2025-02-10,House,"House/ passed 3rd reading",48,23,0,4,75
1927544,1513975,2025-02-26,Senate,"Senate Comm - Substitute Recommendation",5,0,0,2,7
1927544,1513976,2025-02-26,Senate,"Senate Comm - Favorable Recommendation",3,2,0,2,7
1927544,1513977,2025-03-06,Senate,"Senate/ passed 2nd & 3rd readings/ suspension",27,1,0,1,29
1927544,1513978,2025-03-06,House,"House/ concurs with Senate amendment",47,22,0,6,75
1927605,1510644,2025-01-28,Senate,"Senate Comm - Substitute Recommendation",6,0,0,1,7
1927605,1510645,2025-01-28,Senate,"Senate Comm - Favorable Recommendation",5,0,0,2,7
1927605,1510646,2025-02-04,Senate,"Senate/ passed 2nd reading",26,0,0,3,29
1927605,1510647,2025-02-05,Senate,"Senate/ passed 3rd reading",26,0,0,3,29
1927605,1510648,2025-02-24,House,"House Comm - Amendment Recommendation",9,0,0,2,11
1927605,1510649,2025-02-24,House,"House Comm - Favorable Recommendation",9,0,0,2,11
1927605,1510650,2025-02-24,House,"House Comm - Consent Calendar Recommendation",9,0,0,2,11
1927605,1510651,2025-02-26,House,"House/ passed 3rd reading",65,0,0,10,75
1927605,1510652,2025-02-27,Senate,"Senate/ concurs with House amendment",26,0,0,3,29
1927665,1510653,2025-02-13,Senate,"Senate Comm - Favorable Recommendation",6,1,0,2,9
1927665,1510654,2025-02-21,Senate,"Senate/ passed 2nd reading",25,0,0,4,29
1927665,1510655,2025-02-24,Senate,"Senate/ passed 3rd reading",25,0,0,4,29
1927665,1510656,2025-03-03,House,"House Comm - Favorable Recommendation",8,0,0,3,11
1927665,1510657,2025-03-04,House,"House/ passed 3rd reading",71,0,0,4,75
1927726,1513610,2025-03-03,House,"House Comm - Favorable Recommendation",8,1,0,3,12
1927726,1513611,2025-03-04,House,"House/ passed 3rd reading",60,13,0,2,75
1927726,1513612,2025-03-07,Senate,"Senate/ passed 2nd & 3rd readings/ suspension",19,6,0,4,29
1927726,1513613,2025-03-07,House,"House/ concurs with Senate amendment",47,23,0,5,75
1927789,1513200,2025-01-31,Senate,"Senate Comm - Substitute Recommendation",6,0,0,3,9
1927789,1513201,2025-01-31,Senate,"Senate Comm - Favorable Recommendation",5,2,0,2,9
1927789,1513202,2025-02-11,Senate,"Senate/ passed 2nd reading",22,4,0,3,29
1927789,1513203,2025-02-12,Senate,"Senate/ passed 3rd reading",20,8,0,1,29
1927789,1513204,2025-02-24,House,"House Comm - Substitute Recommendation",9,0,0,2,11
1927789,1513205,2025-02-24,House,"House Comm - Favorable Recommendation",9,0,0,2,11
1927789,1513206,2025-03-06,House,"House/ passed 3rd reading",72,0,0,3,75
1927789,1513207,2025-03-06,Senate,"Senate/ concurs with House amendment",25,1,0,3,29
1927850,1511523,2025-02-07,House,"House Comm - Substitute Recommendation",6,0,0,4,10
1927850,1511524,2025-02-07,House,"House Comm - Favorable Recommendation",4,2,0,4,10
1927850,1511525,2025-02-18,House,"House/ failed",30,42,0,3,75
1927910,1510658,2025-01-22,House,"House Comm - Favorable Recommendation",10,0,0,1,11
1927910,1510659,2025-01-30,House,"House/ passed 3rd reading",70,0,0,5,75
1927910,1510660,2025-02-06,Senate,"Senate Comm - Favorable Recommendation",4,0,0,3,7
1927910,1510661,2025-02-13,Senate,"Senate/ passed 2nd reading",22,0,0,7,29
1927910,1510662,2025-02-14,Senate,"Senate/ passed 3rd reading",20,0,0,9,29
1927971,1510663,2025-01-30,House,"House Comm - Substitute Recommendation",9,0,0,2,11
1927971,1510664,2025-01-30,House,"House Comm - Favorable Recommendation",8,1,0,2,11
1927971,1510665,2025-02-10,House,"House/ passed 3rd reading",62,10,0,3,75
1927971,1510666,2025-02-18,Senate,"Senate Comm - Favorable Recommendation",4,1,0,2,7
1927971,1510667,2025-02-20,Senate,"Senate/ passed 2nd reading",16,8,0,5,29
1927971,1510668,2025-02-21,Senate,"Senate/ passed 3rd reading",16,7,0,6,29
1927971,1510669,2025-02-24,House,"House/ concurs with Senate amendment",59,13,0,3,75
1928091,1511730,2025-02-18,House,"House Comm - Substitute Recommendation",9,0,0,3,12
1928091,1511731,2025-02-18,House,"House Comm - Amendment Recommendation",10,0,0,2,12
1928091,1511732,2025-02-18,House,"House Comm - Favorable Recommendation",10,0,0,2,12
1928091,1511733,2025-02-25,House,"House/ passed 3rd reading",66,0,0,9,75
1928091,1511734,2025-02-28,Senate,"Senate Comm - Amendment Recommendation",6,0,0,2,8
1928091,1511735,2025-02-28,Senate,"Senate Comm - Favorable Recommendation",7,0,0,1,8
1928091,1511736,2025-03-07,Senate,"Senate/ passed 2nd & 3rd readings/ suspension",27,0,0,2,29
1928091,1511737,2025-03-07,House,"House/ concurs with Senate amendment",66,0,0,9,75
1928151,1510670,2025-01-31,House,"House Comm - Substitute Recommendation",10,0,0,6,16
1928151,1510671,2025-01-31,House,"House Comm - Favorable Recommendation",10,0,0,6,16
1928151,1510672,2025-02-10,House,"House/ passed 3rd reading",73,0,0,2,75
1928151,1510673,2025-02-19,Senate,"Senate Comm - Favorable Recommendation",6,0,0,1,7
1928151,1510674,2025-02-26,Senate,"Senate/ passed 2nd reading",21,0,0,8,29
1928151,1510675,2025-02-27,Senate,"Senate/ passed 3rd reading",28,0,0,1,29
1928272,1510676,2025-02-07,House,"House Comm - Substitute Recommendation",5,0,0,5,10
1928272,1510677,2025-02-07,House,"House Comm - Favorable Recommendation",5,0,0,5,10
1928272,1510678,2025-02-07,House,"House Comm - Consent Calendar Recommendation",5,0,0,5,10
1928272,1510679,2025-02-12,House,"House/ passed 3rd reading",73,0,0,2,75
1928272,1510680,2025-02-19,Senate,"Senate Comm - Favorable Recommendation",3,0,0,6,9
1928272,1510681,2025-02-26,Senate,"Senate/ passed 2nd reading",18,0,0,11,29
1928272,1510682,2025-02-27,Senate,"Senate/ passed 3rd reading",24,0,0,5,29
1928336,1514499,2025-01-29,Senate,"Senate Comm - Substitute Recommendation",4,0,0,3,7
1928336,1514500,2025-01-29,Senate,"Senate Comm - Favorable Recommendation",4,0,0,3,7
1928336,1514501,2025-02-07,Senate,"Senate/ passed 2nd reading",24,0,0,5,29
1928336,1514502,2025-02-10,Senate,"Senate/ passed 3rd reading",26,0,0,3,29
1928336,1514503,2025-02-26,House,"House Comm - Favorable Recommendation",8,0,0,5,13
1928336,1514504,2025-03-06,House,"House/ passed 3rd reading",49,18,0,8,75
1928573,1511555,2025-01-31,House,"House Comm - Amendment Recommendation",12,0,0,4,16
1928573,1511556,2025-01-31,House,"House Comm - Favorable Recommendation",10,3,0,3,16
1928573,1511557,2025-02-04,House,"House/ passed 3rd reading",63,9,0,3,75
1928573,1511558,2025-02-19,Senate,"Senate Comm - Amendment Recommendation",6,0,0,1,7
1928573,1511559,2025-02-19,Senate,"Senate Comm - Favorable Recommendation",6,1,0,0,7
1928573,1511560,2025-02-26,Senate,"Senate/ passed 2nd reading",15,5,0,9,29
1928573,1511561,2025-03-04,Senate,"Senate/ passed 2nd & 3rd readings/ suspension",21,5,0,3,29
1928573,1511562,2025-03-05,House,"House/ concurs with Senate amendment",65,9,0,1,75
1928808,1511485,2025-01-28,Senate,"Senate Comm - Substitute Recommendation",7,0,0,1,8
1928808,1511486,2025-01-28,Senate,"Senate Comm - Favorable Recommendation",7,0,0,1,8
1928808,1511487,2025-02-07,Senate,"Senate/ passed 2nd reading",24,0,0,5,29
1928808,1511488,2025-02-10,Senate,"Senate/ passed 3rd reading",24,1,0,4,29
1928808,1511489,2025-02-19,House,"House Comm - Substitute Recommendation",8,0,0,2,10
1928808,1511490,2025-02-19,House,"House Comm - Favorable Recommendation",9,0,0,1,10
1928808,1511491,2025-03-04,House,"House/ passed 3rd reading",64,3,0,8,75
1928808,1511492,2025-03-05,Senate,"Senate/ concurs with House amendment",25,1,0,3,29
1929934,1510683,2025-01-23,House,"House Comm - Substitute Recommendation",15,0,0,1,16
1929934,1510684,2025-01-23,House,"House Comm - Favorable Recommendation",11,4,0,1,16
1929934,1510685,2025-01-27,House,"House/ passed 3rd reading",42,32,0,1,75
1929934,1510686,2025-01-29,Senate,"Senate Comm - Favorable Recommendation",4,3,0,0,7
1929934,1510687,2025-01-30,Senate,"Senate/ passed 2nd reading",18,10,0,1,29
1929934,1510688,2025-02-06,Senate,"Senate/ passed 3rd reading",16,13,0,0,29
1929941,1513022,2025-02-21,House,"House Comm - Favorable Recommendation",10,1,0,5,16
1929941,1513023,2025-02-27,House,"House/ passed 3rd reading",67,2,0,6,75
1929941,1513024,2025-03-03,Senate,"Senate Comm - Favorable Recommendation",4,0,0,3,7
1929941,1513025,2025-03-07,Senate,"Senate/ passed 2nd & 3rd readings/ suspension",23,0,0,6,29
1929949,1510689,2025-01-31,House,"House Comm - Favorable Recommendation",12,0,0,2,14
1929949,1510690,2025-02-11,House,"House/ passed 3rd reading",74,0,0,1,75
1929949,1510691,2025-02-18,Senate,"Senate Comm - Favorable Recommendation",3,0,0,4,7
1929949,1510692,2025-02-20,Senate,"Senate/ passed 2nd reading",22,0,0,7,29
1929949,1510693,2025-02-21,Senate,"Senate/ passed 3rd reading",22,0,0,7,29
1929961,1510694,2025-01-23,House,"House Comm - Substitute Recommendation",14,0,0,2,16
1929961,1510695,2025-01-23,House,"House Comm - Favorable Recommendation",13,2,0,1,16
1929961,1510696,2025-01-28,House,"House/ passed 3rd reading",59,13,0,3,75
1929961,1510697,2025-01-30,Senate,"Senate Comm - Favorable Recommendation",5,1,0,1,7
1929961,1510698,2025-02-05,Senate,"Senate/ passed 2nd reading",22,7,0,0,29
1929961,1510699,2025-02-06,Senate,"Senate/ passed 3rd reading",20,7,0,2,29
1929961,1510700,2025-02-10,House,"House/ concurs with Senate amendment",59,14,0,2,75
1930083,1514117,2025-02-03,House,"House Comm - Substitute Recommendation",7,0,0,4,11
1930083,1514118,2025-02-03,House,"House Comm - Favorable Recommendation",7,0,0,4,11
1930083,1514119,2025-02-11,House,"House/ passed 3rd reading",69,0,0,6,75
1930083,1514120,2025-02-28,Senate,"Senate Comm - Favorable Recommendation",5,0,0,4,9
1930091,1512115,2025-02-10,House,"House Comm - Favorable Recommendation",11,0,0,3,14
1930091,1512116,2025-02-10,House,"House Comm - Consent Calendar Recommendation",11,0,0,3,14
1930091,1512117,2025-02-13,House,"House/ passed 3rd reading",69,0,0,6,75
1930091,1512118,2025-02-20,Senate,"Senate Comm - Favorable Recommendation",4,0,0,3,7
1930091,1512119,2025-03-07,Senate,"Senate/ passed 2nd & 3rd readings/ suspension",25,0,0,4,29
1930100,1510701,2025-02-05,House,"House Comm - Favorable Recommendation",13,0,0,1,14
1930100,1510702,2025-02-05,House,"House Comm - Consent Calendar Recommendation",12,0,0,2,14
1930100,1510703,2025-02-10,House,"House/ passed 3rd reading",69,0,0,6,75
1930100,1510704,2025-02-19,Senate,"Senate Comm - Favorable Recommendation",3,0,0,4,7
1930100,1510706,2025-02-26,Senate,"Senate/ passed 2nd reading",19,0,0,10,29
1930100,1510707,2025-02-27,Senate,"Senate/ passed 3rd reading",25,0,0,4,29
1930108,1514867,2025-02-13,House,"House Comm - Substitute Recommendation",9,0,0,7,16
1930108,1514868,2025-02-13,House,"House Comm - Favorable Recommendation",9,0,0,7,16
1930108,1514869,2025-02-21,House,"House/ passed 3rd reading",68,0,0,7,75
1930108,1514870,2025-02-28,Senate,"Senate Comm - Substitute Recommendation",4,0,0,4,8
1930108,1514871,2025-02-28,Senate,"Senate Comm - Motion to Recommend Failed",2,2,0,4,8
1930108,1514872,2025-03-03,Senate,"Senate Comm - Substitute Recommendation",4,0,0,4,8
1930108,1514873,2025-03-03,Senate,"Senate Comm - Favorable Recommendation",4,0,0,4,8
1930108,1514874,2025-03-04,Senate,"Senate/ passed 2nd & 3rd readings/ suspension",25,0,0,4,29
1930108,1514875,2025-03-05,House,"House/ concurs with Senate amendment",75,0,0,0,75
1930118,1510708,2025-02-03,House,"House Comm - Substitute Recommendation",12,0,0,0,12
1930118,1510709,2025-02-03,House,"House Comm - Favorable Recommendation",12,0,0,0,12
1930118,1510710,2025-02-14,House,"House/ passed 3rd reading",73,0,0,2,75
1930118,1510711,2025-02-25,Senate,"Senate Comm - Favorable Recommendation",5,0,0,3,8
1930118,1510712,2025-03-04,Senate,"Senate/ passed 2nd & 3rd readings/ suspension",22,4,0,3,29
1930126,1512449,2025-02-04,House,"House Comm - Favorable Recommendation",11,0,0,0,11
1930126,1512450,2025-02-13,House,"House/ passed 3rd reading",66,5,0,4,75
1930135,1511780,2025-01-31,House,"House Comm - Substitute Recommendation",13,0,0,3,16
1930135,1511781,2025-01-31,House,"House Comm - Amendment Recommendation",13,0,0,3,16
1930135,1511782,2025-01-31,House,"House Comm - Favorable Recommendation",11,2,0,3,16
1930135,1511783,2025-02-11,House,"House/ passed 3rd reading",48,19,0,8,75
1930135,1511784,2025-02-25,Senate,"Senate Comm - Substitute Recommendation",4,0,0,3,7
1930135,1511785,2025-02-25,Senate,"Senate Comm - Motion to Recommend Failed",2,2,0,3,7
1930135,1511786,2025-02-26,Senate,"Senate Comm - Favorable Recommendation",4,1,0,2,7
1930135,1511787,2025-03-07,Senate,"Senate/ passed 2nd & 3rd readings/ suspension",21,7,0,1,29
1930135,1511788,2025-03-07,House,"House/ concurs with Senate amendment",53,16,0,6,75
1930145,1511528,2025-02-03,House,"House Comm - Substitute Recommendation",9,0,0,2,11
1930145,1511529,2025-02-03,House,"House Comm - Favorable Recommendation",9,0,0,2,11
1930145,1511530,2025-02-11,House,"House/ passed 3rd reading",72,0,0,3,75
1930145,1511531,2025-02-28,Senate,"Senate Comm - Substitute Recommendation",4,0,0,5,9
1930145,1511532,2025-02-28,Senate,"Senate Comm - Favorable Recommendation",5,0,0,4,9
1930145,1511534,2025-03-07,Senate,"Senate/ passed 2nd & 3rd readings/ suspension",26,0,0,3,29
1930145,1511535,2025-03-07,House,"House/ concurs with Senate amendment",68,0,0,7,75
1930155,1514032,2025-02-25,House,"House Comm - Substitute Recommendation",10,0,0,3,13
1930155,1514033,2025-02-25,House,"House Comm - Favorable Recommendation",11,0,0,2,13
1930155,1514034,2025-02-27,House,"House/ passed 3rd reading",70,0,0,5,75
1930155,1514035,2025-03-04,Senate,"Senate Comm - Substitute Recommendation",6,0,0,1,7
1930155,1514036,2025-03-04,Senate,"Senate Comm - Favorable Recommendation",6,0,0,1,7
1930164,1514210,2025-01-29,House,"House Comm - Favorable Recommendation",10,0,0,2,12
1930164,1514211,2025-02-10,House,"House/ passed 3rd reading",74,0,0,1,75
1930164,1514212,2025-03-05,Senate,"Senate/ failed",6,22,0,1,29
1930173,1513929,2025-02-19,House,"House Comm - Substitute Recommendation",9,0,0,2,11
1930173,1513930,2025-02-19,House,"House Comm - Favorable Recommendation",7,2,0,2,11
1930173,1513931,2025-02-25,House,"House/ passed 3rd reading",56,14,0,5,75
1930183,1510713,2025-01-29,Senate,"Senate/ passed 2nd & 3rd readings/ suspension",25,0,0,4,29
1930183,1510714,2025-01-30,House,"House/ passed 3rd reading",73,0,0,2,75
1930191,1511747,2025-02-18,House,"House Comm - Substitute Recommendation",11,0,0,5,16
1930191,1511748,2025-02-18,House,"House Comm - Amendment Recommendation",11,1,0,4,16
1930191,1511749,2025-02-18,House,"House Comm - Favorable Recommendation",12,0,0,4,16
1930191,1511750,2025-02-24,House,"House/ passed 3rd reading",67,0,0,8,75
1930191,1511751,2025-02-28,Senate,"Senate Comm - Favorable Recommendation",4,0,0,4,8
1930191,1511752,2025-03-04,Senate,"Senate/ passed 2nd & 3rd readings/ suspension",26,0,0,3,29
1930198,1513688,2025-02-06,House,"House Comm - Substitute Recommendation",11,0,0,3,14
1930198,1513689,2025-02-06,House,"House Comm - Favorable Recommendation",10,1,0,3,14
1930198,1513690,2025-02-19,House,"House/ passed 3rd reading",67,2,0,6,75
1930198,1513691,2025-02-27,Senate,"Senate Comm - Amendment Recommendation",3,0,0,4,7
1930198,1513692,2025-02-27,Senate,"Senate Comm - Favorable Recommendation",3,0,0,4,7
1930198,1513693,2025-03-07,Senate,"Senate/ passed 2nd & 3rd readings/ suspension",17,10,0,2,29
1930198,1513694,2025-03-07,House,"House/ concurs with Senate amendment",60,9,0,6,75
1930205,1513136,2025-02-24,House,"House Comm - Substitute Recommendation",8,0,0,3,11
1930205,1513137,2025-02-24,House,"House Comm - Favorable Recommendation",8,0,0,3,11
1930205,1513138,2025-02-27,House,"House/ passed 3rd reading",69,0,0,6,75
1930205,1513139,2025-03-04,Senate,"Senate Comm - Favorable Recommendation",5,0,0,4,9
1930205,1513140,2025-03-06,Senate,"Senate/ passed 2nd & 3rd readings/ suspension",24,0,0,5,29
1930222,1513292,2025-02-21,Senate,"Senate Comm - Substitute Recommendation",7,0,0,2,9
1930222,1513293,2025-02-21,Senate,"Senate Comm - Favorable Recommendation",5,2,0,2,9
1930222,1513294,2025-02-25,Senate,"Senate/ passed 2nd reading",18,5,0,6,29
1930222,1513295,2025-02-26,Senate,"Senate/ passed 3rd reading",20,4,0,5,29
1930222,1513296,2025-03-03,House,"House Comm - Favorable Recommendation",9,0,0,2,11
1930222,1513297,2025-03-07,House,"House/ passed 3rd reading",69,0,0,6,75
1930222,1513298,2025-03-07,Senate,"Senate/ concurs with House amendment",24,1,0,4,29
1930332,1510715,2025-01-29,House,"House/ passed 3rd reading",72,0,0,3,75
1930332,1510716,2025-01-30,Senate,"Senate/ passed 2nd & 3rd readings/ suspension",26,0,0,3,29
1930430,1510717,2025-02-03,House,"House Comm - Amendment Recommendation",10,0,0,4,14
1930430,1510718,2025-02-03,House,"House Comm - Favorable Recommendation",10,0,0,4,14
1930430,1510719,2025-02-11,House,"House/ passed 3rd reading",71,0,0,4,75
1930430,1510720,2025-02-18,Senate,"Senate Comm - Substitute Recommendation",4,0,0,3,7
1930430,1510721,2025-02-18,Senate,"Senate Comm - Favorable Recommendation",4,0,0,3,7
1930430,1510722,2025-02-26,Senate,"Senate/ passed 2nd reading",25,0,0,4,29
1930430,1510723,2025-02-27,Senate,"Senate/ passed 3rd reading",28,0,0,1,29
1930430,1510724,2025-02-28,House,"House/ concurs with Senate amendment",65,0,0,10,75
1930528,1510725,2025-01-29,House,"House/ passed 3rd reading",73,0,0,2,75
1930528,1510726,2025-01-30,Senate,"Senate/ passed 2nd & 3rd readings/ suspension",27,1,0,1,29
1930626,1510727,2025-01-29,House,"House/ passed 3rd reading",71,0,0,4,75
1930626,1510728,2025-01-30,Senate,"Senate/ passed 2nd & 3rd readings/ suspension",27,0,0,2,29
1930723,1510729,2025-01-29,Senate,"Senate/ passed 2nd & 3rd readings/ suspension",26,0,0,3,29
1930723,1510730,2025-01-30,House,"House/ passed 3rd reading",75,0,0,0,75
1930725,1510731,2025-01-29,Senate,"Senate/ passed 2nd & 3rd readings/ suspension",28,0,0,1,29
1930725,1510732,2025-01-30,House,"House/ passed 3rd reading",74,0,0,1,75
1930739,1510733,2025-01-29,House,"House/ passed 3rd reading",70,0,0,5,75
1930739,1510734,2025-01-30,Senate,"Senate/ passed 2nd & 3rd readings/ suspension",28,0,0,1,29
1930752,1510735,2025-01-29,Senate,"Senate/ passed 2nd & 3rd readings/ suspension",27,0,0,2,29
1930752,1510736,2025-01-30,House,"House/ passed 3rd reading",74,0,0,1,75
1930845,1510737,2025-02-03,House,"House Comm - Favorable Recommendation",12,0,0,0,12
1930845,1510738,2025-02-11,House,"House/ passed 3rd reading",61,10,0,4,75
1930845,1510739,2025-02-19,Senate,"Senate Comm - Favorable Recommendation",5,1,0,2,8
1930845,1510740,2025-02-27,Senate,"Senate/ passed 2nd reading",16,10,0,3,29
1930845,1510741,2025-02-28,Senate,"Senate/ passed 3rd reading",16,8,0,5,29
1930875,1510742,2025-01-24,Senate,"Senate Comm - Favorable Recommendation",5,0,0,1,6
1930875,1510743,2025-02-04,Senate,"Senate/ passed 2nd reading",25,0,0,4,29
1930875,1510744,2025-02-05,Senate,"Senate/ passed 3rd reading",28,0,0,1,29
1930875,1510745,2025-02-21,House,"House Comm - Favorable Recommendation",7,0,0,3,10
1930875,1510746,2025-02-21,House,"House Comm - Consent Calendar Recommendation",7,0,0,3,10
1930875,1510747,2025-02-24,House,"House/ passed 3rd reading",70,0,0,5,75
1930902,1513349,2025-02-25,Senate,"Senate Comm - Substitute Recommendation",6,0,0,3,9
1930902,1513350,2025-02-25,Senate,"Senate Comm - Favorable Recommendation",6,0,0,3,9
1930902,1513351,2025-03-04,Senate,"Senate/ passed 2nd & 3rd readings/ suspension",26,0,0,3,29
1930936,1512837,2025-02-05,House,"House Comm - Amendment Recommendation",8,0,0,2,10
1930936,1512838,2025-02-05,House,"House Comm - Held",8,0,0,2,10
1930936,1512839,2025-02-13,House,"House Comm - Held",7,3,0,0,10
1930997,1510748,2025-02-06,House,"House Comm - Favorable Recommendation",7,0,0,4,11
1930997,1510749,2025-02-10,House,"House/ passed 3rd reading",70,0,0,5,75
1930997,1510750,2025-02-27,Senate,"Senate Comm - Favorable Recommendation",5,0,0,4,9
1930997,1510751,2025-02-27,Senate,"Senate Comm - Consent Calendar Recommendation",5,0,0,4,9
1930997,1510752,2025-03-04,Senate,"Senate/ passed 3rd reading",29,0,0,0,29
1931059,1512020,2025-01-28,Senate,"Senate Comm - Substitute Recommendation",4,0,0,4,8
1931059,1512021,2025-01-28,Senate,"Senate Comm - Favorable Recommendation",4,0,0,4,8
1931059,1512022,2025-02-07,Senate,"Senate/ passed 2nd reading",25,0,0,4,29
1931059,1512023,2025-02-10,Senate,"Senate/ passed 3rd reading",27,0,0,2,29
1931059,1512024,2025-03-07,House,"House/ passed 3rd reading",63,9,0,3,75
1931059,1512025,2025-03-07,House,"House Conference Committee - Final Passage",53,1,0,21,75
1931059,1512026,2025-03-07,Senate,"Senate Conference Committee - Final Passage",16,11,0,2,29
1931087,1514440,2025-01-27,Senate,"Senate Comm - Favorable Recommendation",5,0,0,2,7
1931087,1514441,2025-02-04,Senate,"Senate/ passed 2nd reading",24,0,0,5,29
1931087,1514442,2025-02-05,Senate,"Senate/ passed 3rd reading",27,0,0,2,29
1931087,1514443,2025-02-13,House,"House Comm - Favorable Recommendation",11,0,0,3,14
1931087,1514444,2025-03-04,House,"House/ passed 3rd reading",71,0,0,4,75
1931118,1513329,2025-02-24,House,"House Comm - Held",6,3,0,2,11
1931145,1510753,2025-01-24,Senate,"Senate Comm - Favorable Recommendation",7,0,0,0,7
1931145,1510754,2025-02-03,Senate,"Senate/ passed 2nd reading",27,0,0,2,29
1931145,1510755,2025-02-04,Senate,"Senate/ passed 3rd reading",29,0,0,0,29
1931145,1510756,2025-02-18,House,"House Comm - Favorable Recommendation",8,0,0,2,10
1931145,1510757,2025-02-18,House,"House Comm - Consent Calendar Recommendation",8,0,0,2,10
1931145,1510758,2025-02-20,House,"House/ passed 3rd reading",71,0,0,4,75
1931151,1514054,2025-02-07,House,"House Comm - Substitute Recommendation",11,0,0,2,13
1931151,1514055,2025-02-07,House,"House Comm - Favorable Recommendation",11,0,0,2,13
1931151,1514056,2025-02-18,House,"House/ passed 3rd reading",69,0,0,6,75
1931151,1514057,2025-02-27,Senate,"Senate Comm - Favorable Recommendation",4,0,0,3,7
1931713,1512195,2025-02-13,House,"House Comm - Substitute Recommendation",10,0,0,1,11
1931713,1512196,2025-02-13,House,"House Comm - Favorable Recommendation",10,0,0,1,11
1931713,1512197,2025-02-21,House,"House/ passed 3rd reading",68,0,0,7,75
1931713,1512198,2025-03-04,Senate,"Senate Comm - Favorable Recommendation",2,1,0,4,7
1933844,1510759,2025-01-31,Senate,"Senate Comm - Favorable Recommendation",6,0,0,3,9
1933844,1510760,2025-02-11,Senate,"Senate/ passed 2nd reading",22,0,0,7,29
1933844,1510761,2025-02-12,Senate,"Senate/ passed 3rd reading",28,0,0,1,29
1933844,1510762,2025-02-20,House,"House Comm - Favorable Recommendation",10,0,0,1,11
1933844,1510763,2025-02-26,House,"House/ passed 3rd reading",61,0,0,14,75
1933953,1512619,2025-02-19,House,"House Comm - Substitute Recommendation",7,0,0,3,10
1933953,1512620,2025-02-19,House,"House Comm - Amendment Recommendation",8,0,0,2,10
1933953,1512621,2025-02-19,House,"House Comm - Favorable Recommendation",8,0,0,2,10
1933953,1512622,2025-02-25,House,"House/ passed 3rd reading",44,20,0,11,75
1933953,1512623,2025-03-04,Senate,"Senate Comm - Favorable Recommendation",5,0,0,2,7
1934068,1514972,2025-01-29,Senate,"Senate Comm - Substitute Recommendation",4,0,0,3,7
1934068,1514973,2025-01-29,Senate,"Senate Comm - Held",4,0,0,3,7
1934185,1510764,2025-01-28,House,"House Comm - Favorable Recommendation",9,0,0,1,10
1934185,1510765,2025-02-06,House,"House/ passed 3rd reading",70,0,0,5,75
1934185,1510766,2025-02-14,Senate,"Senate Comm - Favorable Recommendation",4,0,0,2,6
1934185,1510767,2025-02-19,Senate,"Senate/ passed 2nd reading",20,1,0,8,29
1934185,1510768,2025-02-20,Senate,"Senate/ passed 3rd reading",22,2,0,5,29
1934303,1510769,2025-01-31,Senate,"Senate Comm - Favorable Recommendation",5,0,0,4,9
1934303,1510770,2025-01-31,Senate,"Senate Comm - Consent Calendar Recommendation",5,0,0,4,9
1934303,1510771,2025-02-06,Senate,"Senate/ passed 3rd reading",27,0,0,2,29
1934303,1510772,2025-02-13,House,"House Comm - Substitute Recommendation",7,0,0,4,11
1934303,1510773,2025-02-13,House,"House Comm - Favorable Recommendation",7,0,0,4,11
1934303,1510774,2025-02-13,House,"House Comm - Consent Calendar Recommendation",8,0,0,3,11
1934303,1510775,2025-02-18,House,"House/ passed 3rd reading",73,0,0,2,75
1934303,1510776,2025-02-19,Senate,"Senate/ concurs with House amendment",25,0,0,4,29
1934414,1510777,2025-01-31,House,"House Comm - Amendment Recommendation",12,0,0,2,14
1934414,1510778,2025-01-31,House,"House Comm - Favorable Recommendation",12,0,0,2,14
1934414,1510779,2025-02-11,House,"House/ passed 3rd reading",74,0,0,1,75
1934414,1510780,2025-02-19,Senate,"Senate Comm - Favorable Recommendation",6,0,0,1,7
1934414,1510781,2025-02-26,Senate,"Senate/ passed 2nd reading",21,0,0,8,29
1934414,1510782,2025-02-27,Senate,"Senate/ passed 3rd reading",18,5,0,6,29
1934630,1513443,2025-02-13,House,"House Comm - Favorable Recommendation",9,0,0,4,13
1934630,1513444,2025-02-13,House,"House Comm - Consent Calendar Recommendation",9,0,0,4,13
1934630,1513445,2025-02-18,House,"House/ passed 3rd reading",73,0,0,2,75
1934630,1513446,2025-02-27,Senate,"Senate Comm - Favorable Recommendation",5,0,0,2,7
1934730,1513617,2025-02-25,Senate,"Senate Comm - Substitute Recommendation",8,0,0,1,9
1934730,1513618,2025-02-25,Senate,"Senate Comm - Favorable Recommendation",7,1,0,1,9
1934730,1513619,2025-03-03,Senate,"Senate/ passed 2nd reading",20,5,0,4,29
1934730,1513620,2025-03-04,Senate,"Senate/ passed 3rd reading",26,3,0,0,29
1934730,1513621,2025-03-07,House,"House/ passed 3rd reading",66,2,0,7,75
1934831,1511719,2025-01-29,House,"House Comm - Favorable Recommendation",9,0,0,2,11
1934831,1511720,2025-02-07,House,"House/ passed 3rd reading",73,0,0,2,75
1934831,1511721,2025-02-07,House,"House/ passed 3rd reading",72,0,0,3,75
1934831,1511722,2025-02-28,Senate,"Senate Comm - Favorable Recommendation",5,0,0,4,9
1934831,1511723,2025-03-07,Senate,"Senate/ passed 2nd & 3rd readings/ suspension",28,0,0,1,29
1934933,1513027,2025-02-18,Senate,"Senate Comm - Substitute Recommendation",6,0,0,3,9
1934933,1513028,2025-02-18,Senate,"Senate Comm - Amendment Recommendation",6,0,0,3,9
1934933,1513029,2025-02-18,Senate,"Senate Comm - Favorable Recommendation",6,0,0,3,9
1934933,1513030,2025-02-21,Senate,"Senate/ passed 2nd reading",24,0,0,5,29
1934933,1513031,2025-02-24,Senate,"Senate/ passed 3rd reading",26,0,0,3,29
1934933,1513032,2025-03-03,House,"House Comm - Amendment Recommendation",12,1,0,0,13
1934933,1513033,2025-03-03,House,"House Comm - Favorable Recommendation",10,3,0,0,13
1934933,1513034,2025-03-07,House,"House/ passed 3rd reading",75,0,0,0,75
1934933,1513035,2025-03-07,Senate,"Senate/ concurs with House amendment",20,5,0,4,29
1935033,1513932,2025-02-10,House,"House Comm - Favorable Recommendation",9,0,0,5,14
1935033,1513933,2025-02-19,House,"House/ passed 3rd reading",65,0,0,10,75
1935033,1513934,2025-02-25,Senate,"Senate Comm - Favorable Recommendation",3,1,0,3,7
1935033,1513935,2025-03-07,Senate,"Senate/ passed 2nd & 3rd readings/ suspension",27,0,0,2,29
1935131,1510783,2025-02-20,House,"House Comm - Amendment Recommendation",10,0,0,3,13
1935131,1510784,2025-02-20,House,"House Comm - Favorable Recommendation",10,0,0,3,13
1935131,1510785,2025-02-26,House,"House/ passed 3rd reading",72,0,0,3,75
1935131,1510786,2025-03-03,Senate,"Senate Comm - Favorable Recommendation",5,0,0,2,7
1935131,1510787,2025-03-05,Senate,"Senate/ passed 2nd & 3rd readings/ suspension",25,0,0,4,29
1935330,1512095,2025-02-04,House,"House Comm - Favorable Recommendation",9,4,0,0,13
1935330,1512096,2025-02-25,House,"House/ passed 3rd reading",57,15,0,3,75
1935330,1512097,2025-03-03,Senate,"Senate Comm - Substitute Recommendation",5,0,0,3,8
1935330,1512098,2025-03-03,Senate,"Senate Comm - Favorable Recommendation",5,3,0,0,8
1935330,1512099,2025-03-06,Senate,"Senate/ passed 2nd & 3rd readings/ suspension",19,10,0,0,29
1935330,1512100,2025-03-06,House,"House/ concurs with Senate amendment",56,15,0,4,75
1935705,1511478,2025-02-13,House,"House Comm - Substitute Recommendation",11,0,0,5,16
1935705,1511479,2025-02-13,House,"House Comm - Favorable Recommendation",11,0,0,5,16
1935705,1511480,2025-02-21,House,"House/ passed 3rd reading",66,0,0,9,75
1935705,1511481,2025-02-26,Senate,"Senate Comm - Favorable Recommendation",2,0,0,5,7
1935705,1511482,2025-03-06,Senate,"Senate/ passed 2nd & 3rd readings/ suspension",26,0,0,3,29
1936083,1511834,2025-01-31,Senate,"Senate Comm - Substitute Recommendation",7,0,0,2,9
1936083,1511835,2025-01-31,Senate,"Senate Comm - Favorable Recommendation",5,3,0,1,9
1936821,1511806,2025-02-13,House,"House Comm - Held",7,6,0,3,16
1936821,1511807,2025-02-21,House,"House Comm - Amendment Recommendation",8,0,0,8,16
1936821,1511808,2025-02-21,House,"House Comm - Favorable Recommendation",6,2,0,8,16
1936821,1511809,2025-02-27,House,"House/ passed 3rd reading",40,33,0,2,75
1936821,1511810,2025-03-03,Senate,"Senate Comm - Motion to Recommend Failed",2,2,0,3,7
1936861,1512276,2025-02-14,Senate,"Senate Comm - Substitute Recommendation",7,0,0,1,8
1936861,1512277,2025-02-14,Senate,"Senate Comm - Favorable Recommendation",4,3,0,1,8
1936861,1512278,2025-03-05,Senate,"Senate/ failed",13,14,0,2,29
1936904,1510788,2025-02-05,House,"House Comm - Substitute Recommendation",12,0,0,2,14
1936904,1510789,2025-02-05,House,"House Comm - Favorable Recommendation",12,0,0,2,14
1936904,1510790,2025-02-14,House,"House/ passed 3rd reading",72,0,0,3,75
1936904,1510791,2025-02-20,Senate,"Senate Comm - Amendment Recommendation",3,0,0,4,7
1936904,1510792,2025-02-20,Senate,"Senate Comm - Favorable Recommendation",4,0,0,3,7
1936904,1510793,2025-03-05,Senate,"Senate/ passed 2nd & 3rd readings/ suspension",25,0,0,4,29
1936904,1510794,2025-03-05,House,"House/ concurs with Senate amendment",73,0,0,2,75
1936946,1512951,2025-01-28,Senate,"Senate Comm - Favorable Recommendation",5,0,0,2,7
1936946,1512952,2025-02-04,Senate,"Senate/ passed 2nd reading",26,0,0,3,29
1936946,1512953,2025-02-07,Senate,"Senate/ passed 3rd reading",22,0,0,7,29
1936946,1512954,2025-02-14,House,"House Comm - Favorable Recommendation",10,0,0,4,14
1936946,1512955,2025-03-07,House,"House/ passed 3rd reading",71,0,0,4,75
1936988,1510795,2025-01-31,Senate,"Senate Comm - Substitute Recommendation",6,0,0,1,7
1936988,1510796,2025-01-31,Senate,"Senate Comm - Favorable Recommendation",6,0,0,1,7
1936988,1510797,2025-02-10,Senate,"Senate/ passed 2nd reading",25,0,0,4,29
1936988,1510798,2025-02-11,Senate,"Senate/ passed 3rd reading",28,0,0,1,29
1936988,1510799,2025-02-24,House,"House Comm - Favorable Recommendation",11,0,0,3,14
1936988,1510800,2025-02-26,House,"House/ passed 3rd reading",69,0,0,6,75
1937033,1512221,2025-02-12,House,"House Comm - Favorable Recommendation",10,0,0,1,11
1937033,1512222,2025-02-19,House,"House/ failed",22,49,0,4,75
1937119,1513629,2025-01-31,Senate,"Senate Comm - Substitute Recommendation",6,0,0,3,9
1937119,1513630,2025-01-31,Senate,"Senate Comm - Favorable Recommendation",7,0,0,2,9
1937119,1513631,2025-02-11,Senate,"Senate/ passed 2nd reading",21,0,0,8,29
1937119,1513632,2025-02-12,Senate,"Senate/ passed 3rd reading",29,0,0,0,29
1937119,1513633,2025-02-24,House,"House Comm - Favorable Recommendation",10,0,0,1,11
1937119,1513634,2025-03-04,House,"House/ passed 3rd reading",75,0,0,0,75
1937163,1511327,2025-02-05,House,"House Comm - Substitute Recommendation",14,0,0,2,16
1937163,1511328,2025-02-05,House,"House Comm - Favorable Recommendation",14,0,0,2,16
1937163,1511329,2025-02-13,House,"House/ passed 3rd reading",71,0,0,4,75
1937163,1511330,2025-02-26,Senate,"Senate Comm - Substitute Recommendation",3,0,0,4,7
1937163,1511331,2025-02-26,Senate,"Senate Comm - Favorable Recommendation",3,0,0,4,7
1937163,1511332,2025-03-07,Senate,"Senate/ passed 2nd & 3rd readings/ suspension",22,4,0,3,29
1937163,1511333,2025-03-07,House,"House/ concurs with Senate amendment",58,6,0,11,75
1937261,1511204,2025-02-03,House,"House Comm - Held",11,0,0,1,12
1937261,1511205,2025-02-06,House,"House Comm - Substitute Recommendation",11,0,0,1,12
1937261,1511206,2025-02-06,House,"House Comm - Favorable Recommendation",11,0,0,1,12
1937261,1511207,2025-02-18,House,"House/ passed 3rd reading",66,2,0,7,75
1937261,1511208,2025-02-25,Senate,"Senate Comm - Favorable Recommendation",5,0,0,3,8
1937261,1511209,2025-02-25,Senate,"Senate Comm - Consent Calendar Recommendation",5,0,0,3,8
1937261,1511210,2025-03-03,Senate,"Senate/ passed 3rd reading",27,0,0,2,29
1937365,1513502,2025-02-13,House,"House Comm - Substitute Recommendation",8,0,0,5,13
1937365,1513503,2025-02-13,House,"House Comm - Favorable Recommendation",8,0,0,5,13
1937365,1513504,2025-02-21,House,"House/ passed 3rd reading",68,0,0,7,75
1937365,1513505,2025-02-27,Senate,"Senate Comm - Favorable Recommendation",4,1,0,2,7
1937365,1513506,2025-03-07,Senate,"Senate/ passed 2nd & 3rd readings/ suspension",21,4,0,4,29
1937365,1513507,2025-03-07,House,"House/ concurs with Senate amendment",69,0,0,6,75
1937467,1515206,2025-02-05,House,"House Comm - Substitute Recommendation",8,0,0,2,10
1937467,1515207,2025-02-05,House,"House Comm - Favorable Recommendation",8,0,0,2,10
1937467,1515208,2025-02-18,House,"House/ passed 3rd reading",69,0,0,6,75
1937467,1515209,2025-02-24,Senate,"Senate Comm - Favorable Recommendation",4,0,0,2,6
1937467,1515210,2025-03-07,Senate,"Senate/ passed 2nd & 3rd readings/ suspension",22,6,0,1,29
1937467,1515211,2025-03-07,House,"House/ concurs with Senate amendment",55,12,0,8,75
1937677,1510801,2025-02-20,House,"House Comm - Substitute Recommendation",11,0,0,3,14
1937677,1510802,2025-02-20,House,"House Comm - Favorable Recommendation",10,1,0,3,14
1937677,1510803,2025-02-26,House,"House/ passed 3rd reading",63,6,0,6,75
1937677,1510804,2025-03-04,Senate,"Senate Comm - Favorable Recommendation",4,0,0,3,7
1937677,1510805,2025-03-05,Senate,"Senate/ passed 2nd & 3rd readings/ suspension",25,2,0,2,29
1937782,1514638,2025-02-03,House,"House Comm - Substitute Recommendation",8,0,0,3,11
1937782,1514639,2025-02-03,House,"House Comm - Amendment Recommendation",8,0,0,3,11
1937782,1514640,2025-02-03,House,"House Comm - Favorable Recommendation",9,0,0,2,11
1937782,1514641,2025-02-12,House,"House/ passed 3rd reading",60,12,0,3,75
1937782,1514642,2025-02-27,Senate,"Senate Comm - Substitute Recommendation",3,0,0,6,9
1937782,1514643,2025-02-27,Senate,"Senate Comm - Amendment Recommendation",3,0,0,6,9
1937782,1514644,2025-02-27,Senate,"Senate Comm - Favorable Recommendation",4,0,0,5,9
1937782,1514645,2025-03-05,Senate,"Senate/ passed 2nd & 3rd readings/ suspension",19,5,0,5,29
1937782,1514646,2025-03-05,House,"House/ concurs with Senate amendment",57,15,0,3,75
1937887,1510806,2025-02-10,House,"House Comm - Favorable Recommendation",10,1,0,5,16
1937887,1510807,2025-02-18,House,"House/ passed 3rd reading",66,5,0,4,75
1937887,1510808,2025-02-25,Senate,"Senate Comm - Favorable Recommendation",4,1,0,2,7
1937887,1510809,2025-03-05,Senate,"Senate/ passed 2nd & 3rd readings/ suspension",24,0,0,5,29
1937991,1513044,2025-02-03,House,"House Comm - Substitute Recommendation",9,0,0,5,14
1937991,1513045,2025-02-03,House,"House Comm - Favorable Recommendation",9,0,0,5,14
1937991,1513046,2025-02-11,House,"House/ passed 3rd reading",72,0,0,3,75
1937991,1513047,2025-02-18,Senate,"Senate Comm - Substitute Recommendation",5,0,0,2,7
1937991,1513048,2025-02-18,Senate,"Senate Comm - Favorable Recommendation",5,0,0,2,7
1937991,1513049,2025-02-20,Senate,"Senate/ passed 2nd reading",22,0,0,7,29
1937991,1513050,2025-02-26,Senate,"Senate/ passed 3rd reading",20,0,0,9,29
1937991,1513051,2025-02-27,House,"House/ concurs with Senate amendment",61,0,0,14,75
1937991,1513052,2025-03-04,Senate,"Senate Conference Committee - Final Passage",28,0,0,1,29
1937991,1513053,2025-03-05,House,"House Conference Committee - Final Passage",70,0,0,5,75
1938319,1510810,2025-02-03,Senate,"Senate Comm - Favorable Recommendation",5,0,0,1,6
1938319,1510811,2025-02-11,Senate,"Senate/ passed 2nd reading",23,0,0,6,29
1938319,1510812,2025-02-18,Senate,"Senate/ passed 3rd reading",27,0,0,2,29
1938319,1510813,2025-03-04,House,"House Comm - Favorable Recommendation",6,0,0,4,10
1938319,1510814,2025-03-05,House,"House/ passed 3rd reading",59,13,0,3,75
1938542,1510815,2025-01-30,House,"House Comm - Favorable Recommendation",11,0,0,2,13
1938542,1510816,2025-02-10,House,"House/ passed 3rd reading",48,25,0,2,75
1938542,1510817,2025-02-14,Senate,"Senate Comm - Favorable Recommendation",4,0,0,3,7
1938542,1510818,2025-02-19,Senate,"Senate/ passed 2nd reading",18,4,0,7,29
1938542,1510819,2025-02-20,Senate,"Senate/ passed 3rd reading",16,5,0,8,29
1938763,1510820,2025-02-04,Senate,"Senate Comm - Substitute Recommendation",5,0,0,2,7
1938763,1510821,2025-02-04,Senate,"Senate Comm - Favorable Recommendation",6,0,0,1,7
1938763,1510822,2025-02-11,Senate,"Senate/ passed 2nd reading",25,0,0,4,29
1938763,1510823,2025-02-12,Senate,"Senate/ passed 3rd reading",27,0,0,2,29
1938763,1510824,2025-02-21,House,"House Comm - Favorable Recommendation",8,0,0,2,10
1938763,1510825,2025-03-04,House,"House/ passed 3rd reading",68,0,0,7,75
1938983,1511819,2025-01-31,House,"House Comm - Held",10,3,0,3,16
1939916,1512923,2025-02-03,Senate,"Senate Comm - Favorable Recommendation",5,0,0,2,7
1939916,1512924,2025-02-11,Senate,"Senate/ passed 2nd reading",24,1,0,4,29
1939916,1512925,2025-02-20,Senate,"Senate/ passed 3rd reading",26,0,0,3,29
1939916,1512926,2025-02-26,House,"House Comm - Favorable Recommendation",7,2,0,4,13
1939916,1512927,2025-03-06,House,"House/ passed 3rd reading",56,17,0,2,75
1939916,1512928,2025-03-06,Senate,"Senate/ concurs with House amendment",28,0,0,1,29
1940030,1515172,2025-02-14,Senate,"Senate Comm - Substitute Recommendation",4,0,0,3,7
1940030,1515173,2025-02-14,Senate,"Senate Comm - Favorable Recommendation",3,0,0,4,7
1940030,1515174,2025-02-21,Senate,"Senate/ passed 2nd reading",23,0,0,6,29
1940030,1515175,2025-02-24,Senate,"Senate/ passed 3rd reading",20,2,0,7,29
1940030,1515176,2025-03-03,House,"House Comm - Substitute Recommendation",12,0,0,1,13
1940030,1515177,2025-03-03,House,"House Comm - Favorable Recommendation",12,0,0,1,13
1940030,1515178,2025-03-07,House,"House/ passed 3rd reading",74,0,0,1,75
1940030,1515179,2025-03-07,Senate,"Senate/ concurs with House amendment",26,0,0,3,29
1940149,1512844,2025-02-19,House,"House Comm - Favorable Recommendation",5,3,0,3,11
1940149,1512845,2025-02-25,House,"House/ passed 3rd reading",68,1,0,6,75
1940266,1514090,2025-02-14,House,"House Comm - Substitute Recommendation",9,0,0,1,10
1940266,1514091,2025-02-14,House,"House Comm - Amendment Recommendation",10,0,0,0,10
1940266,1514092,2025-02-14,House,"House Comm - Favorable Recommendation",8,2,0,0,10
1940266,1514093,2025-02-24,House,"House/ circled",0,0,0,75,75
1940266,1514094,2025-02-25,House,"House/ passed 3rd reading",71,0,0,4,75
1940266,1514095,2025-03-04,Senate,"Senate Comm - Motion to Recommend Failed",2,4,0,1,7
1940383,1511385,2025-02-18,House,"House Comm - Substitute Recommendation",11,0,0,3,14
1940383,1511386,2025-02-18,House,"House Comm - Favorable Recommendation",11,0,0,3,14
1940618,1513108,2025-03-04,House,"House/ passed 3rd reading",73,0,0,2,75
1940618,1513109,2025-03-05,Senate,"Senate/ passed 2nd & 3rd readings/ suspension",21,1,0,7,29
1940738,1513983,2025-02-14,Senate,"Senate Comm - Substitute Recommendation",4,0,0,3,7
1940738,1513984,2025-02-14,Senate,"Senate Comm - Favorable Recommendation",4,0,0,3,7
1940738,1513985,2025-02-21,Senate,"Senate/ passed 2nd reading",23,0,0,6,29
1940738,1513986,2025-02-24,Senate,"Senate/ passed 3rd reading",19,5,0,5,29
1940854,1511728,2025-03-04,Senate,"Senate/ passed 2nd & 3rd readings/ suspension",24,0,0,5,29
1940854,1511729,2025-03-05,House,"House/ passed 3rd reading",72,0,0,3,75
1941090,1510826,2025-02-06,Senate,"Senate Comm - Substitute Recommendation",3,0,0,3,6
1941090,1510827,2025-02-06,Senate,"Senate Comm - Favorable Recommendation",4,0,0,2,6
1941090,1510828,2025-02-18,Senate,"Senate/ passed 2nd reading",24,0,0,5,29
1941090,1510829,2025-02-19,Senate,"Senate/ passed 3rd reading",25,0,0,4,29
1941090,1510830,2025-02-25,House,"House Comm - Favorable Recommendation",7,0,0,3,10
1941090,1510831,2025-02-27,House,"House/ passed 3rd reading",62,2,0,11,75
1941209,1510832,2025-02-04,House,"House Comm - Favorable Recommendation",12,0,0,1,13
1941209,1510833,2025-02-11,House,"House/ passed 3rd reading",71,0,0,4,75
1941209,1510834,2025-02-19,Senate,"Senate Comm - Substitute Recommendation",6,0,0,1,7
1941209,1510835,2025-02-19,Senate,"Senate Comm - Favorable Recommendation",6,0,0,1,7
1941209,1510836,2025-02-26,Senate,"Senate/ passed 2nd reading",19,0,0,10,29
1941209,1510837,2025-02-27,Senate,"Senate/ passed 3rd reading",26,0,0,3,29
1941209,1510838,2025-02-28,House,"House/ concurs with Senate amendment",64,0,0,11,75
1941334,1513880,2025-02-21,House,"House Comm - Motion to Recommend Failed",2,7,0,7,16
1941361,1510839,2025-02-06,House,"House Comm - Favorable Recommendation",10,0,0,1,11
1941361,1510840,2025-02-18,House,"House/ passed 3rd reading",64,0,0,11,75
1941361,1510841,2025-02-27,Senate,"Senate Comm - Favorable Recommendation",4,0,0,5,9
1941361,1510842,2025-03-04,Senate,"Senate/ passed 2nd & 3rd readings/ suspension",27,0,0,2,29
1941420,1511563,2025-02-14,House,"House Comm - Amendment Recommendation",8,0,0,2,10
1941420,1511564,2025-02-14,House,"House Comm - Favorable Recommendation",8,0,0,2,10
1941420,1511565,2025-02-24,House,"House/ failed",32,36,0,7,75
1941480,1510843,2025-02-04,Senate,"Senate Comm - Substitute Recommendation",5,0,0,2,7
1941480,1510844,2025-02-04,Senate,"Senate Comm - Favorable Recommendation",5,0,0,2,7
1941480,1510845,2025-02-11,Senate,"Senate/ passed 2nd reading",23,0,0,6,29
1941480,1510846,2025-02-12,Senate,"Senate/ passed 3rd reading",28,0,0,1,29
1941480,1510847,2025-02-27,House,"House Comm - Amendment Recommendation",11,0,0,5,16
1941480,1510848,2025-02-27,House,"House Comm - Amendment Recommendation",11,0,0,5,16
1941480,1510849,2025-02-27,House,"House Comm - Favorable Recommendation",11,0,0,5,16
1941480,1510850,2025-03-05,House,"House/ passed 3rd reading",72,0,0,3,75
1941480,1510851,2025-03-05,Senate,"Senate/ concurs with House amendment",27,0,0,2,29
1941508,1511231,2025-02-18,House,"House Comm - Substitute Recommendation",12,0,0,4,16
1941508,1511232,2025-02-18,House,"House Comm - Favorable Recommendation",12,0,0,4,16
1941508,1511233,2025-02-24,House,"House/ passed 3rd reading",57,12,0,6,75
1941508,1511234,2025-02-28,Senate,"Senate Comm - Favorable Recommendation",4,0,0,4,8
1941508,1511235,2025-03-07,Senate,"Senate/ passed 2nd & 3rd readings/ suspension",27,0,0,2,29
1941538,1512665,2025-02-14,House,"House Comm - Substitute Recommendation",7,0,0,3,10
1941538,1512666,2025-02-14,House,"House Comm - Amendment Recommendation",7,0,0,3,10
1941538,1512667,2025-02-14,House,"House Comm - Amendment Recommendation",7,0,0,3,10
1941538,1512668,2025-02-14,House,"House Comm - Favorable Recommendation",8,0,0,2,10
1941538,1512669,2025-02-24,House,"House/ passed 3rd reading",71,0,0,4,75
1941538,1512670,2025-02-27,Senate,"Senate Comm - Favorable Recommendation",3,0,0,3,6
1941570,1513257,2025-02-14,House,"House Comm - Substitute Recommendation",11,0,0,1,12
1941570,1513258,2025-02-14,House,"House Comm - Held",12,0,0,0,12
1941570,1513259,2025-02-18,House,"House Comm - Substitute Recommendation",10,0,0,2,12
1941570,1513260,2025-02-18,House,"House Comm - Amendment Recommendation",10,0,0,2,12
1941570,1513261,2025-02-18,House,"House Comm - Favorable Recommendation",11,0,0,1,12
1941570,1513262,2025-02-27,House,"House/ passed 3rd reading",66,3,0,6,75
1941570,1513263,2025-03-03,Senate,"Senate Comm - Favorable Recommendation",6,0,0,1,7
1941570,1513264,2025-03-06,Senate,"Senate/ passed 2nd & 3rd readings/ suspension",28,1,0,0,29
1941570,1513265,2025-03-06,House,"House/ concurs with Senate amendment",70,0,0,5,75
1941597,1514753,2025-02-18,House,"House Comm - Substitute Recommendation",7,0,0,3,10
1941597,1514754,2025-02-18,House,"House Comm - Favorable Recommendation",7,0,0,3,10
1941597,1514755,2025-02-24,House,"House/ passed 3rd reading",69,0,0,6,75
1941597,1514756,2025-03-03,Senate,"Senate Comm - Favorable Recommendation",4,0,0,2,6
1941597,1514757,2025-03-07,Senate,"Senate/ passed 2nd & 3rd readings/ suspension",26,0,0,3,29
1941628,1514244,2025-02-18,House,"House Comm - Substitute Recommendation",12,0,0,2,14
1941628,1514245,2025-02-18,House,"House Comm - Favorable Recommendation",12,0,0,2,14
1941628,1514246,2025-02-24,House,"House/ passed 3rd reading",68,0,0,7,75
1941628,1514247,2025-02-28,Senate,"Senate Comm - Favorable Recommendation",7,0,0,1,8
1941628,1514248,2025-03-07,Senate,"Senate/ passed 2nd & 3rd readings/ suspension",27,0,0,2,29
1941628,1514249,2025-03-07,House,"House/ concurs with Senate amendment",68,0,0,7,75
1941656,1514783,2025-01-29,Senate,"Senate Comm - Substitute Recommendation",5,0,0,2,7
1941656,1514784,2025-01-29,Senate,"Senate Comm - Favorable Recommendation",5,0,0,2,7
1941656,1514785,2025-02-07,Senate,"Senate/ passed 2nd reading",24,0,0,5,29
1941656,1514786,2025-02-11,Senate,"Senate/ passed 3rd reading",27,0,0,2,29
1941656,1514787,2025-02-27,House,"House Comm - Favorable Recommendation",8,0,0,3,11
1941656,1514788,2025-03-06,House,"House/ passed 3rd reading",71,0,0,4,75
1941686,1511846,2025-02-05,House,"House Comm - Substitute Recommendation",12,0,0,2,14
1941686,1511847,2025-02-05,House,"House Comm - Amendment Recommendation",12,0,0,2,14
1941686,1511848,2025-02-05,House,"House Comm - Favorable Recommendation",13,0,0,1,14
1941686,1511849,2025-02-14,House,"House/ passed 3rd reading",71,0,0,4,75
1941686,1511850,2025-02-25,Senate,"Senate Comm - Favorable Recommendation",5,0,0,4,9
1941865,1513796,2025-03-03,House,"House Comm - Amendment Recommendation",9,0,0,2,11
1941865,1513797,2025-03-03,House,"House Comm - Favorable Recommendation",9,0,0,2,11
1941865,1513798,2025-03-04,House,"House/ passed 3rd reading",60,13,0,2,75
1941913,1510852,2025-01-30,Senate,"Senate Comm - Favorable Recommendation",3,0,0,4,7
1941913,1510853,2025-02-10,Senate,"Senate/ passed 2nd reading",26,0,0,3,29
1941913,1510854,2025-02-11,Senate,"Senate/ passed 3rd reading",27,0,0,2,29
1941913,1510855,2025-02-19,House,"House Comm - Favorable Recommendation",9,0,0,5,14
1941913,1510856,2025-02-26,House,"House/ passed 3rd reading",61,0,0,14,75
1941963,1511790,2025-02-10,House,"House Comm - Favorable Recommendation",11,0,0,3,14
1941963,1511791,2025-02-10,House,"House Comm - Consent Calendar Recommendation",11,0,0,3,14
1941963,1511792,2025-02-13,House,"House/ passed 3rd reading",68,0,0,7,75
1941963,1511793,2025-02-26,Senate,"Senate Comm - Favorable Recommendation",3,0,0,4,7
1941963,1511794,2025-03-07,Senate,"Senate/ passed 2nd & 3rd readings/ suspension",24,0,0,5,29
1941963,1511795,2025-03-07,House,"House/ concurs with Senate amendment",70,0,0,5,75
1942013,1514048,2025-02-18,House,"House Comm - Substitute Recommendation",10,0,0,4,14
1942013,1514049,2025-02-18,House,"House Comm - Favorable Recommendation",10,0,0,4,14
1942013,1514050,2025-02-25,House,"House/ passed 3rd reading",59,1,0,15,75
1942013,1514051,2025-02-28,Senate,"Senate Comm - Favorable Recommendation",4,0,0,3,7
1942063,1510857,2025-01-31,Senate,"Senate Comm - Favorable Recommendation",5,0,0,3,8
1942063,1510858,2025-02-11,Senate,"Senate/ passed 2nd reading",22,0,0,7,29
1942063,1510859,2025-02-12,Senate,"Senate/ passed 3rd reading",26,0,0,3,29
1942063,1510860,2025-02-24,House,"House Comm - Favorable Recommendation",9,1,0,2,12
1942063,1510861,2025-02-27,House,"House/ passed 3rd reading",67,0,0,8,75
1942108,1512146,2025-02-12,House,"House Comm - Favorable Recommendation",9,2,0,0,11
1942108,1512147,2025-02-20,House,"House/ passed 3rd reading",70,1,0,4,75
1942108,1512148,2025-03-04,Senate,"Senate Comm - Favorable Recommendation",4,0,0,3,7
1942108,1512149,2025-03-07,Senate,"Senate/ passed 2nd & 3rd readings/ suspension",27,0,0,2,29
1942159,1511913,2025-02-13,Senate,"Senate Comm - Held",4,0,0,3,7
1942216,1512253,2025-02-04,House,"House Comm - Substitute Recommendation",13,0,0,0,13
1942216,1512254,2025-02-04,House,"House Comm - Favorable Recommendation",10,3,0,0,13
1942216,1512255,2025-02-14,House,"House/ passed 3rd reading",59,13,0,3,75
1942216,1512256,2025-03-03,Senate,"Senate Comm - Substitute Recommendation",4,0,0,4,8
1942216,1512257,2025-03-03,Senate,"Senate Comm - Amendment Recommendation",4,0,0,4,8
1942216,1512258,2025-03-03,Senate,"Senate Comm - Motion to Recommend Failed",3,4,0,1,8
1942268,1510862,2025-02-05,Senate,"Senate Comm - Substitute Recommendation",5,0,0,4,9
1942268,1510863,2025-02-05,Senate,"Senate Comm - Favorable Recommendation",6,0,0,3,9
1942268,1510864,2025-02-11,Senate,"Senate/ passed 2nd reading",25,0,0,4,29
1942268,1510865,2025-02-14,Senate,"Senate/ passed 3rd reading",23,0,0,6,29
1942268,1510866,2025-02-27,House,"House Comm - Motion to Recommend Failed",3,6,0,2,11
1942268,1510867,2025-02-27,House,"House Comm - Held",6,3,0,2,11
1942268,1510868,2025-03-03,House,"House Comm - Substitute Recommendation",8,1,0,2,11
1942268,1510869,2025-03-03,House,"House Comm - Favorable Recommendation",9,0,0,2,11
1942268,1510870,2025-03-05,House,"House/ passed 3rd reading",71,0,0,4,75
1942268,1510871,2025-03-05,Senate,"Senate/ concurs with House amendment",27,0,0,2,29
1942399,1510872,2025-01-30,Senate,"Senate Comm - Substitute Recommendation",4,0,0,3,7
1942399,1510873,2025-01-30,Senate,"Senate Comm - Favorable Recommendation",4,0,0,3,7
1942399,1510874,2025-02-11,Senate,"Senate/ passed 2nd reading",22,0,0,7,29
1942399,1510875,2025-02-12,Senate,"Senate/ passed 3rd reading",26,0,0,3,29
1942399,1510876,2025-02-24,House,"House Comm - Amendment Recommendation",9,0,0,2,11
1942399,1510877,2025-02-24,House,"House Comm - Favorable Recommendation",9,0,0,2,11
1942399,1510878,2025-02-24,House,"House Comm - Consent Calendar Recommendation",9,0,0,2,11
1942399,1510879,2025-02-26,House,"House/ passed 3rd reading",66,0,0,9,75
1942399,1510880,2025-02-27,Senate,"Senate/ concurs with House amendment",27,0,0,2,29
1942476,1510881,2025-02-12,House,"House Comm - Amendment Recommendation",8,0,0,3,11
1942476,1510882,2025-02-12,House,"House Comm - Favorable Recommendation",8,0,0,3,11
1942476,1510883,2025-02-12,House,"House Comm - Consent Calendar Recommendation",8,0,0,3,11
1942476,1510884,2025-02-18,House,"House/ passed 3rd reading",73,0,0,2,75
1942476,1510885,2025-02-27,Senate,"Senate Comm - Favorable Recommendation",5,0,0,4,9
1942476,1510886,2025-02-27,Senate,"Senate Comm - Consent Calendar Recommendation",4,0,0,5,9
1942476,1510887,2025-03-04,Senate,"Senate/ passed 3rd reading",29,0,0,0,29
1942554,1514705,2025-02-05,Senate,"Senate Comm - Substitute Recommendation",5,0,0,4,9
1942554,1514706,2025-02-05,Senate,"Senate Comm - Motion to Recommend Failed",3,3,0,3,9
1942554,1514707,2025-02-10,Senate,"Senate Comm - Substitute Recommendation",6,0,0,3,9
1942554,1514708,2025-02-10,Senate,"Senate Comm - Favorable Recommendation",5,3,0,1,9
1942630,1510888,2025-02-04,Senate,"Senate Comm - Favorable Recommendation",7,0,0,0,7
1942630,1510889,2025-02-11,Senate,"Senate/ passed 2nd reading",22,2,0,5,29
1942630,1510890,2025-02-12,Senate,"Senate/ passed 3rd reading",22,2,0,5,29
1942630,1510891,2025-02-25,House,"House Comm - Favorable Recommendation",10,0,0,6,16
1942630,1510892,2025-02-27,House,"House/ passed 3rd reading",68,1,0,6,75
1942787,1514379,2025-02-05,House,"House Comm - Substitute Recommendation",14,0,0,2,16
1942787,1514380,2025-02-05,House,"House Comm - Favorable Recommendation",14,0,0,2,16
1942787,1514381,2025-02-13,House,"House/ passed 3rd reading",71,0,0,4,75
1942787,1514382,2025-02-20,Senate,"Senate Comm - Amendment Recommendation",4,0,0,4,8
1942787,1514383,2025-02-20,Senate,"Senate Comm - Favorable Recommendation",4,0,0,4,8
1942787,1514384,2025-02-27,Senate,"Senate/ passed 2nd reading",22,0,0,7,29
1942787,1514385,2025-02-28,Senate,"Senate/ passed 3rd reading",23,0,0,6,29
1942787,1514386,2025-03-03,House,"House/ concurs with Senate amendment",71,0,0,4,75
1943587,1510893,2025-02-04,House,"House Comm - Substitute Recommendation",8,0,0,5,13
1943587,1510894,2025-02-04,House,"House Comm - Favorable Recommendation",8,0,0,5,13
1943587,1510895,2025-02-13,House,"House/ passed 3rd reading",72,0,0,3,75
1943587,1510896,2025-02-19,Senate,"Senate Comm - Favorable Recommendation",5,0,0,3,8
1943587,1510897,2025-02-27,Senate,"Senate/ passed 2nd reading",27,0,0,2,29
1943587,1510898,2025-02-28,Senate,"Senate/ passed 3rd reading",26,0,0,3,29
1943669,1510899,2025-02-05,House,"House Comm - Substitute Recommendation",10,0,0,6,16
1943669,1510900,2025-02-05,House,"House Comm - Favorable Recommendation",10,0,0,6,16
1943669,1510901,2025-02-14,House,"House/ passed 3rd reading",70,0,0,5,75
1943669,1510902,2025-02-20,Senate,"Senate Comm - Amendment Recommendation",5,0,0,2,7
1943669,1510903,2025-02-20,Senate,"Senate Comm - Favorable Recommendation",6,0,0,1,7
1943669,1510904,2025-03-05,Senate,"Senate/ passed 2nd & 3rd readings/ suspension",25,0,0,4,29
1943669,1510905,2025-03-05,House,"House/ concurs with Senate amendment",74,0,0,1,75
1943749,1514392,2025-02-14,Senate,"Senate Comm - Amendment Recommendation",6,0,0,2,8
1943749,1514393,2025-02-14,Senate,"Senate Comm - Favorable Recommendation",6,0,0,2,8
1943749,1514394,2025-02-21,Senate,"Senate/ passed 2nd reading",24,0,0,5,29
1943749,1514395,2025-02-24,Senate,"Senate/ passed 3rd reading",23,0,0,6,29
1943749,1514396,2025-02-28,House,"House Comm - Favorable Recommendation",6,0,0,4,10
1943749,1514397,2025-03-06,House,"House/ passed 3rd reading",69,0,0,6,75
1943827,1510906,2025-02-10,Senate,"Senate Comm - Substitute Recommendation",6,0,0,3,9
1943827,1510907,2025-02-10,Senate,"Senate Comm - Favorable Recommendation",6,0,0,3,9
1943827,1510908,2025-02-18,Senate,"Senate/ passed 2nd reading",21,0,0,8,29
1943827,1510909,2025-02-19,Senate,"Senate/ passed 3rd reading",23,0,0,6,29
1943827,1510910,2025-02-24,House,"House Comm - Favorable Recommendation",9,0,0,2,11
1943827,1510911,2025-02-26,House,"House/ passed 3rd reading",66,0,0,9,75
1943876,1510912,2025-02-03,House,"House Comm - Favorable Recommendation",10,0,0,4,14
1943876,1510913,2025-02-11,House,"House/ passed 3rd reading",73,0,0,2,75
1943876,1510914,2025-02-18,Senate,"Senate Comm - Amendment Recommendation",3,0,0,4,7
1943876,1510915,2025-02-18,Senate,"Senate Comm - Favorable Recommendation",3,0,0,4,7
1943876,1510916,2025-02-19,Senate,"Senate/ passed 2nd reading",22,2,0,5,29
1943876,1510917,2025-02-20,Senate,"Senate/ passed 3rd reading",24,2,0,3,29
1943876,1510918,2025-02-24,House,"House/ concurs with Senate amendment",69,0,0,6,75
1943921,1510919,2025-02-03,House,"House Comm - Favorable Recommendation",12,0,0,0,12
1943921,1510920,2025-02-03,House,"House Comm - Consent Calendar Recommendation",12,0,0,0,12
1943921,1510921,2025-02-06,House,"House/ passed 3rd reading",75,0,0,0,75
1943921,1510922,2025-02-13,Senate,"Senate Comm - Favorable Recommendation",3,0,0,4,7
1943921,1510923,2025-02-13,Senate,"Senate Comm - Consent Calendar Recommendation",3,0,0,4,7
1943921,1510924,2025-02-20,Senate,"Senate/ passed 3rd reading",23,0,0,6,29
1943963,1514903,2025-02-18,Senate,"Senate Comm - Substitute Recommendation",3,0,0,3,6
1943963,1514904,2025-02-18,Senate,"Senate Comm - Favorable Recommendation",5,0,0,1,6
1943963,1514905,2025-02-21,Senate,"Senate/ passed 2nd reading",26,0,0,3,29
1943963,1514906,2025-02-24,Senate,"Senate/ passed 3rd reading",22,0,0,7,29
1943963,1514907,2025-02-28,House,"House Comm - Favorable Recommendation",7,0,0,3,10
1943963,1514908,2025-03-06,House,"House/ passed 3rd reading",50,20,0,5,75
1944005,1513832,2025-01-30,Senate,"Senate Comm - Amendment Recommendation",4,0,0,4,8
1944005,1513833,2025-01-30,Senate,"Senate Comm - Favorable Recommendation",4,1,0,3,8
1944005,1513834,2025-02-04,Senate,"Senate/ passed 2nd & 3rd readings/ suspension",28,1,0,0,29
1944005,1513835,2025-03-07,House,"House/ passed 3rd reading",69,0,0,6,75
1944048,1513994,2025-02-12,House,"House Comm - Substitute Recommendation",11,0,0,1,12
1944048,1513995,2025-02-12,House,"House Comm - Amendment Recommendation",10,1,0,1,12
1944048,1513996,2025-02-12,House,"House Comm - Held",9,3,0,0,12
1944048,1513997,2025-02-14,House,"House Comm - Substitute Recommendation",9,0,0,3,12
1944048,1513998,2025-02-14,House,"House Comm - Amendment Recommendation",9,0,0,3,12
1944048,1513999,2025-02-14,House,"House Comm - Favorable Recommendation",9,0,0,3,12
1944048,1514000,2025-02-21,House,"House/ passed 3rd reading",60,3,0,12,75
1944048,1514001,2025-02-27,Senate,"Senate Comm - Favorable Recommendation",4,0,0,3,7
1944092,1513988,2025-02-10,Senate,"Senate Comm - Substitute Recommendation",9,0,0,0,9
1944092,1513989,2025-02-10,Senate,"Senate Comm - Favorable Recommendation",8,0,0,1,9
1944092,1513990,2025-02-18,Senate,"Senate/ passed 2nd reading",25,0,0,4,29
1944092,1513991,2025-02-19,Senate,"Senate/ passed 3rd reading",24,0,0,5,29
1944092,1513992,2025-02-27,House,"House Comm - Favorable Recommendation",7,0,0,4,11
1944092,1513993,2025-03-06,House,"House/ passed 3rd reading",72,0,0,3,75
1944135,1514719,2025-02-14,House,"House Comm - Favorable Recommendation",7,0,0,7,14
1944135,1514720,2025-02-21,House,"House/ passed 3rd reading",67,0,0,8,75
1944135,1514721,2025-02-27,Senate,"Senate Comm - Favorable Recommendation",4,0,0,3,7
1944135,1514722,2025-03-07,Senate,"Senate/ passed 2nd & 3rd readings/ suspension",28,0,0,1,29
1944178,1514535,2025-02-04,Senate,"Senate Comm - Substitute Recommendation",5,0,0,2,7
1944178,1514536,2025-02-04,Senate,"Senate Comm - Favorable Recommendation",5,0,0,2,7
1944178,1514537,2025-02-11,Senate,"Senate/ passed 2nd reading",25,0,0,4,29
1944178,1514538,2025-02-12,Senate,"Senate/ passed 3rd reading",25,0,0,4,29
1944178,1514539,2025-02-27,House,"House Comm - Substitute Recommendation",12,0,0,4,16
1944178,1514540,2025-02-27,House,"House Comm - Amendment Recommendation",12,0,0,4,16
1944178,1514541,2025-02-27,House,"House Comm - Amendment Recommendation",12,0,0,4,16
1944178,1514542,2025-02-27,House,"House Comm - Favorable Recommendation",12,0,0,4,16
1944178,1514543,2025-03-06,House,"House/ passed 3rd reading",70,0,0,5,75
1944178,1514544,2025-03-07,House,"House Conference Committee - Final Passage",68,0,0,7,75
1944178,1514545,2025-03-07,Senate,"Senate Conference Committee - Final Passage",24,0,0,5,29
1944263,1511813,2025-02-10,House,"House Comm - Substitute Recommendation",10,0,0,6,16
1944263,1511814,2025-02-10,House,"House Comm - Favorable Recommendation",10,0,0,6,16
1944263,1511815,2025-02-18,House,"House/ passed 3rd reading",72,0,0,3,75
1944263,1511816,2025-02-25,Senate,"Senate Comm - Favorable Recommendation",4,0,0,3,7
1944263,1511817,2025-03-06,Senate,"Senate/ passed 2nd & 3rd readings/ suspension",28,0,0,1,29
1944263,1511818,2025-03-06,House,"House/ concurs with Senate amendment",73,0,0,2,75
1944305,1513705,2025-01-31,Senate,"Senate Comm - Favorable Recommendation",6,0,0,1,7
1944305,1513706,2025-02-10,Senate,"Senate/ passed 2nd reading",27,0,0,2,29
1944305,1513707,2025-02-11,Senate,"Senate/ passed 3rd reading",25,0,0,4,29
1944305,1513708,2025-02-18,House,"House Comm - Substitute Recommendation",9,0,0,5,14
1944305,1513709,2025-02-18,House,"House Comm - Favorable Recommendation",10,0,0,4,14
1944305,1513710,2025-03-07,House,"House/ passed 3rd reading",60,11,0,4,75
1944305,1513711,2025-03-07,Senate,"Senate/ concurs with House amendment",22,5,0,2,29
1944348,1514977,2025-01-30,Senate,"Senate Comm - Favorable Recommendation",4,0,0,3,7
1944348,1514978,2025-02-10,Senate,"Senate/ passed 2nd reading",24,0,0,5,29
1944348,1514979,2025-02-11,Senate,"Senate/ passed 3rd reading",27,0,0,2,29
1944348,1514980,2025-03-03,House,"House Comm - Amendment Recommendation",8,0,0,2,10
1944348,1514981,2025-03-03,House,"House Comm - Favorable Recommendation",7,1,0,2,10
1944348,1514982,2025-03-05,House,"House/ failed",21,49,0,5,75
1944390,1514683,2025-02-18,Senate,"Senate Comm - Favorable Recommendation",6,0,0,3,9
1944390,1514684,2025-02-21,Senate,"Senate/ passed 2nd reading",24,0,0,5,29
1944390,1514685,2025-02-24,Senate,"Senate/ passed 3rd reading",22,0,0,7,29
1944390,1514686,2025-02-27,House,"House Comm - Favorable Recommendation",6,0,0,5,11
1944390,1514687,2025-03-06,House,"House/ passed 3rd reading",69,0,0,6,75
1944433,1510925,2025-02-05,House,"House Comm - Substitute Recommendation",10,0,0,6,16
1944433,1510926,2025-02-05,House,"House Comm - Favorable Recommendation",10,0,0,6,16
1944433,1510927,2025-02-07,House,"House/ passed 3rd reading",72,1,0,2,75
1944433,1510928,2025-02-14,Senate,"Senate Comm - Amendment Recommendation",6,0,0,1,7
1944433,1510929,2025-02-14,Senate,"Senate Comm - Favorable Recommendation",5,0,0,2,7
1944433,1510930,2025-02-20,Senate,"Senate/ passed 2nd reading",23,0,0,6,29
1944433,1510931,2025-02-27,Senate,"Senate/ passed 3rd reading",23,0,0,6,29
1944433,1510932,2025-02-28,House,"House/ concurs with Senate amendment",61,0,0,14,75
1944475,1511341,2025-02-13,Senate,"Senate Comm - Favorable Recommendation",6,0,0,3,9
1944475,1511342,2025-02-21,Senate,"Senate/ passed 2nd reading",26,0,0,3,29
1944475,1511343,2025-02-24,Senate,"Senate/ passed 3rd reading",25,0,0,4,29
1944475,1511344,2025-03-03,House,"House Comm - Favorable Recommendation",8,0,0,3,11
1944517,1513623,2025-02-14,House,"House Comm - Amendment Recommendation",6,0,0,8,14
1944517,1513624,2025-02-14,House,"House Comm - Favorable Recommendation",6,0,0,8,14
1944517,1513625,2025-02-21,House,"House/ passed 3rd reading",51,15,0,9,75
1944517,1513626,2025-02-26,Senate,"Senate Comm - Favorable Recommendation",4,0,0,3,7
1944517,1513627,2025-03-06,Senate,"Senate/ passed 2nd & 3rd readings/ suspension",21,0,0,8,29
1944564,1511262,2025-02-10,House,"House Comm - Held",4,3,0,3,10
1944564,1511263,2025-02-18,House,"House Comm - Substitute Recommendation",6,1,0,3,10
1944564,1511264,2025-02-18,House,"House Comm - Favorable Recommendation",7,1,0,2,10
1944564,1511265,2025-02-26,House,"House/ passed 3rd reading",69,3,0,3,75
1944564,1511266,2025-03-04,Senate,"Senate Comm - Favorable Recommendation",5,1,0,1,7
1944742,1511797,2025-02-13,House,"House Comm - Favorable Recommendation",7,3,0,1,11
1944742,1511798,2025-02-21,House,"House/ passed 3rd reading",65,2,0,8,75
1944742,1511799,2025-02-27,Senate,"Senate Comm - Favorable Recommendation",6,0,0,2,8
1944742,1511800,2025-03-07,Senate,"Senate/ passed 2nd & 3rd readings/ suspension",28,1,0,0,29
1944922,1512341,2025-02-06,Senate,"Senate Comm - Amendment Recommendation",3,0,0,3,6
1944922,1512342,2025-02-06,Senate,"Senate Comm - Favorable Recommendation",3,0,0,3,6
1944922,1512343,2025-02-18,Senate,"Senate/ passed 2nd reading",17,6,0,6,29
1944922,1512344,2025-02-19,Senate,"Senate/ passed 3rd reading",17,7,0,5,29
1944922,1512345,2025-02-25,House,"House Comm - Substitute Recommendation",14,0,0,2,16
1944922,1512346,2025-02-25,House,"House Comm - Favorable Recommendation",6,5,0,5,16
1944922,1512347,2025-03-06,House,"House/ failed",22,48,0,5,75
1945455,1512180,2025-02-05,Senate,"Senate Comm - Favorable Recommendation",6,0,0,3,9
1945455,1512181,2025-02-11,Senate,"Senate/ passed 2nd reading",24,0,0,5,29
1945455,1512182,2025-02-14,Senate,"Senate/ passed 3rd reading",23,2,0,4,29
1945455,1512183,2025-03-03,House,"House Comm - Favorable Recommendation",8,0,0,3,11
1945455,1512184,2025-03-07,House,"House/ passed 3rd reading",67,0,0,8,75
1945558,1510933,2025-02-12,House,"House Comm - Substitute Recommendation",8,0,0,3,11
1945558,1510934,2025-02-12,House,"House Comm - Amendment Recommendation",8,0,0,3,11
1945558,1510935,2025-02-12,House,"House Comm - Favorable Recommendation",9,0,0,2,11
1945558,1510936,2025-02-20,House,"House/ passed 3rd reading",70,0,0,5,75
1945558,1510937,2025-02-27,Senate,"Senate Comm - Amendment Recommendation",4,0,0,5,9
1945558,1510938,2025-02-27,Senate,"Senate Comm - Favorable Recommendation",4,0,0,5,9
1945558,1510939,2025-03-05,Senate,"Senate/ passed 2nd & 3rd readings/ suspension",27,0,0,2,29
1945558,1510940,2025-03-05,House,"House/ concurs with Senate amendment",69,0,0,6,75
1945667,1515215,2025-02-06,House,"House Comm - Substitute Recommendation",8,0,0,3,11
1945667,1515216,2025-02-06,House,"House Comm - Favorable Recommendation",8,0,0,3,11
1945667,1515217,2025-02-18,House,"House/ passed 3rd reading",65,0,0,10,75
1945667,1515218,2025-02-25,Senate,"Senate Comm - Amendment Recommendation",6,0,0,3,9
1945667,1515219,2025-02-25,Senate,"Senate Comm - Favorable Recommendation",6,0,0,3,9
1945667,1515220,2025-03-07,Senate,"Senate/ passed 2nd & 3rd readings/ suspension",23,0,0,6,29
1945667,1515221,2025-03-07,House,"House/ concurs with Senate amendment",70,0,0,5,75
1945776,1512160,2025-02-13,House,"House Comm - Favorable Recommendation",8,0,0,5,13
1945776,1512161,2025-02-20,House,"House/ passed 3rd reading",67,0,0,8,75
1945776,1512162,2025-02-28,Senate,"Senate Comm - Favorable Recommendation",5,0,0,4,9
1945776,1512163,2025-03-07,Senate,"Senate/ passed 2nd & 3rd readings/ suspension",22,0,0,7,29
1945883,1510941,2025-02-04,Senate,"Senate Comm - Amendment Recommendation",6,0,0,2,8
1945883,1510942,2025-02-04,Senate,"Senate Comm - Favorable Recommendation",4,1,0,3,8
1945883,1510943,2025-02-11,Senate,"Senate/ passed 2nd reading",26,0,0,3,29
1945883,1510944,2025-02-12,Senate,"Senate/ passed 3rd reading",26,0,0,3,29
1945883,1510945,2025-02-21,House,"House Comm - Favorable Recommendation",14,0,0,2,16
1945883,1510946,2025-02-26,House,"House/ passed 3rd reading",66,0,0,9,75
1946239,1511404,2025-02-14,House,"House Comm - Substitute Recommendation",12,0,0,2,14
1946239,1511405,2025-02-14,House,"House Comm - Favorable Recommendation",9,3,0,2,14
1946239,1511406,2025-02-25,House,"House/ passed 3rd reading",43,26,0,6,75
1946239,1511407,2025-03-04,Senate,"Senate Comm - Substitute Recommendation",4,0,0,3,7
1946239,1511408,2025-03-04,Senate,"Senate Comm - Favorable Recommendation",4,1,0,2,7
1946239,1511409,2025-03-07,Senate,"Senate/ passed 2nd & 3rd readings/ suspension",17,7,0,5,29
1946239,1511410,2025-03-07,House,"House/ concurs with Senate amendment",41,29,0,5,75
1946493,1511307,2025-02-18,Senate,"Senate Comm - Favorable Recommendation",6,0,0,3,9
1946493,1511308,2025-02-21,Senate,"Senate/ passed 2nd reading",24,0,0,5,29
1946493,1511309,2025-02-24,Senate,"Senate/ passed 3rd reading",21,0,0,8,29
1946493,1511310,2025-02-27,House,"House Comm - Favorable Recommendation",7,0,0,4,11
1946493,1511311,2025-03-06,House,"House/ circled",0,0,0,75,75
1946493,1511312,2025-03-06,House,"House/ passed 3rd reading",65,0,0,10,75
1946563,1511463,2025-02-13,House,"House Comm - Substitute Recommendation",13,0,0,1,14
1946563,1511464,2025-02-13,House,"House Comm - Favorable Recommendation",12,0,0,2,14
1946563,1511465,2025-02-21,House,"House/ passed 3rd reading",67,0,0,8,75
1946563,1511466,2025-03-03,Senate,"Senate Comm - Substitute Recommendation",4,0,0,3,7
1946563,1511467,2025-03-03,Senate,"Senate Comm - Favorable Recommendation",4,0,0,3,7
1946563,1511468,2025-03-07,Senate,"Senate/ passed 2nd & 3rd readings/ suspension",26,0,0,3,29
1946563,1511469,2025-03-07,House,"House/ concurs with Senate amendment",70,0,0,5,75
1946634,1514460,2025-02-18,House,"House Comm - Substitute Recommendation",11,0,0,3,14
1946634,1514461,2025-02-18,House,"House Comm - Amendment Recommendation",11,0,0,3,14
1946634,1514462,2025-02-18,House,"House Comm - Favorable Recommendation",12,0,0,2,14
1946634,1514463,2025-02-24,House,"House/ passed 3rd reading",68,1,0,6,75
1946634,1514464,2025-02-28,Senate,"Senate Comm - Favorable Recommendation",5,0,0,2,7
1946634,1514465,2025-03-07,Senate,"Senate/ passed 2nd & 3rd readings/ suspension",29,0,0,0,29
1946706,1515186,2025-02-25,House,"House Comm - Substitute Recommendation",13,0,0,3,16
1946706,1515187,2025-02-25,House,"House Comm - Favorable Recommendation",13,0,0,3,16
1946706,1515188,2025-02-27,House,"House/ passed 3rd reading",73,1,0,1,75
1946706,1515189,2025-03-04,Senate,"Senate Comm - Favorable Recommendation",4,0,0,5,9
1946706,1515190,2025-03-07,Senate,"Senate/ passed 2nd & 3rd readings/ suspension",25,0,0,4,29
1946852,1510947,2025-02-06,House,"House Comm - Favorable Recommendation",9,0,0,2,11
1946852,1510948,2025-02-18,House,"House/ passed 3rd reading",68,0,0,7,75
1946852,1510949,2025-02-28,Senate,"Senate Comm - Favorable Recommendation",5,0,0,4,9
1946852,1510950,2025-03-05,Senate,"Senate/ passed 2nd & 3rd readings/ suspension",24,0,0,5,29
1946923,1511984,2025-02-10,Senate,"Senate Comm - Substitute Recommendation",6,0,0,2,8
1946923,1511985,2025-02-10,Senate,"Senate Comm - Favorable Recommendation",6,0,0,2,8
1946923,1511986,2025-02-19,Senate,"Senate/ passed 2nd reading",21,0,0,8,29
1946923,1511987,2025-02-20,Senate,"Senate/ passed 3rd reading",19,6,0,4,29
1946923,1511988,2025-02-27,House,"House Comm - Substitute Recommendation",12,0,0,0,12
1946923,1511989,2025-02-27,House,"House Comm - Favorable Recommendation",10,2,0,0,12
1946923,1511990,2025-03-04,House,"House/ passed 3rd reading",60,14,0,1,75
1946923,1511991,2025-03-06,House,"House Conference Committee - Final Passage",61,9,0,5,75
1946923,1511992,2025-03-06,Senate,"Senate Conference Committee - Final Passage",20,2,0,7,29
1946998,1510951,2025-02-04,Senate,"Senate Comm - Substitute Recommendation",7,0,0,1,8
1946998,1510952,2025-02-04,Senate,"Senate Comm - Favorable Recommendation",6,0,0,2,8
1946998,1510953,2025-02-11,Senate,"Senate/ passed 2nd reading",24,0,0,5,29
1946998,1510954,2025-02-12,Senate,"Senate/ passed 3rd reading",28,0,0,1,29
1946998,1510955,2025-02-21,House,"House Comm - Favorable Recommendation",14,0,0,2,16
1946998,1510956,2025-02-26,House,"House/ passed 3rd reading",70,0,0,5,75
1947068,1511356,2025-02-26,House,"House Comm - Substitute Recommendation",10,0,0,1,11
1947068,1511357,2025-02-26,House,"House Comm - Amendment Recommendation",10,0,0,1,11
1947068,1511358,2025-02-26,House,"House Comm - Motion to Recommend Failed",2,8,0,1,11
1947068,1511359,2025-02-26,House,"House Comm - Held",9,1,0,1,11
1947141,1512027,2025-01-31,Senate,"Senate Comm - Substitute Recommendation",6,0,0,2,8
1947141,1512028,2025-01-31,Senate,"Senate Comm - Favorable Recommendation",6,0,0,2,8
1947141,1512029,2025-02-10,Senate,"Senate/ passed 2nd reading",23,0,0,6,29
1947141,1512030,2025-02-11,Senate,"Senate/ passed 3rd reading",23,3,0,3,29
1947141,1512031,2025-02-26,House,"House Comm - Substitute Recommendation",9,0,0,4,13
1947141,1512032,2025-02-26,House,"House Comm - Favorable Recommendation",9,0,0,4,13
1947141,1512033,2025-03-06,House,"House/ passed 3rd reading",63,8,0,4,75
1947141,1512034,2025-03-06,Senate,"Senate/ concurs with House amendment",25,1,0,3,29
1947215,1514565,2025-02-19,House,"House Comm - Substitute Recommendation",5,0,0,5,10
1947215,1514566,2025-02-19,House,"House Comm - Favorable Recommendation",5,0,0,5,10
1947215,1514567,2025-02-28,House,"House/ passed 3rd reading",60,5,0,10,75
1947215,1514568,2025-03-07,Senate,"Senate/ passed 2nd & 3rd readings/ suspension",21,7,0,1,29
1947215,1514569,2025-03-07,House,"House/ concurs with Senate amendment",56,15,0,4,75
1947287,1512537,2025-02-07,Senate,"Senate Comm - Substitute Recommendation",3,0,0,4,7
1947287,1512538,2025-02-07,Senate,"Senate Comm - Favorable Recommendation",3,0,0,4,7
1947287,1512539,2025-02-18,Senate,"Senate/ passed 2nd reading",23,0,0,6,29
1947287,1512540,2025-02-19,Senate,"Senate/ passed 3rd reading",25,0,0,4,29
1947358,1513267,2025-02-13,House,"House Comm - Favorable Recommendation",6,1,0,3,10
1947358,1513268,2025-02-24,House,"House/ passed 3rd reading",51,16,0,8,75
1947358,1513269,2025-02-27,Senate,"Senate Comm - Substitute Recommendation",3,0,0,3,6
1947358,1513270,2025-02-27,Senate,"Senate Comm - Favorable Recommendation",3,0,0,3,6
1947358,1513271,2025-03-07,Senate,"Senate/ passed 2nd & 3rd readings/ suspension",25,3,0,1,29
1947358,1513272,2025-03-07,House,"House/ concurs with Senate amendment",48,21,0,6,75
1947709,1513906,2025-02-24,House,"House Comm - Substitute Recommendation",10,0,0,1,11
1947709,1513907,2025-02-24,House,"House Comm - Favorable Recommendation",9,1,0,1,11
1947709,1513908,2025-02-27,House,"House/ passed 3rd reading",64,1,0,10,75
1947709,1513909,2025-03-04,Senate,"Senate Comm - Favorable Recommendation",4,2,0,1,7
1947709,1513910,2025-03-07,Senate,"Senate/ failed",13,14,0,2,29
1948376,1512306,2025-02-13,Senate,"Senate Comm - Substitute Recommendation",7,0,0,2,9
1948376,1512307,2025-02-13,Senate,"Senate Comm - Favorable Recommendation",7,0,0,2,9
1948376,1512308,2025-02-21,Senate,"Senate/ passed 2nd reading",23,3,0,3,29
1948376,1512309,2025-02-24,Senate,"Senate/ passed 3rd reading",23,1,0,5,29
1948376,1512310,2025-02-27,House,"House Comm - Favorable Recommendation",9,1,0,1,11
1948376,1512311,2025-03-06,House,"House/ passed 3rd reading",69,0,0,6,75
1948482,1512086,2025-02-26,House,"House Comm - Substitute Recommendation",10,0,0,3,13
1948482,1512087,2025-02-26,House,"House Comm - Favorable Recommendation",10,0,0,3,13
1948482,1512088,2025-02-28,House,"House/ passed 3rd reading",70,0,0,5,75
1948482,1512089,2025-03-04,Senate,"Senate Comm - Motion to Recommend Failed",2,5,0,0,7
1948591,1513220,2025-02-13,House,"House Comm - Substitute Recommendation",8,0,0,5,13
1948591,1513221,2025-02-13,House,"House Comm - Favorable Recommendation",8,0,0,5,13
1948591,1513222,2025-02-20,House,"House/ passed 3rd reading",68,0,0,7,75
1948591,1513223,2025-02-27,Senate,"Senate Comm - Favorable Recommendation",5,0,0,4,9
1948591,1513224,2025-03-07,Senate,"Senate/ passed 2nd & 3rd readings/ suspension",25,0,0,4,29
1948701,1510957,2025-02-03,Senate,"Senate Comm - Favorable Recommendation",5,0,0,2,7
1948701,1510958,2025-02-11,Senate,"Senate/ passed 2nd reading",25,0,0,4,29
1948701,1510959,2025-02-12,Senate,"Senate/ passed 3rd reading",26,0,0,3,29
1948701,1510960,2025-02-20,House,"House Comm - Amendment Recommendation",9,0,0,4,13
1948701,1510961,2025-02-20,House,"House Comm - Favorable Recommendation",9,0,0,4,13
1948701,1510962,2025-02-20,House,"House Comm - Consent Calendar Recommendation",9,0,0,4,13
1948701,1510963,2025-02-24,House,"House/ passed 3rd reading",64,0,0,11,75
1948701,1510964,2025-02-25,Senate,"Senate/ concurs with House amendment",20,0,0,9,29
1948926,1513415,2025-02-13,House,"House Comm - Favorable Recommendation",7,0,0,3,10
1948926,1513416,2025-02-24,House,"House/ passed 3rd reading",53,13,0,9,75
1948926,1513417,2025-02-27,Senate,"Senate Comm - Substitute Recommendation",3,0,0,3,6
1948926,1513418,2025-02-27,Senate,"Senate Comm - Favorable Recommendation",3,0,0,3,6
1948926,1513419,2025-03-07,Senate,"Senate/ passed 2nd & 3rd readings/ suspension",27,0,0,2,29
1948926,1513420,2025-03-07,House,"House/ concurs with Senate amendment",47,22,0,6,75
1949038,1511377,2025-02-03,Senate,"Senate Comm - Favorable Recommendation",4,2,0,1,7
1949038,1511378,2025-02-11,Senate,"Senate/ passed 2nd reading",16,9,0,4,29
1949038,1511379,2025-02-24,Senate,"Senate/ passed 3rd reading",15,10,0,4,29
1949038,1511380,2025-02-28,House,"House Comm - Substitute Recommendation",10,0,0,1,11
1949038,1511381,2025-02-28,House,"House Comm - Favorable Recommendation",7,3,0,1,11
1949038,1511382,2025-03-07,House,"House/ passed 3rd reading",42,32,0,1,75
1949038,1511383,2025-03-07,Senate,"Senate/ concurs with House amendment",18,7,0,4,29
1949146,1513079,2025-02-18,House,"House Comm - Favorable Recommendation",10,2,0,2,14
1949146,1513080,2025-02-25,House,"House/ passed 3rd reading",53,11,0,11,75
1949146,1513081,2025-03-03,Senate,"Senate Comm - Favorable Recommendation",4,0,0,3,7
1949146,1513082,2025-03-05,Senate,"Senate/ passed 2nd & 3rd readings/ suspension",26,0,0,3,29
1949216,1512895,2025-02-14,House,"House Comm - Amendment Recommendation",12,0,0,1,13
1949216,1512896,2025-02-14,House,"House Comm - Favorable Recommendation",10,2,0,1,13
1949216,1512897,2025-02-24,House,"House/ passed 3rd reading",43,27,0,5,75
1949216,1512898,2025-02-27,Senate,"Senate Comm - Substitute Recommendation",3,0,0,4,7
1949216,1512899,2025-02-27,Senate,"Senate Comm - Held",4,0,0,3,7
1949250,1510965,2025-02-04,Senate,"Senate Comm - Amendment Recommendation",5,0,0,3,8
1949250,1510966,2025-02-04,Senate,"Senate Comm - Favorable Recommendation",5,0,0,3,8
1949250,1510967,2025-02-14,Senate,"Senate/ passed 2nd reading",26,0,0,3,29
1949250,1510968,2025-02-18,Senate,"Senate/ passed 3rd reading",27,0,0,2,29
1949250,1510969,2025-02-26,House,"House Comm - Favorable Recommendation",7,0,0,3,10
1949250,1510970,2025-03-06,House,"House/ passed 3rd reading",54,17,0,4,75
1949285,1510971,2025-02-14,House,"House Comm - Substitute Recommendation",11,0,0,2,13
1949285,1510972,2025-02-14,House,"House Comm - Favorable Recommendation",11,0,0,2,13
1949285,1510973,2025-02-24,House,"House/ passed 3rd reading",64,0,0,11,75
1949285,1510974,2025-02-28,Senate,"Senate Comm - Favorable Recommendation",5,0,0,2,7
1949285,1510975,2025-03-07,Senate,"Senate/ passed 2nd & 3rd readings/ suspension",25,0,0,4,29
1949320,1510976,2025-02-13,House,"House Comm - Favorable Recommendation",8,0,0,2,10
1949320,1510977,2025-02-21,House,"House/ passed 3rd reading",67,0,0,8,75
1949320,1510978,2025-02-28,Senate,"Senate Comm - Favorable Recommendation",4,0,0,4,8
1949320,1510979,2025-03-07,Senate,"Senate/ passed 2nd & 3rd readings/ suspension",22,0,0,7,29
1949355,1513390,2025-02-20,House,"House Comm - Substitute Recommendation",11,0,0,3,14
1949355,1513391,2025-02-20,House,"House Comm - Favorable Recommendation",10,1,0,3,14
1949355,1513392,2025-02-25,House,"House/ passed 3rd reading",58,12,0,5,75
1949355,1513393,2025-03-04,Senate,"Senate Comm - Substitute Recommendation",3,0,0,4,7
1949355,1513394,2025-03-04,Senate,"Senate Comm - Favorable Recommendation",2,1,0,4,7
1949355,1513395,2025-03-06,Senate,"Senate/ passed 2nd & 3rd readings/ suspension",20,6,0,3,29
1949355,1513396,2025-03-07,House,"House/ concurs with Senate amendment",59,8,0,8,75
1949424,1510980,2025-02-21,Senate,"Senate/ passed 2nd reading",24,0,0,5,29
1949424,1510981,2025-02-24,Senate,"Senate/ passed 3rd reading",22,0,0,7,29
1949457,1512272,2025-02-10,House,"House Comm - Substitute Recommendation",7,0,0,3,10
1949457,1512273,2025-02-10,House,"House Comm - Favorable Recommendation",7,0,0,3,10
1949457,1512274,2025-02-20,House,"House/ passed 3rd reading",63,5,0,7,75
1949457,1512275,2025-02-27,Senate,"Senate Comm - Motion to Recommend Failed",1,2,0,4,7
1949491,1515127,2025-02-06,Senate,"Senate Comm - Substitute Recommendation",5,0,0,2,7
1949491,1515128,2025-02-06,Senate,"Senate Comm - Favorable Recommendation",5,0,0,2,7
1949491,1515129,2025-02-18,Senate,"Senate/ passed 2nd reading",22,0,0,7,29
1949491,1515130,2025-02-20,Senate,"Senate/ passed 3rd reading",22,0,0,7,29
1949491,1515131,2025-02-25,House,"House Comm - Favorable Recommendation",8,0,0,3,11
1949491,1515132,2025-03-06,House,"House/ passed 3rd reading",73,0,0,2,75
1949526,1511712,2025-02-10,House,"House Comm - Substitute Recommendation",12,0,0,4,16
1949526,1511713,2025-02-10,House,"House Comm - Favorable Recommendation",12,0,0,4,16
1949526,1511714,2025-02-18,House,"House/ passed 3rd reading",67,1,0,7,75
1949526,1511715,2025-02-25,Senate,"Senate Comm - Favorable Recommendation",4,1,0,3,8
1949526,1511716,2025-03-06,Senate,"Senate/ passed 2nd & 3rd readings/ suspension",25,2,0,2,29
1949559,1513826,2025-02-25,House,"House Comm - Substitute Recommendation",7,0,0,3,10
1949559,1513827,2025-02-25,House,"House Comm - Favorable Recommendation",7,0,0,3,10
1949559,1513828,2025-02-25,House,"House Comm - Consent Calendar Recommendation",7,0,0,3,10
1949559,1513829,2025-02-27,House,"House/ passed 3rd reading",69,0,0,6,75
1949559,1513830,2025-03-04,Senate,"Senate Comm - Favorable Recommendation",7,0,0,0,7
1949559,1513831,2025-03-06,Senate,"Senate/ passed 2nd & 3rd readings/ suspension",23,0,0,6,29
1950286,1514940,2025-02-12,House,"House Comm - Amendment Recommendation",11,0,0,0,11
1950286,1514941,2025-02-12,House,"House Comm - Amendment Recommendation",11,0,0,0,11
1950286,1514942,2025-02-12,House,"House Comm - Favorable Recommendation",10,0,0,1,11
1950286,1514943,2025-02-20,House,"House/ passed 3rd reading",73,0,0,2,75
1950286,1514944,2025-02-27,Senate,"Senate Comm - Favorable Recommendation",4,0,0,5,9
1950286,1514945,2025-03-07,Senate,"Senate/ passed 2nd & 3rd readings/ suspension",26,1,0,2,29
1950339,1512715,2025-02-05,Senate,"Senate Comm - Favorable Recommendation",6,2,0,1,9
1950339,1512716,2025-02-18,Senate,"Senate/ passed 2nd reading",19,6,0,4,29
1950339,1512717,2025-02-20,Senate,"Senate/ passed 3rd reading",20,6,0,3,29
1950339,1512718,2025-02-26,House,"House Comm - Substitute Recommendation",9,0,0,2,11
1950339,1512719,2025-02-26,House,"House Comm - Favorable Recommendation",9,0,0,2,11
1950339,1512720,2025-03-06,House,"House/ passed 3rd reading",60,12,0,3,75
1950339,1512721,2025-03-06,Senate,"Senate/ concurs with House amendment",16,6,0,7,29
1950395,1512403,2025-02-05,Senate,"Senate Comm - Favorable Recommendation",6,0,0,3,9
1950395,1512404,2025-02-11,Senate,"Senate/ passed 2nd reading",24,0,0,5,29
1950395,1512405,2025-02-14,Senate,"Senate/ passed 3rd reading",22,0,0,7,29
1950395,1512406,2025-02-27,House,"House Comm - Favorable Recommendation",8,1,0,2,11
1950395,1512407,2025-03-06,House,"House/ passed 3rd reading",68,0,0,7,75
1950557,1512722,2025-02-13,House,"House Comm - Amendment Recommendation",12,0,0,4,16
1950557,1512723,2025-02-13,House,"House Comm - Favorable Recommendation",12,0,0,4,16
1950557,1512724,2025-02-21,House,"House/ passed 3rd reading",67,0,0,8,75
1950557,1512725,2025-02-26,Senate,"Senate Comm - Favorable Recommendation",4,1,0,2,7
1950557,1512726,2025-03-07,Senate,"Senate/ passed 2nd & 3rd readings/ suspension",23,0,0,6,29
1950557,1512727,2025-03-07,House,"House/ concurs with Senate amendment",70,0,0,5,75
1950671,1512813,2025-02-13,House,"House Comm - Favorable Recommendation",7,0,0,6,13
1950671,1512814,2025-02-20,House,"House/ passed 3rd reading",65,0,0,10,75
1950671,1512815,2025-02-26,Senate,"Senate Comm - Favorable Recommendation",3,0,0,4,7
1950671,1512816,2025-03-07,Senate,"Senate/ passed 2nd & 3rd readings/ suspension",19,5,0,5,29
1950671,1512817,2025-03-07,House,"House/ concurs with Senate amendment",52,13,0,10,75
1950727,1514758,2025-02-26,House,"House Comm - Held",9,2,0,0,11
1950786,1510982,2025-02-12,Senate,"Senate Comm - Substitute Recommendation",5,0,0,2,7
1950786,1510983,2025-02-12,Senate,"Senate Comm - Favorable Recommendation",4,0,0,3,7
1950786,1510984,2025-02-18,Senate,"Senate/ passed 2nd reading",24,0,0,5,29
1950786,1510985,2025-02-19,Senate,"Senate/ passed 3rd reading",23,0,0,6,29
1950786,1510986,2025-02-25,House,"House Comm - Substitute Recommendation",9,0,0,2,11
1950786,1510987,2025-02-25,House,"House Comm - Favorable Recommendation",9,0,0,2,11
1950786,1510988,2025-03-04,House,"House/ passed 3rd reading",70,1,0,4,75
1950786,1510989,2025-03-05,Senate,"Senate/ concurs with House amendment",26,0,0,3,29
1950843,1510990,2025-02-05,Senate,"Senate Comm - Motion to Recommend Failed",3,3,0,3,9
1950843,1510991,2025-02-10,Senate,"Senate Comm - Substitute Recommendation",5,0,0,4,9
1950843,1510992,2025-02-10,Senate,"Senate Comm - Favorable Recommendation",7,2,0,0,9
1950843,1510993,2025-02-18,Senate,"Senate/ passed 2nd reading",19,6,0,4,29
1950843,1510994,2025-02-20,Senate,"Senate/ passed 3rd reading",22,7,0,0,29
1950843,1510995,2025-02-26,House,"House Comm - Amendment Recommendation",8,0,0,3,11
1950843,1510996,2025-02-26,House,"House Comm - Amendment Recommendation",9,0,0,2,11
1950843,1510997,2025-02-26,House,"House Comm - Favorable Recommendation",8,2,0,1,11
1950843,1510998,2025-03-06,House,"House/ passed 3rd reading",59,13,0,3,75
1950843,1510999,2025-03-06,Senate,"Senate/ concurs with House amendment",17,6,0,6,29
1950958,1511930,2025-02-12,Senate,"Senate Comm - Substitute Recommendation",4,0,0,3,7
1950958,1511931,2025-02-12,Senate,"Senate Comm - Favorable Recommendation",4,1,0,2,7
1950958,1511932,2025-02-18,Senate,"Senate/ passed 2nd reading",22,3,0,4,29
1950958,1511933,2025-02-19,Senate,"Senate/ passed 3rd reading",25,0,0,4,29
1950958,1511934,2025-02-27,House,"House Comm - Favorable Recommendation",10,0,0,4,14
1950958,1511935,2025-03-06,House,"House/ passed 3rd reading",69,0,0,6,75
1950958,1511936,2025-03-07,Senate,"Senate/ concurs with House amendment",25,0,0,4,29
1951013,1514876,2025-02-13,Senate,"Senate Comm - Amendment Recommendation",3,0,0,4,7
1951013,1514877,2025-02-13,Senate,"Senate Comm - Favorable Recommendation",4,0,0,3,7
1951013,1514878,2025-02-21,Senate,"Senate/ passed 2nd reading",24,0,0,5,29
1951013,1514879,2025-02-24,Senate,"Senate/ passed 3rd reading",25,0,0,4,29
1951013,1514880,2025-02-28,House,"House Comm - Substitute Recommendation",11,0,0,3,14
1951013,1514881,2025-02-28,House,"House Comm - Favorable Recommendation",11,0,0,3,14
1951013,1514882,2025-03-07,House,"House/ passed 3rd reading",71,0,0,4,75
1951013,1514883,2025-03-07,Senate,"Senate/ concurs with House amendment",27,0,0,2,29
1951068,1512779,2025-02-13,House,"House Comm - Motion to Recommend Failed",1,8,0,4,13
1951124,1511222,2025-02-19,House,"House Comm - Favorable Recommendation",8,0,0,2,10
1951124,1511223,2025-02-25,House,"House/ passed 3rd reading",67,0,0,8,75
1951124,1511224,2025-02-28,Senate,"Senate Comm - Favorable Recommendation",4,0,0,3,7
1951124,1511225,2025-03-05,Senate,"Senate/ 2nd & 3rd readings/ suspension",10,17,0,2,29
1951124,1511226,2025-03-06,Senate,"Senate/ passed 2nd & 3rd readings/ suspension",17,8,0,4,29
1951124,1511227,2025-03-07,House,"House/ concurs with Senate amendment",66,0,0,9,75
1951179,1511000,2025-02-13,House,"House Comm - Favorable Recommendation",10,0,0,0,10
1951179,1511001,2025-02-21,House,"House/ passed 3rd reading",65,0,0,10,75
1951179,1511002,2025-02-27,Senate,"Senate Comm - Favorable Recommendation",3,0,0,3,6
1951179,1511003,2025-02-27,Senate,"Senate Comm - Consent Calendar Recommendation",3,0,0,3,6
1951179,1511004,2025-03-05,Senate,"Senate/ passed 3rd reading",26,0,0,3,29
1951234,1512138,2025-02-10,Senate,"Senate Comm - Substitute Recommendation",6,0,0,3,9
1951234,1512139,2025-02-10,Senate,"Senate Comm - Favorable Recommendation",6,0,0,3,9
1951234,1512140,2025-02-18,Senate,"Senate/ passed 2nd reading",23,0,0,6,29
1951234,1512141,2025-02-19,Senate,"Senate/ passed 3rd reading",23,0,0,6,29
1951234,1512142,2025-03-03,House,"House Comm - Favorable Recommendation",8,0,0,3,11
1951941,1512070,2025-02-18,House,"House Comm - Amendment Recommendation",12,0,0,4,16
1951941,1512071,2025-02-18,House,"House Comm - Favorable Recommendation",12,0,0,4,16
1951941,1512072,2025-02-24,House,"House/ passed 3rd reading",64,3,0,8,75
1951941,1512073,2025-03-03,Senate,"Senate Comm - Favorable Recommendation",4,1,0,2,7
1951941,1512074,2025-03-07,Senate,"Senate/ passed 2nd & 3rd readings/ suspension",21,6,0,2,29
1952099,1511915,2025-02-19,House,"House Comm - Substitute Recommendation",9,0,0,2,11
1952099,1511916,2025-02-19,House,"House Comm - Held",9,1,0,1,11
1952099,1511917,2025-02-20,House,"House Comm - Amendment Recommendation",11,0,0,0,11
1952099,1511918,2025-02-20,House,"House Comm - Favorable Recommendation",8,3,0,0,11
1952254,1514668,2025-02-12,Senate,"Senate Comm - Favorable Recommendation",3,1,0,2,6
1952254,1514669,2025-02-19,Senate,"Senate/ passed 2nd reading",17,5,0,7,29
1952254,1514670,2025-02-20,Senate,"Senate/ passed 3rd reading",17,6,0,6,29
1952254,1514671,2025-03-03,House,"House Comm - Favorable Recommendation",8,1,0,4,13
1952254,1514672,2025-03-06,House,"House/ passed 3rd reading",57,8,0,10,75
1952282,1514127,2025-02-20,Senate,"Senate Comm - Substitute Recommendation",5,0,0,2,7
1952282,1514128,2025-02-20,Senate,"Senate Comm - Favorable Recommendation",3,1,0,3,7
1952282,1514129,2025-02-24,Senate,"Senate/ passed 2nd reading",21,4,0,4,29
1952282,1514130,2025-02-25,Senate,"Senate/ passed 3rd reading",17,8,0,4,29
1952282,1514131,2025-02-28,House,"House Comm - Held",9,3,0,4,16
1952303,1511577,2025-02-12,House,"House Comm - Substitute Recommendation",10,0,0,2,12
1952303,1511578,2025-02-12,House,"House Comm - Amendment Recommendation",10,0,0,2,12
1952303,1511579,2025-02-12,House,"House Comm - Favorable Recommendation",9,3,0,0,12
1952303,1511580,2025-02-20,House,"House/ passed 3rd reading",55,14,0,6,75
1952303,1511581,2025-02-28,Senate,"Senate Comm - Substitute Recommendation",6,0,0,2,8
1952303,1511582,2025-02-28,Senate,"Senate Comm - Motion to Recommend Failed",3,3,0,2,8
1952303,1511583,2025-03-04,Senate,"Senate Comm - Substitute Recommendation",7,0,0,1,8
1952303,1511584,2025-03-04,Senate,"Senate Comm - Favorable Recommendation",4,3,0,1,8
1952303,1511585,2025-03-07,Senate,"Senate/ failed",12,17,0,0,29
1952348,1513142,2025-02-05,Senate,"Senate Comm - Favorable Recommendation",6,1,0,1,8
1952348,1513143,2025-02-14,Senate,"Senate/ passed 2nd reading",27,0,0,2,29
1952348,1513144,2025-02-18,Senate,"Senate/ passed 3rd reading",26,0,0,3,29
1952348,1513145,2025-02-24,House,"House Comm - Favorable Recommendation",9,0,0,3,12
1952371,1514912,2025-02-13,House,"House Comm - Favorable Recommendation",11,0,0,3,14
1952371,1514913,2025-02-13,House,"House Comm - Consent Calendar Recommendation",11,0,0,3,14
1952392,1511994,2025-02-19,House,"House Comm - Held",7,2,0,7,16
1952392,1511995,2025-02-25,House,"House Comm - Substitute Recommendation",10,0,0,6,16
1952392,1511996,2025-02-25,House,"House Comm - Favorable Recommendation",8,3,0,5,16
1952392,1511997,2025-02-27,House,"House/ passed 3rd reading",38,34,0,3,75
1952392,1511998,2025-03-03,Senate,"Senate Comm - Favorable Recommendation",4,0,0,3,7
1952392,1511999,2025-03-06,Senate,"Senate/ passed 2nd & 3rd readings/ suspension",16,6,0,7,29
1952416,1510498,2025-02-28,House,"House Comm - Favorable Recommendation",8,3,0,5,16
1952416,1510500,2025-03-03,House,"House/ passed 3rd reading",41,31,0,3,75
1952438,1511753,2025-02-13,Senate,"Senate Comm - Substitute Recommendation",4,0,0,4,8
1952438,1511754,2025-02-13,Senate,"Senate Comm - Favorable Recommendation",5,0,0,3,8
1952438,1511755,2025-02-21,Senate,"Senate/ passed 2nd reading",23,0,0,6,29
1952438,1511756,2025-02-24,Senate,"Senate/ passed 3rd reading",25,0,0,4,29
1952438,1511757,2025-02-26,House,"House Comm - Favorable Recommendation",10,0,0,3,13
1952438,1511758,2025-02-26,House,"House Comm - Consent Calendar Recommendation",10,0,0,3,13
1952438,1511759,2025-03-03,House,"House/ passed 3rd reading",64,0,0,11,75
1952462,1511739,2025-02-21,House,"House Comm - Substitute Recommendation",10,0,0,6,16
1952462,1511740,2025-02-21,House,"House Comm - Amendment Recommendation",11,0,0,5,16
1952462,1511741,2025-02-21,House,"House Comm - Favorable Recommendation",10,1,0,5,16
1952462,1511742,2025-02-27,House,"House/ passed 3rd reading",51,17,0,7,75
1952462,1511743,2025-03-03,Senate,"Senate Comm - Motion to Recommend Failed",2,2,0,3,7
1952484,1511005,2025-02-18,House,"House Comm - Favorable Recommendation",10,0,0,6,16
1952484,1511006,2025-02-24,House,"House/ passed 3rd reading",63,0,0,12,75
1952484,1511007,2025-02-28,Senate,"Senate Comm - Favorable Recommendation",4,0,0,3,7
1952484,1511008,2025-03-04,Senate,"Senate/ passed 2nd & 3rd readings/ suspension",26,0,0,3,29
1952506,1511820,2025-02-10,House,"House Comm - Substitute Recommendation",11,0,0,3,14
1952506,1511821,2025-02-10,House,"House Comm - Favorable Recommendation",11,0,0,3,14
1952506,1511822,2025-02-19,House,"House/ passed 3rd reading",68,0,0,7,75
1952506,1511823,2025-03-03,Senate,"Senate Comm - Favorable Recommendation",5,0,0,2,7
1952528,1511009,2025-02-18,House,"House Comm - Substitute Recommendation",7,1,0,3,11
1952528,1511010,2025-02-18,House,"House Comm - Favorable Recommendation",7,1,0,3,11
1952528,1511011,2025-02-25,House,"House/ passed 3rd reading",62,5,0,8,75
1952528,1511012,2025-03-04,Senate,"Senate Comm - Substitute Recommendation",4,0,0,5,9
1952528,1511013,2025-03-04,Senate,"Senate Comm - Favorable Recommendation",5,0,0,4,9
1952528,1511014,2025-03-05,Senate,"Senate/ passed 2nd & 3rd readings/ suspension",27,0,0,2,29
1952528,1511015,2025-03-05,House,"House/ concurs with Senate amendment",63,10,0,2,75
1952552,1513919,2025-02-27,House,"House Comm - Amendment Recommendation",11,0,0,5,16
1952552,1513920,2025-02-27,House,"House Comm - Amendment Recommendation",11,0,0,5,16
1952552,1513921,2025-02-27,House,"House Comm - Favorable Recommendation",11,0,0,5,16
1952552,1513922,2025-02-28,House,"House/ passed 3rd reading",70,0,0,5,75
1952552,1513923,2025-03-04,Senate,"Senate Comm - Favorable Recommendation",5,0,0,1,6
1952577,1514792,2025-02-28,House,"House Comm - Substitute Recommendation",9,0,0,4,13
1952577,1514793,2025-02-28,House,"House Comm - Favorable Recommendation",9,0,0,4,13
1952577,1514794,2025-03-03,House,"House/ passed 3rd reading",68,0,0,7,75
1952577,1514795,2025-03-07,Senate,"Senate/ passed 2nd & 3rd readings/ suspension",22,4,0,3,29
1952598,1513757,2025-02-06,Senate,"Senate Comm - Favorable Recommendation",5,0,0,2,7
1952598,1513758,2025-02-18,Senate,"Senate/ passed 2nd reading",23,0,0,6,29
1952598,1513759,2025-02-19,Senate,"Senate/ passed 3rd reading",25,0,0,4,29
1952598,1513760,2025-03-03,House,"House Comm - Substitute Recommendation",7,0,0,3,10
1952598,1513761,2025-03-03,House,"House Comm - Amendment Recommendation",7,0,0,3,10
1952598,1513762,2025-03-03,House,"House Comm - Favorable Recommendation",7,0,0,3,10
1952598,1513763,2025-03-07,House,"House/ passed 3rd reading",72,0,0,3,75
1952598,1513764,2025-03-07,Senate,"Senate/ concurs with House amendment",26,0,0,3,29
1952620,1515071,2025-02-13,House,"House Comm - Favorable Recommendation",11,0,0,2,13
1952620,1515072,2025-02-20,House,"House/ passed 3rd reading",72,0,0,3,75
1952667,1512874,2025-02-13,House,"House Comm - Substitute Recommendation",11,0,0,3,14
1952667,1512875,2025-02-13,House,"House Comm - Favorable Recommendation",11,0,0,3,14
1952667,1512876,2025-02-21,House,"House/ passed 3rd reading",68,0,0,7,75
1952667,1512877,2025-02-26,Senate,"Senate Comm - Favorable Recommendation",3,0,0,4,7
1952667,1512878,2025-03-06,Senate,"Senate/ passed 2nd & 3rd readings/ suspension",25,0,0,4,29
1952667,1512879,2025-03-07,House,"House/ concurs with Senate amendment",71,0,0,4,75
1952713,1511016,2025-02-21,House,"House Comm - Substitute Recommendation",8,0,0,2,10
1952713,1511017,2025-02-21,House,"House Comm - Favorable Recommendation",7,2,0,1,10
1952713,1511018,2025-02-27,House,"House/ passed 3rd reading",54,14,0,7,75
1952713,1511019,2025-03-05,Senate,"Senate/ passed 2nd & 3rd readings/ suspension",15,13,0,1,29
1952735,1514821,2025-02-12,House,"House Comm - Substitute Recommendation",5,0,0,2,7
1952735,1514822,2025-02-12,House,"House Comm - Favorable Recommendation",5,0,0,2,7
1952735,1514823,2025-02-12,House,"House Comm - Consent Calendar Recommendation",5,0,0,2,7
1952735,1514824,2025-02-14,House,"House/ passed 3rd reading",71,0,0,4,75
1952735,1514825,2025-02-24,Senate,"Senate Comm - Held",4,1,0,2,7
1952735,1514826,2025-02-26,Senate,"Senate Comm - Favorable Recommendation",4,2,0,1,7
1952735,1514827,2025-03-07,Senate,"Senate/ passed 2nd & 3rd readings/ suspension",20,7,0,2,29
1952758,1514174,2025-02-06,Senate,"Senate Comm - Substitute Recommendation",4,0,0,3,7
1952758,1514175,2025-02-06,Senate,"Senate Comm - Favorable Recommendation",4,0,0,3,7
1952780,1512994,2025-02-12,Senate,"Senate Comm - Motion to Recommend Failed",1,3,0,3,7
1952780,1512995,2025-02-12,Senate,"Senate Comm - Held",4,0,0,3,7
1952803,1511020,2025-02-14,Senate,"Senate Comm - Amendment Recommendation",5,0,0,2,7
1952803,1511021,2025-02-14,Senate,"Senate Comm - Favorable Recommendation",4,0,0,3,7
1952803,1511022,2025-02-21,Senate,"Senate/ passed 2nd reading",24,0,0,5,29
1952803,1511023,2025-02-24,Senate,"Senate/ passed 3rd reading",23,0,0,6,29
1952803,1511024,2025-02-28,House,"House Comm - Favorable Recommendation",9,0,0,2,11
1952803,1511025,2025-03-07,House,"House/ passed 3rd reading",72,0,0,3,75
1952824,1512521,2025-02-05,Senate,"Senate Comm - Substitute Recommendation",6,0,0,2,8
1952824,1512522,2025-02-05,Senate,"Senate Comm - Favorable Recommendation",7,0,0,1,8
1952824,1512523,2025-02-18,Senate,"Senate/ floor amendment failed",10,14,0,5,29
1952824,1512524,2025-02-18,Senate,"Senate/ failed",11,13,0,5,29
1952845,1514843,2025-02-05,Senate,"Senate Comm - Favorable Recommendation",3,1,0,3,7
1952845,1514844,2025-02-18,Senate,"Senate/ passed 2nd reading",20,3,0,6,29
1952845,1514845,2025-02-19,Senate,"Senate/ passed 3rd reading",20,2,0,7,29
1952845,1514846,2025-02-24,House,"House Comm - Substitute Recommendation",11,0,0,3,14
1952845,1514847,2025-02-24,House,"House Comm - Favorable Recommendation",9,2,0,3,14
1952845,1514848,2025-03-04,House,"House/ passed 3rd reading",59,11,0,5,75
1952845,1514849,2025-03-05,Senate,"Senate/ concurs with House amendment",22,4,0,3,29
1953291,1513036,2025-02-19,House,"House Comm - Favorable Recommendation",7,3,0,3,13
1953291,1513037,2025-02-25,House,"House/ passed 3rd reading",40,33,0,2,75
1953291,1513038,2025-03-03,Senate,"Senate Comm - Motion to Recommend Failed",3,4,0,0,7
1953455,1512291,2025-02-12,House,"House Comm - Held",12,0,0,0,12
1953455,1512292,2025-02-18,House,"House Comm - Substitute Recommendation",11,0,0,1,12
1953455,1512293,2025-02-18,House,"House Comm - Amendment Recommendation",11,0,0,1,12
1953455,1512294,2025-02-18,House,"House Comm - Favorable Recommendation",11,0,0,1,12
1953455,1512295,2025-02-25,House,"House/ passed 3rd reading",38,29,0,8,75
1953455,1512296,2025-02-28,Senate,"Senate Comm - Favorable Recommendation",6,0,0,2,8
1953625,1511026,2025-02-14,Senate,"Senate Comm - Substitute Recommendation",3,0,0,4,7
1953625,1511027,2025-02-14,Senate,"Senate Comm - Favorable Recommendation",3,0,0,4,7
1953625,1511028,2025-02-24,Senate,"Senate/ passed 2nd reading",23,3,0,3,29
1953625,1511029,2025-02-25,Senate,"Senate/ passed 3rd reading",22,0,0,7,29
1953625,1511030,2025-02-28,House,"House Comm - Favorable Recommendation",9,0,0,2,11
1953625,1511031,2025-03-05,House,"House/ passed 3rd reading",72,0,0,3,75
1953796,1512386,2025-02-14,Senate,"Senate Comm - Substitute Recommendation",6,0,0,2,8
1953796,1512387,2025-02-14,Senate,"Senate Comm - Favorable Recommendation",7,0,0,1,8
1953796,1512388,2025-02-21,Senate,"Senate/ passed 2nd reading",24,0,0,5,29
1953796,1512389,2025-02-24,Senate,"Senate/ passed 3rd reading",21,0,0,8,29
1953796,1512390,2025-02-28,House,"House Comm - Favorable Recommendation",12,0,0,4,16
1953796,1512391,2025-03-07,House,"House/ passed 3rd reading",66,0,0,9,75
1953796,1512392,2025-03-07,Senate,"Senate/ concurs with House amendment",24,0,0,5,29
1954044,1512358,2025-02-24,House,"House Comm - Substitute Recommendation",7,1,0,3,11
1954044,1512359,2025-02-24,House,"House Comm - Favorable Recommendation",7,1,0,3,11
1954044,1512360,2025-02-27,House,"House/ passed 3rd reading",56,11,0,8,75
1954044,1512361,2025-03-03,Senate,"Senate Comm - Held",3,2,0,2,7
1954106,1513245,2025-02-13,Senate,"Senate Comm - Favorable Recommendation",5,0,0,2,7
1954106,1513246,2025-02-24,Senate,"Senate/ passed 2nd reading",22,0,0,7,29
1954106,1513247,2025-02-25,Senate,"Senate/ passed 3rd reading",25,0,0,4,29
1954106,1513248,2025-03-04,House,"House Comm - Favorable Recommendation",13,0,0,3,16
1954106,1513249,2025-03-07,House,"House/ passed 3rd reading",69,0,0,6,75
1954171,1512235,2025-02-14,Senate,"Senate Comm - Substitute Recommendation",5,0,0,3,8
1954171,1512236,2025-02-14,Senate,"Senate Comm - Favorable Recommendation",5,0,0,3,8
1954171,1512237,2025-02-21,Senate,"Senate/ passed 2nd reading",22,0,0,7,29
1954171,1512238,2025-02-24,Senate,"Senate/ passed 3rd reading",24,0,0,5,29
1954171,1512239,2025-03-04,House,"House Comm - Favorable Recommendation",7,0,0,3,10
1954171,1512240,2025-03-07,House,"House/ passed 3rd reading",69,0,0,6,75
1954369,1515045,2025-02-18,House,"House Comm - Substitute Recommendation",7,0,0,3,10
1954369,1515046,2025-02-18,House,"House Comm - Amendment Recommendation",7,0,0,3,10
1954369,1515047,2025-02-18,House,"House Comm - Favorable Recommendation",7,0,0,3,10
1954369,1515048,2025-02-24,House,"House/ passed 3rd reading",67,0,0,8,75
1954369,1515049,2025-03-03,Senate,"Senate Comm - Held",2,0,0,4,6
1954369,1515050,2025-03-03,Senate,"Senate Comm - Reconsider actions",3,0,0,3,6
1954369,1515051,2025-03-03,Senate,"Senate Comm - Favorable Recommendation",2,1,0,3,6
1954369,1515052,2025-03-06,Senate,"Senate/ passed 2nd & 3rd readings/ suspension",23,0,0,6,29
1954435,1511032,2025-02-26,House,"House Comm - Favorable Recommendation",7,0,0,6,13
1954435,1511033,2025-02-28,House,"House/ passed 3rd reading",69,0,0,6,75
1954435,1511034,2025-03-04,Senate,"Senate Comm - Favorable Recommendation",4,0,0,3,7
1954435,1511035,2025-03-05,Senate,"Senate/ passed 2nd & 3rd readings/ suspension",25,0,0,4,29
1954503,1513382,2025-02-20,House,"House Comm - Favorable Recommendation",8,3,0,2,13
1954503,1513383,2025-02-25,House,"House/ passed 3rd reading",54,16,0,5,75
1954503,1513384,2025-03-03,Senate,"Senate Comm - Substitute Recommendation",5,0,0,3,8
1954503,1513385,2025-03-03,Senate,"Senate Comm - Favorable Recommendation",6,1,0,1,8
1954503,1513386,2025-03-07,Senate,"Senate/ passed 2nd & 3rd readings/ suspension",19,7,0,3,29
1954503,1513387,2025-03-07,House,"House/ concurs with Senate amendment",52,12,0,11,75
1954569,1513093,2025-02-20,Senate,"Senate Comm - Substitute Recommendation",3,0,0,4,7
1954569,1513094,2025-02-20,Senate,"Senate Comm - Favorable Recommendation",6,0,0,1,7
1954569,1513095,2025-02-20,Senate,"Senate Comm - Consent Calendar Recommendation",6,0,0,1,7
1954569,1513096,2025-02-25,Senate,"Senate/ passed 3rd reading",20,4,0,5,29
1954569,1513097,2025-03-03,House,"House Comm - Favorable Recommendation",9,0,0,4,13
1954569,1513098,2025-03-06,House,"House/ passed 3rd reading",63,9,0,3,75
1954635,1512730,2025-02-14,Senate,"Senate Comm - Substitute Recommendation",4,0,0,4,8
1954635,1512731,2025-02-14,Senate,"Senate Comm - Favorable Recommendation",4,2,0,2,8
1954635,1512732,2025-02-27,Senate,"Senate/ passed 2nd reading",24,2,0,3,29
1954635,1512733,2025-02-28,Senate,"Senate/ passed 3rd reading",24,3,0,2,29
1954635,1512734,2025-03-05,House,"House/ failed",28,43,0,4,75
1954704,1512061,2025-02-25,House,"House Comm - Amendment Recommendation",14,0,0,0,14
1954704,1512062,2025-02-25,House,"House Comm - Favorable Recommendation",14,0,0,0,14
1954704,1512063,2025-03-03,House,"House/ passed 3rd reading",71,0,0,4,75
1954704,1512064,2025-03-07,Senate,"Senate/ failed",12,17,0,0,29
1954769,1514478,2025-02-12,House,"House Comm - Favorable Recommendation",7,0,0,7,14
1954769,1514479,2025-02-20,House,"House/ passed 3rd reading",68,0,0,7,75
1954769,1514480,2025-02-28,Senate,"Senate Comm - Favorable Recommendation",5,0,0,2,7
1954899,1512155,2025-02-10,Senate,"Senate Comm - Substitute Recommendation",6,0,0,2,8
1954899,1512156,2025-02-10,Senate,"Senate Comm - Favorable Recommendation",6,0,0,2,8
1954899,1512157,2025-03-04,Senate,"Senate/ passed 2nd & 3rd readings/ suspension",26,2,0,1,29
1955030,1512246,2025-02-14,House,"House Comm - Amendment Recommendation",10,0,0,4,14
1955030,1512247,2025-02-14,House,"House Comm - Favorable Recommendation",10,0,0,4,14
1955030,1512248,2025-02-21,House,"House/ passed 3rd reading",61,5,0,9,75
1955030,1512249,2025-03-04,Senate,"Senate Comm - Favorable Recommendation",4,0,0,3,7
1955030,1512250,2025-03-06,Senate,"Senate/ passed 2nd & 3rd readings/ suspension",28,0,0,1,29
1957539,1513519,2025-02-25,House,"House Comm - Amendment Recommendation",10,0,0,6,16
1957539,1513520,2025-02-25,House,"House Comm - Favorable Recommendation",10,0,0,6,16
1957539,1513521,2025-02-25,House,"House Comm - Consent Calendar Recommendation",10,0,0,6,16
1957539,1513522,2025-02-28,House,"House/ passed 3rd reading",65,0,0,10,75
1957539,1513523,2025-03-03,Senate,"Senate Comm - Favorable Recommendation",6,0,0,2,8
1957539,1513524,2025-03-07,Senate,"Senate/ passed 2nd & 3rd readings/ suspension",26,0,0,3,29
1957581,1513744,2025-02-12,House,"House Comm - Substitute Recommendation",6,0,0,1,7
1957581,1513745,2025-02-12,House,"House Comm - Amendment Recommendation",6,0,0,1,7
1957581,1513746,2025-02-12,House,"House Comm - Favorable Recommendation",6,0,0,1,7
1957581,1513747,2025-02-19,House,"House/ passed 3rd reading",68,0,0,7,75
1957581,1513748,2025-02-21,Senate,"Senate Comm - Amendment Recommendation",9,0,0,0,9
1957581,1513749,2025-02-21,Senate,"Senate Comm - Favorable Recommendation",9,0,0,0,9
1957581,1513750,2025-03-07,Senate,"Senate/ passed 2nd & 3rd readings/ suspension",27,0,0,2,29
1957581,1513751,2025-03-07,House,"House/ concurs with Senate amendment",66,3,0,6,75
1957624,1511036,2025-02-10,House,"House Comm - Amendment Recommendation",10,0,0,6,16
1957624,1511037,2025-02-10,House,"House Comm - Favorable Recommendation",10,0,0,6,16
1957624,1511038,2025-02-12,House,"House/ passed 3rd reading",72,0,0,3,75
1957624,1511039,2025-02-20,Senate,"Senate Comm - Favorable Recommendation",4,0,0,4,8
1957624,1511040,2025-02-27,Senate,"Senate/ passed 2nd reading",22,2,0,5,29
1957624,1511041,2025-02-28,Senate,"Senate/ passed 3rd reading",27,0,0,2,29
1957624,1511042,2025-03-03,House,"House/ concurs with Senate amendment",69,0,0,6,75
1957667,1514804,2025-02-13,Senate,"Senate Comm - Favorable Recommendation",5,0,0,3,8
1957667,1514805,2025-02-21,Senate,"Senate/ passed 2nd reading",24,0,0,5,29
1957667,1514806,2025-02-24,Senate,"Senate/ passed 3rd reading",23,0,0,6,29
1957667,1514807,2025-03-04,House,"House Comm - Favorable Recommendation",9,0,0,5,14
1957667,1514808,2025-03-07,House,"House/ passed 3rd reading",68,0,0,7,75
1957708,1512382,2025-02-12,House,"House Comm - Favorable Recommendation",9,0,0,5,14
1957708,1512383,2025-02-20,House,"House/ passed 3rd reading",69,0,0,6,75
1957708,1512384,2025-02-25,Senate,"Senate Comm - Favorable Recommendation",5,0,0,2,7
1957708,1512385,2025-03-06,Senate,"Senate/ passed 2nd & 3rd readings/ suspension",27,0,0,2,29
1957751,1511043,2025-02-18,House,"House Comm - Favorable Recommendation",5,4,0,1,10
1957751,1511044,2025-02-24,House,"House/ passed 3rd reading",69,0,0,6,75
1957751,1511045,2025-02-28,Senate,"Senate Comm - Held",6,1,0,0,7
1957751,1511046,2025-02-28,Senate,"Senate Comm - Motion to Recommend Failed",3,4,0,0,7
1957751,1511047,2025-03-04,Senate,"Senate Comm - Favorable Recommendation",4,1,0,2,7
1957751,1511048,2025-03-05,Senate,"Senate/ passed 2nd & 3rd readings/ suspension",22,1,0,6,29
1957838,1512036,2025-02-13,House,"House Comm - Substitute Recommendation",9,0,0,1,10
1957838,1512037,2025-02-13,House,"House Comm - Favorable Recommendation",9,0,0,1,10
1957838,1512038,2025-02-21,House,"House/ passed 3rd reading",64,1,0,10,75
1957838,1512039,2025-02-28,Senate,"Senate Comm - Favorable Recommendation",7,0,0,1,8
1957838,1512040,2025-03-05,Senate,"Senate/ passed 2nd & 3rd readings/ suspension",20,5,0,4,29
1957838,1512041,2025-03-05,House,"House/ concurs with Senate amendment",73,0,0,2,75
1957881,1511774,2025-02-14,House,"House Comm - Favorable Recommendation",8,0,0,3,11
1957881,1511775,2025-02-24,House,"House/ passed 3rd reading",54,13,0,8,75
1957881,1511776,2025-03-03,Senate,"Senate Comm - Favorable Recommendation",4,1,0,2,7
1957881,1511777,2025-03-07,Senate,"Senate/ passed 2nd & 3rd readings/ suspension",22,7,0,0,29
1957881,1511778,2025-03-07,House,"House/ concurs with Senate amendment",55,13,0,7,75
1957966,1511049,2025-02-12,Senate,"Senate Comm - Favorable Recommendation",5,1,0,1,7
1957966,1511050,2025-02-18,Senate,"Senate/ passed 2nd reading",20,4,0,5,29
1957966,1511051,2025-02-19,Senate,"Senate/ passed 3rd reading",21,4,0,4,29
1957966,1511052,2025-02-25,House,"House Comm - Favorable Recommendation",9,0,0,2,11
1957966,1511053,2025-02-25,House,"House Comm - Consent Calendar Recommendation",9,0,0,2,11
1957966,1511054,2025-02-27,House,"House/ passed 3rd reading",66,1,0,8,75
1958011,1514799,2025-02-14,House,"House Comm - Substitute Recommendation",12,0,0,1,13
1958011,1514800,2025-02-14,House,"House Comm - Favorable Recommendation",12,0,0,1,13
1958011,1514801,2025-02-24,House,"House/ passed 3rd reading",65,0,0,10,75
1958011,1514802,2025-03-04,Senate,"Senate Comm - Favorable Recommendation",6,0,0,1,7
1958138,1514367,2025-02-14,House,"House Comm - Favorable Recommendation",5,4,0,4,13
1958138,1514368,2025-02-24,House,"House/ passed 3rd reading",70,0,0,5,75
1958138,1514369,2025-02-28,Senate,"Senate Comm - Favorable Recommendation",6,0,0,2,8
1958138,1514370,2025-03-07,Senate,"Senate/ passed 2nd & 3rd readings/ suspension",28,0,0,1,29
1958181,1511055,2025-02-12,Senate,"Senate Comm - Favorable Recommendation",4,0,0,2,6
1958181,1511056,2025-02-12,Senate,"Senate Comm - Consent Calendar Recommendation",4,0,0,2,6
1958181,1511057,2025-02-19,Senate,"Senate/ passed 3rd reading",26,0,0,3,29
1958181,1511058,2025-02-28,House,"House Comm - Favorable Recommendation",6,0,0,4,10
1958181,1511059,2025-02-28,House,"House Comm - Consent Calendar Recommendation",6,0,0,4,10
1958181,1511060,2025-03-05,House,"House/ passed 3rd reading",69,2,0,4,75
1958224,1515025,2025-02-14,Senate,"Senate Comm - Favorable Recommendation",4,0,0,3,7
1958224,1515026,2025-02-21,Senate,"Senate/ passed 2nd reading",22,2,0,5,29
1958224,1515027,2025-02-24,Senate,"Senate/ passed 3rd reading",25,3,0,1,29
1958224,1515028,2025-02-27,House,"House Comm - Substitute Recommendation",10,0,0,4,14
1958224,1515029,2025-02-27,House,"House Comm - Favorable Recommendation",10,0,0,4,14
1958224,1515030,2025-03-07,House,"House/ passed 3rd reading",68,0,0,7,75
1958224,1515031,2025-03-07,House,"House/ passed 3rd reading",65,0,0,10,75
1958224,1515032,2025-03-07,Senate,"Senate/ concurs with House amendment",19,5,0,5,29
1958266,1514493,2025-02-13,Senate,"Senate Comm - Favorable Recommendation",7,0,0,2,9
1958266,1514494,2025-02-21,Senate,"Senate/ passed 2nd reading",27,0,0,2,29
1958266,1514495,2025-02-24,Senate,"Senate/ passed 3rd reading",25,0,0,4,29
1958266,1514496,2025-02-27,House,"House Comm - Favorable Recommendation",8,0,0,3,11
1958266,1514497,2025-03-06,House,"House/ passed 3rd reading",72,0,0,3,75
1958306,1512112,2025-02-18,Senate,"Senate Comm - Favorable Recommendation",5,0,0,2,7
1958306,1512113,2025-02-21,Senate,"Senate/ passed 2nd reading",26,1,0,2,29
1958306,1512114,2025-03-04,Senate,"Senate/ passed 3rd reading",26,0,0,3,29
1958634,1513011,2025-02-20,House,"House Comm - Favorable Recommendation",8,0,0,4,12
1958749,1512644,2025-02-20,House,"House Comm - Substitute Recommendation",10,0,0,1,11
1958749,1512645,2025-02-20,House,"House Comm - Favorable Recommendation",10,0,0,1,11
1958749,1512646,2025-02-26,House,"House/ passed 3rd reading",73,0,0,2,75
1958749,1512647,2025-03-03,Senate,"Senate Comm - Favorable Recommendation",3,0,0,4,7
1958749,1512648,2025-03-07,Senate,"Senate/ passed 2nd & 3rd readings/ suspension",24,0,0,5,29
1958810,1511061,2025-02-10,Senate,"Senate Comm - Favorable Recommendation",7,0,0,1,8
1958810,1511062,2025-02-18,Senate,"Senate/ passed 2nd reading",21,0,0,8,29
1958810,1511063,2025-02-19,Senate,"Senate/ passed 3rd reading",23,0,0,6,29
1958810,1511064,2025-02-24,House,"House Comm - Favorable Recommendation",10,0,0,2,12
1958810,1511065,2025-02-24,House,"House Comm - Consent Calendar Recommendation",10,0,0,2,12
1958810,1511066,2025-02-26,House,"House/ passed 3rd reading",65,0,0,10,75
1958870,1511067,2025-02-12,House,"House Comm - Amendment Recommendation",6,0,0,1,7
1958870,1511068,2025-02-12,House,"House Comm - Favorable Recommendation",6,0,0,1,7
1958870,1511069,2025-02-12,House,"House Comm - Consent Calendar Recommendation",6,0,0,1,7
1958870,1511070,2025-02-14,House,"House/ passed 3rd reading",72,0,0,3,75
1958988,1513511,2025-02-19,House,"House Comm - Substitute Recommendation",11,0,0,2,13
1958988,1513512,2025-02-19,House,"House Comm - Favorable Recommendation",11,0,0,2,13
1958988,1513513,2025-02-25,House,"House/ passed 3rd reading",67,0,0,8,75
1958988,1513514,2025-03-03,Senate,"Senate Comm - Favorable Recommendation",6,0,0,1,7
1958988,1513515,2025-03-07,Senate,"Senate/ passed 2nd & 3rd readings/ suspension",28,0,0,1,29
1959047,1511071,2025-02-12,Senate,"Senate Comm - Substitute Recommendation",4,0,0,3,7
1959047,1511072,2025-02-12,Senate,"Senate Comm - Favorable Recommendation",5,0,0,2,7
1959047,1511073,2025-02-21,Senate,"Senate/ passed 2nd reading",23,0,0,6,29
1959047,1511074,2025-02-24,Senate,"Senate/ passed 3rd reading",25,0,0,4,29
1959047,1511075,2025-02-27,House,"House Comm - Favorable Recommendation",6,0,0,5,11
1959047,1511076,2025-03-04,House,"House/ passed 3rd reading",69,0,0,6,75
1959108,1513378,2025-02-18,House,"House Comm - Substitute Recommendation",11,0,0,3,14
1959108,1513379,2025-02-18,House,"House Comm - Favorable Recommendation",11,0,0,3,14
1959108,1513380,2025-02-25,House,"House/ passed 3rd reading",68,0,0,7,75
1959108,1513381,2025-03-03,Senate,"Senate Comm - Favorable Recommendation",5,0,0,2,7
1959168,1513317,2025-02-10,Senate,"Senate Comm - Held",4,0,0,3,7
1959168,1513318,2025-02-25,Senate,"Senate Comm - Substitute Recommendation",5,0,0,2,7
1959168,1513319,2025-02-25,Senate,"Senate Comm - Held",6,0,0,1,7
1959226,1511852,2025-02-13,House,"House Comm - Substitute Recommendation",12,0,0,2,14
1959226,1511853,2025-02-13,House,"House Comm - Amendment Recommendation",11,0,0,3,14
1959226,1511854,2025-02-13,House,"House Comm - Favorable Recommendation",12,0,0,2,14
1959226,1511855,2025-02-21,House,"House/ passed 3rd reading",69,0,0,6,75
1959226,1511856,2025-02-26,Senate,"Senate Comm - Favorable Recommendation",3,0,0,4,7
1959226,1511857,2025-03-07,Senate,"Senate/ passed 2nd & 3rd readings/ suspension",28,0,0,1,29
1959586,1511947,2025-02-18,House,"House Comm - Substitute Recommendation",14,0,0,2,16
1959586,1511948,2025-02-18,House,"House Comm - Favorable Recommendation",8,6,0,2,16
1959586,1511949,2025-03-04,House,"House/ substituted",40,34,0,1,75
1959586,1511950,2025-03-04,House,"House/ failed",22,47,0,6,75
1960304,1511077,2025-02-12,Senate,"Senate Comm - Substitute Recommendation",4,0,0,2,6
1960304,1511078,2025-02-12,Senate,"Senate Comm - Favorable Recommendation",5,0,0,1,6
1960304,1511079,2025-02-18,Senate,"Senate/ passed 2nd reading",23,0,0,6,29
1960304,1511080,2025-02-19,Senate,"Senate/ passed 3rd reading",24,0,0,5,29
1960304,1511081,2025-02-25,House,"House Comm - Favorable Recommendation",7,0,0,3,10
1960304,1511082,2025-02-27,House,"House/ passed 3rd reading",63,2,0,10,75
1960355,1512856,2025-02-13,House,"House Comm - Substitute Recommendation",11,0,0,5,16
1960355,1512857,2025-02-13,House,"House Comm - Favorable Recommendation",8,3,0,5,16
1960355,1512858,2025-02-21,House,"House/ passed 3rd reading",64,0,0,11,75
1960355,1512859,2025-02-26,Senate,"Senate Comm - Favorable Recommendation",4,0,0,3,7
1960355,1512860,2025-03-06,Senate,"Senate/ passed 2nd & 3rd readings/ suspension",24,2,0,3,29
1960355,1512861,2025-03-07,House,"House/ concurs with Senate amendment",71,0,0,4,75
1960408,1511083,2025-02-14,House,"House Comm - Amendment Recommendation",9,0,0,2,11
1960408,1511084,2025-02-14,House,"House Comm - Favorable Recommendation",9,0,0,2,11
1960408,1511085,2025-02-14,House,"House Comm - Consent Calendar Recommendation",9,0,0,2,11
1960408,1511086,2025-02-18,House,"House/ passed 3rd reading",70,0,0,5,75
1960408,1511087,2025-02-25,Senate,"Senate Comm - Favorable Recommendation",5,0,0,3,8
1960408,1511088,2025-02-25,Senate,"Senate Comm - Consent Calendar Recommendation",5,0,0,3,8
1960408,1511089,2025-03-05,Senate,"Senate/ passed 2nd & 3rd readings/ suspension",20,0,0,9,29
1960459,1514965,2025-02-18,House,"House Comm - Substitute Recommendation",11,0,0,3,14
1960459,1514966,2025-02-18,House,"House Comm - Favorable Recommendation",10,0,0,4,14
1960459,1514967,2025-02-25,House,"House/ passed 3rd reading",64,0,0,11,75
1960459,1514968,2025-02-28,Senate,"Senate Comm - Favorable Recommendation",6,0,0,1,7
1960459,1514969,2025-03-07,Senate,"Senate/ passed 2nd & 3rd readings/ suspension",27,0,0,2,29
1960561,1514552,2025-02-13,House,"House Comm - Favorable Recommendation",12,0,0,4,16
1960561,1514553,2025-02-21,House,"House/ passed 3rd reading",69,0,0,6,75
1960561,1514554,2025-02-28,Senate,"Senate Comm - Favorable Recommendation",4,0,0,4,8
1960614,1512283,2025-02-10,House,"House Comm - Substitute Recommendation",7,0,0,3,10
1960614,1512284,2025-02-10,House,"House Comm - Favorable Recommendation",7,0,0,3,10
1960614,1512285,2025-02-18,House,"House/ passed 3rd reading",70,0,0,5,75
1960614,1512286,2025-02-25,Senate,"Senate Comm - Amendment Recommendation",4,0,0,4,8
1960614,1512287,2025-02-25,Senate,"Senate Comm - Favorable Recommendation",4,0,0,4,8
1960614,1512288,2025-03-06,Senate,"Senate/ passed 2nd & 3rd readings/ suspension",27,0,0,2,29
1960614,1512289,2025-03-07,Senate,"Senate Conference Committee - Final Passage",26,0,0,3,29
1960614,1512290,2025-03-07,House,"House Conference Committee - Final Passage",68,0,0,7,75
1960664,1511217,2025-02-12,House,"House Comm - Substitute Recommendation",10,0,0,1,11
1960664,1511218,2025-02-12,House,"House Comm - Favorable Recommendation",10,0,0,1,11
1960664,1511219,2025-02-20,House,"House/ passed 3rd reading",70,0,0,5,75
1960664,1511220,2025-03-07,Senate,"Senate/ passed 2nd & 3rd readings/ suspension",26,0,0,3,29
1960664,1511221,2025-03-07,House,"House/ concurs with Senate amendment",65,0,0,10,75
1960767,1514448,2025-02-20,Senate,"Senate Comm - Substitute Recommendation",4,0,0,3,7
1960767,1514449,2025-02-20,Senate,"Senate Comm - Amendment Recommendation",4,0,0,3,7
1960767,1514450,2025-02-20,Senate,"Senate Comm - Favorable Recommendation",3,2,0,2,7
1960767,1514451,2025-02-24,Senate,"Senate/ passed 2nd reading",21,2,0,6,29
1960767,1514452,2025-02-25,Senate,"Senate/ passed 3rd reading",21,3,0,5,29
1960767,1514453,2025-03-04,House,"House Comm - Favorable Recommendation",9,0,0,5,14
1960819,1512988,2025-02-20,House,"House Comm - Substitute Recommendation",12,0,0,2,14
1960819,1512989,2025-02-20,House,"House Comm - Favorable Recommendation",12,0,0,2,14
1960819,1512990,2025-02-25,House,"House/ passed 3rd reading",69,0,0,6,75
1960819,1512991,2025-02-28,Senate,"Senate Comm - Favorable Recommendation",6,0,0,1,7
1960819,1512992,2025-03-07,Senate,"Senate/ passed 2nd & 3rd readings/ suspension",26,0,0,3,29
1960870,1511090,2025-02-12,Senate,"Senate Comm - Favorable Recommendation",4,0,0,3,7
1960870,1511091,2025-02-21,Senate,"Senate/ passed 2nd reading",24,1,0,4,29
1960870,1511092,2025-02-24,Senate,"Senate/ passed 3rd reading",22,4,0,3,29
1960870,1511093,2025-02-28,House,"House Comm - Favorable Recommendation",7,0,0,3,10
1960870,1511094,2025-03-04,House,"House/ passed 3rd reading",58,14,0,3,75
1960870,1511095,2025-03-05,Senate,"Senate/ concurs with House amendment",25,2,0,2,29
1960923,1514194,2025-02-19,House,"House Comm - Amendment Recommendation",6,0,0,4,10
1960923,1514195,2025-02-19,House,"House Comm - Favorable Recommendation",5,0,0,5,10
1960923,1514196,2025-02-26,House,"House/ passed 3rd reading",67,0,0,8,75
1960923,1514197,2025-03-04,Senate,"Senate Comm - Favorable Recommendation",7,0,0,0,7
1960923,1514198,2025-03-07,Senate,"Senate/ passed 2nd & 3rd readings/ suspension",26,0,0,3,29
1961834,1511699,2025-02-25,House,"House Comm - Substitute Recommendation",9,0,0,1,10
1961834,1511700,2025-02-25,House,"House Comm - Favorable Recommendation",9,0,0,1,10
1961834,1511701,2025-02-27,House,"House/ passed 3rd reading",73,0,0,2,75
1961834,1511702,2025-03-03,Senate,"Senate Comm - Substitute Recommendation",4,0,0,2,6
1961834,1511703,2025-03-03,Senate,"Senate Comm - Favorable Recommendation",5,0,0,1,6
1961834,1511704,2025-03-06,Senate,"Senate/ passed 2nd & 3rd readings/ suspension",26,0,0,3,29
1961834,1511705,2025-03-06,House,"House/ concurs with Senate amendment",70,0,0,5,75
1961925,1511346,2025-02-20,House,"House Comm - Substitute Recommendation",12,0,0,1,13
1961925,1511347,2025-02-20,House,"House Comm - Favorable Recommendation",8,5,0,0,13
1961925,1511348,2025-02-26,House,"House/ passed 3rd reading",57,14,0,4,75
1961925,1511349,2025-03-04,Senate,"Senate Comm - Held",6,1,0,0,7
1962120,1515138,2025-02-13,Senate,"Senate Comm - Substitute Recommendation",5,0,0,4,9
1962120,1515139,2025-02-13,Senate,"Senate Comm - Amendment Recommendation",5,0,0,4,9
1962120,1515140,2025-02-13,Senate,"Senate Comm - Favorable Recommendation",6,0,0,3,9
1962120,1515141,2025-02-21,Senate,"Senate/ passed 2nd reading",21,2,0,6,29
1962120,1515142,2025-02-24,Senate,"Senate/ passed 3rd reading",21,4,0,4,29
1962120,1515143,2025-03-03,Senate,"Senate/ passed 3rd reading",27,1,0,1,29
1962120,1515144,2025-03-04,House,"House Comm - Favorable Recommendation",8,0,0,3,11
1962214,1511096,2025-02-18,House,"House Comm - Favorable Recommendation",9,0,0,5,14
1962214,1511097,2025-02-25,House,"House/ passed 3rd reading",66,0,0,9,75
1962214,1511098,2025-03-04,Senate,"Senate Comm - Favorable Recommendation",5,0,0,2,7
1962214,1511099,2025-03-07,Senate,"Senate/ passed 2nd & 3rd readings/ suspension",26,0,0,3,29
1962309,1512780,2025-02-10,House,"House Comm - Favorable Recommendation",12,0,0,4,16
1962309,1512781,2025-02-19,House,"House/ passed 3rd reading",73,0,0,2,75
1962309,1512782,2025-02-25,Senate,"Senate Comm - Favorable Recommendation",4,0,0,3,7
1962309,1512783,2025-03-05,Senate,"Senate/ passed 2nd & 3rd readings/ suspension",25,0,0,4,29
1962309,1512784,2025-03-06,Senate,"Senate Conference Committee - Final Passage",23,0,0,6,29
1962309,1512785,2025-03-06,House,"House Conference Committee - Final Passage",72,0,0,3,75
1962500,1513104,2025-02-18,House,"House Comm - Substitute Recommendation",8,0,0,3,11
1962500,1513105,2025-02-18,House,"House Comm - Favorable Recommendation",8,0,0,3,11
1962500,1513106,2025-02-25,House,"House/ passed 3rd reading",68,0,0,7,75
1962500,1513107,2025-03-04,Senate,"Senate Comm - Favorable Recommendation",4,0,0,5,9
1962601,1511100,2025-02-12,Senate,"Senate Comm - Favorable Recommendation",4,0,0,3,7
1962601,1511101,2025-02-21,Senate,"Senate/ passed 2nd reading",23,0,0,6,29
1962601,1511102,2025-02-24,Senate,"Senate/ passed 3rd reading",23,0,0,6,29
1962601,1511103,2025-03-03,House,"House Comm - Favorable Recommendation",11,0,0,2,13
1962601,1511104,2025-03-05,House,"House/ passed 3rd reading",68,0,0,7,75
1962701,1512049,2025-02-18,House,"House Comm - Substitute Recommendation",8,0,0,8,16
1962701,1512050,2025-02-18,House,"House Comm - Favorable Recommendation",6,2,0,8,16
1962701,1512051,2025-02-24,House,"House/ passed 3rd reading",61,4,0,10,75
1962701,1512052,2025-02-28,Senate,"Senate Comm - Favorable Recommendation",3,0,0,4,7
1962804,1511105,2025-02-13,House,"House Comm - Substitute Recommendation",11,0,0,5,16
1962804,1511106,2025-02-13,House,"House Comm - Amendment Recommendation",12,0,0,4,16
1962804,1511107,2025-02-13,House,"House Comm - Favorable Recommendation",13,0,0,3,16
1962804,1511108,2025-02-24,House,"House/ passed 3rd reading",69,0,0,6,75
1962804,1511109,2025-02-26,Senate,"Senate Comm - Amendment Recommendation",4,0,0,3,7
1962804,1511110,2025-02-26,Senate,"Senate Comm - Favorable Recommendation",6,0,0,1,7
1962804,1511111,2025-02-27,Senate,"Senate/ passed 2nd reading",26,1,0,2,29
1962804,1511112,2025-02-28,Senate,"Senate/ passed 3rd reading",25,1,0,3,29
1962804,1511113,2025-03-03,House,"House/ concurs with Senate amendment",66,0,0,9,75
1962841,1511114,2025-02-13,House,"House Comm - Favorable Recommendation",9,0,0,1,10
1962841,1511115,2025-02-21,House,"House/ passed 3rd reading",66,0,0,9,75
1962914,1511116,2025-02-12,House,"House Comm - Favorable Recommendation",6,0,0,1,7
1962914,1511117,2025-02-12,House,"House Comm - Consent Calendar Recommendation",6,0,0,1,7
1962914,1511118,2025-02-14,House,"House/ passed 3rd reading",70,0,0,5,75
1962949,1513736,2025-02-12,Senate,"Senate Comm - Motion to Recommend Failed",1,5,0,1,7
1962985,1511428,2025-02-26,House,"House Comm - Held",6,2,0,5,13
1963023,1512763,2025-02-19,House,"House Comm - Amendment Recommendation",10,0,0,6,16
1963023,1512764,2025-02-19,House,"House Comm - Amendment Recommendation",10,0,0,6,16
1963023,1512765,2025-02-19,House,"House Comm - Motion to Recommend Failed",5,5,0,6,16
1963023,1512766,2025-02-27,House,"House Comm - Substitute Recommendation",12,0,0,4,16
1963023,1512767,2025-02-27,House,"House Comm - Favorable Recommendation",9,3,0,4,16
1963023,1512768,2025-02-28,House,"House/ passed 3rd reading",57,10,0,8,75
1963023,1512769,2025-03-04,Senate,"Senate Comm - Favorable Recommendation",3,2,0,1,6
1963060,1512572,2025-02-14,House,"House Comm - Substitute Recommendation",13,0,0,1,14
1963060,1512573,2025-02-14,House,"House Comm - Favorable Recommendation",13,0,0,1,14
1963060,1512574,2025-02-24,House,"House/ passed 3rd reading",61,5,0,9,75
1963060,1512575,2025-02-28,Senate,"Senate Comm - Favorable Recommendation",4,0,0,4,8
1963060,1512576,2025-03-06,Senate,"Senate/ passed 2nd & 3rd readings/ suspension",27,0,0,2,29
1963060,1512577,2025-03-06,House,"House/ concurs with Senate amendment",61,10,0,4,75
1963098,1511420,2025-02-25,House,"House Comm - Substitute Recommendation",9,0,0,1,10
1963098,1511421,2025-02-25,House,"House Comm - Favorable Recommendation",9,0,0,1,10
1963098,1511422,2025-02-27,House,"House/ passed 3rd reading",70,0,0,5,75
1963098,1511423,2025-03-03,Senate,"Senate Comm - Favorable Recommendation",5,0,0,2,7
1963098,1511424,2025-03-05,Senate,"Senate/ passed 2nd & 3rd readings/ suspension",28,0,0,1,29
1963136,1514526,2025-02-20,House,"House Comm - Favorable Recommendation",11,0,0,3,14
1963136,1514527,2025-02-25,House,"House/ passed 3rd reading",65,0,0,10,75
1963136,1514528,2025-02-28,Senate,"Senate Comm - Favorable Recommendation",5,0,0,2,7
1963171,1512771,2025-02-13,Senate,"Senate Comm - Favorable Recommendation",5,0,0,2,7
1963171,1512772,2025-02-21,Senate,"Senate/ passed 2nd reading",26,0,0,3,29
1963171,1512773,2025-02-24,Senate,"Senate/ passed 3rd reading",24,0,0,5,29
1963171,1512774,2025-03-04,House,"House Comm - Substitute Recommendation",13,0,0,3,16
1963171,1512775,2025-03-04,House,"House Comm - Favorable Recommendation",13,0,0,3,16
1963207,1514530,2025-02-13,Senate,"Senate Comm - Favorable Recommendation",6,2,0,1,9
1963207,1514531,2025-02-21,Senate,"Senate/ passed 2nd reading",21,0,0,8,29
1963207,1514532,2025-02-24,Senate,"Senate/ passed 3rd reading",25,0,0,4,29
1963207,1514533,2025-03-03,House,"House Comm - Favorable Recommendation",7,1,0,3,11
1963244,1514951,2025-02-14,Senate,"Senate Comm - Favorable Recommendation",7,0,0,1,8
1963244,1514952,2025-02-21,Senate,"Senate/ passed 2nd reading",25,0,0,4,29
1963244,1514953,2025-02-24,Senate,"Senate/ passed 3rd reading",25,0,0,4,29
1963244,1514954,2025-03-04,House,"House Comm - Substitute Recommendation",10,0,0,4,14
1963244,1514955,2025-03-04,House,"House Comm - Amendment Recommendation",10,0,0,4,14
1963244,1514956,2025-03-04,House,"House Comm - Favorable Recommendation",10,0,0,4,14
1963244,1514957,2025-03-07,House,"House/ passed 3rd reading",65,0,0,10,75
1963244,1514958,2025-03-07,Senate,"Senate/ concurs with House amendment",26,0,0,3,29
1963280,1514152,2025-02-20,House,"House Comm - Favorable Recommendation",8,0,0,2,10
1963280,1514153,2025-03-04,House,"House/ passed 3rd reading",70,3,0,2,75
1963280,1514154,2025-03-06,Senate,"Senate/ passed 2nd & 3rd readings/ suspension",15,14,0,0,29
1963318,1513583,2025-02-12,House,"House Comm - Substitute Recommendation",5,0,0,2,7
1963318,1513585,2025-02-12,House,"House Comm - Favorable Recommendation",5,0,0,2,7
1963318,1513587,2025-02-12,House,"House Comm - Consent Calendar Recommendation",5,0,0,2,7
1963318,1513589,2025-02-14,House,"House/ passed 3rd reading",68,0,0,7,75
1963318,1513590,2025-02-24,Senate,"Senate Comm - Favorable Recommendation",4,0,0,3,7
1963318,1513592,2025-02-24,Senate,"Senate Comm - Consent Calendar Recommendation",4,0,0,3,7
1963318,1513593,2025-02-27,Senate,"Senate/ passed 3rd reading",25,0,0,4,29
1963319,1512568,2025-02-14,Senate,"Senate Comm - Amendment Recommendation",2,0,0,5,7
1963319,1512569,2025-02-14,Senate,"Senate Comm - Favorable Recommendation",2,0,0,5,7
1963319,1512570,2025-02-14,Senate,"Senate Comm - Consent Calendar Recommendation",2,0,0,5,7
1963550,1511119,2025-02-25,House,"House Comm - Amendment Recommendation",8,0,0,8,16
1963550,1511120,2025-02-25,House,"House Comm - Favorable Recommendation",8,0,0,8,16
1963550,1511121,2025-02-28,House,"House/ passed 3rd reading",66,0,0,9,75
1963550,1511122,2025-03-03,Senate,"Senate Comm - Favorable Recommendation",4,0,0,3,7
1963550,1511123,2025-03-05,Senate,"Senate/ passed 2nd & 3rd readings/ suspension",23,4,0,2,29
1963550,1511125,2025-03-05,House,"House/ concurs with Senate amendment",73,0,0,2,75
1963640,1512207,2025-02-18,House,"House Comm - Substitute Recommendation",6,0,0,5,11
1963640,1512208,2025-02-18,House,"House Comm - Held",5,1,0,5,11
1963640,1512209,2025-02-24,House,"House Comm - Substitute Recommendation",9,0,0,2,11
1963640,1512210,2025-02-24,House,"House Comm - Favorable Recommendation",10,0,0,1,11
1963640,1512211,2025-02-27,House,"House/ passed 3rd reading",44,20,0,11,75
1963640,1512212,2025-03-04,Senate,"Senate Comm - Favorable Recommendation",3,2,0,2,7
1963734,1514775,2025-02-18,House,"House Comm - Substitute Recommendation",8,0,0,3,11
1963734,1514776,2025-02-18,House,"House Comm - Favorable Recommendation",8,0,0,3,11
1963734,1514777,2025-02-25,House,"House/ passed 3rd reading",66,0,0,9,75
1963734,1514778,2025-02-28,Senate,"Senate Comm - Favorable Recommendation",6,0,0,3,9
1963734,1514779,2025-03-07,Senate,"Senate/ passed 2nd & 3rd readings/ suspension",25,0,0,4,29
1963919,1512820,2025-02-19,Senate,"Senate Comm - Favorable Recommendation",6,0,0,1,7
1963919,1512821,2025-02-24,Senate,"Senate/ passed 2nd reading",22,0,0,7,29
1963919,1512822,2025-02-25,Senate,"Senate/ passed 3rd reading",22,0,0,7,29
1963919,1512823,2025-02-28,House,"House Comm - Favorable Recommendation",9,0,0,7,16
1963919,1512824,2025-03-07,House,"House/ passed 3rd reading",66,4,0,5,75
1964011,1513208,2025-02-28,Senate,"Senate Comm - Substitute Recommendation",5,0,0,2,7
1964011,1513209,2025-02-28,Senate,"Senate Comm - Favorable Recommendation",5,0,0,2,7
1964109,1512833,2025-02-14,House,"House Comm - Favorable Recommendation",10,0,0,1,11
1964109,1512834,2025-02-20,House,"House/ passed 3rd reading",70,0,0,5,75
1964109,1512835,2025-02-26,Senate,"Senate Comm - Favorable Recommendation",5,0,0,1,6
1964127,1511543,2025-02-13,Senate,"Senate Comm - Favorable Recommendation",2,1,0,4,7
1964127,1511544,2025-02-21,Senate,"Senate/ passed 2nd reading",17,5,0,7,29
1964127,1511545,2025-02-24,Senate,"Senate/ passed 3rd reading",15,4,0,10,29
1964127,1511546,2025-02-27,House,"House Comm - Favorable Recommendation",12,0,0,0,12
1964127,1511547,2025-03-07,House,"House/ passed 3rd reading",73,0,0,2,75
1964127,1511548,2025-03-07,Senate,"Senate/ concurs with House amendment",19,8,0,2,29
1964167,1514305,2025-02-14,House,"House Comm - Favorable Recommendation",7,1,0,3,11
1964167,1514306,2025-02-21,House,"House/ passed 3rd reading",54,16,0,5,75
1964167,1514307,2025-02-27,Senate,"Senate Comm - Substitute Recommendation",2,1,0,6,9
1964167,1514308,2025-02-27,Senate,"Senate Comm - Favorable Recommendation",4,0,0,5,9
1964167,1514309,2025-03-07,Senate,"Senate/ passed 2nd & 3rd readings/ suspension",22,6,0,1,29
1964167,1514310,2025-03-07,House,"House/ concurs with Senate amendment",56,12,0,7,75
1964186,1515089,2025-02-19,House,"House Comm - Substitute Recommendation",10,0,0,6,16
1964186,1515090,2025-02-19,House,"House Comm - Amendment Recommendation",11,0,0,5,16
1964186,1515091,2025-02-19,House,"House Comm - Favorable Recommendation",11,0,0,5,16
1964186,1515092,2025-02-25,House,"House/ passed 3rd reading",68,2,0,5,75
1964186,1515093,2025-03-03,Senate,"Senate Comm - Favorable Recommendation",4,0,0,4,8
1964205,1511942,2025-02-28,House,"House Comm - Substitute Recommendation",9,0,0,7,16
1964205,1511943,2025-02-28,House,"House Comm - Amendment Recommendation",10,0,0,6,16
1964205,1511944,2025-02-28,House,"House Comm - Favorable Recommendation",7,3,0,6,16
1964205,1511945,2025-03-03,House,"House/ passed 3rd reading",54,14,0,7,75
1964227,1513229,2025-02-18,Senate,"Senate Comm - Substitute Recommendation",7,0,0,2,9
1964227,1513230,2025-02-18,Senate,"Senate Comm - Amendment Recommendation",7,0,0,2,9
1964227,1513231,2025-02-18,Senate,"Senate Comm - Favorable Recommendation",7,0,0,2,9
1964227,1513232,2025-02-21,Senate,"Senate/ passed 2nd reading",24,0,0,5,29
1964227,1513233,2025-02-27,Senate,"Senate/ passed 3rd reading",25,0,0,4,29
1964227,1513234,2025-03-04,House,"House Comm - Substitute Recommendation",8,0,0,3,11
1964227,1513235,2025-03-04,House,"House Comm - Favorable Recommendation",8,1,0,2,11
1964246,1513672,2025-02-20,Senate,"Senate Comm - Substitute Recommendation",3,0,0,4,7
1964246,1513673,2025-02-20,Senate,"Senate Comm - Favorable Recommendation",4,0,0,3,7
1964246,1513674,2025-02-24,Senate,"Senate/ passed 2nd reading",22,0,0,7,29
1964246,1513675,2025-02-25,Senate,"Senate/ passed 3rd reading",23,0,0,6,29
1964246,1513676,2025-03-03,House,"House Comm - Substitute Recommendation",10,0,0,1,11
1964246,1513677,2025-03-03,House,"House Comm - Favorable Recommendation",10,0,0,1,11
1964246,1513678,2025-03-07,House,"House/ passed 3rd reading",67,0,0,8,75
1964246,1513679,2025-03-07,Senate,"Senate/ concurs with House amendment",28,0,0,1,29
1964266,1512693,2025-02-18,House,"House Comm - Substitute Recommendation",10,0,0,2,12
1964266,1512694,2025-02-18,House,"House Comm - Favorable Recommendation",10,0,0,2,12
1964266,1512695,2025-02-27,House,"House/ passed 3rd reading",64,2,0,9,75
1964266,1512696,2025-03-04,Senate,"Senate Comm - Favorable Recommendation",6,0,0,2,8
1964285,1514371,2025-02-12,Senate,"Senate Comm - Substitute Recommendation",7,0,0,0,7
1964285,1514372,2025-02-12,Senate,"Senate Comm - Favorable Recommendation",6,0,0,1,7
1964285,1514373,2025-02-21,Senate,"Senate/ passed 2nd reading",21,1,0,7,29
1964285,1514374,2025-02-24,Senate,"Senate/ passed 3rd reading",24,0,0,5,29
1964285,1514375,2025-02-27,House,"House Comm - Substitute Recommendation",7,0,0,3,10
1964285,1514376,2025-02-27,House,"House Comm - Favorable Recommendation",7,0,0,3,10
1964285,1514377,2025-03-07,House,"House/ passed 3rd reading",66,2,0,7,75
1964285,1514378,2025-03-07,Senate,"Senate/ concurs with House amendment",25,0,0,4,29
1964306,1513536,2025-02-12,Senate,"Senate Comm - Favorable Recommendation",4,0,0,2,6
1964306,1513537,2025-02-18,Senate,"Senate/ passed 2nd reading",23,0,0,6,29
1964306,1513538,2025-02-19,Senate,"Senate/ passed 3rd reading",25,0,0,4,29
1964306,1513539,2025-02-28,House,"House Comm - Favorable Recommendation",5,0,0,5,10
1964306,1513540,2025-03-07,House,"House/ passed 3rd reading",72,0,0,3,75
1964345,1512610,2025-02-20,Senate,"Senate Comm - Amendment Recommendation",5,0,0,2,7
1964345,1512611,2025-02-20,Senate,"Senate Comm - Favorable Recommendation",5,0,0,2,7
1964345,1512612,2025-02-24,Senate,"Senate/ passed 2nd reading",22,0,0,7,29
1964345,1512613,2025-02-25,Senate,"Senate/ passed 3rd reading",24,0,0,5,29
1964345,1512614,2025-03-03,House,"House Comm - Substitute Recommendation",11,0,0,2,13
1964345,1512615,2025-03-03,House,"House Comm - Favorable Recommendation",11,0,0,2,13
1964345,1512616,2025-03-05,House,"House/ passed 3rd reading",71,0,0,4,75
1964345,1512617,2025-03-06,Senate,"Senate/ concurs with House amendment",25,0,0,4,29
1964366,1512076,2025-02-21,House,"House Comm - Substitute Recommendation",14,0,0,2,16
1964366,1512077,2025-02-21,House,"House Comm - Favorable Recommendation",14,0,0,2,16
1964366,1512078,2025-02-27,House,"House/ passed 3rd reading",60,10,0,5,75
1964387,1514987,2025-02-20,House,"House Comm - Substitute Recommendation",11,0,0,0,11
1964387,1514988,2025-02-20,House,"House Comm - Favorable Recommendation",11,0,0,0,11
1964387,1514989,2025-02-26,House,"House/ passed 3rd reading",69,0,0,6,75
1964387,1514990,2025-03-03,Senate,"Senate Comm - Favorable Recommendation",4,0,0,3,7
1964387,1514991,2025-03-07,Senate,"Senate/ passed 2nd & 3rd readings/ suspension",20,3,0,6,29
1964426,1511126,2025-02-13,Senate,"Senate Comm - Favorable Recommendation",3,0,0,5,8
1964426,1511127,2025-02-13,Senate,"Senate Comm - Consent Calendar Recommendation",3,0,0,5,8
1964426,1511128,2025-02-20,Senate,"Senate/ passed 3rd reading",21,0,0,8,29
1964426,1511129,2025-02-27,House,"House Comm - Amendment Recommendation",9,0,0,3,12
1964426,1511130,2025-02-27,House,"House Comm - Favorable Recommendation",9,0,0,3,12
1964426,1511131,2025-03-05,House,"House/ passed 3rd reading",67,0,0,8,75
1964426,1511132,2025-03-05,Senate,"Senate/ concurs with House amendment",23,0,0,6,29
1964445,1514075,2025-02-14,House,"House Comm - Favorable Recommendation",11,0,0,1,12
1964445,1514076,2025-02-21,House,"House/ passed 3rd reading",64,0,0,11,75
1964445,1514077,2025-02-27,Senate,"Senate Comm - Substitute Recommendation",6,0,0,2,8
1964445,1514078,2025-02-27,Senate,"Senate Comm - Favorable Recommendation",6,0,0,2,8
1964445,1514079,2025-03-06,Senate,"Senate/ passed 2nd & 3rd readings/ suspension",26,0,0,3,29
1964445,1514080,2025-03-07,House,"House/ concurs with Senate amendment",71,0,0,4,75
1964840,1514003,2025-02-20,House,"House Comm - Substitute Recommendation",11,0,0,0,11
1964840,1514004,2025-02-20,House,"House Comm - Favorable Recommendation",11,0,0,0,11
1964840,1514005,2025-02-26,House,"House/ passed 3rd reading",66,0,0,9,75
1964840,1514006,2025-03-03,Senate,"Senate Comm - Favorable Recommendation",4,0,0,3,7
1964875,1513309,2025-02-20,House,"House Comm - Favorable Recommendation",12,0,0,2,14
1964875,1513310,2025-02-25,House,"House/ passed 3rd reading",69,0,0,6,75
1964875,1513311,2025-03-03,Senate,"Senate Comm - Substitute Recommendation",4,0,0,2,6
1964875,1513312,2025-03-03,Senate,"Senate Comm - Favorable Recommendation",4,0,0,2,6
1964875,1513313,2025-03-07,Senate,"Senate/ passed 2nd & 3rd readings/ suspension",23,0,0,6,29
1964875,1513314,2025-03-07,House,"House/ concurs with Senate amendment",68,1,0,6,75
1964907,1511133,2025-02-26,House,"House Comm - Favorable Recommendation",8,0,0,2,10
1964907,1511134,2025-03-03,House,"House/ passed 3rd reading",71,0,0,4,75
1964907,1511135,2025-03-05,Senate,"Senate/ passed 2nd & 3rd readings/ suspension",27,0,0,2,29
1964941,1511240,2025-02-21,House,"House Comm - Amendment Recommendation",12,0,0,4,16
1964941,1511241,2025-02-21,House,"House Comm - Favorable Recommendation",11,1,0,4,16
1964941,1511242,2025-02-27,House,"House/ passed 3rd reading",66,0,0,9,75
1964941,1511243,2025-03-03,Senate,"Senate Comm - Amendment Recommendation",5,0,0,3,8
1964941,1511244,2025-03-03,Senate,"Senate Comm - Favorable Recommendation",3,1,0,4,8
1964941,1511245,2025-03-05,Senate,"Senate/ passed 2nd & 3rd readings/ suspension",27,0,0,2,29
1964941,1511246,2025-03-07,Senate,"Senate Conference Committee - Final Passage",23,0,0,6,29
1964941,1511247,2025-03-07,House,"House Conference Committee - Final Passage",72,0,0,3,75
1964973,1514268,2025-02-20,House,"House Comm - Favorable Recommendation",10,0,0,3,13
1964973,1514269,2025-02-26,House,"House/ passed 3rd reading",70,0,0,5,75
1964973,1514270,2025-03-04,Senate,"Senate Comm - Favorable Recommendation",4,0,0,3,7
1964973,1514271,2025-03-07,Senate,"Senate/ passed 2nd & 3rd readings/ suspension",29,0,0,0,29
1965006,1515134,2025-02-25,House,"House Comm - Favorable Recommendation",9,1,0,6,16
1965006,1515135,2025-02-28,House,"House/ passed 3rd reading",49,19,0,7,75
1965006,1515136,2025-03-04,Senate,"Senate Comm - Favorable Recommendation",3,2,0,4,9
1965006,1515137,2025-03-07,Senate,"Senate/ passed 2nd & 3rd readings/ suspension",17,7,0,5,29
1965040,1512600,2025-02-14,Senate,"Senate Comm - Favorable Recommendation",5,0,0,2,7
1965040,1512601,2025-02-21,Senate,"Senate/ passed 2nd reading",23,0,0,6,29
1965040,1512602,2025-02-24,Senate,"Senate/ passed 3rd reading",23,0,0,6,29
1965040,1512603,2025-02-28,House,"House Comm - Favorable Recommendation",9,0,0,2,11
1965040,1512604,2025-03-07,House,"House/ passed 3rd reading",72,0,0,3,75
1965123,1511630,2025-02-19,House,"House Comm - Amendment Recommendation",9,0,0,7,16
1965123,1511631,2025-02-19,House,"House Comm - Favorable Recommendation",8,1,0,7,16
1965123,1511632,2025-02-25,House,"House/ passed 3rd reading",50,14,0,11,75
1965123,1511633,2025-03-03,Senate,"Senate Comm - Amendment Recommendation",5,0,0,1,6
1965123,1511634,2025-03-03,Senate,"Senate Comm - Favorable Recommendation",4,1,0,1,6
1965123,1511635,2025-03-07,Senate,"Senate/ passed 2nd & 3rd readings/ suspension",25,0,0,4,29
1965123,1511636,2025-03-07,House,"House/ concurs with Senate amendment",50,15,0,10,75
1965165,1514647,2025-02-25,Senate,"Senate Comm - Favorable Recommendation",5,0,0,3,8
1965165,1514648,2025-02-25,Senate,"Senate/ passed 2nd reading",24,0,0,5,29
1965165,1514649,2025-02-26,Senate,"Senate/ passed 3rd reading",23,0,0,6,29
1965165,1514650,2025-03-04,House,"House Comm - Favorable Recommendation",7,1,0,2,10
1965165,1514651,2025-03-07,House,"House/ passed 3rd reading",67,6,0,2,75
1965207,1511136,2025-02-14,Senate,"Senate Comm - Favorable Recommendation",4,0,0,3,7
1965207,1511137,2025-02-21,Senate,"Senate/ passed 2nd reading",23,0,0,6,29
1965207,1511138,2025-02-24,Senate,"Senate/ passed 3rd reading",25,0,0,4,29
1965207,1511139,2025-02-27,House,"House Comm - Favorable Recommendation",8,0,0,2,10
1965207,1511140,2025-03-04,House,"House/ passed 3rd reading",68,0,0,7,75
1965250,1515146,2025-02-24,House,"House Comm - Substitute Recommendation",11,0,0,3,14
1965250,1515147,2025-02-24,House,"House Comm - Favorable Recommendation",11,0,0,3,14
1965250,1515148,2025-02-27,House,"House/ passed 3rd reading",70,0,0,5,75
1965250,1515149,2025-03-03,Senate,"Senate Comm - Favorable Recommendation",6,0,0,1,7
1965250,1515150,2025-03-07,Senate,"Senate/ passed 2nd & 3rd readings/ suspension",24,3,0,2,29
1965250,1515151,2025-03-07,House,"House/ concurs with Senate amendment",69,1,0,5,75
1965291,1511648,2025-02-19,House,"House Comm - Amendment Recommendation",8,0,0,8,16
1965291,1511649,2025-02-19,House,"House Comm - Favorable Recommendation",9,0,0,7,16
1965291,1511650,2025-02-25,House,"House/ passed 3rd reading",53,15,0,7,75
1965291,1511651,2025-02-28,Senate,"Senate Comm - Favorable Recommendation",5,1,0,3,9
1965291,1511652,2025-03-07,Senate,"Senate/ passed 2nd & 3rd readings/ suspension",23,2,0,4,29
1965333,1511616,2025-02-25,House,"House Comm - Substitute Recommendation",11,0,0,3,14
1965333,1511617,2025-02-25,House,"House Comm - Favorable Recommendation",11,0,0,3,14
1965333,1511618,2025-02-25,House,"House Comm - Consent Calendar Recommendation",11,0,0,3,14
1965333,1511619,2025-02-28,House,"House/ passed 3rd reading",64,0,0,11,75
1965333,1511620,2025-03-03,Senate,"Senate Comm - Favorable Recommendation",5,0,0,2,7
1965333,1511621,2025-03-07,Senate,"Senate/ passed 2nd & 3rd readings/ suspension",24,0,0,5,29
1965374,1514605,2025-02-20,House,"House Comm - Favorable Recommendation",11,0,0,2,13
1965374,1514606,2025-02-26,House,"House/ passed 3rd reading",70,0,0,5,75
1965374,1514607,2025-03-04,Senate,"Senate Comm - Favorable Recommendation",5,0,0,2,7
1965374,1514608,2025-03-07,Senate,"Senate/ passed 2nd & 3rd readings/ suspension",28,0,0,1,29
1965749,1512578,2025-02-18,Senate,"Senate Comm - Favorable Recommendation",3,1,0,2,6
1965749,1512579,2025-02-28,Senate,"Senate/ passed 2nd reading",25,2,0,2,29
1965749,1512580,2025-03-03,Senate,"Senate/ passed 3rd reading",26,1,0,2,29
1965749,1512581,2025-03-04,House,"House Comm - Amendment Recommendation",10,0,0,2,12
1965749,1512582,2025-03-04,House,"House Comm - Favorable Recommendation",8,2,0,2,12
1965749,1512583,2025-03-05,House,"House/ passed 3rd reading",45,22,0,8,75
1965749,1512584,2025-03-06,Senate,"Senate/ concurs with House amendment",24,0,0,5,29
1967013,1514133,2025-02-18,Senate,"Senate Comm - Favorable Recommendation",4,2,0,3,9
1967013,1514134,2025-02-21,Senate,"Senate/ passed 2nd reading",21,2,0,6,29
1967013,1514135,2025-02-24,Senate,"Senate/ passed 3rd reading",21,2,0,6,29
1967013,1514136,2025-02-28,House,"House Comm - Favorable Recommendation",12,0,0,4,16
1967013,1514137,2025-03-07,House,"House/ passed 3rd reading",59,7,0,9,75
1967049,1513301,2025-02-20,Senate,"Senate Comm - Favorable Recommendation",4,0,0,3,7
1967049,1513302,2025-02-24,Senate,"Senate/ passed 2nd reading",23,0,0,6,29
1967049,1513303,2025-02-25,Senate,"Senate/ passed 3rd reading",25,0,0,4,29
1967049,1513304,2025-03-06,House,"House/ passed 3rd reading",69,0,0,6,75
1967120,1513341,2025-02-20,Senate,"Senate Comm - Favorable Recommendation",5,0,0,2,7
1967120,1513342,2025-02-24,Senate,"Senate/ passed 2nd reading",24,0,0,5,29
1967120,1513343,2025-02-25,Senate,"Senate/ passed 3rd reading",23,0,0,6,29
1967120,1513344,2025-02-28,House,"House Comm - Motion to Recommend Failed",4,5,0,7,16
1967193,1512530,2025-02-18,Senate,"Senate Comm - Favorable Recommendation",6,0,0,2,8
1967193,1512531,2025-02-21,Senate,"Senate/ passed 2nd reading",21,6,0,2,29
1967193,1512532,2025-02-24,Senate,"Senate/ passed 3rd reading",21,2,0,6,29
1967193,1512533,2025-02-28,House,"House Comm - Favorable Recommendation",8,0,0,5,13
1967193,1512534,2025-02-28,House,"House Comm - Consent Calendar Recommendation",8,0,0,5,13
1967193,1512535,2025-03-03,House,"House/ passed 3rd reading",68,0,0,7,75
1967231,1513211,2025-02-18,Senate,"Senate Comm - Amendment Recommendation",5,0,0,2,7
1967231,1513212,2025-02-18,Senate,"Senate Comm - Favorable Recommendation",5,0,0,2,7
1967231,1513213,2025-02-21,Senate,"Senate/ passed 2nd reading",22,4,0,3,29
1967231,1513214,2025-02-24,Senate,"Senate/ passed 3rd reading",22,1,0,6,29
1967231,1513215,2025-03-03,House,"House Comm - Favorable Recommendation",11,1,0,1,13
1967231,1513216,2025-03-07,House,"House/ passed 3rd reading",55,10,0,10,75
1967306,1514699,2025-02-14,Senate,"Senate Comm - Favorable Recommendation",3,1,0,3,7
1967343,1514473,2025-02-25,House,"House Comm - Substitute Recommendation",10,0,0,6,16
1967343,1514474,2025-02-25,House,"House Comm - Amendment Recommendation",10,0,0,6,16
1967343,1514475,2025-02-25,House,"House Comm - Favorable Recommendation",7,3,0,6,16
1967343,1514476,2025-02-27,House,"House/ passed 3rd reading",42,29,0,4,75
1967343,1514477,2025-03-04,Senate,"Senate Comm - Favorable Recommendation",6,0,0,2,8
1967381,1514711,2025-02-24,House,"House Comm - Favorable Recommendation",9,0,0,5,14
1967381,1514712,2025-02-27,House,"House/ passed 3rd reading",69,0,0,6,75
1967381,1514713,2025-03-04,Senate,"Senate Comm - Favorable Recommendation",5,0,0,2,7
1967381,1514714,2025-03-06,Senate,"Senate/ passed 2nd & 3rd readings/ suspension",26,0,0,3,29
1967418,1511296,2025-02-20,House,"House Comm - Favorable Recommendation",11,0,0,0,11
1967418,1511297,2025-02-27,House,"House/ passed 3rd reading",66,2,0,7,75
1967418,1511298,2025-03-04,Senate,"Senate Comm - Favorable Recommendation",5,0,0,2,7
1967455,1511273,2025-02-20,House,"House Comm - Favorable Recommendation",10,0,0,3,13
1967455,1511274,2025-02-20,House,"House Comm - Consent Calendar Recommendation",10,0,0,3,13
1967455,1511275,2025-02-24,House,"House/ passed 3rd reading",68,0,0,7,75
1967455,1511276,2025-02-28,Senate,"Senate Comm - Substitute Recommendation",6,0,0,2,8
1967455,1511277,2025-02-28,Senate,"Senate Comm - Favorable Recommendation",6,0,0,2,8
1967491,1511639,2025-02-21,House,"House Comm - Favorable Recommendation",13,0,0,3,16
1967491,1511640,2025-02-27,House,"House/ passed 3rd reading",63,1,0,11,75
1967491,1511641,2025-03-03,Senate,"Senate Comm - Favorable Recommendation",4,0,0,3,7
1967491,1511642,2025-03-05,Senate,"Senate/ passed 2nd & 3rd readings/ suspension",27,0,0,2,29
1967491,1511643,2025-03-06,Senate,"Senate/ passed 2nd & 3rd readings/ suspension",25,0,0,4,29
1967491,1511644,2025-03-06,House,"House/ concurs with Senate amendment",70,1,0,4,75
1967527,1514401,2025-02-19,House,"House Comm - Amendment Recommendation",10,0,0,3,13
1967527,1514402,2025-02-19,House,"House Comm - Favorable Recommendation",9,1,0,3,13
1967527,1514403,2025-02-21,House,"House/ passed 3rd reading",63,4,0,8,75
1967527,1514404,2025-03-03,Senate,"Senate Comm - Substitute Recommendation",4,1,0,2,7
1967527,1514405,2025-03-03,Senate,"Senate Comm - Favorable Recommendation",4,1,0,2,7
1967527,1514406,2025-03-04,Senate,"Senate/ passed 2nd & 3rd readings/ suspension",22,4,0,3,29
1967527,1514407,2025-03-05,Senate,"Senate Conference Committee - Final Passage",19,4,0,6,29
1967527,1514408,2025-03-06,House,"House Conference Committee - Final Passage",67,0,0,8,75
1967563,1513146,2025-02-18,Senate,"Senate Comm - Favorable Recommendation",4,0,0,3,7
1967563,1513147,2025-02-18,Senate,"Senate Comm - Consent Calendar Recommendation",4,0,0,3,7
1967563,1513148,2025-02-24,Senate,"Senate/ passed 3rd reading",25,0,0,4,29
1967563,1513149,2025-02-28,House,"House Comm - Favorable Recommendation",6,0,0,7,13
1967563,1513150,2025-03-05,House,"House/ passed 3rd reading",39,32,0,4,75
1967563,1513151,2025-03-06,Senate,"Senate/ concurs with House amendment",18,4,0,7,29
1967694,1514237,2025-02-28,House,"House Comm - Favorable Recommendation",11,0,0,3,14
1967694,1514238,2025-03-03,House,"House/ passed 3rd reading",73,1,0,1,75
1967946,1512870,2025-02-25,House,"House Comm - Favorable Recommendation",8,0,0,6,14
1967946,1512871,2025-02-28,House,"House/ passed 3rd reading",63,0,0,12,75
1967946,1512872,2025-03-04,Senate,"Senate Comm - Favorable Recommendation",4,0,0,5,9
1967946,1512873,2025-03-06,Senate,"Senate/ passed 2nd & 3rd readings/ suspension",23,0,0,6,29
1968071,1511441,2025-02-25,House,"House Comm - Amendment Recommendation",12,0,0,4,16
1968071,1511442,2025-02-25,House,"House Comm - Favorable Recommendation",12,0,0,4,16
1968071,1511443,2025-02-25,House,"House Comm - Consent Calendar Recommendation",12,0,0,4,16
1968071,1511444,2025-02-28,House,"House/ passed 3rd reading",66,0,0,9,75
1968071,1511445,2025-03-03,Senate,"Senate Comm - Favorable Recommendation",5,0,0,2,7
1968071,1511446,2025-03-03,Senate,"Senate Comm - Consent Calendar Recommendation",5,0,0,2,7
1968071,1511447,2025-03-07,Senate,"Senate/ passed 3rd reading",21,0,0,8,29
1968353,1511397,2025-02-19,Senate,"Senate Comm - Favorable Recommendation",4,0,0,5,9
1968353,1511398,2025-02-25,Senate,"Senate/ passed 2nd reading",24,0,0,5,29
1968353,1511399,2025-02-27,Senate,"Senate/ passed 3rd reading",25,0,0,4,29
1968353,1511400,2025-03-04,House,"House Comm - Favorable Recommendation",7,0,0,3,10
1968353,1511401,2025-03-07,House,"House/ passed 3rd reading",70,0,0,5,75
1968434,1514239,2025-02-25,House,"House/ passed 3rd reading",70,0,0,5,75
1968434,1514240,2025-02-27,Senate,"Senate/ passed 2nd reading",25,0,0,4,29
1968434,1514241,2025-02-28,Senate,"Senate/ passed 3rd reading",25,0,0,4,29
1968481,1512673,2025-02-20,Senate,"Senate Comm - Favorable Recommendation",5,1,0,1,7
1968481,1512674,2025-02-25,Senate,"Senate/ passed 2nd reading",18,5,0,6,29
1968481,1512675,2025-02-26,Senate,"Senate/ passed 3rd reading",21,6,0,2,29
1968481,1512676,2025-03-04,House,"House Comm - Favorable Recommendation",10,1,0,5,16
1968481,1512677,2025-03-07,House,"House/ passed 3rd reading",58,11,0,6,75
1968521,1512848,2025-02-19,House,"House Comm - Favorable Recommendation",9,0,0,5,14
1968521,1512849,2025-02-25,House,"House/ passed 3rd reading",63,0,0,12,75
1968521,1512850,2025-03-03,Senate,"Senate Comm - Favorable Recommendation",4,0,0,3,7
1968563,1512793,2025-02-24,House,"House Comm - Substitute Recommendation",12,0,0,2,14
1968563,1512794,2025-02-24,House,"House Comm - Favorable Recommendation",11,1,0,2,14
1968563,1512795,2025-02-27,House,"House/ passed 3rd reading",56,13,0,6,75
1968563,1512796,2025-03-04,Senate,"Senate Comm - Favorable Recommendation",5,1,0,1,7
1968605,1511269,2025-02-19,Senate,"Senate Comm - Favorable Recommendation",6,0,0,1,7
1968605,1511270,2025-02-24,Senate,"Senate/ passed 2nd reading",23,0,0,6,29
1968605,1511271,2025-02-25,Senate,"Senate/ passed 3rd reading",23,0,0,6,29
1968605,1511272,2025-02-28,House,"House Comm - Favorable Recommendation",10,0,0,4,14
1968648,1513279,2025-02-19,Senate,"Senate Comm - Favorable Recommendation",5,0,0,2,7
1968648,1513280,2025-02-24,Senate,"Senate/ passed 2nd reading",21,0,0,8,29
1968648,1513281,2025-02-25,Senate,"Senate/ passed 3rd reading",22,0,0,7,29
1968648,1513282,2025-03-03,House,"House Comm - Favorable Recommendation",9,0,0,5,14
1968648,1513283,2025-03-07,House,"House/ passed 3rd reading",52,16,0,7,75
1968690,1513550,2025-02-25,House,"House Comm - Substitute Recommendation",8,0,0,8,16
1968690,1513551,2025-02-25,House,"House Comm - Amendment Recommendation",8,0,0,8,16
1968690,1513552,2025-02-25,House,"House Comm - Favorable Recommendation",8,0,0,8,16
1968690,1513553,2025-02-28,House,"House/ passed 3rd reading",73,0,0,2,75
1968690,1513554,2025-03-07,Senate,"Senate/ passed 2nd & 3rd readings/ suspension",16,11,0,2,29
1968690,1513555,2025-03-07,House,"House/ concurs with Senate amendment",60,11,0,4,75
1968735,1511141,2025-02-27,House,"House Comm - Substitute Recommendation",7,0,0,4,11
1968735,1511142,2025-02-27,House,"House Comm - Amendment Recommendation",7,0,0,4,11
1968735,1511143,2025-02-27,House,"House Comm - Favorable Recommendation",7,0,0,4,11
1968735,1511144,2025-03-03,House,"House/ passed 3rd reading",71,0,0,4,75
1968735,1511145,2025-03-05,Senate,"Senate/ passed 2nd & 3rd readings/ suspension",24,0,0,5,29
1968823,1511146,2025-02-19,Senate,"Senate Comm - Favorable Recommendation",4,1,0,3,8
1968823,1511147,2025-02-21,Senate,"Senate/ passed 2nd reading",28,0,0,1,29
1968823,1511148,2025-02-28,Senate,"Senate/ passed 3rd reading",26,0,0,3,29
1968823,1511149,2025-03-04,House,"House Comm - Favorable Recommendation",10,0,0,4,14
1968823,1511150,2025-03-05,House,"House/ passed 3rd reading",70,5,0,0,75
1968823,1511151,2025-03-05,Senate,"Senate/ concurs with House amendment",28,0,0,1,29
1969147,1514594,2025-02-18,House,"House Comm - Favorable Recommendation",11,0,0,1,12
1969147,1514595,2025-02-25,House,"House/ passed 3rd reading",64,0,0,11,75
1969147,1514596,2025-03-04,Senate,"Senate Comm - Substitute Recommendation",6,0,0,1,7
1969147,1514597,2025-03-04,Senate,"Senate Comm - Amendment Recommendation",6,0,0,1,7
1969147,1514598,2025-03-04,Senate,"Senate Comm - Favorable Recommendation",6,0,0,1,7
1969147,1514599,2025-03-07,Senate,"Senate/ passed 2nd & 3rd readings/ suspension",24,0,0,5,29
1969147,1514600,2025-03-07,House,"House/ concurs with Senate amendment",68,0,0,7,75
1969430,1514318,2025-02-18,Senate,"Senate Comm - Substitute Recommendation",5,0,0,2,7
1969430,1514319,2025-02-18,Senate,"Senate Comm - Favorable Recommendation",4,2,0,1,7
1969430,1514320,2025-02-26,Senate,"Senate/ passed 2nd reading",18,7,0,4,29
1969430,1514321,2025-02-27,Senate,"Senate/ passed 3rd reading",21,8,0,0,29
1969430,1514322,2025-03-03,House,"House Comm - Substitute Recommendation",11,0,0,2,13
1969430,1514323,2025-03-03,House,"House Comm - Favorable Recommendation",9,2,0,2,13
1969430,1514324,2025-03-05,House,"House/ passed 3rd reading",44,23,0,8,75
1969430,1514325,2025-03-06,Senate,"Senate/ concurs with House amendment",18,6,0,5,29
1969722,1511152,2025-02-19,Senate,"Senate Comm - Favorable Recommendation",6,0,0,1,7
1969722,1511153,2025-02-25,Senate,"Senate/ passed 2nd reading",25,0,0,4,29
1969722,1511154,2025-02-27,Senate,"Senate/ passed 3rd reading",26,0,0,3,29
1969722,1511155,2025-03-05,House,"House/ passed 3rd reading",70,0,0,5,75
1970015,1512264,2025-02-25,House,"House Comm - Favorable Recommendation",10,4,0,2,16
1970015,1512265,2025-02-28,House,"House/ passed 3rd reading",41,25,0,9,75
1970015,1512266,2025-03-04,Senate,"Senate Comm - Substitute Recommendation",5,0,0,1,6
1970015,1512267,2025-03-04,Senate,"Senate Comm - Favorable Recommendation",6,0,0,0,6
1970015,1512268,2025-03-05,Senate,"Senate/ passed 2nd & 3rd readings/ suspension",17,11,0,1,29
1970015,1512269,2025-03-05,House,"House/ concurs with Senate amendment",47,27,0,1,75
1970114,1512188,2025-02-20,Senate,"Senate Comm - Favorable Recommendation",4,0,0,3,7
1970114,1512189,2025-02-24,Senate,"Senate/ passed 2nd reading",23,0,0,6,29
1970114,1512190,2025-02-25,Senate,"Senate/ passed 3rd reading",23,1,0,5,29
1970114,1512191,2025-03-04,House,"House Comm - Favorable Recommendation",10,1,0,5,16
1970114,1512192,2025-03-07,House,"House/ passed 3rd reading",62,5,0,8,75
1970214,1513818,2025-02-18,Senate,"Senate Comm - Favorable Recommendation",4,0,0,2,6
1970214,1513819,2025-02-21,Senate,"Senate/ passed 2nd reading",26,0,0,3,29
1970214,1513820,2025-02-24,Senate,"Senate/ passed 3rd reading",26,0,0,3,29
1970214,1513821,2025-02-28,House,"House Comm - Favorable Recommendation",4,1,0,5,10
1970214,1513822,2025-03-07,House,"House/ passed 3rd reading",68,0,0,7,75
1970310,1513449,2025-02-26,House,"House Comm - Favorable Recommendation",8,0,0,5,13
1970310,1513450,2025-02-28,House,"House/ passed 3rd reading",65,0,0,10,75
1970310,1513451,2025-03-04,Senate,"Senate Comm - Favorable Recommendation",7,0,0,0,7
1970310,1513452,2025-03-06,Senate,"Senate/ passed 2nd & 3rd readings/ suspension",26,2,0,1,29
1970310,1513453,2025-03-07,House,"House/ concurs with Senate amendment",71,0,0,4,75
1970585,1512809,2025-02-26,House,"House Comm - Amendment Recommendation",10,0,0,4,14
1970585,1512810,2025-02-26,House,"House Comm - Favorable Recommendation",10,0,0,4,14
1970585,1512811,2025-02-28,House,"House/ passed 3rd reading",65,1,0,9,75
1970585,1512812,2025-03-04,Senate,"Senate Comm - Favorable Recommendation",5,0,0,2,7
1970638,1515009,2025-02-20,Senate,"Senate Comm - Favorable Recommendation",6,0,0,1,7
1970638,1515010,2025-02-24,Senate,"Senate/ passed 2nd reading",26,0,0,3,29
1970638,1515011,2025-02-25,Senate,"Senate/ passed 3rd reading",24,1,0,4,29
1970638,1515012,2025-02-28,House,"House Comm - Favorable Recommendation",9,0,0,7,16
1970638,1515013,2025-03-07,House,"House/ passed 3rd reading",70,0,0,5,75
1970690,1513654,2025-02-25,House,"House Comm - Favorable Recommendation",10,0,0,6,16
1970690,1513655,2025-02-28,House,"House/ passed 3rd reading",70,0,0,5,75
1970690,1513656,2025-03-04,Senate,"Senate Comm - Substitute Recommendation",4,0,0,2,6
1970690,1513657,2025-03-04,Senate,"Senate Comm - Favorable Recommendation",3,1,0,2,6
1970690,1513658,2025-03-06,Senate,"Senate/ passed 2nd & 3rd readings/ suspension",20,6,0,3,29
1970690,1513659,2025-03-07,House,"House/ concurs with Senate amendment",62,8,0,5,75
1970744,1511321,2025-02-25,House,"House Comm - Substitute Recommendation",12,0,0,2,14
1970744,1511322,2025-02-25,House,"House Comm - Amendment Recommendation",12,0,0,2,14
1970744,1511323,2025-02-25,House,"House Comm - Favorable Recommendation",13,0,0,1,14
1970744,1511324,2025-02-28,House,"House/ passed 3rd reading",66,0,0,9,75
1970744,1511325,2025-03-03,Senate,"Senate Comm - Substitute Recommendation",4,0,0,3,7
1970744,1511326,2025-03-03,Senate,"Senate Comm - Motion to Recommend Failed",2,2,0,3,7
1970796,1513187,2025-02-25,House,"House Comm - Substitute Recommendation",11,0,0,3,14
1970796,1513188,2025-02-25,House,"House Comm - Favorable Recommendation",11,0,0,3,14
1970796,1513189,2025-02-28,House,"House/ passed 3rd reading",68,0,0,7,75
1970796,1513190,2025-03-03,Senate,"Senate Comm - Favorable Recommendation",5,0,0,2,7
1970796,1513191,2025-03-03,Senate,"Senate Comm - Consent Calendar Recommendation",6,0,0,1,7
1970796,1513192,2025-03-07,Senate,"Senate/ passed 3rd reading",22,0,0,7,29
1970852,1513152,2025-02-20,House,"House Comm - Favorable Recommendation",11,0,0,0,11
1970852,1513153,2025-02-20,House,"House Comm - Consent Calendar Recommendation",11,0,0,0,11
1970852,1513154,2025-02-24,House,"House/ passed 3rd reading",64,0,0,11,75
1970852,1513155,2025-03-03,Senate,"Senate Comm - Favorable Recommendation",6,0,0,1,7
1970957,1512880,2025-02-19,Senate,"Senate Comm - Favorable Recommendation",4,1,0,4,9
1970957,1512881,2025-02-27,Senate,"Senate/ passed 2nd reading",18,8,0,3,29
1970957,1512882,2025-02-28,Senate,"Senate/ passed 3rd reading",21,7,0,1,29
1970957,1512883,2025-03-04,House,"House Comm - Favorable Recommendation",9,2,0,1,12
1970957,1512884,2025-03-07,House,"House/ passed 3rd reading",47,19,0,9,75
1970957,1512885,2025-03-07,House,"House/ passed 3rd reading",52,21,0,2,75
1971279,1511156,2025-02-24,House,"House Comm - Amendment Recommendation",10,0,0,4,14
1971279,1511157,2025-02-24,House,"House Comm - Favorable Recommendation",10,0,0,4,14
1971279,1511158,2025-02-27,House,"House/ passed 3rd reading",70,1,0,4,75
1971279,1511159,2025-03-04,Senate,"Senate Comm - Favorable Recommendation",4,0,0,3,7
1971279,1511160,2025-03-05,Senate,"Senate/ passed 2nd & 3rd readings/ suspension",22,0,0,7,29
1971544,1513869,2025-02-20,Senate,"Senate Comm - Favorable Recommendation",5,0,0,2,7
1971544,1513870,2025-02-24,Senate,"Senate/ passed 2nd reading",24,0,0,5,29
1971544,1513871,2025-02-25,Senate,"Senate/ passed 3rd reading",24,0,0,5,29
1971544,1513872,2025-03-03,House,"House Comm - Favorable Recommendation",12,0,0,1,13
1971544,1513873,2025-03-06,House,"House/ passed 3rd reading",71,0,0,4,75
1971545,1514359,2025-02-25,House,"House Comm - Held",9,0,0,2,11
1971601,1513841,2025-02-19,Senate,"Senate Comm - Favorable Recommendation",6,0,0,3,9
1971601,1513842,2025-02-19,Senate,"Senate Comm - Consent Calendar Recommendation",6,0,0,3,9
1971601,1513843,2025-02-25,Senate,"Senate/ passed 3rd reading",24,0,0,5,29
1971601,1513844,2025-03-07,House,"House/ passed 3rd reading",71,0,0,4,75
1971966,1514522,2025-02-24,Senate,"Senate Comm - Favorable Recommendation",6,1,0,0,7
1971966,1514523,2025-02-25,Senate,"Senate/ passed 2nd reading",23,0,0,6,29
1971966,1514524,2025-02-26,Senate,"Senate/ passed 3rd reading",25,0,0,4,29
1971966,1514525,2025-03-03,House,"House Comm - Favorable Recommendation",7,0,0,3,10
1972084,1511161,2025-02-20,Senate,"Senate Comm - Favorable Recommendation",4,0,0,3,7
1972084,1511162,2025-02-24,Senate,"Senate/ passed 2nd reading",22,0,0,7,29
1972084,1511163,2025-02-25,Senate,"Senate/ passed 3rd reading",25,0,0,4,29
1972084,1511164,2025-03-05,House,"House/ passed 3rd reading",55,16,0,4,75
1972115,1514431,2025-02-24,Senate,"Senate Comm - Substitute Recommendation",4,0,0,3,7
1972115,1514432,2025-02-24,Senate,"Senate Comm - Favorable Recommendation",4,0,0,3,7
1972115,1514433,2025-02-25,Senate,"Senate/ passed 2nd reading",24,0,0,5,29
1972115,1514434,2025-02-26,Senate,"Senate/ passed 3rd reading",24,0,0,5,29
1972115,1514435,2025-03-03,House,"House Comm - Favorable Recommendation",11,0,0,2,13
1972115,1514436,2025-03-07,House,"House/ passed 3rd reading",70,0,0,5,75
1972115,1514437,2025-03-07,House,"House/ passed 3rd reading",73,1,0,1,75
1972115,1514438,2025-03-07,Senate,"Senate/ concurs with House amendment",25,0,0,4,29
1972171,1512241,2025-02-24,House,"House Comm - Favorable Recommendation",9,0,0,3,12
1972171,1512242,2025-02-27,House,"House/ passed 3rd reading",74,0,0,1,75
1972171,1512243,2025-03-05,Senate,"Senate/ passed 2nd & 3rd readings/ suspension",28,0,0,1,29
1972171,1512244,2025-03-06,House,"House/ concurs with Senate amendment",72,0,0,3,75
1972226,1511165,2025-02-25,Senate,"Senate Comm - Favorable Recommendation",6,0,0,3,9
1972226,1511166,2025-02-27,Senate,"Senate/ passed 2nd reading",24,0,0,5,29
1972226,1511167,2025-02-28,Senate,"Senate/ passed 3rd reading",20,0,0,9,29
1972226,1511168,2025-03-03,House,"House Comm - Favorable Recommendation",9,0,0,2,11
1972226,1511169,2025-03-03,House,"House Comm - Consent Calendar Recommendation",9,0,0,2,11
1972226,1511170,2025-03-05,House,"House/ passed 3rd reading",68,0,0,7,75
1972256,1512862,2025-02-20,Senate,"Senate Comm - Favorable Recommendation",5,0,0,3,8
1972256,1512863,2025-02-25,Senate,"Senate/ passed 2nd reading",27,0,0,2,29
1972256,1512864,2025-02-28,Senate,"Senate/ passed 3rd reading",23,2,0,4,29
1972283,1515196,2025-02-26,Senate,"Senate Comm - Favorable Recommendation",7,0,0,1,8
1972283,1515197,2025-02-28,Senate,"Senate/ passed 2nd reading",22,0,0,7,29
1972283,1515198,2025-03-03,Senate,"Senate/ passed 3rd reading",25,0,0,4,29
1972283,1515199,2025-03-04,House,"House Comm - Favorable Recommendation",10,0,0,2,12
1972283,1515200,2025-03-07,House,"House/ passed 3rd reading",66,0,0,9,75
1972283,1515201,2025-03-07,Senate,"Senate/ concurs with House amendment",27,0,0,2,29
1972312,1511236,2025-02-25,House,"House Comm - Favorable Recommendation",7,3,0,3,13
1972312,1511237,2025-02-27,House,"House/ passed 3rd reading",72,2,0,1,75
1972312,1511238,2025-03-04,Senate,"Senate Comm - Substitute Recommendation",5,0,0,2,7
1972312,1511239,2025-03-04,Senate,"Senate Comm - Motion to Recommend Failed",1,4,0,2,7
1972342,1515084,2025-03-03,Senate,"Senate Comm - Substitute Recommendation",5,0,0,2,7
1972342,1515085,2025-03-03,Senate,"Senate Comm - Favorable Recommendation",5,0,0,2,7
1972342,1515086,2025-03-04,Senate,"Senate/ passed 2nd & 3rd readings/ suspension",18,1,0,10,29
1972371,1512650,2025-02-24,Senate,"Senate Comm - Substitute Recommendation",3,0,0,4,7
1972371,1512651,2025-02-24,Senate,"Senate Comm - Favorable Recommendation",3,0,0,4,7
1972371,1512652,2025-02-25,Senate,"Senate/ passed 2nd reading",25,2,0,2,29
1972371,1512653,2025-02-26,Senate,"Senate/ passed 3rd reading",24,0,0,5,29
1972371,1512654,2025-03-04,House,"House Comm - Amendment Recommendation",13,0,0,3,16
1972371,1512655,2025-03-04,House,"House Comm - Favorable Recommendation",13,0,0,3,16
1972400,1512544,2025-02-25,House,"House Comm - Favorable Recommendation",12,0,0,1,13
1972400,1512545,2025-02-25,House,"House Comm - Consent Calendar Recommendation",12,0,0,1,13
1972400,1512546,2025-02-27,House,"House/ passed 3rd reading",67,0,0,8,75
1972400,1512547,2025-03-04,Senate,"Senate Comm - Favorable Recommendation",6,0,0,2,8
1972400,1512548,2025-03-07,Senate,"Senate/ passed 2nd & 3rd readings/ suspension",22,2,0,5,29
1972460,1514213,2025-02-24,House,"House Comm - Favorable Recommendation",7,2,0,2,11
1972488,1513073,2025-02-24,Senate,"Senate Comm - Substitute Recommendation",4,0,0,2,6
1972488,1513074,2025-02-24,Senate,"Senate Comm - Favorable Recommendation",4,0,0,2,6
1972488,1513075,2025-02-24,Senate,"Senate Comm - Consent Calendar Recommendation",4,0,0,2,6
1972488,1513076,2025-02-27,Senate,"Senate/ passed 3rd reading",25,0,0,4,29
1972488,1513077,2025-03-04,House,"House Comm - Favorable Recommendation",6,0,0,4,10
1972488,1513078,2025-03-07,House,"House/ passed 3rd reading",63,0,0,12,75
1972547,1513643,2025-02-25,Senate,"Senate Comm - Substitute Recommendation",7,0,0,2,9
1972547,1513644,2025-02-25,Senate,"Senate Comm - Favorable Recommendation",6,2,0,1,9
1972547,1513645,2025-03-03,Senate,"Senate/ passed 2nd reading",22,0,0,7,29
1972547,1513646,2025-03-04,Senate,"Senate/ passed 3rd reading",26,1,0,2,29
1972547,1513647,2025-03-07,House,"House/ passed 3rd reading",72,0,0,3,75
1972606,1512090,2025-02-21,House,"House Comm - Substitute Recommendation",14,0,0,2,16
1972606,1512091,2025-02-21,House,"House Comm - Favorable Recommendation",14,0,0,2,16
1972606,1512092,2025-02-27,House,"House/ passed 3rd reading",65,0,0,10,75
1972606,1512093,2025-03-03,Senate,"Senate Comm - Favorable Recommendation",5,1,0,2,8
1972606,1512094,2025-03-07,Senate,"Senate/ passed 2nd & 3rd readings/ suspension",26,0,0,3,29
1972608,1512204,2025-02-25,House,"House Comm - Favorable Recommendation",12,0,0,2,14
1972608,1512205,2025-02-28,House,"House/ passed 3rd reading",69,0,0,6,75
1972608,1512206,2025-03-04,House,"House/ passed 3rd reading",73,0,0,2,75
1973429,1512754,2025-02-20,Senate,"Senate Comm - Substitute Recommendation",4,0,0,3,7
1973429,1512755,2025-02-20,Senate,"Senate Comm - Favorable Recommendation",4,0,0,3,7
1973429,1512756,2025-02-24,Senate,"Senate/ passed 2nd reading",24,0,0,5,29
1973429,1512757,2025-02-25,Senate,"Senate/ passed 3rd reading",24,0,0,5,29
1973429,1512758,2025-03-03,House,"House Comm - Substitute Recommendation",10,0,0,1,11
1973429,1512759,2025-03-03,House,"House Comm - Favorable Recommendation",10,0,0,1,11
1973429,1512760,2025-03-07,House,"House/ passed 3rd reading",67,0,0,8,75
1973429,1512761,2025-03-07,Senate,"Senate/ concurs with House amendment",26,0,0,3,29
1973545,1513950,2025-02-26,House,"House Comm - Substitute Recommendation",11,0,0,3,14
1973545,1513951,2025-02-26,House,"House Comm - Favorable Recommendation",11,0,0,3,14
1973545,1513952,2025-03-03,House,"House/ passed 3rd reading",70,0,0,5,75
1973545,1513953,2025-03-06,Senate,"Senate/ passed 2nd & 3rd readings/ suspension",24,2,0,3,29
1973545,1513954,2025-03-06,House,"House/ concurs with Senate amendment",69,0,0,6,75
1974636,1512687,2025-02-25,Senate,"Senate Comm - Substitute Recommendation",5,0,0,4,9
1974636,1512688,2025-02-25,Senate,"Senate Comm - Favorable Recommendation",4,2,0,3,9
1974636,1512689,2025-02-27,Senate,"Senate/ passed 2nd reading",20,8,0,1,29
1974636,1512690,2025-02-28,Senate,"Senate/ passed 3rd reading",17,12,0,0,29
1974636,1512691,2025-03-03,House,"House Comm - Favorable Recommendation",7,2,0,2,11
1974636,1512692,2025-03-07,House,"House/ passed 3rd reading",40,29,0,6,75
1975040,1511278,2025-02-28,House,"House Comm - Substitute Recommendation",11,0,0,3,14
1975040,1511279,2025-02-28,House,"House Comm - Favorable Recommendation",11,0,0,3,14
1975040,1511280,2025-03-03,House,"House/ passed 3rd reading",71,1,0,3,75
1975308,1515162,2025-03-03,House,"House Comm - Substitute Recommendation",10,0,0,2,12
1975308,1515163,2025-03-03,House,"House Comm - Favorable Recommendation",6,4,0,2,12
1975329,1514085,2025-02-24,Senate,"Senate Comm - Favorable Recommendation",3,0,0,4,7
1975329,1514086,2025-02-25,Senate,"Senate/ passed 2nd reading",27,0,0,2,29
1975329,1514087,2025-02-27,Senate,"Senate/ passed 3rd reading",23,0,0,6,29
1975329,1514088,2025-03-03,House,"House Comm - Amendment Recommendation",6,2,0,3,11
1975329,1514089,2025-03-03,House,"House Comm - Favorable Recommendation",8,0,0,3,11
1975352,1513805,2025-02-25,Senate,"Senate Comm - Favorable Recommendation",4,1,0,2,7
1975352,1513806,2025-02-27,Senate,"Senate/ passed 2nd reading",20,5,0,4,29
1975352,1513807,2025-02-28,Senate,"Senate/ passed 3rd reading",24,1,0,4,29
1975352,1513808,2025-03-04,House,"House Comm - Favorable Recommendation",10,0,0,4,14
1975352,1513809,2025-03-07,House,"House/ passed 3rd reading",69,0,0,6,75
1975395,1514690,2025-02-27,House,"House Comm - Favorable Recommendation",7,0,0,4,11
1975395,1514691,2025-03-03,House,"House/ passed 3rd reading",67,0,0,8,75
1975462,1512563,2025-02-25,Senate,"Senate Comm - Favorable Recommendation",5,0,0,2,7
1975462,1512564,2025-02-25,Senate,"Senate/ passed 2nd reading",22,0,0,7,29
1975462,1512565,2025-02-26,Senate,"Senate/ passed 3rd reading",23,0,0,6,29
1975462,1512566,2025-03-03,House,"House Comm - Favorable Recommendation",8,1,0,4,13
1975462,1512567,2025-03-07,House,"House/ passed 3rd reading",51,13,0,11,75
1975482,1513595,2025-02-25,Senate,"Senate Comm - Favorable Recommendation",7,0,0,2,9
1975482,1513596,2025-02-27,Senate,"Senate/ passed 2nd reading",25,0,0,4,29
1975482,1513597,2025-02-28,Senate,"Senate/ passed 3rd reading",22,0,0,7,29
1975482,1513598,2025-03-04,House,"House Comm - Favorable Recommendation",8,0,0,3,11
1975504,1514676,2025-02-25,Senate,"Senate Comm - Favorable Recommendation",4,0,0,4,8
1975504,1514677,2025-02-25,Senate,"Senate/ passed 2nd reading",25,0,0,4,29
1975524,1515202,2025-02-24,Senate,"Senate Comm - Favorable Recommendation",3,0,0,4,7
1975524,1515203,2025-02-25,Senate,"Senate/ passed 2nd reading",24,1,0,4,29
1975524,1515204,2025-03-04,Senate,"Senate/ passed 3rd reading",22,7,0,0,29
1975545,1514097,2025-02-25,House,"House Comm - Substitute Recommendation",10,0,0,3,13
1975545,1514098,2025-02-25,House,"House Comm - Favorable Recommendation",8,1,0,4,13
1975545,1514099,2025-02-27,House,"House/ passed 3rd reading",69,3,0,3,75
1975545,1514100,2025-03-04,Senate,"Senate Comm - Amendment Recommendation",3,0,0,4,7
1975545,1514101,2025-03-04,Senate,"Senate Comm - Favorable Recommendation",4,0,0,3,7
1975567,1513766,2025-02-25,Senate,"Senate Comm - Favorable Recommendation",5,0,0,3,8
1975567,1513767,2025-02-25,Senate,"Senate/ passed 2nd reading",23,0,0,6,29
1975567,1513768,2025-02-26,Senate,"Senate/ passed 3rd reading",22,0,0,7,29
1975567,1513769,2025-03-04,House,"House Comm - Favorable Recommendation",6,0,0,5,11
1975567,1513770,2025-03-07,House,"House/ passed 3rd reading",67,0,0,8,75
1975588,1514214,2025-02-21,Senate,"Senate Comm - Substitute Recommendation",7,0,0,2,9
1975588,1514215,2025-02-21,Senate,"Senate Comm - Favorable Recommendation",8,0,0,1,9
1975588,1514216,2025-02-27,Senate,"Senate/ passed 2nd reading",24,3,0,2,29
1975588,1514217,2025-02-28,Senate,"Senate/ passed 3rd reading",19,6,0,4,29
1975588,1514218,2025-03-04,House,"House Comm - Substitute Recommendation",9,0,0,5,14
1975588,1514219,2025-03-04,House,"House Comm - Favorable Recommendation",10,0,0,4,14
1975588,1514220,2025-03-05,House,"House/ passed 3rd reading",53,19,0,3,75
1975588,1514221,2025-03-05,Senate,"Senate/ concurs with House amendment",27,1,0,1,29
1975609,1513957,2025-02-24,Senate,"Senate Comm - Favorable Recommendation",3,0,0,4,7
1975609,1513958,2025-02-25,Senate,"Senate/ passed 2nd reading",22,4,0,3,29
1975609,1513959,2025-02-26,Senate,"Senate/ passed 3rd reading",22,5,0,2,29
1975609,1513960,2025-03-03,House,"House Comm - Amendment Recommendation",7,0,0,3,10
1975609,1513961,2025-03-03,House,"House Comm - Favorable Recommendation",7,0,0,3,10
1975629,1512684,2025-02-25,House,"House Comm - Favorable Recommendation",11,0,0,3,14
1975629,1512685,2025-02-28,House,"House/ passed 3rd reading",64,0,0,11,75
1975650,1512956,2025-02-25,Senate,"Senate Comm - Amendment Recommendation",6,0,0,1,7
1975650,1512957,2025-02-25,Senate,"Senate Comm - Motion to Recommend Failed",3,3,0,1,7
1975853,1513891,2025-02-27,House,"House Comm - Favorable Recommendation",10,0,0,6,16
1975853,1513892,2025-02-27,House,"House Comm - Consent Calendar Recommendation",10,0,0,6,16
1975853,1513893,2025-03-03,House,"House/ passed 3rd reading",63,0,0,12,75
1976055,1511171,2025-02-25,House,"House Comm - Amendment Recommendation",7,0,0,3,10
1976055,1511172,2025-02-25,House,"House Comm - Favorable Recommendation",7,0,0,3,10
1976055,1511173,2025-02-27,House,"House/ passed 3rd reading",71,0,0,4,75
1976055,1511174,2025-03-03,Senate,"Senate Comm - Favorable Recommendation",5,0,0,1,6
1976055,1511175,2025-03-04,Senate,"Senate/ passed 2nd & 3rd readings/ suspension",26,0,0,3,29
1976255,1513289,2025-02-24,Senate,"Senate Comm - Favorable Recommendation",3,1,0,3,7
1976255,1513290,2025-02-25,Senate,"Senate/ passed 2nd reading",16,8,0,5,29
1976255,1513291,2025-03-04,Senate,"Senate/ passed 3rd reading",18,10,0,1,29
1976619,1514468,2025-02-25,Senate,"Senate Comm - Motion to Recommend Failed",2,2,0,3,7
1976789,1514584,2025-02-25,Senate,"Senate Comm - Favorable Recommendation",4,0,0,3,7
1976789,1514585,2025-02-25,Senate,"Senate/ passed 2nd reading",22,0,0,7,29
1976789,1514586,2025-02-26,Senate,"Senate/ passed 3rd reading",23,0,0,6,29
1976789,1514587,2025-03-04,House,"House Comm - Amendment Recommendation",11,0,0,5,16
1976789,1514588,2025-03-04,House,"House Comm - Favorable Recommendation",11,0,0,5,16
1976962,1514997,2025-02-26,Senate,"Senate Comm - Favorable Recommendation",3,1,0,3,7
1976962,1514998,2025-02-27,Senate,"Senate/ passed 2nd reading",23,4,0,2,29
1976962,1514999,2025-02-28,Senate,"Senate/ passed 3rd reading",21,2,0,6,29
1976962,1515000,2025-03-04,House,"House Comm - Favorable Recommendation",8,4,0,0,12
1977141,1514183,2025-02-24,Senate,"Senate Comm - Amendment Recommendation",4,0,0,3,7
1977141,1514184,2025-02-24,Senate,"Senate Comm - Favorable Recommendation",4,0,0,3,7
1977141,1514185,2025-02-25,Senate,"Senate/ passed 2nd reading",29,0,0,0,29
1977141,1514186,2025-02-26,Senate,"Senate/ passed 3rd reading",19,0,0,10,29
1977141,1514187,2025-03-03,House,"House Comm - Favorable Recommendation",7,0,0,3,10
1977141,1514188,2025-03-07,House,"House/ passed 3rd reading",71,1,0,3,75
1977199,1514961,2025-02-27,Senate,"Senate Comm - Substitute Recommendation",3,0,0,4,7
1977199,1514962,2025-02-27,Senate,"Senate Comm - Favorable Recommendation",3,1,0,3,7
1977199,1514963,2025-03-03,Senate,"Senate/ passed 2nd reading",23,0,0,6,29
1977199,1514964,2025-03-04,Senate,"Senate/ passed 3rd reading",17,8,0,4,29
1977309,1513370,2025-02-25,Senate,"Senate Comm - Favorable Recommendation",5,0,0,3,8
1977309,1513371,2025-02-25,Senate,"Senate/ passed 2nd reading",24,0,0,5,29
1977309,1513372,2025-02-26,Senate,"Senate/ passed 3rd reading",22,0,0,7,29
1977309,1513373,2025-03-04,House,"House Comm - Favorable Recommendation",13,0,0,3,16
1977367,1511827,2025-03-03,House,"House Comm - Substitute Recommendation",9,1,0,2,12
1977367,1511828,2025-03-03,House,"House Comm - Favorable Recommendation",10,0,0,2,12
1977367,1511829,2025-03-04,House,"House/ passed 3rd reading",70,0,0,5,75
1977424,1512213,2025-02-27,Senate,"Senate Comm - Held",5,0,0,2,7
1977483,1514070,2025-02-25,Senate,"Senate Comm - Favorable Recommendation",4,0,0,4,8
1977483,1514071,2025-02-25,Senate,"Senate/ passed 2nd reading",26,0,0,3,29
1977483,1514072,2025-02-27,Senate,"Senate/ passed 3rd reading",26,0,0,3,29
1977483,1514073,2025-03-04,House,"House Comm - Favorable Recommendation",7,0,0,4,11
1977540,1515076,2025-02-25,Senate,"Senate Comm - Substitute Recommendation",3,0,0,4,7
1977540,1515077,2025-02-25,Senate,"Senate Comm - Favorable Recommendation",4,0,0,3,7
1977540,1515078,2025-02-25,Senate,"Senate/ passed 2nd reading",22,0,0,7,29
1977540,1515079,2025-02-26,Senate,"Senate/ passed 3rd reading",22,0,0,7,29
1977540,1515080,2025-03-04,House,"House Comm - Amendment Recommendation",8,0,0,6,14
1977540,1515081,2025-03-04,House,"House Comm - Favorable Recommendation",8,0,0,6,14
1977540,1515082,2025-03-07,House,"House/ passed 3rd reading",68,0,0,7,75
1977540,1515083,2025-03-07,Senate,"Senate/ concurs with House amendment",28,0,0,1,29
1977599,1512125,2025-02-27,Senate,"Senate Comm - Favorable Recommendation",3,0,0,4,7
1977599,1512126,2025-03-03,Senate,"Senate/ passed 2nd reading",23,0,0,6,29
1977599,1512127,2025-03-04,Senate,"Senate/ passed 3rd reading",24,0,0,5,29
1977657,1513898,2025-02-26,House,"House Comm - Favorable Recommendation",9,0,0,2,11
1977657,1513899,2025-02-26,House,"House Comm - Consent Calendar Recommendation",9,0,0,2,11
1977657,1513900,2025-02-28,House,"House/ passed 3rd reading",64,0,0,11,75
1977657,1513901,2025-03-04,Senate,"Senate Comm - Substitute Recommendation",5,0,0,4,9
1977657,1513902,2025-03-04,Senate,"Senate Comm - Favorable Recommendation",6,0,0,3,9
1977657,1513903,2025-03-07,Senate,"Senate/ passed 2nd & 3rd readings/ suspension",27,0,0,2,29
1977657,1513904,2025-03-07,House,"House/ concurs with Senate amendment",67,0,0,8,75
1977714,1512639,2025-02-26,Senate,"Senate Comm - Favorable Recommendation",5,0,0,2,7
1977714,1512640,2025-02-27,Senate,"Senate/ passed 2nd reading",24,0,0,5,29
1977714,1512641,2025-02-28,Senate,"Senate/ passed 3rd reading",25,0,0,4,29
1977714,1512642,2025-03-04,House,"House Comm - Favorable Recommendation",14,0,0,2,16
1977714,1512643,2025-03-07,House,"House/ passed 3rd reading",68,0,0,7,75
1977777,1512702,2025-02-25,House,"House Comm - Favorable Recommendation",10,0,0,6,16
1977777,1512703,2025-02-28,House,"House/ passed 3rd reading",65,0,0,10,75
1977777,1512704,2025-03-03,Senate,"Senate Comm - Favorable Recommendation",4,0,0,3,7
1977777,1512705,2025-03-07,Senate,"Senate/ passed 2nd & 3rd readings/ suspension",28,0,0,1,29
1979233,1514166,2025-02-26,Senate,"Senate Comm - Substitute Recommendation",5,0,0,1,6
1979233,1514167,2025-02-26,Senate,"Senate Comm - Favorable Recommendation",5,0,0,1,6
1979233,1514168,2025-02-27,Senate,"Senate/ passed 2nd reading",23,3,0,3,29
1979233,1514169,2025-02-28,Senate,"Senate/ passed 3rd reading",19,5,0,5,29
1979233,1514170,2025-03-04,House,"House Comm - Substitute Recommendation",6,1,0,3,10
1979233,1514171,2025-03-04,House,"House Comm - Favorable Recommendation",4,3,0,3,10
1979233,1514172,2025-03-07,House,"House/ passed 3rd reading",38,27,0,10,75
1979233,1514173,2025-03-07,Senate,"Senate/ concurs with House amendment",22,5,0,2,29
1979379,1515109,2025-02-27,Senate,"Senate Comm - Favorable Recommendation",4,0,0,5,9
1979379,1515110,2025-03-03,Senate,"Senate/ passed 2nd reading",23,0,0,6,29
1979379,1515111,2025-03-04,Senate,"Senate/ passed 3rd reading",26,0,0,3,29
1979379,1515112,2025-03-05,House,"House/ passed 3rd reading",69,0,0,6,75
1979379,1515113,2025-03-06,Senate,"Senate/ concurs with House amendment",21,0,0,8,29
1979527,1511706,2025-02-26,Senate,"Senate Comm - Favorable Recommendation",4,0,0,4,8
1979527,1511707,2025-02-28,Senate,"Senate/ passed 2nd reading",24,0,0,5,29
1979527,1511708,2025-03-03,Senate,"Senate/ passed 3rd reading",26,0,0,3,29
1979527,1511709,2025-03-04,House,"House Comm - Favorable Recommendation",10,0,0,2,12
1979527,1511710,2025-03-07,House,"House/ passed 3rd reading",68,0,0,7,75
1979677,1513648,2025-02-27,House,"House Comm - Favorable Recommendation",7,0,0,4,11
1979677,1513649,2025-02-27,House,"House Comm - Consent Calendar Recommendation",7,0,0,4,11
1979677,1513650,2025-03-03,House,"House/ passed 3rd reading",67,0,0,8,75
1979847,1513422,2025-02-27,House,"House Comm - Substitute Recommendation",8,0,0,2,10
1979847,1513423,2025-02-27,House,"House Comm - Favorable Recommendation",8,0,0,2,10
1979847,1513424,2025-02-28,House,"House/ passed 3rd reading",71,0,0,4,75
1979847,1513425,2025-03-04,Senate,"Senate Comm - Substitute Recommendation",4,0,0,2,6
1979847,1513426,2025-03-04,Senate,"Senate Comm - Favorable Recommendation",3,1,0,2,6
1979847,1513427,2025-03-07,Senate,"Senate/ passed 2nd & 3rd readings/ suspension",17,9,0,3,29
1979847,1513428,2025-03-07,House,"House/ concurs with Senate amendment",39,26,0,10,75
1979856,1513577,2025-02-27,House,"House Comm - Favorable Recommendation",8,0,0,2,10
1979856,1513578,2025-02-28,House,"House/ passed 3rd reading",73,0,0,2,75
1979856,1513579,2025-03-04,Senate,"Senate Comm - Favorable Recommendation",4,0,0,2,6
1979856,1513580,2025-03-07,Senate,"Senate/ passed 2nd & 3rd readings/ suspension",23,0,0,6,29
1979876,1511176,2025-02-26,Senate,"Senate Comm - Amendment Recommendation",5,0,0,2,7
1979876,1511177,2025-02-26,Senate,"Senate Comm - Favorable Recommendation",6,0,0,1,7
1979876,1511178,2025-02-27,Senate,"Senate/ passed 2nd reading",24,1,0,4,29
1979876,1511179,2025-02-28,Senate,"Senate/ passed 3rd reading",26,1,0,2,29
1979876,1511180,2025-03-04,House,"House Comm - Favorable Recommendation",11,1,0,0,12
1979876,1511181,2025-03-05,House,"House/ passed 3rd reading",67,4,0,4,75
1979883,1513739,2025-03-03,House,"House Comm - Substitute Recommendation",8,0,0,3,11
1979883,1513740,2025-03-03,House,"House Comm - Favorable Recommendation",8,1,0,2,11
1979883,1513741,2025-03-04,House,"House/ passed 3rd reading",53,19,0,3,75
1979912,1512697,2025-02-26,Senate,"Senate Comm - Favorable Recommendation",5,0,0,2,7
1979912,1512698,2025-02-28,Senate,"Senate/ passed 2nd reading",22,2,0,5,29
1979912,1512699,2025-03-03,Senate,"Senate/ passed 3rd reading",18,8,0,3,29
1979912,1512700,2025-03-04,House,"House Comm - Held",10,0,0,4,14
1979922,1511248,2025-02-28,House,"House Comm - Substitute Recommendation",8,1,0,4,13
1979922,1511249,2025-02-28,House,"House Comm - Favorable Recommendation",7,1,0,5,13
1979922,1511250,2025-03-03,House,"House/ passed 3rd reading",61,12,0,2,75
1979931,1512944,2025-02-28,House,"House Comm - Favorable Recommendation",7,0,0,3,10
1979931,1512945,2025-02-28,House,"House Comm - Consent Calendar Recommendation",7,0,0,3,10
1979931,1512946,2025-03-03,House,"House/ passed 3rd reading",60,4,0,11,75
1979931,1512947,2025-03-07,Senate,"Senate/ passed 2nd & 3rd readings/ suspension",24,5,0,0,29
1979949,1512629,2025-02-25,Senate,"Senate Comm - Favorable Recommendation",5,0,0,2,7
1979949,1512630,2025-02-27,Senate,"Senate/ passed 2nd reading",25,0,0,4,29
1979949,1512631,2025-02-28,Senate,"Senate/ passed 3rd reading",24,0,0,5,29
1979949,1512632,2025-03-04,House,"House Comm - Favorable Recommendation",10,0,0,4,14
1980691,1514620,2025-02-25,Senate,"Senate Comm - Favorable Recommendation",6,0,0,3,9
1980691,1514621,2025-03-04,Senate,"Senate/ passed 2nd & 3rd readings/ suspension",27,0,0,2,29
1980691,1514622,2025-03-07,House,"House/ passed 3rd reading",68,0,0,7,75
1981180,1515005,2025-02-28,House,"House Comm - Substitute Recommendation",13,0,0,1,14
1981180,1515006,2025-02-28,House,"House Comm - Favorable Recommendation",7,6,0,1,14
1981180,1515007,2025-03-03,House,"House/ passed 3rd reading",71,0,0,4,75
1981228,1512672,2025-02-28,Senate,"Senate Comm - Motion to Recommend Failed",3,4,0,2,9
1981274,1511182,2025-02-27,House,"House Comm - Amendment Recommendation",13,0,0,3,16
1981274,1511183,2025-02-27,House,"House Comm - Favorable Recommendation",11,2,0,3,16
1981274,1511184,2025-02-28,House,"House/ passed 3rd reading",58,11,0,6,75
1981274,1511185,2025-03-04,Senate,"Senate Comm - Favorable Recommendation",4,1,0,2,7
1981274,1511186,2025-03-07,Senate,"Senate/ passed 2nd & 3rd readings/ suspension",16,11,0,2,29
1981323,1512414,2025-03-03,Senate,"Senate Comm - Substitute Recommendation",6,0,0,1,7
1981323,1512415,2025-03-03,Senate,"Senate Comm - Favorable Recommendation",6,0,0,1,7
1981323,1512416,2025-03-04,Senate,"Senate/ failed",13,15,0,1,29
1981323,1512417,2025-03-05,Senate,"Senate/ passed 2nd & 3rd readings/ suspension",24,2,0,3,29
1981323,1512418,2025-03-07,House,"House/ passed 3rd reading",66,0,0,9,75
1981323,1512419,2025-03-07,Senate,"Senate/ concurs with House amendment",24,0,0,5,29
1981469,1513174,2025-02-26,Senate,"Senate Comm - Substitute Recommendation",5,0,0,2,7
1981469,1513175,2025-02-26,Senate,"Senate Comm - Favorable Recommendation",4,1,0,2,7
1981469,1513176,2025-02-27,Senate,"Senate/ passed 2nd reading",20,8,0,1,29
1981469,1513177,2025-02-28,Senate,"Senate/ passed 3rd reading",18,10,0,1,29
1981469,1513178,2025-03-04,House,"House Comm - Substitute Recommendation",13,0,0,3,16
1981469,1513179,2025-03-04,House,"House Comm - Favorable Recommendation",11,2,0,3,16
1981469,1513180,2025-03-07,House,"House/ passed 3rd reading",55,9,0,11,75
1981469,1513181,2025-03-07,Senate,"Senate/ concurs with House amendment",19,5,0,5,29
1981518,1515064,2025-02-26,Senate,"Senate Comm - Favorable Recommendation",5,1,0,2,8
1981518,1515065,2025-03-03,Senate,"Senate/ passed 2nd reading",21,5,0,3,29
1981518,1515066,2025-03-04,Senate,"Senate/ passed 3rd reading",24,4,0,1,29
1981518,1515067,2025-03-07,House,"House/ passed 3rd reading",61,4,0,10,75
1981518,1515068,2025-03-07,Senate,"Senate/ concurs with House amendment",27,1,0,1,29
1981567,1512831,2025-03-03,Senate,"Senate Comm - Amendment Recommendation",6,0,0,1,7
1981567,1512832,2025-03-03,Senate,"Senate Comm - Motion to Recommend Failed",3,3,0,1,7
1981617,1511187,2025-02-26,Senate,"Senate Comm - Favorable Recommendation",7,0,0,1,8
1981617,1511188,2025-02-28,Senate,"Senate/ passed 2nd reading",25,0,0,4,29
1981617,1511189,2025-03-03,Senate,"Senate/ passed 3rd reading",24,0,0,5,29
1981617,1511190,2025-03-04,House,"House Comm - Favorable Recommendation",8,0,0,3,11
1981617,1511191,2025-03-05,House,"House/ passed 3rd reading",74,0,0,1,75
1981665,1511351,2025-02-28,House,"House Comm - Substitute Recommendation",10,0,0,4,14
1981665,1511352,2025-02-28,House,"House Comm - Favorable Recommendation",10,2,0,2,14
1981665,1511353,2025-03-03,House,"House/ failed",32,42,0,1,75
1981665,1511354,2025-03-04,House,"House/ passed 3rd reading",55,15,0,5,75
1981665,1511355,2025-03-05,Senate,"Senate/ passed 2nd & 3rd readings/ suspension",18,3,0,8,29
1981715,1514011,2025-02-28,House,"House Comm - Favorable Recommendation",10,0,0,3,13
1981715,1514012,2025-03-03,House,"House/ passed 3rd reading",69,0,0,6,75
1981715,1514013,2025-03-07,Senate,"Senate/ passed 2nd & 3rd readings/ suspension",23,6,0,0,29
1981715,1514014,2025-03-07,Senate,"Senate/ passed 2nd & 3rd readings/ suspension",23,6,0,0,29
1981715,1514015,2025-03-07,House,"House/ concurs with Senate amendment",65,5,0,5,75
1982335,1511192,2025-02-26,Senate,"Senate Comm - Favorable Recommendation",5,1,0,1,7
1982335,1511193,2025-03-03,Senate,"Senate/ passed 2nd reading",22,5,0,2,29
1982335,1511194,2025-03-04,Senate,"Senate/ passed 3rd reading",25,4,0,0,29
1982335,1511195,2025-03-05,House,"House/ passed 3rd reading",68,3,0,4,75
1982582,1513584,2025-02-28,House,"House Comm - Substitute Recommendation",9,0,0,7,16
1982582,1513586,2025-02-28,House,"House Comm - Favorable Recommendation",9,0,0,7,16
1982582,1513588,2025-03-03,House,"House/ passed 3rd reading",74,0,0,1,75
1982582,1513591,2025-03-07,Senate,"Senate/ passed 2nd & 3rd readings/ suspension",23,0,0,6,29
1982665,1512659,2025-02-28,House,"House Comm - Favorable Recommendation",10,0,0,1,11
1982665,1512660,2025-03-03,House,"House/ passed 3rd reading",74,0,0,1,75
1982745,1511302,2025-02-27,Senate,"Senate Comm - Substitute Recommendation",3,0,0,3,6
1982745,1511303,2025-02-27,Senate,"Senate Comm - Favorable Recommendation",4,0,0,2,6
1982745,1511304,2025-03-04,Senate,"Senate/ passed 2nd & 3rd readings/ suspension",23,4,0,2,29
1982745,1511305,2025-03-06,House,"House/ passed 3rd reading",45,27,0,3,75
1982745,1511306,2025-03-06,Senate,"Senate/ concurs with House amendment",17,7,0,5,29
1983572,1513771,2025-02-27,Senate,"Senate Comm - Substitute Recommendation",3,0,0,3,6
1983572,1513772,2025-02-27,Senate,"Senate Comm - Favorable Recommendation",2,1,0,3,6
1983572,1513773,2025-03-03,Senate,"Senate/ passed 2nd reading",20,4,0,5,29
1983572,1513774,2025-03-04,Senate,"Senate/ passed 3rd reading",21,4,0,4,29
1983572,1513775,2025-03-07,House,"House/ passed 3rd reading",54,16,0,5,75
1983572,1513776,2025-03-07,Senate,"Senate/ concurs with House amendment",22,5,0,2,29
1984610,1514761,2025-02-27,House,"House Comm - Favorable Recommendation",6,0,0,5,11
1984610,1514762,2025-02-27,House,"House Comm - Consent Calendar Recommendation",6,0,0,5,11
1984610,1514763,2025-03-03,House,"House/ passed 3rd reading",66,0,0,9,75
1984708,1513100,2025-02-28,House,"House Comm - Held",7,4,0,5,16
1984708,1513101,2025-02-28,House,"House Comm - Motion to Recommend Failed",5,6,0,5,16
1984906,1513849,2025-03-03,Senate,"Senate Comm - Substitute Recommendation",5,0,0,2,7
1984906,1513850,2025-03-03,Senate,"Senate Comm - Favorable Recommendation",5,0,0,2,7
1984906,1513851,2025-03-03,Senate,"Senate/ passed 2nd reading",23,0,0,6,29
1984906,1513852,2025-03-04,Senate,"Senate/ passed 3rd reading",26,0,0,3,29
1984906,1513853,2025-03-07,House,"House/ passed 3rd reading",70,0,0,5,75
1985005,1514294,2025-02-28,House,"House Comm - Favorable Recommendation",8,0,0,8,16
1985005,1514295,2025-03-03,House,"House/ passed 3rd reading",71,0,0,4,75
1985204,1513487,2025-03-03,House,"House Comm - Substitute Recommendation",9,0,0,2,11
1985204,1513488,2025-03-03,House,"House Comm - Favorable Recommendation",9,1,0,1,11
1985204,1513489,2025-03-04,House,"House/ passed 3rd reading",60,11,0,4,75
1985204,1513490,2025-03-06,Senate,"Senate/ failed",14,10,0,5,29
1985204,1513491,2025-03-06,Senate,"Senate/ passed 2nd & 3rd readings/ suspension",17,11,0,1,29
1985204,1513492,2025-03-07,House,"House/ concurs with Senate amendment",58,14,0,3,75
1985302,1514694,2025-02-28,House,"House Comm - Favorable Recommendation",8,0,0,5,13
1985302,1514695,2025-03-03,House,"House/ passed 3rd reading",68,3,0,4,75
1985502,1513801,2025-03-03,Senate,"Senate Comm - Substitute Recommendation",3,0,0,3,6
1985502,1513802,2025-03-03,Senate,"Senate Comm - Favorable Recommendation",3,2,0,1,6
1986304,1511335,2025-02-28,Senate,"Senate Comm - Favorable Recommendation",6,0,0,2,8
1986304,1511336,2025-03-03,Senate,"Senate/ passed 2nd reading",24,0,0,5,29
1986304,1511337,2025-03-04,Senate,"Senate/ passed 3rd reading",24,0,0,5,29
1986304,1511338,2025-03-07,House,"House/ passed 3rd reading",63,4,0,8,75
1986304,1511339,2025-03-07,Senate,"Senate/ concurs with House amendment",27,1,0,1,29
1986606,1513914,2025-03-03,Senate,"Senate Comm - Favorable Recommendation",7,0,0,0,7
1986606,1513915,2025-03-04,Senate,"Senate/ passed 2nd & 3rd readings/ suspension",27,0,0,2,29
1989320,1511430,2025-03-04,Senate,"Senate/ passed 2nd & 3rd readings/ suspension",26,1,0,2,29
1989320,1511431,2025-03-05,House,"House/ passed 3rd reading",70,0,0,5,75
1989323,1511284,2025-03-04,House,"House/ passed 3rd reading",73,0,0,2,75
1989323,1511285,2025-03-05,Senate,"Senate/ passed 2nd & 3rd readings/ suspension",23,1,0,5,29
1989328,1511196,2025-03-03,House,"House Comm - Amendment Recommendation",11,0,0,2,13
1989328,1511197,2025-03-03,House,"House Comm - Favorable Recommendation",12,0,0,1,13
1989328,1511198,2025-03-04,House,"House/ passed 3rd reading",73,0,0,2,75
1989328,1511199,2025-03-05,Senate,"Senate/ passed 2nd & 3rd readings/ suspension",26,0,0,3,29
1989329,1513252,2025-03-04,House,"House/ passed 3rd reading",72,2,0,1,75
1989329,1513253,2025-03-05,Senate,"Senate/ passed 2nd & 3rd readings/ suspension",23,0,0,6,29
1989333,1511200,2025-03-04,Senate,"Senate/ passed 2nd & 3rd readings/ suspension",27,0,0,2,29
1989333,1511201,2025-03-05,House,"House/ passed 3rd reading",70,0,0,5,75
1995499,1511460,2025-03-07,Senate,"Senate/ passed 2nd & 3rd readings/ suspension",27,0,0,2,29
1995499,1511461,2025-03-07,House,"House/ passed 3rd reading",72,0,0,3,75
